period,mktsize,entries,exits,surviv,entryrate,exitrate,survivrate,firms,totresinv,totinninv,totimiinv,costshareinn,firmsres,firmsinn,firmsimi,hindex,div,gini,pcm,cs,totprofits,ts,maxage,minage,avgage,actfirms,inactfirms,profitablefirms,wmc,avgproxopt,price,totoutput,avgoutput,magtechshock
1,4,40,26,14,1.0,0.65,0.35,40,0,0,0,0,0,0,0,375.4294078254477,0.4990251068376068,-0.06796205630354946,0.16058943779758666,118248.47647392275,2078.7910997732297,120327.26757369598,0,0,0.0,34,6,14,47.71649326805388,0.5030637254901961,56.84523809523809,972.6190476190463,28.606442577030776,0
2,4,35,28,21,0.7142857142857143,0.5714285714285714,0.4285714285714286,49,200,100,100,0.5,3,1,2,289.24034518408257,0.5000531462585034,-0.12772722903918265,0.13448620429362068,121918.45441980635,-1347.252831861083,120571.20158794527,1,0,0.2857142857142857,42,7,15,45.959453492935616,0.5277777777777778,53.10077519379844,987.5968992248049,23.514211886304878,0
3,4,13,16,18,0.38235294117647056,0.47058823529411764,0.5294117647058824,34,550,300,250,0.5454545454545454,8,3,5,334.44360417108305,0.4988116458704694,0.007425427492468106,0.15788319520403377,122571.43565759661,1398.6465419501405,123970.08219954676,2,0,0.9411764705882353,34,0,15,44.16100625150277,0.548406862745098,52.440476190476204,990.2380952380972,29.124649859944036,0
4,4,16,14,20,0.47058823529411764,0.4117647058823529,0.5882352941176471,34,500,300,200,0.6,7,3,4,344.0130971847311,0.49511660724896017,-0.00233929237285202,0.16732364779299208,123841.98022959172,1720.6526360544062,125562.63286564613,3,0,1.1470588235294117,34,0,17,42.600316947733525,0.5615808823529411,51.16071428571428,995.3571428571419,29.275210084033585,0
5,4,12,12,20,0.375,0.375,0.625,32,500,200,300,0.4,8,2,6,369.4515028090718,0.48916330645161293,-0.03698850719878821,0.18444621685007773,124936.87665799416,2831.623367513522,127768.50002550767,4,0,1.4375,32,0,16,40.82917613875557,0.5774739583333333,50.063131313131315,999.7474747474754,31.242108585858606,0
6,4,3,2,21,0.13043478260869565,0.08695652173913043,0.9130434782608696,23,550,300,250,0.5454545454545454,8,3,5,471.4642518428368,0.48674242424242425,0.006201408996603153,0.22646910031846076,123313.02218967007,7027.536349826379,130340.55853949644,5,0,2.5217391304347827,23,0,20,39.98590718405873,0.5910326086956521,51.69270833333333,993.2291666666661,43.183876811594175,0
7,4,5,1,25,0.19230769230769232,0.038461538461538464,0.9615384615384616,26,850,700,150,0.8235294117647058,10,7,3,415.14616969419484,0.4824038461538462,0.04592979835698241,0.20931495688777255,125347.46334876555,5207.5038580247065,130554.96720679026,6,0,3.0384615384615383,26,0,22,39.25970873786409,0.5997596153846154,49.652777777777786,1001.3888888888898,38.5149572649573,0
8,4,3,1,27,0.10714285714285714,0.03571428571428571,0.9642857142857143,28,500,300,200,0.6,7,3,4,385.0374189133088,0.48134369488536155,0.020592802991600934,0.19778079321256015,126115.9855372243,4111.874710992215,130227.86024821652,7,0,3.5,28,0,25,39.217684642158964,0.6008184523809523,48.88649425287357,1004.4540229885066,35.873357963875236,0
9,4,2,3,26,0.06896551724137931,0.10344827586206896,0.896551724137931,29,1250,900,350,0.72,16,9,7,370.34120479673396,0.4796284893267652,-0.0011416556861592042,0.19299808724453812,126707.17833719135,3584.9778163580177,130292.15615354937,8,0,4.103448275862069,29,0,24,38.977071550098856,0.6038074712643677,48.29861111111111,1006.8055555555555,34.71743295019157,0
10,4,0,0,26,0.0,0.0,1.0,26,700,500,200,0.7142857142857143,9,5,4,407.7177993099397,0.47746794871794873,-0.0052632822560638726,0.2098538016843491,126198.84842725952,5090.703351242177,131289.55177850171,9,1,5.153846153846154,26,0,26,38.56230481748834,0.608573717948718,48.804012345679006,1004.7839506172836,38.64553656220322,0
11,4,0,0,26,0.0,0.0,1.0,26,1100,700,400,0.6363636363636364,15,7,8,409.02292359818057,0.47660256410256413,-0.0025499362515939428,0.21152328334648768,126392.74691358021,5139.506172839496,131532.25308641972,10,2,6.153846153846154,26,0,24,38.328729281767956,0.6105769230769231,48.61111111111111,1005.5555555555553,38.67521367521367,0
12,4,2,1,27,0.07142857142857142,0.03571428571428571,0.9642857142857143,28,950,600,350,0.631578947368421,13,6,7,382.08403498687477,0.4750055114638448,-0.008705961370158555,0.20118888533930027,127128.23533904733,4114.733823820832,131242.96916286816,11,0,6.642857142857143,28,0,26,38.24767298285606,0.6112351190476191,47.88074712643677,1008.477011494252,36.017036124794714,0
13,4,0,1,26,0.0,0.037037037037037035,0.962962962962963,27,1100,700,400,0.6363636363636364,15,7,8,394.0831524959594,0.4751899335232668,-0.018685352018685153,0.20636790607503028,126904.52108577802,4602.186747094666,131506.7078328727,12,1,7.518518518518518,27,0,26,38.17582951804264,0.6122685185185186,48.10267857142857,1007.5892857142853,37.318121693121675,0
14,4,2,0,28,0.07142857142857142,0.0,1.0,28,900,600,300,0.6666666666666666,12,6,6,380.1163891453817,0.4744543650793651,-0.017534499928866243,0.20195299314458692,127490.73368757419,4092.263467763227,131582.99715533742,13,0,7.892857142857143,28,0,20,37.92443211457297,0.6149553571428572,47.52155172413792,1009.9137931034472,36.06834975369454,0
15,4,1,1,28,0.034482758620689655,0.034482758620689655,0.9655172413793104,29,900,400,500,0.4444444444444444,14,4,10,369.71541546289893,0.4739839901477832,-0.02726433626014768,0.1987731956935217,127968.81028163576,3662.4083719135724,131631.21865354932,14,0,8.586206896551724,29,0,23,37.696608327613816,0.6167385057471264,47.04861111111111,1011.8055555555552,34.88984674329501,0
16,4,0,0,28,0.0,0.0,1.0,28,550,200,350,0.36363636363636365,9,2,7,382.71844115066807,0.47379298941798936,-0.016332474174497458,0.20517556033964598,127853.74812144932,4186.397435262246,132040.14555671156,15,1,9.785714285714286,28,0,23,37.48579343656768,0.6186755952380952,47.16235632183908,1011.3505747126435,36.11966338259441,0
17,4,4,4,28,0.125,0.125,0.875,32,800,600,200,0.75,10,6,4,338.38073517928564,0.471669186827957,-0.023702478568766283,0.1871908273167058,129105.1315713958,2337.33786730946,131442.46943870527,16,0,9.4375,32,0,18,37.330724313579324,0.6201171875,45.928030303030305,1016.287878787879,31.758996212121218,0
18,4,0,0,28,0.0,0.0,1.0,28,400,400,0,1.0,4,4,0,380.04529354742317,0.47078924162257496,-0.004699781217081256,0.2061599546228021,128326.43843308228,4153.97179283921,132480.41022592149,17,1,11.142857142857142,28,0,26,37.068680279826076,0.6235119047619048,46.695402298850574,1013.2183908045974,36.186371100164195,0
19,4,1,2,27,0.034482758620689655,0.06896551724137931,0.9310344827586207,29,600,300,300,0.5,9,3,6,368.4097212547968,0.4701867816091954,-0.0050973691911229135,0.20176922215049048,128707.64853395046,3683.429783950599,132391.07831790106,18,0,11.724137931034482,29,0,19,36.97360616844604,0.6242816091954023,46.319444444444436,1014.7222222222209,34.99042145593865,0
20,4,1,1,27,0.03571428571428571,0.03571428571428571,0.9642857142857143,28,550,100,450,0.18181818181818182,10,1,9,401.8495800891172,0.47004519400352734,0.01998876748698053,0.20714353815205405,126260.34493080332,4547.533318470081,130807.8782492734,19,0,12.785714285714286,28,0,20,38.64605670717179,0.6023065476190477,48.742816091954026,1005.0287356321842,35.89388341543515,8
21,4,2,1,28,0.06896551724137931,0.034482758620689655,0.9655172413793104,29,1300,1000,300,0.7692307692307693,16,10,6,382.99011152750506,0.4706999178981937,0.037348006443243875,0.20096596090781688,126987.0008680557,3926.9531250000196,130913.95399305571,20,0,13.241379310344827,29,0,20,38.37028041890589,0.6066810344827587,48.02083333333334,1007.9166666666678,34.755747126436816,0
22,4,2,0,30,0.06666666666666667,0.0,1.0,30,550,300,250,0.5454545454545454,8,3,5,378.1885224859391,0.4700670498084291,0.0643406691715871,0.19093908330387654,125403.55098855363,3485.2367325702485,128888.78772112388,21,0,13.2,30,0,17,40.12681159420291,0.5875,49.59677419354839,1001.6129032258068,33.38709677419356,8
23,4,3,2,31,0.09090909090909091,0.06060606060606061,0.9393939393939394,33,700,600,100,0.8571428571428571,8,6,2,348.7919313434569,0.47293244949494945,0.056031599989654124,0.1797889773065801,126259.28316332657,2207.643844915414,128466.92700824198,22,0,12.909090909090908,33,0,20,39.9802615534691,0.588699494949495,48.743872549019606,1005.0245098039213,30.455288175876404,0
24,4,4,3,32,0.11428571428571428,0.08571428571428572,0.9142857142857143,35,1050,900,150,0.8571428571428571,12,9,3,327.7301398775368,0.47321428571428575,0.06953325239444208,0.17266976026383654,127152.0408163265,1337.048302776986,128489.08911910348,23,0,12.742857142857142,34,1,21,39.59366147308782,0.5955882352941176,47.857142857142854,1008.5714285714283,29.66386554621848,0
25,4,4,3,33,0.1111111111111111,0.08333333333333333,0.9166666666666666,36,1000,700,300,0.7,13,7,6,320.77277687854297,0.47263558201058203,0.1001379196379768,0.17233404073112146,127939.53517500439,1007.9039941272446,128947.43916913164,24,0,12.805555555555555,35,1,20,38.964482515349125,0.6014880952380952,47.077546296296305,1011.6898148148157,28.905423280423307,0
26,4,0,0,33,0.0,0.0,1.0,33,800,500,300,0.625,11,5,6,347.7008830168258,0.47123579545454547,0.11796090200491816,0.1845098846373959,127442.37075617282,2262.3649691357978,129704.73572530862,25,1,14.909090909090908,32,1,20,38.792411737734966,0.6031901041666667,47.56944444444444,1009.7222222222222,31.553819444444443,0
27,4,3,2,34,0.08333333333333333,0.05555555555555555,0.9444444444444444,36,1000,800,200,0.8,12,8,4,321.2694320712876,0.4719080687830688,0.12160987372295207,0.1743777977547503,128349.69142500426,1046.9664941272256,129396.65791913148,26,0,14.583333333333334,35,1,23,38.533814011041315,0.6056547619047619,46.6724537037037,1013.310185185185,28.951719576719572,0
28,4,0,1,33,0.0,0.029411764705882353,0.9705882352941176,34,950,600,350,0.631578947368421,13,6,7,367.2457430140665,0.47034685086155675,0.15023187698315832,0.18831111503487238,126043.8368055556,2471.961939514751,128515.79874507035,27,1,15.735294117647058,33,1,19,39.738934993084364,0.586489898989899,48.958333333333336,1004.1666666666671,30.42929292929294,8
29,4,5,2,36,0.13157894736842105,0.05263157894736842,0.9473684210526316,38,1150,700,450,0.6086956521739131,16,7,9,329.0561749601066,0.4740398293029872,0.13274477942819862,0.17323664365120275,127121.19187510703,774.6831865140457,127895.87506162107,28,0,14.842105263157896,35,3,19,39.59182160755959,0.5931547619047619,47.887731481481474,1008.449074074073,28.812830687830658,0
30,4,3,6,33,0.07692307692307693,0.15384615384615385,0.8461538461538461,39,1750,1500,250,0.8571428571428571,20,15,5,320.484110915985,0.4752024291497976,0.1329903095789382,0.170506671110106,127546.62390430979,375.33327246165277,127921.95717677144,29,0,15.384615384615385,36,3,14,39.372909698996644,0.5954861111111112,47.46621621621622,1010.1351351351358,28.059309309309327,0
31,4,1,2,32,0.029411764705882353,0.058823529411764705,0.9411764705882353,34,1100,600,500,0.5454545454545454,16,6,10,375.1890877071197,0.47025401069518713,0.08047076078047932,0.19067062829935724,125674.92821270658,2630.3723327566213,128305.30054546321,30,0,17.676470588235293,33,1,17,39.92096471930253,0.5827020202020202,49.32598039215686,1002.6960784313719,30.384729649435513,8
32,4,5,3,34,0.13513513513513514,0.08108108108108109,0.9189189189189189,37,900,700,200,0.7777777777777778,11,7,4,338.4575440997297,0.475975975975976,0.08760526283995196,0.1773137063585703,126921.74437951461,1191.5243791088349,128113.26875862344,31,0,16.243243243243242,36,1,18,39.559352182983154,0.5891203703703703,48.085585585585584,1007.6576576576574,27.990490490490483,0
33,4,5,8,31,0.1282051282051282,0.20512820512820512,0.7948717948717949,39,1050,500,550,0.47619047619047616,16,5,11,314.1286044201802,0.4770017993702204,0.06962918423782516,0.16849039648984948,127874.2412361201,233.79138815836114,128108.03262427846,32,0,15.102564102564102,38,1,16,39.199103904792096,0.5951206140350878,47.14209401709401,1011.4316239316227,26.61662168241112,0
34,4,3,1,33,0.08823529411764706,0.029411764705882353,0.9705882352941176,34,650,200,450,0.3076923076923077,11,2,9,360.05220298294654,0.47406045751633985,0.09154304370238897,0.18770234135202335,126721.57343329492,2325.2763360246136,129046.84976931954,33,0,17.58823529411765,33,1,17,39.22123498864007,0.5934343434343434,48.2843137254902,1006.8627450980395,30.510992275698165,7
35,4,3,4,32,0.08333333333333333,0.1111111111111111,0.8888888888888888,36,1450,1000,450,0.6896551724137931,19,10,9,347.8164814009092,0.4752480158730159,0.099453080023028,0.1859985869053227,127753.08956916111,1687.4666778476171,129440.55624700873,34,0,16.63888888888889,34,2,18,38.47125726173653,0.6017156862745099,47.261904761904766,1010.9523809523818,29.73389355742299,0
36,4,0,0,32,0.0,0.0,1.0,32,850,500,350,0.5882352941176471,12,5,7,372.6565853107853,0.4739373319892473,0.09207301341589291,0.19732471648423527,127354.73632812487,3091.916232638875,130446.65256076374,35,1,17.4375,31,1,18,38.25249398004816,0.6048387096774194,47.65624999999999,1009.374999999999,32.56048387096771,0
37,4,2,1,33,0.058823529411764705,0.029411764705882353,0.9705882352941176,34,1000,600,400,0.6,14,6,8,352.3676461751099,0.47348484848484845,0.08766529867761075,0.18939760981912143,127958.47750865041,2217.6855055747706,130176.16301422518,36,0,17.352941176470587,33,1,21,38.14599483204136,0.6060606060606061,47.05882352941176,1011.7647058823521,30.65953654188946,0
38,4,2,0,35,0.05714285714285714,0.0,1.0,35,1000,400,600,0.4,16,4,12,340.065573060942,0.47391456582633057,0.07687969924812021,0.18460702537593987,128355.5555555555,1729.8611111111056,130085.41666666661,37,0,17.65714285714286,34,1,23,38.05167214912281,0.607843137254902,46.666666666666664,1013.3333333333329,29.803921568627437,0
39,4,2,3,34,0.05405405405405406,0.08108108108108109,0.9189189189189189,37,950,800,150,0.8421052631578947,11,8,3,325.0411748221493,0.47353603603603606,0.0880805417390782,0.17920974308653959,128972.51136271407,984.275322619918,129956.78668533398,38,0,17.64864864864865,36,1,17,37.80441611234295,0.6099537037037037,46.05855855855856,1015.7657657657658,28.215715715715717,0
40,4,1,2,33,0.02857142857142857,0.05714285714285714,0.9428571428571428,35,950,600,350,0.631578947368421,13,6,7,345.5976297202265,0.4734243697478992,0.11192682068722903,0.1897560198727861,128808.33510487515,1903.1710600906886,130711.50616496585,39,0,19.514285714285716,34,1,18,37.4496696767132,0.6124387254901961,46.22023809523809,1015.1190476190465,29.856442577030776,0
41,4,1,6,28,0.029411764705882353,0.17647058823529413,0.8235294117647058,34,700,400,300,0.5714285714285714,10,4,6,348.27409942501066,0.4727792632204397,0.10936890137886524,0.19207212309606844,128983.44574502572,2184.3186815166937,131167.76442654242,40,0,19.852941176470587,33,1,20,37.20329653757994,0.6164772727272727,46.047794117647044,1015.8088235294099,30.78208556149727,0
42,4,1,0,29,0.034482758620689655,0.0,1.0,29,1300,1000,300,0.7692307692307693,16,10,6,393.1355565615411,0.4699815270935961,0.09357789190511134,0.21287293961281611,128253.660077289,4284.214807107948,132537.87488439694,41,0,20.724137931034484,28,1,23,36.81176122931443,0.6227678571428572,46.76724137931035,1012.9310344827591,36.17610837438425,0
43,4,0,0,29,0.0,0.0,1.0,29,550,300,250,0.5454545454545454,8,3,5,393.0989060587207,0.46926313628899835,0.09463324484078695,0.21343545684620155,128362.83535225931,4291.858031113769,132654.6933833731,42,1,21.724137931034484,28,1,23,36.70069473982703,0.6238839285714286,46.6594827586207,1013.362068965518,36.19150246305421,0
44,4,1,0,30,0.03333333333333333,0.0,1.0,30,800,700,100,0.875,9,7,2,380.54963693034284,0.46886973180076624,0.0876996076284331,0.20841796457369452,128707.6485339507,3795.92978395063,132503.57831790132,43,0,21.966666666666665,29,1,22,36.665640113149,0.6242816091954023,46.31944444444445,1014.722222222223,34.99042145593872,0
45,4,0,0,30,0.0,0.0,1.0,30,1050,600,450,0.5714285714285714,15,6,9,413.7224853538872,0.46867816091954023,0.08881827392465702,0.2135893972176487,126322.9263117284,4452.5270061728415,130775.45331790124,44,1,22.966666666666665,29,1,17,38.28290503822419,0.5998563218390804,48.68055555555556,1005.2777777777777,34.6647509578544,8
46,4,4,0,34,0.11764705882352941,0.0,1.0,34,1000,800,200,0.8,12,8,4,364.5962195120031,0.4691213606654783,0.11728540851723368,0.18942841391855725,126583.26478165512,2573.0257116621,129156.29049331722,45,0,21.147058823529413,32,2,19,39.24926808866583,0.5944010416666667,48.421717171717184,1006.3131313131328,31.4472853535354,8
47,4,1,2,33,0.02857142857142857,0.05714285714285714,0.9428571428571428,35,1150,800,350,0.6956521739130435,15,8,7,355.30512985921814,0.4686974789915966,0.10857547838412507,0.18637008856184287,126972.00255102049,2022.7607709750696,128994.76332199556,46,0,21.514285714285716,34,1,20,39.08329396015434,0.59375,48.03571428571429,1007.8571428571435,29.64285714285716,0
48,4,0,1,32,0.0,0.030303030303030304,0.9696969696969697,33,500,300,200,0.6,7,3,4,369.168193921441,0.468197601010101,0.11380167362108695,0.19240177636140993,126710.35640495879,2755.486685032157,129465.84308999094,47,1,23.21212121212121,32,1,20,39.003323300727374,0.595703125,48.295454545454554,1006.8181818181828,31.463068181818212,0
49,4,1,0,33,0.030303030303030304,0.0,1.0,33,1050,700,350,0.6666666666666666,14,7,7,368.19348868076827,0.46756628787878785,0.11592882735167276,0.1933984745807404,127028.3644526069,2754.203333843485,129782.56778645038,48,0,24.060606060606062,32,1,21,38.70057823981295,0.5989583333333333,47.97979797979798,1008.0808080808082,31.502525252525256,0
50,4,1,1,33,0.029411764705882353,0.029411764705882353,0.9705882352941176,34,1050,600,450,0.5714285714285714,15,6,9,357.8671227167491,0.4687685680332739,0.03906686014064076,0.183102887059929,125954.19501133791,2214.9730725623654,128169.16808390028,49,0,24.323529411764707,34,0,19,40.06685839658444,0.5833333333333333,49.04761904761905,1003.8095238095241,29.523809523809533,8
51,4,0,1,32,0.0,0.030303030303030304,0.9696969696969697,33,650,300,350,0.46153846153846156,10,3,7,358.2927291196779,0.4685527146464647,0.0135797812146361,0.18372031429328153,126043.83680555546,2432.1180555555457,128475.95486111101,50,1,24.666666666666668,33,0,19,39.96369294605808,0.586489898989899,48.95833333333333,1004.1666666666658,30.429292929292902,0
52,4,2,3,31,0.058823529411764705,0.08823529411764706,0.9117647058823529,34,850,400,450,0.47058823529411764,13,4,9,350.6981750812621,0.46938131313131315,0.03689953445000427,0.18220354480405077,126582.35721371861,2078.4403344670973,128660.79754818571,51,0,24.823529411764707,34,0,19,39.5998462084467,0.5897671568627452,48.42261904761904,1006.3095238095221,29.597338935574182,0
53,4,1,2,30,0.03125,0.0625,0.9375,32,650,600,50,0.9230769230769231,7,6,1,359.1101511471028,0.46984206989247307,0.03415934755332528,0.1865780902635206,126583.26478165478,2691.4670696867474,129274.73185134154,52,0,25.21875,32,0,20,39.387285654537855,0.5944010416666667,48.42171717171716,1006.31313131313,31.447285353535314,0
54,4,4,2,32,0.11764705882352941,0.058823529411764705,0.9411764705882353,34,800,500,300,0.625,11,5,6,338.76204984427784,0.4717580213903743,0.055443862872196714,0.18021291491715957,127542.56129535135,1841.3159013605273,129383.87719671188,53,0,23.58823529411765,34,0,16,38.91548811628364,0.5995710784313726,47.47023809523809,1010.1190476190466,29.70938375350137,0
55,4,0,1,31,0.0,0.03125,0.96875,32,900,800,100,0.8888888888888888,10,8,2,355.97719928383566,0.46984206989247307,0.06711514392991225,0.1878637927528298,127219.3605882051,2657.4383353739136,129876.79892357902,54,1,26.0625,32,0,23,38.81231748018355,0.6009114583333333,47.79040404040403,1008.8383838383825,31.526199494949452,0
56,4,0,0,31,0.0,0.0,1.0,31,850,700,150,0.8235294117647058,10,7,3,373.25303824599075,0.46872759856630825,0.06979250988797125,0.188241909321306,125358.32934909411,3158.075459798197,128516.40480889232,55,2,27.161290322580644,31,0,18,40.29723594677761,0.5843413978494624,49.64192708333334,1001.4322916666679,32.304267473118315,8
57,4,2,2,31,0.06060606060606061,0.06060606060606061,0.9393939393939394,33,850,500,350,0.5882352941176471,12,5,7,355.13328226164197,0.4694602272727273,0.07243433973569458,0.18196416395057108,126013.07377270755,2350.287299356008,128363.36107206355,56,0,26.454545454545453,33,0,21,40.074733512347954,0.5861742424242424,48.98897058823529,1004.0441176470583,30.425579322638132,0
58,4,2,0,33,0.06060606060606061,0.0,1.0,33,850,600,250,0.7058823529411765,11,6,5,365.3361589975762,0.4691051136363636,0.12447969463041164,0.18280247661429927,125030.6391321848,2535.642691512893,127566.2818236977,57,0,27.09090909090909,33,0,21,40.83483948045584,0.5760732323232323,49.969362745098046,1000.1225490196084,30.306743909685103,8
59,4,3,1,35,0.08333333333333333,0.027777777777777776,0.9722222222222222,36,1050,600,450,0.5714285714285714,15,6,9,344.0325672749891,0.4708664021164021,0.14550769077356462,0.17604513804186306,125959.03969848243,1466.8023597922443,127425.84205827468,58,0,25.75,36,0,19,40.409047565627105,0.5792824074074074,49.0427927927928,1003.8288288288302,27.88413413413417,0
60,4,1,0,36,0.027777777777777776,0.0,1.0,36,1250,900,350,0.72,16,9,7,339.50800042084416,0.4706183862433862,0.13364705418097156,0.17561690628015142,126402.72285997744,1383.004204390558,127785.727064368,57,0,25.11111111111111,34,2,17,40.06599976322954,0.5879289215686274,48.60119047619048,1005.595238095239,29.57633053221291,0
61,4,4,3,37,0.1,0.075,0.925,40,1250,1000,250,0.8,15,10,5,312.76834920819346,0.47262286324786323,0.16553911205073923,0.16697452502875362,127685.20801373386,-12.82165424792015,127672.38635948594,58,0,23.5,38,2,19,39.42631254404508,0.5932017543859649,47.32905982905984,1010.6837606837624,26.596941070625327,0
62,4,0,1,36,0.0,0.02702702702702703,0.972972972972973,37,1250,900,350,0.72,16,9,7,333.3475126432033,0.472190940940941,0.1618646851391634,0.17663772814544468,127383.94445516121,1092.6242069615953,128476.56866212281,59,1,25.405405405405407,35,2,20,39.214534128258045,0.5958333333333333,47.62731481481482,1009.490740740741,28.8425925925926,0
63,4,0,1,35,0.0,0.027777777777777776,0.9722222222222222,36,1300,800,500,0.6153846153846154,18,8,10,342.89162923689076,0.471114417989418,0.16171114517418017,0.18186766151082376,127422.337372449,1538.4105725623608,128960.74794501136,60,2,27.0,34,2,22,38.93433360845811,0.5983455882352942,47.589285714285715,1009.6428571428573,29.69537815126051,0
64,4,0,1,34,0.0,0.02857142857142857,0.9714285714285714,35,1500,1000,500,0.6666666666666666,20,10,10,342.12871386396836,0.46978291316526616,0.13846671829231405,0.18213953989019033,127572.62613378669,1729.2517006802568,129301.87783446694,61,3,27.114285714285714,34,1,22,38.79968968497132,0.5998774509803921,47.44047619047618,1010.2380952380939,29.712885154061585,0
65,4,2,0,36,0.05555555555555555,0.0,1.0,36,1300,900,400,0.6923076923076923,17,9,8,336.3182194894268,0.47010582010582014,0.14664392871206688,0.18147905403294332,128115.2360494896,1417.4976155263748,129532.73366501597,62,0,27.0,35,1,24,38.3918533973553,0.6032738095238095,46.90393518518517,1012.384259259257,28.925264550264483,0
66,4,0,1,35,0.0,0.027777777777777776,0.9722222222222222,36,1250,900,350,0.72,16,9,7,337.585469446259,0.4696924603174603,0.14605344517030971,0.1828624829910074,128268.64216887712,1460.3326543224382,129728.97482319956,63,1,28.0,33,3,25,38.203181708202266,0.6092171717171717,46.75245098039214,1012.9901960784296,30.69667260843726,0
67,4,1,0,36,0.027777777777777776,0.0,1.0,36,1200,800,400,0.6666666666666666,16,8,8,338.28279702744885,0.46833664021164023,0.149519287138,0.1860228224272794,128868.7659438772,1518.81731859406,130387.58326247125,64,0,27.333333333333332,34,2,23,37.57376792902644,0.6130514705882353,46.16071428571426,1015.35714285714,29.863445378151177,0
68,4,0,0,36,0.0,0.0,1.0,36,1700,1400,300,0.8235294117647058,20,14,6,341.5966895049439,0.46782407407407406,0.15180142544276087,0.18844714920081007,128995.54887099167,1612.8904910407737,130608.43936203244,65,1,28.333333333333332,35,1,23,37.360549352474266,0.6122023809523809,46.03587962962961,1015.8564814814792,29.024470899470835,0
69,4,1,1,36,0.02702702702702703,0.02702702702702703,0.972972972972973,37,1250,700,550,0.56,18,7,11,332.8326929120499,0.4681243743743744,0.14487790030959147,0.18553786958718002,129407.39300679434,1214.3663194444332,130621.75932623878,66,0,28.54054054054054,35,2,24,37.16454802259886,0.6163690476190475,45.63078703703703,1017.4768518518513,29.07076719576718,0
70,4,0,0,36,0.0,0.0,1.0,36,1200,1000,200,0.8333333333333334,14,10,4,387.14179080528857,0.46739417989417986,0.16168495803744376,0.20383502173942616,127124.83935885952,2771.59808751486,129896.43744637439,67,1,30.11111111111111,31,5,18,38.123655046266414,0.602486559139785,47.88411458333333,1008.4635416666661,32.53108198924729,8
71,4,0,0,36,0.0,0.0,1.0,36,900,700,200,0.7777777777777778,11,7,4,384.98985466031303,0.467063492063492,0.16097344117478363,0.20319491784115154,127223.34120008674,2595.939127604157,129819.2803276909,68,2,31.11111111111111,31,5,18,38.07649285837206,0.603494623655914,47.78645833333333,1008.8541666666661,32.543682795698906,0
72,4,2,2,36,0.05263157894736842,0.05263157894736842,0.9473684210526316,38,1150,800,350,0.6956521739130435,15,8,7,364.8745559212219,0.468142484589853,0.15198489875300303,0.19602756566118026,127939.53517500432,1736.3762163494548,129675.91139135377,69,0,30.42105263157895,35,3,16,37.849049498531826,0.6014880952380952,47.0775462962963,1011.6898148148151,28.90542328042329,0
73,4,3,0,39,0.07692307692307693,0.0,1.0,39,1350,1100,250,0.8148148148148148,16,11,5,347.75054680831363,0.46724583895636523,0.13259533415580238,0.18700711223468047,127978.05574792234,1101.0518731695342,129079.10762109187,70,0,30.05128205128205,37,2,19,38.242757549487074,0.597972972972973,47.03947368421052,1011.842105263157,27.34708392603127,8
74,4,1,3,37,0.025,0.075,0.925,40,1150,900,250,0.782608695652174,14,9,5,356.21342218804745,0.4680555555555555,0.15455337690631854,0.18537637277133068,126650.14716066472,1063.3175592489906,127713.46471991371,71,0,30.275,37,3,15,39.39133986928103,0.5844594594594594,48.35526315789473,1006.5789473684204,27.204836415362713,8
75,4,2,0,39,0.05128205128205128,0.0,1.0,39,1100,600,500,0.5454545454545454,16,6,10,362.39508497814506,0.46879217273954116,0.1855220476141355,0.1898542869077545,126921.74437951483,1399.163267997751,128320.90764751258,72,0,31.871794871794872,36,3,18,38.95633102369246,0.5891203703703703,48.0855855855856,1007.6576576576591,27.99049049049053,0
76,4,0,2,37,0.0,0.05128205128205128,0.9487179487179487,39,1400,1000,400,0.7142857142857143,18,10,8,365.41219862031255,0.46901709401709407,0.1786395422759055,0.19223859144807767,127092.0138888891,1488.1944444444673,128580.20833333356,73,1,32.87179487179487,36,3,20,38.70523415977961,0.5908564814814814,47.91666666666668,1008.3333333333351,28.00925925925931,0
77,4,0,1,36,0.0,0.02702702702702703,0.972972972972973,37,1800,1200,600,0.6666666666666666,24,12,12,374.9743869954235,0.4680930930930931,0.18874246146973395,0.19726913402802726,127092.01388888898,2131.250000000008,129223.26388888899,74,2,34.810810810810814,34,3,20,38.46418732782367,0.5949754901960784,47.91666666666667,1008.3333333333342,29.656862745098064,0
78,4,1,0,37,0.02702702702702703,0.0,1.0,37,1250,900,350,0.72,16,9,7,366.5773623222399,0.4692817817817818,0.17712653816014234,0.1950740605308086,127555.82475790569,1951.8155577181926,129507.64031562388,75,0,33.891891891891895,33,4,18,38.199457115127984,0.6019570707070707,47.45710784313726,1010.1715686274516,30.61125965537732,0
79,4,0,2,35,0.0,0.05405405405405406,0.9459459459459459,37,1000,700,300,0.7,13,7,6,364.68214485261194,0.46943818818818817,0.1772896942049358,0.19466237207763704,127679.65032980117,1912.4977472606863,129592.14807706185,76,1,34.891891891891895,33,4,19,38.120301321692736,0.603219696969697,47.33455882352942,1010.6617647058835,30.62611408199647,0
80,4,2,0,37,0.05405405405405406,0.0,1.0,37,1350,1000,350,0.7407407407407407,17,10,7,355.35343725436974,0.4684997497497498,0.16629905204442763,0.19323657327619273,128423.86529519886,1728.017168877344,130151.8824640762,77,0,33.351351351351354,33,4,17,37.594582476927414,0.6107954545454546,46.59926470588235,1013.6029411764698,30.715240641711205,0
81,4,0,1,36,0.0,0.02702702702702703,0.972972972972973,37,1650,1200,450,0.7272727272727273,21,12,9,357.6280561063686,0.46656031031031026,0.16637238615260674,0.1959972159243438,128734.59314025842,1807.8204596789612,130542.41359993738,78,1,34.351351351351354,33,4,19,37.21961417703178,0.6139520202020202,46.29289215686274,1014.8284313725479,30.75237670825903,0
82,4,0,0,36,0.0,0.0,1.0,36,1300,1100,200,0.8461538461538461,15,11,4,363.10658899133705,0.4656084656084656,0.16032071743426024,0.19957211770877284,128848.62075617308,2157.156635802501,131005.77739197559,79,2,35.666666666666664,32,4,21,36.9642042863657,0.6175130208333333,46.18055555555557,1015.2777777777798,31.727430555555618,0
83,4,0,0,36,0.0,0.0,1.0,36,1150,500,650,0.43478260869565216,18,5,13,363.2110547677546,0.46507936507936504,0.1652487832347851,0.19999534955882953,128921.21006644092,2165.1217380334638,131086.33180447438,80,3,36.666666666666664,33,3,21,36.88746932947186,0.6158459595959596,46.10906862745099,1015.5637254901972,30.774658348187792,0
84,4,2,1,37,0.05263157894736842,0.02631578947368421,0.9736842105263158,38,1300,900,400,0.6923076923076923,17,9,8,350.7298875941601,0.46428994784257943,0.16560195237497077,0.1966903939414287,129643.02722318677,1493.9368730709905,131136.96409625775,81,0,35.68421052631579,35,3,19,36.46969826116602,0.61875,45.39930555555556,1018.402777777778,29.09722222222223,0
85,4,0,0,37,0.0,0.0,1.0,37,1300,800,500,0.6153846153846154,18,8,10,349.47291325251877,0.4623686186186186,0.07351821784312995,0.1903350501210062,128485.98082768629,1610.9162324719928,130096.89706015828,82,1,37.4054054054054,33,4,20,37.680179499576916,0.6114267676767677,46.53799019607842,1013.8480392156848,30.722667855020752,8
86,4,1,0,38,0.02631578947368421,0.0,1.0,38,1500,1000,500,0.6666666666666666,20,10,10,353.48711258727707,0.46362316263632053,0.058592547431199904,0.18690443509087146,127296.33012099189,1430.6139928189662,128726.94411381085,83,0,37.39473684210526,35,3,21,38.796139656688446,0.5949404761904762,47.71412037037037,1009.1435185185181,28.83267195767195,8
87,4,4,3,39,0.09523809523809523,0.07142857142857142,0.9285714285714286,42,450,200,250,0.4444444444444444,7,2,5,325.259643128298,0.4652172861014325,0.0785050043136073,0.17639306866939705,128315.61872260773,-44.37205334792279,128271.24666925981,84,0,34.73809523809524,36,6,23,38.46745211366751,0.6032986111111112,46.70608108108108,1013.1756756756756,28.143768768768766,0
88,4,1,2,38,0.025,0.05,0.95,40,950,700,250,0.7368421052631579,12,7,5,362.7294726010578,0.46461004273504275,0.1451134930643132,0.192345847385959,127413.15593117705,1310.276073413715,128723.43200459077,85,0,36.725,35,5,14,38.443028965569965,0.5961309523809524,47.598379629629626,1009.6064814814808,28.845899470899454,8
89,4,2,1,39,0.05,0.025,0.975,40,1150,900,250,0.782608695652174,14,9,5,362.2462450143492,0.4641292735042735,0.16158271322266726,0.1937673576362734,127763.9548637904,1256.4025795181842,129020.35744330857,86,0,36.9,35,5,17,38.095425491318444,0.5997023809523809,47.25115740740741,1010.9953703703712,28.885582010582034,0
90,4,1,4,36,0.025,0.1,0.9,40,1300,800,500,0.6153846153846154,18,8,10,358.1771071483003,0.4617387820512821,0.16738683127571985,0.19341563786008234,128144.53125000013,1179.687500000014,129324.21875000015,87,0,37.175,36,4,20,37.808641975308646,0.6015625,46.87500000000001,1012.500000000001,28.12500000000003,0
91,4,0,0,36,0.0,0.0,1.0,36,1150,700,450,0.6086956521739131,16,7,9,381.9040193044372,0.45787037037037037,0.18168814033953984,0.20479882204805203,127865.5013246107,2566.4697772491295,130431.97110185983,88,1,39.916666666666664,33,3,20,37.494320247182834,0.6051136363636364,47.150735294117645,1011.3970588235292,30.648395721925127,0
92,4,1,0,37,0.02702702702702703,0.0,1.0,37,1550,1000,550,0.6451612903225806,21,10,11,371.81738467846424,0.4570508008008008,0.1851415332601476,0.20190841200469248,128368.35048719526,2146.5251103468618,130514.87559754212,89,0,39.810810810810814,32,5,14,37.23419719245783,0.6126302083333333,46.65404040404041,1013.383838383839,31.66824494949497,0
93,4,1,0,38,0.02631578947368421,0.0,1.0,38,900,500,400,0.5555555555555556,13,5,8,362.5055427197834,0.45828888098624937,0.17879481311975565,0.19851494006083373,128703.50346020758,1731.1466743560104,130434.65013456359,90,0,39.73684210526316,33,5,15,37.127616747181946,0.6136363636363636,46.3235294117647,1014.7058823529409,30.74866310160427,0
94,4,0,1,37,0.0,0.02631578947368421,0.9736842105263158,38,750,300,450,0.4,12,3,9,365.37280611328475,0.45830369843527735,0.18459177643492963,0.2005555303536341,128796.78376405717,1811.7684604479093,130608.55222450508,91,1,40.73684210526316,33,5,16,36.959611050746496,0.6145833333333333,46.231617647058826,1015.0735294117653,30.759803921568647,0
95,4,0,0,37,0.0,0.0,1.0,37,1400,1100,300,0.7857142857142857,17,11,6,376.10698720711304,0.45748873873873874,0.18739052524349287,0.2063838955739237,128784.53290799407,2287.3525341801915,131071.88544217426,92,2,42.648648648648646,32,5,16,36.699734627026594,0.6168619791666667,46.24368686868687,1015.0252525252524,31.71953914141414,0
96,4,0,3,34,0.0,0.08108108108108109,0.9189189189189189,37,600,300,300,0.5,9,3,6,388.68575240945347,0.4572697697697698,0.15365979364521842,0.20526297624034803,127246.52364775547,2600.452509618063,129846.97615737353,93,3,43.648648648648646,33,4,19,37.95940625126523,0.598800505050505,47.76348039215685,1008.9460784313709,30.574123588829423,8
97,4,3,0,37,0.08108108108108109,0.0,1.0,37,1100,700,400,0.6363636363636364,15,7,8,368.2670004629664,0.46046046046046046,0.14064814156336825,0.19785014450195393,127939.53517500433,2023.1817719050096,129962.71694690935,94,0,40.54054054054054,35,2,18,37.763246958776634,0.6014880952380952,47.0775462962963,1011.6898148148152,28.905423280423292,0
98,4,2,1,38,0.05128205128205128,0.02564102564102564,0.9743589743589743,39,1200,900,300,0.75,15,9,6,353.46283343728146,0.4614260008996851,0.1566480160594541,0.19278817777726973,128543.91289515882,1287.2632346161713,129831.17612977499,95,0,39.41025641025641,36,3,14,37.51989635387748,0.6056134259259259,46.480855855855864,1014.0765765765777,28.168793793793824,0
99,4,0,1,37,0.0,0.02631578947368421,0.9736842105263158,38,1250,900,350,0.72,16,9,7,356.98714357998716,0.4606004030346136,0.14925893007278557,0.19505207770168365,128613.70991941006,1582.6881858710442,130196.3981052811,96,1,39.526315789473685,35,3,14,37.35927278259547,0.6083333333333334,46.41203703703703,1014.3518518518512,28.981481481481463,0
100,4,1,3,35,0.02631578947368421,0.07894736842105263,0.9210526315789473,38,1100,800,300,0.7272727272727273,14,8,6,353.45019565424894,0.46163762446657186,0.15051479588163263,0.19426473159643284,128848.62075617274,1508.3140432098642,130356.9347993826,97,0,40.23684210526316,35,3,15,37.20930232558139,0.6107142857142858,46.18055555555555,1015.2777777777769,29.007936507936485,0
101,4,0,0,35,0.0,0.0,1.0,35,1150,800,350,0.6956521739130435,15,8,7,382.7359729780449,0.4580532212885154,0.15741682974559734,0.20850541811490492,128496.33487654307,2836.0339506172686,131332.36882716033,98,1,43.142857142857146,32,3,15,36.82648401826484,0.6139322916666667,46.52777777777777,1013.8888888888878,31.684027777777743,0
102,4,0,1,34,0.0,0.02857142857142857,0.9714285714285714,35,1200,1000,200,0.8333333333333334,14,10,4,382.89152460903426,0.4575280112044818,0.15429744793194544,0.20951480054449387,128672.41753472216,2853.515624999994,131525.93315972216,99,2,44.142857142857146,33,2,17,36.642282683093775,0.6133207070707071,46.354166666666664,1014.5833333333328,30.74494949494948,0
103,4,0,2,32,0.0,0.058823529411764705,0.9411764705882353,34,1000,600,400,0.6,14,6,8,386.6861541167863,0.4562722816399287,0.143035326305625,0.21253201402960203,128848.62075617285,3164.7955246913602,132013.4162808642,100,3,44.05882352941177,32,2,18,36.36570907432741,0.6175130208333333,46.18055555555556,1015.2777777777778,31.727430555555557,0
104,4,1,1,32,0.030303030303030304,0.030303030303030304,0.9696969696969697,33,900,700,200,0.7777777777777778,11,7,4,388.1222539258051,0.4574258207070707,0.12785821663106245,0.21366648106264544,128912.7245466024,3406.7794421487592,132319.50398875115,101,0,43.60606060606061,32,1,19,36.263676488872306,0.6181640625,46.11742424242424,1015.5303030303032,31.735321969696976,0
105,4,0,1,31,0.0,0.03125,0.96875,32,1250,800,450,0.64,17,8,9,398.8849441157133,0.4566742271505377,0.13112179487179465,0.219724757351876,128936.76757812501,3886.1870659722226,132822.95464409725,102,1,42.8125,31,1,20,35.96581196581196,0.6209677419354839,46.09375,1015.6250000000001,32.76209677419355,0
106,4,1,1,31,0.03125,0.03125,0.96875,32,950,600,350,0.631578947368421,13,6,7,387.69626254793377,0.4558971774193548,0.12455985915492995,0.215356174288717,129267.58660210496,3623.5833062065926,132891.16990831154,103,0,42.78125,31,1,22,35.91175842936408,0.6243279569892473,45.768229166666664,1016.9270833333327,32.80409946236557,0
107,4,1,1,31,0.03125,0.03125,0.96875,32,700,400,300,0.5714285714285714,10,4,6,415.78172334866207,0.45713625672043007,0.09188420459068647,0.2252873363679988,128280.65609102187,4334.641712130036,132615.29780315192,104,0,41.5,30,2,21,36.21052806156297,0.6170138888888889,46.74059139784945,1013.0376344086004,33.76792114695335,8
108,4,4,1,34,0.11428571428571428,0.02857142857142857,0.9714285714285714,35,1200,1000,200,0.8333333333333334,14,10,4,379.2848993648564,0.45906862745098037,0.09718363032316524,0.2110608910583261,129338.07376575333,2821.0730648051867,132159.14683055851,105,0,38.8,30,5,23,36.05366895701198,0.6277777777777778,45.6989247311828,1017.2043010752693,33.90681003584231,0
109,4,1,4,31,0.02857142857142857,0.11428571428571428,0.8857142857142857,35,950,500,450,0.5263157894736842,14,5,9,376.88553733476647,0.458578431372549,0.09016019142601461,0.21129905286703982,129631.97708129868,2771.283467610663,132403.26054890934,106,0,39.65714285714286,31,4,17,35.815033243830726,0.6280241935483871,45.41015624999999,1018.3593749999989,32.850302419354804,0
110,4,2,0,33,0.06060606060606061,0.0,1.0,33,1050,900,150,0.8571428571428571,12,9,3,399.0501589680247,0.45714962121212116,0.10024328484186484,0.2220853620274935,129342.63117283958,3722.8395061728515,133065.47067901242,107,0,42.90909090909091,29,4,23,35.54637720735481,0.6307471264367817,45.69444444444445,1017.2222222222229,35.076628352490445,0
111,4,0,1,32,0.0,0.030303030303030304,0.9696969696969697,33,1150,800,350,0.6956521739130435,15,8,7,402.5898963189464,0.45679450757575757,0.09836594414184185,0.22465926659016924,129448.61352237665,3822.940779321005,133271.55430169764,108,1,43.90909090909091,29,4,17,35.34799940858014,0.6318247126436782,45.590277777777786,1017.6388888888897,35.09099616858241,0
112,4,1,3,30,0.030303030303030304,0.09090909090909091,0.9090909090909091,33,1100,900,200,0.8181818181818182,13,9,4,394.13651737587776,0.4568734217171717,0.0716298518316516,0.22133209942072635,129696.07445987655,3623.591820987652,133319.66628086418,107,0,41.60606060606061,29,4,18,35.31042632487955,0.6343390804597702,45.34722222222222,1018.6111111111112,35.12452107279694,0
113,4,0,0,30,0.0,0.0,1.0,30,1500,1200,300,0.8,18,12,6,417.4851268284584,0.4541906130268199,0.06468637206126204,0.23195880949151898,129277.04480229589,4794.2486890589535,134071.29349135485,108,1,44.43333333333333,27,3,23,35.144741976392545,0.6365740740740741,45.75892857142857,1016.9642857142854,37.665343915343904,0
114,4,0,0,30,0.0,0.0,1.0,30,750,600,150,0.8,9,6,3,418.85833009468877,0.4530172413793103,0.07492444184459357,0.2336177211409038,129428.42306193298,4842.43463010202,134270.857692035,109,2,45.43333333333333,27,3,20,34.95478697474894,0.6381172839506173,45.61011904761904,1017.5595238095227,37.687389770723065,0
115,4,1,1,30,0.03225806451612903,0.03225806451612903,0.967741935483871,31,350,200,150,0.5714285714285714,5,2,3,404.68094102923146,0.45412186379928315,0.07519114343121713,0.22786984377064226,129802.20148533944,4305.695408950607,134107.89689429005,110,0,44.935483870967744,29,2,21,34.93352755440462,0.6354166666666667,45.24305555555555,1019.0277777777771,35.138888888888864,0
116,4,0,1,29,0.0,0.03333333333333333,0.9666666666666667,30,750,600,150,0.8,9,6,3,415.4837759931249,0.4537835249042146,0.08783262811471548,0.23342155085509145,129713.14944180199,4778.741825208071,134491.89126701007,111,1,46.6,28,2,22,34.749353549600386,0.6376488095238095,45.330459770114935,1018.6781609195394,36.38136288998355,0
117,4,4,3,30,0.12121212121212122,0.09090909090909091,0.9090909090909091,33,1050,800,250,0.7619047619047619,13,8,5,369.60311659587205,0.4534801136363636,0.0681440090423544,0.21416728536993654,130915.14373048887,3079.651410543614,133994.7951410325,112,0,41.96969696969697,30,3,21,34.69704929515806,0.64375,44.1532258064516,1023.3870967741918,34.11290322580639,0
118,4,1,1,30,0.03225806451612903,0.03225806451612903,0.967741935483871,31,750,500,250,0.6666666666666666,10,5,5,391.1232330431791,0.4530017921146953,0.10148736959457638,0.2256090091411142,130739.70512947558,4027.0672314704866,134766.77236094608,113,0,45.03225806451613,28,3,23,34.32465814367331,0.6480654761904762,44.32471264367817,1022.7011494252881,36.52504105090315,0
119,4,0,1,29,0.0,0.03333333333333333,0.9666666666666667,30,800,400,400,0.5,12,4,8,392.1247346590103,0.4503591954022988,0.08154681139755726,0.2275558499556619,130972.46334876544,4271.50848765432,135243.97183641975,114,1,45.4,29,1,24,34.06264133876074,0.6472701149425287,44.09722222222222,1023.6111111111112,35.29693486590038,0
120,4,0,1,28,0.0,0.034482758620689655,0.9655172413793104,29,950,600,350,0.631578947368421,13,6,7,404.33013070171916,0.4482245484400657,0.08473763960361524,0.23434040040588677,130923.44441554377,4787.258678491226,135710.70309403498,115,2,47.06896551724138,28,1,24,33.800131030932654,0.6499255952380952,44.14511494252874,1023.4195402298859,36.550697865353065,0
121,4,0,0,28,0.0,0.0,1.0,28,800,600,200,0.75,10,6,4,407.6559777341717,0.4467041446208113,0.0587185758389801,0.23694588069606107,131033.74991742638,5083.338287752684,136117.08820517905,116,3,46.67857142857143,28,0,24,33.602886144634674,0.6510416666666667,44.037356321839084,1023.850574712644,36.566091954023,0
122,4,0,0,28,0.0,0.0,1.0,28,850,400,450,0.47058823529411764,13,4,9,408.55314858588315,0.4460703262786596,0.06435985812476197,0.238150073284445,131144.10186699044,5115.867147245358,136259.9690142358,117,4,47.67857142857143,28,0,24,33.46776078926451,0.6521577380952381,43.92959770114943,1024.281609195403,36.581486042692966,0
123,4,0,0,28,0.0,0.0,1.0,28,1000,500,500,0.5,15,5,10,406.6970915252767,0.44571208112874783,0.06534933098309414,0.2377511194064158,131254.50026423577,5076.164701413669,136330.66496564943,118,5,48.67857142857143,28,0,24,33.403147784632644,0.6532738095238095,43.821839080459775,1024.7126436781614,36.59688013136291,0
124,4,2,2,28,0.06666666666666667,0.06666666666666667,0.9333333333333333,30,1100,600,500,0.5454545454545454,16,6,10,387.62105720619985,0.4452825670498084,0.06258120776106346,0.2309713937912237,131983.34209518452,4231.9045193086,136215.2466144931,119,0,46.36666666666667,30,0,21,33.15402223675605,0.6545138888888888,43.11155913978495,1027.553763440861,34.25179211469537,0
125,4,0,0,28,0.0,0.0,1.0,28,500,400,100,0.8,6,4,2,400.3216389876596,0.44072420634920634,0.04653104068779346,0.2369758169483704,131733.4300477277,4947.148525234525,136680.57857296223,120,1,47.035714285714285,28,0,21,33.08082575227431,0.6581101190476191,43.35488505747127,1026.580459770116,36.663587848932714,0
126,4,0,1,27,0.0,0.03571428571428571,0.9642857142857143,28,500,300,200,0.6,7,3,4,400.4095460801611,0.4402557319223986,0.05043780736475889,0.23725759670720012,131770.30692627837,4952.41775663894,136722.7246829173,121,2,48.035714285714285,28,0,21,33.04121186677861,0.6584821428571428,43.31896551724139,1026.7241379310356,36.6687192118227,0
127,4,0,0,27,0.0,0.0,1.0,27,1150,900,250,0.782608695652174,14,9,5,407.0600088439828,0.4389245014245014,0.03487354581716051,0.241056394936879,131747.9167773882,5325.861633716,137073.7784111042,122,3,48.333333333333336,27,0,22,32.89320312122528,0.6616512345679013,43.34077380952382,1026.636904761906,38.02358906525578,0
128,4,0,0,27,0.0,0.0,1.0,27,900,500,400,0.5555555555555556,13,5,8,406.9549761570708,0.4388651471984805,0.032754864397866124,0.24172144969329665,131862.52170138908,5332.421875000024,137194.9435763891,123,4,49.333333333333336,27,0,23,32.77974983096687,0.6628086419753086,43.22916666666668,1027.0833333333348,38.04012345679018,0
129,4,0,1,26,0.0,0.037037037037037035,0.962962962962963,27,650,400,250,0.6153846153846154,9,4,5,420.127309335123,0.4383309591642925,0.020021776932702684,0.23410027823343407,129390.57019292086,5472.102421697836,134862.6726146187,124,5,50.333333333333336,27,0,21,34.961270781531866,0.6377314814814814,45.64732142857142,1017.4107142857138,37.68187830687829,8
130,4,0,0,26,0.0,0.0,1.0,26,750,500,250,0.6666666666666666,10,5,5,430.008728333771,0.4370833333333333,0.02820279401981729,0.2391719433289353,129319.08543381338,5921.667095336069,135240.75252914944,125,6,52.80769230769231,26,0,21,34.78322712790169,0.640625,45.71759259259259,1017.1296296296291,39.12037037037035,0
131,4,1,0,27,0.037037037037037035,0.0,1.0,27,850,700,150,0.8235294117647058,10,7,3,414.555856406673,0.43779677113010446,0.027561439944617572,0.23346040334481055,129807.25623582762,5362.471655328787,135169.7278911564,126,0,51.81481481481482,27,0,20,34.676791277258566,0.6419753086419753,45.238095238095234,1019.0476190476187,37.74250440917106,0
132,4,0,0,27,0.0,0.0,1.0,27,1100,1000,100,0.9090909090909091,12,10,2,413.23023791486355,0.43720322886989554,0.030269615792090754,0.23361828301919504,129958.94451530612,5340.593112244898,135299.53762755104,127,1,52.81481481481482,27,0,20,34.55560420315237,0.6435185185185186,45.089285714285715,1019.6428571428572,37.764550264550266,0
133,4,1,0,28,0.03571428571428571,0.0,1.0,28,650,300,350,0.46153846153846156,10,3,7,400.8980173892048,0.43761022927689597,0.02565236620964173,0.2286341341547101,130299.25724996686,4847.34277975953,135146.6000297264,128,0,51.892857142857146,28,0,21,34.523055633736746,0.6436011904761905,44.75574712643677,1020.977011494252,36.463464696223284,0
134,4,0,0,28,0.0,0.0,1.0,28,950,700,250,0.7368421052631579,12,7,5,400.85515259335875,0.43681106701940037,0.021999276570946247,0.2292581882370222,130409.29954832203,4855.047934007124,135264.34748232915,129,1,52.892857142857146,28,0,21,34.41207155249215,0.6447172619047619,44.64798850574712,1021.4080459770109,36.47885878489325,0
135,4,0,1,27,0.0,0.03571428571428571,0.9642857142857143,28,900,700,200,0.7777777777777778,11,7,4,401.2235876404245,0.43559854497354494,-0.02460723939597176,0.21316708975998033,127490.73368757416,4630.457912207669,132121.19159978183,130,2,53.892857142857146,28,0,21,37.39152084222509,0.6149553571428572,47.52155172413792,1009.9137931034469,36.068349753694534,8
136,4,3,1,29,0.1,0.03333333333333333,0.9666666666666667,30,750,500,250,0.6666666666666666,10,5,5,378.0716813598917,0.4397030651340996,0.005207780725021927,0.2053789969346957,128382.79714417821,3707.5799947970445,132090.37713897525,131,0,51.13333333333333,30,0,18,37.06095269672854,0.6180555555555556,46.63978494623654,1013.4408602150513,33.781362007168376,0
137,4,1,0,30,0.03333333333333333,0.0,1.0,30,1050,500,550,0.47619047619047616,16,5,11,375.7728286739466,0.4360632183908046,0.018349677533350928,0.2051795777983793,128587.20119377963,3663.9152647704936,132251.11645855012,132,0,52.1,30,0,20,36.91000750949732,0.6201388888888889,46.43817204301075,1014.247311827957,33.808243727598565,0
138,4,0,0,30,0.0,0.0,1.0,30,1050,700,350,0.6666666666666666,14,7,7,376.2673566948816,0.43448275862068964,0.024362030905076715,0.20615519180307382,128723.56088854208,3686.8947999768793,132410.45568851897,133,1,53.1,30,0,21,36.7580022075055,0.6215277777777778,46.303763440860216,1014.7849462365596,33.826164874551985,0
139,4,0,0,30,0.0,0.0,1.0,30,1000,700,300,0.7,13,7,6,376.91799697022134,0.4341475095785441,0.02982084546818431,0.2072226018277332,128859.99284599391,3713.9300786218264,132573.92292461573,134,2,54.1,30,0,22,36.602021004324406,0.6229166666666667,46.16935483870969,1015.3225806451626,33.84408602150542,0
140,4,2,0,32,0.0625,0.0,1.0,32,1100,700,400,0.6363636363636364,15,7,8,396.7493060567836,0.43724798387096775,0.007923329894248266,0.21042367436144352,127420.45932345936,3734.208874146191,131154.66819760556,135,0,51.65625,31,1,18,37.576842060012034,0.605510752688172,47.59114583333334,1009.635416666668,32.568884408602194,8
141,4,1,1,32,0.030303030303030304,0.030303030303030304,0.9696969696969697,33,800,500,300,0.625,11,5,6,385.5210723342589,0.43919665404040403,0.019064269064269057,0.20636716224951526,127793.20987654333,3253.395061728409,131046.60493827175,136,0,51.06060606060606,32,1,19,37.47710622710622,0.6067708333333333,47.22222222222223,1011.1111111111121,31.597222222222253,0
142,4,0,1,31,0.0,0.03125,0.96875,32,750,500,250,0.6666666666666666,10,5,5,391.4882148627854,0.4392641129032258,0.03299661944623278,0.20950420319845145,127782.2388543024,3605.0481160481872,131387.2869703506,137,1,52.90625,31,1,19,37.33754561064605,0.6092069892473118,47.23307291666667,1011.0677083333342,32.61508736559143,0
143,4,2,1,32,0.06060606060606061,0.030303030303030304,0.9696969696969697,33,1050,400,650,0.38095238095238093,17,4,13,377.32986244560027,0.43986742424242425,0.03147497070148986,0.20493777525569495,128375.34798516174,3088.4833441840374,131463.8313293458,138,0,51.90909090909091,31,2,16,37.08737526232388,0.615255376344086,46.64713541666667,1013.4114583333339,32.690692204301094,0
144,4,0,1,31,0.0,0.03125,0.96875,32,1050,600,450,0.5714285714285714,15,6,9,388.37599354396326,0.43869707661290325,0.029152016717526763,0.21043780469740125,128280.6560910221,3564.2254523644374,131844.88154338655,139,1,54.53125,30,2,22,36.904603953827795,0.6170138888888889,46.740591397849464,1013.0376344086023,33.76792114695341,0
145,4,0,1,30,0.0,0.03225806451612903,0.967741935483871,31,1200,700,500,0.5833333333333334,17,7,10,398.88115768661066,0.43803763440860216,0.08963934309556443,0.20840678354058362,126812.07561728399,3931.7827366041142,130743.8583538881,140,2,56.25806451612903,29,2,19,38.15039529325245,0.6048850574712643,48.19444444444445,1007.2222222222226,34.73180076628354,8
146,4,1,1,30,0.03225806451612903,0.03225806451612903,0.967741935483871,31,550,100,450,0.18181818181818182,10,1,9,386.7136782942872,0.4396057347670251,0.058118688008667485,0.20361492829768688,127125.8983155568,3632.264748814907,130758.1630643717,141,0,54.38709677419355,30,1,20,38.13335776800388,0.6052083333333333,47.88306451612904,1008.4677419354846,33.615591397849485,0
147,4,0,0,30,0.0,0.0,1.0,30,1000,600,400,0.6,14,6,8,410.4004292756546,0.4385536398467433,0.06899763659112979,0.20400900399307445,124757.06259645076,4240.0704089506335,128997.1330054014,142,1,56.9,29,1,20,39.993019834097964,0.5836925287356323,50.243055555555564,999.027777777779,34.449233716475135,8
148,4,5,2,33,0.14285714285714285,0.05714285714285714,0.9428571428571428,35,1050,700,350,0.6666666666666666,14,7,7,362.74662098659013,0.45245098039215687,0.07829970406241604,0.1877372863000777,126424.48992768614,2178.8496550097184,128603.33958269586,143,0,49.628571428571426,32,3,20,39.45935342121782,0.5927734375,48.57954545454547,1005.6818181818197,31.427556818181866,0
149,4,4,1,36,0.10810810810810811,0.02702702702702703,0.972972972972973,37,1000,700,300,0.7,13,7,6,347.1568168713772,0.45264014014014015,0.0933127558894431,0.18344770447642114,127272.13718820876,1436.678004535168,128708.81519274392,144,0,47.78378378378378,34,3,23,38.98065125058991,0.5968137254901961,47.73809523809525,1009.0476190476202,29.677871148459417,0
150,4,3,1,38,0.07692307692307693,0.02564102564102564,0.9743589743589743,39,950,900,50,0.9473684210526315,10,9,1,331.5696436540661,0.4578553756185335,0.10632661334064153,0.1779067227778272,127888.11404309743,680.7632801720943,128568.87732326952,145,0,46.256410256410255,36,3,21,38.7439230312477,0.5989583333333333,47.12837837837839,1011.4864864864887,28.09684684684691,0
151,4,3,3,38,0.07317073170731707,0.07317073170731707,0.926829268292683,41,900,500,400,0.5555555555555556,13,5,8,316.86531520138055,0.4632876016260163,0.11725155226235784,0.1721802532866764,128394.4473900626,-62.9937891176111,128331.453600945,146,0,44.90243902439025,37,4,17,38.59981878178082,0.6021959459459459,46.62828947368423,1013.4868421052654,27.391536273115282,0
152,4,1,0,39,0.02564102564102564,0.0,1.0,39,1650,1300,350,0.7878787878787878,20,13,7,334.4576860868606,0.4609480431848853,0.1106532530861486,0.18153608441974342,128349.69142500425,785.5081607938937,129135.19958579814,147,0,47.717948717948715,35,4,27,38.199719208071606,0.6056547619047619,46.6724537037037,1013.3101851851849,28.95171957671957,0
153,4,0,1,38,0.0,0.02564102564102564,0.9743589743589743,39,1300,900,400,0.6923076923076923,17,9,8,335.41877426678997,0.46047008547008544,0.10950866899713674,0.18245947981543742,128437.66744898818,816.0809970850283,129253.74844607321,148,1,48.717948717948715,35,4,20,38.08565502017202,0.6065476190476191,46.58564814814814,1013.6574074074061,28.961640211640177,0
154,4,1,1,38,0.02564102564102564,0.02564102564102564,0.9743589743589743,39,1200,800,400,0.6666666666666666,16,8,8,340.1303413039145,0.45987966711650924,0.11400236956426357,0.1859789420791519,128643.06205257599,951.0817204646401,129594.14377304063,149,0,49.666666666666664,35,4,21,37.756821639094895,0.6086309523809523,46.38310185185183,1014.4675925925901,28.98478835978829,0
155,4,0,3,35,0.0,0.07894736842105263,0.9210526315789473,38,1250,1000,250,0.8,15,10,5,345.69278316662485,0.4593853722143196,0.10977778875727284,0.1890881834496772,128657.32001133752,1295.1814058956502,129952.50141723317,150,1,50.76315789473684,34,4,21,37.60120863647032,0.610906862745098,46.3690476190476,1014.5238095238067,29.83893557422961,0
156,4,2,0,37,0.05405405405405406,0.0,1.0,37,1400,1000,400,0.7142857142857143,18,10,8,370.89249287464156,0.4592092092092092,0.11976080358433361,0.19816256047873687,127717.31190650095,2075.0263984337216,129792.33830493467,151,0,51.513513513513516,36,1,17,37.92474376114082,0.5972222222222222,47.29729729729729,1010.8108108108097,28.078078078078047,8
157,4,4,5,36,0.0975609756097561,0.12195121951219512,0.8780487804878049,41,1300,700,600,0.5384615384615384,19,7,12,338.9678545322217,0.46222052845528455,0.1266648574447291,0.18600032183786464,128783.6897530971,532.846222957771,129316.53597605487,152,0,47.390243902439025,37,4,15,37.64302239746499,0.6061373873873874,46.24451754385965,1015.0219298245613,27.43302513039355,0
158,4,0,2,34,0.0,0.05555555555555555,0.9444444444444444,36,1050,900,150,0.8571428571428571,12,9,3,374.79717414762763,0.4542162698412699,0.15109860556429644,0.20254735447886524,128175.55334787109,2407.967037918122,130583.5203857892,153,1,54.361111111111114,33,3,21,37.35616099883014,0.608270202020202,46.844362745098046,1012.6225490196084,30.685531788472982,0
159,4,1,0,35,0.02857142857142857,0.0,1.0,35,900,600,300,0.6666666666666666,12,6,6,382.03000835212515,0.4544467787114846,0.15702532321829255,0.20679114217279,128240.42986685033,2798.338498622591,131038.76836547292,154,0,56.2,32,3,23,37.106550735477434,0.611328125,46.78030303030303,1012.878787878788,31.652462121212125,0
160,4,1,1,35,0.027777777777777776,0.027777777777777776,0.9722222222222222,36,750,600,150,0.8,9,6,3,370.129020031197,0.45398478835978834,0.15372399102286116,0.20208352663759369,128584.36113522376,2318.560715663579,130902.92185088735,155,0,55.611111111111114,35,1,18,37.05601677507703,0.6080357142857142,46.44097222222222,1014.2361111111111,28.9781746031746,0
161,4,0,0,35,0.0,0.0,1.0,35,1100,800,300,0.7272727272727273,14,8,6,376.5882626578491,0.4513655462184874,0.16070170730889233,0.20536356090394092,128536.57171201808,2681.07284580498,131217.64455782305,156,1,58.17142857142857,34,1,19,36.94113446035844,0.6096813725490196,46.488095238095234,1014.0476190476186,29.82492997198878,0
162,4,1,0,36,0.027777777777777776,0.0,1.0,36,1050,800,250,0.7619047619047619,13,8,5,372.4181459566073,0.45176917989417986,0.1696581196581195,0.20514558887440254,128936.76757812512,2403.6783854166815,131340.4459635418,157,0,57.52777777777778,35,1,20,36.63782051282052,0.6116071428571428,46.09375000000001,1015.6250000000009,29.017857142857167,0
163,4,1,1,36,0.02702702702702703,0.02702702702702703,0.972972972972973,37,1000,700,300,0.7,13,7,6,350.50240927678834,0.4533596096096096,0.1733993351640417,0.18726843009931238,127717.31190650094,1553.316373277825,129270.62827977876,158,0,56.945945945945944,36,1,17,38.440006684491976,0.5972222222222222,47.29729729729729,1010.8108108108096,28.078078078078043,8
164,4,1,1,36,0.02702702702702703,0.02702702702702703,0.972972972972973,37,850,700,150,0.8235294117647058,10,7,3,351.2021767796952,0.4543606106106106,0.17911121272652908,0.18870815527444845,127945.07345183,1586.9176609041228,129531.99111273412,159,0,57.5945945945946,36,1,18,38.18918818640548,0.599537037037037,47.07207207207206,1011.71171171171,28.103103103103056,0
165,4,1,1,36,0.02702702702702703,0.02702702702702703,0.972972972972973,37,1350,900,450,0.6666666666666666,18,9,9,349.03215973174827,0.45523648648648646,0.18106995884773647,0.18847736625514377,128144.53124999977,1545.4678496063327,129689.9990996061,160,0,58.351351351351354,35,2,19,38.040123456790106,0.6035714285714286,46.874999999999986,1012.4999999999982,28.928571428571377,0
166,4,0,0,36,0.0,0.0,1.0,36,1150,700,450,0.6086956521739131,16,7,9,354.8872124632367,0.45515873015873015,0.17971820541342298,0.1915027635080728,128116.02776763224,1893.3479932635087,130009.37576089575,161,1,57.47222222222222,36,0,19,37.921069707081955,0.6012731481481481,46.90315315315314,1012.3873873873854,28.121871871871818,0
167,4,2,1,37,0.05263157894736842,0.02631578947368421,0.9736842105263158,38,1450,900,550,0.6206896551724138,20,9,11,344.81967877064534,0.4566885964912281,0.18555391363771712,0.18888572190895356,128715.26668137734,1276.717722790361,129991.9844041677,162,0,55.39473684210526,36,2,17,37.56427329560166,0.607349537037037,46.31193693693694,1014.7522522522524,28.18756256256257,0
168,4,0,1,36,0.0,0.02702702702702703,0.972972972972973,37,1250,900,350,0.72,16,9,7,387.33247359810196,0.45426676676676675,0.24758115156408156,0.19875527659815015,126073.72448979595,2367.405758109188,128441.13024790514,163,1,57.891891891891895,34,3,17,39.20375968073337,0.5845588235294117,48.92857142857143,1004.2857142857146,29.53781512605043,8
169,4,2,1,37,0.05263157894736842,0.02631578947368421,0.9736842105263158,38,1200,800,400,0.6666666666666666,16,8,8,384.80882404982714,0.4563033428165007,0.2558090947077729,0.1994259683850359,126480.04979263137,2134.1278452932265,128614.1776379246,164,0,57.28947368421053,35,3,17,38.8472989299275,0.5866071428571429,48.524305555555564,1005.9027777777794,28.740079365079414,0
170,4,0,1,36,0.0,0.02702702702702703,0.972972972972973,37,1300,900,400,0.6923076923076923,17,9,8,393.41693495115146,0.45561186186186187,0.2644341986120129,0.20350231779132755,126402.72285997742,2545.794359410441,128948.51721938787,165,1,59.83783783783784,34,3,17,38.710735566867925,0.5879289215686274,48.60119047619048,1005.5952380952389,29.576330532212907,0
171,4,1,0,37,0.02702702702702703,0.0,1.0,37,950,500,450,0.5263157894736842,14,5,9,395.88910139728887,0.45830205205205204,0.2648418468148772,0.20583311581873806,126612.30867346944,2624.8866213151978,129237.19529478463,166,0,58.86486486486486,34,3,18,38.43200457377178,0.5900735294117647,48.392857142857146,1006.4285714285718,29.600840336134464,0
172,4,2,1,38,0.05128205128205128,0.02564102564102564,0.9743589743589743,39,1250,1000,250,0.8,15,10,5,378.78726586341355,0.4614260008996851,0.25779356326136393,0.19957869385761154,127153.80652873889,1835.5696322646636,128989.37616100356,167,0,56.794871794871796,33,6,20,38.3044754961523,0.5978535353535354,47.85539215686274,1008.5784313725485,30.562982768865105,0
173,4,1,2,37,0.02564102564102564,0.05128205128205128,0.9487179487179487,39,1250,900,350,0.72,16,9,7,370.5180906611027,0.4619883040935673,0.26134575362988643,0.19769503907115638,127662.84190759622,1660.2784863945399,129323.12039399076,168,0,56.97435897435897,34,5,19,37.990095024934234,0.600796568627451,47.35119047619047,1010.5952380952368,29.72338935574226,0
174,4,1,0,38,0.02631578947368421,0.0,1.0,38,1300,1000,300,0.7692307692307693,16,10,6,369.91518817107317,0.4617117117117117,0.24566255582465635,0.1985577608268862,127903.57320011329,1862.6948696145027,129766.26806972778,169,0,57.421052631578945,34,4,20,37.75842454199521,0.6032475490196079,47.113095238095234,1011.5476190476184,29.75140056022407,0
175,4,0,2,36,0.0,0.05263157894736842,0.9473684210526316,38,1250,800,450,0.64,17,8,9,370.03166861420164,0.46073376007586536,0.24290664933939787,0.19981710105166897,128144.53125,1883.506944444444,130028.03819444444,170,1,58.421052631578945,34,4,20,37.50857338820301,0.6056985294117647,46.875,1012.5,29.779411764705884,0
176,4,1,3,34,0.02702702702702703,0.08108108108108109,0.9189189189189189,37,1200,1100,100,0.9166666666666666,13,11,2,363.12893008374544,0.46296296296296297,0.2145991618473917,0.19753311612878513,128437.66744898827,1927.8865526405966,130365.55400162887,171,0,55.945945945945944,35,2,16,37.383439902565264,0.6065476190476191,46.585648148148145,1013.6574074074069,28.961640211640198,0
177,4,0,0,34,0.0,0.0,1.0,34,900,700,200,0.7777777777777778,11,7,4,384.35852845207785,0.46117424242424243,0.20746741810496672,0.2070576588757969,128048.66850321404,3043.3195592286625,131091.9880624427,172,3,58.529411764705884,32,2,20,37.24426147704591,0.609375,46.969696969696976,1012.1212121212127,31.628787878787897,0
178,4,2,1,35,0.05555555555555555,0.027777777777777776,0.9722222222222222,36,1150,800,350,0.6956521739130435,15,8,7,368.95931579131826,0.4613095238095238,0.2166119321291733,0.20242903001523696,128778.12500000013,2302.7777777777915,131080.90277777793,173,0,56.22222222222222,34,2,18,36.88765736179529,0.6121323529411764,46.25000000000001,1015.000000000001,29.85294117647062,0
179,4,0,0,35,0.0,0.0,1.0,35,1200,800,400,0.6666666666666666,16,8,8,376.975878757046,0.45920868347338933,0.22630889149479216,0.2070867493118947,128827.88470780481,2713.0010092272373,131540.88571703204,174,1,58.82857142857143,33,2,18,36.633369547722516,0.6148989898989898,46.20098039215687,1015.1960784313736,30.763517528223442,0
180,4,0,2,33,0.0,0.05714285714285714,0.9428571428571428,35,1000,700,300,0.7,13,7,6,375.95137659132644,0.4583333333333333,0.22298810959848292,0.20749912862464043,129014.56921616696,2700.640979430999,131715.21019559796,175,2,59.82857142857143,33,2,19,36.46863691194209,0.6167929292929293,46.017156862745104,1015.9313725490205,30.785799168152135,0
181,4,2,0,35,0.05714285714285714,0.0,1.0,35,1100,700,400,0.6363636363636364,15,7,8,375.58699355259057,0.4548669467787115,0.23253796095444645,0.20860916147920996,129263.69214965403,2709.952301999233,131973.64445165326,176,0,60.371428571428574,33,2,21,36.223588013175856,0.6193181818181819,45.77205882352941,1016.9117647058828,30.815508021390386,0
182,4,1,1,35,0.027777777777777776,0.027777777777777776,0.9722222222222222,36,950,800,150,0.8421052631578947,11,8,3,371.8113350271357,0.4553736772486772,0.2458393374096144,0.20922637846793252,129776.92920918361,2450.506660997725,132227.43587018133,177,0,59.666666666666664,34,2,19,35.7966273318534,0.6222426470588236,45.26785714285714,1018.9285714285709,29.968487394957968,0
183,4,0,1,34,0.0,0.02857142857142857,0.9714285714285714,35,800,300,500,0.375,13,3,10,381.10412719920043,0.4542016806722689,0.24294478527607377,0.21420680252920565,129731.44531249988,2888.2378472222076,132619.6831597221,178,1,62.34285714285714,33,2,19,35.60625426039536,0.6240530303030303,45.31249999999999,1018.7499999999991,30.871212121212093,0
184,4,0,0,34,0.0,0.0,1.0,34,1250,1000,250,0.8,15,10,5,381.42059614600936,0.45417409387997626,0.22588366450259056,0.21517878914652228,129876.19447314051,3107.491104224061,132983.68557736458,179,2,62.411764705882355,32,2,19,35.450730831165615,0.6279296875,45.17045454545455,1019.318181818182,31.853693181818187,0
185,4,0,0,34,0.0,0.0,1.0,34,1500,1000,500,0.6666666666666666,20,10,10,380.559444184686,0.45361705288175874,0.22778186426235747,0.21540144573789125,130004.92814827563,3094.9206394755583,133099.8487877512,180,3,63.411764705882355,32,2,19,35.341607857702954,0.6292317708333333,45.04419191919192,1019.8232323232319,31.869476010100996,0
186,4,0,0,34,0.0,0.0,1.0,34,850,500,350,0.5882352941176471,12,5,7,381.16819305900714,0.4529300356506239,0.22018428752347297,0.2166386312449293,130165.93491735532,3123.0228420569256,133288.95775941224,181,4,64.41176470588235,32,2,19,35.16224325661964,0.630859375,44.88636363636363,1020.454545454545,31.889204545454533,0
187,4,0,0,34,0.0,0.0,1.0,34,900,600,300,0.6666666666666666,12,6,6,384.5175249357603,0.4521130421865716,0.221734172562023,0.21927286640154892,130295.81917656798,3220.2410499145444,133516.0602264825,182,5,65.41176470588235,31,3,19,34.94465523105047,0.634744623655914,44.759114583333336,1020.9635416666671,32.934307795698935,0
188,4,0,0,34,0.0,0.0,1.0,34,1000,600,400,0.6,14,6,8,370.5772249728293,0.4519644979203803,0.17865223012281817,0.19836780866192638,127793.20987654332,2671.4506172839638,130464.66049382728,183,6,66.41176470588235,32,2,19,37.85485347985349,0.6067708333333333,47.22222222222223,1011.111111111112,31.59722222222225,8
189,4,1,0,35,0.02857142857142857,0.0,1.0,35,900,600,300,0.6666666666666666,12,6,6,359.6119153196742,0.45276610644257703,0.18157796335535292,0.19481204568600607,128272.40404359267,2226.1392332415285,130498.5432768342,184,0,65.48571428571428,32,3,20,37.641520212721765,0.6116536458333333,46.748737373737384,1013.0050505050519,31.656407828282873,0
190,4,2,1,36,0.05405405405405406,0.02702702702702703,0.972972972972973,37,1050,600,450,0.5714285714285714,15,6,9,341.8895775073858,0.45461086086086083,0.1643035440503795,0.18843681364941944,128959.43877551016,1417.9776077097463,130377.41638321991,185,0,62.891891891891895,34,3,19,37.389875371151746,0.6139705882352942,46.07142857142857,1015.7142857142853,29.873949579831923,0
191,4,0,1,35,0.0,0.027777777777777776,0.9722222222222222,36,1200,1000,200,0.8333333333333334,14,10,4,350.0472177882282,0.45433201058201056,0.16523924406915924,0.19320182659550034,129014.56921616699,1832.2382016532224,130846.80741782021,186,1,64.72222222222223,33,3,19,37.12655810213107,0.6167929292929293,46.017156862745104,1015.9313725490207,30.785799168152142,0
192,4,1,1,35,0.027777777777777776,0.027777777777777776,0.9722222222222222,36,950,500,450,0.5263157894736842,14,5,9,341.4542583382655,0.4554398148148148,0.14808649062380397,0.1793767545311395,127033.66796339165,1475.2373756858728,128508.90533907752,187,0,61.833333333333336,35,1,21,39.369020283199376,0.5922619047619048,47.97453703703704,1008.101851851852,28.802910052910057,8
193,4,2,1,36,0.05405405405405406,0.02702702702702703,0.972972972972973,37,900,400,500,0.4444444444444444,14,4,10,334.3626441852107,0.45630005005005003,0.15493711533315513,0.17774014243529623,127512.49999999999,1127.1101251714679,128639.61012517146,188,0,61.054054054054056,34,3,15,39.05734323432344,0.5992647058823529,47.5,1009.9999999999999,29.705882352941174,0
194,4,0,1,35,0.0,0.027777777777777776,0.9722222222222222,36,500,200,300,0.4,8,2,6,354.5273554410051,0.4546130952380953,0.1319460834447852,0.18706505666295656,127212.0819161,1820.0325963719054,129032.1145124719,189,1,63.75,34,2,18,38.85635473212176,0.5962009803921569,47.79761904761906,1008.8095238095257,29.670868347338992,6
195,4,2,0,37,0.05405405405405406,0.0,1.0,37,1150,800,350,0.6956521739130435,15,8,7,335.3109295141758,0.4568943943943944,0.10577284778375873,0.17978671390846698,127859.63909433121,1174.546886413477,129034.18598074469,190,0,57.91891891891892,36,1,17,38.67841368815645,0.5986689814814814,47.15653153153155,1011.3738738738771,28.093718718718808,0
196,4,2,2,37,0.05128205128205128,0.05128205128205128,0.9487179487179487,39,1450,1000,450,0.6896551724137931,19,10,9,322.5876097211179,0.4586988304093567,0.10840082038311527,0.17561869355385534,128469.25593770595,488.5180391190511,128957.773976825,191,0,55.8974358974359,38,1,14,38.378648961955946,0.6011513157894737,46.554487179487204,1013.7820512820554,26.678475033738298,0
197,4,1,0,38,0.02631578947368421,0.0,1.0,38,1100,700,400,0.6363636363636364,15,7,8,331.3715637384606,0.45972617354196305,0.10191677290111034,0.18069128664229303,128533.3948907359,918.462411511264,129451.85730224717,192,0,57.63157894736842,37,1,15,38.09066825259517,0.6036036036036037,46.49122807017545,1014.0350877193006,27.40635372214326,0
198,4,0,1,37,0.0,0.02631578947368421,0.9736842105263158,38,1200,800,400,0.6666666666666666,16,8,8,336.0724020569719,0.4596817211948791,0.10667633427165901,0.1841533499726038,128728.04763244475,1052.3888359880104,129780.43646843276,193,1,58.63157894736842,37,1,15,37.77316315505133,0.6055743243243243,46.299342105263165,1014.8026315789486,27.427098150782395,0
199,4,1,0,38,0.02631578947368421,0.0,1.0,38,850,600,250,0.7058823529411765,11,6,5,339.3031508063377,0.45876303935514456,0.11769084771960148,0.18683863155578476,128922.8476550477,1148.785684056632,130071.63333910434,194,0,59.526315789473685,37,1,16,37.492802130569345,0.607545045045045,46.10745614035088,1015.5701754385965,27.447842579421525,0
200,4,2,1,39,0.05,0.025,0.975,40,1400,1300,100,0.9285714285714286,15,13,2,326.78289513454297,0.46116452991452994,0.12789180059371463,0.18231536850767285,129439.78000217021,459.7412109375048,129899.52121310771,195,0,57.5,39,1,15,37.285567441225616,0.6092414529914529,45.598958333333336,1017.6041666666673,26.092414529914546,0
201,4,1,0,40,0.025,0.0,1.0,40,1500,1200,300,0.8,18,12,6,321.3614012323308,0.46151175213675216,0.1320800531642976,0.18074961848495857,129757.97661675356,339.84103732639454,130097.81765407995,196,0,57.75,39,1,16,37.100948267048345,0.6124465811965811,45.286458333333336,1018.8541666666673,26.124465811965827,0
202,4,1,2,39,0.024390243902439025,0.04878048780487805,0.9512195121951219,41,1150,600,550,0.5217391304347826,17,6,11,318.8768459161996,0.461280487804878,0.1429782973728908,0.18072088664375455,130055.18297846832,94.31730864562726,130149.50028711394,197,0,57.31707317073171,40,1,17,36.86339709740626,0.6138020833333333,44.99491869918698,1020.0203252032506,25.500508130081265,0
203,4,0,1,38,0.0,0.02564102564102564,0.9743589743589743,39,850,400,450,0.47058823529411764,13,4,9,333.66559867093866,0.45836144849302746,0.14205773262377064,0.18813060350595479,129853.9201183432,865.5571992110471,130719.47731755425,198,1,60.794871794871796,38,1,17,36.69025157232705,0.6151315789473684,45.19230769230769,1019.2307692307693,26.82186234817814,0
204,4,0,1,37,0.0,0.02631578947368421,0.9736842105263158,38,1250,900,350,0.72,16,9,7,342.2585103136915,0.45739983404457085,0.14753374399855024,0.19306038300218922,129871.1141889813,1289.8988150200162,131161.01300400132,199,2,63.10526315789474,37,1,18,36.45385111876076,0.6171171171171171,45.17543859649123,1019.2982456140357,27.548601232811777,0
205,4,0,1,36,0.0,0.02702702702702703,0.972972972972973,37,1050,500,550,0.47619047619047616,16,5,11,348.43240869418673,0.45482982982982983,0.14579426974477783,0.19663405009350274,129889.23890106347,1651.5240747504567,131540.7629758139,200,3,65.56756756756756,36,1,18,36.27812453969658,0.619212962962963,45.15765765765767,1019.3693693693713,28.315815815815867,0
206,4,0,0,36,0.0,0.0,1.0,36,1150,800,350,0.6956521739130435,15,8,7,355.5227227167773,0.45388558201058204,0.14358159249167457,0.2007335988262419,129908.3719135802,2037.0756172839447,131945.44753086413,201,4,63.166666666666664,35,1,19,36.07799727520436,0.6214285714285714,45.138888888888886,1019.444444444444,29.126984126984116,0
207,4,1,0,37,0.02702702702702703,0.0,1.0,37,1300,900,400,0.6923076923076923,17,9,8,348.08368998744857,0.4544544544544544,0.14155110855254338,0.19774208871324594,130147.65346004802,1660.4550919162564,131808.10855196428,202,0,62.432432432432435,36,1,20,36.02481330243168,0.6218171296296297,44.90427927927929,1020.3828828828839,28.343968968968998,0
208,4,0,0,37,0.0,0.0,1.0,37,950,700,250,0.7368421052631579,12,7,5,346.38319430824436,0.4542042042042042,0.09015112378286827,0.1876280133782403,128268.64216887731,1569.928210644241,129838.57037952155,203,1,63.432432432432435,33,4,24,37.98038148237762,0.6092171717171717,46.752450980392155,1012.990196078431,30.696672608437304,8
209,4,1,2,36,0.02631578947368421,0.05263157894736842,0.9473684210526316,38,1100,800,300,0.7272727272727273,14,8,6,372.8659903182351,0.45645151730678046,0.10473944553088654,0.1935118838111294,126538.2684568973,1851.7420567669512,128390.01051366425,204,0,62.73684210526316,35,3,15,39.087604010889976,0.587202380952381,48.46643518518518,1006.1342592592594,28.746693121693124,8
210,4,0,0,36,0.0,0.0,1.0,36,1250,900,350,0.72,16,9,7,387.0342340591337,0.45358796296296294,0.12579548839602483,0.20025239121622018,126413.28605584394,2585.25386870435,128998.5399245483,205,1,66.91666666666667,33,3,16,38.86028515720204,0.5902777777777778,48.59068627450981,1005.6372549019611,30.473856209150338,0
211,4,1,0,37,0.02702702702702703,0.0,1.0,37,1350,1100,250,0.8148148148148148,16,11,5,372.73227437846793,0.45692567567567566,0.128593968584515,0.1949357543751913,126852.04790249429,2056.3704648526086,128908.4183673469,206,0,66.08108108108108,34,3,19,38.767677066099445,0.5925245098039216,48.154761904761905,1007.3809523809521,29.62885154061624,0
212,4,2,0,39,0.05128205128205128,0.0,1.0,39,1000,400,600,0.4,16,4,12,364.37073316038396,0.45819275753486277,0.17385228995227808,0.18765426227009138,126223.21605725602,1523.6146541949838,127746.83071145101,207,0,63.64102564102564,34,5,21,39.62603167081308,0.5860906862745099,48.77976190476189,1004.8809523809507,29.55532212885149,8
213,4,2,0,41,0.04878048780487805,0.0,1.0,41,1050,600,450,0.5714285714285714,15,6,9,346.0152584505301,0.4606707317073171,0.1746976449858435,0.18051741196409787,126751.58900454493,571.5967656845862,127323.18577022952,208,0,61.48780487804878,36,5,17,39.54372623574143,0.5873842592592593,48.254504504504496,1006.9819819819808,27.97172172172169,0
214,4,2,0,43,0.046511627906976744,0.0,1.0,43,1150,700,450,0.6086956521739131,16,7,9,332.581706623145,0.46202473237356956,0.17972416034349448,0.1758995969071795,127307.56104353852,-131.96681642195466,127175.59422711657,209,0,59.58139534883721,38,5,19,39.312054485143605,0.5893640350877193,47.70299145299145,1009.1880341880335,26.557579847053514,0
215,4,0,2,41,0.0,0.046511627906976744,0.9534883720930233,43,700,400,300,0.5714285714285714,10,4,6,332.1947588597692,0.46158637873754155,0.17768653023846626,0.17581198246208607,127334.51727892821,-140.028147600278,127194.48913132794,210,1,60.58139534883721,38,5,12,39.294220387424566,0.5896381578947368,47.676282051282044,1009.2948717948707,26.560391363022912,0
216,4,1,0,42,0.023809523809523808,0.0,1.0,42,1200,900,300,0.75,15,9,6,332.7393452549668,0.4615998838559814,0.167150108774474,0.17716121896007658,127577.25180802084,89.99424720576172,127667.2460552266,211,0,61.523809523809526,38,4,14,39.03209602368864,0.5921052631578947,47.435897435897424,1010.2564102564087,26.585695006747596,0
217,4,4,5,41,0.08695652173913043,0.10869565217391304,0.8913043478260869,46,850,800,50,0.9411764705882353,9,8,1,308.43490855930077,0.46353663446054755,0.176458070886248,0.1676048418000965,128395.770345175,-1278.3940391026179,127117.37630607239,212,0,57.08695652173913,41,5,12,38.81207582876531,0.5955284552845528,46.62698412698412,1013.4920634920626,24.719318621757623,0
218,4,1,3,39,0.023809523809523808,0.07142857142857142,0.9285714285714286,42,1350,1000,350,0.7407407407407407,17,10,7,330.7922251500981,0.45999080526519553,0.1813430471967059,0.17790648292995917,127982.32299884954,67.1114809336085,128049.43447978316,213,0,62.833333333333336,38,4,17,38.6673793685989,0.596217105263158,47.035256410256416,1011.8589743589752,26.62786774628882,0
219,4,0,0,39,0.0,0.0,1.0,39,1150,800,350,0.6956521739130435,15,8,7,351.78971140212485,0.4583333333333333,0.1850194392567277,0.18776453300509482,127676.20991941003,1183.035408093262,128859.24532750329,160,1,62.8974358974359,35,4,18,38.44957245380973,0.5988095238095238,47.337962962962955,1010.6481481481472,28.87566137566135,0
220,4,1,0,40,0.025,0.0,1.0,40,1350,900,450,0.6666666666666666,18,9,9,415.73958016840345,0.45834668803418804,0.20699172033118707,0.21622436537945183,126625.62157064464,2563.6466906721453,129189.26826131679,161,0,62.3,35,5,16,37.91877491567005,0.5880952380952381,48.379629629629626,1006.4814814814808,28.75661375661374,8
221,4,3,3,40,0.06976744186046512,0.06976744186046512,0.9302325581395349,43,1250,900,350,0.72,16,9,7,392.2662300882213,0.46045588778146923,0.23143875105266587,0.2094342305200345,127688.85598013535,1419.3199095616917,129108.17588969704,162,0,58.883720930232556,36,7,16,37.41388115134633,0.5969328703703703,47.32545045045044,1010.6981981981967,28.074949949949907,0
222,4,0,1,39,0.0,0.025,0.975,40,950,400,550,0.42105263157894735,15,4,11,409.66779810962925,0.4595753205128205,0.22849034842782578,0.2170053796160139,127370.19903702902,2435.893796856977,129806.092833886,163,1,59.85,33,7,16,37.30259297478857,0.6000631313131313,47.64093137254902,1009.4362745098038,30.5889780154486,0
223,4,0,1,38,0.0,0.02564102564102564,0.9743589743589743,39,1500,900,600,0.6,21,9,12,420.69017362221024,0.4579678362573099,0.2457804892130635,0.22271504953218238,127346.77105652502,2914.7070451994923,130261.47810172451,164,2,62.256410256410255,32,7,16,37.04861979818199,0.6022135416666667,47.664141414141426,1009.3434343434358,31.541982323232368,0
224,4,0,0,38,0.0,0.0,1.0,38,1200,900,300,0.75,15,9,6,421.0292563064281,0.45842223802750115,0.24172180935898724,0.22348267506203637,127453.3271789552,3132.31591118708,130585.64309014227,165,3,63.78947368421053,31,7,16,36.93007199656136,0.6058467741935484,47.55859375000001,1009.7656250000009,32.57308467741938,0
225,4,0,1,37,0.0,0.02631578947368421,0.9736842105263158,38,1150,900,250,0.782608695652174,14,9,5,424.16103832361136,0.45824442863916554,0.23927540330270847,0.22615328379106334,127633.67776566165,3227.4466572288547,130861.1244228905,166,4,64.78947368421052,32,6,16,36.664896497146906,0.6051432291666667,47.380050505050505,1010.4797979797979,31.577493686868685,0
226,4,1,0,38,0.02631578947368421,0.0,1.0,38,700,200,500,0.2857142857142857,12,2,10,421.11943731512906,0.45972617354196305,0.23530397744079168,0.22524404372626863,127761.29548324169,3160.552972910948,130921.84845615264,167,0,65.44736842105263,32,6,18,36.610153615586384,0.6064453125,47.25378787878789,1010.9848484848499,31.593276515151558,0
227,4,1,0,39,0.02564102564102564,0.0,1.0,39,900,700,200,0.7777777777777778,11,7,4,414.5379215938738,0.45937359424201535,0.23399886013081317,0.22351401060955692,128084.2704790251,2819.15745464854,130903.42793367364,168,0,64.74358974358974,34,5,19,36.44400015680739,0.6050857843137255,46.93452380952382,1012.2619047619061,29.772408963585473,0
228,4,1,1,39,0.025,0.025,0.975,40,850,600,250,0.7058823529411765,11,6,5,403.42525219008195,0.4593215811965812,0.23703770848440886,0.21989068093680772,128517.04422577866,2369.432540172947,130886.47676595161,169,0,64.1,33,7,15,36.28081943437274,0.6117424242424243,46.50735294117648,1013.970588235295,30.726381461675608,0
229,4,0,2,37,0.0,0.05128205128205128,0.9487179487179487,39,850,600,250,0.7058823529411765,11,6,5,405.3449676435955,0.4592049032838506,0.2345030598807034,0.2211094006098059,128548.1113784363,2621.266009467527,131169.37738790383,170,1,65.33333333333333,33,6,15,36.20027693856999,0.6120580808080809,46.47671568627452,1014.093137254903,30.730095068330396,0
230,4,0,0,37,0.0,0.0,1.0,37,800,500,300,0.625,11,5,6,419.9090373369998,0.4592404904904905,0.23129525621177294,0.22863019333607568,128474.33302137595,3389.5067003038293,131863.83972167977,171,2,68.54054054054055,31,6,16,35.90686274509803,0.616263440860215,46.54947916666667,1013.802083333334,32.70329301075271,0
231,4,0,1,36,0.0,0.02702702702702703,0.972972972972973,37,1400,1000,400,0.7142857142857143,18,10,8,420.2195065901582,0.4582394894894895,0.23138271116707765,0.22974948602413486,128639.3928527832,3411.356438530816,132050.74929131402,172,3,69.54054054054055,31,6,16,35.7293939588414,0.6179435483870968,46.38671875,1014.453125,32.72429435483871,0
232,4,0,2,34,0.0,0.05555555555555555,0.9444444444444444,36,1400,1100,300,0.7857142857142857,17,11,6,421.7852454792997,0.4572420634920635,0.22073949649537594,0.23107621117362886,128720.4610020663,3658.4782483930467,132378.93925045934,173,4,69.33333333333333,32,4,16,35.60641408485754,0.6162109375,46.306818181818194,1014.7727272727287,31.711647727272773,0
233,4,3,2,35,0.08108108108108109,0.05405405405405406,0.9459459459459459,37,1450,1100,350,0.7586206896551724,18,11,7,401.18416413436574,0.4555492992992993,0.221278090801442,0.22459825037926623,129575.43372741256,2996.7224144559837,132572.15614186853,174,0,66.37837837837837,33,4,17,35.254172684962285,0.6224747474747474,45.46568627450981,1018.137254901961,30.852644087938213,0
234,4,1,0,36,0.027777777777777776,0.0,1.0,36,1300,900,400,0.6923076923076923,17,9,8,406.95086628401384,0.4542989417989418,0.2301793981481488,0.22789248511904764,129586.77685950408,3347.0902203856726,132933.86707988975,175,0,67.30555555555556,32,4,18,35.095796130952394,0.625,45.45454545454545,1018.1818181818178,31.818181818181806,0
235,4,0,0,36,0.0,0.0,1.0,36,750,400,350,0.5333333333333333,11,4,7,410.4541860226745,0.4537037037037037,0.23229631465873468,0.23060893961218235,129715.36705438222,3448.4430797877817,133163.81013417,176,1,68.30555555555556,32,4,18,34.87517559081143,0.6263020833333333,45.32828282828283,1018.6868686868688,31.83396464646465,0
236,4,0,0,36,0.0,0.0,1.0,36,1250,1000,250,0.8,15,10,5,409.29782617708446,0.4530092592592592,0.23380834365964476,0.23033706117497021,129779.68606519741,3423.7086776859514,133203.39474288336,177,2,69.30555555555556,32,4,18,34.83890954151178,0.626953125,45.265151515151516,1018.9393939393938,31.841856060606055,0
237,4,0,0,36,0.0,0.0,1.0,36,1150,900,250,0.782608695652174,14,9,5,381.4730181812371,0.4526951058201058,0.1290252906063465,0.20338837803532256,127632.76643990904,2623.815350864832,130256.58179077387,178,3,70.30555555555556,34,2,15,37.74421732642161,0.6004901960784313,47.380952380952365,1010.4761904761883,29.71988795518201,8
238,4,3,0,39,0.07692307692307693,0.0,1.0,39,1450,1000,450,0.6896551724137931,19,10,9,368.448411320996,0.4564496176338282,0.07588763819766853,0.19596690329613256,127534.65008464141,1597.9878424130488,129132.63792705446,179,0,65.82051282051282,37,2,16,38.17393978868143,0.5934684684684685,47.478070175438596,1010.0877192982455,27.29966808914177,8
239,4,0,0,39,0.0,0.0,1.0,39,1150,800,350,0.6956521739130435,15,8,7,368.4057946569071,0.4561965811965812,0.08070216448770817,0.1962133521369216,127590.03371229612,1600.9815520160078,129191.01526431213,180,1,66.82051282051282,37,2,16,38.1181716228927,0.5940315315315315,47.42324561403509,1010.30701754386,27.30559506875297,0
240,4,2,2,39,0.04878048780487805,0.04878048780487805,0.9512195121951219,41,750,400,350,0.5333333333333333,11,4,7,361.0565737024337,0.45810467479674793,0.10029652748622309,0.19537665912650123,128227.80957842778,1061.9033019775081,129289.71288040529,181,0,64.51219512195122,37,4,18,37.65054942080761,0.6005067567567568,46.792763157894726,1012.8289473684196,27.37375533428161,0
241,4,0,1,38,0.0,0.02564102564102564,0.9743589743589743,39,800,600,200,0.75,10,6,4,361.463695884772,0.45771479982006297,0.08363426139267527,0.18823585887226835,126677.7412881848,1373.8984591412677,128051.63974732607,182,1,66.48717948717949,37,2,17,39.23081635987363,0.584740990990991,48.32785087719298,1006.6885964912278,27.20779990516832,8
242,4,2,0,40,0.05,0.0,1.0,40,950,500,450,0.5263157894736842,14,5,9,357.17867495568834,0.4597489316239316,0.10641785364792877,0.18803504714181274,127119.65610812954,1081.56235572485,128201.21846385438,183,0,65.45,37,3,19,38.884396179913736,0.5892454954954955,47.88925438596492,1008.4429824561413,27.255215742057874,0
243,4,3,1,42,0.06976744186046512,0.023255813953488372,0.9767441860465116,43,1400,1200,200,0.8571428571428571,16,12,4,349.4627884748065,0.46179401993355484,0.13863315150736422,0.18774430972837008,127938.82118985051,341.9714414369597,128280.79263128748,184,0,61.81395348837209,40,3,17,38.23957810145653,0.5924479166666667,47.07825203252032,1011.6869918699178,25.292174796747947,0
244,4,2,1,43,0.045454545454545456,0.022727272727272728,0.9772727272727273,44,1150,600,550,0.5217391304347826,17,6,11,348.8292544170755,0.4641252642706131,0.15855902478293382,0.18951857430700916,128388.0362426036,157.59632838066437,128545.63257098426,185,0,61.36363636363637,38,6,16,37.79648956356735,0.600328947368421,46.63461538461539,1013.4615384615389,26.670040485829972,0
245,4,1,0,44,0.022727272727272728,0.0,1.0,44,1700,1300,400,0.7647058823529411,21,13,8,353.575381723829,0.46527043692741366,0.1623373203221512,0.1930127141290575,128577.58881446785,292.37400924099956,128869.96282370885,186,0,62.25,38,6,17,37.482662663717136,0.6022478070175439,46.447649572649574,1014.2094017094018,26.689721097615838,0
246,4,1,2,43,0.022222222222222223,0.044444444444444446,0.9555555555555556,45,850,500,350,0.5882352941176471,12,5,7,345.0928381264573,0.46614057239057244,0.16546377059460693,0.18946082859393418,128804.55864800367,-110.09385850692416,128694.46478949675,187,0,61.84444444444444,39,6,18,37.46632888660852,0.6028311965811965,46.22395833333334,1015.1041666666683,26.02831196581201,0
247,4,0,0,43,0.0,0.0,1.0,43,1000,800,200,0.8,12,8,4,361.74118334550803,0.46560077519379844,0.16846763042111923,0.19752691534509717,128588.99493113253,703.187038319473,129292.18196945201,188,1,65.46511627906976,37,6,18,37.26396396396398,0.6041666666666667,46.436403508771924,1014.2543859649113,27.41228070175436,0
248,4,0,0,43,0.0,0.0,1.0,43,1600,1100,500,0.6875,21,11,10,359.7245477659949,0.4653008490217792,0.16198877305533266,0.19736238701755943,128778.12500000001,664.9305555555554,129443.05555555558,189,2,66.46511627906976,39,4,18,37.12198960043786,0.6025641025641026,46.25,1015.0000000000001,26.02564102564103,0
249,4,0,2,41,0.0,0.046511627906976744,0.9534883720930233,43,850,500,350,0.5882352941176471,12,5,7,360.95645184825827,0.464562569213732,0.16610000453329699,0.19843443520389023,128857.43408203125,702.3844401041665,129559.81852213542,190,3,67.46511627906976,39,4,18,37.00978506207037,0.6033653846153846,46.171875,1015.3125,26.033653846153847,0
250,4,2,2,41,0.046511627906976744,0.046511627906976744,0.9534883720930233,43,1050,700,350,0.6666666666666666,14,7,7,352.7277613544748,0.4654162052417867,0.16145634769348094,0.19560357675111764,129201.38888888879,515.5002170138796,129716.88910590266,185,0,63.23255813953488,37,6,20,36.868169398907106,0.6103603603603603,45.83333333333333,1016.6666666666658,27.477477477477454,0
251,4,1,1,41,0.023809523809523808,0.023809523809523808,0.9761904761904762,42,1000,500,500,0.5,15,5,10,351.15291327889923,0.4644429926442122,0.16659995175999054,0.19569656950840258,129396.54659366334,687.5948609187341,130084.14145458207,186,0,64.83333333333333,37,5,21,36.70957269102275,0.6123310810810811,45.64144736842105,1017.434210526315,27.498221906116623,0
252,4,0,1,40,0.0,0.024390243902439025,0.975609756097561,41,1200,600,600,0.5,18,6,12,351.8185291775477,0.463109756097561,0.16037780451033012,0.19704383968291375,129591.85157933216,918.5629232071449,130510.41450253931,187,1,66.51219512195122,37,4,18,36.494005312657045,0.6143018018018018,45.449561403508774,1018.2017543859653,27.518966334755817,0
253,4,1,2,39,0.024390243902439025,0.04878048780487805,0.9512195121951219,41,1450,1000,450,0.6896551724137931,19,10,9,348.02619907313635,0.46234756097560975,0.15700776613921308,0.19589385027175396,129787.30384589493,833.8764090874159,130621.18025498235,188,0,67.46341463414635,37,4,19,36.39197514258043,0.6162725225225225,45.25767543859649,1018.9692982456144,27.539710763394982,0
254,4,1,0,40,0.025,0.0,1.0,40,850,500,350,0.5882352941176471,12,5,7,355.8237946583419,0.4607238247863248,0.1657526881720428,0.20128718310964583,129982.90339335173,1250.2019852262117,131233.10537857795,189,0,67.425,37,3,20,35.994623655913976,0.6182432432432432,45.065789473684205,1019.7368421052627,27.560455192034127,0
255,4,0,0,40,0.0,0.0,1.0,40,1100,900,200,0.8181818181818182,13,9,4,356.86949967781226,0.460803952991453,0.1686250268759404,0.2021680929356278,130038.81602993225,1281.3774430593958,131320.19347299164,190,1,68.425,37,3,21,35.911183974772435,0.6188063063063063,45.0109649122807,1019.9561403508769,27.566382171645323,0
256,4,0,0,40,0.0,0.0,1.0,40,1200,900,300,0.75,15,9,6,356.200652495105,0.4606303418803419,0.16609081139172477,0.2022237383445364,130122.70752779703,1269.9586651662044,131392.66619296322,191,2,69.425,37,3,21,35.843072720759444,0.6196509009009009,44.92872807017544,1020.2850877192984,27.57527264106212,0
257,4,0,1,39,0.0,0.025,0.975,40,1450,1000,450,0.6896551724137931,19,10,9,357.8297818915172,0.459642094017094,0.15983732003174267,0.20403468041791017,130292.12648158851,1324.630926844402,131616.7574084329,192,3,70.425,35,5,23,35.62958186902467,0.625297619047619,44.762731481481474,1020.9490740740729,29.169973544973512,0
258,4,0,1,38,0.0,0.02564102564102564,0.9743589743589743,39,1050,800,250,0.7619047619047619,13,8,5,367.6800894524209,0.45875506072874495,0.15877897833099852,0.20934538585389922,130235.32238476146,1776.9869968587905,132012.30938162026,193,4,72.61538461538461,38,1,23,35.435855836996744,0.6189692982456141,44.81837606837607,1020.7264957264955,26.861223571749882,0
259,4,1,2,37,0.02564102564102564,0.05128205128205128,0.9487179487179487,39,700,500,200,0.7142857142857143,9,5,4,361.2409253499749,0.4583052181736392,0.14940806059972345,0.20708018759672583,130498.99798525377,1628.3243185931892,132127.32230384694,194,0,71.84615384615384,35,4,18,35.332653677692186,0.6273809523809524,44.56018518518518,1021.7592592592592,29.193121693121693,0
260,4,0,1,36,0.0,0.02702702702702703,0.972972972972973,37,850,600,250,0.7058823529411765,11,6,5,374.01397850526706,0.45698823823823825,0.15499258711358088,0.21327244729140182,130293.86421388415,2346.345305891973,132640.20951977614,195,6,75.37837837837837,33,4,23,35.21473512583523,0.6297348484848485,44.76102941176471,1020.9558823529417,30.93805704099823,0
261,4,1,0,37,0.02702702702702703,0.0,1.0,37,850,600,250,0.7058823529411765,11,6,5,368.23432312805693,0.45748873873873874,0.14616875841840882,0.21195686106057343,130657.85147392303,2222.5410997732574,132880.3925736963,196,0,73.10810810810811,34,3,21,34.99286795528645,0.6311274509803921,44.40476190476191,1022.3809523809534,30.070028011204514,0
262,4,0,0,37,0.0,0.0,1.0,37,650,200,450,0.3076923076923077,11,2,9,370.1016924147686,0.45683183183183185,0.14481505009780538,0.2140413152498331,130840.48327664396,2284.856859410428,133125.34013605438,197,1,74.10810810810811,34,3,21,34.75995849817702,0.6329656862745099,44.226190476190474,1023.095238095238,30.09103641456582,0
263,4,0,0,37,0.0,0.0,1.0,37,1250,800,450,0.64,17,8,9,368.3004326663062,0.4558308308308308,0.14632306725330002,0.21401241357636708,131023.24263038553,2251.183390022683,133274.42602040822,198,2,75.10810810810811,34,3,21,34.62088178294574,0.6348039215686274,44.04761904761905,1023.8095238095241,30.112044817927178,0
264,4,0,1,36,0.0,0.02702702702702703,0.972972972972973,37,900,500,400,0.5555555555555556,13,5,8,365.98049716006585,0.4550175175175175,0.1463289484534822,0.21320351674584723,131120.59709630045,2197.5162626457354,133318.1133589462,199,3,76.10810810810811,35,2,21,34.58170885599126,0.6336309523809525,43.95254629629629,1024.1898148148139,29.26256613756611,0
265,4,0,1,35,0.0,0.027777777777777776,0.9722222222222222,36,950,700,250,0.7368421052631579,12,7,5,374.92563547863716,0.4546130952380953,0.1528746770025844,0.2178621935889378,131023.24263038553,2624.794501133794,133648.03713151932,200,4,78.72222222222223,34,2,21,34.45130813953489,0.6348039215686274,44.04761904761905,1023.8095238095241,30.112044817927178,0
266,4,0,0,35,0.0,0.0,1.0,35,1400,900,500,0.6428571428571429,19,9,10,380.3512662409871,0.45217086834733894,0.15422074036077604,0.22114369028834013,131045.64838343434,2968.675659602087,134014.32404303644,201,5,81.62857142857143,33,2,21,34.28972172351886,0.6373106060606061,44.02573529411765,1023.8970588235301,31.027183600713034,0
267,4,0,0,35,0.0,0.0,1.0,35,1300,1100,200,0.8461538461538461,15,11,4,384.2986653235959,0.4512605042016807,0.15655502392344522,0.22435313143193192,131202.5422914265,3084.1923779315844,134286.7346693581,202,6,82.62857142857143,33,2,21,34.029605263157904,0.6388888888888888,43.87254901960785,1024.5098039215698,31.045751633986963,0
268,4,0,1,34,0.0,0.02857142857142857,0.9714285714285714,35,1150,800,350,0.6956521739130435,15,8,7,387.2105599221848,0.45038515406162466,0.15471789974345973,0.2274079570166549,131431.47193678466,3178.5109871543423,134609.982923939,203,7,83.62857142857143,30,5,21,33.72301961812381,0.6489583333333333,43.649193548387096,1025.403225806452,34.180107526881734,0
269,4,0,0,34,0.0,0.0,1.0,34,850,600,250,0.7058823529411765,11,6,5,392.1732327459215,0.44971776589423645,0.16496717863743626,0.23055789415572323,131470.52469135806,3511.8441358024756,134982.36882716054,204,8,85.70588235294117,29,5,21,33.55622517154209,0.6522988505747127,43.611111111111114,1025.5555555555557,35.36398467432951,0
270,4,0,0,34,0.0,0.0,1.0,34,1300,900,400,0.6923076923076923,17,9,8,383.88547750211353,0.44890077243018417,0.16120871083779909,0.22682048978048408,131661.99578179244,3308.6256239149257,134970.62140570738,205,9,86.70588235294117,31,3,20,33.57491753362091,0.648521505376344,43.424479166666664,1026.3020833333328,33.10651881720428,0
271,4,0,0,34,0.0,0.0,1.0,34,900,700,200,0.7777777777777778,11,7,4,384.6034825348891,0.44823232323232326,0.15753557543783736,0.22744405497543352,131695.40617201055,3330.1023695203903,135025.50854153093,206,10,87.70588235294117,31,3,20,33.52269123430166,0.6488575268817205,43.39192708333333,1026.432291666666,33.11071908602148,0
272,4,0,0,34,0.0,0.0,1.0,34,1000,800,200,0.8,12,8,4,384.875573693187,0.4478238265002971,0.16023841902722724,0.22812012866421238,131781.48275686146,3343.894755637168,135125.3775124986,207,11,88.70588235294117,32,2,20,33.42863584194129,0.6471354166666667,43.3080808080808,1026.7676767676762,32.08648989898988,0
273,4,0,0,34,0.0,0.0,1.0,34,1150,900,250,0.782608695652174,14,9,5,384.88668302573103,0.4473039215686274,0.15929203539823034,0.2289062904310924,131911.15702479324,3354.1695362717915,135265.32656106504,208,12,89.70588235294117,32,2,20,33.29722836774828,0.6484375,43.18181818181817,1027.2727272727261,32.10227272727269,0
274,4,1,0,35,0.02857142857142857,0.0,1.0,35,1200,700,500,0.5833333333333334,17,7,10,371.5504380433533,0.4477941176470588,0.1438850879880187,0.22308972653332654,132271.9101427334,2829.137230872722,135101.04737360612,209,0,88.11428571428571,33,2,21,33.27575252164243,0.6496212121212122,42.83088235294117,1028.676470588234,31.172014260249515,0
275,4,0,1,34,0.0,0.02857142857142857,0.9714285714285714,35,900,600,300,0.6666666666666666,12,6,6,367.5603306557163,0.4468487394957983,0.13281929062105746,0.22162365499300282,132430.49178655233,2735.299143041682,135165.79092959402,210,1,89.11428571428571,32,3,21,33.21858644095518,0.6536458333333333,42.676767676767675,1029.2929292929289,32.16540404040403,0
276,4,0,1,33,0.0,0.029411764705882353,0.9705882352941176,34,500,300,200,0.6,7,3,4,376.1134941449397,0.444760101010101,0.1372753593888767,0.22580667920403988,132268.0900705284,3149.562704060794,135417.6527745892,211,2,91.82352941176471,32,2,21,33.1622580909128,0.6520182291666667,42.83459595959595,1028.661616161615,32.14567550505047,0
277,4,1,0,34,0.029411764705882353,0.0,1.0,34,1200,800,400,0.6666666666666666,16,8,8,377.60264415892465,0.44464869281045755,0.14818918717929708,0.22870114205950168,132599.08888075076,3214.0170838903073,135813.10596464106,212,0,91.55882352941177,31,3,23,32.790244416350625,0.6579301075268817,42.51302083333333,1029.9479166666658,33.224126344085995,0
278,4,0,1,33,0.0,0.029411764705882353,0.9705882352941176,34,1000,800,200,0.8,12,8,4,376.7938731506635,0.4444815805109923,0.14682091238922323,0.22861910462945156,132666.1512586805,3197.5585937499964,135863.7098524305,213,1,92.55882352941177,31,3,20,32.743511964947764,0.6586021505376345,42.447916666666664,1030.208333333333,33.23252688172042,0
279,4,0,0,33,0.0,0.0,1.0,33,750,400,350,0.5333333333333333,11,4,7,379.5083708857384,0.4435763888888889,0.13583027142349224,0.23138546937151122,132847.95388195157,3483.3821106486193,136331.3359926002,214,2,92.84848484848484,30,3,20,32.49049326379836,0.6631944444444444,42.27150537634408,1030.9139784946228,34.363799283154094,0
280,4,0,0,33,0.0,0.0,1.0,33,1250,1100,150,0.88,14,11,3,377.96949112425307,0.44223484848484845,0.13188301033814098,0.23160497124342286,133035.29739379883,3456.656731499566,136491.9541252984,215,3,93.84848484848484,31,2,21,32.34162669864109,0.6622983870967742,42.08984375,1031.640625,33.27872983870968,0
281,4,1,1,33,0.029411764705882353,0.029411764705882353,0.9705882352941176,34,850,700,150,0.8235294117647058,10,7,3,368.73016062792544,0.4437945632798574,0.12972098374802243,0.22781062794081802,133341.78272625245,3033.4273926130013,136375.21011886545,216,0,92.05882352941177,32,2,22,32.27205582722088,0.6627604166666667,41.792929292929294,1032.828282828283,32.27588383838384,0
282,4,0,0,33,0.0,0.0,1.0,33,1250,1000,250,0.8,15,10,5,379.59079700164534,0.4419191919191919,0.13731311348257536,0.23428284910661856,133304.0894402397,3520.2011108398347,136824.29055107955,217,1,95.63636363636364,31,2,22,32.02950972975246,0.664986559139785,41.82942708333333,1032.6822916666658,33.312331989247284,0
283,4,0,1,32,0.0,0.030303030303030304,0.9696969696969697,33,1000,700,300,0.7,13,7,6,381.28930794123244,0.4412089646464647,0.14147833751842565,0.235984048228076,133406.99450311193,3573.3321217222724,136980.3266248342,218,2,96.63636363636364,32,1,22,31.882231320785458,0.6634114583333333,41.72979797979798,1033.080808080808,32.28377525252525,0
284,4,0,0,32,0.0,0.0,1.0,32,900,600,300,0.6666666666666666,12,6,6,385.7227992872414,0.4396211357526882,0.14856857198595397,0.23937228440029049,133506.94670265348,3899.3505835388,137406.29728619228,219,3,98.6875,30,2,22,31.66726275631855,0.6697916666666667,41.63306451612903,1033.467741935484,34.4489247311828,0
285,4,0,0,32,0.0,0.0,1.0,32,600,300,300,0.5,9,3,6,384.82907976555975,0.43907510080645157,0.14530376413990354,0.23926600262545836,133576.40921277023,3880.817327147641,137457.22653991787,220,4,99.6875,30,2,22,31.620562995709268,0.6704861111111111,41.56586021505376,1033.7365591397847,34.45788530465949,0
286,4,0,0,32,0.0,0.0,1.0,32,750,300,450,0.4,12,3,9,386.16629793842407,0.438487063172043,0.14858881450669403,0.2405487716631819,133645.8897885594,3921.907698866924,137567.79748742632,221,5,100.6875,30,2,22,31.51620520819792,0.6711805555555556,41.498655913978496,1034.0053763440862,34.466845878136205,0
287,4,0,1,31,0.0,0.03125,0.96875,32,750,500,250,0.6666666666666666,10,5,5,385.83588661447374,0.4380250336021505,0.14582927225471098,0.24079538909151463,133715.38843002077,3918.439089779163,137633.82751979993,222,6,101.6875,30,2,20,31.454949101147932,0.671875,41.431451612903224,1034.2741935483868,34.4758064516129,0
288,4,0,0,31,0.0,0.0,1.0,31,350,200,150,0.5714285714285714,5,2,3,398.1337565879686,0.4353046594982079,0.15064741467473253,0.24780164582281247,133615.77932098758,4439.390432098753,138055.16975308635,223,7,103.74193548387096,29,2,22,31.237126097080424,0.6738505747126438,41.52777777777777,1033.8888888888882,35.65134099616856,0
289,4,0,0,31,0.0,0.0,1.0,31,950,600,350,0.631578947368421,13,6,7,400.20994960657964,0.43449820788530463,0.14521975238070461,0.25030763346930407,133795.33420138888,4509.2447916666615,138304.57899305553,224,8,104.74193548387096,29,2,20,31.002903074238144,0.6756465517241379,41.354166666666664,1034.5833333333333,35.67528735632184,0
290,4,0,0,31,0.0,0.0,1.0,31,500,300,200,0.6,7,3,4,400.20994960657964,0.43449820788530463,0.14521975238070461,0.25030763346930407,133795.33420138888,4509.2447916666615,138304.57899305553,225,9,105.74193548387096,29,2,20,31.002903074238144,0.6756465517241379,41.354166666666664,1034.5833333333333,35.67528735632184,0
291,4,0,1,30,0.0,0.03225806451612903,0.967741935483871,31,800,500,300,0.625,11,5,6,397.8019008152786,0.4344086021505376,0.14392725698203068,0.24904404714906078,133831.2596450616,4447.66589506171,138278.9255401233,226,10,106.74193548387096,29,2,20,31.02908277404922,0.6760057471264368,41.319444444444436,1034.7222222222213,35.68007662835246,0
292,4,0,0,30,0.0,0.0,1.0,30,700,400,300,0.5714285714285714,10,4,6,401.6849896905278,0.43318965517241376,0.13396278811441253,0.2515595909348852,133843.64884727172,4752.596941471786,138596.24578874352,227,11,107.03333333333333,28,2,20,30.916180690548927,0.6793154761904762,41.30747126436781,1034.7701149425282,36.95607553366172,0
293,4,0,0,30,0.0,0.0,1.0,30,700,600,100,0.8571428571428571,8,6,2,404.8284769630639,0.4328065134099617,0.13319456008881514,0.25455445069771704,133992.36400118904,4848.784928656364,138841.1489298454,228,12,108.03333333333333,28,2,20,30.685366361365546,0.6808035714285714,41.16379310344828,1035.3448275862067,36.97660098522167,0
294,4,0,0,30,0.0,0.0,1.0,30,850,500,350,0.5882352941176471,12,5,7,409.0829420330676,0.43177681992337164,0.1363064687658948,0.2580121547783361,134103.95455558854,4971.928053573785,139075.88260916233,229,13,109.03333333333333,28,2,20,30.463078559208405,0.6819196428571428,41.05603448275862,1035.7758620689651,36.99199507389161,0
295,4,0,1,29,0.0,0.03333333333333333,0.9666666666666667,30,900,600,300,0.6666666666666666,12,6,6,407.9547907993026,0.43093869731800766,0.1351446261898155,0.2586103568388549,134290.04202999067,4956.853200554875,139246.89523054555,230,14,110.03333333333333,28,2,20,30.305366879216336,0.6837797619047619,40.876436781609186,1036.4942528735626,37.01765188834152,0
296,4,0,0,29,0.0,0.0,1.0,29,700,500,200,0.7142857142857143,9,5,4,417.1633249397413,0.426878078817734,0.14928499689129082,0.26337544420451264,134141.16172876203,5391.754607609987,139532.91633637203,231,19,114.34482758620689,28,1,20,30.21642394822007,0.6822916666666667,41.020114942528735,1035.919540229885,36.997126436781606,0
297,4,0,0,29,0.0,0.0,1.0,29,900,600,300,0.6666666666666666,12,6,6,420.29436468332636,0.42641625615763545,0.15084832462459996,0.2661618307691688,134252.81421340324,5485.140251354185,139737.95446475744,232,20,115.34482758620689,28,1,20,30.023048662137782,0.6834077380952381,40.91235632183907,1036.3505747126428,37.01252052545153,0
298,4,0,0,29,0.0,0.0,1.0,29,450,300,150,0.6666666666666666,6,3,3,419.2668523584387,0.4259544334975369,0.14711815148705054,0.2657812893597343,134290.04202999067,5460.672644999321,139750.71467498998,233,21,116.34482758620689,28,1,20,30.012244709361426,0.6837797619047619,40.876436781609186,1036.4942528735626,37.01765188834152,0
299,4,0,0,29,0.0,0.0,1.0,29,800,600,200,0.75,10,6,4,419.1170551029739,0.4256978653530377,0.14603562963529293,0.26622787584710017,134364.51314572594,5462.891811996288,139827.40495772223,234,22,117.34482758620689,28,1,20,29.941276330376926,0.6845238095238095,40.80459770114942,1036.7816091954019,37.02791461412149,0
300,4,0,0,29,0.0,0.0,1.0,29,900,500,400,0.5555555555555556,13,5,8,418.37904894431495,0.42544129720853857,0.14369329122330865,0.2660300965842396,134401.75644487378,5446.175807570341,139847.93225244412,235,23,118.34482758620689,28,1,21,29.922982772158328,0.6848958333333333,40.768678160919535,1036.9252873563214,37.033045977011476,0
301,4,0,0,29,0.0,0.0,1.0,29,700,500,200,0.7142857142857143,9,5,4,419.7744631232311,0.4250821018062398,0.14261216808135635,0.2674626521876967,134476.25852572982,5489.939845091801,139966.19837082163,236,24,119.34482758620689,28,1,21,29.811954564344088,0.6856398809523809,40.69683908045976,1037.2126436781598,37.04330870279142,0
302,4,0,0,29,0.0,0.0,1.0,29,600,500,100,0.8333333333333334,7,5,2,418.86421186755035,0.4245689655172414,0.13765406453399787,0.26742868911543605,134550.78125000003,5471.722032302814,140022.50328230285,237,25,120.34482758620689,27,2,22,29.7607095046854,0.6898148148148149,40.625,1037.5000000000002,38.42592592592593,0
303,4,0,0,29,0.0,0.0,1.0,29,650,500,150,0.7692307692307693,8,5,3,421.5707504353297,0.42410714285714285,0.13545879770180824,0.2697279278473386,134627.98726261343,5551.044323979597,140179.03158659302,238,26,121.34482758620689,27,2,22,29.61296721154764,0.6905864197530864,40.55059523809524,1037.7976190476195,38.43694885361554,0
304,4,0,0,29,0.0,0.0,1.0,29,750,600,150,0.8,9,6,3,420.0377703896977,0.4234913793103448,0.13298797848782007,0.26931833513221803,134705.2154195012,5516.25566893425,140221.47108843547,239,27,122.34482758620689,27,2,23,29.575210244648314,0.691358024691358,40.47619047619048,1038.0952380952388,38.44797178130514,0
305,4,0,0,29,0.0,0.0,1.0,29,750,600,150,0.8,9,6,3,438.41513461230716,0.42308087027914615,0.16237424651570187,0.2597307115383506,131763.47748532987,5756.609319253514,137520.08680458338,240,28,123.34482758620689,26,3,22,32.07262387895184,0.6654647435897436,43.325617283950606,1026.6975308641966,39.48836657169987,8
306,4,0,0,29,0.0,0.0,1.0,29,1000,800,200,0.8,12,8,4,441.8194839834291,0.4213875205254516,0.1652458540930799,0.2631157535207216,131961.60312833393,5860.641479957292,137822.24460829122,241,29,124.34482758620689,26,3,22,31.783818964654053,0.6674679487179487,43.1327160493827,1027.4691358024677,39.51804368471029,0
307,4,0,0,29,0.0,0.0,1.0,29,750,700,50,0.9333333333333333,8,7,1,443.4426070446926,0.4212335796387521,0.17194270302170644,0.26491221574212503,132080.54995903806,5914.0286827465015,137994.57864178455,242,30,125.34482758620689,26,3,22,31.621253065105346,0.6686698717948718,43.01697530864196,1027.9320987654305,39.53584995251656,0
308,4,0,0,29,0.0,0.0,1.0,29,1000,700,300,0.7,13,7,6,443.018556589635,0.4201046798029557,0.16875598209897302,0.265771258296122,132239.22908569567,5916.8864788141855,138156.11556450985,243,31,126.34482758620689,26,3,22,31.470992748187033,0.6702724358974359,42.862654320987644,1028.5493827160485,39.55959164292494,0
309,4,0,0,29,0.0,0.0,1.0,29,700,400,300,0.5714285714285714,10,4,6,444.35198819223524,0.4197454844006568,0.16778982127625608,0.26688143304716927,132283.1660333402,5956.057566255635,138239.22359959583,244,32,127.34482758620689,27,2,22,31.392093398910266,0.6670524691358024,42.81994047619046,1028.7202380952365,38.100749559082836,0
310,4,0,0,29,0.0,0.0,1.0,29,1000,700,300,0.7,13,7,6,443.0253501316734,0.41948891625615764,0.19834130915107218,0.24519033243421862,129122.95429431491,5640.998231872338,134763.95252618726,245,33,128.3448275862069,26,3,20,34.65368458345986,0.6386217948717949,45.910493827160494,1016.3580246913583,39.09069325735994,8
311,4,0,0,29,0.0,0.0,1.0,29,1200,900,300,0.75,15,9,6,446.0556401382556,0.41948891625615764,0.20270192523941288,0.24859212471948589,129397.57956580547,5743.704037113241,135141.2836029187,246,34,129.3448275862069,26,3,20,34.294580110217915,0.641426282051282,45.64043209876543,1017.4382716049379,39.13224121557453,0
312,4,2,0,31,0.06451612903225806,0.0,1.0,31,700,600,100,0.8571428571428571,8,6,2,419.07240587258786,0.42710573476702507,0.1781692253156273,0.23720701251065635,130006.03819857317,4696.388641167927,134702.4268397411,247,0,121.93548387096774,28,3,21,34.35856344510191,0.640625,45.043103448275865,1019.8275862068969,36.42241379310346,0
313,4,1,0,32,0.03125,0.0,1.0,32,700,600,100,0.8571428571428571,8,6,2,405.99234590259397,0.43092657930107525,0.16878230852945197,0.2315321749208665,130298.03481867281,4180.000964506171,134478.035783179,248,0,119.09375,29,3,22,34.39427175440983,0.6404454022988506,44.75694444444444,1020.9722222222221,35.205938697318004,0
314,4,0,0,32,0.0,0.0,1.0,32,750,400,350,0.5333333333333333,11,4,7,405.99234590259397,0.43092657930107525,0.16878230852945197,0.2315321749208665,130298.03481867281,4180.000964506171,134478.035783179,249,1,120.09375,29,3,22,34.39427175440983,0.6404454022988506,44.75694444444444,1020.9722222222221,35.205938697318004,0
315,4,1,0,33,0.030303030303030304,0.0,1.0,33,1050,700,350,0.6666666666666666,14,7,7,391.4472412767027,0.4330808080808081,0.1714026349422486,0.22621905492459993,130812.00003251807,3641.1993077234156,134453.1993402415,250,0,117.42424242424242,30,3,18,34.24292690404239,0.6427083333333333,44.254032258064505,1022.9838709677408,34.09946236559136,0
316,4,0,1,32,0.0,0.030303030303030304,0.9696969696969697,33,650,400,250,0.6153846153846154,9,4,5,390.5987133493702,0.43260732323232326,0.17220145763427008,0.2261314072037073,130880.75798141382,3624.371133946093,134505.12911535992,251,1,118.42424242424242,30,3,18,34.19479837120715,0.6434027777777778,44.186827956989234,1023.2526881720413,34.10842293906804,0
317,4,0,2,30,0.0,0.0625,0.9375,32,1200,900,300,0.75,15,9,6,401.38530121379324,0.42893145161290325,0.17961004346054632,0.23143304407495358,130723.78713348755,4094.1213348765305,134817.9084683641,252,2,123.03125,29,3,19,34.07847231653765,0.6447557471264368,44.34027777777777,1022.6388888888881,35.263409961685795,0
318,4,1,1,30,0.03225806451612903,0.03225806451612903,0.967741935483871,31,800,500,300,0.625,11,5,6,410.29543443224986,0.42477598566308244,0.18712760844132892,0.23577073671656112,130592.80659598364,4516.326463205185,135109.1330591888,253,0,127.64516129032258,28,3,19,33.98404554399776,0.6465773809523809,44.4683908045977,1022.1264367816094,36.50451559934319,0
319,4,0,0,30,0.0,0.0,1.0,30,300,100,200,0.3333333333333333,5,1,4,420.4137949950483,0.4218390804597701,0.18038027683365354,0.21934773714198072,126754.62649252397,4657.87871138037,131412.50520390435,254,4,132.9,27,3,20,37.667633367814396,0.6107253086419753,48.25148809523809,1006.9940476190466,37.296075837742464,8
320,4,1,0,31,0.03225806451612903,0.0,1.0,31,800,600,200,0.75,10,6,4,406.2430499752438,0.42732974910394267,0.17042551236099635,0.21410106687884467,127164.46195005944,4131.935774210596,131296.39772427003,255,0,129.58064516129033,28,3,21,37.601198955365625,0.6116071428571428,47.8448275862069,1008.6206896551723,36.022167487684726,0
321,4,1,0,32,0.03125,0.0,1.0,32,900,600,300,0.6666666666666666,12,6,6,392.7038743478307,0.43107358870967744,0.1674917491749175,0.20875311215332046,127512.49999999991,3614.930555555541,131127.43055555545,256,0,126.5,29,3,22,37.58422717271725,0.6120689655172413,47.49999999999999,1009.9999999999993,34.82758620689653,0
322,4,2,0,34,0.058823529411764705,0.0,1.0,34,1400,1100,300,0.7857142857142857,17,11,6,371.711440127006,0.435754604872252,0.15987546097575778,0.2020532018120539,128408.33875868034,2746.1697048610868,131154.50846354142,257,0,120.0,31,3,19,37.19595751969853,0.6155913978494624,46.61458333333332,1013.5416666666649,32.69489247311822,0
323,4,0,0,34,0.0,0.0,1.0,34,1100,800,300,0.7272727272727273,14,8,6,368.89636196195846,0.43579174093879974,0.15848204167359237,0.20085504015635008,128474.33302137573,2678.7428114149116,131153.07583279064,258,1,121.0,31,3,19,37.19978165938865,0.616263440860215,46.54947916666666,1013.8020833333322,32.70329301075265,0
324,4,1,1,34,0.02857142857142857,0.02857142857142857,0.9714285714285714,35,1200,900,300,0.75,15,9,6,355.8006450130992,0.4387955182072829,0.14482868865561915,0.1958730039589566,128912.72454660227,2173.4461088154126,131086.1706554177,259,0,118.51428571428572,32,3,20,37.08426582121099,0.6181640625,46.117424242424235,1015.5303030303022,31.735321969696944,0
325,4,1,0,35,0.02857142857142857,0.0,1.0,35,1300,800,500,0.6153846153846154,18,8,10,354.86945588592687,0.440266106442577,0.14479599446042468,0.1958353663963077,129008.91012396682,2156.2643480256984,131165.17447199253,260,0,117.14285714285714,32,3,21,37.009849614715385,0.619140625,46.022727272727266,1015.9090909090899,31.747159090909058,0
326,4,0,3,32,0.0,0.08571428571428572,0.9142857142857143,35,750,600,150,0.8,9,6,3,353.8606210648633,0.44019607843137254,0.14274353876739565,0.19559548614903982,129073.05377002344,2134.774193959797,131207.82796398323,261,1,118.14285714285714,32,3,21,36.97010644466533,0.6197916666666667,45.95959595959596,1016.1616161616159,31.755050505050498,0
327,4,1,0,33,0.030303030303030304,0.0,1.0,33,650,400,250,0.6153846153846154,9,4,5,359.5750621964188,0.4360400883838384,0.10282147722906054,0.1992336771162129,129168.29639010954,2689.139641655811,131857.43603176533,262,0,111.0,31,2,22,36.72785641091329,0.6233198924731183,45.865885416666664,1016.5364583333328,32.79149865591396,0
328,4,0,0,33,0.0,0.0,1.0,33,850,600,250,0.7058823529411765,11,6,5,358.15289618371736,0.4351720328282828,0.100389455228165,0.1992799447996581,129333.80126953124,2664.2550998263887,131998.05636935763,263,1,112.0,31,2,22,36.595408772828144,0.625,45.703125,1017.1874999999999,32.81249999999999,0
329,4,0,0,33,0.0,0.0,1.0,33,1000,600,400,0.6,14,6,8,359.0357129013368,0.43402777777777773,0.10067925932818489,0.2004445094312034,129466.28146701383,2696.6037326388837,132162.88519965272,264,2,113.0,31,2,18,36.438075742067554,0.6263440860215054,45.572916666666664,1017.7083333333328,32.8293010752688,0
330,4,1,1,33,0.029411764705882353,0.029411764705882353,0.9705882352941176,34,950,600,350,0.631578947368421,13,6,7,350.44783329659026,0.4351604278074866,0.10327080677472211,0.198031228402377,129940.55333958274,2307.477075043361,132248.0304146261,265,0,110.6470588235294,32,2,20,36.174664602683166,0.6285807291666667,45.10732323232323,1019.5707070707074,31.861584595959606,0
331,4,2,1,34,0.05714285714285714,0.02857142857142857,0.9714285714285714,35,900,700,200,0.7777777777777778,11,7,4,341.3696455475127,0.43746498599439776,0.10613812495713648,0.19481451278779952,130325.14537677805,1897.8097366397456,132222.9551134178,266,0,108.34285714285714,33,2,22,36.016262602016326,0.630050505050505,44.73039215686274,1021.078431372548,30.94177064765297,0
332,4,1,1,34,0.02857142857142857,0.02857142857142857,0.9714285714285714,35,700,400,300,0.5714285714285714,10,4,6,340.34930329118015,0.43651960784313726,0.10899623158616012,0.19548988908047102,130575.52984429052,1888.2581218761848,132463.7879661667,267,0,109.02857142857142,33,2,18,35.788868904876104,0.6325757575757576,44.48529411764705,1022.0588235294106,30.97147950089123,0
333,4,0,0,34,0.0,0.0,1.0,34,800,500,300,0.625,11,5,6,349.79884679402505,0.43354500891265596,0.11565137734737974,0.20029883010689697,130455.9981921486,2326.671544995392,132782.669737144,268,1,113.0,32,2,23,35.66848967989124,0.6337890625,44.60227272727272,1021.5909090909079,31.92471590909087,0
334,4,1,0,35,0.02857142857142857,0.0,1.0,35,1150,900,250,0.782608695652174,14,9,5,342.38206571865487,0.434733893557423,0.12979425698209401,0.1987433908928368,130982.91710219615,1969.2403462610362,132952.15744845718,269,0,110.74285714285715,33,2,20,35.325007981164454,0.6366792929292929,44.08700980392156,1023.6519607843127,31.019756387403415,0
335,4,1,1,35,0.027777777777777776,0.027777777777777776,0.9722222222222222,36,1500,1000,500,0.6666666666666666,20,10,10,335.52148103959007,0.43470568783068786,0.12929521671247302,0.19667634262981026,131358.63272392296,1614.728599773242,132973.3613236962,270,0,108.63888888888889,34,2,22,35.121501567762145,0.6381740196078431,43.720238095238095,1025.119047619048,30.150560224089645,0
336,4,0,0,35,0.0,0.0,1.0,35,700,500,200,0.7142857142857143,9,5,4,346.67558024104994,0.43186274509803924,0.13170256743137299,0.20288648548326807,131296.72369100826,2103.473573865823,133400.1972648741,271,1,112.37142857142857,33,2,22,34.89813763003706,0.6398358585858586,43.78063725490196,1024.8774509803923,31.05689245395128,0
337,4,0,0,35,0.0,0.0,1.0,35,950,800,150,0.8421052631578947,11,8,3,348.0071386079715,0.4321778711484594,0.13031358885017452,0.20383275261324044,131328.125,2140.6249999999995,133468.75,272,2,113.37142857142857,33,2,22,34.832317073170735,0.6401515151515151,43.75,1025.0,31.060606060606062,0
338,4,1,1,35,0.027777777777777776,0.027777777777777776,0.9722222222222222,36,1000,800,200,0.8,12,8,4,339.6972453851994,0.4324900793650794,0.1262889920082495,0.20056097638496004,131633.36167800447,1743.0980725623515,133376.4597505668,273,0,111.19444444444444,34,2,17,34.737529002320194,0.6409313725490196,43.45238095238095,1026.1904761904757,30.182072829131638,0
339,4,0,0,35,0.0,0.0,1.0,35,1300,1100,200,0.8461538461538461,15,11,4,355.12588977057334,0.4301120448179272,0.1394225685976911,0.2102395461913845,131736.68368235766,2356.6214016243603,134093.305083982,274,4,115.37142857142857,33,2,19,34.237470653774224,0.6442550505050505,43.3517156862745,1026.5931372549012,31.108882947118218,0
340,4,0,1,34,0.0,0.02857142857142857,0.9714285714285714,35,550,300,250,0.5454545454545454,8,3,5,354.993676956683,0.4298669467787115,0.14012208846298146,0.21033500887857762,131768.1375552671,2355.3711312956407,134123.50868656274,275,5,116.37142857142857,33,2,20,34.20913901488023,0.6445707070707071,43.32107843137254,1026.715686274509,31.112596553773,0
341,4,0,0,34,0.0,0.0,1.0,34,1150,600,550,0.5217391304347826,17,6,11,359.4754921275087,0.42918152109328583,0.11574171155862478,0.2136108932401229,131878.73247946633,2681.4344518416406,134560.16693130796,276,6,115.1470588235294,32,2,21,33.982534316738366,0.6481119791666667,43.213383838383834,1027.1464646464642,32.09832702020201,0
342,4,0,0,34,0.0,0.0,1.0,34,850,400,450,0.47058823529411764,13,4,9,359.67210011668345,0.4281788472964943,0.11111271738973305,0.21427610181182788,131976.01807213548,2693.618317008462,134669.63638914394,277,7,116.1470588235294,32,2,21,33.87938273121979,0.6490885416666667,43.118686868686865,1027.5252525252522,32.11016414141413,0
343,4,0,1,33,0.0,0.029411764705882353,0.9705882352941176,34,1200,800,400,0.6666666666666666,16,8,8,363.9722227549807,0.4264334521687463,0.11535462349908654,0.2185174427991768,132268.09007052865,2828.382148505266,135096.47221903392,278,8,117.1470588235294,32,2,21,33.47448958716909,0.6520182291666667,42.834595959595966,1028.661616161617,32.145675505050534,0
344,4,0,0,33,0.0,0.0,1.0,33,900,600,300,0.6666666666666666,12,6,6,397.4073094452756,0.4260969065656566,0.12020990430833023,0.21943037634016357,129030.63441221525,3655.6072205582527,132686.2416327735,279,9,121.33333333333333,30,3,20,35.90725184107244,0.6246527777777777,46.001344086021504,1015.9946236559138,33.866487455197124,8
345,4,1,0,34,0.029411764705882353,0.0,1.0,34,650,600,50,0.9230769230769231,7,6,1,389.36251264678975,0.4287730243612597,0.11022258365711846,0.2166452954983422,129333.80126953138,3271.5467664930698,132605.34803602446,280,0,118.73529411764706,31,3,21,35.801757979177324,0.625,45.70312500000001,1017.187500000001,32.812500000000036,0
346,4,1,1,34,0.02857142857142857,0.02857142857142857,0.9714285714285714,35,600,400,200,0.6666666666666666,8,4,4,379.767058145209,0.4309873949579832,0.10938330204385238,0.21301815653680511,129651.06398581785,2847.440631058064,132498.5046168759,281,0,116.31428571428572,32,3,18,35.72221877841143,0.6256510416666667,45.391414141414145,1018.434343434344,31.82607323232325,0
347,4,2,0,36,0.05555555555555555,0.0,1.0,36,1100,800,300,0.7272727272727273,14,8,6,374.0108288213246,0.4330687830687831,0.12551020408163316,0.2130991931656386,130262.5868055557,2543.9236111111354,132806.51041666683,282,0,114.0,33,3,20,35.2465986394558,0.6294191919191919,44.79166666666668,1020.8333333333345,30.93434343434347,0
348,4,2,0,38,0.05263157894736842,0.0,1.0,38,1150,900,250,0.782608695652174,14,9,5,356.3604050725185,0.4348921289710763,0.1321146680317622,0.20648353221829685,130913.23329260979,1730.4585691015138,132643.6918617113,283,0,108.94736842105263,35,3,19,35.03779310864811,0.631547619047619,44.155092592592595,1023.3796296296301,29.239417989418005,0
349,4,0,0,38,0.0,0.0,1.0,38,1450,1000,450,0.6896551724137931,19,10,9,360.8052738801016,0.4353366524419156,0.13307794803464335,0.21002664890073286,131090.96364883403,1859.662208504801,132950.62585733883,284,1,109.94736842105263,35,3,19,34.74419831223628,0.6333333333333333,43.98148148148148,1024.0740740740741,29.25925925925926,0
350,4,0,1,37,0.0,0.02631578947368421,0.9736842105263158,38,1050,500,550,0.47619047619047616,16,5,11,360.7677230297498,0.4347291370317686,0.13377267295653517,0.21081694072490956,131239.16437596473,1869.370900848783,133108.53527681352,285,2,110.94736842105263,35,3,19,34.59526431718061,0.6348214285714286,43.836805555555564,1024.6527777777794,29.275793650793698,0
351,4,0,0,37,0.0,0.0,1.0,37,1050,600,450,0.5714285714285714,15,6,9,372.3258608412808,0.43327702702702703,0.14243761483738293,0.21721112085011693,131175.6395266441,2368.016581632671,133543.65610827677,286,3,114.83783783783784,34,3,19,34.36349990315709,0.6363357843137255,43.89880952380953,1024.4047619047628,30.12955182072832,0
352,4,0,0,37,0.0,0.0,1.0,37,1300,1100,200,0.8461538461538461,15,11,4,383.9529612976238,0.4334021521521521,0.13071790733062705,0.21134274042818987,128907.38195516102,2498.874206961573,131406.2561621226,287,4,115.83783783783784,35,2,17,36.374990502241474,0.6113095238095239,46.122685185185176,1015.5092592592579,29.014550264550223,8
353,4,1,1,37,0.02631578947368421,0.02631578947368421,0.9736842105263158,38,900,700,200,0.7777777777777778,11,7,4,383.049307505038,0.43523293029871973,0.1522363930303574,0.21337157243151347,129377.9538001543,2311.9620198902603,131689.91582004455,288,0,113.76315789473684,35,3,19,35.91723549488055,0.6160714285714286,45.65972222222222,1017.361111111111,29.067460317460313,0
354,4,2,0,39,0.05128205128205128,0.0,1.0,39,1000,700,300,0.7,13,7,6,377.812159026793,0.4351664417453891,0.16780230299116994,0.2135275460567156,129946.64216581451,2019.0842869896992,131965.7264528042,289,0,111.64102564102564,36,3,19,35.47097047345557,0.6197916666666667,45.101351351351354,1019.594594594595,28.322072072072086,0
355,4,0,0,39,0.0,0.0,1.0,39,1450,1000,450,0.6896551724137931,19,10,9,374.17730216510944,0.43446356275303644,0.16856285730457898,0.2124089196501188,130118.92804967146,1937.5098916484253,132056.4379413199,290,1,112.64102564102564,36,3,19,35.388383002207526,0.6215277777777778,44.93243243243244,1020.2702702702717,28.34084084084088,0
356,4,0,1,38,0.0,0.02564102564102564,0.9743589743589743,39,1400,900,500,0.6428571428571429,19,9,10,369.2383725728594,0.43406995051731895,0.16873339614153915,0.21006951479145186,130205.11379200163,1815.3448634445454,132020.4586554462,291,2,113.64102564102564,36,3,19,35.4267810511604,0.6223958333333333,44.84797297297298,1020.6081081081095,28.350225225225262,0
357,4,1,0,39,0.02564102564102564,0.0,1.0,39,1150,700,450,0.6086956521739131,16,7,9,387.13510019323144,0.43592555105713,0.1983625154998203,0.20890010619310237,128115.23604948958,2169.708145312918,130284.9441948025,292,0,113.94871794871794,35,4,18,37.105698144125604,0.6032738095238095,46.90393518518517,1012.3842592592569,28.925264550264483,8
358,4,1,1,39,0.025,0.025,0.975,40,1300,1000,300,0.7692307692307693,16,10,6,375.2247099581352,0.4390090811965812,0.19964941972920713,0.20420123689300612,128454.92118415986,1639.9021557435958,130094.82333990345,293,0,112.075,33,7,19,37.05925612508059,0.6111111111111112,46.56862745098039,1013.7254901960778,30.718954248365993,0
359,4,0,0,39,0.0,0.0,1.0,39,1150,800,350,0.6956521739130435,15,8,7,380.3715518859073,0.43839968511021143,0.21102915349490714,0.20721733796769579,128496.33487654322,1975.2700617283967,130471.60493827162,294,1,115.35897435897436,32,7,19,36.88641552511415,0.6139322916666667,46.52777777777778,1013.8888888888889,31.68402777777778,0
360,4,0,1,38,0.0,0.02564102564102564,0.9743589743589743,39,1750,1400,350,0.8,21,14,7,380.5371987550912,0.4369939271255061,0.21967143082680907,0.20887936496278484,128796.78376405725,2002.393460447924,130799.17722450518,295,2,116.35897435897436,33,6,19,36.57478671173889,0.6145833333333333,46.23161764705883,1015.073529411766,30.75980392156867,0
361,4,1,0,39,0.02564102564102564,0.0,1.0,39,650,400,250,0.6153846153846154,9,4,5,378.22249473969504,0.437246963562753,0.22594665157097293,0.2085885734462633,128983.44574502615,1956.888125961196,130940.33387098735,296,0,116.43589743589743,33,6,20,36.44275043229983,0.6164772727272727,46.04779411764707,1015.8088235294134,30.782085561497375,0
362,4,2,0,41,0.04878048780487805,0.0,1.0,41,1100,700,400,0.6363636363636364,15,7,8,361.3776405506426,0.4402439024390244,0.23415220802839443,0.20344313345826642,129793.87622849391,1181.2888972991282,130975.16512579305,297,0,111.70731707317073,33,8,20,36.04517438364402,0.6246843434343434,45.251225490196084,1018.9950980392163,30.878639334521704,0
363,4,0,0,41,0.0,0.0,1.0,41,1550,1100,450,0.7096774193548387,20,11,9,358.10847199380186,0.4400914634146342,0.23401758194176248,0.20198450179255156,129867.92091836737,1101.3605442176909,130969.28146258506,298,1,112.70731707317073,34,7,20,36.053200186872225,0.6231617647058824,45.17857142857143,1019.2857142857144,29.97899159663866,0
364,4,0,0,41,0.0,0.0,1.0,41,1300,900,400,0.6923076923076923,17,9,8,355.525652526806,0.4394563008130081,0.23593177108241692,0.2014645364318567,130050.0,1047.2222222222224,131097.22222222222,299,2,113.70731707317073,34,7,20,35.93409586056645,0.625,45.0,1020.0,30.0,0
365,4,0,0,41,0.0,0.0,1.0,41,1700,1400,300,0.8235294117647058,20,14,6,351.83131391501195,0.43866869918699186,0.23118525831239878,0.20014929357620434,130201.83000283457,961.8161848072675,131163.64618764183,300,3,114.70731707317073,34,7,21,35.87425638632918,0.626531862745098,44.85119047619048,1020.5952380952389,30.017507002801143,0
366,4,0,0,41,0.0,0.0,1.0,41,1200,800,400,0.6666666666666666,16,8,8,352.0267515486103,0.437474593495935,0.23336416753509748,0.20089636259609775,130325.14537677847,975.6016867531703,131300.74706353163,301,4,115.70731707317073,33,8,21,35.74421907505201,0.630050505050505,44.73039215686276,1021.0784313725514,30.941770647653073,0
367,4,0,0,41,0.0,0.0,1.0,41,1250,800,450,0.64,17,8,9,350.68317409283407,0.4373983739837399,0.23138096255557516,0.20029080806823799,130356.43029423807,942.7613477989592,131299.19164203704,302,5,116.70731707317073,33,8,21,35.746804872194886,0.6303661616161615,44.6997549019608,1021.2009803921592,30.945484254307853,0
368,4,0,0,41,0.0,0.0,1.0,41,1200,800,400,0.6666666666666666,16,8,8,353.3953309399202,0.4376778455284553,0.22923728937493149,0.2028192473990364,130544.21864487234,1026.7434700596068,131570.96211493196,303,6,117.70731707317073,33,8,18,35.48724367430146,0.632260101010101,44.515931372549026,1021.9362745098053,30.967765894236525,0
369,4,1,1,41,0.023809523809523808,0.023809523809523808,0.9761904761904762,42,1200,800,400,0.6666666666666666,16,8,8,344.69585273781365,0.43832268679829656,0.2356100870745219,0.19987838857445833,130942.84664619782,627.0912369255936,131569.9378831234,304,0,115.88095238095238,35,7,19,35.30629217083192,0.6318452380952381,44.12615740740741,1023.4953703703713,29.242724867724895,0
370,4,0,0,41,0.0,0.0,1.0,41,1000,500,500,0.5,15,5,10,353.07741794223296,0.4380589430894309,0.23799997162275188,0.20435692977868664,130870.93431122464,1041.5143140589685,131912.4486252836,305,1,119.51219512195122,34,7,19,35.164582121388385,0.6332720588235294,44.19642857142858,1023.2142857142869,30.094537815126085,0
371,4,0,0,41,0.0,0.0,1.0,41,950,700,250,0.7368421052631579,12,7,5,351.5095285030422,0.4377794715447154,0.2342337230514333,0.20377123510051626,130931.84700963726,1004.7583616780164,131936.60537131527,306,2,120.51219512195122,34,7,19,35.14307316505759,0.6338848039215687,44.136904761904766,1023.4523809523815,30.101540616246517,0
372,4,0,0,41,0.0,0.0,1.0,41,1450,1300,150,0.896551724137931,16,13,3,365.25368391628615,0.43762703252032525,0.1489897142522716,0.2022850136506476,129149.73416121364,1258.8915408271298,130408.62570204076,307,3,121.51219512195122,40,1,18,36.60247117243219,0.6046875,45.88414634146342,1016.463414634147,25.411585365853675,8
373,4,4,2,43,0.08888888888888889,0.044444444444444446,0.9555555555555556,45,1700,1400,300,0.8235294117647058,20,14,6,337.2018447503649,0.44093013468013464,0.17763277143375023,0.19318199143175144,130475.34722222242,-195.87908569632424,130279.46813652609,308,0,111.62222222222222,39,6,21,35.97063621533442,0.6196581196581197,44.58333333333334,1021.6666666666682,26.196581196581235,0
374,4,1,1,43,0.022727272727272728,0.022727272727272728,0.9772727272727273,44,1300,1000,300,0.7692307692307693,16,10,6,335.3292440955182,0.43952607470049326,0.20163425313104533,0.19383569783767476,130821.45317925388,-26.348198784682154,130795.1049804692,309,0,114.1590909090909,39,5,19,35.6685715982758,0.6231303418803419,44.244791666666686,1023.0208333333366,26.231303418803503,0
375,4,0,0,43,0.0,0.0,1.0,43,1600,1000,600,0.625,22,10,12,334.12006752917034,0.438468992248062,0.1963719035665228,0.19300347430214468,130794.81336805588,140.2343750000352,130935.04774305591,310,1,117.79069767441861,39,4,19,35.72640868974882,0.6228632478632479,44.27083333333335,1022.9166666666692,26.228632478632544,0
376,4,0,0,43,0.0,0.0,1.0,43,1000,700,300,0.7,13,7,6,337.0925030268892,0.4378691399040236,0.2045801526717559,0.19539432697576326,130928.03955078138,226.97211371529391,131155.01166449668,311,2,118.79069767441861,39,4,19,35.51579728583546,0.624198717948718,44.14062500000001,1023.437500000001,26.241987179487207,0
377,4,0,1,42,0.0,0.023255813953488372,0.9767441860465116,43,1150,700,450,0.6086956521739131,16,7,9,334.2654421205499,0.4376845699520118,0.2066615554987643,0.19415843765725574,131008.00781250013,158.28993055557112,131166.2977430557,312,3,119.79069767441861,39,4,19,35.507393840727175,0.625,44.06250000000001,1023.750000000001,26.250000000000025,0
378,4,0,1,41,0.0,0.023809523809523808,0.9761904761904762,42,1150,1000,150,0.8695652173913043,13,10,3,350.90772549538127,0.4361449864498645,0.17570682513956437,0.19228247480519528,128728.04763244433,664.6284193212989,129392.67605176562,313,4,123.0952380952381,37,5,17,37.39679002341076,0.6055743243243243,46.29934210526314,1014.8026315789452,27.427098150782303,8
379,4,0,0,41,0.0,0.0,1.0,41,1400,1000,400,0.7142857142857143,18,10,8,353.8159528816473,0.43460365853658534,0.16808019316293787,0.1949671131197319,128950.68825263518,924.9621277700546,129875.65038040523,314,5,125.95121951219512,37,4,19,37.09595073590269,0.6078265765765766,46.08004385964911,1015.6798245614015,27.450806069227067,0
380,4,1,0,42,0.023809523809523808,0.0,1.0,42,1400,1000,400,0.7142857142857143,18,10,8,349.60778435608313,0.4346689895470383,0.17735223356525154,0.19445273474185157,129319.08543381322,642.9221796996164,129962.00761351283,315,0,123.92857142857143,35,7,20,36.82768168714914,0.6154761904761905,45.71759259259258,1017.1296296296279,29.06084656084651,0
381,4,0,0,42,0.0,0.0,1.0,42,1250,1100,150,0.88,14,11,3,352.86272728490576,0.4339914827719706,0.18897625004061158,0.19714579566349807,129495.73072059317,738.8433427640437,130234.57406335721,316,1,124.92857142857143,35,7,17,36.565177014631175,0.6172619047619048,45.543981481481474,1017.8240740740732,29.080687830687808,0
382,4,0,0,42,0.0,0.0,1.0,42,1000,800,200,0.8,12,8,4,351.7120317515751,0.4338584010840108,0.18989958031205423,0.197181147125201,129631.08114448898,718.5621854962938,130349.64332998528,317,2,125.92857142857143,36,6,18,36.45683585830659,0.6166087962962963,45.41103603603603,1018.355855855855,28.28766266266264,0
383,4,0,0,42,0.0,0.0,1.0,42,1550,1200,350,0.7741935483870968,19,12,7,349.2633603325521,0.43303571428571425,0.18168214336961697,0.19645006926211078,129759.37307633094,664.0389350569137,130423.41201138786,318,3,126.92857142857143,37,5,18,36.38882910030133,0.615990990990991,45.28508771929823,1018.8596491228052,27.53674727358933,0
384,4,0,1,41,0.0,0.023809523809523808,0.9761904761904762,42,1050,400,650,0.38095238095238093,17,4,13,333.2433166068125,0.43283004258614016,0.17607632785825422,0.174158425109148,126822.83676674712,62.972383691527,126885.80915043864,319,4,127.92857142857143,38,4,15,39.792152807240846,0.5844298245614035,48.18376068376069,1007.264957264958,26.506972559604158,8
385,4,1,1,41,0.023809523809523808,0.023809523809523808,0.9761904761904762,42,1250,900,350,0.72,16,9,7,331.471207483552,0.4353585946573752,0.17163297751533046,0.17403621828643928,127011.23078977653,20.113206771868846,127031.3439965484,320,0,128.02380952380952,38,4,16,39.64361420243773,0.5863486842105263,47.996794871794876,1008.012820512821,26.526653171390027,0
386,4,0,2,39,0.0,0.04878048780487805,0.9512195121951219,41,1300,1100,200,0.8461538461538461,15,11,4,352.3439554148134,0.43442581300813005,0.10957517605054634,0.18055520394701682,126017.68798828126,680.314127604167,126698.00211588544,321,1,130.4390243902439,39,2,19,40.139991181657834,0.5745192307692308,48.984375,1004.0625000000001,25.74519230769231,7
387,4,3,2,40,0.07142857142857142,0.047619047619047616,0.9523809523809523,42,850,500,350,0.5882352941176471,12,5,7,334.0480344030186,0.44080284552845533,0.11354261449802894,0.1736607331168009,126607.70052596963,58.61612554444818,126666.31665151408,322,0,124.54761904761905,38,4,13,39.9927016985138,0.5822368421052632,48.39743589743589,1006.4102564102553,26.484480431848823,0
388,4,2,1,41,0.047619047619047616,0.023809523809523808,0.9761904761904762,42,1100,900,200,0.8181818181818182,13,9,4,345.42288797136956,0.44118999225706546,0.14978244848925337,0.18124135289888196,126984.3087972093,372.65733435603715,127356.96613156534,323,0,125.5,38,4,17,39.31965938802911,0.5860745614035088,48.023504273504265,1007.9059829059819,26.523841655420576,0
389,4,1,0,42,0.023809523809523808,0.0,1.0,42,1250,1000,250,0.8,15,10,5,345.6796922020769,0.43996806039488967,0.16684263097696395,0.18247841927431477,127230.25504241673,396.22873746779965,127626.48377988453,324,0,126.4047619047619,37,5,18,39.06085842118608,0.5903716216216216,47.77960526315788,1008.8815789473671,27.267069701280192,0
390,4,0,1,41,0.0,0.023809523809523808,0.9761904761904762,42,1500,1000,500,0.6666666666666666,20,10,10,333.87707051254677,0.43930265195509094,0.1312123855856384,0.17351190845732736,126593.58859592021,53.339301215282035,126646.9278971355,325,1,127.4047619047619,39,3,18,40.01149380671428,0.5803952991452992,48.411458333333336,1006.3541666666673,25.80395299145301,8
391,4,0,0,41,0.0,0.0,1.0,41,1000,600,400,0.6,14,6,8,339.1978108848987,0.4364075203252033,0.13728311731334575,0.17680310673557992,126715.24581780996,396.30679742859047,127111.55261523856,326,2,131.46341463414635,38,3,18,39.752670486700595,0.5833333333333333,48.29059829059829,1006.8376068376072,26.495726495726505,0
392,4,1,1,41,0.023809523809523808,0.023809523809523808,0.9761904761904762,42,1300,900,400,0.6923076923076923,17,9,8,333.0113473139903,0.4401253387533875,0.13737389023405977,0.17542562046004834,127145.88355613984,68.7636971290668,127214.64725326891,327,0,129.3095238095238,38,4,19,39.466807909604505,0.5877192982456141,47.86324786324786,1008.5470085470076,26.540710751237043,0
393,4,0,1,40,0.0,0.024390243902439025,0.975609756097561,41,1500,1000,500,0.6666666666666666,20,10,10,341.2449285452485,0.43899898373983737,0.1497451231440905,0.18013738310641586,127230.25504241673,483.33585814863704,127713.59090056537,328,1,132.5121951219512,37,4,21,39.17271220519506,0.5903716216216216,47.77960526315788,1008.8815789473671,27.267069701280192,0
394,4,1,2,39,0.024390243902439025,0.04878048780487805,0.9512195121951219,41,1450,1100,350,0.7586206896551724,18,11,7,334.49973105659365,0.4407520325203252,0.16969503169339162,0.17833700430288962,127631.2242037402,338.5220341149782,127969.74623785519,329,0,133.02439024390245,38,3,15,38.93242933671671,0.5926535087719298,47.38247863247863,1010.4700854700852,26.591318038686452,0
395,4,1,0,40,0.025,0.0,1.0,40,800,700,100,0.875,9,7,2,340.48776561614926,0.4385016025641026,0.18877927146574103,0.1825964622118236,127867.13219452165,707.4388273315102,128574.57102185316,330,0,133.95,37,3,16,38.53985978606534,0.5968468468468469,47.149122807017555,1011.4035087719319,27.33522996680897,0
396,4,0,0,40,0.0,0.0,1.0,40,1300,900,400,0.6923076923076923,17,9,8,342.66341165172844,0.4384748931623932,0.19265279583875183,0.18427144304907644,127978.05574792257,770.6794398276575,128748.73518775022,331,1,134.95,37,3,16,38.37144198815201,0.597972972972973,47.039473684210535,1011.8421052631589,27.347083926031324,0
397,4,1,0,41,0.024390243902439025,0.0,1.0,41,1250,1000,250,0.8,15,10,5,335.6014046484111,0.4407520325203252,0.18609243897158612,0.18172835733540585,128255.57503270256,408.6584333641353,128664.2334660667,332,0,132.6341463414634,37,4,18,38.26676048206685,0.6007882882882882,46.76535087719299,1012.9385964912295,27.376718824087284,0
398,4,2,1,42,0.046511627906976744,0.023255813953488372,0.9767441860465116,43,850,700,150,0.8235294117647058,10,7,3,323.23172804212896,0.44469822812846066,0.2023950124188476,0.1776954119135159,128857.43408203153,-269.83778211802667,128587.5962999135,333,0,127.4186046511628,39,4,14,37.96734465305565,0.6033653846153846,46.171875000000014,1015.3125000000022,26.0336538461539,0
399,4,1,1,42,0.023255813953488372,0.023255813953488372,0.9767441860465116,43,1100,800,300,0.7272727272727273,14,8,6,321.13105528558856,0.4431755260243632,0.21205639767370288,0.1772490765252039,129016.12548828153,-313.78309461802786,128702.3423936635,334,0,128.37209302325581,39,4,15,37.85939796301994,0.6049679487179487,46.015625000000014,1015.9375000000022,26.049679487179542,0
400,4,1,0,43,0.023255813953488372,0.0,1.0,43,1600,1300,300,0.8125,19,13,6,319.677112337859,0.4449981543004799,0.2063203223993213,0.17775212556189393,129307.31336805566,-332.6822916666562,128974.631076389,335,0,122.3953488372093,39,4,17,37.600710091492545,0.607905982905983,45.72916666666667,1017.0833333333343,26.079059829059855,0
401,4,0,1,42,0.0,0.023255813953488372,0.9767441860465116,43,1300,900,400,0.6923076923076923,17,9,8,323.7512951413735,0.44419066076042824,0.21527695127466617,0.18074572305892672,129466.28146701383,-217.0247395833386,129249.25672743049,336,1,123.3953488372093,39,4,13,37.3358068918458,0.6095085470085471,45.572916666666664,1017.7083333333328,26.095085470085458,0
402,4,0,0,42,0.0,0.0,1.0,42,1200,700,500,0.5833333333333334,17,7,10,323.8691380638133,0.4447469028261711,0.1962648590824112,0.18084275552144685,129473.07715136232,-13.53322010374282,129459.54393125858,337,2,119.88095238095238,38,4,13,37.32591503954092,0.6112938596491229,45.56623931623931,1017.735042735042,26.78250112460637,0
403,4,0,2,40,0.0,0.047619047619047616,0.9523809523809523,42,1700,1300,400,0.7647058823529411,21,13,8,325.4757040500709,0.444190379403794,0.20675797855069877,0.18262271257853607,129663.42872242325,40.45915059538575,129703.88787301864,338,3,120.88095238095238,38,4,13,37.09198748207981,0.6132127192982456,45.37927350427351,1018.482905982907,26.80218173639229,0
404,4,0,0,40,0.0,0.0,1.0,40,1550,1200,350,0.7741935483870968,19,12,7,341.7655443869835,0.44226762820512816,0.20763679448513583,0.19114164542703355,129536.0351261928,854.1907125269466,130390.22583871975,339,5,127.275,37,3,14,36.80660275743214,0.6137387387387387,45.50438596491229,1017.9824561403518,27.513039355144645,0
405,4,0,0,40,0.0,0.0,1.0,40,1500,1000,500,0.6666666666666666,20,10,10,346.1427478138682,0.44174679487179486,0.21017382413087904,0.19455609618503625,129731.44531250003,981.1197916666672,130712.5651041667,340,6,128.275,37,3,14,36.496676891615536,0.6157094594594594,45.3125,1018.7500000000002,27.53378378378379,0
406,4,0,1,39,0.0,0.025,0.975,40,1800,1400,400,0.7777777777777778,22,14,8,348.5060404571792,0.4408787393162393,0.2005133856574559,0.19728878163677588,130010.85820877599,1061.9138821560684,131072.77209093206,341,7,129.275,37,3,15,36.1528106296814,0.6185247747747749,45.038377192982466,1019.8464912280718,27.563418681839778,0
407,4,0,0,39,0.0,0.0,1.0,39,1100,900,200,0.8181818181818182,13,9,4,354.89866927118845,0.44109874044084574,0.19686329786782353,0.20131665904368784,130090.20580969482,1433.768185415141,131523.97399510996,342,8,128.12820512820514,36,3,15,35.909270706847686,0.6212384259259259,44.960585585585584,1020.1576576576575,28.337712712712708,0
408,4,0,0,39,0.0,0.0,1.0,39,1350,1000,350,0.7407407407407407,17,10,7,357.57141742815674,0.4406770130454341,0.20460763261160508,0.20343187420912642,130205.11379200139,1511.5254190000721,131716.63921100146,343,9,129.12820512820514,36,3,15,35.72446577660082,0.6223958333333333,44.84797297297297,1020.6081081081076,28.35022522522521,0
409,4,1,1,39,0.025,0.025,0.975,40,1350,1200,150,0.8888888888888888,15,12,3,348.0516358172259,0.4415197649572649,0.19238842975206616,0.1997829598381607,130550.1420973336,1087.6507842301514,131637.79288156377,344,0,126.875,36,4,13,35.617768595041305,0.6258680555555556,44.51013513513512,1021.9594594594578,28.387762762762716,0
410,4,0,0,39,0.0,0.0,1.0,39,1000,700,300,0.7,13,7,6,357.9150164581167,0.4386246063877643,0.20199133293832006,0.20517362112287327,130498.99798525349,1541.5102023319284,132040.50818758542,345,11,131.12820512820514,35,4,13,35.417610632834915,0.6273809523809524,44.56018518518517,1021.759259259257,29.19312169312163,0
411,4,1,0,40,0.025,0.0,1.0,40,1200,900,300,0.75,15,9,6,348.8664515246301,0.43985042735042734,0.20807844647375995,0.20235144721808307,130953.2521330451,1137.039277453121,132090.2914104982,346,0,128.825,36,4,14,35.18905636850406,0.6299189814814814,44.11599099099099,1023.5360360360352,28.431556556556533,0
412,4,0,0,40,0.0,0.0,1.0,40,1600,1200,400,0.75,20,12,8,351.6413545735095,0.4393963675213675,0.21281198460692696,0.20488008455131773,131126.20380092936,1221.8791849281765,132348.08298585753,347,1,129.825,36,4,15,34.9431922301631,0.6316550925925926,43.947072072072075,1024.211711711712,28.450325325325334,0
413,4,1,0,41,0.024390243902439025,0.0,1.0,41,1150,800,350,0.6956521739130435,15,8,7,341.1179152976599,0.4388719512195122,0.20892145439569143,0.20112415459610605,131581.1250216412,776.9358119805972,132358.0608336218,348,0,127.63414634146342,37,4,14,34.753727156139774,0.6342905405405406,43.503289473684205,1025.9868421052627,27.729374110953046,0
414,4,0,0,41,0.0,0.0,1.0,41,950,800,150,0.8421052631578947,11,8,3,343.4356570634281,0.4385670731707317,0.21341789104249353,0.20308914629000321,131693.64762474992,845.6588806171108,132539.30650536704,349,1,128.6341463414634,37,4,16,34.5808629776021,0.6354166666666667,43.39364035087719,1026.4254385964912,27.74122807017544,0
415,4,0,0,41,0.0,0.0,1.0,41,1550,1100,450,0.7096774193548387,20,11,9,340.00904755782955,0.4377794715447154,0.20959722891409438,0.2016583109803085,131806.21831957897,763.0613506078716,132569.27967018684,350,2,129.6341463414634,37,4,16,34.55541466453107,0.6365427927927928,43.28399122807017,1026.8640350877183,27.753082029397792,0
416,4,0,2,39,0.0,0.04878048780487805,0.9512195121951219,41,900,700,200,0.7777777777777778,11,7,4,340.21946191920154,0.4374237804878049,0.2138227873150942,0.20208216232068213,131862.52170138876,772.4392361110906,132634.96093749985,351,3,130.6341463414634,37,4,16,34.493323191345496,0.6371058558558558,43.22916666666666,1027.0833333333321,27.759009009008977,0
417,4,0,0,39,0.0,0.0,1.0,39,1250,1000,250,0.8,15,10,5,350.8574753770392,0.43671277552856497,0.2065564552406658,0.208321626005117,131848.0642804967,1451.9757933609253,133300.04007385764,352,4,132.43589743589743,36,3,16,34.23474049707603,0.6388888888888888,43.24324324324324,1027.0270270270269,28.528528528528525,0
418,4,0,0,39,0.0,0.0,1.0,39,1150,1000,150,0.8695652173913043,13,10,3,357.57403680589374,0.43671277552856497,0.21690510747114566,0.19871175502544414,129285.00987082558,1445.7925756001805,130730.80244642576,353,5,133.43589743589743,37,2,16,36.6598158131177,0.611204954954955,45.75109649122807,1016.9956140350872,27.486367946894248,8
419,4,0,0,39,0.0,0.0,1.0,39,1100,800,300,0.7272727272727273,14,8,6,354.91329794640234,0.4357849752586595,0.20833770870524004,0.19776707643906302,129391.54071015041,1384.5556879611256,130776.09639811153,354,6,134.43589743589743,38,1,18,36.61901886660365,0.6104714912280702,45.646367521367516,1017.4145299145293,26.77406657669814,0
420,4,1,1,39,0.025,0.025,0.975,40,1100,600,500,0.5454545454545454,16,6,10,347.56462209508993,0.43755341880341886,0.21119631901840474,0.19535528759137813,129731.44531250001,1018.012152777778,130749.4574652778,355,0,132.05,39,1,15,36.46046353101567,0.6121794871794872,45.3125,1018.7500000000001,26.121794871794876,0
421,4,1,0,40,0.025,0.0,1.0,40,650,400,250,0.6153846153846154,9,4,5,349.2062118825911,0.43593750000000003,0.21776806705509588,0.1966772809929412,129811.04736328125,1066.1648220486113,130877.21218532986,356,0,132.8,39,1,16,36.33780111758493,0.6129807692307692,45.234375,1019.0625,26.129807692307693,0
422,4,0,0,40,0.0,0.0,1.0,40,1200,600,600,0.5,18,6,12,351.0983733783095,0.43533653846153847,0.22019820187985317,0.1984151777498205,129943.77170138882,1124.6093749999955,131068.38107638882,357,1,133.8,39,1,16,36.15481542024248,0.6143162393162394,45.104166666666664,1019.5833333333327,26.143162393162378,0
423,4,0,0,40,0.0,0.0,1.0,40,1450,1000,450,0.6896551724137931,19,10,9,347.3156691870649,0.4353899572649573,0.20825163398692847,0.19681221253933678,130050.0,1033.680555555556,131083.68055555556,358,2,134.8,39,1,16,36.14345043572985,0.6153846153846154,45.0,1020.0,26.153846153846153,0
424,4,0,0,40,0.0,0.0,1.0,40,1400,1000,400,0.7142857142857143,18,10,8,344.63082485981295,0.43476228632478636,0.2004311664455558,0.1962253023126848,130236.00396050341,976.6682942708246,131212.67225477422,359,3,135.8,39,1,16,36.023339966663265,0.6172542735042735,44.81770833333333,1020.7291666666661,26.172542735042718,0
425,4,0,0,40,0.0,0.0,1.0,40,1050,700,350,0.6666666666666666,14,7,7,347.6177336646105,0.43528311965811967,0.200703525473376,0.1986179268439933,130371.67302441725,1063.903814835909,131435.57683925316,360,4,136.8,38,2,16,35.80962095058756,0.6203399122807017,44.68482905982905,1021.2606837606824,26.875281151596905,0
426,4,0,1,39,0.0,0.025,0.975,40,950,600,350,0.631578947368421,13,6,7,344.16962308151795,0.43414797008547007,0.20264807829544318,0.19730916614883726,130501.95448133661,982.9616970485923,131484.9161783852,361,5,137.8,39,1,12,35.765729602066116,0.6199252136752137,44.55729166666666,1021.7708333333318,26.199252136752097,0
427,4,1,1,39,0.025,0.025,0.975,40,1350,1000,350,0.7407407407407407,17,10,7,342.9749661131518,0.43414797008547007,0.2099667361731712,0.19885439745109645,130937.7904707017,981.6768499239604,131919.46732062567,362,0,136.175,40,0,14,35.35543474663224,0.62265625,44.1310975609756,1023.4756097560955,25.58689024390239,0
428,4,0,1,38,0.0,0.02564102564102564,0.9743589743589743,39,1400,1200,200,0.8571428571428571,16,12,4,346.8746169094325,0.43080859199280247,0.2054204700245812,0.20120365913530616,130954.6929253473,1284.971788194449,132239.66471354174,363,1,140.48717948717947,39,0,15,35.23856774543727,0.624465811965812,44.114583333333336,1023.5416666666673,26.244658119658137,0
429,4,0,0,38,0.0,0.0,1.0,38,1700,1400,300,0.8235294117647058,20,14,6,353.0970407719133,0.43050616405879566,0.20898898613109074,0.20563719519073867,131109.19922017664,1658.854052523916,132768.05327270055,364,2,143.73684210526315,38,0,15,34.923108352458456,0.6277412280701755,43.96367521367521,1024.1452991452982,26.951192082771005,0
430,4,0,1,37,0.0,0.02631578947368421,0.9736842105263158,38,850,400,450,0.47058823529411764,13,4,9,353.63130120386325,0.4308469653864391,0.2162185145967177,0.20697895499991834,131300.74929003217,1686.4109640952647,132987.16025412743,365,3,144.73684210526315,38,0,15,34.7158518364085,0.6296600877192983,43.776709401709404,1024.8931623931626,26.97087269455691,0
431,4,0,0,37,0.0,0.0,1.0,37,1300,900,400,0.6923076923076923,17,9,8,360.40033654331995,0.43068068068068066,0.21716483738955672,0.21062796403985776,131243.84576263858,2060.065236418908,133303.9109990575,366,4,147.59459459459458,37,0,15,34.5999420367398,0.6309121621621622,43.83223684210527,1024.6710526315794,27.69381223328593,0
432,4,0,0,37,0.0,0.0,1.0,37,1150,700,450,0.6086956521739131,16,7,9,358.6690214833623,0.4304617117117117,0.21548786515100304,0.21054074198938602,131412.43128895422,2026.713628231756,133439.14491718597,367,5,148.59459459459458,37,0,15,34.473919901614785,0.6326013513513513,43.66776315789473,1025.3289473684206,27.711593172119475,0
433,4,0,0,37,0.0,0.0,1.0,37,900,500,400,0.5555555555555556,13,5,8,357.68457171874854,0.4301488988988989,0.21959098290079737,0.21042650841869015,131496.76462950135,2006.8727877808542,133503.6374172822,368,6,149.59459459459458,37,0,16,34.41397619556696,0.6334459459459459,43.58552631578947,1025.6578947368419,27.720483641536266,0
434,4,0,0,37,0.0,0.0,1.0,37,1000,600,400,0.6,14,6,8,362.40138067061133,0.4288663663663664,0.22449757449757435,0.21414627039627046,131665.51246537405,2143.1527008310354,133808.6651662051,369,7,150.59459459459458,37,0,14,34.12259615384615,0.6351351351351351,43.42105263157895,1026.3157894736848,27.73826458036986,0
435,4,0,0,37,0.0,0.0,1.0,37,1150,500,650,0.43478260869565216,18,5,13,343.95905453312054,0.4285222722722723,0.12905799927943806,0.19772744382502447,130607.6912004911,1586.7714712073082,132194.46267169842,370,8,151.59459459459458,36,1,16,35.66408688626934,0.6264467592592593,44.45382882882883,1022.1846846846852,28.394019019019034,8
436,4,0,0,37,0.0,0.0,1.0,37,1050,800,250,0.7619047619047619,13,8,5,342.046656946005,0.4275838338338338,0.1309807936101708,0.19736135567875565,130751.61944038619,1544.6308639720646,132296.25030435825,371,9,152.59459459459458,36,1,16,35.567376862658726,0.6278935185185186,44.313063063063055,1022.7477477477466,28.409659659659628,0
437,4,0,0,37,0.0,0.0,1.0,37,1000,500,500,0.5,15,5,10,342.87449847615073,0.42727102102102105,0.12701453379419503,0.19843042631556057,130866.8190995047,1574.1789931823491,132440.99809268705,372,10,153.59459459459458,36,1,17,35.429736224227746,0.6290509259259259,44.20045045045044,1023.1981981981966,28.422172172172125,0
438,4,0,0,37,0.0,0.0,1.0,37,850,600,250,0.7058823529411765,11,6,5,340.5252830285094,0.4261448948948949,0.1277808825103155,0.1979575366557035,131039.71370018646,1524.4671191461505,132564.1808193326,373,11,154.59459459459458,36,1,18,35.315158014371605,0.630787037037037,44.03153153153152,1023.8738738738722,28.440940940940894,0
439,4,0,1,36,0.0,0.02702702702702703,0.972972972972973,37,1700,1400,300,0.8235294117647058,20,14,6,368.1609007517727,0.4255505505505506,0.09694114155335853,0.19793742892816701,127968.81028163576,2076.0437344720767,130044.85401610783,374,12,155.59459459459458,35,2,18,37.73592999313658,0.6017857142857144,47.04861111111111,1011.8055555555552,28.908730158730148,8
440,4,0,1,35,0.0,0.027777777777777776,0.9722222222222222,36,800,400,400,0.5,12,4,8,375.6839654128771,0.425,0.10299386711649894,0.20165424220550948,127903.57320011331,2410.264314058948,130313.83751417226,375,13,158.77777777777777,34,2,18,37.61253971990114,0.6032475490196079,47.113095238095234,1011.5476190476186,29.751400560224077,0
441,4,0,0,35,0.0,0.0,1.0,35,1400,800,600,0.5714285714285714,20,8,12,384.93029265068196,0.423984593837535,0.10382059800664445,0.2069000322997415,127958.47750865048,2851.0188389081045,130809.49634755858,376,14,163.54285714285714,33,2,18,37.32235142118862,0.6060606060606061,47.05882352941176,1011.7647058823527,30.659536541889477,0
442,4,0,0,35,0.0,0.0,1.0,35,1150,800,350,0.6956521739130435,15,8,7,370.3294472346177,0.4241596638655462,0.09895686912776536,0.19171746986864516,126436.39458550341,2405.744025359827,128842.13861086324,377,15,164.54285714285714,31,4,17,39.256430174348345,0.5954301075268817,48.56770833333333,1005.7291666666661,32.442876344086,8
443,4,1,0,36,0.027777777777777776,0.0,1.0,36,1400,1000,400,0.7142857142857143,18,10,8,363.49704514359985,0.42782738095238093,0.09837610996229196,0.19021700879220416,126875.85791822826,2023.79989066701,128899.65780889527,378,0,160.94444444444446,33,3,19,38.975768357458534,0.5950126262626263,48.13112745098037,1007.475490196076,30.529560308972,0
444,4,0,1,35,0.0,0.027777777777777776,0.9722222222222222,36,750,500,250,0.6666666666666666,10,5,5,362.33825599200486,0.4283564814814815,0.09361614441877153,0.1898985008937062,126937.59799416056,1998.8695754036478,128936.4675695642,379,1,161.94444444444446,33,3,19,38.94145992946613,0.5956439393939394,48.06985294117645,1007.7205882352914,30.536987522281557,0
445,4,1,1,35,0.027777777777777776,0.027777777777777776,0.9722222222222222,36,1100,800,300,0.7272727272727273,14,8,6,353.31850562536374,0.4298115079365079,0.08793458164783141,0.1869010466885198,127314.91246110099,1796.7306511936326,129111.64311229462,380,0,160.5,32,4,14,38.781329496642904,0.6018880208333333,47.69570707070708,1009.2171717171724,31.538036616161637,0
446,4,1,0,36,0.027777777777777776,0.0,1.0,36,750,300,450,0.4,12,3,9,360.09867815475513,0.42987764550264546,0.11115276736371471,0.19184484837512358,127601.78330017373,1989.8466993164352,129591.62999949016,381,0,161.47222222222223,32,4,15,38.315941847871386,0.6048177083333333,47.41161616161618,1010.3535353535376,31.57354797979805,0
447,4,3,2,37,0.07692307692307693,0.05128205128205128,0.9487179487179487,39,1350,1200,150,0.8888888888888888,15,12,3,336.1700048257249,0.437246963562753,0.12522211586031662,0.1830026769588891,128466.99948827598,837.3503675840318,129304.34985586001,382,0,149.97435897435898,35,4,15,38.03670986033413,0.606845238095238,46.55671296296297,1013.7731481481488,28.96494708994711,0
448,4,2,2,37,0.05128205128205128,0.05128205128205128,0.9487179487179487,39,1100,700,400,0.6363636363636364,15,7,8,341.07932479467036,0.4364035087719298,0.15034938455691016,0.18718809001559833,128789.87295310377,985.5125814472133,129775.38553455098,383,0,150.82051282051282,35,4,17,37.583143291524124,0.6101190476190477,46.23842592592594,1015.0462962962979,29.001322751322796,0
449,4,0,0,37,0.0,0.0,1.0,37,1250,1000,250,0.8,15,10,5,356.9537575092459,0.43531031031031026,0.1634807129312621,0.1956276681624135,128734.59314025873,1790.4593485678802,130525.05248882661,384,1,150.8108108108108,33,4,18,37.23672161172162,0.6139520202020202,46.292892156862756,1014.8284313725504,30.752376708259103,0
450,4,1,0,38,0.02631578947368421,0.0,1.0,38,1300,1000,300,0.7692307692307693,16,10,6,351.0535189524079,0.4369517543859649,0.159882986134658,0.19422837921560013,129110.63102324282,1464.9482709750778,130575.5792942179,385,0,147.81578947368422,34,4,20,37.00314318066456,0.6155024509803921,45.92261904761906,1016.3095238095254,29.8914565826331,0
451,4,0,0,38,0.0,0.0,1.0,38,800,600,200,0.75,10,6,4,350.8026416543433,0.43662577050734946,0.1645653473339126,0.1946852087309777,129231.6485969388,1466.9607426303903,130698.60933956919,386,1,148.81578947368422,34,4,20,36.886293564375755,0.6167279411764706,45.80357142857143,1016.7857142857146,29.905462184873958,0
452,4,0,1,37,0.0,0.02631578947368421,0.9736842105263158,38,1050,600,450,0.5714285714285714,15,6,9,350.54741563454337,0.43650723091512567,0.16347089921009506,0.19469284943759885,129261.91184807259,1462.4858276644036,130724.397675737,387,2,149.81578947368422,34,4,21,36.861976118005146,0.6170343137254901,45.773809523809526,1016.904761904762,29.90896358543418,0
453,4,0,0,37,0.0,0.0,1.0,37,1050,800,250,0.7619047619047619,13,8,5,351.065385093408,0.43665540540540543,0.16500877706260986,0.19543020948685158,129352.72285997732,1682.2526927437664,131034.9755527211,388,3,152.43243243243242,34,3,21,36.756387751121515,0.617953431372549,45.68452380952381,1017.2619047619047,29.919467787114844,0
454,4,0,0,37,0.0,0.0,1.0,37,1250,1000,250,0.8,15,10,5,356.1982235002035,0.4364364364364364,0.16843443045338002,0.19889866836729206,129473.85381235839,1823.6713435374286,131297.52515589583,389,4,153.43243243243242,34,3,17,36.502563652668925,0.6191789215686274,45.5654761904762,1017.7380952380961,29.93347338935577,0
455,4,0,0,37,0.0,0.0,1.0,37,1400,900,500,0.6428571428571429,19,9,10,357.1449027350033,0.4360297797797798,0.1665481686526935,0.200043245127209,129595.0414540816,1856.841695011334,131451.88314909293,390,5,154.43243243243242,34,3,17,36.35517752055809,0.6204044117647058,45.44642857142857,1018.2142857142853,29.947478991596626,0
456,4,1,1,37,0.02631578947368421,0.02631578947368421,0.9736842105263158,38,900,600,300,0.6666666666666666,12,6,6,350.60411193714816,0.43609234234234234,0.1680878506681951,0.1988561546083669,130085.419077932,1521.6965663580136,131607.11564429002,391,0,151.3421052631579,35,3,18,36.02365554799183,0.6232142857142857,44.96527777777777,1020.1388888888881,29.146825396825374,0
457,4,0,0,37,0.0,0.0,1.0,37,950,600,350,0.631578947368421,13,6,7,359.8753255067616,0.4329016516516517,0.16915397769939022,0.20361241996637502,129989.2928004534,1955.9878117913704,131945.28061224477,392,1,156.27027027027026,34,3,19,35.88484512413418,0.6243872549019608,45.0595238095238,1019.7619047619038,29.99299719887952,0
458,4,0,0,37,0.0,0.0,1.0,37,1500,1200,300,0.8,18,12,6,362.4826230276028,0.43218218218218213,0.17058248446813207,0.2057268926719574,130110.72137188211,2032.5751133786835,132143.2964852608,393,2,157.27027027027026,34,3,19,35.695011668611436,0.6256127450980392,44.94047619047619,1020.2380952380955,30.007002801120457,0
459,4,0,0,37,0.0,0.0,1.0,37,1100,900,200,0.8181818181818182,13,9,4,363.34860474802196,0.4308058058058058,0.16878102592388333,0.2070242050308496,130262.58680555547,2066.145833333328,132328.7326388888,394,3,158.27027027027026,34,3,20,35.5187074829932,0.6271446078431373,44.791666666666664,1020.8333333333327,30.02450980392155,0
460,4,1,1,37,0.02631578947368421,0.02631578947368421,0.9736842105263158,38,800,400,400,0.5,12,4,8,355.47613421550136,0.4322101706970128,0.18056350114416508,0.204398777173913,130617.2839506171,1686.2654320987476,132303.54938271584,395,0,155.07894736842104,35,3,19,35.36005434782609,0.6285714285714286,44.444444444444436,1022.2222222222207,29.206349206349163,0
461,4,0,0,37,0.0,0.0,1.0,37,1200,1000,200,0.8333333333333334,14,10,4,355.79533588583405,0.4295232732732733,0.15536260242142652,0.20583971002819165,130854.01663237282,1911.4497599450997,132765.46639231793,396,1,149.7027027027027,35,2,19,35.1121794871795,0.6309523809523809,44.21296296296295,1023.1481481481458,29.232804232804163,0
462,4,0,0,37,0.0,0.0,1.0,37,1400,1000,400,0.7142857142857143,18,10,8,355.5211015993963,0.4288663663663664,0.18317151485643257,0.19026091467445924,127783.17920918346,1720.9134682679444,129504.09267745141,397,2,150.7027027027027,34,3,17,38.24571215510814,0.6020220588235294,47.23214285714285,1011.0714285714268,29.737394957983142,8
463,4,2,0,39,0.05128205128205128,0.0,1.0,39,1050,700,350,0.6666666666666666,14,7,7,340.88273291496006,0.43249550157444894,0.1808724684795504,0.1850234548462786,128349.69142500423,950.9489204310805,129300.64034543531,398,0,143.92307692307693,35,4,20,38.036955073291466,0.6056547619047619,46.6724537037037,1013.3101851851848,28.951719576719565,0
464,4,0,2,37,0.0,0.05128205128205128,0.9487179487179487,39,1050,800,250,0.7619047619047619,13,8,5,338.7980615615405,0.43229869545659017,0.18307657174978487,0.18429772814633344,128437.6674489882,902.8865526405825,129340.55400162879,399,1,144.92307692307693,35,4,16,38.00001903021997,0.6065476190476191,46.58564814814814,1013.6574074074063,28.96164021164018,0
465,4,1,0,38,0.02631578947368421,0.0,1.0,38,700,300,400,0.42857142857142855,11,3,8,348.4772676153158,0.4308469653864391,0.1931092270683763,0.1890305943068164,128325.39859693861,1343.6968537414787,129669.09545068009,400,0,149.6578947368421,34,4,21,37.86937492656562,0.6075367647058824,46.69642857142856,1013.2142857142844,29.800420168067188,0
466,4,0,2,36,0.0,0.05263157894736842,0.9473684210526316,38,1050,700,350,0.6666666666666666,14,7,7,347.5715026055017,0.4305506164058796,0.18655932255771535,0.189109990075773,128446.04768990926,1328.8371598639392,129774.8848497732,401,1,150.6578947368421,34,4,17,37.76913290272068,0.6087622549019608,46.57738095238095,1013.6904761904759,29.814425770308116,0
467,4,0,1,35,0.0,0.027777777777777776,0.9722222222222222,36,1350,800,550,0.5925925925925926,19,8,11,360.07346489607255,0.4290674603174603,0.18670737435415652,0.19606046208791267,128476.21882086164,2052.1754535147315,130528.39427437638,402,7,153.08333333333334,34,2,18,37.42147134805073,0.6090686274509804,46.547619047619044,1013.8095238095235,29.817927170868337,0
468,4,1,0,36,0.027777777777777776,0.0,1.0,36,1200,800,400,0.6666666666666666,16,8,8,350.79699471107756,0.4314980158730159,0.19388439547272052,0.19319878385282122,128929.21095521527,1845.5959467119992,130774.80690192727,403,0,152.05555555555554,34,2,20,37.19449654202321,0.6136642156862745,46.10119047619047,1015.5952380952369,29.870448179271676,0
469,4,0,0,36,0.0,0.0,1.0,36,1200,1100,100,0.9166666666666666,13,11,2,353.32470418852586,0.4312830687830688,0.1983243496601832,0.19503706504171275,129019.90504535142,1917.183956916094,130937.08900226752,404,1,153.05555555555554,34,2,20,37.03787790016405,0.6145833333333333,46.01190476190476,1015.9523809523805,29.88095238095237,0
470,4,0,0,36,0.0,0.0,1.0,36,1150,900,250,0.782608695652174,14,9,5,354.8706042423106,0.43164682539682536,0.19657218708518798,0.19649061083144279,129140.88010204074,1965.6604308389924,131106.54053287974,405,2,154.05555555555554,34,2,21,36.875341610057006,0.6158088235294117,45.89285714285714,1016.4285714285708,29.894957983193258,0
471,4,0,0,36,0.0,0.0,1.0,36,1550,1200,350,0.7741935483870968,19,12,7,356.07401386697336,0.4312996031746032,0.20317833192788015,0.19824080409857459,129357.17520004333,2012.1598915301533,131369.33509157348,406,3,155.05555555555554,33,3,21,36.624477974541236,0.6202651515151515,45.680147058823536,1017.2794117647065,30.826648841354743,0
472,4,0,0,36,0.0,0.0,1.0,36,1200,800,400,0.6666666666666666,16,8,8,355.053206847977,0.430109126984127,0.20091154715567883,0.19861461207314107,129544.24267409171,1999.0197580257648,131543.26243211748,407,4,156.05555555555554,33,3,20,36.46008888086353,0.6221590909090908,45.49632352941177,1018.0147058823532,30.84893048128343,0
473,4,1,0,37,0.02702702702702703,0.0,1.0,37,1300,900,400,0.6923076923076923,17,9,8,345.6722723011319,0.431275025025025,0.19204493460185246,0.19542462127123408,129958.94451530621,1584.6407312925326,131543.58524659876,408,0,152.8108108108108,34,3,22,36.277729130180994,0.6240808823529411,45.08928571428572,1019.6428571428579,29.98949579831935,0
474,4,0,1,36,0.0,0.02702702702702703,0.972972972972973,37,600,400,200,0.6666666666666666,8,4,4,343.17730360117866,0.43074324324324326,0.1883942766295703,0.19446713870733498,130050.00000000026,1526.0416666666931,131576.04166666695,409,1,153.8108108108108,34,3,22,36.24897875816992,0.625,45.000000000000014,1020.000000000002,30.00000000000006,0
475,4,0,0,36,0.0,0.0,1.0,36,1300,900,400,0.6923076923076923,17,9,8,344.26531538244745,0.43113425925925924,0.17109867039888016,0.19599806202450912,130232.20663265316,1766.8863378684891,131999.09297052165,410,2,151.52777777777777,34,2,23,36.03651543425862,0.6268382352941176,44.82142857142858,1020.7142857142866,30.02100840336137,0
476,4,0,0,36,0.0,0.0,1.0,36,1400,1000,400,0.7142857142857143,18,10,8,349.9644642157347,0.4305886243386243,0.18407985069652688,0.20020273227440993,130419.0113928539,1928.4074322130994,132347.418825067,411,3,152.52777777777777,33,3,23,35.70173465306937,0.6309974747474747,44.63848039215687,1021.4460784313742,30.9529114676174,0
477,4,0,0,36,0.0,0.0,1.0,36,1100,700,400,0.6363636363636364,15,7,8,350.8074336610882,0.4306547619047619,0.19010021054875925,0.20117141553412354,130512.91120001936,1956.979887543267,132469.89108756263,412,4,153.52777777777777,33,3,20,35.585072359478694,0.6319444444444444,44.54656862745099,1021.8137254901972,30.964052287581733,0
478,4,0,0,36,0.0,0.0,1.0,36,1000,700,300,0.7,13,7,6,355.11090522916817,0.4301587301587302,0.19562987825994282,0.20429897733942912,130638.16350682438,2078.207300076903,132716.37080690128,413,5,154.52777777777777,33,3,21,35.34823783265405,0.6332070707070707,44.42401960784314,1022.3039215686281,30.97890671420085,0
479,4,1,0,37,0.02702702702702703,0.0,1.0,37,1050,800,250,0.7619047619047619,13,8,5,345.1122228231476,0.4329642142142142,0.19594594594594605,0.2005381835323696,131023.24263038556,1643.5445011337938,132666.78713151935,414,0,151.32432432432432,34,3,22,35.214389534883715,0.6348039215686274,44.04761904761905,1023.8095238095243,30.112044817927185,0
480,4,0,0,37,0.0,0.0,1.0,37,1100,800,300,0.7272727272727273,14,8,6,345.4576175986961,0.4327452452452452,0.1967606661922403,0.20124782476174194,131120.59709630048,1659.321818201291,132779.91891450176,415,1,152.32432432432432,35,2,22,35.1071919614269,0.6336309523809525,43.95254629629629,1024.189814814814,29.262566137566118,0
481,4,0,0,37,0.0,0.0,1.0,37,1350,900,450,0.6666666666666666,18,9,9,348.5707040212536,0.43236986986986986,0.20314820314820348,0.20385561739032182,131270.41737683635,1751.4043604415324,133021.82173727787,416,2,153.32432432432432,36,1,22,34.876144688644686,0.6331018518518519,43.80630630630631,1024.774774774775,28.465965965965975,0
482,4,0,0,37,0.0,0.0,1.0,37,1150,600,550,0.5217391304347826,17,6,11,346.0241919492365,0.4324011511511512,0.19863766205229583,0.2026713124274101,131328.12500000012,1688.5543482671992,133016.67934826732,417,3,154.32432432432432,35,2,22,34.88313008130081,0.6357142857142857,43.75000000000001,1025.000000000001,29.285714285714313,0
483,4,1,0,38,0.02631578947368421,0.0,1.0,38,1050,700,350,0.6666666666666666,14,7,7,342.805523461213,0.4331584874348032,0.21596032461677206,0.2033001740740563,131803.09070644717,1436.5655006858724,133239.65620713303,418,0,151.23684210526315,35,3,15,34.4867748722573,0.6404761904761904,43.28703703703704,1026.8518518518517,29.338624338624335,0
484,4,0,0,38,0.0,0.0,1.0,38,650,500,150,0.7692307692307693,8,5,3,344.4161465383522,0.43301031294452347,0.21559730970428048,0.20457489185952737,131862.521701389,1483.116319444454,133345.63802083346,419,1,152.23684210526315,35,3,15,34.385564570655845,0.6410714285714285,43.22916666666667,1027.0833333333342,29.34523809523812,0
485,4,0,0,38,0.0,0.0,1.0,38,1000,800,200,0.8,12,8,4,344.02438598149905,0.4324027975343765,0.2132060667947404,0.20473153772401956,131934.82069485038,1477.7591358250252,133412.57983067541,420,2,153.23684210526315,36,2,16,34.322819613431236,0.6397569444444444,43.15878378378379,1027.364864864866,28.537912912912944,0
486,4,0,0,38,0.0,0.0,1.0,38,1050,800,250,0.7619047619047619,13,8,5,346.333676111841,0.4321360834518729,0.21731218457101664,0.20642030009931733,131992.67415641993,1542.7016120850597,133535.37576850498,421,3,154.23684210526315,36,2,17,34.2052511415525,0.6403356481481481,43.10247747747748,1027.5900900900901,28.54416916916917,0
487,4,0,0,38,0.0,0.0,1.0,38,1150,800,350,0.6956521739130435,15,8,7,352.37365238790983,0.4310099573257468,0.22556761523785385,0.21098516852157406,132166.31063073204,1714.3851199172145,133880.69575064926,422,4,155.23684210526315,36,2,17,33.875214470850224,0.6420717592592593,42.93355855855856,1028.2657657657655,28.56293793793793,0
488,4,0,0,38,0.0,0.0,1.0,38,1000,800,200,0.8,12,8,4,351.7250366919129,0.4304765291607397,0.22630426641315893,0.21124314333863406,132282.1316882761,1705.3875243486682,133987.51921262476,423,5,156.23684210526315,36,2,19,33.775314723590576,0.6432291666666667,42.820945945945944,1028.716216216216,28.575450450450447,0
489,4,0,0,38,0.0,0.0,1.0,38,1150,600,550,0.5217391304347826,17,6,11,346.2589065256445,0.43018018018018017,0.21224835193447977,0.2089298992292456,132457.56842635447,1572.9732872731163,134030.54171362758,424,6,157.23684210526315,35,3,19,33.73950603403041,0.6470238095238094,42.650462962962955,1029.3981481481471,29.411375661375633,0
490,4,0,0,38,0.0,0.0,1.0,38,1050,800,250,0.7619047619047619,13,8,5,347.01631362284485,0.4300023707918445,0.20738108255877452,0.21002410245406467,132571.90626014536,1600.9228400698037,134172.82910021517,425,7,158.23684210526315,36,2,19,33.60511208310551,0.6461226851851851,42.539414414414416,1029.842342342343,28.606731731731752,0
491,4,0,0,38,0.0,0.0,1.0,38,1400,1100,300,0.7857142857142857,17,11,6,348.58036967362403,0.4288021574205785,0.21198159332758104,0.21178687798895496,132716.91243608482,1652.5020797824932,134369.4145158673,426,8,159.23684210526315,36,2,16,33.41917122040072,0.6475694444444444,42.39864864864865,1030.405405405406,28.622372372372393,0
492,4,0,0,38,0.0,0.0,1.0,38,1150,700,450,0.6086956521739131,16,7,9,348.5548115610108,0.4283279990516833,0.21548819612938774,0.2124281454746669,132832.97444403882,1659.914475286115,134492.88891932493,427,9,160.23684210526315,36,2,16,33.30329182142595,0.6487268518518519,42.286036036036045,1030.8558558558573,28.634884884884926,0
493,4,0,0,38,0.0,0.0,1.0,38,1350,900,450,0.6666666666666666,18,9,9,354.2363756779031,0.42792792792792794,0.22236942689802985,0.21639376198015756,132920.05423920558,1817.0236537213063,134737.0778929269,428,10,161.23684210526315,36,2,16,33.06941865967749,0.6495949074074074,42.201576576576585,1031.193693693695,28.644269269269305,0
494,4,0,0,38,0.0,0.0,1.0,38,1250,1000,250,0.8,15,10,5,354.9341164356133,0.4281353722143196,0.21606527235118334,0.21732596968918572,133007.1625679734,1841.7559451343263,134848.91851310772,429,11,162.23684210526315,36,2,16,32.963973799126634,0.650462962962963,42.11711711711712,1031.5315315315318,28.65365365365366,0
495,4,0,0,38,0.0,0.0,1.0,38,1150,1000,150,0.8695652173913043,13,10,3,358.6895264967362,0.42699442863916554,0.2202533389988175,0.2206542416019518,133181.46482631264,1954.1593113383528,135135.624137651,430,12,163.23684210526315,36,2,17,32.692150338206424,0.6521990740740741,41.94819819819819,1032.207207207206,28.67242242242239,0
496,4,0,1,37,0.0,0.02631578947368421,0.9736842105263158,38,1100,600,500,0.5454545454545454,16,6,10,358.6311470126059,0.4265647226173542,0.22219000648780263,0.22079057922528925,133210.5262991031,1954.688768160049,135165.21506726314,431,13,164.23684210526315,36,2,18,32.66449401839933,0.6524884259259259,41.92004504504504,1032.3198198198195,28.67555055055054,0
497,4,0,0,37,0.0,0.0,1.0,37,900,400,500,0.4444444444444444,14,4,10,356.90212860810584,0.42511261261261263,0.20506594688888646,0.22058667948743577,133355.88121905687,2118.999573898223,135474.88079295508,432,14,162.8918918918919,36,1,20,32.56332679168486,0.6539351851851851,41.77927927927928,1032.8828828828828,28.691191191191187,0
498,4,0,0,37,0.0,0.0,1.0,37,500,300,200,0.6,7,3,4,354.71688051782246,0.424705955955956,0.2058461339036879,0.21957980174564803,133414.04537983934,2064.8427988799663,135478.8881787193,433,15,163.8918918918919,36,1,21,32.56145083932854,0.6545138888888888,41.722972972972975,1033.1081081081084,28.697447447447455,0
499,4,0,0,37,0.0,0.0,1.0,37,800,500,300,0.625,11,5,6,353.5878121953633,0.4238613613613614,0.2036546570088964,0.21940136032608726,133502.12358806998,2040.9574421886382,135543.08103025862,434,16,164.8918918918919,35,2,21,32.5023565535521,0.6574404761904762,41.637731481481474,1033.4490740740728,29.527116402116366,0
500,4,0,0,37,0.0,0.0,1.0,37,1000,600,400,0.6,14,6,8,354.27876334851413,0.4227352352352352,0.20637115342141676,0.22054161623639543,133621.7625412593,2067.8705579132225,135689.63309917253,435,17,165.8918918918919,35,2,22,32.36466379342514,0.6586309523809524,41.52199074074073,1033.912037037036,29.540343915343886,0
501,4,0,0,37,0.0,0.0,1.0,37,1250,800,450,0.64,17,8,9,356.8214925215172,0.42170295295295296,0.19660111519429946,0.2129960603168013,132050.54029959036,2026.9125451504333,134077.4528447408,436,18,166.8918918918919,36,1,18,33.87750629998904,0.6409143518518519,43.04617117117118,1027.815315315317,28.550425425425473,8
502,4,0,0,37,0.0,0.0,1.0,37,850,600,250,0.7058823529411765,11,6,5,358.6719275788807,0.4207957957957958,0.19800479559515693,0.21459205103507084,132137.36329234645,2078.7925594513495,134216.15585179778,437,19,167.8918918918919,36,1,18,33.74246987951807,0.6417824074074074,42.961711711711715,1028.1531531531534,28.559809809809817,0
503,4,0,0,37,0.0,0.0,1.0,37,1200,1000,200,0.8333333333333334,14,10,4,355.66232834790674,0.4198886386386386,0.19260639950295144,0.21360784809060684,132282.1316882762,2009.55419101535,134291.68587929153,438,20,168.8918918918919,36,1,18,33.674055829228244,0.6432291666666667,42.82094594594595,1028.7162162162167,28.575450450450465,0
504,4,1,0,38,0.02631578947368421,0.0,1.0,38,800,500,300,0.625,11,5,6,349.8194342067696,0.41927453769559037,0.1909506377492285,0.21155746735361786,132542.91453615788,1673.2682006330745,134216.18273679097,439,0,165.42105263157896,36,2,19,33.562080781568966,0.6458333333333333,42.56756756756757,1029.7297297297305,28.603603603603624,0
505,4,0,1,37,0.0,0.02631578947368421,0.9736842105263158,38,1100,700,400,0.6363636363636364,15,7,8,351.0991043328876,0.41865220483641535,0.19236212183097345,0.2131523361341466,132687.9048600966,1717.3209104374637,134405.22577053407,440,1,166.42105263157896,36,2,15,33.38342988304733,0.6472800925925926,42.4268018018018,1030.2927927927929,28.619244244244246,0
506,4,0,2,35,0.0,0.05405405405405406,0.9459459459459459,37,1050,800,250,0.7619047619047619,13,8,5,356.672907685832,0.418480980980981,0.1814472302003194,0.21658268923733112,132695.96220207465,2065.8109353566374,134761.77313743127,441,2,164.7027027027027,35,2,15,33.23176439751366,0.6494047619047619,42.418981481481474,1030.3240740740732,29.437830687830665,0
507,4,0,1,34,0.0,0.02857142857142857,0.9714285714285714,35,900,700,200,0.7777777777777778,11,7,4,375.8015873015875,0.41827731092436976,0.19697959183673475,0.22677681992337165,132461.07266435976,2955.8162725874545,135416.88893694722,442,24,173.62857142857143,33,2,20,32.97569444444445,0.6515151515151515,42.647058823529406,1029.4117647058815,31.19429590017823,0
508,4,0,0,34,0.0,0.0,1.0,34,1150,800,350,0.6956521739130435,15,8,7,380.84864754742097,0.4154226084373143,0.18485128234717152,0.23043038348640685,132560.4848995,3297.096278440978,135857.58117794097,443,25,174.58823529411765,32,2,21,32.745575854176906,0.6549479166666667,42.55050505050505,1029.7979797979797,32.181186868686865,0
509,4,0,0,34,0.0,0.0,1.0,34,1000,600,400,0.6,14,6,8,377.98893844424816,0.41428995840760546,0.17751907819357093,0.23009125313351209,132788.1262913223,3238.488578971531,136026.61487029382,444,26,175.58823529411765,32,2,19,32.58988729633712,0.6572265625,42.32954545454545,1030.681818181818,32.20880681818181,0
510,4,0,0,34,0.0,0.0,1.0,34,750,400,350,0.5333333333333333,11,4,7,381.9657031213348,0.41339869281045755,0.19034637241697205,0.2333219070599808,132918.2947690287,3354.0459838281854,136272.3407528569,445,27,176.58823529411765,32,2,19,32.35633239459612,0.6585286458333333,42.20328282828283,1031.186868686869,32.22458964646466,0
511,4,0,1,33,0.0,0.029411764705882353,0.9705882352941176,34,1150,800,350,0.6956521739130435,15,8,7,392.36230643159075,0.4137514854426619,0.16414872604475628,0.21983401241672895,129606.62853529908,3370.551140186485,132977.17967548556,446,28,177.58823529411765,33,1,18,35.4468798892767,0.622790404040404,45.43504901960785,1018.2598039215699,30.856357694593026,8
512,4,0,0,33,0.0,0.0,1.0,33,1550,1300,250,0.8387096774193549,18,13,5,396.9265568139526,0.4137468434343434,0.1735769244794514,0.22256813003535414,129637.82709775101,3691.3392685505755,133329.1663663016,447,29,182.06060606060606,33,0,18,35.29883674288008,0.6231060606060606,45.40441176470589,1018.3823529411776,30.860071301247807,0
513,4,0,0,33,0.0,0.0,1.0,33,1150,1000,150,0.8695652173913043,13,10,3,396.32944341384405,0.4124447601010101,0.17175847967284108,0.2229420157336062,129762.65889321413,3685.7524750096104,133448.41136822375,448,30,183.06060606060606,33,0,18,35.18663298853339,0.6243686868686869,45.28186274509804,1018.8725490196077,30.874925727866902,0
514,4,0,0,33,0.0,0.0,1.0,33,1350,1100,250,0.8148148148148148,16,11,5,400.5741500665789,0.4137073863636364,0.17161398870328082,0.22659262424908236,129981.25908604857,3813.4264765955313,133794.6855626441,449,31,184.06060606060606,33,0,19,34.85546108240195,0.6265782828282829,45.06740196078431,1019.7303921568622,30.90092097445037,0
515,4,0,0,33,0.0,0.0,1.0,33,650,500,150,0.7692307692307693,8,5,3,405.2013094175256,0.41287878787878785,0.17029393029393036,0.22994552835043633,130106.25608239621,3943.8450655997704,134050.10114799597,450,32,185.06060606060606,33,0,19,34.60998498498498,0.6278409090909092,44.94485294117647,1020.2205882352943,30.915775401069524,0
516,4,0,0,33,0.0,0.0,1.0,33,950,800,150,0.8421052631578947,11,8,3,408.99140046520904,0.41240530303030304,0.17862379346350998,0.23284274603381594,130231.31315179268,4052.697430074982,134284.01058186765,451,33,186.06060606060606,33,0,19,34.38575559290831,0.6291035353535354,44.82230392156863,1020.7107843137262,30.930629827688673,0
517,4,0,0,33,0.0,0.0,1.0,33,1000,800,200,0.8,12,8,4,406.87238677039636,0.4120107323232323,0.1797313264619802,0.23275781357112246,130419.01139285375,4012.778889129184,134431.79028198292,452,34,187.06060606060606,33,0,20,34.248525294941025,0.6309974747474747,44.638480392156865,1021.4460784313728,30.95291146761736,0
518,4,0,0,33,0.0,0.0,1.0,33,1250,1000,250,0.8,15,10,5,407.4932859467819,0.41098484848484845,0.18431800014533795,0.23405606093637488,130575.52984429077,4041.7303440984356,134617.2601883892,453,35,188.06060606060606,33,0,18,34.0732414068745,0.6325757575757576,44.485294117647065,1022.0588235294126,30.97147950089129,0
519,4,0,0,33,0.0,0.0,1.0,33,1450,1000,450,0.6896551724137931,19,10,9,406.0456431170702,0.41133996212121215,0.17900064629036616,0.23436078405636712,130763.47588667825,4019.1879325259574,134782.6638192042,454,36,189.06060606060606,33,0,18,33.91894320632638,0.634469696969697,44.3014705882353,1022.7941176470592,30.993761140819977,0
520,4,0,0,33,0.0,0.0,1.0,33,1200,800,400,0.6666666666666666,16,8,8,403.9090368608798,0.4104719065656566,0.17961221409497274,0.2342672413793104,130951.5570934257,3978.503460207625,134930.06055363332,455,37,190.06060606060606,33,0,19,33.78232758620691,0.6363636363636364,44.117647058823536,1023.5294117647067,31.016042780748688,0
521,4,1,0,34,0.029411764705882353,0.0,1.0,34,700,400,300,0.5714285714285714,10,4,6,392.7164372343367,0.4142342543077837,0.17067161475953196,0.22947117279537946,131236.62308673482,3507.755810657612,134744.37889739242,456,0,185.44117647058823,34,0,21,33.77943340691685,0.6369485294117647,43.83928571428572,1024.6428571428582,30.136554621848774,0
522,4,0,0,34,0.0,0.0,1.0,34,1600,1400,200,0.875,18,14,4,389.14604084318046,0.4135286690433749,0.15951674077020295,0.21343758346114047,128765.68657487512,3221.76331316841,131987.4498880435,457,1,186.44117647058823,33,1,19,36.38815101022297,0.6142676767676767,46.26225490196079,1014.9509803921574,30.75609031491386,7
523,4,1,0,35,0.02857142857142857,0.0,1.0,35,550,400,150,0.7272727272727273,7,4,3,378.61924107436937,0.41768207282913167,0.15888485416422626,0.2094797447214446,129110.6310232426,2776.7538265306043,131887.3848497732,458,0,182.0857142857143,34,1,20,36.30276053258364,0.6155024509803921,45.922619047619044,1016.3095238095235,29.891456582633044,0
524,4,1,1,35,0.027777777777777776,0.027777777777777776,0.9722222222222222,36,600,500,100,0.8333333333333334,7,5,2,367.20838792654126,0.4216435185185185,0.14570169279975054,0.20457385157889285,129383.00028344648,2302.1364795918084,131685.1367630383,459,0,178.0,34,2,22,36.31499141898743,0.6182598039215687,45.65476190476189,1017.3809523809506,29.92296918767502,0
525,4,0,0,35,0.0,0.0,1.0,35,1000,900,100,0.9,11,9,2,372.47775074414716,0.4207282913165266,0.13816980417799507,0.20753760313274547,129388.34372597066,2638.8558487120176,132027.1995746827,460,1,175.97142857142856,33,2,23,36.175519955030914,0.6205808080808081,45.64950980392156,1017.4019607843127,30.830362448009474,0
526,4,0,2,33,0.0,0.05714285714285714,0.9428571428571428,35,1150,700,450,0.6086956521739131,16,7,9,412.75852320424013,0.4206932773109244,0.1054261478389662,0.22006874026115492,127632.76643990914,3550.734987622483,131183.50142753162,461,2,176.97142857142856,34,1,17,36.95388587810242,0.6004901960784313,47.38095238095237,1010.4761904761892,29.719887955182035,8
527,4,2,0,35,0.05714285714285714,0.0,1.0,35,1150,700,450,0.6086956521739131,16,7,9,413.6174130153822,0.41705182072829133,0.1410590350715044,0.22268281368231524,128024.02388038526,3590.593112244872,131614.61699263012,462,0,177.77142857142857,34,1,19,36.52928086891738,0.6044730392156863,46.994047619047606,1012.0238095238076,29.765406162464927,0
528,4,1,0,36,0.027777777777777776,0.0,1.0,36,1050,400,650,0.38095238095238093,17,4,13,402.4699782091816,0.420734126984127,0.140830192988467,0.21877278703772818,128408.33875868046,3136.3270177862723,131544.66577646672,463,0,173.80555555555554,31,5,17,36.416581020897574,0.6155913978494624,46.61458333333333,1013.5416666666658,32.69489247311825,0
529,4,0,0,36,0.0,0.0,1.0,36,1800,1600,200,0.8888888888888888,20,16,4,398.6891947739976,0.42063492063492064,0.1423590135985937,0.217818512550784,128610.25694744804,3055.103956410994,131665.36090385902,464,1,174.80555555555554,33,3,17,36.30529882002337,0.6126893939393939,46.41544117647059,1014.3382352941172,30.737522281639915,0
530,4,1,1,36,0.02702702702702703,0.02702702702702703,0.972972972972973,37,1350,1100,250,0.8148148148148148,16,11,5,389.4623389408711,0.42251626626626626,0.14488506047909144,0.21517242753693563,129054.34355977799,2652.3612986539783,131706.70485843197,465,0,171.05405405405406,35,2,18,36.08480939362872,0.612797619047619,45.97800925925926,1016.0879629629633,29.031084656084666,0
531,4,1,0,37,0.02702702702702703,0.0,1.0,37,1200,1000,200,0.8333333333333334,14,10,4,375.44882086923116,0.42439314314314314,0.1186220545488279,0.20935873469961208,129419.51600646372,2318.332109901177,131737.84811636488,466,0,163.0,33,4,20,36.06816311373399,0.6208964646464646,45.6188725490196,1017.5245098039204,30.834076054664255,0
532,4,1,1,37,0.02631578947368421,0.02631578947368421,0.9736842105263158,38,1200,800,400,0.6666666666666666,16,8,8,370.92949324376303,0.42745376955903275,0.11668890132116894,0.20905381116918048,129837.58680555534,2032.118055555531,131869.70486111086,467,0,159.68421052631578,34,4,18,35.75735895339328,0.6228553921568627,45.20833333333332,1019.1666666666649,29.97549019607838,0
533,4,0,1,36,0.0,0.02702702702702703,0.972972972972973,37,1100,800,300,0.7272727272727273,14,8,6,377.9083500923099,0.4245182682682683,0.11894233020315825,0.21224150040319414,129700.23548635117,2402.9603998461844,132103.19588619735,468,1,164.97297297297297,33,4,18,35.7194417709336,0.6237373737373737,45.34313725490195,1018.6274509803902,30.86749851455728,0
534,4,1,0,37,0.02702702702702703,0.0,1.0,37,1000,400,600,0.4,16,4,12,375.02716464921394,0.42345470470470475,0.1263634745351756,0.2114269661908435,129849.38298396768,2339.4091863854455,132188.79217035312,469,0,165.8108108108108,35,2,19,35.640945567416146,0.6208333333333333,45.19675925925925,1019.2129629629621,29.120370370370345,0
535,4,0,0,37,0.0,0.0,1.0,37,1550,1000,550,0.6451612903225806,21,10,11,396.19273798644673,0.42214089089089085,0.09453928689945035,0.22168647094966826,129554.6392746913,2866.3778506515687,132421.01712534289,470,1,166.8108108108108,35,2,15,35.40245566166438,0.6178571428571429,45.48611111111111,1018.0555555555552,29.087301587301578,7
536,4,0,1,36,0.0,0.02702702702702703,0.972972972972973,37,850,400,450,0.47058823529411764,13,4,9,400.9433496397596,0.42120245245245247,0.08932031679446739,0.22518841226416877,129701.96926708247,3000.628402563439,132702.5976696459,471,2,167.8108108108108,35,2,15,35.13106938605461,0.6193452380952381,45.34143518518518,1018.6342592592592,29.103835978835978,0
537,4,0,1,35,0.0,0.027777777777777776,0.9722222222222222,36,1400,1100,300,0.7857142857142857,17,11,6,409.2068075660702,0.41964285714285715,0.09719624954547812,0.22973579038945513,129685.96938775507,3413.67630385487,133099.64569160994,472,5,173.41666666666666,34,2,15,34.936983793049706,0.6213235294117647,45.357142857142854,1018.5714285714283,29.957983193277304,0
538,4,0,0,35,0.0,0.0,1.0,35,1250,900,350,0.72,16,9,7,419.0739595486258,0.415406162464986,0.1168562493556482,0.2357361907772175,129762.65889321415,3876.030252787389,133638.68914600153,473,6,179.0857142857143,33,2,15,34.60728891027183,0.6243686868686869,45.28186274509804,1018.8725490196078,30.874925727866906,0
539,4,0,0,35,0.0,0.0,1.0,35,1400,1000,400,0.7142857142857143,18,10,8,430.2673106776104,0.4148809523809524,0.09926895761343357,0.22618588913384605,127061.12320081181,3935.010723039168,130996.13392385098,474,7,180.0857142857143,33,2,18,37.10230035249785,0.5969065656565656,47.947303921568604,1008.2107843137225,30.55184194890068,8
540,4,4,3,36,0.10256410256410256,0.07692307692307693,0.9230769230769231,39,900,600,300,0.6666666666666666,12,6,6,392.8196736432354,0.4318488529014845,0.08537497075222422,0.21136991541066547,128002.04554216375,2256.3481056734113,130258.39364783716,475,0,162.51282051282053,36,3,17,37.0780473328882,0.6001157407407407,47.015765765765764,1011.9369369369366,28.10935935935935,0
541,4,3,3,36,0.07692307692307693,0.07692307692307693,0.9230769230769231,39,1150,900,250,0.782608695652174,14,9,5,395.54851519972703,0.4297402159244264,0.11854523286586405,0.2151258118013742,128429.74044568211,2360.0386281551755,130789.77907383729,476,0,163.43589743589743,36,3,16,36.570010739547456,0.6044560185185186,46.593468468468465,1013.6261261261257,28.156281281281267,0
542,4,1,0,37,0.02702702702702703,0.0,1.0,37,1000,700,300,0.7,13,7,6,409.0471346952911,0.4275838338338338,0.12602240398293052,0.2220541588345864,128355.5555555554,3100.6944444444252,131456.24999999983,477,0,165.3783783783784,34,3,20,36.30413925438596,0.607843137254902,46.66666666666666,1013.3333333333321,29.803921568627416,0
543,4,1,1,37,0.02631578947368421,0.02631578947368421,0.9736842105263158,38,950,700,250,0.7368421052631579,12,7,5,398.78756193723746,0.4287873399715505,0.12879369957741105,0.2185355839416058,128731.1385459531,2667.2753772290534,131398.41392318215,478,0,162.0,35,3,18,36.17890815085159,0.6095238095238096,46.29629629629628,1014.8148148148127,28.994708994708937,0
544,4,1,0,38,0.02631578947368421,0.0,1.0,38,800,400,400,0.5,12,4,8,394.5333631375538,0.42635727833096254,0.135369188696445,0.21748899465421898,128966.15655006836,2576.2902949245286,131542.4468449929,479,0,162.89473684210526,35,3,19,36.04622455180795,0.611904761904762,46.0648148148148,1015.7407407407389,29.02116402116397,0
545,4,0,1,37,0.0,0.02631578947368421,0.9736842105263158,38,1350,1000,350,0.7407407407407407,17,10,7,396.7206479833542,0.42650545282124225,0.1343364105023377,0.21934554718475124,129083.74592764063,2642.037465706451,131725.78339334708,480,1,163.89473684210526,35,3,19,35.87034927866364,0.6130952380952381,45.949074074074076,1016.2037037037039,29.034391534391542,0
546,4,0,0,37,0.0,0.0,1.0,37,900,600,300,0.6666666666666666,12,6,6,400.13395102321704,0.42567567567567566,0.11719415327240057,0.22138324950649418,129110.63102324272,2932.3093820861745,132042.9404053289,481,2,157.0810810810811,34,3,20,35.75612041700831,0.6155024509803921,45.92261904761905,1016.3095238095244,29.891456582633072,0
547,4,0,0,37,0.0,0.0,1.0,37,1350,1100,250,0.8148148148148148,16,11,5,400.9724257270361,0.42511261261261263,0.11165139152965486,0.22286970936799433,129292.17864229037,2968.519699546502,132260.69834183686,482,3,158.0810810810811,34,3,20,35.5490850208748,0.6173406862745099,45.74404761904763,1017.0238095238104,29.912464985994426,0
548,4,1,0,38,0.02631578947368421,0.0,1.0,38,1350,1000,350,0.7407407407407407,17,10,7,395.2392303478153,0.42649063537221427,0.12652028845118912,0.2221517053334274,129731.44531250012,2654.991319444458,132386.43663194458,483,0,154.89473684210526,35,3,18,35.24625085207907,0.6196428571428572,45.31250000000001,1018.7500000000009,29.107142857142883,0
549,4,0,1,37,0.0,0.02631578947368421,0.9736842105263158,38,900,700,200,0.7777777777777778,11,7,4,396.88676145421385,0.42629800853485067,0.1287748793772454,0.22324563329593933,129760.92470689755,2700.0786340449567,132461.00334094252,484,1,155.89473684210526,35,3,18,35.174206709833776,0.6199404761904762,45.28356481481483,1018.8657407407429,29.110449735449798,0
550,4,2,1,38,0.05128205128205128,0.02564102564102564,0.9743589743589743,39,1500,1200,300,0.8,18,12,6,385.9054513510064,0.42771592442645073,0.12393020933239396,0.21955185848048797,130205.11379200165,2249.3726412223227,132454.48643322397,485,0,152.12820512820514,36,3,20,35.00151715767406,0.6223958333333333,44.84797297297298,1020.6081081081096,28.350225225225266,0
551,4,0,0,38,0.0,0.0,1.0,38,600,300,300,0.5,9,3,6,396.4439131411667,0.4257942152678995,0.12420347930987097,0.2246855438272094,130055.9028447576,2711.974210176637,132767.87705493424,486,1,156.94736842105263,35,3,20,34.884663754302366,0.6229166666666667,44.994212962962976,1020.02314814815,29.143518518518572,0
552,4,0,1,37,0.0,0.02631578947368421,0.9736842105263158,38,800,600,200,0.75,10,6,4,393.86662292055934,0.42502370791844474,0.1256872190684264,0.2239021285809528,130173.9878713351,2654.23779899694,132828.22567033206,487,2,157.94736842105263,35,3,20,34.83008676420551,0.6241071428571429,44.878472222222236,1020.4861111111129,29.15674603174608,0
553,4,1,1,37,0.02631578947368421,0.02631578947368421,0.9736842105263158,38,1250,1000,250,0.8,15,10,5,392.9429679490849,0.4265499051683262,0.12864100000613332,0.224939533553776,130444.94224773259,2651.514692972116,133096.4569407047,488,0,154.6315789473684,34,4,21,34.57784640484794,0.6289828431372548,44.61309523809525,1021.5476190476203,30.04551820728295,0
554,4,0,0,37,0.0,0.0,1.0,37,950,600,350,0.631578947368421,13,6,7,403.9216099573084,0.4249562062062062,0.12897995187412015,0.23088358692621475,130387.7189662631,3133.2834727028267,133521.00243896592,489,1,159.1891891891892,33,4,21,34.35575153987682,0.6306818181818181,44.66911764705883,1021.3235294117658,30.9491978609626,0
555,4,0,0,37,0.0,0.0,1.0,37,1200,700,500,0.5833333333333334,17,7,10,408.8535939713885,0.4236111111111111,0.1373448920618734,0.23496766786066536,130597.00255102041,3279.0107709750578,133876.01332199547,490,2,160.1891891891892,34,3,19,34.01661619690971,0.6305147058823529,44.464285714285715,1022.1428571428572,30.063025210084035,0
556,4,0,1,36,0.0,0.02702702702702703,0.972972972972973,37,1200,700,500,0.5833333333333334,17,7,10,408.0967062499226,0.4238613613613614,0.13578343131207582,0.234901777029111,130657.85147392293,3264.2077664399094,133922.05924036284,491,3,161.1891891891892,34,3,19,33.97400442477876,0.6311274509803921,44.404761904761905,1022.3809523809525,30.070028011204485,0
557,4,0,1,35,0.0,0.027777777777777776,0.9722222222222222,36,1100,700,400,0.6363636363636364,15,7,8,435.5809701887989,0.42397486772486775,0.10003242542153057,0.22845777416024782,126968.47366397551,3862.725040996806,130831.19870497232,492,4,164.36111111111111,33,3,19,37.06428339818417,0.595959595959596,48.03921568627452,1007.843137254903,30.540701128936455,8
558,4,1,0,36,0.027777777777777776,0.0,1.0,36,1550,1200,350,0.7741935483870968,19,12,7,431.5204442601506,0.42681878306878307,0.11707331988014458,0.22859260851915267,127372.26080246917,3792.9872057755642,131165.24800824473,493,0,165.13888888888889,29,7,16,36.74899101082371,0.610632183908046,47.63888888888889,1009.4444444444447,34.80842911877396,0
559,4,0,0,36,0.0,0.0,1.0,36,850,600,250,0.7058823529411765,11,6,5,431.8476402095657,0.42683531746031744,0.1209662632929962,0.22956111400613746,127512.49999999999,3813.194444444444,131325.69444444444,494,1,166.13888888888889,29,7,17,36.595847084708474,0.6120689655172413,47.5,1009.9999999999999,34.82758620689655,0
560,4,2,0,38,0.05263157894736842,0.0,1.0,38,1000,800,200,0.8,12,8,4,366.60001676225147,0.43263987671882403,0.08116918594062983,0.18718622764008958,125869.56259645057,1628.7567515432074,127498.31934799378,495,0,158.3421052631579,35,3,18,39.93512110726643,0.5803571428571428,49.13194444444444,1003.472222222222,28.670634920634914,8
561,4,5,5,38,0.11627906976744186,0.11627906976744186,0.8837209302325582,43,1200,900,300,0.75,15,9,6,327.39379924052855,0.4417220376522702,0.0825523953324252,0.17191207488971935,127015.17083292006,-283.20413196511583,126731.96670095494,496,0,140.8139534883721,40,3,17,39.742329535907515,0.5830729166666666,47.99288617886178,1008.0284552845517,25.20071138211379,0
562,4,2,0,40,0.05,0.0,1.0,40,950,700,250,0.7368421052631579,12,7,5,353.79886674108656,0.43414797008547007,0.11665306344542459,0.18524545791930708,126898.60251471585,979.3163521467956,127877.91886686264,497,0,151.85,37,3,19,39.196661769507024,0.5869932432432432,48.10855263157894,1007.5657894736825,27.23150782361304,0
563,4,1,0,41,0.024390243902439025,0.0,1.0,41,1100,800,300,0.7272727272727273,14,8,6,379.317791652839,0.43866869918699186,0.15241559025889972,0.1880482922472733,124643.89433527642,1262.0159568328893,125905.91029210931,498,0,149.1219512195122,37,4,16,40.88693221331576,0.5639076576576576,50.356359649122815,998.5745614035103,26.988501659554334,8
564,4,5,2,44,0.10869565217391304,0.043478260869565216,0.9565217391304348,46,1200,800,400,0.6666666666666666,16,8,8,345.74507127023946,0.4514895330112721,0.18672608140374236,0.17694012470888743,125963.38757396454,-487.7240419673918,125475.66353199715,499,0,133.80434782608697,38,8,20,40.36159003831417,0.575657894736842,49.03846153846154,1003.8461538461543,26.417004048583006,0
565,4,1,0,45,0.022222222222222223,0.0,1.0,45,1450,1100,350,0.7586206896551724,18,11,7,346.49778870364617,0.4518728956228956,0.17276918093244675,0.17779443496312522,126072.10884871357,-263.20724910901504,125808.90159960455,500,0,129.17777777777778,36,9,21,40.23066644240115,0.5804398148148149,48.93018018018018,1004.2792792792792,27.896646646646644,0
566,4,3,3,45,0.0625,0.0625,0.9375,48,1000,800,200,0.8,12,8,4,327.05832669300383,0.4555721778959811,0.19772386516389195,0.17106441738496703,126855.79562717023,-1302.1511501736004,125553.64447699663,501,0,122.04166666666667,39,9,17,39.91411177747907,0.5830662393162394,48.15104166666667,1007.3958333333342,25.830662393162413,0
567,4,3,0,48,0.0625,0.0,1.0,48,900,800,100,0.8888888888888888,10,8,2,327.65342189027547,0.4571605348699764,0.21630285097513768,0.17261553214407696,127148.79575521468,-1267.1932166277356,125881.60253858694,502,0,122.79166666666667,36,12,21,39.59891878814947,0.5914351851851851,47.86036036036036,1008.5585585585586,28.015515515515517,0
568,4,3,0,51,0.058823529411764705,0.0,1.0,51,1050,600,450,0.5714285714285714,15,6,9,314.88319958328395,0.46107843137254906,0.2515969142400465,0.16981870877363772,128093.08824319181,-2133.1277058959704,125959.96053729585,503,0,116.50980392156863,40,11,17,38.95693203493623,0.5940104166666667,46.92581300813008,1012.2967479674792,25.30741869918698,0
569,4,0,0,51,0.0,0.0,1.0,51,1550,1100,450,0.7096774193548387,20,11,9,313.5435655085494,0.4605718954248366,0.25086582313205064,0.16942506950020086,128170.89979383699,-2162.5574889930763,126008.34230484391,504,1,117.50980392156863,39,12,18,38.91157031169633,0.5964209401709402,46.84895833333334,1012.6041666666681,25.96420940170944,0
570,4,1,1,51,0.019230769230769232,0.019230769230769232,0.9807692307692307,52,1100,600,500,0.5454545454545454,16,6,10,309.0778465882106,0.46023441427853196,0.2601993616726026,0.16852342913973606,128530.68300118999,-2454.802655496043,126075.88034569395,505,0,116.23076923076923,40,12,13,38.65859056591168,0.5984375,46.4939024390244,1014.0243902439042,25.350609756097604,0
571,4,0,0,51,0.0,0.0,1.0,51,850,700,150,0.8235294117647058,10,7,3,314.1431092279541,0.458937908496732,0.25318052657021894,0.1712852428347832,128530.68300119002,-2124.5943221627094,126406.0886790273,506,1,119.3921568627451,40,11,14,38.53018306941939,0.5984375,46.4939024390244,1014.0243902439045,25.35060975609761,0
572,4,1,3,49,0.019230769230769232,0.057692307692307696,0.9423076923076923,52,1400,1100,300,0.7857142857142857,17,11,6,308.4830374809465,0.4606114881850176,0.2586392845064067,0.16965738251571688,128873.80248685137,-2448.923591427298,126424.87889542407,507,0,118.07692307692308,41,11,15,38.32508956196058,0.6003556910569106,46.155753968253975,1015.3769841269853,24.76529229578013,0
573,4,1,1,49,0.02,0.02,0.98,50,1500,900,600,0.6,21,9,12,323.57553608813294,0.45920068027210886,0.26700379526105156,0.17812184648917082,128910.32036675373,-1657.5547960069193,127252.76557074681,508,0,123.36,39,11,16,37.90484921530411,0.6038995726495726,46.11979166666668,1015.5208333333354,26.03899572649578,0
574,4,0,1,48,0.0,0.02040816326530612,0.9795918367346939,49,1400,1100,300,0.7857142857142857,17,11,6,330.30511375577845,0.45824475623582767,0.26368762340270036,0.18158397878046104,128857.43408203137,-1287.5461154513755,127569.88796657999,509,1,126.65306122448979,39,10,16,37.78780222974591,0.6033653846153846,46.17187500000001,1015.3125000000009,26.033653846153868,0
575,4,0,1,47,0.0,0.020833333333333332,0.9791666666666666,48,1450,800,650,0.5517241379310345,21,8,13,328.8715454546268,0.45664339539007087,0.12067287329358534,0.18041205262982715,128773.09032698681,-1122.4190540655377,127650.67127292127,510,2,130.125,41,7,13,37.91000798227609,0.599339430894309,46.254960317460295,1014.980158730155,24.755613627564756,8
576,4,0,3,44,0.0,0.06382978723404255,0.9361702127659575,47,1300,700,600,0.5384615384615384,19,7,12,336.49224800375964,0.45544249152019733,0.13155708900389795,0.18490415608127372,128840.02267995224,-729.2662271135075,128110.75645283873,511,3,133.72340425531914,40,7,14,37.6484818151485,0.6015625,46.189024390243894,1015.243902439023,25.381097560975576,0
577,4,1,2,43,0.022222222222222223,0.044444444444444446,0.9555555555555556,45,1600,1200,400,0.75,20,12,8,348.84656627261353,0.4521885521885522,0.14002127982976154,0.19173446612427092,128848.62075617275,-10.320216049393906,128838.30054012335,512,0,139.77777777777777,38,7,15,37.32615139078885,0.6049890350877193,46.18055555555555,1015.277777777777,26.717836257309923,0
578,4,1,1,43,0.022727272727272728,0.022727272727272728,0.9772727272727273,44,1500,1100,400,0.7333333333333333,19,11,8,351.51703496369095,0.45103285764622975,0.15262613182651985,0.19424617549245818,129062.08070031165,273.5039868036277,129335.58468711528,513,0,143.38636363636363,37,7,17,37.04082137333189,0.6089527027027026,45.9703947368421,1016.1184210526317,27.462660028449505,0
579,4,1,0,44,0.022727272727272728,0.0,1.0,44,1250,700,550,0.56,18,7,11,325.1515753086597,0.4516825229034531,0.14498400344253404,0.17535088839342738,128091.80230034752,-450.4291284337148,127641.37317191382,514,0,143.5909090909091,39,5,19,38.698377581120965,0.5956196581196581,46.92708333333335,1012.2916666666691,25.956196581196643,8
580,4,1,1,44,0.022222222222222223,0.022222222222222223,0.9777777777777777,45,1100,700,400,0.6363636363636364,15,7,8,318.54723740598206,0.4534511784511785,0.1602301921693554,0.1732690423251884,128434.73442925386,-817.4831814235712,127617.2512478303,515,0,141.37777777777777,39,6,16,38.516189668756205,0.5990918803418803,46.588541666666686,1013.6458333333364,25.990918803418882,0
581,4,0,0,44,0.0,0.0,1.0,44,1600,900,700,0.5625,23,9,14,325.70808355775193,0.4526955602536998,0.15479361490111887,0.17719715004563955,128442.1798524364,-433.06875045655994,128009.11110197984,516,1,145.52272727272728,38,6,16,38.32714130129286,0.6008771929824561,46.581196581196586,1013.6752136752148,26.67566351776881,0
582,4,1,0,45,0.022222222222222223,0.0,1.0,45,1350,1000,350,0.7407407407407407,17,10,7,322.39770909732005,0.45416666666666666,0.16220307299503078,0.17735512800680997,128883.87586805545,-689.6267361111204,128194.24913194432,517,0,143.26666666666668,39,6,19,37.96163315551909,0.6036324786324787,46.14583333333333,1015.4166666666657,26.036324786324762,0
583,4,0,0,45,0.0,0.0,1.0,45,1350,900,450,0.6666666666666666,18,9,9,323.38946947523357,0.4538299663299663,0.1554986047041398,0.17873451981478242,129069.04432508704,-652.08604600692,128416.95827908012,518,1,144.26666666666668,39,6,19,37.74827011788827,0.6055021367521367,45.96354166666668,1016.1458333333353,26.05502136752142,0
584,4,0,0,45,0.0,0.0,1.0,45,1600,1200,400,0.75,20,12,8,326.4191890443989,0.45338804713804715,0.15614501713272433,0.18127015324537482,129257.13320444776,-561.4626465594945,128695.67055788827,519,2,145.26666666666668,37,8,19,37.48023147149738,0.6109234234234234,45.778508771929836,1016.8859649122826,27.483404457088717,0
585,4,1,2,44,0.021739130434782608,0.043478260869565216,0.9565217391304348,46,1300,1000,300,0.7692307692307693,16,10,6,320.5909668725768,0.4539251207729469,0.1646894833620023,0.17938410589129686,129554.63927469144,-893.190586419747,128661.44868827169,520,0,143.08695652173913,38,8,18,37.326625738972254,0.6121162280701755,45.486111111111114,1018.0555555555562,26.79093567251464,0
586,4,0,0,44,0.0,0.0,1.0,44,1600,1100,500,0.6875,21,11,10,336.7970251696964,0.44994274136715995,0.1597247374139803,0.18785789626131966,129430.46932067211,-81.64059329598916,129348.82872737612,521,1,149.54545454545453,36,8,19,37.04026486646007,0.6145833333333333,45.60810810810811,1017.5675675675683,28.265765765765785,0
587,4,0,0,44,0.0,0.0,1.0,44,1400,900,500,0.6428571428571429,19,9,10,333.90048685655506,0.44997577519379844,0.15751945953884583,0.1868755889368964,129563.94184989601,-147.70734745307377,129416.23450244294,522,2,150.54545454545453,37,7,20,36.97843744390593,0.6140202702702703,45.47697368421052,1018.092105263157,27.51600284495019,0
588,4,1,0,45,0.022222222222222223,0.0,1.0,45,1800,1100,700,0.6111111111111112,25,11,14,330.0534425237861,0.45149410774410775,0.17127428046041238,0.18700416710828424,130044.55133912282,-415.66962981224174,129628.88170931058,523,0,148.17777777777778,38,7,21,36.589155406584965,0.6170504385964912,45.00534188034189,1019.9786324786338,26.84154295996405,0
589,4,1,0,46,0.021739130434782608,0.0,1.0,46,1950,1200,750,0.6153846153846154,27,12,15,328.3761722519674,0.4526368760064412,0.17391304347826075,0.1882847548811642,130508.09500328744,-628.6676345971073,129879.42736869033,524,0,145.93478260869566,38,8,17,36.162954830614815,0.6217105263157895,44.55128205128206,1021.7948717948727,26.88933873144402,0
590,4,1,0,47,0.02127659574468085,0.0,1.0,47,1150,900,250,0.782608695652174,14,9,5,323.92468654325546,0.4530141843971631,0.18267285338601602,0.18737268970717655,130848.09570312513,-923.0143229166524,129925.08138020847,525,0,143.80851063829786,39,8,19,35.933363877010784,0.6233974358974359,44.21875000000001,1023.125000000001,26.233974358974386,0
591,4,0,0,47,0.0,0.0,1.0,47,1050,500,550,0.47619047619047616,16,5,11,323.65064881325,0.45312981806968855,0.188024118095502,0.18747311167107122,130901.38888888899,-926.736111111102,129974.6527777779,526,1,144.80851063829786,39,8,19,35.88660423452767,0.6239316239316239,44.16666666666667,1023.3333333333342,26.23931623931626,0
592,4,0,0,47,0.0,0.0,1.0,47,1250,800,450,0.64,17,8,9,325.124083744333,0.45189639222941724,0.1846575435011164,0.18939887375580317,131119.8742894444,-873.9542021944319,130245.92008724995,527,2,145.80851063829786,40,7,20,35.628555599656,0.6244791666666667,43.95325203252034,1024.186991869921,25.604674796748025,0
593,4,0,2,45,0.0,0.0425531914893617,0.9574468085106383,47,1400,1100,300,0.7857142857142857,17,11,6,326.9688523581605,0.45147240209682393,0.17862297129642934,0.19125022663455285,131276.0468305903,-815.3643251371457,130460.68250545315,528,3,146.80851063829786,40,7,20,35.423897593547544,0.6260416666666666,43.800813008130085,1024.79674796748,25.619918699187004,0
594,4,2,2,45,0.0425531914893617,0.0425531914893617,0.9574468085106383,47,1100,900,200,0.8181818181818182,13,9,4,327.19999326777236,0.44858156028368795,0.177474837558925,0.19220944328141987,131440.53939673724,-798.5002953135095,130642.03910142372,529,0,146.9787234042553,37,10,22,35.2522633304819,0.6328828828828829,43.64035087719297,1025.4385964912265,27.71455666192504,0
595,4,1,0,46,0.021739130434782608,0.0,1.0,46,900,500,400,0.5555555555555556,13,5,8,325.3148007496356,0.4452093397745572,0.18668614725653576,0.1920896668905889,131637.3803117303,-635.2823705371098,131002.09794119318,530,0,149.43478260869566,37,9,19,35.10246376037326,0.6348536036036037,43.44846491228069,1026.2061403508753,27.7353010905642,0
596,4,0,2,44,0.0,0.043478260869565216,0.9565217391304348,46,1250,1000,250,0.8,15,10,5,324.4691287021617,0.44500805152979067,0.18623389651040778,0.19201516958973666,131721.78578985823,-652.0693867343946,131069.71640312384,531,1,150.43478260869566,37,9,19,35.03925443281352,0.6356981981981982,43.36622807017543,1026.5350877192968,27.744191559980994,0
597,4,1,0,45,0.022222222222222223,0.0,1.0,45,1650,1000,650,0.6060606060606061,23,10,13,331.92364326579695,0.44379208754208754,0.18802481323047293,0.19663078984108318,131761.33639974432,-253.0594361253166,131508.27696361902,532,0,154.66666666666666,36,9,20,34.808142298270624,0.6380208333333333,43.3277027027027,1026.6891891891892,28.519144144144143,0
598,4,1,0,46,0.021739130434782608,0.0,1.0,46,1150,700,450,0.6086956521739131,16,7,9,323.61733688888927,0.4439814814814815,0.19209043478260934,0.19336599957510078,132087.85545792905,-650.8159962681159,131437.03946166093,533,0,152.2826086956522,37,9,22,34.69322222222223,0.6393581081081081,43.009868421052616,1027.9605263157869,27.7827169274537,0
599,4,1,0,47,0.02127659574468085,0.0,1.0,47,1150,900,250,0.782608695652174,14,9,5,318.8602879960539,0.4445343817452976,0.20203571935655784,0.1923895638661339,132455.95838659603,-952.2836051383288,131503.6747814577,534,0,150.0212765957447,36,11,23,34.44622214929074,0.6449652777777778,42.652027027027025,1029.3918918918916,28.594219219219212,0
600,4,0,1,46,0.0,0.02127659574468085,0.9787234042553191,47,1500,900,600,0.6,21,9,12,316.3435056481541,0.44409111933395007,0.1942299068214659,0.1917245736812103,132623.7941001077,-1009.0648084025923,131614.72929170512,535,1,151.0212765957447,37,10,26,34.34284294940031,0.6447072072072072,42.489035087719294,1030.0438596491226,27.83902323376007,0
601,4,0,0,46,0.0,0.0,1.0,46,1300,900,400,0.6923076923076923,17,9,8,321.9476415085088,0.4440418679549114,0.19694045389288717,0.19500219398919394,132600.9011545332,-661.8905222790062,131939.01063225418,536,2,150.67391304347825,36,10,27,34.221472046067504,0.646412037037037,42.511261261261275,1029.9549549549572,28.609859859859924,0
602,4,0,0,46,0.0,0.0,1.0,46,1650,1400,250,0.8484848484848485,19,14,5,318.336896717621,0.4436191626409018,0.19019310306540693,0.19351424032032366,132736.7615516314,-748.998249461356,131987.76330217006,537,3,151.67391304347825,37,9,17,34.1783712846705,0.6458333333333333,42.37938596491229,1030.482456140352,27.850877192982487,0
603,4,0,0,46,0.0,0.0,1.0,46,1500,1000,500,0.6666666666666666,20,10,10,315.684019918515,0.4432065217391304,0.18530064754856612,0.1921910483959873,132793.2633117883,-815.8577639273569,131977.40554786095,538,4,152.67391304347825,37,9,17,34.19015957446807,0.6463963963963963,42.324561403508774,1030.7017543859654,27.85680417259366,0
604,4,1,1,46,0.02127659574468085,0.02127659574468085,0.9787234042553191,47,1400,1000,400,0.7142857142857143,18,10,8,318.3461422180799,0.4428384212149245,0.20504061855533995,0.19664231034007534,133334.25931633066,-910.7105842282099,132423.54873210244,539,0,150.40425531914894,38,9,19,33.580523085410846,0.6499451754385965,41.800213675213676,1032.7991452991455,27.1789248762933,0
605,4,1,2,45,0.02127659574468085,0.0425531914893617,0.9574468085106383,47,1150,700,450,0.6086956521739131,16,7,9,322.57623741885897,0.44071847055195806,0.22948228958600803,0.20094267381139475,133646.82883897392,-777.5990836043852,132869.22975536954,540,0,151.25531914893617,36,11,20,33.159079358164526,0.6568287037037037,41.49774774774774,1034.0090090090075,28.722472472472433,0
606,4,0,0,45,0.0,0.0,1.0,45,1650,1000,650,0.6060606060606061,23,10,13,329.6399176694696,0.4369739057239057,0.21719130895601446,0.20610686701202421,133783.99032635038,-179.8912886657523,133604.09903768462,541,1,154.2,37,8,17,32.83949390567037,0.65625,41.36513157894736,1034.5394736842102,27.960526315789465,0
607,4,0,1,44,0.0,0.022222222222222223,0.9777777777777777,45,1600,1300,300,0.8125,19,13,6,330.05487640358604,0.4361952861952862,0.2149725193894243,0.20732189541758198,133954.19894823415,-157.55268447983872,133796.64626375432,542,2,155.2,37,8,17,32.658859407548626,0.6579391891891893,41.20065789473684,1035.1973684210532,27.978307254623058,0
608,4,0,0,44,0.0,0.0,1.0,44,1450,900,550,0.6206896551724138,20,9,11,332.45839251312583,0.43644291754756875,0.2011296282041415,0.2099643644695195,134152.91243459514,120.05232379192302,134272.96475838707,468,3,147.4090909090909,37,7,19,32.398391193903464,0.6599099099099099,41.008771929824555,1035.964912280701,27.999051683262188,0
609,4,0,0,44,0.0,0.0,1.0,44,1350,900,450,0.6666666666666666,18,9,9,328.6453665900291,0.4362447145877379,0.19442841618341533,0.20836248493464388,134294.94081111476,27.082010810999122,134322.02282192576,469,4,148.4090909090909,37,7,21,32.35557935752319,0.6613175675675675,40.87171052631578,1036.5131578947353,28.013869132290143,0
610,4,0,0,44,0.0,0.0,1.0,44,1350,900,450,0.6666666666666666,18,9,9,326.2364678136967,0.4359033650458069,0.19339568234683524,0.2076409497026878,134437.04433094786,-28.34670283165019,134408.6976281162,470,5,149.4090909090909,37,7,21,32.276467893141614,0.6627252252252251,40.734649122807014,1037.061403508771,28.028686581318137,0
611,4,0,0,44,0.0,0.0,1.0,44,1250,1000,250,0.8,15,10,5,324.5033053381546,0.43580426356589147,0.19148568133768995,0.2068599237532981,134493.906779009,-71.256540473982,134422.65023853502,471,6,150.4090909090909,37,7,22,32.26479915433404,0.6632882882882882,40.679824561403514,1037.2807017543867,28.03461356092937,0
612,4,0,1,43,0.0,0.022727272727272728,0.9772727272727273,44,1100,800,300,0.7272727272727273,14,8,6,322.6488440017893,0.4352096546863989,0.18430075101319554,0.2066437048255034,134664.56626077276,-110.12667359185252,134554.4395871809,472,7,151.4090909090909,37,7,23,32.14310866962462,0.6649774774774775,40.51535087719299,1037.9385964912296,28.052394499762965,0
613,4,0,0,43,0.0,0.0,1.0,43,1750,1500,250,0.8571428571428571,20,15,5,332.21600215149715,0.43380860095976376,0.18869552493352248,0.2129601604890476,134696.86536198374,349.69082257935565,135046.5561845631,473,8,154.88372093023256,36,7,23,31.86270521443552,0.6672453703703703,40.48423423423424,1038.0630630630642,28.835085085085115,0
614,4,0,0,43,0.0,0.0,1.0,43,1650,1000,650,0.6060606060606061,23,10,13,331.8770314478087,0.4335086747877446,0.18645999314225792,0.21377330573146577,134872.27091956834,352.20177948220226,135224.47269905056,474,9,155.88372093023256,36,7,18,31.696977088753986,0.6689814814814814,40.315315315315324,1038.7387387387398,28.853853853853884,0
615,4,0,0,43,0.0,0.0,1.0,43,1300,900,400,0.6923076923076923,17,9,8,333.4863997771376,0.4327473237356958,0.18885806924594317,0.21602897939247434,135077.0549899563,409.2721522197994,135486.3271421761,475,10,156.88372093023256,36,7,19,31.451540100386378,0.6710069444444444,40.11824324324325,1039.5270270270278,28.875750750750772,0
616,4,0,0,43,0.0,0.0,1.0,43,800,300,500,0.375,13,3,10,333.175391750193,0.43263196751568844,0.18509935109427267,0.21600247307849604,135106.32253875516,402.8203879555456,135509.14292671072,476,11,157.88372093023256,36,7,19,31.43053148469095,0.6712962962962963,40.0900900900901,1039.639639639641,28.87887887887892,0
617,4,0,0,43,0.0,0.0,1.0,43,1200,900,300,0.75,15,9,6,335.07902453209203,0.43173218899963084,0.18594074615026202,0.2177659951832423,135194.1442075523,460.1443927035363,135654.28860025585,477,12,158.88372093023256,36,7,19,31.29376466341817,0.6721643518518519,40.00563063063064,1039.977477477479,28.888263263263305,0
618,4,0,2,41,0.0,0.046511627906976744,0.9534883720930233,43,1200,900,300,0.75,15,9,6,340.89966190813715,0.4312476928755999,0.20716887280613872,0.2032009162975088,131996.2904188367,400.211495411153,132396.50191424784,478,13,159.88372093023256,39,4,17,34.341210508531844,0.6348824786324787,43.09895833333333,1027.6041666666658,26.348824786324766,8
619,4,1,2,40,0.023809523809523808,0.047619047619047616,0.9523809523809523,42,1200,1100,100,0.9166666666666666,13,11,2,346.2861470363778,0.43155971738288806,0.21300834744378072,0.20635564821535818,131985.99810979606,740.9845496383782,132726.98265943443,479,0,163.02380952380952,38,4,18,34.21319401122893,0.6365131578947368,43.10897435897435,1027.5641025641016,27.04116059379215,0
620,4,1,3,38,0.024390243902439025,0.07317073170731707,0.926829268292683,41,900,800,100,0.8888888888888888,10,8,2,345.63412869363526,0.4323932926829268,0.19323700871785943,0.20731587270614468,132233.1242809005,940.8561390532267,133173.9804199537,480,0,152.5121951219512,38,3,20,33.98125064921574,0.6389802631578947,42.86858974358973,1028.525641025639,27.06646423751682,0
621,4,0,0,38,0.0,0.0,1.0,38,1150,1000,150,0.8695652173913043,13,10,3,361.00333519058734,0.43225462304409673,0.18132936531461552,0.21509983958537113,131981.42387902935,1929.14684070643,133910.57071973578,481,1,152.23684210526315,35,3,20,33.83973492528346,0.6422619047619047,43.11342592592592,1027.5462962962952,29.358465608465576,0
622,4,0,0,38,0.0,0.0,1.0,38,1100,900,200,0.8181818181818182,13,9,4,361.5047479912347,0.4320619962067331,0.18036984352773877,0.21573670444638185,132040.89506172828,1946.6820987654205,133987.5771604937,482,2,153.23684210526315,35,3,20,33.766891891891895,0.6428571428571428,43.05555555555555,1027.777777777777,29.36507936507934,0
623,4,0,0,38,0.0,0.0,1.0,38,800,700,100,0.875,9,7,2,358.7810756519418,0.43135075865339023,0.1731202161188654,0.21478511294419453,132159.87761488324,1883.2926097393438,134043.1702246226,483,3,154.23684210526315,35,3,20,33.716981840012004,0.644047619047619,42.9398148148148,1028.2407407407393,29.378306878306837,0
624,4,0,0,38,0.0,0.0,1.0,38,1150,800,350,0.6956521739130435,15,8,7,359.1791183582368,0.4310395922238028,0.1704635604759932,0.21604210840356725,132338.45191400888,1906.6416966735233,134245.0936106824,484,4,155.23684210526315,35,3,20,33.52690288713911,0.6458333333333333,42.7662037037037,1028.935185185185,29.39814814814814,0
625,4,1,1,38,0.02564102564102564,0.02564102564102564,0.9743589743589743,39,1100,700,400,0.6363636363636364,15,7,8,350.87664570407424,0.43201754385964913,0.1621324632147858,0.21268844786316532,132629.8992193206,1507.346831628922,134137.24605094953,485,0,152.23076923076923,36,3,14,33.44744178419155,0.6467013888888888,42.483108108108105,1030.067567567567,28.612987987987974,0
626,4,0,0,38,0.0,0.0,1.0,38,950,500,450,0.5263157894736842,14,5,9,359.79854912142497,0.43006164058795643,0.16850093192509075,0.21727142528411914,132487.35592689036,1933.7516878857905,134421.10761477615,486,6,157.23684210526315,35,3,21,33.361087689713315,0.6473214285714286,42.62152777777777,1029.5138888888882,29.41468253968252,0
627,4,0,1,37,0.0,0.02631578947368421,0.9736842105263158,38,800,400,400,0.5,12,4,8,361.2902366749947,0.4297949265054528,0.16754612731671825,0.21851796299778548,132546.94097490126,1977.5831350737108,134524.52410997497,487,7,158.23684210526315,35,3,21,33.26273369300513,0.6479166666666667,42.5636574074074,1029.745370370369,29.42129629629626,0
628,4,0,0,37,0.0,0.0,1.0,37,1400,1300,100,0.9285714285714286,15,13,2,366.1985106984638,0.42714589589589586,0.1608501705589087,0.22187321530553944,132612.49999999977,2312.4999999999723,134924.99999999974,488,8,162.05405405405406,34,3,21,33.07038834951455,0.6507352941176471,42.499999999999986,1029.9999999999982,30.29411764705877,0
629,4,0,0,37,0.0,0.0,1.0,37,1050,900,150,0.8571428571428571,12,9,3,368.4551706626675,0.42714589589589586,0.16010093754489452,0.223605262756993,132673.81660997708,2376.8707482992895,135050.68735827637,489,9,163.05405405405406,34,3,15,32.95056236037285,0.6513480392156863,42.440476190476176,1030.2380952380931,30.30112044817921,0
630,4,0,0,37,0.0,0.0,1.0,37,850,400,450,0.47058823529411764,13,4,9,364.5716029380785,0.42686436436436437,0.15509579660523087,0.22173125359020804,132755.59413580227,2279.7839506172613,135035.37808641954,490,10,164.05405405405406,35,2,15,32.96832884097035,0.65,42.3611111111111,1030.5555555555538,29.444444444444397,0
631,4,0,0,37,0.0,0.0,1.0,37,1100,800,300,0.7272727272727273,14,8,6,363.5500547112845,0.42583208208208206,0.15246653096018914,0.2219922849501596,132904.7325772674,2263.5045599708174,135168.2371372382,491,11,165.05405405405406,35,2,16,32.844712275975596,0.6514880952380953,42.21643518518517,1031.134259259257,29.460978835978775,0
632,4,0,0,37,0.0,0.0,1.0,37,1000,800,200,0.8,12,8,4,361.69670554921004,0.424486986986987,0.15140833330807602,0.22227770664247432,133143.52823055966,2231.515105238324,135375.043335798,492,12,166.05405405405406,35,2,16,32.65263448095399,0.6538690476190476,41.984953703703695,1032.0601851851839,29.487433862433825,0
633,4,0,2,35,0.0,0.05405405405405406,0.9459459459459459,37,1200,800,400,0.6666666666666666,16,8,8,364.59611092119286,0.4237987987987988,0.1494849109198888,0.2245992617000717,133233.1318587104,2315.25634430725,135548.38820301765,493,13,167.05405405405406,35,2,17,32.48785500747383,0.6547619047619048,41.89814814814814,1032.4074074074063,29.497354497354465,0
634,4,0,1,34,0.0,0.02857142857142857,0.9714285714285714,35,1250,900,350,0.72,16,9,7,377.3218911443316,0.4198529411764706,0.1637316953150194,0.2313672980003006,133060.97902549495,3041.3640486831937,136102.34307417815,494,14,175.34285714285716,33,2,17,32.33249693154374,0.6575126262626263,42.064950980392155,1031.740196078431,31.26485442661912,0
635,4,0,0,34,0.0,0.0,1.0,34,1050,700,350,0.6666666666666666,14,7,7,387.26660544842383,0.41779931669637554,0.17332144979203856,0.23666292555181445,132934.57031249997,3496.223958333333,136430.7942708333,495,30,181.08823529411765,33,1,17,32.203282828282845,0.65625,42.1875,1031.2499999999998,31.249999999999993,0
636,4,0,0,34,0.0,0.0,1.0,34,1050,900,150,0.8571428571428571,12,9,3,386.88001083270785,0.4171122994652406,0.16893949979041523,0.23742927778508757,133092.5905901577,3498.1725778546793,136590.76316801237,496,31,182.08823529411765,33,1,18,32.05413697545527,0.6578282828282829,42.0343137254902,1031.8627450980398,31.268568033273933,0
637,4,0,0,34,0.0,0.0,1.0,34,1350,1100,250,0.8148148148148148,16,11,5,389.7235636513598,0.41646241830065356,0.17224895419404884,0.23978389895072333,133187.44781153876,3581.2573589484723,136768.70517048723,497,32,183.08823529411765,33,1,18,31.885289287268996,0.6587752525252526,41.94240196078431,1032.230392156862,31.279708853238244,0
638,4,0,0,34,0.0,0.0,1.0,34,650,400,250,0.6153846153846154,9,4,5,392.1105231181046,0.4162767379679144,0.17809390818642035,0.2416628498368712,133250.70473195394,3649.8007076605036,136900.50543961444,498,33,184.08823529411765,33,1,18,31.760014836795254,0.6594065656565656,41.88112745098039,1032.4754901960775,31.287136066547806,0
639,4,0,0,34,0.0,0.0,1.0,34,1150,1000,150,0.8695652173913043,13,10,3,391.8695766073671,0.4157382650029709,0.17309249281107797,0.24213172959288054,133345.61827181853,3650.818194925029,136996.43646674356,499,34,185.08823529411765,33,1,19,31.67072061382693,0.6603535353535354,41.78921568627451,1032.843137254902,31.298276886512184,0
640,4,0,0,34,0.0,0.0,1.0,34,950,600,350,0.631578947368421,13,6,7,387.93956776230726,0.416165329768271,0.08192114913099147,0.2301322031080121,131813.89534550055,3427.2251901287264,135241.12053562928,500,35,186.08823529411765,32,2,14,33.317195376859715,0.6474609375,43.276515151515156,1026.89393939394,32.09043560606062,8
641,4,0,0,34,0.0,0.0,1.0,34,1250,1000,250,0.8,15,10,5,381.37743245795497,0.4168523469994058,0.08236595203330821,0.22720714094749908,131976.0180721355,3266.534983675142,135242.55305581065,501,36,187.08823529411765,32,2,14,33.32181330384207,0.6490885416666667,43.11868686868687,1027.5252525252527,32.110164141414145,0
642,4,0,0,34,0.0,0.0,1.0,34,1000,600,400,0.6,14,6,8,368.6009768652149,0.4160910576351753,0.08457955467730027,0.2108640454476023,130419.01139285362,2814.515000240281,133233.5263930939,502,37,188.08823529411765,33,1,19,35.2258298340332,0.6309974747474747,44.63848039215686,1021.4460784313718,30.952911467617326,8
643,4,0,0,34,0.0,0.0,1.0,34,850,500,350,0.5882352941176471,12,5,7,370.55128923044083,0.41596108140225785,0.0863441345828162,0.2121507930649006,130450.30757400987,2867.7059304113673,133318.01350442125,503,38,189.08823529411765,33,1,19,35.1442538387716,0.6313131313131313,44.607843137254896,1021.5686274509794,30.956625074272104,0
644,4,0,0,34,0.0,0.0,1.0,34,1200,800,400,0.6666666666666666,16,8,8,370.1682570965293,0.4153112002376708,0.08077392328469557,0.2127893475149658,130606.84479827482,2869.301620770869,133476.1464190457,504,39,190.08823529411765,33,1,17,34.995179434919855,0.6328914141414141,44.454656862745104,1022.1813725490206,30.97519310754608,0
645,4,0,1,33,0.0,0.029411764705882353,0.9705882352941176,34,850,600,250,0.7058823529411765,11,6,5,371.81056378228953,0.4159982174688057,0.08894027409621619,0.21425326962703226,130700.8121876203,2919.1885332564616,133620.00072087676,505,40,191.08823529411765,33,1,18,34.85788191115373,0.6338383838383839,44.36274509803923,1022.5490196078443,30.986333927510433,0
646,4,0,0,33,0.0,0.0,1.0,33,600,500,100,0.8333333333333334,7,5,2,372.70054887081824,0.4159564393939394,0.08601692062565913,0.21537944700081108,130810.95838434862,3150.6631976329086,133961.62158198154,506,41,194.3030303030303,32,1,19,34.723422200279764,0.6373697916666667,44.25505050505051,1022.9797979797987,31.96811868686871,0
647,4,0,0,33,0.0,0.0,1.0,33,1200,900,300,0.75,15,9,6,372.1941147120992,0.4150094696969697,0.08298932064973519,0.21544722183048948,130875.54841342726,3142.2217758392094,134017.77018926648,507,42,195.3030303030303,32,1,19,34.67089297466273,0.6380208333333333,44.1919191919192,1023.2323232323237,31.976010101010115,0
648,4,0,1,32,0.0,0.030303030303030304,0.9696969696969697,33,900,900,0,1.0,9,9,0,373.39884473603166,0.414614898989899,0.08455251740490333,0.2170531349078483,131037.09323347129,3185.819846189187,134222.91307966047,508,43,196.3030303030303,32,1,20,34.47635343445553,0.6396484375,44.03409090909092,1023.8636363636381,31.99573863636369,0
649,4,0,0,32,0.0,0.0,1.0,32,750,600,150,0.8,9,6,3,380.45692934744807,0.4117523521505377,0.08770828033579225,0.22091228792685647,130994.67807345922,3567.566596137157,134562.24466959637,509,44,201.3125,31,1,20,34.338696684473845,0.6418010752688172,44.075520833333336,1023.6979166666669,33.02251344086022,0
650,4,0,0,32,0.0,0.0,1.0,32,850,700,150,0.8235294117647058,10,7,3,387.68513295301034,0.41139532930107525,0.084961811325579,0.21772152154281385,129698.2849968803,3656.4193725585847,133354.7043694389,510,45,202.3125,31,1,17,35.47245834931188,0.6286962365591398,45.34505208333333,1018.6197916666656,32.85870295698921,8
651,4,1,0,33,0.030303030303030304,0.0,1.0,33,500,300,200,0.6,7,3,4,375.21776633957836,0.4148121843434343,0.08436975924904644,0.21237798869830227,130004.92814827565,3156.0317505866697,133160.95989886232,511,0,197.15151515151516,32,1,18,35.47779703685362,0.6292317708333333,45.04419191919192,1019.823232323232,31.869476010101,0
652,4,0,0,33,0.0,0.0,1.0,33,1250,900,350,0.72,16,9,7,378.0091628488126,0.4149700126262626,0.0893011750154602,0.21537731371618413,130262.58680555568,3248.0902777777874,133510.67708333346,512,1,198.15151515151516,32,1,18,35.14455782312925,0.6318359375,44.79166666666667,1020.8333333333344,31.9010416666667,0
653,4,0,0,33,0.0,0.0,1.0,33,1200,900,300,0.75,15,9,6,376.092947899515,0.4149700126262626,0.08029853430446932,0.2148191922748078,130359.27456382007,3205.440771349873,133564.71533516995,513,2,199.15151515151516,32,1,18,35.09520276953513,0.6328125,44.6969696969697,1021.2121212121216,31.9128787878788,0
654,4,0,0,33,0.0,0.0,1.0,33,500,200,300,0.4,8,2,6,374.87597042542086,0.41469381313131315,0.07627823350938301,0.21447995761963634,130423.75299714331,3178.5461942659135,133602.29919140923,514,3,200.15151515151516,32,1,19,35.060774618871044,0.6334635416666667,44.633838383838395,1021.4646464646478,31.920770202020243,0
655,4,0,0,33,0.0,0.0,1.0,33,1150,900,250,0.782608695652174,14,9,5,375.13629132385074,0.4147727272727273,0.07988946676701558,0.21516498977207132,130520.50053884824,3192.5953027752494,133713.0958416235,515,4,201.15151515151516,32,1,18,34.95587750731087,0.6344401041666667,44.539141414141426,1021.8434343434357,31.932607323232364,0
656,4,1,0,34,0.029411764705882353,0.0,1.0,34,950,600,350,0.631578947368421,13,6,7,368.66445287986465,0.4173908199643494,0.09265726879691272,0.21417405002492276,131014.28086553248,2860.061634948094,133874.34250048056,516,0,196.2058823529412,33,1,19,34.62064081078923,0.6369949494949495,44.056372549019606,1023.7745098039215,31.023469994058228,0
657,4,0,0,34,0.0,0.0,1.0,34,900,600,300,0.6666666666666666,12,6,6,366.111619056951,0.4169080510992276,0.08292250993155625,0.21324700465449875,131114.67013888882,2800.5208333333235,133915.19097222213,517,1,197.2058823529412,34,0,19,34.58435042039598,0.6357230392156863,43.95833333333333,1024.166666666666,30.122549019607824,0
658,4,0,0,34,0.0,0.0,1.0,34,750,500,250,0.6666666666666666,10,5,5,366.589435763274,0.416165329768271,0.08527600653366951,0.21420470289304142,131236.6230867347,2821.9919217687093,134058.6150085034,518,2,198.2058823529412,34,0,19,34.44870454281399,0.6369485294117647,43.839285714285715,1024.6428571428573,30.136554621848745,0
659,4,0,1,33,0.0,0.029411764705882353,0.9705882352941176,34,1100,700,400,0.6363636363636364,15,7,8,367.0041738455189,0.4154040404040404,0.093820631700956,0.21532325806543479,131392.8425670852,2844.4081026197073,134237.2506697049,519,3,199.2058823529412,32,2,19,34.280069786535286,0.6432291666666667,43.6868686868687,1025.252525252527,32.03914141414147,0
660,4,0,0,33,0.0,0.0,1.0,33,700,500,200,0.7142857142857143,9,5,4,375.2484958427814,0.41323390151515155,0.08970466570466518,0.22036404957210326,131428.24172973647,3263.6500040690253,134691.8917338055,520,4,200.9090909090909,31,2,19,34.03293650793651,0.6461693548387097,43.65234375000001,1025.3906250000011,33.07711693548391,0
661,4,0,0,33,0.0,0.0,1.0,33,750,400,350,0.5333333333333333,11,4,7,371.15805458524324,0.4125631313131313,0.08652253703952373,0.21849913300366067,131522.32552800738,3163.1140955004626,134685.43962350785,521,5,201.9090909090909,32,1,19,34.042651403249636,0.64453125,43.56060606060606,1025.757575757576,32.05492424242425,0
662,4,0,0,33,0.0,0.0,1.0,33,900,800,100,0.8888888888888888,10,8,2,369.3783664939245,0.41197127525252525,0.08691566831101705,0.2180056633621006,131619.47959710748,3123.477674471997,134742.95727157948,522,6,202.9090909090909,32,1,19,33.990094745908706,0.6455078125,43.46590909090909,1026.136363636364,32.066761363636374,0
663,4,0,0,33,0.0,0.0,1.0,33,1050,600,450,0.5714285714285714,15,6,9,368.62236854776927,0.41137941919191917,0.08530763296474753,0.2183006903613919,131749.0741537853,3113.131153708803,134862.2053074941,523,7,203.9090909090909,32,1,19,33.87857172139549,0.6468098958333333,43.339646464646464,1026.641414141414,32.08254419191919,0
664,4,0,0,33,0.0,0.0,1.0,33,1100,800,300,0.7272727272727273,14,8,6,369.82954399341116,0.41114267676767674,0.08548785531448733,0.21938903583504094,131813.89534550047,3149.7345615243285,134963.6299070248,524,8,204.9090909090909,32,1,19,33.78212221812369,0.6474609375,43.27651515151515,1026.8939393939393,32.0904356060606,0
665,4,0,0,33,0.0,0.0,1.0,33,800,700,100,0.875,9,7,2,373.727355996154,0.41114267676767674,0.0855308813324076,0.22253765288861907,131956.9396386006,3263.1836312956625,135220.12326989626,525,9,205.9090909090909,33,0,19,33.53759144402035,0.6464646464646464,43.13725490196079,1027.4509803921574,31.134878193701738,0
666,4,0,0,33,0.0,0.0,1.0,33,850,600,250,0.7058823529411765,11,6,5,374.0652300058019,0.4111032196969697,0.08500890627992086,0.223294312032645,132051.3913669022,3279.1668168492915,135330.55818375148,526,10,206.9090909090909,33,0,19,33.433562855212415,0.6474116161616161,43.0453431372549,1027.8186274509808,31.146019013666084,0
667,4,0,1,32,0.0,0.030303030303030304,0.9696969696969697,33,1000,400,600,0.4,16,4,12,378.46303051285895,0.41007733585858586,0.0873824606999114,0.22743000294598764,132303.42784325723,3414.391249759687,135717.8190930169,527,11,207.9090909090909,33,0,19,33.066185229303144,0.6499368686868687,42.800245098039206,1028.799019607842,31.175727866904303,0
668,4,0,0,32,0.0,0.0,1.0,32,850,400,450,0.47058823529411764,13,4,9,388.29900835651637,0.41015625,0.09089583844831806,0.23292221812019018,132235.6216840118,3869.392153861844,136105.01383787364,528,12,211.1875,32,0,19,32.881680170226694,0.6516927083333333,42.86616161616161,1028.5353535353531,32.141729797979785,0
669,4,1,0,33,0.030303030303030304,0.0,1.0,33,1150,1000,150,0.8695652173913043,13,10,3,377.57868274243805,0.41236584595959597,0.09667562662255635,0.22950519932593344,132733.2305908202,3423.6469506609114,136156.8775414811,529,0,205.75757575757575,31,2,19,32.655736669193836,0.6592741935483871,42.38281249999999,1030.468749999999,33.24092741935481,0
670,4,0,0,33,0.0,0.0,1.0,33,950,600,350,0.631578947368421,13,6,7,377.9663460059029,0.4120107323232323,0.09077549929864426,0.23067811520808681,132885.7466712579,3445.2680211202783,136331.01469237817,530,1,206.75757575757575,32,1,20,32.49219324026452,0.658203125,42.23484848484848,1031.060606060605,32.22064393939391,0
671,4,0,0,33,0.0,0.0,1.0,33,350,100,250,0.2857142857142857,6,1,5,380.1863401494258,0.4108664772727273,0.09994436408145102,0.23284275854728675,133015.9629757166,3514.17042903783,136530.13340475442,531,2,207.75757575757575,32,1,20,32.30390656874744,0.6595052083333333,42.10858585858585,1031.5656565656552,32.236426767676726,0
672,4,0,0,33,0.0,0.0,1.0,33,1000,700,300,0.7,13,7,6,409.6817558299038,0.4099589646464647,0.12691358024691324,0.23635485913263699,130746.38429752081,4121.685765483133,134868.07006300395,532,3,208.75757575757575,32,1,17,33.84336419753087,0.63671875,44.31818181818183,1022.7272727272739,31.96022727272731,8
673,4,1,0,34,0.029411764705882353,0.0,1.0,34,900,600,300,0.6666666666666666,12,6,6,399.56106940625835,0.4129159239453357,0.12486711021931263,0.2323126468259769,131045.64838343432,3672.147881824308,134717.79626525863,533,0,203.58823529411765,33,1,18,33.79800019948136,0.6373106060606061,44.02573529411765,1023.89705882353,31.02718360071303,0
674,4,0,0,34,0.0,0.0,1.0,34,650,500,150,0.7692307692307693,8,5,3,401.3606980203981,0.4129901960784314,0.126266110129585,0.23374016399696645,131108.39468293454,3724.3513612552947,134832.74604418984,534,1,204.58823529411765,33,1,18,33.68820051055005,0.6379419191919191,43.96446078431373,1024.1421568627457,31.034610814022596,0
675,4,0,0,34,0.0,0.0,1.0,34,700,400,300,0.5714285714285714,10,4,6,366.92689325257516,0.4133801247771836,0.07006211180124233,0.20314728271549018,129137.21335833063,2704.214156094231,131841.42751442487,535,2,205.58823529411765,32,2,19,36.57272256728779,0.6204427083333333,45.896464646464636,1016.4141414141402,31.76294191919188,8
676,4,1,0,35,0.02857142857142857,0.0,1.0,35,1500,1200,300,0.8,18,12,6,356.27953749800423,0.4165966386554622,0.06870355078447532,0.1988269677004992,129450.6920415225,2224.1265378700464,131674.81857939254,536,0,200.68571428571428,33,2,17,36.52406470777135,0.6212121212121212,45.588235294117645,1017.6470588235295,30.837789661319075,0
677,4,0,0,35,0.0,0.0,1.0,35,1000,800,200,0.8,12,8,4,388.03981780785364,0.4162464985994398,0.06887014936039493,0.20575373893843477,127410.50020406072,2949.584259197469,130360.08446325819,537,1,201.68571428571428,32,3,15,37.80692429548108,0.6028645833333333,47.6010101010101,1009.5959595959589,31.549873737373716,8
678,4,1,1,35,0.027777777777777776,0.027777777777777776,0.9722222222222222,36,1050,900,150,0.8571428571428571,12,9,3,378.7968232136458,0.4177579365079365,0.06242590796422065,0.20235208535402527,127710.61610918876,2475.275134563632,130185.8912437524,538,0,197.05555555555554,33,3,17,37.73187439379244,0.6035353535353536,47.30392156862745,1010.7843137254902,30.62982768865122,0
679,4,1,1,35,0.027777777777777776,0.027777777777777776,0.9722222222222222,36,1450,1200,250,0.8275862068965517,17,12,5,376.686249359429,0.4196097883597884,0.0674583939247051,0.20184512530610452,127834.51677239532,2430.700932333728,130265.21770472905,539,0,197.97222222222223,33,3,18,37.65804249474875,0.6047979797979798,47.18137254901961,1011.2745098039222,30.64468211527037,0
680,4,1,1,35,0.027777777777777776,0.027777777777777776,0.9722222222222222,36,500,300,200,0.6,7,3,4,374.69528460622956,0.4216931216931217,0.09122948614474069,0.2020223923529673,128082.49831795476,2398.3816320646065,130480.87995001936,540,0,198.77777777777777,33,3,20,37.45409604519774,0.6073232323232323,46.93627450980393,1012.2549019607853,30.674390968508646,0
681,4,2,1,36,0.05405405405405406,0.02702702702702703,0.972972972972973,37,950,600,350,0.631578947368421,13,6,7,358.849503151031,0.42627002002002,0.09842886773184834,0.1962846897209942,128657.320011338,1833.7230725623763,130491.04308390038,541,0,194.05405405405406,34,3,17,37.267513494484845,0.610906862745098,46.36904761904763,1014.5238095238105,29.838935574229723,0
682,4,1,0,37,0.02702702702702703,0.0,1.0,37,1300,900,400,0.6923076923076923,17,9,8,362.916048170132,0.42670795795795796,0.10393889376423648,0.19987326061584243,128929.21095521563,1958.0959467120447,130887.30690192767,542,0,195.02702702702703,34,3,18,36.88679521744227,0.6136642156862745,46.10119047619049,1015.5952380952398,29.870448179271758,0
683,4,0,1,36,0.0,0.02702702702702703,0.972972972972973,37,900,800,100,0.8888888888888888,10,8,2,364.5727695566927,0.42686436436436437,0.10300986399404688,0.201399908619183,129050.14349489815,2009.6336451247407,131059.7771400229,543,1,196.02702702702703,34,3,19,36.72134348760008,0.6148897058823529,45.98214285714287,1016.07142857143,29.884453781512647,0
684,4,1,1,36,0.02702702702702703,0.02702702702702703,0.972972972972973,37,950,600,350,0.631578947368421,13,6,7,365.4931470034934,0.4248936436436436,0.10057598582188731,0.2026825633383011,129201.38888888907,2044.4444444444648,131245.83333333352,544,0,196.8918918918919,34,3,20,36.54371584699452,0.616421568627451,45.83333333333334,1016.6666666666681,29.90196078431377,0
685,4,0,1,35,0.0,0.027777777777777776,0.9722222222222222,36,750,500,250,0.6666666666666666,10,5,5,372.1534778468328,0.42331349206349206,0.09597969080727631,0.20605079741399435,129139.10064638613,2411.9130863129644,131551.0137326991,545,1,203.19444444444446,33,3,20,36.43798730005626,0.6180555555555556,45.89460784313726,1016.421568627452,30.800653594771273,0
686,4,0,0,35,0.0,0.0,1.0,35,900,700,200,0.7777777777777778,11,7,4,379.3937616921762,0.4212535014005602,0.17432907972843292,0.20801958093326817,128752.49496224875,2810.1880592034095,131562.68302145216,546,2,201.8,32,3,17,36.64909388736835,0.6165364583333333,46.275252525252526,1014.89898989899,31.715593434343436,7
687,4,1,0,36,0.027777777777777776,0.0,1.0,36,700,300,400,0.42857142857142855,11,3,8,371.77285220723945,0.42359457671957673,0.17804507147929338,0.20567793618109648,129107.96215698283,2399.7670667531656,131507.729223736,547,0,197.16666666666666,33,3,18,36.4794354676635,0.617739898989899,45.92524509803921,1016.2990196078428,30.796939988116446,0
688,4,0,0,36,0.0,0.0,1.0,36,1250,900,350,0.72,16,9,7,368.38378442409686,0.42359457671957673,0.1741784620478437,0.2046181379139086,129265.58036169769,2323.902528973842,131589.48289067153,548,1,198.16666666666666,32,4,18,36.404788510884856,0.6217447916666667,45.770202020202014,1016.9191919191912,31.778724747474726,0
689,4,0,0,36,0.0,0.0,1.0,36,750,400,350,0.5333333333333333,11,4,7,368.54481390938713,0.42339616402116403,0.1748593181065876,0.20504123072196276,129329.78777675734,2332.7645138251028,131662.55229058245,549,2,199.16666666666666,32,4,18,36.33523667659715,0.6223958333333333,45.7070707070707,1017.1717171717161,31.786616161616127,0
690,4,0,0,36,0.0,0.0,1.0,36,1150,900,250,0.782608695652174,14,9,5,367.7707529089199,0.42339616402116403,0.1765648918125029,0.20477739849254759,129361.89746263117,2315.104485511657,131677.00194814283,550,3,200.16666666666666,32,4,18,36.322193951429384,0.6227213541666667,45.67550505050504,1017.2979797979782,31.79056186868682,0
691,4,0,0,36,0.0,0.0,1.0,36,1300,900,400,0.6923076923076923,17,9,8,365.7542118409866,0.4227513227513227,0.1612103174603179,0.20482235863095227,129586.776859504,2279.381887052326,131866.15874655632,551,4,201.16666666666666,32,4,14,36.144438244047635,0.625,45.454545454545446,1018.1818181818171,31.818181818181785,0
692,4,0,1,35,0.0,0.027777777777777776,0.9722222222222222,36,1350,1100,250,0.8148148148148148,16,11,5,367.2907701493182,0.42212301587301587,0.1664394314989257,0.20635807336801507,129715.36705438206,2328.6514131210865,132044.01846750316,552,5,202.16666666666666,32,4,14,35.97442571475787,0.6263020833333333,45.328282828282816,1018.6868686868676,31.83396464646461,0
693,4,2,0,37,0.05405405405405406,0.0,1.0,37,1150,800,350,0.6956521739130435,15,8,7,356.35890905053,0.42623873873873874,0.16921494775293855,0.2032050699041727,130293.86421388392,1886.2758614475001,132180.1400753314,553,0,195.13513513513513,33,4,18,35.665361301164324,0.6297348484848485,44.761029411764696,1020.9558823529399,30.938057040998178,0
694,4,0,0,37,0.0,0.0,1.0,37,750,300,450,0.4,12,3,9,355.2463979280951,0.4259259259259259,0.17557192509207886,0.20338832233026075,130450.30757400977,1868.4003748557984,132318.70794886557,554,1,196.13513513513513,33,4,19,35.535128758797185,0.6313131313131313,44.60784313725489,1021.5686274509786,30.95662507427208,0
695,4,1,0,38,0.02631578947368421,0.0,1.0,38,1200,1000,200,0.8333333333333334,14,10,4,344.4819890327362,0.4275723091512565,0.16874146138247514,0.1987538460564294,130749.15143140576,1408.1455498866048,132157.29698129237,555,0,191.94736842105263,34,4,16,35.50760485779692,0.632046568627451,44.31547619047618,1022.738095238094,30.080532212885117,0
696,4,0,1,37,0.0,0.02631578947368421,0.9736842105263158,38,900,700,200,0.7777777777777778,11,7,4,347.2128158861285,0.4272315078236131,0.17052288622417056,0.20080396633414443,130840.48327664388,1485.898526077079,132326.38180272095,556,1,192.94736842105263,34,4,16,35.345396012722034,0.6329656862745099,44.22619047619047,1023.0952380952373,30.091036414565803,0
697,4,0,0,37,0.0,0.0,1.0,37,700,400,300,0.5714285714285714,10,4,6,353.08147981681213,0.4247997997997998,0.173737308308908,0.2036257739510228,130732.14215986649,1831.819642685513,132563.961802552,557,2,198.0810810810811,33,4,16,35.30494807269822,0.6341540404040404,44.33210784313726,1022.6715686274517,30.990047534165203,0
698,4,0,0,37,0.0,0.0,1.0,37,750,600,150,0.8,9,6,3,352.29151461037566,0.4244244244244244,0.16997112109713908,0.20366548226921172,130826.1546039985,1817.7888312187647,132643.94343521725,558,3,199.0810810810811,33,4,18,35.229995208433145,0.6351010101010102,44.240196078431374,1023.0392156862748,31.00118835412954,0
699,4,0,0,37,0.0,0.0,1.0,37,850,600,250,0.7058823529411765,11,6,5,351.66020522466056,0.42389264264264265,0.1683939416490594,0.20412909619469002,130982.91710219627,1812.295901816607,132795.21300401288,559,4,200.0810810810811,33,4,18,35.08756833872062,0.6366792929292929,44.08700980392157,1023.6519607843137,31.019756387403447,0
700,4,1,0,38,0.02631578947368421,0.0,1.0,38,700,500,200,0.7142857142857143,9,5,4,342.3076399461535,0.42520151730678046,0.16764279731737308,0.20033490634238155,131297.62081916086,1388.8357426303724,132686.45656179124,560,0,195.78947368421052,34,4,19,35.009147403879666,0.6375612745098039,43.7797619047619,1024.8809523809514,30.14355742296916,0
701,4,0,0,38,0.0,0.0,1.0,38,800,500,300,0.625,11,5,6,361.2813013479583,0.4246384542437174,0.19314966448194437,0.1969623821474464,128525.67361379034,1686.7845239626263,130212.45813775297,561,1,196.78947368421052,35,3,18,37.340319788456405,0.6074404761904761,46.498842592592595,1014.00462962963,28.97156084656086,8
702,4,0,0,38,0.0,0.0,1.0,38,850,600,250,0.7058823529411765,11,6,5,362.7354166551416,0.4246236367946894,0.1914882757378329,0.19833910960588372,128643.06205257635,1732.6789426869063,130375.74099526326,562,2,197.78947368421052,35,3,19,37.18351872979656,0.6086309523809523,46.383101851851855,1014.467592592593,28.98478835978837,0
703,4,1,0,39,0.02564102564102564,0.0,1.0,39,1300,800,500,0.6153846153846154,18,8,10,348.78921918224194,0.4255229419703104,0.18387766874966238,0.19272046078881627,129058.31665702868,1202.8298991559145,130261.1465561846,563,0,193.69230769230768,36,3,21,37.11394953637,0.6108217592592593,45.9740990990991,1016.1036036036039,28.225100100100107,0
704,4,1,1,39,0.025,0.025,0.975,40,700,500,200,0.7142857142857143,9,5,4,339.37742633890787,0.42705662393162397,0.19120340443869854,0.18953677925858844,129480.23069598325,788.5334910741597,130268.76418705742,564,0,189.825,37,3,16,36.92406449759391,0.6131756756756757,45.55921052631578,1017.7631578947357,27.5071123755334,0
705,4,0,0,39,0.0,0.0,1.0,39,1050,700,350,0.6666666666666666,14,7,7,343.01053304051237,0.4238079172289699,0.19875980872107046,0.19118446428260513,129401.82317029868,1077.2376684116548,130479.06083871034,565,1,195.4102564102564,36,3,22,36.91131710016601,0.6142939814814814,45.63626126126126,1017.454954954955,28.26263763763764,0
706,4,0,0,39,0.0,0.0,1.0,39,1050,700,350,0.6666666666666666,14,7,7,342.7856742750887,0.42422964462438145,0.1948638512037495,0.19147694215687588,129487.7711326191,1077.310587614642,130565.08172023375,566,2,196.4102564102564,36,3,17,36.829682083056724,0.615162037037037,45.5518018018018,1017.7927927927927,28.27202202202202,0
707,4,0,0,39,0.0,0.0,1.0,39,1050,700,350,0.6666666666666666,14,7,7,344.01122512344693,0.4239766081871345,0.1925728074130153,0.19286382571551955,129631.08114448912,1118.909407718532,130749.99055220764,567,3,197.4102564102564,36,3,17,36.652889896420795,0.6166087962962963,45.41103603603604,1018.355855855856,28.28766266266267,0
708,4,0,1,38,0.0,0.02564102564102564,0.9743589743589743,39,1200,900,300,0.75,15,9,6,342.8291867851945,0.4234424201529465,0.19186687644399125,0.1924823087816315,129688.42734203793,1092.1956162243255,130780.62295826226,568,4,198.4102564102564,36,3,17,36.62474663718445,0.6171875,45.354729729729726,1018.5810810810807,28.29391891891891,0
709,4,0,3,35,0.0,0.07894736842105263,0.9210526315789473,38,1650,1200,450,0.7272727272727273,21,12,9,378.0124756704152,0.4220898530109056,0.21604102167182693,0.19772960265837114,126858.71056241433,1992.103208062927,128850.81377047725,569,5,204.5,35,3,16,38.62783394607844,0.5904761904761905,48.14814814814815,1007.407407407408,28.7830687830688,8
710,4,2,0,37,0.05405405405405406,0.0,1.0,37,900,600,300,0.6666666666666666,12,6,6,378.48956052059833,0.42792792792792794,0.2052815687676337,0.19882441677967905,127032.00113378685,2216.0572562358234,129248.05839002268,570,0,199.86486486486487,34,3,18,38.437352385451106,0.5943627450980392,47.976190476190474,1008.0952380952381,29.64985994397759,0
711,4,2,3,36,0.05128205128205128,0.07692307692307693,0.9230769230769231,39,950,700,250,0.7368421052631579,12,7,5,360.29568323833587,0.43406995051731895,0.20578604383437749,0.1921650342305383,127646.96830257637,1398.1445039113983,129045.11280648777,571,0,190.56410256410257,35,4,16,38.26463654411485,0.5985119047619047,47.36689814814815,1010.532407407408,28.872354497354515,0
712,4,0,0,36,0.0,0.0,1.0,36,1100,800,300,0.7272727272727273,14,8,6,384.9425236645408,0.4245205026455026,0.22117941656879836,0.20297641974906044,127184.70848051223,2591.7605308054513,129776.46901131768,572,1,207.38888888888889,33,3,18,38.11745737658447,0.5981691919191919,47.82475490196078,1008.7009803921562,30.566696375519886,0
713,4,0,1,35,0.0,0.027777777777777776,0.9722222222222222,36,850,500,350,0.5882352941176471,12,5,7,382.18577343808516,0.424239417989418,0.21853156289639175,0.20198444534590446,127277.43686322556,2528.7251297577736,129806.16199298334,573,2,208.38888888888889,33,3,18,38.09155129139342,0.5991161616161615,47.732843137254896,1009.0686274509794,30.577837195484225,0
714,4,0,0,35,0.0,0.0,1.0,35,1000,700,300,0.7,13,7,6,387.6302898928009,0.42230392156862745,0.23187390542907127,0.20521301572205647,127346.77105652493,2872.693156310589,130219.46421283552,574,3,213.57142857142858,32,3,17,37.88283921274288,0.6022135416666667,47.66414141414142,1009.3434343434351,31.541982323232347,0
715,4,2,0,37,0.05405405405405406,0.0,1.0,37,800,600,200,0.75,10,6,4,367.8843413968081,0.43021146146146144,0.22649405494446007,0.19776401122906226,127963.7914540817,2015.1750283446754,129978.96648242637,575,0,202.97297297297297,34,3,19,37.748068400203934,0.6038602941176471,47.05357142857143,1011.7857142857149,29.758403361344556,0
716,4,0,0,37,0.0,0.0,1.0,37,1050,800,250,0.7619047619047619,13,8,5,368.11394983436566,0.4302427427427427,0.22579630082864277,0.19848274669889718,128084.27047902481,2029.9213435374006,130114.1918225622,576,1,203.97297297297297,34,3,20,37.61883060880474,0.6050857843137255,46.9345238095238,1012.2619047619037,29.772408963585402,0
717,4,2,0,39,0.05128205128205128,0.0,1.0,39,1200,1100,100,0.9166666666666666,13,11,2,352.1212079320635,0.4334514170040486,0.22282560744099156,0.19260837657923272,128658.13607103738,1260.6516567243038,129918.7877277617,577,0,194.46153846153845,36,3,17,37.43733118733118,0.6067708333333333,46.36824324324325,1014.5270270270281,28.181306306306336,0
718,4,2,1,40,0.04878048780487805,0.024390243902439025,0.975609756097561,41,1050,800,250,0.7619047619047619,13,8,5,339.91103627322224,0.43864329268292684,0.2236337859981643,0.18862926626939464,129229.25954380163,586.4348201178177,129815.69436391945,578,0,185.9268292682927,37,4,21,37.165583773679856,0.6106418918918919,45.80592105263156,1016.7763157894711,27.480440967283005,0
719,4,0,1,39,0.0,0.025,0.975,40,1300,900,400,0.6923076923076923,17,9,8,349.36844934157494,0.4360309829059829,0.22827868852459043,0.193740685543964,129201.3888888887,1027.7777777777537,130229.16666666645,579,1,191.5,36,4,21,36.9535519125683,0.6122685185185186,45.83333333333332,1016.6666666666652,28.240740740740698,0
720,4,1,1,39,0.025,0.025,0.975,40,1500,1200,300,0.8,18,12,6,344.59789879530973,0.4355902777777778,0.22185446515135232,0.1925889400672399,129508.13140822151,925.6459920359796,130433.77740025749,580,0,191.525,37,3,15,36.7628774821358,0.6134572072072072,45.53179824561402,1017.8728070175418,27.51007586533897,0
721,4,0,2,37,0.0,0.05128205128205128,0.9487179487179487,39,850,700,150,0.8235294117647058,10,7,3,340.6252620863564,0.4344073324336482,0.16425717217388303,0.18229283468939622,127783.97108966243,917.9889485226394,128701.96003818508,581,3,197.43589743589743,37,2,16,38.62142121244982,0.5960022522522522,47.231359649122815,1011.0745614035106,27.32633949739218,6
722,4,1,0,38,0.02631578947368421,0.0,1.0,38,850,500,350,0.5882352941176471,12,5,7,350.14481874663386,0.43207681365576106,0.20280291714260534,0.1882735605289353,127973.55791179712,1361.8556478776238,129335.41355967475,582,0,203.44736842105263,36,2,17,38.1867928028195,0.5998263888888888,47.043918918918926,1011.8243243243259,28.106231231231273,0
723,4,1,1,38,0.02564102564102564,0.02564102564102564,0.9743589743589743,39,900,400,500,0.4444444444444444,14,4,10,338.04513816037985,0.4335076473234368,0.20118257819805252,0.18343365365473122,128338.88942992088,876.8675217374729,129215.75695165835,583,0,199.2051282051282,37,2,19,38.119859863651115,0.6016328828828829,46.683114035087726,1013.2675438596502,27.38560929350406,0
724,4,0,1,37,0.0,0.02631578947368421,0.9736842105263158,38,1500,1200,300,0.8,18,12,6,346.6576116343516,0.4325065196775723,0.21389698395421464,0.18759558116963657,128230.06071950342,1290.3853177501965,129520.44603725363,584,1,205.28947368421052,36,2,19,38.01284189459639,0.6024305555555556,46.79054054054055,1012.837837837839,28.134384384384415,0
725,4,0,0,37,0.0,0.0,1.0,37,1100,700,400,0.6363636363636364,15,7,8,352.9462610884393,0.4336211211211211,0.20973269362577107,0.19143070443421287,128320.37278163577,1658.0391589506119,129978.41194058639,525,2,196.05405405405406,35,2,20,37.76130911583275,0.6053571428571429,46.701388888888886,1013.1944444444442,28.948412698412692,0
726,4,0,0,37,0.0,0.0,1.0,37,950,600,350,0.631578947368421,13,6,7,348.85485112381014,0.43308933933933935,0.13646334120978731,0.18086595386471266,126496.56994409971,1425.7884151043206,127922.35835920404,526,3,197.05405405405406,36,1,12,39.73445837531253,0.5847800925925926,48.507882882882896,1005.9684684684701,27.94356856856861,8
727,4,0,0,37,0.0,0.0,1.0,37,1200,900,300,0.75,15,9,6,347.2187833733502,0.4336836836836837,0.13727600950693364,0.1806426941671133,126638.21549590144,1394.2334226118185,128032.44891851327,527,4,198.05405405405406,36,1,13,39.62995077198479,0.5862268518518519,48.367117117117125,1006.5315315315327,27.95920920920924,0
728,4,4,2,39,0.0975609756097561,0.04878048780487805,0.9512195121951219,41,950,600,350,0.631578947368421,13,6,7,319.46810590537496,0.44217479674796745,0.14567750956948666,0.17004400060759198,127565.1095920138,-48.59158937231541,127516.51800264149,528,0,179.6341463414634,39,2,12,39.37968309617104,0.5902777777777778,47.447916666666664,1010.2083333333326,25.902777777777757,0
729,4,2,0,41,0.04878048780487805,0.0,1.0,41,750,400,350,0.5333333333333333,11,4,7,319.1071169303839,0.44082825203252035,0.15373016172201925,0.17063000384624663,127749.32861328126,-46.856011284721944,127702.47260199655,529,0,180.58536585365854,39,2,14,39.20069122445476,0.5921474358974359,47.265625,1010.9375000000001,25.92147435897436,0
730,4,1,0,42,0.023809523809523808,0.0,1.0,42,850,300,550,0.35294117647058826,14,3,11,312.8241829569073,0.44290795586527293,0.15468895745138833,0.1680606983991372,127938.8211898506,-395.52855856302443,127543.29263128758,530,0,177.26190476190476,40,2,15,39.166248116524386,0.5924479166666667,47.078252032520325,1011.6869918699185,25.292174796747965,0
731,4,0,0,42,0.0,0.0,1.0,42,1150,700,450,0.6086956521739131,16,7,9,344.6423761134826,0.4426659891598916,0.17304324327133447,0.17731376150072098,126181.50686990228,436.62529921861784,126618.1321691209,531,1,178.26190476190476,37,5,18,40.164588562697816,0.5796734234234234,48.82127192982456,1004.7149122807017,27.154457088667613,8
732,4,1,1,42,0.023255813953488372,0.023255813953488372,0.9767441860465116,43,1100,700,400,0.6363636363636364,15,7,8,336.1739661176162,0.444813584348468,0.17262200226705215,0.17442150076747084,126527.07151955967,-92.97850920445646,126434.09301035521,532,0,175.09302325581396,38,5,15,40.022034618243566,0.5814144736842105,48.47756410256411,1006.089743589745,26.476045883940657,0
733,4,2,2,42,0.045454545454545456,0.045454545454545456,0.9545454545454546,44,1100,900,200,0.8181818181818182,13,9,4,330.6398591758391,0.4468595842142354,0.18710053387472736,0.17304917304917328,126882.03125000026,-409.54861111108187,126472.48263888918,533,0,171.97727272727272,39,5,17,39.79700854700857,0.5833333333333333,48.125000000000014,1007.500000000002,25.833333333333385,0
734,4,2,2,42,0.045454545454545456,0.045454545454545456,0.9545454545454546,44,1500,1300,200,0.8666666666666667,17,13,4,336.9107682248066,0.44841217406624384,0.2141001462550991,0.1784267342033619,127361.47636788677,-217.93581981882147,127143.54054806795,534,0,172.61363636363637,38,6,15,39.147615015523556,0.5899122807017544,47.649572649572654,1009.4017094017106,26.563202878992385,0
735,4,4,3,43,0.08695652173913043,0.06521739130434782,0.9347826086956522,46,750,400,350,0.5333333333333333,11,4,7,327.11232228459636,0.4516807568438003,0.232429046045308,0.1761877564971495,128041.6555642309,-823.1993398440077,127218.45622438689,535,0,165.3913043478261,40,6,18,38.69991967064967,0.5934895833333333,46.97662601626016,1012.0934959349589,25.30233739837397,0
736,4,1,1,43,0.022727272727272728,0.022727272727272728,0.9772727272727273,44,1500,1100,400,0.7333333333333333,19,11,8,340.80260635834213,0.44792767794221283,0.24057690646031604,0.1830436687241711,127928.27641034752,-80.34199448464545,127847.93441586288,536,0,173.79545454545453,38,6,19,38.46939134720316,0.5956688596491229,47.0886752136752,1011.6452991452975,26.622244714349932,0
737,4,0,0,43,0.0,0.0,1.0,43,1250,800,450,0.64,17,8,9,380.83394134977743,0.4450904392764858,0.24862422727537492,0.19859160042106794,126732.93856042242,1059.3270594948876,127792.2656199173,537,1,178.74418604651163,37,6,16,38.68640876256851,0.5853040540540541,48.27302631578947,1006.907894736842,27.21372688477951,8
738,4,3,4,42,0.06521739130434782,0.08695652173913043,0.9130434782608696,46,1300,900,400,0.6923076923076923,17,9,8,361.85397799464414,0.4521940418679549,0.24314415767876807,0.19222872967989432,127486.19927300338,26.785638068920264,127512.9849110723,538,0,168.02173913043478,39,7,13,38.39017105036961,0.5894764957264957,47.526041666666664,1009.8958333333326,25.894764957264936,0
739,4,1,1,42,0.023255813953488372,0.023255813953488372,0.9767441860465116,43,1300,800,500,0.6153846153846154,18,8,10,380.4384946383447,0.4465669988925803,0.24735729386892258,0.20014372978799863,127092.0138888888,1070.1388888888832,128162.1527777777,539,0,180.65116279069767,37,6,18,38.326446280991746,0.5889639639639639,47.916666666666664,1008.3333333333326,27.25225225225223,0
740,4,2,2,42,0.045454545454545456,0.045454545454545456,0.9545454545454546,44,1150,800,350,0.6956521739130435,15,8,7,378.1819992786032,0.44629800916138124,0.25908898651311696,0.20149110801001408,127604.23657909637,851.5250611805101,128455.76164027688,540,0,177.38636363636363,38,6,16,37.85665820732438,0.5923793859649122,47.409188034188034,1010.363247863248,26.588506522717054,0
741,4,2,2,42,0.045454545454545456,0.045454545454545456,0.9545454545454546,44,1200,900,300,0.75,15,9,6,374.6419799492703,0.44608879492600423,0.27111418366171147,0.20108334842175152,127901.25739644993,783.4360618014706,128684.69345825141,541,0,177.5,38,6,19,37.641265314744395,0.5953947368421053,47.11538461538463,1011.5384615384635,26.61943319838062,0
742,4,1,1,42,0.023255813953488372,0.023255813953488372,0.9767441860465116,43,1350,1000,350,0.7407407407407407,17,10,7,367.6426959240832,0.4470514950166113,0.25736990389429293,0.19839306301689155,128117.48940755367,820.2918401636533,128937.78124771733,542,0,174.48837209302326,38,5,20,37.59673561277614,0.5975877192982456,46.90170940170941,1012.3931623931637,26.641925326135887,0
743,4,2,2,42,0.045454545454545456,0.045454545454545456,0.9545454545454546,44,1200,900,300,0.75,15,9,6,357.83526542103414,0.4482690274841437,0.25616529660075504,0.19475411483193178,128458.27880245114,393.3890188665422,128851.66782131768,543,0,171.3181818181818,36,8,14,37.496528549211284,0.6047453703703703,46.56531531531532,1013.7387387387391,28.15940940940942,0
744,4,1,0,43,0.023255813953488372,0.0,1.0,43,1050,900,150,0.8571428571428571,12,9,3,363.7812539956398,0.4483204134366925,0.2654795462002928,0.19784864454469808,128429.74044568212,744.0664059329533,129173.80685161508,544,0,176.09302325581396,36,7,16,37.37501388734585,0.6044560185185186,46.593468468468465,1013.6261261261258,28.15628128128127,0
745,4,0,1,42,0.0,0.023255813953488372,0.9767441860465116,43,1200,900,300,0.75,15,9,6,367.3064597032743,0.44797434477667036,0.2631096419301939,0.20033886551350608,128543.91289515868,843.001912385361,129386.91480754403,545,1,177.09302325581396,36,7,16,37.16893392559689,0.6056134259259259,46.48085585585586,1014.0765765765766,28.168793793793796,0
746,4,1,2,41,0.023255813953488372,0.046511627906976744,0.9534883720930233,43,1200,900,300,0.75,15,9,6,370.87662221461693,0.4466362126245847,0.258357800011352,0.2035981652035662,128800.9863748884,953.8549529259003,129754.8413278143,546,0,178.0,36,7,18,36.81564788107389,0.6082175925925926,46.22747747747748,1015.09009009009,28.196946946946944,0
747,4,0,0,41,0.0,0.0,1.0,41,1600,1200,400,0.75,20,12,8,391.7455331853789,0.44428353658536585,0.27175982523999376,0.2137911721464602,128566.7534722223,1873.0902777777835,130439.84375000009,547,1,187.4390243902439,34,7,18,36.52595179402903,0.6099877450980392,46.458333333333336,1014.1666666666673,29.828431372549037,0
748,4,0,0,41,0.0,0.0,1.0,41,1100,600,500,0.5454545454545454,16,6,10,392.7585589860681,0.4442327235772358,0.2748049114448239,0.21459700816420826,128613.70991941009,1902.8270747599338,130516.53699417002,548,2,188.4390243902439,35,6,18,36.45215274608245,0.6083333333333334,46.41203703703703,1014.3518518518514,28.981481481481467,0
749,4,1,1,41,0.023809523809523808,0.023809523809523808,0.9761904761904762,42,1400,1000,400,0.7142857142857143,18,10,8,387.63526236350845,0.44673102981029805,0.2724897054165347,0.2137206642126435,128972.5113627141,1598.8586559532505,130571.37001866735,549,0,184.92857142857142,36,6,19,36.214892830746486,0.6099537037037037,46.05855855855856,1015.765765765766,28.21571571571572,0
750,4,1,0,42,0.023809523809523808,0.0,1.0,42,850,300,550,0.35294117647058826,14,3,11,392.8177065494924,0.4475779132791328,0.289747160634499,0.21767743628129324,129172.76810171655,1748.270102873139,130921.03820458968,550,0,185.6904761904762,36,6,20,35.87847568405894,0.6119791666666667,45.861486486486484,1016.5540540540537,28.237612612612605,0
751,4,0,0,42,0.0,0.0,1.0,42,1200,900,300,0.75,15,9,6,393.1611920532921,0.44703348819202476,0.29143995950904733,0.2186595989301312,129315.9037415793,1768.3989732976063,131084.30271487692,551,1,186.6904761904762,36,6,20,35.72344626513137,0.6134259259259259,45.72072072072071,1017.1171171171162,28.253253253253227,0
752,4,1,0,43,0.023255813953488372,0.0,1.0,43,1300,1000,300,0.7692307692307693,16,10,6,392.0776513070277,0.4473975636766334,0.30081390343281056,0.22053181210320205,129759.37307633107,1575.1500461680403,131334.52312249911,552,0,183.32558139534885,37,6,16,35.298285263308934,0.615990990990991,45.28508771929824,1018.8596491228062,27.536747273589356,0
753,4,1,3,41,0.022727272727272728,0.06818181818181818,0.9318181818181819,44,850,500,350,0.5882352941176471,12,5,7,389.2330140219276,0.44880857998590556,0.3020092537057668,0.22084290260816275,130099.04308431932,1327.7685322156256,131426.81161653495,553,0,180.13636363636363,38,6,17,35.02460990679652,0.6175986842105263,44.951923076923066,1020.192307692306,26.84716599190279,0
754,4,2,2,41,0.046511627906976744,0.046511627906976744,0.9534883720930233,43,600,300,300,0.5,9,3,6,391.8009626570839,0.4489202657807309,0.3122737662379922,0.2235846212049103,130323.35778061197,1612.4715924337831,131935.82937304577,554,0,181.48837209302326,34,9,19,34.730723640744614,0.6277573529411764,44.73214285714284,1021.0714285714263,30.03151260504195,0
755,4,0,0,41,0.0,0.0,1.0,41,1700,900,800,0.5294117647058824,25,9,16,396.9156329296193,0.4454014227642276,0.31263858093126395,0.22703574203574206,130414.54081632645,2152.714002267566,132567.25481859402,555,1,189.4390243902439,34,7,19,34.50733294483295,0.6286764705882353,44.64285714285714,1021.4285714285708,30.04201680672267,0
756,4,0,0,41,0.0,0.0,1.0,41,1500,900,600,0.6,21,9,12,396.6047063871406,0.44443597560975606,0.3076625826836088,0.22757050799647147,130536.16780045342,2154.251700680262,132690.41950113367,556,2,190.4390243902439,34,7,16,34.391503572538056,0.6299019607843137,44.52380952380952,1021.9047619047611,30.056022408963564,0
757,4,0,1,40,0.0,0.024390243902439025,0.975609756097561,41,1300,900,400,0.6923076923076923,17,9,8,400.4564161515654,0.44390243902439025,0.31203494382405395,0.23050400146847444,130657.8514739227,2264.554988662105,132922.4064625848,557,3,191.4390243902439,34,7,17,34.1692866014594,0.6311274509803921,44.40476190476189,1022.3809523809507,30.070028011204432,0
758,4,1,1,40,0.024390243902439025,0.024390243902439025,0.975609756097561,41,900,600,300,0.6666666666666666,12,6,6,401.4976847410173,0.4464176829268293,0.3242951801245766,0.23238199328949757,130870.93431122432,2308.8754251700493,133179.80973639438,558,0,192.0,34,7,18,33.925974403723096,0.6332720588235294,44.19642857142856,1023.2142857142843,30.09453781512601,0
759,4,0,0,40,0.0,0.0,1.0,40,1300,1000,300,0.7692307692307693,16,10,6,407.8712134096014,0.4441907051282051,0.326629327902241,0.23560560680483994,130794.81336805536,2669.4878472221976,133464.30121527755,559,1,197.7,33,7,18,33.840376782077385,0.6347853535353536,44.27083333333332,1022.916666666665,30.997474747474698,0
760,4,0,0,40,0.0,0.0,1.0,40,1100,800,300,0.7272727272727273,14,8,6,403.99756176270233,0.44424412393162394,0.3203772455089824,0.2339375617696645,130888.84833958081,2575.755118223747,133464.60345780457,560,2,198.7,33,7,19,33.8438123752495,0.6357323232323233,44.178921568627445,1023.2843137254894,31.008615567439072,0
761,4,1,1,40,0.024390243902439025,0.024390243902439025,0.975609756097561,41,1350,900,450,0.6666666666666666,18,9,9,376.83429792414955,0.44494410569105686,0.2793041071276814,0.2062834072287784,128688.43102744625,1524.824505055453,130213.2555325017,561,0,194.82926829268294,32,9,18,36.77954413472706,0.6158854166666667,46.33838383838384,1014.6464646464651,31.707702020202035,8
762,4,0,0,40,0.0,0.0,1.0,40,900,700,200,0.7777777777777778,11,7,4,387.4431688036898,0.44348290598290596,0.2870282413350449,0.21165373667466658,128606.37240939675,1965.5320909288243,130571.90450032557,562,1,199.6,31,9,18,36.59445870774497,0.6176075268817205,46.419270833333336,1014.3229166666671,32.72009408602152,0
763,4,0,0,40,0.0,0.0,1.0,40,1050,700,350,0.6666666666666666,14,7,7,388.53781764890476,0.4428418803418803,0.2939407540394974,0.21366839929662634,128870.65463595928,2014.2245822482737,130884.87921820756,563,2,200.6,31,9,20,36.29616568350858,0.6202956989247312,46.15885416666667,1015.3645833333339,32.75369623655916,0
764,4,2,0,42,0.047619047619047616,0.0,1.0,42,550,300,250,0.5454545454545454,8,3,5,369.4600180340188,0.44387582268679826,0.2954335700814572,0.2066736949366057,129544.24267409176,1172.2836469146555,130716.52632100641,564,0,192.0,33,9,17,36.093430239557,0.6221590909090908,45.49632352941177,1018.0147058823535,30.84893048128344,0
765,4,0,0,42,0.0,0.0,1.0,42,1100,500,600,0.45454545454545453,17,5,12,372.72712668684886,0.44356126596980255,0.2960217279992876,0.20925546561238054,129685.96938775516,1267.4957482993277,130953.4651360545,565,1,193.0,34,8,17,35.86591280972418,0.6213235294117647,45.35714285714286,1018.571428571429,29.957983193277325,0
766,4,1,0,43,0.023255813953488372,0.0,1.0,43,900,600,300,0.6666666666666666,12,6,6,365.152216626573,0.44541343669250644,0.2993681489005262,0.207264442341484,130114.93866008677,902.35165359227,131017.29031367904,566,0,189.48837209302326,35,8,19,35.622636604273005,0.6235119047619048,44.9363425925926,1020.2546296296312,29.150132275132318,0
767,4,1,2,42,0.022727272727272728,0.045454545454545456,0.9545454545454546,44,1300,1000,300,0.7692307692307693,16,10,6,360.3520789229905,0.44636407681465823,0.3104648700164139,0.20693127742835285,130566.58340419512,610.1554025030955,131176.7388066982,567,0,186.1590909090909,34,10,16,35.28683750728016,0.6302083333333333,44.49404761904763,1022.0238095238103,30.05952380952383,0
768,4,0,0,42,0.0,0.0,1.0,42,1100,900,200,0.8181818181818182,13,9,4,404.5405144306246,0.4429926442121564,0.3152145473574046,0.21654815772462827,127793.20987654309,1952.2612748803078,129745.4711514234,568,1,195.47619047619048,32,10,19,36.99633699633699,0.6067708333333333,47.222222222222214,1011.1111111111102,31.597222222222193,8
769,4,1,0,43,0.023255813953488372,0.0,1.0,43,700,500,200,0.7142857142857143,9,5,4,392.6676451017096,0.4445828719084533,0.3092965261265441,0.2122098728918942,128176.49347005399,1466.6346227425693,129643.12809279656,569,0,191.90697674418604,32,11,20,36.90279509559435,0.6106770833333333,46.84343434343434,1012.626262626262,31.644570707070688,0
770,4,1,1,43,0.022727272727272728,0.022727272727272728,0.9772727272727273,44,1300,800,500,0.6153846153846154,18,8,10,379.3221783655799,0.4470027307963354,0.3126523754090802,0.2073995371539146,128641.33536380224,959.3023116109013,129600.63767541313,570,0,188.52272727272728,33,11,20,36.76461705726021,0.6130050505050505,46.38480392156862,1014.4607843137243,30.741235888294675,0
771,4,1,0,44,0.022727272727272728,0.0,1.0,44,950,500,450,0.5263157894736842,14,5,9,380.2170591099573,0.4482029598308668,0.31957877287547665,0.20837706594901081,128734.59314025837,989.4176819011705,129724.01082215954,571,0,189.47727272727272,33,11,21,36.646515114921705,0.6139520202020202,46.292892156862735,1014.8284313725475,30.752376708259014,0
772,4,1,1,44,0.022222222222222223,0.022222222222222223,0.9777777777777777,45,1900,1400,500,0.7368421052631579,24,14,10,375.1331809090823,0.4486111111111111,0.32308132875143203,0.20739228188082412,129080.38548752827,684.467120181399,129764.85260770968,572,0,186.24444444444444,34,11,22,36.422211808809735,0.6151960784313726,45.95238095238095,1016.1904761904757,29.887955182072815,0
773,4,3,1,46,0.06382978723404255,0.02127659574468085,0.9787234042553191,47,1200,600,600,0.5,18,6,12,359.19154076761197,0.44933317915510335,0.3266521806148779,0.20196854177984422,129746.60572562378,-79.1099773242394,129667.49574829954,573,0,179.08510638297872,34,13,20,36.14892498247254,0.6219362745098039,45.29761904761906,1018.8095238095254,29.964985994397807,0
774,4,0,0,46,0.0,0.0,1.0,46,1400,1100,300,0.7857142857142857,17,11,6,366.91136192057957,0.4487218196457327,0.3355947191887263,0.20557427553594743,129606.62853529911,310.82891796426463,129917.45745326337,574,1,183.97826086956522,33,13,20,36.094771733461705,0.622790404040404,45.43504901960785,1018.2598039215701,30.856357694593033,0
775,4,0,1,45,0.0,0.021739130434782608,0.9782608695652174,46,1600,1000,600,0.625,22,10,12,382.00725525144514,0.4489834943639291,0.3401331499368512,0.2059738548765398,128084.2704790247,597.1816821090891,128681.45216113378,575,2,184.97826086956522,34,12,20,37.26723901368144,0.6050857843137255,46.934523809523796,1012.2619047619028,29.772408963585377,7
776,4,0,1,44,0.0,0.022222222222222223,0.9777777777777777,45,1500,1000,500,0.6666666666666666,20,10,10,387.91105065985045,0.44789562289562285,0.35637341942426715,0.20914786412861366,128082.49831795452,936.923298731244,129019.42161668577,576,3,190.04444444444445,33,12,20,37.11965294592414,0.6073232323232323,46.936274509803916,1012.2549019607834,30.67439096850859,0
777,4,1,0,45,0.022222222222222223,0.0,1.0,45,650,300,350,0.46153846153846156,10,3,7,384.2904923823631,0.4474116161616162,0.3550608321570212,0.2080000602187446,128237.60880730963,856.0987660995721,129093.7075734092,577,0,190.93333333333334,33,12,21,37.0522030651341,0.6089015151515151,46.783088235294116,1012.8676470588231,30.69295900178252,0
778,4,1,1,45,0.021739130434782608,0.021739130434782608,0.9782608695652174,46,1050,700,350,0.6666666666666666,14,7,7,375.04238928568515,0.4479971819645732,0.35525953287144296,0.20514192820876817,128657.32001133786,450.3897392290257,129107.70975056688,578,0,187.7608695652174,34,12,16,36.85681178127201,0.610906862745098,46.36904761904762,1014.5238095238094,29.838935574229687,0
779,4,0,0,45,0.0,0.0,1.0,45,1100,700,400,0.6363636363636364,15,7,8,383.0766178907327,0.4474747474747475,0.35952764358561495,0.20978005265444882,128703.50346020755,860.6605632448983,129564.16402345244,579,1,192.9111111111111,33,12,17,36.60577697262479,0.6136363636363636,46.3235294117647,1014.7058823529406,30.74866310160426,0
780,4,1,1,45,0.021739130434782608,0.021739130434782608,0.9782608695652174,46,1150,800,350,0.6956521739130435,15,8,7,378.28307373141877,0.4482387278582931,0.36641269970613877,0.2092937524591784,129110.63102324268,568.073270975066,129678.70429421774,580,0,189.69565217391303,34,12,18,36.31130178438952,0.6155024509803921,45.92261904761905,1016.3095238095241,29.89145658263306,0
781,4,3,0,48,0.0625,0.0,1.0,48,1650,1300,350,0.7878787878787878,20,13,7,358.359573844426,0.448969414893617,0.3631104486087451,0.20187818603328023,129819.89354263117,-295.5277669516903,129524.36577567947,581,0,182.54166666666666,35,13,19,36.095613287904605,0.6205357142857143,45.22569444444444,1019.0972222222222,29.11706349206349,0
782,4,2,1,49,0.04,0.02,0.98,50,1500,1000,500,0.6666666666666666,20,10,10,344.0089152498663,0.4496938775510204,0.35906437768240296,0.19742383559906118,130542.57079101255,-1018.438365650982,129524.13242536156,582,0,176.2,37,13,17,35.72871959942775,0.6238738738738738,44.517543859649116,1021.9298245614029,27.619724988146025,0
783,4,0,0,49,0.0,0.0,1.0,49,1400,1000,400,0.7142857142857143,18,10,8,352.4723605832939,0.44894416099773243,0.3682110621291186,0.20142229603843043,130377.57087746524,-609.1019651408276,129768.46891232442,583,1,180.79591836734693,36,13,20,35.67969640166134,0.6241319444444444,44.67905405405405,1021.2837837837834,28.368993993993982,0
784,4,1,1,49,0.02,0.02,0.98,50,1000,500,500,0.5,15,5,10,345.6784602215747,0.4498979591836734,0.362505362505362,0.1989571582164174,130654.64854570635,-967.1004539858459,129687.54809172051,584,0,178.16,37,13,18,35.57262619762619,0.625,44.4078947368421,1022.3684210526314,27.631578947368418,0
785,4,0,0,49,0.0,0.0,1.0,49,1300,700,600,0.5384615384615384,19,7,12,348.8611355471936,0.4499362244897959,0.3556813806139958,0.20137231883565723,130766.77439212053,-676.1109187442414,130090.66347337629,585,1,178.18367346938774,37,12,19,35.37780517438538,0.6261261261261262,44.29824561403508,1022.8070175438586,27.64343290659077,0
786,4,0,2,47,0.0,0.04081632653061224,0.9591836734693877,49,2100,1500,600,0.7142857142857143,27,15,12,349.7097845730725,0.44965277777777773,0.3491995469711353,0.2027447906338544,130935.05333371794,-642.1461411203592,130292.90719259757,586,2,179.18367346938774,37,12,19,35.185879580030004,0.6278153153153153,44.133771929824555,1023.4649122807007,27.661213845424342,0
787,4,0,0,47,0.0,0.0,1.0,47,1150,700,450,0.6086956521739131,16,7,9,365.1619955398004,0.44771430773974713,0.3560518114249105,0.21028950903511057,130676.44702717756,143.61443329902835,130820.06146047659,587,3,187.59574468085106,35,12,19,35.05254320428647,0.6291666666666667,44.38657407407407,1022.4537037037031,29.212962962962948,0
788,4,0,1,46,0.0,0.02127659574468085,0.9787234042553191,47,1250,800,450,0.64,17,8,9,366.7783505976051,0.446904872032069,0.3597884616773339,0.21203099025063638,130824.41332572432,196.7125075016939,131021.12583322602,588,4,188.59574468085106,35,12,19,34.86124467322848,0.6306547619047619,44.24189814814814,1023.0324074074064,29.229497354497326,0
789,4,0,2,44,0.0,0.043478260869565216,0.9565217391304348,46,1200,1100,100,0.9166666666666666,13,11,2,368.35237251619486,0.44747383252818035,0.34697776663076696,0.2132680632230305,130883.62328800141,442.25863233023415,131325.88192033165,589,5,185.1304347826087,35,11,20,34.760985748218516,0.63125,44.18402777777777,1023.2638888888879,29.236111111111082,0
790,4,2,1,45,0.043478260869565216,0.021739130434782608,0.9782608695652174,46,900,500,400,0.5555555555555556,13,5,8,361.3607800144021,0.4474838969404187,0.33785362597012436,0.211818162050798,131357.78523930462,294.26386745540697,131652.04910676004,590,0,173.2608695652174,35,11,22,34.46014922283693,0.6360119047619048,43.72106481481481,1025.11574074074,29.289021164021143,0
791,4,0,1,44,0.0,0.022222222222222223,0.9777777777777777,45,1750,1200,550,0.6857142857142857,23,12,11,374.8949121857429,0.44608585858585864,0.346193941270579,0.21993153840215351,131389.14399092953,851.4243197278755,132240.5683106574,591,1,177.73333333333332,34,11,22,34.08156254838212,0.6384803921568627,43.69047619047618,1025.2380952380938,30.154061624649817,0
792,4,1,1,44,0.022222222222222223,0.022222222222222223,0.9777777777777777,45,1000,800,200,0.8,12,8,4,347.0072388991307,0.44448653198653204,0.18855045521712177,0.19972194416638855,130654.64854570635,71.4801866037215,130726.12873231007,592,0,178.17777777777778,37,8,19,35.538663663663655,0.625,44.4078947368421,1022.3684210526314,27.631578947368418,8
793,4,0,0,44,0.0,0.0,1.0,44,900,600,300,0.6666666666666666,12,6,6,353.59616352713385,0.4435782241014799,0.19592226105942112,0.20326740825432507,130607.69120049098,436.4757071260393,131044.16690761702,593,1,183.04545454545453,36,8,19,35.41781425581138,0.6264467592592593,44.453828828828826,1022.1846846846843,28.39401901901901,0
794,4,0,2,42,0.0,0.045454545454545456,0.9545454545454546,44,1400,1000,400,0.7142857142857143,18,10,8,354.50360264674674,0.44312676180408733,0.19590090441291164,0.20462930727034964,130766.77439212053,471.45852570020486,131238.23291782074,594,2,184.04545454545453,37,7,19,35.23352630074329,0.6261261261261262,44.29824561403508,1022.8070175438586,27.64343290659077,0
795,4,0,0,42,0.0,0.0,1.0,42,1450,1100,350,0.7586206896551724,18,11,7,369.4798058564045,0.44024632210607817,0.21508349774141045,0.21277604986541565,130676.44702717756,1256.4616555212529,131932.90868269882,595,3,193.4047619047619,35,7,19,34.94217417553393,0.6291666666666667,44.38657407407407,1022.4537037037031,29.212962962962948,0
796,4,1,2,41,0.023255813953488372,0.046511627906976744,0.9534883720930233,43,1150,700,450,0.6086956521739131,16,7,9,363.74328809786414,0.4410068290882245,0.21550575191922539,0.21129650045352577,131010.89000740586,930.8663815842694,131941.75638899012,596,0,189.88372093023256,36,7,20,34.75002749972501,0.6304976851851851,44.059684684684676,1023.7612612612597,28.43781281281277,0
797,4,0,0,41,0.0,0.0,1.0,41,1250,800,450,0.64,17,8,9,373.0039672836775,0.43821138211382116,0.2066482747089684,0.21656498996022455,130991.1703601107,1572.0452446906645,132563.21560480137,597,1,189.3170731707317,37,4,20,34.532990574121676,0.6283783783783784,44.07894736842105,1023.6842105263149,27.66714082503554,0
798,4,0,0,41,0.0,0.0,1.0,41,1300,900,400,0.6923076923076923,17,9,8,371.07436846077576,0.43737296747967475,0.20852065938771158,0.21639055868667692,131159.5935768697,1533.9926708217793,132693.58624769148,598,2,190.3170731707317,37,4,20,34.41179618925284,0.6300675675675675,43.91447368421052,1024.342105263157,27.68492176386911,0
799,4,0,0,41,0.0,0.0,1.0,41,1400,1100,300,0.7857142857142857,17,11,6,369.94258670713293,0.43734756097560973,0.21432933353515038,0.21636316741957826,131271.9358360263,1512.6159010464573,132784.55173707276,599,3,191.3170731707317,37,4,21,34.32707397103929,0.6311936936936937,43.8048245614035,1024.7807017543846,27.696775723091477,0
800,4,0,0,41,0.0,0.0,1.0,41,1450,1200,250,0.8275862068965517,17,12,5,374.68833286415673,0.43625508130081303,0.21206221144429405,0.22018202032354403,131453.76778162265,1650.8867114821835,133104.65449310484,600,4,192.3170731707317,33,8,21,34.02147068196304,0.6414141414141414,43.62745098039217,1025.490196078433,31.075460487225243,0
801,4,0,0,41,0.0,0.0,1.0,41,1150,700,450,0.6086956521739131,16,7,9,376.00496265486936,0.43605182926829267,0.21504621637072718,0.22164232340353407,131572.2859977326,1694.3664965986616,133266.65249433127,601,5,193.3170731707317,34,7,18,33.867825094762914,0.6403186274509804,43.51190476190477,1025.9523809523823,30.175070028011245,0
802,4,0,2,39,0.0,0.04878048780487805,0.9512195121951219,41,1250,700,550,0.56,18,7,11,379.2299203942491,0.4361534552845528,0.21854744936499326,0.22408095570382636,131663.90483276665,1786.1784297052363,133450.0832624719,602,6,194.3170731707317,34,7,18,33.692437072265385,0.6412377450980392,43.42261904761906,1026.3095238095254,30.185574229691923,0
803,4,0,1,38,0.0,0.02564102564102564,0.9743589743589743,39,900,700,200,0.7777777777777778,11,7,4,387.78243524803815,0.43347953216374274,0.21687307401593126,0.22995251415026968,131799.59518274217,2421.913596933869,134221.50877967605,603,7,193.12820512820514,33,6,18,33.33569538926683,0.6448863636363636,43.29044117647059,1026.8382352941173,31.116310160427798,0
804,4,0,0,38,0.0,0.0,1.0,38,1450,1100,350,0.7586206896551724,18,11,7,394.46401188094586,0.4317804646752015,0.2206806414316591,0.23333549177364435,131705.23356401388,2790.5949634755866,134495.82852748947,604,12,199.02631578947367,33,5,18,33.25971028334925,0.6439393939393939,43.38235294117647,1026.4705882352944,31.105169340463465,0
805,4,0,1,37,0.0,0.02631578947368421,0.9736842105263158,38,650,400,250,0.6153846153846154,9,4,5,397.2975567676797,0.43167674253200566,0.21833906121397528,0.2352057691196365,131736.68368235786,2867.7325127355007,134604.41619509336,605,13,200.02631578947367,33,5,18,33.1551420556285,0.6442550505050505,43.35171568627452,1026.593137254903,31.108882947118275,0
806,4,1,0,38,0.02631578947368421,0.0,1.0,38,500,300,200,0.6,7,3,4,394.9131815252585,0.43078769559032715,0.19764812699528367,0.21234559760649022,127973.5579117971,2507.6889812109557,130481.24689300806,606,0,200.07894736842104,36,2,20,37.054349842329785,0.5998263888888888,47.043918918918926,1011.8243243243257,28.10623123123127,8
807,4,1,0,39,0.02564102564102564,0.0,1.0,39,1350,700,650,0.5185185185185185,20,7,13,389.80746603212447,0.43229869545659017,0.2077121844563703,0.2119298062450517,128415.88010204092,2211.83616738637,130627.71626942728,607,0,195.92307692307693,34,5,18,36.72970010179312,0.6084558823529411,46.60714285714286,1013.5714285714294,29.810924369747923,0
808,4,0,1,38,0.0,0.02564102564102564,0.9743589743589743,39,1400,1100,300,0.7857142857142857,17,11,6,392.4207120571423,0.4324392712550607,0.2178539072540724,0.2141596442033819,128566.7534722221,2290.451388888881,130857.20486111098,608,1,196.92307692307693,34,5,19,36.508833196384586,0.6099877450980392,46.45833333333333,1014.1666666666656,29.828431372548987,0
809,4,0,0,38,0.0,0.0,1.0,38,1250,600,650,0.48,19,6,13,393.22585950749726,0.43209163110478904,0.21756978653530368,0.21574283643249156,128778.12499999988,2527.777777777766,131305.90277777764,609,2,200.1315789473684,34,4,19,36.271893814997256,0.6121323529411764,46.24999999999999,1014.9999999999991,29.852941176470562,0
810,4,1,1,38,0.02564102564102564,0.02564102564102564,0.9743589743589743,39,1100,800,300,0.7272727272727273,14,8,6,386.11437731580145,0.4341824111560954,0.21967351884279251,0.2136653231844875,129117.79495854497,2170.847400161588,131288.64235870657,610,0,195.97435897435898,37,2,21,36.10500503470348,0.6095157657657657,45.915570175438596,1016.3377192982459,27.4685870080607,0
811,4,1,0,39,0.02564102564102564,0.0,1.0,39,700,400,300,0.5714285714285714,10,4,6,381.87023342675747,0.4348571749887539,0.22126271704686573,0.21277091798046557,129388.34372597063,2082.0196106387643,131470.36333660939,611,0,194.69230769230768,33,6,22,35.93662169758292,0.6205808080808081,45.64950980392156,1017.4019607843125,30.830362448009467,0
812,4,0,0,39,0.0,0.0,1.0,39,1250,900,350,0.72,16,9,7,377.9624299319399,0.4344354475933423,0.21018913689511853,0.21176600339207607,129606.62853529886,1997.287251297568,131603.91578659642,612,1,195.69230769230768,33,6,20,35.81345027480242,0.622790404040404,45.43504901960784,1018.2598039215682,30.856357694592976,0
813,4,1,0,40,0.025,0.0,1.0,40,1150,700,450,0.6086956521739131,16,7,9,367.07620002011356,0.4370726495726496,0.2234057642119598,0.2080413215933929,130055.90284475726,1548.085321287707,131603.98816604496,613,0,191.775,35,5,22,35.63355743409356,0.6229166666666667,44.994212962962955,1020.0231481481472,29.143518518518494,0
814,4,1,0,41,0.024390243902439025,0.0,1.0,41,1300,900,400,0.6923076923076923,17,9,8,356.6068025076512,0.43864329268292684,0.21920230625549086,0.20381943762246066,130384.14292800432,1099.502661468371,131483.6455894727,614,0,188.0731707317073,34,7,23,35.567470956210904,0.6283700980392157,44.67261904761904,1021.3095238095221,30.038515406162418,0
815,4,0,1,40,0.0,0.024390243902439025,0.975609756097561,41,800,600,200,0.75,10,6,4,355.707675651356,0.43846544715447155,0.21381810742618157,0.20410392298069766,130536.16780045332,1086.5433673469124,131622.71116780024,615,1,189.0731707317073,34,7,19,35.43632533395464,0.6299019607843137,44.52380952380951,1021.9047619047603,30.05602240896354,0
816,4,0,1,39,0.0,0.025,0.975,40,1100,700,400,0.6363636363636364,15,7,8,355.3177257271087,0.43716613247863245,0.21090893210667327,0.2043612398405008,130627.42524092946,1282.8479308389747,131910.27317176844,616,2,191.475,34,6,19,35.35382943208729,0.6308210784313726,44.434523809523796,1022.2619047619028,30.0665266106442,0
817,4,0,0,39,0.0,0.0,1.0,39,1250,900,350,0.72,16,9,7,365.5052446229165,0.4344073324336482,0.21575737444755094,0.20943073707362567,130481.60750973175,1738.3423743271699,132219.9498840589,617,4,197.33333333333334,33,6,22,35.241368797728995,0.6316287878787878,44.577205882352935,1021.6911764705875,30.960338680926895,0
818,4,0,0,39,0.0,0.0,1.0,39,1400,900,500,0.6428571428571429,19,9,10,364.5296769441172,0.43347953216374274,0.21595302279898854,0.20998963080301974,130688.28125000001,1727.9513888888905,132416.2326388889,618,5,198.33333333333334,34,5,20,35.056710133116006,0.6314338235294117,44.375,1022.5000000000001,30.07352941176471,0
819,4,0,0,39,0.0,0.0,1.0,39,950,600,350,0.631578947368421,13,6,7,359.1433923211378,0.43339518668466037,0.09155793758877673,0.1949349286901151,128349.69142500414,1430.2998274605463,129779.9912524647,619,6,199.33333333333334,35,4,17,37.574362269179524,0.6056547619047619,46.672453703703695,1013.3101851851841,28.951719576719544,8
820,4,0,1,38,0.0,0.02564102564102564,0.9743589743589743,39,800,400,400,0.5,12,4,8,359.542127978983,0.43314215024741337,0.08963821566561281,0.19586996524228173,128496.33487654311,1439.9691358024575,129936.30401234557,620,7,200.33333333333334,35,4,16,37.414383561643824,0.6071428571428572,46.52777777777777,1013.8888888888881,28.968253968253947,0
821,4,0,0,38,0.0,0.0,1.0,38,950,700,250,0.7368421052631579,12,7,5,362.5224274724109,0.4310247747747748,0.10057925382013044,0.1973482872735145,128466.99948827589,1714.4337009173519,130181.43318919324,621,8,206.3684210526316,35,3,16,37.368825398637576,0.606845238095238,46.55671296296296,1013.7731481481482,28.96494708994709,0
822,4,0,0,38,0.0,0.0,1.0,38,1250,1100,150,0.88,14,11,3,363.07280583948807,0.4308469653864391,0.09624103041402687,0.198523589718223,128643.06205257637,1741.3594982424618,130384.42155081882,622,9,207.3684210526316,35,3,16,37.174961969956264,0.6086309523809523,46.383101851851855,1014.4675925925931,28.98478835978837,0
823,4,1,0,39,0.02564102564102564,0.0,1.0,39,1400,1100,300,0.7857142857142857,17,11,6,352.596457334443,0.4320737741790373,0.09831191607047907,0.19454266921186616,129001.10995708557,1297.06687261587,130298.17682970145,623,0,203.02564102564102,36,3,17,37.07552747293352,0.6102430555555556,46.03040540540541,1015.8783783783792,28.218843843843867,0
824,4,0,0,39,0.0,0.0,1.0,39,1000,700,300,0.7,13,7,6,352.8087612544205,0.43198942869995505,0.10076065610046192,0.19537259359787798,129145.65659626042,1312.7438250230848,130458.40042128351,624,1,204.02564102564102,37,2,17,36.92286947141315,0.6097972972972974,45.88815789473684,1016.4473684210529,27.471550497866296,0
825,4,0,0,39,0.0,0.0,1.0,39,1550,1300,250,0.8387096774193549,18,13,5,355.8567909863119,0.4311178587494377,0.10443749945286318,0.19778074777967886,129289.65627411267,1401.7444837460687,130691.40075785873,625,2,205.02564102564102,35,4,18,36.69874530556503,0.6151785714285714,45.74652777777778,1017.013888888889,29.057539682539687,0
826,4,0,0,39,0.0,0.0,1.0,39,1050,600,450,0.5714285714285714,15,6,9,356.3202935935522,0.43100539811066124,0.10779267766067946,0.19818624937342638,129319.08543381347,1415.802897805218,130734.88833161868,626,3,206.02564102564102,35,4,18,36.65699438628433,0.6154761904761905,45.717592592592595,1017.1296296296299,29.060846560846567,0
827,4,2,0,41,0.04878048780487805,0.0,1.0,41,1500,1000,500,0.6666666666666666,20,10,10,339.523018513155,0.4346544715447154,0.12971258568039712,0.1927554415658885,130122.70752779729,635.9308873884565,130758.63841518575,627,0,196.9268292682927,37,4,18,36.268471252015054,0.6196509009009009,44.92872807017545,1020.2850877193005,27.575272641062174,0
828,4,1,0,42,0.023809523809523808,0.0,1.0,42,1150,600,550,0.5217391304347826,17,6,11,333.9719964004888,0.43587882307394504,0.13306043602244477,0.1913869042103172,130486.54994806115,315.84586122655827,130802.3958092877,628,0,193.21428571428572,37,5,20,36.041800815625685,0.6233108108108107,44.572368421052644,1021.7105263157912,27.613798008534896,0
829,4,0,0,42,0.0,0.0,1.0,42,1450,1100,350,0.7586206896551724,18,11,7,330.7376813936399,0.4355763646922184,0.135302050449015,0.1900824085050257,130598.60365689472,238.7758733456801,130837.3795302404,629,1,194.21428571428572,37,5,17,36.01113852535222,0.6244369369369369,44.46271929824563,1022.1491228070199,27.625651967757296,0
830,4,0,0,42,0.0,0.0,1.0,42,750,400,350,0.5333333333333333,11,4,7,331.56884550783286,0.43539488966318235,0.1317862122860518,0.1906981089863991,130626.62459843433,262.3438221376034,130888.96842057192,630,2,195.21428571428572,37,5,17,35.96157799706818,0.6247184684684685,44.43530701754387,1022.258771929826,27.628615457562866,0
831,4,0,1,41,0.0,0.023809523809523808,0.9761904761904762,42,1100,800,300,0.7272727272727273,14,8,6,335.4670765512255,0.43428184281842813,0.13240953401725064,0.1939224178576789,130822.8553497231,377.3521660511012,131200.2075157742,631,3,196.21428571428572,37,5,17,35.663629867809924,0.6266891891891893,44.24342105263158,1023.0263157894746,27.649359886202014,0
832,4,1,0,42,0.023809523809523808,0.0,1.0,42,1500,1300,200,0.8666666666666667,17,13,4,335.6021409098732,0.43517711962833916,0.13361332537727533,0.19499173551185334,131019.23338190591,394.0670446675835,131413.3004265735,632,0,197.0952380952381,37,5,18,35.461849809003596,0.6286599099099099,44.051535087719294,1023.7938596491223,27.670104314841144,0
833,4,0,0,42,0.0,0.0,1.0,42,1750,1300,450,0.7428571428571429,22,13,9,338.2432129523951,0.4344875145180023,0.13440597212667815,0.19767872576861326,131243.8457626382,478.46801419664064,131722.31377683484,633,1,198.0952380952381,37,5,18,35.16753611556981,0.6309121621621622,43.832236842105246,1024.6710526315765,27.69381223328585,0
834,4,0,0,42,0.0,0.0,1.0,42,950,500,450,0.5263157894736842,14,5,9,339.6764175050012,0.43374951606658924,0.13412435248995358,0.19909936221029767,131356.22409058516,523.7223232147938,131879.94641379995,634,2,199.0952380952381,37,5,18,35.01744839020216,0.6320382882882882,43.722587719298225,1025.1096491228038,27.70566619250821,0
835,4,0,0,42,0.0,0.0,1.0,42,1150,900,250,0.782608695652174,14,9,5,340.83395080541044,0.4332292876500194,0.13156474224809123,0.20007145473831695,131412.4312889541,557.9636282317408,131970.39491718585,635,3,200.0952380952381,37,5,19,34.93109025772644,0.6326013513513513,43.667763157894726,1025.3289473684197,27.71159317211945,0
836,4,0,0,42,0.0,0.0,1.0,42,1350,900,450,0.6666666666666666,18,9,9,342.24767639671677,0.4329510259388308,0.13880575744620272,0.20164164108108795,131553.00188519518,604.7418436441718,132157.74372883936,636,4,201.0952380952381,37,5,19,34.75309961522018,0.634009009009009,43.53070175438595,1025.877192982454,27.72641062114741,0
837,4,0,0,42,0.0,0.0,1.0,42,1200,900,300,0.75,15,9,6,324.53135723751393,0.4329268292682927,0.08191991606924276,0.18541406913499933,130368.94531250003,61.76215277777908,130430.70746527781,637,5,202.0952380952381,39,3,17,36.40180878552971,0.6185897435897436,44.6875,1021.2500000000002,26.18589743589744,6
838,4,0,2,40,0.0,0.047619047619047616,0.9523809523809523,42,1250,700,550,0.56,18,7,11,327.5609390740632,0.4324549941927991,0.07929467290128045,0.18753007177462566,130448.74267578126,145.9825303819453,130594.72520616322,638,6,203.0952380952381,39,3,18,36.243775704428806,0.6193910256410257,44.609375,1021.5625000000001,26.19391025641026,0
839,4,0,0,40,0.0,0.0,1.0,40,1500,1000,500,0.6666666666666666,20,10,10,337.56465440889946,0.42904647435897436,0.08643685567010317,0.1926104204568424,130318.55955678657,798.1879039704374,131116.747460757,639,11,212.95,37,3,18,36.120060137457045,0.6216216216216216,44.73684210526315,1021.0526315789463,27.59601706970125,0
840,4,0,0,40,0.0,0.0,1.0,40,800,500,300,0.625,11,5,6,338.86492137794033,0.42924679487179485,0.09399957063117226,0.19391066385484584,130430.54112803933,839.6670129270476,131270.20814096637,640,12,213.95,37,3,18,35.97350436524975,0.6227477477477478,44.62719298245614,1021.4912280701749,27.607871028923647,0
841,4,0,0,40,0.0,0.0,1.0,40,1050,700,350,0.6666666666666666,14,7,7,337.5496323681048,0.42915331196581197,0.08943741284994045,0.19413789158345718,130626.62459843412,818.5938221375729,131445.2184205717,641,13,214.95,37,3,13,35.808730201294274,0.6247184684684685,44.435307017543856,1022.2587719298244,27.628615457562823,0
842,4,0,0,40,0.0,0.0,1.0,40,900,800,100,0.8888888888888888,10,8,2,337.52077568299944,0.42935363247863245,0.0886300268096516,0.19440279390018322,130682.67549871099,821.623600530915,131504.2990992419,642,14,215.95,37,3,13,35.75279267202859,0.6252815315315315,44.38048245614034,1022.4780701754373,27.63454243717398,0
843,4,0,0,40,0.0,0.0,1.0,40,1300,800,500,0.6153846153846154,18,8,10,336.691817273033,0.4284855769230769,0.09353360488798401,0.19448903797771644,130794.81336805533,807.508680555531,131602.32204861086,643,15,216.95,37,3,14,35.66064154786151,0.6264076576576576,44.27083333333332,1022.9166666666648,27.646396396396348,0
844,4,0,0,40,0.0,0.0,1.0,40,850,400,450,0.47058823529411764,13,4,9,337.8825553641043,0.4278712606837607,0.09639106205122716,0.19546076404850915,130850.90033712276,842.4473155201397,131693.3476526429,644,16,217.95,37,3,15,35.573513914192844,0.6269707207207207,44.216008771929815,1023.1359649122791,27.65232337600754,0
845,4,1,1,40,0.024390243902439025,0.024390243902439025,0.975609756097561,41,1200,1000,200,0.8333333333333334,14,10,4,330.44283833198716,0.42921747967479673,0.106686334850836,0.19299310716222592,131218.63928153968,472.05192125061194,131690.6912027903,645,0,213.609756097561,38,3,17,35.39277024678485,0.6288377192982456,43.856837606837594,1024.5726495726476,26.962438146648623,0
846,4,0,0,40,0.0,0.0,1.0,40,1000,800,200,0.8,12,8,4,332.9117386423706,0.4295005341880342,0.09391718382195613,0.19470545114840992,131271.93583602618,740.3936788242195,132012.3295148504,646,1,208.8,37,3,17,35.275786432698474,0.6311936936936937,43.80482456140349,1024.7807017543837,27.696775723091452,0
847,4,0,0,40,0.0,0.0,1.0,40,900,700,200,0.7777777777777778,11,7,4,336.6902882081372,0.42875267094017094,0.09469247666117497,0.19765087518601485,131414.71021274655,849.2233541938268,132263.93356694037,647,2,209.8,36,4,18,35.03500823723227,0.6345486111111112,43.66554054054054,1025.337837837838,28.481606606606608,0
848,4,0,0,40,0.0,0.0,1.0,40,1500,1100,400,0.7333333333333333,19,11,8,335.68527426118607,0.4276976495726496,0.09709902294434114,0.19765721805075262,131530.20154867697,830.5503560993363,132360.7519047763,648,3,210.8,36,4,18,34.94437735572877,0.6357060185185186,43.552927927927925,1025.7882882882877,28.494119119119105,0
849,4,0,1,39,0.0,0.025,0.975,40,700,400,300,0.5714285714285714,10,4,6,337.0623962766346,0.4276308760683761,0.09606014047410039,0.19891920692180692,131616.8533398265,872.6183954224726,132489.47173524898,649,4,211.8,36,4,13,34.82175519461516,0.6365740740740741,43.46846846846848,1026.1261261261277,28.50350350350355,0
850,4,0,0,39,0.0,0.0,1.0,39,1100,800,300,0.7272727272727273,14,8,6,371.72072444799954,0.4274066576698156,0.1494182312182759,0.205242617868412,129029.71172185702,1792.603583313049,130822.31530517006,650,5,211.5897435897436,36,3,18,36.560629572156955,0.6105324074074074,46.002252252252255,1015.9909909909912,28.22197197197198,6
851,4,0,1,38,0.0,0.02564102564102564,0.9743589743589743,39,1000,700,300,0.7,13,7,6,375.8742182764096,0.42676000899685107,0.14795368989274826,0.2079868068635561,129115.5360385724,1906.2402351676062,131021.77627374,651,6,212.5897435897436,36,3,18,36.36749769159742,0.611400462962963,45.917792792792795,1016.3288288288293,28.23135635635637,0
852,4,0,0,38,0.0,0.0,1.0,38,1000,500,500,0.5,15,5,10,382.1911081687317,0.4245643669985775,0.15658164550131315,0.21099833632107712,129024.94454089504,2262.4373070987635,131287.3818479938,652,7,218.55263157894737,35,3,18,36.299555707450445,0.6125,46.00694444444444,1015.9722222222221,29.02777777777777,0
853,4,0,0,38,0.0,0.0,1.0,38,1500,1200,300,0.8,18,12,6,385.48937259623085,0.42371977240398295,0.14685367066761756,0.2136121867200439,129171.97312510705,2358.8845754029358,131530.85770050998,653,8,219.55263157894737,35,3,18,36.06552905233596,0.6139880952380952,45.86226851851851,1016.550925925925,29.044312169312143,0
854,4,0,0,38,0.0,0.0,1.0,38,1200,800,400,0.6666666666666666,16,8,8,384.7271507386433,0.4231270744428639,0.14205494959659348,0.21382653216574696,129289.65627411264,2348.2482156635824,131637.90448977624,654,9,220.55263157894737,35,3,18,35.96470638443155,0.6151785714285714,45.74652777777778,1017.0138888888888,29.05753968253968,0
855,4,0,1,37,0.0,0.02631578947368421,0.9736842105263158,38,1350,1000,350,0.7407407407407407,17,10,7,356.5382439008297,0.4227714556661925,0.08645026766783448,0.19184746465226682,128002.04554216375,1527.5249066634162,129529.57044882716,655,10,221.55263157894737,36,2,17,37.995910304918766,0.6001157407407407,47.015765765765764,1011.9369369369366,28.10935935935935,7
856,4,2,1,38,0.05128205128205128,0.02564102564102564,0.9743589743589743,39,700,400,300,0.5714285714285714,10,4,6,346.1366022967195,0.4284750337381917,0.08666586947732857,0.1889276509263185,128572.46393352808,1100.8064229770293,129673.2703565051,656,0,212.66666666666666,36,3,15,37.67650270190243,0.6059027777777778,46.4527027027027,1014.1891891891889,28.171921921921914,0
857,4,0,2,36,0.0,0.05263157894736842,0.9473684210526316,38,1100,800,300,0.7272727272727273,14,8,6,351.8825330404077,0.42635727833096254,0.08610872399258729,0.19165144857609145,128486.82032962014,1442.453559978896,129929.27388959903,657,1,219.26315789473685,36,2,15,37.618247621163334,0.6050347222222222,46.53716216216216,1013.8513513513511,28.16253753753753,0
858,4,0,0,36,0.0,0.0,1.0,36,850,600,250,0.7058823529411765,11,6,5,361.03055747922417,0.42534722222222227,0.09265350877192935,0.1959880169172934,128355.55555555577,2068.0555555555793,130423.61111111134,658,2,224.22222222222223,34,2,20,37.520559210526315,0.607843137254902,46.66666666666668,1013.3333333333351,29.8039215686275,0
859,4,1,0,37,0.02702702702702703,0.0,1.0,37,1050,800,250,0.7619047619047619,13,8,5,354.64162685679804,0.4279904904904905,0.09634274932016185,0.19405671042613595,128672.41753472244,1726.519097222247,130398.93663194469,659,0,219.13513513513513,35,2,16,37.3588295687885,0.6089285714285715,46.35416666666668,1014.5833333333351,28.988095238095287,0
860,4,0,1,36,0.0,0.02702702702702703,0.972972972972973,37,1100,800,300,0.7272727272727273,14,8,6,356.3437761307433,0.42736486486486486,0.10197204270602933,0.19614556410107548,128907.38195516125,1787.0686514060467,130694.4506065673,660,1,220.13513513513513,35,2,16,37.07592508168072,0.6113095238095239,46.12268518518519,1015.5092592592599,29.014550264550284,0
861,4,0,0,36,0.0,0.0,1.0,36,650,500,150,0.7692307692307693,8,5,3,363.25268854399474,0.42731481481481487,0.08899243282668468,0.20005866274814857,128929.2109552155,2166.776502267584,131095.98745748308,661,2,219.44444444444446,34,2,16,36.87824795842614,0.6136642156862745,46.10119047619048,1015.5952380952388,29.87044817927173,0
862,4,1,0,37,0.02702702702702703,0.0,1.0,37,1300,900,400,0.6923076923076923,17,9,8,356.4230045686641,0.42817817817817816,0.08728400531679203,0.19765275707898658,129201.38888888893,1810.0694444444478,131011.45833333339,662,0,214.48648648648648,35,2,17,36.77424863387978,0.6142857142857143,45.833333333333336,1016.6666666666671,29.047619047619058,0
863,4,0,1,36,0.0,0.02702702702702703,0.972972972972973,37,1300,900,400,0.6923076923076923,17,9,8,361.24357884192,0.4272397397397398,0.08331334747717012,0.2012250353625145,129377.95380015441,1947.3910108024816,131325.34481095689,663,1,215.48648648648648,35,2,17,36.471843003412964,0.6160714285714286,45.65972222222223,1017.3611111111119,29.06746031746034,0
864,4,0,0,36,0.0,0.0,1.0,36,650,300,350,0.46153846153846156,10,3,7,364.9059652458884,0.42643849206349205,0.06815109447304124,0.20360419000795377,129443.56575963706,2246.9458616779893,131690.51162131506,664,2,206.19444444444446,34,2,15,36.31185657463734,0.6188725490196079,45.59523809523809,1017.6190476190466,29.929971988795486,0
865,4,0,0,36,0.0,0.0,1.0,36,800,500,300,0.625,11,5,6,364.5771348449098,0.4262566137566137,0.06731643924626418,0.20373428123686105,129504.14540816299,2242.8500566893126,131746.9954648523,665,3,207.19444444444446,34,2,15,36.258528265107216,0.6194852941176471,45.53571428571427,1017.8571428571407,29.936974789915904,0
866,4,0,0,36,0.0,0.0,1.0,36,1000,500,500,0.5,15,5,10,366.1874940784015,0.4259093915343915,0.060722683398937605,0.20510816220383526,129595.0414540815,2291.2166950113196,131886.2581490928,666,4,208.19444444444446,34,2,15,36.12499512841497,0.6204044117647058,45.44642857142856,1018.2142857142845,29.947478991596604,0
867,4,0,1,35,0.0,0.027777777777777776,0.9722222222222222,36,750,500,250,0.6666666666666666,10,5,5,367.8201869168894,0.4259093915343915,0.06042007637752356,0.20618177450111858,129625.34722222219,2335.763888888885,131961.11111111107,667,5,209.19444444444446,34,2,15,36.05257774140753,0.6207107843137255,45.416666666666664,1018.333333333333,29.950980392156854,0
868,4,1,1,35,0.027777777777777776,0.027777777777777776,0.9722222222222222,36,1300,1000,300,0.7692307692307693,16,10,6,368.46692103596956,0.4258597883597883,0.060044008256416204,0.20734440349420513,129776.92920918354,2363.701105442155,132140.63031462568,668,0,210.02777777777777,34,2,16,35.881820306110505,0.6222426470588236,45.26785714285713,1018.9285714285703,29.96848739495795,0
869,4,0,0,35,0.0,0.0,1.0,35,1250,900,350,0.72,16,9,7,378.5457590041606,0.42566526610644256,0.026408822004968968,0.2002459465069661,127314.91246110103,2639.8110635056196,129954.72352460666,669,1,214.11428571428573,32,3,15,38.14483506401435,0.6018880208333333,47.69570707070708,1009.2171717171727,31.538036616161648,8
870,4,1,1,35,0.027777777777777776,0.027777777777777776,0.9722222222222222,36,1000,800,200,0.8,12,8,4,374.3787401419246,0.429646164021164,0.032694794697704754,0.1999919591120848,127710.61610918865,2362.4279123413944,130073.04402153005,670,0,209.13888888888889,33,3,16,37.84351762043324,0.6035353535353536,47.303921568627445,1010.7843137254893,30.62982768865119,0
871,4,0,1,34,0.0,0.02857142857142857,0.9714285714285714,35,700,500,200,0.7142857142857143,9,5,4,381.31380477416576,0.4282212885154062,0.041098873636672195,0.20330808658278793,127633.67776566165,2733.696657228856,130367.3744228905,671,1,216.05714285714285,32,3,16,37.74730309467284,0.6051432291666667,47.380050505050505,1010.4797979797979,31.577493686868685,0
872,4,0,0,34,0.0,0.0,1.0,34,1000,800,200,0.8,12,8,4,389.6634403717707,0.424502376708259,0.052739513127070925,0.20750848550752005,127584.8409864637,3143.0296156141458,130727.87060207785,672,2,223.05882352941177,31,3,16,37.58659298878721,0.6071908602150538,47.428385416666664,1010.2864583333329,32.58988575268816,0
873,4,1,0,35,0.02857142857142857,0.0,1.0,35,1050,800,250,0.7619047619047619,13,8,5,378.268962681915,0.42703081232492995,0.06323933117045155,0.20345285012972267,127984.77993317023,2682.5339888787016,130667.31392204892,673,0,217.65714285714284,32,3,18,37.46386531902505,0.6087239583333333,47.03282828282829,1011.868686868688,31.6208964646465,0
874,4,1,0,36,0.027777777777777776,0.0,1.0,36,1550,1000,550,0.6451612903225806,21,10,11,367.18221392863,0.42686838624338624,0.05813149021346398,0.19966890804758067,128423.86529519908,2230.9918360726833,130654.85713127177,674,0,212.58333333333334,33,3,17,37.29484040623867,0.6107954545454546,46.59926470588236,1013.6029411764716,30.71524064171126,0
875,4,0,0,36,0.0,0.0,1.0,36,1050,800,250,0.7619047619047619,13,8,5,365.61662091264316,0.4264054232804233,0.05216261930651278,0.19974975388078872,128610.25694744816,2204.409511966564,130814.66645941472,675,1,213.58333333333334,33,3,17,37.14396822520237,0.6126893939393939,46.415441176470594,1014.3382352941182,30.737522281639947,0
876,4,0,0,36,0.0,0.0,1.0,36,950,900,50,0.9473684210526315,10,9,1,377.68762473969764,0.4261078042328042,0.0316423973831379,0.19212805258497712,125715.30612244933,2297.5784707265675,128012.8845931759,676,2,214.58333333333334,34,2,19,39.816545979740425,0.5808823529411764,49.285714285714306,1002.8571428571457,29.495798319327815,8
877,4,3,1,38,0.07692307692307693,0.02564102564102564,0.9743589743589743,39,1100,800,300,0.7272727272727273,14,8,6,351.77575816352396,0.43378879892037786,0.057009720048053936,0.18262952751831135,126552.40929705238,1104.9000850340374,127657.30938208642,677,0,199.0,34,5,19,39.60354551191039,0.5894607843137255,48.45238095238096,1006.190476190478,29.593837535014057,0
878,4,2,2,38,0.05,0.05,0.95,40,1100,800,300,0.7272727272727273,14,8,6,343.15882775194217,0.438394764957265,0.05919553072625683,0.18002763824032203,126978.48820103939,714.7578321565392,127693.24603319593,678,0,194.975,36,4,21,39.38268156424582,0.5896990740740741,48.02927927927931,1007.8828828828871,27.996746746746865,0
879,4,1,0,39,0.02564102564102564,0.0,1.0,39,1350,700,650,0.5185185185185185,20,7,13,353.2700668981056,0.43679712100764734,0.07810931654348008,0.18571729346707289,127062.83925165044,1177.4995445387576,128240.3387961892,679,0,200.71794871794873,35,4,22,39.04127444227604,0.5925595238095238,47.945601851851855,1008.2175925925931,28.806216931216944,0
880,4,2,0,41,0.04878048780487805,0.0,1.0,41,1300,1000,300,0.7692307692307693,16,10,6,382.38113454457346,0.4416920731707317,0.07947836024065302,0.20058885057916553,126975.33543381355,1550.3871420610526,128525.7225758746,680,0,191.8780487804878,35,6,20,38.397642015005346,0.5916666666666667,48.03240740740741,1007.8703703703713,28.796296296296322,8
881,4,0,1,40,0.0,0.024390243902439025,0.975609756097561,41,1100,700,400,0.6363636363636364,15,7,8,379.1779354119642,0.4420477642276423,0.0792315820690963,0.19962811006058104,127122.02558106575,1440.4270247193485,128562.4526057851,681,1,192.8780487804878,34,7,20,38.32733246763466,0.595281862745098,47.88690476190476,1008.4523809523808,29.66036414565826,0
882,4,0,1,39,0.0,0.025,0.975,40,1200,1000,200,0.8333333333333334,14,10,4,382.8677918515204,0.44226762820512816,0.08526232693709068,0.2023448907641474,127277.43686322556,1746.0862408688856,129023.52310409445,682,2,196.85,33,7,20,38.07434620678489,0.5991161616161615,47.732843137254896,1009.0686274509794,30.577837195484225,0
883,4,1,1,39,0.025,0.025,0.975,40,900,700,200,0.7777777777777778,11,7,4,382.102939742349,0.44214743589743594,0.09522206042955972,0.2030245213679365,127493.93449935106,1743.1614343040937,129237.09593365516,683,0,197.7,33,7,19,37.87098551955668,0.6013257575757576,47.51838235294117,1009.926470588234,30.6038324420677,0
884,4,1,0,40,0.025,0.0,1.0,40,1150,900,250,0.782608695652174,14,9,5,373.88064371405164,0.4437767094017094,0.10419670442842466,0.2005735386996374,127880.9950086804,1562.4457465277587,129443.44075520815,684,0,196.925,35,5,20,37.681299347751434,0.6008928571428571,47.13541666666666,1011.4583333333321,28.89880952380949,0
885,4,0,1,39,0.0,0.025,0.975,40,850,600,250,0.7058823529411765,11,6,5,339.3935961105963,0.44383012820512824,0.11331524779058033,0.17669419660061855,126666.55411746204,619.9361180225799,127286.49023548463,685,1,197.925,36,4,15,39.79774956184509,0.5865162037037037,48.33896396396396,1006.6441441441441,27.962337337337335,8
886,4,0,0,39,0.0,0.0,1.0,39,950,700,250,0.7368421052631579,12,7,5,343.75277973335074,0.44101439496176337,0.12821987290072423,0.1786569288572316,126596.50051708249,903.579791452335,127500.08030853482,686,3,203.97435897435898,35,4,15,39.76003929461376,0.5877976190476191,48.40856481481482,1006.3657407407408,28.75330687830688,0
887,4,0,0,39,0.0,0.0,1.0,39,900,400,500,0.4444444444444444,14,4,10,342.65873959571934,0.44093004948268105,0.1329089301503097,0.17872488216323493,126742.1392746913,885.860339506166,127627.99961419747,687,4,204.97435897435898,35,4,15,39.637931034482754,0.5892857142857143,48.263888888888886,1006.944444444444,28.76984126984126,0
888,4,1,1,39,0.025,0.025,0.975,40,1100,800,300,0.7272727272727273,14,8,6,333.3941354437059,0.44184027777777773,0.13774991622919686,0.17527173779374622,127063.6277113262,472.4536614317018,127536.08137275791,688,0,200.825,36,4,16,39.54144793179195,0.5905671296296297,47.94481981981982,1008.2207207207208,28.006131131131134,0
889,4,2,3,38,0.04878048780487805,0.07317073170731707,0.926829268292683,41,1200,900,300,0.75,15,9,6,321.5488982279327,0.4443089430894309,0.07464098101391548,0.17043757662547926,127396.24361582406,10.6578553395602,127406.90147116363,689,0,196.7560975609756,37,4,14,39.499723941928224,0.5920608108108107,47.61513157894736,1009.5394736842102,27.28485064011379,8
890,4,2,2,38,0.05,0.05,0.95,40,1150,900,250,0.782608695652174,14,9,5,325.4809330054371,0.44798344017094016,0.07865704091871994,0.17304318246151565,127518.18700034512,300.9476960068406,127819.13469635196,690,0,199.025,36,4,15,39.27579254469098,0.5951967592592593,47.49436936936938,1010.022522522524,28.056181181181223,0
891,4,1,0,39,0.02564102564102564,0.0,1.0,39,1650,1000,650,0.6060606060606061,23,10,13,333.87493922289633,0.4428418803418803,0.08118323840892927,0.17738095112268595,127489.75326678054,713.1267246976981,128202.87999147823,691,0,205.05128205128204,36,3,16,39.092932277728224,0.5949074074074074,47.522522522522536,1009.9099099099119,28.05305305305311,0
892,4,1,0,40,0.025,0.0,1.0,40,1150,700,450,0.6086956521739131,16,7,9,326.77884878366655,0.44575320512820515,0.08578941661244821,0.17500316744965036,127811.68845221636,353.2312827024035,128164.91973491876,692,0,200.9,37,3,19,38.9431070628208,0.5962837837837838,47.20394736842107,1011.1842105263182,27.32930298719779,0
893,4,2,0,42,0.047619047619047616,0.0,1.0,42,1200,800,400,0.6666666666666666,16,8,8,316.246411549585,0.4486546651180798,0.10242009957440001,0.17204965325587523,128442.17985243634,-275.69148052735113,128166.48837190898,693,0,192.28571428571428,38,4,15,38.56691786115796,0.6008771929824561,46.581196581196586,1013.6752136752143,26.675663517768797,0
894,4,1,0,43,0.023255813953488372,0.0,1.0,43,900,800,100,0.8888888888888888,10,8,2,311.19146033363796,0.4492894056847545,0.11058922366059498,0.17073477418305005,128778.12500000013,-585.0694444444302,128193.05555555571,694,0,188.7906976744186,39,4,16,38.353516694033935,0.6025641025641026,46.25000000000001,1015.000000000001,26.02564102564105,0
895,4,0,3,40,0.0,0.06976744186046512,0.9302325581395349,43,1250,900,350,0.72,16,9,7,321.0062734994399,0.4492894056847545,0.09176433561170527,0.17236971937197396,127918.62643494882,-387.46368339003857,127531.16275155878,695,1,189.7906976744186,41,2,15,38.979908306364635,0.5907012195121951,47.09821428571428,1011.6071428571415,24.67334494773516,8
896,4,0,1,39,0.0,0.025,0.975,40,1400,1100,300,0.7857142857142857,17,11,6,335.0009646741864,0.4443108974358974,0.11899239141921192,0.17920373819738977,127766.205130488,560.3603942946918,128326.5655247827,696,2,204.475,38,2,16,38.78174645109021,0.5940241228070176,47.248931623931625,1011.0042735042737,26.605375618533518,0
897,4,0,0,39,0.0,0.0,1.0,39,1450,1200,250,0.8275862068965517,17,12,5,339.6887188850742,0.4415485829959514,0.13975374862855094,0.1819555022211221,127820.21747616706,883.8171844181547,128704.03466058521,697,3,210.64102564102564,38,1,17,38.608029582673026,0.5945723684210527,47.195512820512825,1011.2179487179492,26.610998650472347,0
898,4,1,0,40,0.025,0.0,1.0,40,1850,1600,250,0.8648648648648649,21,16,5,340.0655080091246,0.4433092948717949,0.1563933362180876,0.1849156209433145,128422.23087873185,735.2160644331082,129157.44694316495,698,0,206.35,37,3,16,37.98364705033895,0.6024774774774775,46.60087719298245,1013.5964912280697,27.394499762920802,0
899,4,0,0,40,0.0,0.0,1.0,40,1450,1100,350,0.7586206896551724,18,11,7,369.62931624876416,0.4428952991452992,0.13918578623391165,0.19190226267767058,126553.21865361996,1513.849834126086,128067.06848774604,699,1,207.35,36,4,14,39.153609401231115,0.5853587962962963,48.451576576576585,1006.1936936936947,27.949824824824855,8
900,4,3,3,40,0.06976744186046512,0.06976744186046512,0.9302325581395349,43,900,500,400,0.5555555555555556,13,5,8,350.4211656476579,0.44979697305278704,0.15434909403375174,0.18543040272857253,127328.45187717037,323.716905381968,127652.16878255234,700,0,193.8139534883721,39,4,14,38.84054511989541,0.5878739316239316,47.68229166666668,1009.2708333333353,25.87873931623937,0
901,4,2,2,40,0.047619047619047616,0.047619047619047616,0.9523809523809523,42,900,700,200,0.7777777777777778,11,7,4,349.7733512838054,0.45013066202090596,0.15513593568179407,0.185857644164464,127496.31461620648,518.9626479289964,128015.27726413548,701,0,195.47619047619048,38,4,15,38.68480905532634,0.591282894736842,47.51602564102564,1009.9358974358977,26.57726045883941,0
902,4,1,1,40,0.024390243902439025,0.024390243902439025,0.975609756097561,41,1300,1000,300,0.7692307692307693,16,10,6,358.91941055946756,0.4479928861788618,0.1654363873208855,0.1908987072790888,127534.65008464154,954.9322868575084,128489.58237149905,702,0,200.9512195121951,37,4,16,38.41456795484152,0.5934684684684685,47.4780701754386,1010.0877192982466,27.2996680891418,0
903,4,0,0,40,0.0,0.0,1.0,40,800,500,300,0.625,11,5,6,359.1801197020734,0.447542735042735,0.16611779783795821,0.19149870553099851,127631.95363860483,1168.5720771447145,128800.52571574954,703,1,203.275,36,4,16,38.30821167205319,0.5963541666666667,47.38175675675676,1010.4729729729731,28.0686936936937,0
904,4,2,0,42,0.047619047619047616,0.0,1.0,42,850,500,350,0.5882352941176471,12,5,7,345.5838533760613,0.4494047619047619,0.1819521748093178,0.18739406133772324,128311.1149584486,469.4771173059549,128780.59207575455,704,0,194.54761904761904,37,5,18,37.95725108225108,0.6013513513513513,46.710526315789465,1013.157894736841,27.382645803698402,0
905,4,0,0,42,0.0,0.0,1.0,42,1100,800,300,0.7272727272727273,14,8,6,346.82489499077064,0.4485699767711963,0.18749871216336045,0.18859113701733393,128422.23087873166,508.00534779929995,128930.23622653096,705,1,195.54761904761904,37,5,18,37.812364777152766,0.6024774774774775,46.600877192982445,1013.5964912280681,27.39449976292076,0
906,4,1,1,42,0.023255813953488372,0.023255813953488372,0.9767441860465116,43,950,600,350,0.631578947368421,13,6,7,340.863003392814,0.4491509782207457,0.19219648579899462,0.18683541080371235,128740.17373666796,176.55245543865144,128916.72619210661,706,0,191.97674418604652,38,5,19,37.63926904586445,0.6038925438596492,46.28739316239315,1014.850427350426,26.706590193432262,0
907,4,0,0,42,0.0,0.0,1.0,42,1050,400,650,0.38095238095238093,17,4,13,376.2780316718042,0.4496951219512195,0.23902798232695233,0.2005437861107962,127617.73003472188,1307.2516881711194,128924.981722893,707,1,196.0952380952381,35,7,17,37.890893470790374,0.5982142857142857,47.395833333333314,1010.4166666666639,28.86904761904754,8
908,4,1,0,43,0.023255813953488372,0.0,1.0,43,1400,1200,200,0.8571428571428571,16,12,4,374.8689097924397,0.4508351790328535,0.2611171154829657,0.20200904298272088,128061.27997316477,1001.2384820329281,129062.5184551977,708,0,192.51162790697674,37,6,18,37.47145036651861,0.5988175675675675,46.95723684210526,1012.1710526315785,27.35597439544807,0
909,4,0,0,43,0.0,0.0,1.0,43,1100,800,300,0.7272727272727273,14,8,6,368.3386940410172,0.45044296788482835,0.19292289101191518,0.19417465022827,127174.94956380784,773.7706553939397,127948.72021920177,709,1,193.51162790697674,37,6,16,38.54619614450845,0.5898085585585586,47.83442982456139,1008.6622807017524,27.261142721668982,8
910,4,0,0,43,0.0,0.0,1.0,43,1250,500,750,0.4,20,5,15,367.78590315690354,0.4502122554448136,0.18978529587509851,0.19487223551085564,127381.02349175341,769.7889539930458,128150.81244574646,710,2,194.51162790697674,39,4,13,38.34840315756888,0.5884081196581197,47.63020833333333,1009.4791666666661,25.88408119658118,0
911,4,1,1,43,0.022727272727272728,0.022727272727272728,0.9772727272727273,44,1050,700,350,0.6666666666666666,14,7,7,371.8269740663116,0.4515613988724454,0.21767930561900406,0.1991215496210872,127810.33631601556,704.6661213563316,128515.00243737189,711,0,191.0681818181818,40,4,14,37.80569514237855,0.5911458333333333,47.20528455284553,1011.1788617886175,25.279471544715438,0
912,4,0,0,43,0.0,0.0,1.0,43,1300,800,500,0.6153846153846154,18,8,10,372.7342375446528,0.4513888888888889,0.16378910425785032,0.19988957018092338,127867.13219452163,970.8881630443784,128838.02035756601,712,1,186.02325581395348,37,6,17,37.72450491471523,0.5968468468468469,47.149122807017555,1011.4035087719318,27.335229966808967,8
913,4,0,0,43,0.0,0.0,1.0,43,1150,600,550,0.5217391304347826,17,6,11,370.81222618483275,0.45085825027685494,0.16269997278253245,0.19940881254275267,127978.05574792245,891.1655509387527,128869.2212988612,713,2,187.02325581395348,37,6,17,37.65938809420604,0.597972972972973,47.03947368421053,1011.842105263158,27.3470839260313,0
914,4,1,0,44,0.022727272727272728,0.0,1.0,44,1400,1000,400,0.7142857142857143,18,10,8,364.5981149531668,0.45202387244538406,0.17990314174738242,0.19839373588828849,128450.01737313381,566.6350463603974,129016.65241949422,714,0,183.75,37,7,18,37.33358121507122,0.602759009009009,46.57346491228069,1013.7061403508753,27.39746325272636,0
915,4,0,0,44,0.0,0.0,1.0,44,1300,1100,200,0.8461538461538461,15,11,4,365.26015861861714,0.4521670190274842,0.18541238784996295,0.1995878161477156,128616.79945992985,595.7185143505608,129212.51797428042,715,1,184.75,37,7,18,37.14632201924118,0.6044481981981982,46.40899122807017,1014.3640350877183,27.415244191559953,0
916,4,1,2,43,0.022222222222222223,0.044444444444444446,0.9555555555555556,45,1000,700,300,0.7,13,7,6,359.0309284653593,0.45359848484848486,0.1902457838084226,0.19787287170551668,128957.11343277417,259.91843359628893,129217.03186637047,716,0,181.62222222222223,38,7,19,36.956979068055126,0.6060855263157895,46.073717948717935,1015.7051282051257,26.72908232118752,0
917,4,0,1,42,0.0,0.023255813953488372,0.9767441860465116,43,1250,900,350,0.72,16,9,7,376.030517008061,0.45205795496493173,0.19661619496421134,0.207208249794507,128950.6882526352,1097.8787944367223,130048.56704707192,717,1,190.1627906976744,37,6,20,36.53187862103709,0.6078265765765766,46.08004385964911,1015.6798245614016,27.45080606922707,0
918,4,0,0,42,0.0,0.0,1.0,42,800,500,300,0.625,11,5,6,384.33593373613564,0.4502879403794038,0.20639673034882655,0.21159593714483935,128915.3236851715,1509.3582602872975,130424.6819454588,718,2,195.3095238095238,36,6,20,36.357146817476156,0.609375,46.114864864864856,1015.5405405405393,28.209459459459424,0
919,4,0,0,42,0.0,0.0,1.0,42,1650,1100,550,0.6666666666666666,22,11,11,388.5093531538942,0.45015485869144406,0.21173184931682876,0.2146879055263645,129062.08070031145,1628.3650979147233,130690.44579822617,719,3,196.3095238095238,37,5,20,36.101106974569255,0.6089527027027026,45.970394736842096,1016.11842105263,27.46266002844946,0
920,4,1,1,42,0.023255813953488372,0.023255813953488372,0.9767441860465116,43,1400,1000,400,0.7142857142857143,18,10,8,382.34571634901477,0.4508813215208564,0.2045989330997504,0.21349925075556675,129473.85381235827,1301.0552501240577,130774.90906248233,720,0,192.72093023255815,34,9,17,35.83728116348891,0.6191789215686274,45.56547619047619,1017.7380952380952,29.93347338935574,0
921,4,0,0,42,0.0,0.0,1.0,42,1300,700,600,0.5384615384615384,19,7,12,392.05909510618596,0.44835220673635306,0.21303258145363335,0.2190918472652219,129504.14540816353,1754.6556122449256,131258.80102040846,721,5,198.3095238095238,34,8,19,35.55921052631579,0.6194852941176471,45.5357142857143,1017.857142857145,29.936974789916032,0
922,4,1,0,43,0.023255813953488372,0.0,1.0,43,1450,1200,250,0.8275862068965517,17,12,5,384.84526648664354,0.4497508305647841,0.22095206779713195,0.21734274469766632,129917.93894823905,1399.6607671861316,131317.5997154252,722,0,194.67441860465115,36,7,20,35.320934128649796,0.6195023148148149,45.12950450450452,1019.4819819819842,28.318943943944006,0
923,4,0,0,43,0.0,0.0,1.0,43,1100,800,300,0.7272727272727273,14,8,6,385.7149783243776,0.44896640826873385,0.22026390996556655,0.21847533200024324,130032.77084094238,1431.1174772745785,131463.88831821695,723,1,195.67441860465115,36,7,20,35.181811490191734,0.6206597222222222,45.016891891891895,1019.9324324324332,28.33145645645648,0
924,4,1,0,44,0.022727272727272728,0.0,1.0,44,1550,1100,450,0.7096774193548387,20,11,9,376.6392610021943,0.4495573467230444,0.21697778389888867,0.21560650424681974,130444.94224773237,1026.7460467568978,131471.68829448926,724,0,192.20454545454547,34,10,21,34.99422173017908,0.6289828431372548,44.613095238095234,1021.5476190476186,30.0455182072829,0
925,4,0,2,42,0.0,0.045454545454545456,0.9545454545454546,44,1000,600,400,0.6,14,6,8,375.64334048259724,0.44903981677237487,0.2168555090803197,0.21571224602294967,130566.58340419496,1009.2935090702838,131575.87691326524,725,1,193.20454545454547,34,10,16,34.89613667249076,0.6302083333333333,44.49404761904761,1022.0238095238091,30.059523809523796,0
926,4,0,0,42,0.0,0.0,1.0,42,1050,700,350,0.6666666666666666,14,7,7,383.39786615633386,0.44647696476964766,0.2171184136883344,0.21986048198153454,130512.91120001927,1607.6743319876975,132120.58553200695,726,4,202.28571428571428,33,9,17,34.7525385783961,0.6319444444444444,44.54656862745098,1021.8137254901965,30.964052287581712,0
927,4,1,1,42,0.023255813953488372,0.023255813953488372,0.9767441860465116,43,1200,900,300,0.75,15,9,6,372.79373454670645,0.44735142118863047,0.22694140292196496,0.21633778138655327,130972.46334876542,1165.1427469135788,132137.606095679,727,0,198.5581395348837,35,8,18,34.557327001356846,0.6321428571428571,44.09722222222222,1023.6111111111111,29.246031746031747,0
928,4,0,0,42,0.0,0.0,1.0,42,750,500,250,0.6666666666666666,10,5,5,381.24438910865825,0.4472754548974061,0.25596462420418864,0.20635133438003017,128237.60880730968,1401.6041673341424,129639.21297464381,728,1,200.73809523809524,33,9,19,37.12933555152247,0.6089015151515151,46.783088235294116,1012.8676470588234,30.692959001782526,8
929,4,0,1,41,0.0,0.023809523809523808,0.9761904761904762,42,950,600,350,0.631578947368421,13,6,7,377.8055367725932,0.4468278164924506,0.24689566199000157,0.2049669408159974,128330.7201557093,1296.8113225682366,129627.53147827754,729,2,201.73809523809524,33,9,20,37.121028866311875,0.6098484848484849,46.69117647058823,1013.2352941176467,30.70409982174687,0
930,4,0,0,41,0.0,0.0,1.0,41,1450,1100,350,0.7586206896551724,18,11,7,375.10509407625466,0.44646849593495935,0.2384614683940942,0.20484155137420487,128592.36501696256,1447.1302354351633,130039.49525239773,730,3,203.6341463414634,32,9,18,36.92165650026971,0.6149088541666667,46.43308080808081,1014.2676767676768,31.6958648989899,0
931,4,1,0,42,0.023809523809523808,0.0,1.0,42,1850,1300,550,0.7027027027027027,24,13,11,376.61059393149867,0.4471302748741773,0.20462541882722785,0.20460025438027096,128385.71605725618,1281.06111686333,129666.77717411952,731,0,199.76190476190476,34,8,18,37.09498218411058,0.6081495098039216,46.63690476190476,1013.4523809523805,29.807422969187662,7
932,4,0,0,42,0.0,0.0,1.0,42,1250,1000,250,0.8,15,10,5,376.6125967956486,0.44661004645760743,0.2122282046551156,0.20522133633451917,128506.39349489786,1279.4253117913745,129785.81880668923,732,1,200.76190476190476,34,8,18,36.97140033658174,0.609375,46.51785714285714,1013.9285714285706,29.821428571428548,0
933,4,1,3,40,0.023255813953488372,0.06976744186046512,0.9302325581395349,43,1100,900,200,0.8181818181818182,13,9,4,372.8484415954848,0.4491279069767442,0.14152032049182361,0.2007812786421429,128033.53555901835,949.2951324112508,128982.8306914296,733,0,197.06976744186048,37,6,17,37.551011195377406,0.5985360360360361,46.98464912280703,1012.0614035087734,27.353010905642524,8
934,4,1,0,41,0.024390243902439025,0.0,1.0,41,1350,900,450,0.6666666666666666,18,9,9,370.0611951321873,0.4475609756097561,0.17687105148803917,0.20100842584227266,128379.01341735263,1301.7144104643944,129680.72782781703,734,0,204.609756097561,35,6,14,37.26777828536624,0.605952380952381,46.643518518518526,1013.4259259259268,28.95502645502648,0
935,4,1,0,42,0.023809523809523808,0.0,1.0,42,1150,800,350,0.6956521739130435,15,8,7,327.3849165731757,0.4485941734417344,0.05943823618242239,0.17477772634211286,127685.20801373353,-23.21474409705803,127661.99326963647,735,0,200.71428571428572,38,4,18,39.056994362226924,0.5932017543859649,47.32905982905982,1010.6837606837596,26.596941070625252,8
936,4,3,1,44,0.06666666666666667,0.022222222222222223,0.9777777777777777,45,1050,700,350,0.6666666666666666,14,7,7,308.76337023831866,0.4531144781144781,0.09187214611872152,0.16820691065221838,128496.33487654322,-1065.0077160493804,127431.32716049383,736,0,188.26666666666668,41,4,17,38.70148401826485,0.5965447154471545,46.52777777777778,1013.8888888888889,24.7289972899729,0
937,4,2,0,46,0.043478260869565216,0.0,1.0,46,1200,800,400,0.6666666666666666,16,8,8,328.76724030603395,0.4518518518518519,0.15302772827123134,0.18208914207023724,129152.13647767546,-707.801702121284,128444.33477555418,737,0,185.1304347826087,42,4,20,37.52720845249443,0.6016865079365079,45.881782945736425,1016.472868217053,24.201734957548883,0
938,4,1,2,45,0.02127659574468085,0.0425531914893617,0.9574468085106383,47,750,600,150,0.8,9,6,3,321.55471431531316,0.4518385753931545,0.1604424885946143,0.1793719974617953,129433.96297053652,-1075.9516344827684,128358.01133605375,738,0,182.17021276595744,40,7,16,37.42447318485967,0.6075520833333333,45.60467479674796,1017.5813008130066,25.439532520325166,0
939,4,2,0,47,0.0425531914893617,0.0,1.0,47,900,500,400,0.5555555555555556,13,5,8,317.13004565548414,0.45218547641073076,0.18414724820900097,0.17870965216778845,129832.53146455318,-1165.24067381585,128667.29079073733,739,0,181.80851063829786,41,6,18,37.13324166910022,0.610010162601626,45.21329365079364,1019.1468253968235,24.857239643824965,0
940,4,0,1,46,0.0,0.02127659574468085,0.9787234042553191,47,1600,1100,500,0.6875,21,11,10,321.1166315616843,0.45203129818069687,0.18711978357030357,0.18165976091483474,129984.2345068812,-1051.9800918052695,128932.25441507593,740,1,182.80851063829786,41,6,19,36.87808071472581,0.6115345528455285,45.06448412698411,1019.7420634920613,24.871757646147838,0
941,4,0,1,45,0.0,0.021739130434782608,0.9782608695652174,46,1250,600,650,0.48,19,6,13,324.70992523928226,0.45139895330112717,0.17947341070500644,0.18439409781687727,130132.94004891255,-748.9085531099289,129384.03149580263,741,2,184.95652173913044,40,6,20,36.63595617529884,0.6145833333333333,44.918699186991866,1020.3252032520314,25.508130081300784,0
942,4,0,0,45,0.0,0.0,1.0,45,950,500,450,0.5263157894736842,14,5,9,325.66368037750686,0.4495580808080808,0.18408019650799945,0.1851820316167003,130184.79100568459,-520.7083663824303,129664.08263930216,742,3,189.64444444444445,40,5,21,36.559159861913294,0.6151041666666667,44.867886178861795,1020.528455284554,25.513211382113848,0
943,4,0,0,45,0.0,0.0,1.0,45,700,400,300,0.5714285714285714,10,4,6,326.0308204914617,0.4490740740740741,0.18630385487528334,0.1857617465590888,130262.58680555565,-506.0531512327231,129756.53365432292,743,4,190.64444444444445,39,6,21,36.47108843537415,0.6175213675213675,44.79166666666667,1020.8333333333342,26.175213675213698,0
944,4,0,1,44,0.0,0.022222222222222223,0.9777777777777777,45,1350,1000,350,0.7407407407407407,17,10,7,326.078160867163,0.4478324915824916,0.1709212410501193,0.17892450157587897,128783.04268260613,-601.3324582356952,128181.71022437043,744,5,191.64444444444445,42,3,14,37.97076372315033,0.5979662698412698,46.245155038759684,1015.0193798449606,24.16712809154668,8
945,4,0,0,44,0.0,0.0,1.0,44,1200,700,500,0.5833333333333334,17,7,10,333.85099907425194,0.4467054263565891,0.17284320780362927,0.18337612847701698,128823.44148596963,-198.43307114510253,128625.00841482452,745,6,196.8409090909091,41,3,15,37.732397635102124,0.5998475609756098,46.20535714285715,1015.1785714285734,24.76045296167252,0
946,4,0,0,44,0.0,0.0,1.0,44,900,800,100,0.8888888888888888,10,8,2,334.75227607978485,0.4467274489076815,0.16803526224630283,0.1841047579622032,128873.80248685137,-171.84025809396286,128701.96222875742,746,7,197.8409090909091,41,3,15,37.65826005536556,0.6003556910569106,46.155753968253975,1015.3769841269853,24.76529229578013,0
947,4,1,2,43,0.022222222222222223,0.044444444444444446,0.9555555555555556,45,1300,700,600,0.5384615384615384,19,7,12,331.8344155807309,0.44720117845117846,0.1862050711979253,0.18436221236208433,129275.28511094593,-420.4022632353742,128854.88284771056,747,0,194.42222222222222,42,3,16,37.32412259806257,0.6029265873015873,45.76065891472869,1016.9573643410858,24.213270579549665,0
948,4,1,2,42,0.022727272727272728,0.045454545454545456,0.9545454545454546,44,1250,900,350,0.72,16,9,7,332.21250643137955,0.4471678999295278,0.18116042373468044,0.18561490252953283,129497.10053482391,-195.88873114594202,129301.21180367797,748,0,191.47727272727272,42,2,15,37.089243780147235,0.6051587301587302,45.54263565891474,1017.8294573643434,24.23403469915103,0
949,4,1,0,43,0.023255813953488372,0.0,1.0,43,1500,1200,300,0.8,18,12,6,340.28797136177917,0.4447674418604651,0.1877585960907402,0.19126530804127587,129731.4453125,229.21006944444383,129960.65538194444,749,0,196.62790697674419,41,2,17,36.645790729379684,0.6089939024390244,45.3125,1018.75,24.847560975609756,0
950,4,1,1,43,0.022727272727272728,0.022727272727272728,0.9772727272727273,44,950,700,250,0.7368421052631579,12,7,5,340.74444555436486,0.4450317124735729,0.20231331168831157,0.19328434928859647,130089.53788834796,65.45749203772777,130154.99538038569,750,0,193.13636363636363,42,2,18,36.270936233535956,0.6111111111111112,44.961240310077514,1020.1550387596892,24.289405684754506,0
951,4,1,0,44,0.022727272727272728,0.0,1.0,44,1300,1000,300,0.7692307692307693,16,10,6,339.3586005830907,0.44618789640591966,0.21549165120593727,0.19335548172757486,130262.58680555546,41.375875097644666,130303.9626806531,751,0,177.9318181818182,40,4,20,36.130952380952394,0.6158854166666667,44.791666666666664,1020.8333333333326,25.520833333333314,0
952,4,2,0,46,0.043478260869565216,0.0,1.0,46,1750,1400,350,0.8,21,14,7,328.99572842046666,0.44777576489533016,0.22058865916979986,0.19034881624064126,130856.77059859672,-589.7362876329653,130267.03431096375,752,0,171.15217391304347,42,4,17,35.794898506803044,0.6187996031746033,44.21027131782945,1023.1589147286811,24.360926541159074,0
953,4,0,0,46,0.0,0.0,1.0,46,1250,900,350,0.72,16,9,7,328.65859620187393,0.4472322866344605,0.22024992899744356,0.19064364369469491,130955.93268320718,-592.0414000060032,130363.89128320118,753,1,172.15217391304347,42,4,17,35.70343810154942,0.6197916666666667,44.11337209302326,1023.5465116279073,24.370155038759698,0
954,4,0,0,46,0.0,0.0,1.0,46,1050,900,150,0.8571428571428571,12,9,3,329.04478916494185,0.44686996779388083,0.22122762148337616,0.19127055163716936,131037.09323347101,-576.5854568411432,130460.50777662986,754,2,173.15217391304347,43,3,17,35.61166605006784,0.6191860465116279,44.03409090909091,1023.8636363636358,23.810782241014785,0
955,4,0,2,44,0.0,0.043478260869565216,0.9565217391304348,46,1900,1500,400,0.7894736842105263,23,15,8,329.8585132650267,0.44593397745571656,0.22195051379015118,0.19259251241307748,131206.82253106352,-544.0625179350347,130662.76001312849,755,3,174.15217391304347,43,3,17,35.41965138490924,0.6208817829457365,43.86837121212121,1024.5265151515155,23.82619802677943,0
956,4,0,0,44,0.0,0.0,1.0,44,1400,1300,100,0.9285714285714286,15,13,2,342.9451445389458,0.4438865398167724,0.22473671233841785,0.1998061891772048,131124.8307193245,193.72480473668907,131318.5555240612,756,4,181.54545454545453,41,3,18,35.16724783675579,0.6229674796747968,43.94841269841269,1024.206349206347,24.98064266356944,0
957,4,0,0,44,0.0,0.0,1.0,44,1150,600,550,0.5217391304347826,17,6,11,345.1923878079889,0.4433029422128259,0.22150386024038382,0.20166101152937402,131228.82207349304,259.8380881557443,131488.6601616488,757,5,182.54545454545453,42,2,19,35.00468917470524,0.6225198412698413,43.846899224806194,1024.612403100774,24.395533407161285,0
958,4,0,0,44,0.0,0.0,1.0,44,850,600,250,0.7058823529411765,11,6,5,347.0156652786042,0.4429065362931642,0.2257945306725797,0.20325203252032514,131328.12499999985,314.73356468960696,131642.85856468946,758,6,183.54545454545453,38,6,19,34.857723577235774,0.6299342105263157,43.74999999999999,1024.9999999999989,26.973684210526287,0
959,4,0,1,43,0.0,0.022727272727272728,0.9772727272727273,44,1100,600,500,0.5454545454545454,16,6,10,345.1311466277802,0.44256518675123324,0.22758905729036827,0.20257160860210133,131408.21533203122,270.6136067708336,131678.82893880206,759,7,184.54545454545453,39,5,19,34.82519303058011,0.6290064102564102,43.671875,1025.3124999999998,26.290064102564095,0
960,4,0,0,43,0.0,0.0,1.0,43,1500,900,600,0.6,21,9,12,347.7383091236715,0.4410529715762274,0.23729477907094787,0.2049595814816902,131568.46923828137,550.2794053819584,132118.74864366333,760,8,188.72093023255815,39,4,14,34.59668071208583,0.6306089743589743,43.51562500000001,1025.937500000001,26.306089743589766,0
961,4,0,0,43,0.0,0.0,1.0,43,1100,800,300,0.7272727272727273,14,8,6,349.5079853856212,0.4407299741602067,0.23909675072465753,0.2068178184171155,131719.04047070208,607.3712943684427,132326.41176507052,761,9,189.72093023255815,40,3,15,34.399440649440635,0.63046875,43.368902439024396,1026.5243902439033,25.663109756097583,0
962,4,0,1,42,0.0,0.023255813953488372,0.9767441860465116,43,1050,700,350,0.6666666666666666,14,7,7,351.5698174846332,0.44033776301218164,0.24699579802926208,0.2087523252350002,131849.47472569236,670.8591529512867,132520.33387864364,762,10,190.72093023255815,40,3,15,34.21502902566132,0.6317708333333334,43.24186991869919,1027.0325203252032,25.67581300813008,0
963,4,0,0,42,0.0,0.0,1.0,42,700,500,200,0.7142857142857143,9,5,4,358.5132400067465,0.4396172086720867,0.24617346938775508,0.2123501498501498,131755.55555555547,1047.2222222222126,132802.7777777777,763,11,194.83333333333334,39,3,15,34.131493506493506,0.6324786324786325,43.33333333333333,1026.666666666666,26.32478632478631,0
964,4,0,0,42,0.0,0.0,1.0,42,1450,1100,350,0.7586206896551724,18,11,7,355.8933369476039,0.4392179636082075,0.24510116451489838,0.21124337200279503,131835.77609592007,983.8948567708237,132819.67095269088,764,12,195.83333333333334,39,3,15,34.11783226831658,0.6332799145299146,43.25520833333333,1026.979166666666,26.33279914529913,0
965,4,1,0,43,0.023255813953488372,0.0,1.0,43,1250,700,550,0.56,18,7,11,350.78016372697584,0.44031469176818017,0.24879584520636078,0.21030185171309226,132215.03404058437,675.6822575847791,132890.71629816917,765,0,192.25581395348837,40,3,16,33.86713603425561,0.6354166666666667,42.88617886178862,1028.455284552846,25.711382113821152,0
966,4,0,2,41,0.0,0.046511627906976744,0.9534883720930233,43,1650,1200,450,0.7272727272727273,21,12,9,347.23869437627155,0.43987633813215204,0.24105364481987834,0.20861111591519274,132293.43401951552,587.4798606980019,132880.9138802135,766,1,193.25581395348837,40,3,16,33.879325957390755,0.6361979166666667,42.8099593495935,1028.7601626016262,25.719004065040657,0
967,4,0,1,40,0.0,0.024390243902439025,0.975609756097561,41,1250,900,350,0.72,16,9,7,358.88778404827633,0.4371443089430895,0.24904470065596795,0.21401993767888222,132013.44515897808,1275.6025595368617,133289.04771851495,767,2,203.0,38,3,16,33.861801296046025,0.6367872807017544,43.08226495726496,1027.6709401709406,27.043972109761597,0
968,4,0,2,38,0.0,0.05,0.95,40,1400,1100,300,0.7857142857142857,17,11,6,360.23641524973397,0.4373931623931624,0.20760177393677504,0.20126550417447053,129495.73072059352,1462.4779672801246,130958.20868787364,768,3,203.7,35,5,15,36.37754908649838,0.6172619047619048,45.543981481481495,1017.8240740740761,29.08068783068789,8
969,4,0,0,38,0.0,0.0,1.0,38,1050,600,450,0.5714285714285714,15,6,9,370.8371858307158,0.4367443100995732,0.2084498380030304,0.20646005899267433,129357.17520004339,1994.0901636389995,131351.26536368238,769,4,212.81578947368422,33,5,18,36.2490212022648,0.6202651515151515,45.680147058823536,1017.279411764707,30.826648841354757,0
970,4,0,0,38,0.0,0.0,1.0,38,1400,900,500,0.6428571428571429,19,9,10,377.5081419309807,0.4366109530583215,0.20945595034517694,0.21167966662931514,129637.82709775091,2187.867046328339,131825.69414407926,770,5,213.81578947368422,33,5,15,35.79322101885279,0.6231060606060606,45.404411764705884,1018.3823529411768,30.860071301247782,0
971,4,0,0,38,0.0,0.0,1.0,38,1500,1300,200,0.8666666666666667,17,13,4,378.61805179949096,0.4357515410146989,0.209170719111762,0.21338704025381428,129837.58680555542,2231.770833333325,132069.35763888873,771,6,214.81578947368422,34,4,15,35.561460888525495,0.6228553921568627,45.20833333333333,1019.1666666666655,29.975490196078397,0
972,4,0,0,38,0.0,0.0,1.0,38,1000,800,200,0.8,12,8,4,380.7394366557172,0.43486249407302036,0.21508894829016523,0.2152497211192222,129958.94451530601,2296.099064625839,132255.04357993184,772,7,215.81578947368422,34,4,15,35.38382953882079,0.6240808823529411,45.08928571428571,1019.6428571428563,29.989495798319304,0
973,4,0,0,38,0.0,0.0,1.0,38,1100,600,500,0.5454545454545454,16,6,10,383.74262327275414,0.4344327880512091,0.21514317485086587,0.2172850663303158,130019.64462868459,2378.8159013605155,132398.4605300451,773,8,216.81578947368422,34,4,15,35.24546710244738,0.6246936274509804,45.02976190476189,1019.8809523809506,29.99649859943972,0
974,4,0,0,38,0.0,0.0,1.0,38,550,300,250,0.5454545454545454,8,3,5,382.6998075019614,0.4343735182550972,0.21476742971912266,0.21703207481696254,130080.35891439892,2356.345663265291,132436.7045776642,774,9,217.81578947368422,34,4,15,35.21025401641577,0.6253063725490196,44.97023809523809,1020.1190476190462,30.003501400560182,0
975,4,0,1,37,0.0,0.02631578947368421,0.9736842105263158,38,1150,800,350,0.6956521739130435,15,8,7,383.0070803831739,0.4335141062114746,0.2110633727175082,0.21822496440436634,130262.58680555539,2378.426162131499,132641.0129676869,775,10,218.81578947368422,33,5,16,35.017006802721085,0.6294191919191919,44.79166666666666,1020.833333333332,30.934343434343393,0
976,4,0,1,36,0.0,0.02702702702702703,0.972972972972973,37,1050,700,350,0.6666666666666666,14,7,7,387.6618314809812,0.4314314314314314,0.20812984914317623,0.22069961684245312,130231.31315179243,2697.141874519397,132928.45502631183,776,11,224.43243243243242,33,4,16,34.930038620082435,0.6291035353535354,44.82230392156862,1020.7107843137243,30.930629827688616,0
977,4,1,0,37,0.02702702702702703,0.0,1.0,37,1350,1100,250,0.8148148148148148,16,11,5,386.8543256177221,0.43133758758758756,0.21596980858017378,0.22148472928223412,130450.30757400984,2693.05315263359,133143.36072664344,777,0,225.1081081081081,33,4,17,34.727887076135644,0.6313131313131313,44.607843137254896,1021.5686274509792,30.956625074272097,0
978,4,0,0,37,0.0,0.0,1.0,37,1300,1000,300,0.7692307692307693,16,10,6,384.0974252860462,0.43068068068068066,0.20874037988131922,0.22133348871455577,130700.8121876201,2640.369088811988,133341.1812764321,778,1,226.1081081081081,33,4,16,34.54378395653563,0.6338383838383839,44.36274509803921,1022.5490196078429,30.98633392751039,0
979,4,0,0,37,0.0,0.0,1.0,37,1150,1000,150,0.8695652173913043,13,10,3,380.99228060278506,0.4299924924924925,0.21049155061375036,0.22007907032466748,130794.81336805547,2566.362847222211,133361.1762152777,779,2,227.1081081081081,33,4,16,34.52774949083502,0.6347853535353536,44.27083333333333,1022.916666666666,30.997474747474726,0
980,4,0,0,37,0.0,0.0,1.0,37,1100,800,300,0.7272727272727273,14,8,6,381.11714295958984,0.42930430430430433,0.21268166369962782,0.2206884981770163,130888.84833958092,2576.7967848904277,133465.64512447134,780,3,228.1081081081081,33,4,17,34.42914171656687,0.6357323232323233,44.17892156862745,1023.2843137254902,31.008615567439097,0
981,4,0,0,37,0.0,0.0,1.0,37,1050,900,150,0.8571428571428571,12,9,3,383.1396071200375,0.429054054054054,0.21641035264883013,0.22240202489740635,130982.91710219644,2636.948679594413,133619.86578179087,781,4,229.1081081081081,33,4,17,34.28196955185763,0.6366792929292929,44.08700980392158,1023.6519607843151,31.019756387403486,0
982,4,0,0,37,0.0,0.0,1.0,37,1200,1100,100,0.9166666666666666,13,11,2,383.4842683251982,0.42911661661661665,0.22225743752607463,0.223329479469943,131108.39468293454,2655.6013612552943,133763.99604418984,782,5,230.1081081081081,33,4,17,34.14590064217623,0.6379419191919191,43.96446078431373,1024.1421568627457,31.034610814022596,0
983,4,1,0,38,0.02631578947368421,0.0,1.0,38,1400,1000,400,0.7142857142857143,18,10,8,371.38658058194903,0.43142484589853014,0.21123075374861577,0.21824177712849396,131453.76778162265,2164.217037918134,133617.98481954078,783,0,225.02631578947367,33,5,18,34.106118546845124,0.6414141414141414,43.62745098039217,1025.490196078433,31.075460487225243,0
984,4,0,0,38,0.0,0.0,1.0,38,1250,900,350,0.72,16,9,7,369.39478680575763,0.43066915599810335,0.20756773590781696,0.21792016888972138,131602.82206632668,2122.6792800453736,133725.50134637207,784,1,226.02631578947367,34,4,17,34.006506942027315,0.640625,43.48214285714287,1026.0714285714298,30.178571428571466,0
985,4,0,1,37,0.0,0.02631578947368421,0.9736842105263158,38,1150,1000,150,0.8695652173913043,13,10,3,369.67012071221586,0.4300023707918445,0.20954645632757174,0.21843222142974764,131663.90483276665,2134.4423185941264,133798.34715136077,785,2,227.02631578947367,34,4,17,33.93771990874994,0.6412377450980392,43.42261904761906,1026.3095238095254,30.185574229691923,0
986,4,0,0,37,0.0,0.0,1.0,37,900,600,300,0.6666666666666666,12,6,6,383.34616628723273,0.42780280280280275,0.22086491651709084,0.22601226085610648,131579.47063629367,2688.0971261053364,134267.567762399,786,9,234.1081081081081,33,4,17,33.67226071030418,0.6426767676767677,43.50490196078431,1025.9803921568623,31.090314913844313,0
987,4,0,1,36,0.0,0.02702702702702703,0.972972972972973,37,1200,900,300,0.75,15,9,6,377.2001217143714,0.42680180180180183,0.21499020806648828,0.22330780350539137,131736.68368235766,2538.218623846584,134274.90230620425,787,10,235.1081081081081,33,4,17,33.67093927818232,0.6442550505050505,43.3517156862745,1026.5931372549012,31.108882947118218,0
988,4,0,0,36,0.0,0.0,1.0,36,1150,900,250,0.782608695652174,14,9,5,382.18418419727294,0.4244378306878307,0.22449311108459025,0.22663278693481595,131799.59518274217,2874.3441524894247,134673.93933523158,788,11,241.52777777777777,33,3,17,33.47940784500937,0.6448863636363636,43.29044117647059,1026.8382352941173,31.116310160427798,0
989,4,0,0,36,0.0,0.0,1.0,36,750,400,350,0.5333333333333333,11,4,7,356.4750811540104,0.42447089947089944,0.07941657897813581,0.19966806608449592,129595.04145408176,2039.4805839002374,131634.522037982,789,12,242.52777777777777,34,2,19,36.37222806812423,0.6204044117647058,45.44642857142858,1018.2142857142868,29.94747899159667,8
990,4,0,0,36,0.0,0.0,1.0,36,1000,800,200,0.8,12,8,4,354.9893002042915,0.4242228835978836,0.08430081554204949,0.19929714255563763,129685.9693877551,2007.4263038548695,131693.39569160997,790,13,243.52777777777777,34,2,19,36.31759389122642,0.6213235294117647,45.357142857142854,1018.5714285714286,29.95798319327731,0
991,4,0,0,36,0.0,0.0,1.0,36,1100,400,700,0.36363636363636365,18,4,14,366.30594929634697,0.4232638888888889,0.058641975308642014,0.19780521262002743,128144.53125,2189.2998866213147,130333.83113662132,791,14,244.52777777777777,34,2,21,37.60288065843622,0.6056985294117647,46.875,1012.5,29.779411764705884,8
992,4,2,1,37,0.05263157894736842,0.02631578947368421,0.9736842105263158,38,600,500,100,0.8333333333333334,7,5,2,353.3538958134744,0.42816500711237554,0.0823981409036234,0.19397880736069784,128800.98637488841,1502.4660640370116,130303.45243892542,792,0,232.60526315789474,36,2,19,37.26032652910288,0.6082175925925926,46.22747747747748,1015.0900900900901,28.196946946946948,0
993,4,0,0,37,0.0,0.0,1.0,37,1100,800,300,0.7272727272727273,14,8,6,344.61305879531903,0.4257695195195195,0.09148326586049049,0.19123859330993387,129229.25954380211,1506.818083448774,130736.07762725088,793,1,239.48648648648648,37,0,14,37.046061145260445,0.6106418918918919,45.80592105263159,1016.776315789475,27.48044096728311,8
994,4,1,0,38,0.02631578947368421,0.0,1.0,38,800,500,300,0.625,11,5,6,337.44107252758386,0.42816500711237554,0.09737504971496724,0.1886818391457055,129527.44904667992,1141.576265614737,130669.02531229466,794,0,234.1578947368421,38,0,14,36.92537783375314,0.611842105263158,45.51282051282052,1017.9487179487188,26.788124156545233,0
995,4,0,1,37,0.0,0.02631578947368421,0.9736842105263158,38,800,600,200,0.75,10,6,4,335.65185556032395,0.4283724513987672,0.1029330565187625,0.1882019698353534,129636.22708013738,1102.528033457527,130738.7551135949,795,1,235.1578947368421,38,0,14,36.860487480766544,0.6129385964912281,45.40598290598291,1018.3760683760687,26.799370220422862,0
996,4,0,0,37,0.0,0.0,1.0,37,800,500,300,0.625,11,5,6,357.270488170239,0.42551926926926925,0.06181483926290987,0.19491930369536972,128555.01570001729,1844.0011489101253,130399.01684892742,796,2,242.43243243243242,35,2,17,37.412025412767235,0.6077380952380953,46.46990740740741,1014.1203703703716,28.97486772486776,8
997,4,1,0,38,0.02631578947368421,0.0,1.0,38,1100,800,300,0.7272727272727273,14,8,6,349.669507115249,0.42652027027027023,0.07393928427590013,0.19237156471374026,128886.73460200077,1413.552192395115,130300.28679439588,797,0,237.02631578947367,36,2,18,37.26641344127759,0.6090856481481481,46.143018018018026,1015.427927927929,28.20633133133136,0
998,4,0,0,38,0.0,0.0,1.0,38,950,400,550,0.42105263157894735,15,4,11,348.51063099973675,0.42549786628733993,0.07729643328005209,0.1924273508494267,129029.71172185728,1393.6452499797454,130423.35697183703,798,1,238.02631578947367,36,2,18,37.150160718244294,0.6105324074074074,46.00225225225227,1015.9909909909934,28.22197197197204,0
999,4,2,1,39,0.05,0.025,0.975,40,900,700,200,0.7777777777777778,11,7,4,333.30822483851466,0.42844551282051285,0.08936739404112481,0.18688788230357198,129636.22708013754,641.7641445686558,130277.9912247062,799,0,227.075,38,2,16,36.92015491677158,0.6129385964912281,45.40598290598292,1018.37606837607,26.799370220422894,0
1000,4,2,1,40,0.04878048780487805,0.024390243902439025,0.975609756097561,41,1550,1200,350,0.7741935483870968,19,12,7,332.1979854640053,0.4315294715447155,0.11423619239255456,0.18850214771926252,130103.13042534747,443.9995659722467,130547.12999131971,800,0,222.4878048780488,39,2,19,36.475137839493556,0.6159188034188035,44.94791666666668,1020.2083333333353,26.159188034188084,0
1001,4,1,0,41,0.024390243902439025,0.0,1.0,41,1450,1000,450,0.6896551724137931,19,10,9,324.31363413161245,0.43363821138211384,0.11519727290588078,0.18530269149217504,130371.67302441763,256.3598695234529,130628.03289394108,801,0,220.4878048780488,38,3,20,36.404609966174974,0.6203399122807017,44.68482905982907,1021.2606837606854,26.875281151596983,0
1002,4,1,0,42,0.023809523809523808,0.0,1.0,42,950,500,450,0.5263157894736842,14,5,9,316.57311151097053,0.4348262679055362,0.11691310591066117,0.18236394733519307,130688.28125000012,-125.52083333331876,130562.7604166668,802,0,216.21428571428572,39,3,18,36.28259983700084,0.6217948717948718,44.37500000000001,1022.5000000000009,26.21794871794874,0
1003,4,0,1,41,0.0,0.023809523809523808,0.9761904761904762,42,1400,1000,400,0.7142857142857143,18,10,8,316.08652013906044,0.4346447928765002,0.116356592530098,0.18271251996973026,130821.45317925369,-129.82042100692047,130691.63275824676,803,1,217.21428571428572,39,3,19,36.1607142857143,0.6231303418803419,44.24479166666668,1023.0208333333351,26.231303418803464,0
1004,4,0,1,40,0.0,0.024390243902439025,0.975609756097561,41,1250,1100,150,0.88,14,11,3,329.3207882966012,0.43216463414634143,0.1292221964717295,0.19056828939677048,130863.12601587042,419.1895637007843,131282.3155795712,804,2,223.4390243902439,38,3,19,35.78016776304341,0.6252741228070176,44.20405982905983,1023.1837606837607,26.925888439046336,0
1005,4,0,0,40,0.0,0.0,1.0,40,1350,1100,250,0.8148148148148148,16,11,5,335.8888046775513,0.43035523504273504,0.13156122768556222,0.19464481911713613,130917.78897518065,794.7639299802553,131712.5529051609,805,3,229.725,38,2,19,35.556947489299496,0.6258223684210527,44.150641025641015,1023.3974358974347,26.93151147098512,0
1006,4,0,0,40,0.0,0.0,1.0,40,850,500,350,0.5882352941176471,12,5,7,335.815204214332,0.42984775641025647,0.1322300469483575,0.19543343851817627,131081.84633875705,803.8553994082504,131885.7017381653,806,4,230.725,38,2,19,35.393192488262926,0.627467105263158,43.9903846153846,1024.0384615384587,26.948380566801546,0
1007,4,0,0,40,0.0,0.0,1.0,40,1300,900,400,0.6923076923076923,17,9,8,339.04277678890867,0.42865918803418807,0.1349217935349325,0.1980158483194659,131218.6392815398,897.7463656950722,132116.38564723489,807,5,231.725,38,2,20,35.17248870351061,0.6288377192982456,43.8568376068376,1024.5726495726485,26.962438146648644,0
1008,4,0,0,40,0.0,0.0,1.0,40,1050,800,250,0.7619047619047619,13,8,5,342.31978080678675,0.42896634615384616,0.13468552786394294,0.20064875427978962,131356.22409058534,993.2124247561915,132349.43651534154,808,6,232.725,37,3,20,34.94970495953221,0.6320382882882882,43.72258771929823,1025.1096491228052,27.70566619250825,0
1009,4,0,0,40,0.0,0.0,1.0,40,1050,600,450,0.5714285714285714,15,6,9,368.49180423666957,0.42813835470085465,0.14296756756756768,0.20121305721305707,128588.99493113243,1532.0855936441726,130121.0805247766,809,7,233.725,37,3,16,37.09279279279279,0.6041666666666667,46.43640350877192,1014.2543859649104,27.412280701754334,7
1010,4,0,0,40,0.0,0.0,1.0,40,1050,800,250,0.7619047619047619,13,8,5,368.3339943441886,0.4286858974358974,0.15104279230603002,0.201690105542078,128700.231080717,1480.9340373961045,130181.1651181131,810,8,234.725,37,3,16,36.98310640443771,0.6052927927927928,46.326754385964904,1014.6929824561391,27.424134660976733,0
1011,4,0,0,40,0.0,0.0,1.0,40,850,600,250,0.7058823529411765,11,6,5,367.69376526328784,0.42841880341880345,0.15418556923741633,0.2019044412104103,128811.51532202208,1472.6382156047925,130284.15353762687,811,9,235.725,37,3,16,36.88566645063728,0.6064189189189189,46.21710526315789,1015.1315789473678,27.43598862019913,0
1012,4,0,1,39,0.0,0.025,0.975,40,1150,800,350,0.6956521739130435,15,8,7,370.3472352268415,0.42741720085470086,0.1541419320021591,0.20436373641314395,129006.3784650085,1555.4311182286906,130561.80958323719,812,10,236.725,37,3,16,36.619333513221804,0.6083896396396397,46.02521929824562,1015.8991228070179,27.45673304883832,0
1013,4,1,0,40,0.025,0.0,1.0,40,1350,900,450,0.6666666666666666,18,9,9,380.61723891735966,0.4262686965811966,0.24125335120643454,0.19995807058616225,127035.24470416368,1676.594706171607,128711.83941033529,813,0,237.45,36,4,15,38.38038985701519,0.5902777777777778,47.972972972972975,1008.1081081081085,28.003003003003013,8
1014,4,1,1,40,0.024390243902439025,0.024390243902439025,0.975609756097561,41,1750,1400,350,0.8,21,14,7,369.201745984061,0.42820121951219514,0.22763482019779513,0.19577792280966314,127413.15593117694,1208.2572894270115,128621.41322060395,814,0,232.6341463414634,35,6,16,38.279667736634956,0.5961309523809524,47.59837962962962,1009.6064814814799,28.845899470899425,0
1015,4,2,1,41,0.047619047619047616,0.023809523809523808,0.9761904761904762,42,1550,1000,550,0.6451612903225806,21,10,11,391.68119012310785,0.43153552071234996,0.32087768440709596,0.20195000703921084,126270.10192202346,1525.1284225369732,127795.23034456043,815,0,227.73809523809524,36,6,18,38.891456582633054,0.5824652777777778,48.73310810810811,1005.0675675675683,27.918543543543564,8
1016,4,2,2,41,0.046511627906976744,0.046511627906976744,0.9534883720930233,43,900,500,400,0.5555555555555556,13,5,8,380.1489926967941,0.4328857511997047,0.3329813178547818,0.19823442361923127,126732.93856042255,1035.479787049874,127768.41834747243,816,0,223.37209302325581,37,6,20,38.70365076772296,0.5853040540540541,48.27302631578948,1006.9078947368431,27.213726884779543,0
1017,4,0,0,41,0.0,0.0,1.0,41,1300,1100,200,0.8461538461538461,15,11,4,384.421927358589,0.4327997967479675,0.322326669561928,0.20122627045439098,126887.86175679462,1555.695274991454,128443.55703178607,817,1,230.02439024390245,35,6,20,38.43636320122535,0.5907738095238095,48.119212962962976,1007.52314814815,28.786375661375715,0
1018,4,0,0,41,0.0,0.0,1.0,41,1150,800,350,0.6956521739130435,15,8,7,382.93501596991405,0.43300304878048784,0.32108079950933854,0.20102357167462243,127004.50002411287,1526.8940489969411,128531.39407310981,818,2,231.02439024390245,35,6,20,38.35364278332761,0.5919642857142857,48.003472222222236,1007.9861111111129,28.799603174603227,0
1019,4,5,3,43,0.10869565217391304,0.06521739130434782,0.9347826086956522,46,1500,1000,500,0.6666666666666666,20,10,10,345.6421841082103,0.4420893719806764,0.29126664152913495,0.18704607724845068,128230.06071950354,-325.408470830033,127904.6522486735,819,0,206.80434782608697,36,10,18,38.03855348009783,0.6024305555555556,46.790540540540555,1012.8378378378399,28.13438438438444,0
1020,4,1,1,43,0.022727272727272728,0.022727272727272728,0.9772727272727273,44,950,800,150,0.8421052631578947,11,8,3,362.64166198833715,0.4393058491895701,0.3166390142241471,0.1951316152471377,128002.04554216388,483.7749066634318,128485.8204488273,820,0,217.1818181818182,36,8,19,37.841503449810844,0.6001157407407407,47.01576576576577,1011.9369369369376,28.109359359359377,0
1021,4,1,0,44,0.022727272727272728,0.0,1.0,44,1050,700,350,0.6666666666666666,14,7,7,363.4462763669285,0.43832584566596194,0.3195294248525973,0.1959819183120769,128087.52745566523,510.5869805616543,128598.11443622688,821,0,218.0681818181818,36,8,20,37.73361886750472,0.6009837962962963,46.93130630630631,1012.2747747747757,28.118743743743767,0
1022,4,0,0,44,0.0,0.0,1.0,44,1150,700,450,0.6086956521739131,16,7,9,361.17235447737966,0.4378964059196617,0.3195342920928299,0.1960362035616525,128349.69142500414,471.284731283288,128820.97615628743,822,1,219.0681818181818,35,9,21,37.52296306872263,0.6056547619047619,46.672453703703695,1013.3101851851841,28.951719576719544,0
1023,4,2,1,45,0.043478260869565216,0.021739130434782608,0.9782608695652174,46,950,500,450,0.5263157894736842,14,5,9,347.42085108767964,0.4411332528180354,0.31665720092560834,0.19144314953153913,128950.68825263533,-239.9684277854845,128710.71982484985,823,0,210.5,37,9,20,37.25833513260642,0.6078265765765766,46.080043859649116,1015.6798245614027,27.4508060692271,0
1024,4,1,0,46,0.021739130434782608,0.0,1.0,46,1500,1200,300,0.8,18,12,6,346.4600657791851,0.4422504025764895,0.3185363335601501,0.1911824008007232,129006.37846500821,-260.88832621578024,128745.49013879243,824,0,211.43478260869566,37,9,21,37.226007375427244,0.6083896396396397,46.0252192982456,1015.8991228070154,27.456733048838252,0
1025,4,1,0,47,0.02127659574468085,0.0,1.0,47,1500,1000,500,0.6666666666666666,20,10,10,339.79543063497886,0.4440333024976873,0.31755177807511825,0.18897982324477378,129315.90374157931,-611.5147982474833,128704.38894333183,825,0,207.91489361702128,36,11,22,37.08042700029523,0.6134259259259259,45.72072072072071,1017.1171171171163,28.25325325325323,0
1026,4,0,1,46,0.0,0.02127659574468085,0.9787234042553191,47,1400,900,500,0.6428571428571429,19,9,10,340.15039149878305,0.4441489361702127,0.3154333022519853,0.18972832948043225,129430.46932067195,-594.835037740447,128835.63428293151,826,1,208.91489361702128,36,11,15,36.954957945993804,0.6145833333333333,45.608108108108105,1017.5675675675669,28.26576576576575,0
1027,4,0,0,46,0.0,0.0,1.0,46,1450,1000,450,0.6896551724137931,19,10,9,343.6813547757006,0.4439915458937198,0.319600105868483,0.19155836152982414,129401.82317029838,-305.4012204772611,129096.42194982112,827,2,214.17391304347825,36,10,23,36.89425382770709,0.6142939814814814,45.63626126126125,1017.4549549549525,28.26263763763757,0
1028,4,0,2,44,0.0,0.043478260869565216,0.9565217391304348,46,1500,1300,200,0.8666666666666667,17,13,4,336.6642267185512,0.44384057971014496,0.23742077473103596,0.1783274379269833,127368.5713392577,-606.8263980646636,126761.74494119304,828,3,215.17391304347825,37,9,13,39.14657107683393,0.5917792792792793,47.642543859649095,1009.4298245613992,27.281887150308087,8
1029,4,2,1,45,0.043478260869565216,0.021739130434782608,0.9782608695652174,46,1650,1200,450,0.7272727272727273,21,12,9,330.85385428309024,0.4436996779388083,0.25536759921925833,0.17718549617878362,127811.68845221582,-742.6020506309881,127069.08640158483,829,0,215.93478260869566,37,9,16,38.84009253235018,0.5962837837837838,47.20394736842104,1011.1842105263138,27.32930298719767,0
1030,4,1,0,46,0.021739130434782608,0.0,1.0,46,1150,800,350,0.6956521739130435,15,8,7,330.0914453366388,0.4447866344605475,0.2563860315425901,0.17738810519051643,127950.32035097339,-752.9387648122508,127197.38158616114,830,0,216.82608695652175,37,9,17,38.71778024637839,0.5976914414414414,47.06688596491228,1011.7324561403509,27.3441204362257,0
1031,4,0,0,46,0.0,0.0,1.0,46,800,500,300,0.625,11,5,6,332.50315079848906,0.44476650563607084,0.25636344792172094,0.17893128738887784,128005.79415060405,-687.5340248922719,127318.26012571178,831,1,217.82608695652175,37,9,17,38.60013273377399,0.5982545045045045,47.012061403508774,1011.951754385965,27.350047415836894,0
1032,4,1,1,46,0.02127659574468085,0.02127659574468085,0.9787234042553191,47,1150,700,450,0.6086956521739131,16,7,9,322.8266411897754,0.44694341658957754,0.24995913217460597,0.17517563072429337,128338.88942992086,-1113.682334949201,127225.20709497166,832,0,214.17021276595744,37,10,18,38.50537008981712,0.6016328828828829,46.683114035087726,1013.2675438596501,27.385609293504057,0
1033,4,1,1,46,0.02127659574468085,0.02127659574468085,0.9787234042553191,47,1350,1000,350,0.7407407407407407,17,10,7,319.2151898923623,0.4463652482269504,0.2547485827873077,0.17406262241300532,128533.39489073586,-1194.0375884887376,127339.35730224712,833,0,214.89361702127658,37,10,13,38.39884299307959,0.6036036036036037,46.49122807017545,1014.0350877193002,27.40635372214325,0
1034,4,1,0,47,0.02127659574468085,0.0,1.0,47,1300,900,400,0.6923076923076923,17,9,8,320.78325092067007,0.4448041936478569,0.26266732269886717,0.1756525564508807,128700.23108071725,-1143.0242959371992,127557.20678478005,834,0,215.85106382978722,37,10,14,38.18934154599814,0.6052927927927928,46.32675438596492,1014.6929824561413,27.42413466097679,0
1035,4,0,1,46,0.0,0.02127659574468085,0.9787234042553191,47,1200,900,300,0.75,15,9,6,321.27499418779485,0.4445536540240518,0.26008966548935697,0.17653917929880092,128839.34389667994,-1121.4281076869581,127717.91578899299,835,1,216.85106382978722,37,10,15,38.035402491269764,0.6067004504504505,46.18969298245615,1015.241228070177,27.438952110004784,0
1036,4,0,0,46,0.0,0.0,1.0,46,1500,1200,300,0.8,18,12,6,327.8461692519453,0.44170692431562,0.261938086806224,0.17989756898430714,128783.68975309725,-755.7521304631993,128027.93762263405,836,2,222.45652173913044,37,9,16,37.925241258867175,0.6061373873873874,46.24451754385966,1015.0219298245626,27.43302513039358,0
1037,4,0,3,43,0.0,0.06521739130434782,0.9347826086956522,46,1350,900,450,0.6666666666666666,18,9,9,328.06671525321076,0.44157608695652173,0.2625090894123778,0.18080755141520446,128957.11343277461,-738.692677514779,128218.42075525984,837,3,223.45652173913044,38,8,16,37.743241821815516,0.6060855263157895,46.073717948717956,1015.7051282051292,26.72908232118761,0
1038,4,0,0,43,0.0,0.0,1.0,43,1350,1000,350,0.7407407407407407,17,10,7,352.5767732064764,0.4365079365079365,0.2813627063047852,0.1925003279506762,128584.36113522378,467.17182677468986,129051.53296199847,838,4,239.25581395348837,35,8,17,37.50106983909621,0.6080357142857142,46.44097222222222,1014.2361111111112,28.978174603174605,0
1039,4,0,0,43,0.0,0.0,1.0,43,1300,800,500,0.6153846153846154,18,8,10,350.21241398424513,0.4364387227759321,0.2775421874627051,0.1920583275939867,128760.50407503855,418.70539158949833,129179.20946662805,839,5,240.25581395348837,35,8,19,37.38132911392404,0.6098214285714285,46.26736111111111,1014.9305555555553,28.998015873015866,0
1040,4,1,0,44,0.022727272727272728,0.0,1.0,44,1100,700,400,0.6363636363636364,15,7,8,344.52701796700427,0.4383478682170543,0.2773956046169659,0.19077919412086963,129144.15048494421,98.72981089195952,129242.88029583618,840,0,235.77272727272728,36,8,20,37.134851170692095,0.6116898148148149,45.88963963963963,1016.4414414414399,28.23448448448444,0
1041,4,0,0,44,0.0,0.0,1.0,44,1550,1100,450,0.7096774193548387,20,11,9,346.65153679038826,0.43841393587033123,0.28417602996254643,0.1928249173396534,129322.44897959176,165.99049925544614,129488.43947884721,841,1,236.77272727272728,34,10,20,36.89943235018725,0.6176470588235294,45.71428571428571,1017.1428571428565,29.915966386554604,0
1042,4,1,0,45,0.022222222222222223,0.0,1.0,45,1300,800,500,0.6153846153846154,18,8,10,340.789809343387,0.4393939393939394,0.2926607589184278,0.19154737559645507,129731.44531249975,-157.76909722225287,129573.6762152775,842,0,232.48888888888888,37,8,18,36.633009543285596,0.6157094594594594,45.312499999999986,1018.7499999999981,27.533783783783733,0
1043,4,2,0,47,0.0425531914893617,0.0,1.0,47,1450,1200,250,0.8275862068965517,17,12,5,330.5535004246984,0.4410075547332717,0.29171628705118957,0.18987997277560506,130578.91506371222,-764.081300472787,129814.83376323944,843,0,223.5531914893617,36,11,17,36.03574445423828,0.6261574074074074,44.481981981981974,1022.0720720720709,28.39089089089086,0
1044,4,0,0,47,0.0,0.0,1.0,47,1950,1400,550,0.717948717948718,25,14,11,328.94654578406494,0.4407762873882208,0.28939637239516847,0.18987706553674216,130766.77439212042,-796.9442520775881,129969.83014004283,844,1,224.5531914893617,37,10,17,35.88702472841623,0.6261261261261262,44.298245614035075,1022.8070175438578,27.64343290659075,0
1045,4,0,2,45,0.0,0.0425531914893617,0.9574468085106383,47,1900,1300,600,0.6842105263157895,25,13,12,333.19381046329744,0.44019811902559364,0.2981959908375027,0.1933103928324971,130963.11034404805,-672.7804468682781,130290.32989717978,845,2,225.5531914893617,37,10,17,35.580141938939484,0.6280968468468469,44.1063596491228,1023.5745614035078,27.66417733522994,0
1046,4,0,0,45,0.0,0.0,1.0,45,1600,1100,500,0.6875,21,11,10,346.2090076606545,0.44055134680134683,0.30364420308984186,0.2001400535456195,130824.4133257243,58.51806305725057,130882.93138878155,846,3,220.57777777777778,35,10,17,35.38732228381794,0.6306547619047619,44.24189814814814,1023.0324074074061,29.22949735449732,0
1047,4,0,0,45,0.0,0.0,1.0,45,1200,900,300,0.75,15,9,6,346.4658808270856,0.4401936026936027,0.3039173547487086,0.2005962575240512,130883.62328800144,69.34196566356877,130952.96525366501,847,4,221.57777777777778,35,10,17,35.32087716321682,0.63125,44.18402777777777,1023.2638888888881,29.23611111111109,0
1048,4,0,0,45,0.0,0.0,1.0,45,1550,1100,450,0.7096774193548387,20,11,9,347.52794580107616,0.4404671717171717,0.3026543558821688,0.20183090483325755,131002.08340031267,105.37698795436222,131107.46038826703,848,5,222.57777777777778,35,10,17,35.17394478990014,0.6324404761904762,44.068287037037024,1023.7268518518497,29.249338624338563,0
1049,4,0,0,45,0.0,0.0,1.0,45,550,200,350,0.36363636363636365,9,2,7,346.15599757593554,0.4401515151515152,0.303113848560395,0.20123083951153467,131039.71370018648,72.0365635905955,131111.75026377707,849,6,223.57777777777778,36,9,17,35.17102947646281,0.630787037037037,44.03153153153152,1023.8738738738723,28.440940940940898,0
1050,4,0,0,45,0.0,0.0,1.0,45,1500,1100,400,0.7333333333333333,19,11,8,347.1364783112943,0.43924663299663297,0.29527890707980853,0.203169716341549,131299.26960321798,115.7532109812434,131415.0228141992,850,7,224.57777777777778,36,9,18,34.88375819507013,0.6333912037037037,43.77815315315315,1024.8873873873865,28.46909409409407,0
1051,4,0,1,44,0.0,0.022222222222222223,0.9777777777777777,45,1400,1000,400,0.7142857142857143,18,10,8,376.5039457011303,0.4388468013468014,0.18477618723017475,0.2116211832733939,129731.44531250001,839.2694320164755,130570.71474451649,851,8,225.57777777777778,35,10,13,35.72341513292432,0.6196428571428572,45.3125,1018.7500000000001,29.10714285714286,8
1052,4,0,0,44,0.0,0.0,1.0,44,1450,1000,450,0.6896551724137931,19,10,9,383.51678399621767,0.43674022198731505,0.20344613325685912,0.21581329087597778,129776.9292091835,1154.3261054421555,130931.25531462565,852,9,231.29545454545453,34,10,13,35.49845192195349,0.6222426470588236,45.26785714285713,1018.92857142857,29.96848739495794,0
1053,4,0,0,44,0.0,0.0,1.0,44,1750,1300,450,0.7428571428571429,22,13,9,380.62376272707183,0.43658606412966877,0.20030848137961832,0.21451744784110993,129837.58680555547,1083.854166666659,130921.44097222213,853,10,232.29545454545453,34,10,13,35.510357045516486,0.6228553921568627,45.20833333333333,1019.166666666666,29.97549019607841,0
1054,4,0,2,42,0.0,0.045454545454545456,0.9545454545454546,44,1200,800,400,0.6666666666666666,16,8,8,386.41315989215343,0.4366190979563072,0.20334635015970348,0.21879719370760586,130019.6446286847,1248.2603458049753,131267.90497448968,854,11,233.29545454545453,34,10,15,35.177376366678345,0.6246936274509804,45.0297619047619,1019.8809523809516,29.996498599439754,0
1055,4,0,0,42,0.0,0.0,1.0,42,1050,800,250,0.7619047619047619,13,8,5,389.7567074897532,0.4342213511420829,0.20533455647291055,0.22034760393727637,129958.94451530615,1730.4740646258533,131689.418579932,855,12,240.76190476190476,34,8,15,35.15396964389959,0.6240808823529411,45.089285714285715,1019.6428571428575,29.989495798319336,0
1056,4,0,1,41,0.0,0.023809523809523808,0.9761904761904762,42,1300,900,400,0.6923076923076923,17,9,8,391.5953525955966,0.43419715447154467,0.20669757513091658,0.22155916712905405,129989.2928004534,1780.6405895691482,131769.93339002255,856,13,241.76190476190476,34,8,15,35.07617324305394,0.6243872549019608,45.0595238095238,1019.7619047619038,29.99299719887952,0
1057,4,0,0,41,0.0,0.0,1.0,41,900,700,200,0.7777777777777778,11,7,4,391.3750005260276,0.433739837398374,0.20987735142843356,0.22195184510307928,130080.35891439894,1982.040107709736,132062.39902210867,857,14,244.58536585365854,34,7,15,34.98901077527523,0.6253063725490196,44.97023809523809,1020.1190476190463,30.003501400560186,0
1058,4,0,1,40,0.0,0.024390243902439025,0.975609756097561,41,1100,600,500,0.5454545454545454,16,6,10,393.33462055007385,0.43391768292682925,0.20607135851697023,0.2242895772623316,130293.86421388402,2049.9450791345885,132343.80929301862,858,15,245.58536585365854,33,8,18,34.7215970471732,0.6297348484848485,44.7610294117647,1020.9558823529406,30.938057040998203,0
1059,4,1,1,40,0.024390243902439025,0.024390243902439025,0.975609756097561,41,1150,600,550,0.5217391304347826,17,6,11,390.7718650190584,0.4354166666666666,0.20725128004187354,0.22463322716223058,130606.84479827469,2007.4960652152986,132614.34086348998,859,0,242.14634146341464,33,8,17,34.46866382927707,0.6328914141414141,44.4546568627451,1022.1813725490194,30.975193107546044,0
1060,4,0,0,40,0.0,0.0,1.0,40,1350,900,450,0.6666666666666666,18,9,9,398.18619924204546,0.4329059829059829,0.212074340527578,0.22871025493654654,130575.52984429053,2398.6747885428517,132974.2046328334,860,1,248.725,33,7,18,34.31105115907274,0.6325757575757576,44.48529411764705,1022.0588235294107,30.971479500891235,0
1061,4,0,0,40,0.0,0.0,1.0,40,1100,900,200,0.8181818181818182,13,9,4,397.30495197485646,0.43253205128205124,0.2155658115559822,0.2285736489223621,130638.16350682414,2380.6378556324303,133018.80136245658,861,2,249.725,33,7,18,34.26985934627987,0.6332070707070707,44.42401960784313,1022.3039215686262,30.978906714200793,0
1062,4,0,0,40,0.0,0.0,1.0,40,1250,1000,250,0.8,15,10,5,399.9567487564728,0.431877670940171,0.21869327437747277,0.23130742253116587,130840.48327664383,2466.106859410413,133306.59013605423,862,3,250.725,34,6,18,33.99634434877045,0.6329656862745099,44.22619047619047,1023.0952380952369,30.091036414565792,0
1063,4,0,0,40,0.0,0.0,1.0,40,1150,800,350,0.6956521739130435,15,8,7,392.9779452092978,0.43095619658119655,0.21288231189673268,0.22817132686392638,130992.77388038542,2295.454223356003,133288.22810374142,863,4,251.725,34,6,18,34.02018645578943,0.6344975490196079,44.07738095238095,1023.6904761904757,30.10854341736693,0
1064,4,1,0,41,0.024390243902439025,0.0,1.0,41,1000,700,300,0.7,13,7,6,383.89231616344796,0.43145325203252033,0.20778119017779706,0.22467722799916248,131298.46810967493,1880.8946062671284,133179.36271594206,864,0,246.5609756097561,35,6,19,33.94280538302277,0.6354166666666667,43.778935185185176,1024.884259259258,29.282407407407373,0
1065,4,0,0,41,0.0,0.0,1.0,41,1100,800,300,0.7272727272727273,14,8,6,356.3865657060145,0.43119918699186993,0.042607470086322374,0.2005996580924285,129787.30384589493,1208.59040621533,130995.89425211026,865,1,247.5609756097561,37,4,14,36.179001219555936,0.6162725225225225,45.25767543859649,1018.9692982456144,27.539710763394982,8
1066,4,3,0,44,0.06818181818181818,0.0,1.0,44,1600,1000,600,0.625,22,10,12,336.37242153441167,0.4356611169837914,0.07383878546900435,0.19358733184417526,130651.91436975352,-10.459837067876435,130641.45453268565,866,0,231.61363636363637,40,4,13,35.81324552683897,0.6197916666666667,44.41056910569106,1022.3577235772362,25.558943089430905,0
1067,4,0,0,44,0.0,0.0,1.0,44,900,700,200,0.7777777777777778,11,7,4,336.3511009440169,0.4353858350951374,0.07548725501712328,0.19370511886650002,130677.89019639442,-9.269552680272596,130668.62064371415,867,1,232.61363636363637,40,4,13,35.787529403969124,0.6200520833333334,44.38516260162602,1022.4593495934965,25.561483739837414,0
1068,4,0,1,43,0.0,0.022727272727272728,0.9772727272727273,44,950,500,450,0.5263157894736842,14,5,9,345.10754408901676,0.43487931642001404,0.07123789913069367,0.1909934377581702,129121.97401258702,145.9345446220003,129267.90855720901,868,2,233.61363636363637,39,5,19,37.142671073759,0.6060363247863247,45.91145833333334,1016.3541666666683,26.06036324786329,8
1069,4,0,1,42,0.0,0.023255813953488372,0.9767441860465116,43,1050,900,150,0.8571428571428571,12,9,3,353.9710098385751,0.43429309708379477,0.0749310540418957,0.19575420032468177,129092.79348381917,539.0212944700216,129631.81477828919,869,3,240.0,38,5,22,36.947189514998605,0.6074561403508771,45.940170940170944,1016.2393162393167,26.743139901034652,0
1070,4,0,1,41,0.0,0.023809523809523808,0.9761904761904762,42,1150,700,450,0.6086956521739131,16,7,9,358.9054573828871,0.4331566976384049,0.07629940193600082,0.19846872189884254,129089.93632656215,866.2165281625242,129956.15285472467,870,4,245.52380952380952,37,5,22,36.82473744784922,0.6092342342342343,45.942982456140356,1016.2280701754396,27.465623518255125,0
1071,4,0,0,41,0.0,0.0,1.0,41,1200,800,400,0.6666666666666666,16,8,8,365.8290782047833,0.43249491869918694,0.0863654538184726,0.20286885245901648,129201.38888888907,1253.1250000000196,130454.51388888908,871,5,252.2439024390244,36,5,23,36.53517759562841,0.6122685185185186,45.83333333333334,1016.6666666666681,28.24074074074078,0
1072,4,0,0,41,0.0,0.0,1.0,41,1200,700,500,0.5833333333333334,17,7,10,366.25185861825247,0.4324695121951219,0.08886832809318612,0.20325907241445718,129231.6485969388,1266.2662981859457,130497.91489512475,872,6,253.2439024390244,34,7,23,36.49357998673067,0.6167279411764706,45.80357142857143,1016.7857142857146,29.905462184873958,0
1073,4,0,0,41,0.0,0.0,1.0,41,1150,700,450,0.6086956521739131,16,7,9,364.7173324242246,0.43198678861788614,0.09307291949192398,0.20271829348732273,129292.17864229021,1231.0196995464744,130523.19834183669,873,7,254.2439024390244,34,7,23,36.47089234851144,0.6173406862745099,45.74404761904761,1017.0238095238092,29.912464985994387,0
1074,4,0,0,41,0.0,0.0,1.0,41,1550,1300,250,0.8387096774193549,18,13,5,365.86654927130235,0.43135162601626015,0.0987767776109778,0.20382630574136554,129383.0002834466,1267.382369614499,130650.3826530611,874,8,255.2439024390244,34,7,24,36.34912044621265,0.6182598039215687,45.6547619047619,1017.3809523809515,29.922969187675044,0
1075,4,1,0,42,0.023809523809523808,0.0,1.0,42,1100,800,300,0.7272727272727273,14,8,6,355.4734424689053,0.4336769260549748,0.11052189328496675,0.20022849541248508,129815.23762119105,829.1738804247382,130644.41150161579,875,0,250.14285714285714,37,5,20,36.17387561867873,0.6165540540540541,45.23026315789473,1019.0789473684204,27.542674253200552,0
1076,4,2,1,43,0.045454545454545456,0.022727272727272728,0.9772727272727273,44,1300,1100,200,0.8461538461538461,15,11,4,340.330809373135,0.43542988019732204,0.1268567705723167,0.19462802276256844,130406.32482144304,78.56641735693862,130484.89123879997,876,0,239.72727272727272,36,8,22,35.96058434399119,0.6244212962962963,44.6509009009009,1021.3963963963961,28.372122122122114,0
1077,4,0,3,40,0.0,0.06976744186046512,0.9302325581395349,43,1200,800,400,0.6666666666666666,16,8,8,350.55223165371956,0.43505444813584343,0.12758017246832143,0.20034150855650384,130380.76560356648,541.0536694101469,130921.81927297663,877,1,245.32558139534885,35,8,22,35.72548352976731,0.6261904761904762,44.675925925925924,1021.296296296296,29.17989417989417,0
1078,4,0,0,40,0.0,0.0,1.0,40,1550,1300,250,0.8387096774193549,18,13,5,357.9515410655123,0.4336004273504273,0.1322225554889025,0.20477186649149245,130419.01139285372,1336.7372224625176,131755.74861531623,878,2,250.975,33,7,23,35.497775444911035,0.6309974747474747,44.638480392156865,1021.4460784313726,30.95291146761735,0
1079,4,1,0,41,0.024390243902439025,0.0,1.0,41,1250,900,350,0.72,16,9,7,350.7891257808499,0.43417174796747965,0.13978894532281294,0.20239283946160394,130749.15143140595,973.0761054421748,131722.22753684814,879,0,245.82926829268294,34,7,21,35.34634113219258,0.632046568627451,44.31547619047619,1022.7380952380956,30.080532212885167,0
1080,4,0,1,40,0.0,0.024390243902439025,0.975609756097561,41,1350,1000,350,0.7407407407407407,17,10,7,343.0385351030811,0.43368902439024387,0.1351103118630419,0.19891736169944557,130942.84664619763,783.6884591477994,131726.53510534542,880,1,246.82926829268294,35,6,21,35.34869859399149,0.6318452380952381,44.126157407407405,1023.4953703703698,29.24272486772485,0
1081,4,0,2,38,0.0,0.05,0.95,40,1350,1000,350,0.7407407407407407,17,10,7,357.53771609250714,0.4323985042735043,0.0356156631960165,0.20621431197084783,130735.6234996568,1348.5832475994193,132084.20674725622,881,2,253.9,35,5,17,35.18749056888486,0.6297619047619047,44.32870370370369,1022.6851851851831,29.219576719576658,8
1082,4,0,0,38,0.0,0.0,1.0,38,1000,700,300,0.7,13,7,6,355.1319588051025,0.4319582740635372,0.022529173612765074,0.20545592381132863,130854.01663237285,1694.0886488339877,132548.10528120684,881,3,241.23684210526315,35,3,17,35.12914781297135,0.6309523809523809,44.21296296296295,1023.148148148146,29.23280423280417,0
1083,4,1,0,39,0.02564102564102564,0.0,1.0,39,1150,700,450,0.6086956521739131,16,7,9,349.3349540735322,0.43325461088618983,0.03989731190522483,0.2041489240279426,131241.5683208545,1369.4534483807984,132611.02176923532,882,0,236.02564102564102,36,3,20,34.88570172546433,0.6328125,43.83445945945945,1024.6621621621612,28.46283783783781,0
1084,4,0,0,39,0.0,0.0,1.0,39,750,300,450,0.4,12,3,9,347.136478311294,0.43302968960863697,0.03984346606036526,0.20316971634154907,131299.26960321813,1315.753210981256,132615.0228141994,883,1,237.02564102564102,36,3,20,34.88375819507014,0.6333912037037037,43.778153153153156,1024.8873873873877,28.469094094094103,0
1085,4,0,0,39,0.0,0.0,1.0,39,900,600,300,0.6666666666666666,12,6,6,347.136478311294,0.43302968960863697,0.03984346606036526,0.20316971634154907,131299.26960321813,1315.753210981256,132615.0228141994,884,2,238.02564102564102,36,3,20,34.88375819507014,0.6333912037037037,43.778153153153156,1024.8873873873877,28.469094094094103,0
1086,4,0,0,39,0.0,0.0,1.0,39,1300,800,500,0.6153846153846154,18,8,10,347.9254588599657,0.43213000449842554,0.04197391130519512,0.20455501315930966,131472.44953991144,1348.5224667234704,132820.9720066349,885,3,239.02564102564102,36,3,20,34.688746751583025,0.6351273148148149,43.60923423423423,1025.5630630630624,28.487862862862844,0
1087,4,0,0,39,0.0,0.0,1.0,39,1200,600,600,0.5,18,6,12,351.6171846616021,0.4314271255060729,0.046309109933506454,0.20813910749189385,131732.4334469605,1463.8774754484236,133196.3109224089,886,4,240.02564102564102,36,3,15,34.33180671347081,0.6377314814814814,43.35585585585586,1026.5765765765768,28.516016016016025,0
1088,4,0,1,38,0.0,0.02564102564102564,0.9743589743589743,39,1150,700,450,0.6086956521739131,16,7,9,349.82627444766234,0.4307523616734143,0.04643446621733727,0.20755145066286498,131819.15181651246,1422.7605561642754,133241.91237267674,887,5,241.02564102564102,36,3,15,34.29035530211647,0.638599537037037,43.2713963963964,1026.9144144144145,28.525400400400404,0
1089,4,0,0,38,0.0,0.0,1.0,38,750,500,250,0.6666666666666666,10,5,5,357.59474548680595,0.4292318634423897,0.05088668898226567,0.21141001353179975,131684.268904321,1817.9205246913598,133502.18942901236,888,6,247.78947368421052,35,3,16,34.226995940460085,0.6392857142857142,43.40277777777778,1026.3888888888891,29.325396825396833,0
1090,4,0,0,38,0.0,0.0,1.0,38,1150,700,450,0.6086956521739131,16,7,9,356.9693264477885,0.42940967283072545,0.05426333590458676,0.2113696879567344,131743.6731074244,1805.69005058297,133549.36315800739,889,7,248.78947368421052,35,3,16,34.183107854190155,0.6398809523809523,43.3449074074074,1026.620370370369,29.332010582010543,0
1091,4,0,0,38,0.0,0.0,1.0,38,1200,700,500,0.5833333333333334,17,7,10,357.9113676666023,0.429054054054054,0.05375253549695702,0.21259072802365633,131862.52170138876,1839.019097222202,133701.54079861095,890,8,249.78947368421052,35,3,18,34.03904665314401,0.6410714285714285,43.22916666666666,1027.0833333333321,29.34523809523806,0
1092,4,0,0,38,0.0,0.0,1.0,38,1200,700,500,0.5833333333333334,17,7,10,362.06983095087276,0.4282390943575154,0.04859279716011122,0.21624358901645588,132070.6356765474,1963.758546596358,134034.39422314375,891,9,250.78947368421052,35,3,18,33.72238955823293,0.643154761904762,43.02662037037037,1027.8935185185178,29.368386243386222,0
1093,4,0,0,38,0.0,0.0,1.0,38,1100,900,200,0.8181818181818182,13,9,4,364.15652725553775,0.42826872925557136,0.0462059403828714,0.2178318135764943,132130.1269531249,2023.2096354166522,134153.33658854157,892,10,251.78947368421052,35,3,19,33.608789260384995,0.64375,42.96874999999999,1028.1249999999993,29.374999999999982,0
1094,4,0,1,37,0.0,0.02631578947368421,0.9736842105263158,38,850,500,350,0.5882352941176471,12,5,7,364.8904640011859,0.42838726884779516,0.04829843319610205,0.21861441487866048,132189.6316256215,2046.9472040037665,134236.57882962527,893,11,252.78947368421052,35,3,19,33.52994278746953,0.6443452380952381,42.910879629629626,1028.3564814814808,29.38161375661374,0
1095,4,0,2,35,0.0,0.05405405405405406,0.9459459459459459,37,1150,800,350,0.6956521739130435,15,8,7,369.0852653503836,0.4267705205205205,0.03146635465190828,0.2212718672700875,132214.28748582752,2359.669075963699,134573.95656179122,894,12,246.78378378378378,34,3,20,33.39723926380367,0.6467524509803921,42.88690476190475,1028.4523809523798,30.248599439775877,0
1096,4,0,0,35,0.0,0.0,1.0,35,950,500,450,0.5263157894736842,14,5,9,386.6776244506217,0.42331932773109243,0.04572692327944794,0.23056184508451366,132008.45457415064,3208.9431244260777,135217.39769857674,895,13,260.54285714285714,32,3,20,33.152875046074435,0.6494140625,43.08712121212121,1027.6515151515155,32.11410984848486,0
1097,4,0,0,35,0.0,0.0,1.0,35,800,600,200,0.75,10,6,4,386.4022299830187,0.4227941176470588,0.04267817665017337,0.2309902317563684,132105.7879935721,3209.1942148760327,135314.98220844814,896,14,261.54285714285714,32,3,20,33.06159420289855,0.650390625,42.99242424242424,1028.0303030303032,32.125946969696976,0
1098,4,0,1,34,0.0,0.02857142857142857,0.9714285714285714,35,700,500,200,0.7142857142857143,9,5,4,384.52779432450876,0.4216386554621849,0.04027838648037463,0.23125586685980978,132333.03880025004,3177.146305223965,135510.185105474,897,15,262.54285714285714,32,3,20,32.88031251278275,0.6526692708333333,42.77146464646465,1028.914141414142,32.15356691919194,0
1099,4,0,0,34,0.0,0.0,1.0,34,850,600,250,0.7058823529411765,11,6,5,385.5860341441945,0.41902480689245397,0.0554176528314958,0.23249240756978373,132430.49178655245,3412.669625548425,135843.16141210086,898,16,268.8235294117647,32,2,20,32.75474321229963,0.6536458333333333,42.67676767676768,1029.2929292929298,32.165404040404056,0
1100,4,0,0,34,0.0,0.0,1.0,34,850,500,350,0.5882352941176471,12,5,7,390.52417563138755,0.41774361259655374,0.05898578629686502,0.23648891615629036,132592.99314164382,3556.1538682277405,136149.14700987155,899,17,269.8235294117647,32,2,20,32.46368150055167,0.6552734375,42.5189393939394,1029.9242424242432,32.1851325757576,0
1101,4,0,0,34,0.0,0.0,1.0,34,650,300,350,0.46153846153846156,10,3,7,390.52417563138755,0.41774361259655374,0.05898578629686502,0.23648891615629036,132592.99314164382,3556.1538682277405,136149.14700987155,900,18,270.8235294117647,32,2,20,32.46368150055167,0.6552734375,42.5189393939394,1029.9242424242432,32.1851325757576,0
1102,4,0,0,34,0.0,0.0,1.0,34,1050,900,150,0.8571428571428571,12,9,3,388.7752316669148,0.41729797979797983,0.06188252588797383,0.23665713766569896,132788.12629132214,3524.94691230485,136313.073203627,901,19,271.8235294117647,32,2,17,32.31195638858264,0.6572265625,42.329545454545446,1030.6818181818169,32.20880681818178,0
1103,4,0,0,34,0.0,0.0,1.0,34,550,300,250,0.5454545454545454,8,3,5,385.715919629173,0.4169451871657754,0.05508086884478236,0.2352031727985211,132853.20255905006,3448.719040148958,136301.921599199,902,20,272.8235294117647,32,2,17,32.325219432537246,0.6578776041666667,42.26641414141414,1030.9343434343432,32.216698232323225,0
1104,4,0,0,34,0.0,0.0,1.0,34,950,600,350,0.631578947368421,13,6,7,384.0531461095883,0.416165329768271,0.06049772093927541,0.23500600378795689,132983.40292125792,3414.5388544536136,136397.94177571154,903,21,273.8235294117647,32,2,17,32.23696290855675,0.6591796875,42.14015151515151,1031.439393939393,32.232481060606034,0
1105,4,0,0,34,0.0,0.0,1.0,34,1050,700,350,0.6666666666666666,14,7,7,385.81720100933074,0.4160167855020796,0.06305914021059289,0.23691089285118389,133113.667052469,3471.508487654301,136585.1755401233,904,22,274.8235294117647,32,2,17,32.06034096007178,0.6604817708333333,42.01388888888888,1031.9444444444434,32.24826388888886,0
1106,4,0,1,33,0.0,0.029411764705882353,0.9705882352941176,34,1000,900,100,0.9,11,9,2,389.6609320103844,0.41510695187165775,0.059729834707177076,0.240320294267038,133276.58689164367,3586.5358126721676,136863.12270431584,905,23,275.8235294117647,32,2,18,31.797199804353145,0.662109375,41.8560606060606,1032.5757575757573,32.267992424242415,0
1107,4,0,0,33,0.0,0.0,1.0,33,1000,700,300,0.7,13,7,6,396.3835552033193,0.414654356060606,0.06056018168054522,0.24354543089469058,133136.0626220703,3954.5891655815976,137090.6517876519,906,24,279.8787878787879,31,2,18,31.76518210110186,0.6633064516129032,41.9921875,1032.03125,33.29133064516129,0
1108,4,0,0,33,0.0,0.0,1.0,33,1050,800,250,0.7619047619047619,13,8,5,396.43280068483944,0.414101957070707,0.06818086273250867,0.2442358723100304,133236.86599731445,3963.8927883572055,137200.75878567167,907,25,280.8787878787879,31,2,19,31.662383865136412,0.6643145161290323,41.89453125,1032.421875,33.303931451612904,0
1109,4,0,0,33,0.0,0.0,1.0,33,850,600,250,0.7058823529411765,11,6,5,396.71295777090666,0.41358901515151514,0.07677378933052159,0.2450722103612795,133337.70751953113,3979.359266493041,137317.06678602417,908,26,281.8787878787879,31,2,19,31.5536224575559,0.6653225806451613,41.79687499999999,1032.812499999999,33.316532258064484,0
1110,4,0,0,33,0.0,0.0,1.0,33,1150,900,250,0.782608695652174,14,9,5,398.6906345894086,0.41268150252525254,0.07883218369732115,0.24674036621157308,133404.95639377163,4037.4613444010315,137442.41773817266,909,27,282.8787878787879,31,2,19,31.43485841525922,0.665994623655914,41.73177083333333,1033.072916666666,33.324932795698906,0
1111,4,0,0,33,0.0,0.0,1.0,33,1000,600,400,0.6,14,6,8,399.8968548531804,0.41181344696969696,0.05791544748259492,0.23245617175659056,131037.09323347097,3880.264290633592,134917.35752410456,910,28,283.8787878787879,32,1,19,33.798094709581925,0.6396484375,44.0340909090909,1023.8636363636355,31.99573863636361,8
1112,4,0,0,33,0.0,0.0,1.0,33,1150,900,250,0.782608695652174,14,9,5,402.08281371185683,0.410748106060606,0.05009802274127573,0.23491015358327705,131231.07854109275,3953.1522612488507,135184.2308023416,911,29,284.8787878787879,32,1,19,33.54513247073321,0.6416015625,43.84469696969697,1024.6212121212122,32.01941287878788,0
1113,4,0,1,32,0.0,0.030303030303030304,0.9696969696969697,33,650,500,150,0.7692307692307693,8,5,3,398.5722784057108,0.41023516414141414,0.04853412170485316,0.23344947735191632,131328.12500000003,3868.75,135196.87500000003,912,30,285.8787878787879,32,1,20,33.53658536585365,0.642578125,43.75,1025.0000000000002,32.03125000000001,0
1114,4,0,0,32,0.0,0.0,1.0,32,1000,800,200,0.8,12,8,4,402.038237885056,0.4086651545698925,0.0460791629620223,0.2356848136164591,131361.49300469286,4162.4686347113675,135523.96163940424,913,31,284.46875,31,1,21,33.413909352639834,0.645497311827957,43.717447916666664,1025.130208333333,33.06871639784945,0
1115,4,0,0,32,0.0,0.0,1.0,32,1100,800,300,0.7272727272727273,14,8,6,399.1554209598704,0.408224126344086,0.039756856272219476,0.2346080668268611,131461.62245008675,4094.723849826384,135556.34629991313,914,32,285.46875,31,1,21,33.38623666835957,0.646505376344086,43.619791666666664,1025.520833333333,33.081317204301065,0
1116,4,0,0,32,0.0,0.0,1.0,32,1000,700,300,0.7,13,7,6,397.6240383338286,0.40799311155913975,0.04188222038847278,0.2339122143357406,131495.00740898974,4057.1151733398347,135552.12258232958,915,33,286.46875,31,1,21,33.39165185561339,0.6468413978494624,43.58723958333333,1025.651041666666,33.08551747311826,0
1117,4,0,0,32,0.0,0.0,1.0,32,450,300,150,0.6666666666666666,6,3,3,397.73272540799087,0.4080141129032258,0.04349930185326212,0.23418074818865123,131528.39660644534,4062.629530164931,135591.02613661028,916,34,287.46875,31,1,21,33.355018194127105,0.6471774193548387,43.5546875,1025.7812500000002,33.089717741935495,0
1118,4,0,0,32,0.0,0.0,1.0,32,850,600,250,0.7058823529411765,11,6,5,395.7529871105016,0.40751008064516125,0.03956007358538449,0.23383246209932335,131661.99578179247,4021.1256239149257,135683.1214057074,917,35,288.46875,31,1,18,33.27042628774423,0.648521505376344,43.424479166666664,1026.302083333333,33.10651881720429,0
1119,4,0,0,32,0.0,0.0,1.0,32,1000,900,100,0.9,11,9,2,394.9380472741567,0.4074050739247312,0.03952310764549272,0.23437745514306055,131829.0901184082,4012.8646850585947,135841.9548034668,918,36,289.46875,31,1,18,33.12214720426017,0.6502016129032258,43.26171875,1026.953125,33.12752016129032,0
1120,4,0,1,31,0.0,0.03125,0.96875,32,1200,800,400,0.6666666666666666,16,8,8,393.2951791614038,0.40713205645161293,0.0363209939148077,0.23360785942960485,131862.52170138885,3972.17881944444,135834.70052083328,919,37,290.46875,31,1,18,33.13049357674104,0.6505376344086021,43.229166666666664,1027.083333333333,33.131720430107514,0
1121,4,0,0,31,0.0,0.0,1.0,31,600,400,200,0.6666666666666666,8,4,4,396.99432581343694,0.40542114695340503,0.01785171423745946,0.235484211895548,131810.75846918716,4265.624638686543,136076.3831078737,920,38,283.0967741935484,30,1,18,33.087914485165776,0.6527777777777778,43.27956989247311,1026.8817204301072,34.22939068100357,0
1122,4,0,0,31,0.0,0.0,1.0,31,450,200,250,0.4444444444444444,7,2,5,397.9048959609938,0.4055555555555555,0.015721637515778708,0.23623864102859,131845.26616155042,4292.375382992247,136137.64154454265,921,39,284.0967741935484,30,1,18,33.02959909261441,0.653125,43.24596774193548,1027.0161290322576,34.23387096774192,0
1123,4,0,0,31,0.0,0.0,1.0,31,1050,800,250,0.7619047619047619,13,8,5,392.8826639621771,0.4054659498207885,0.015055169940294322,0.23410662244667527,131983.34209518437,4170.793408197477,136154.13550338184,922,40,285.0967741935484,30,1,19,33.0188576411598,0.6545138888888888,43.111559139784944,1027.55376344086,34.251792114695334,0
1124,4,1,0,32,0.03125,0.0,1.0,32,900,600,300,0.6666666666666666,12,6,6,388.89600284285837,0.4090221774193548,-0.03956528465346576,0.22066570947825123,130101.52025303541,3719.1922380369338,133820.71249107234,923,0,277.15625,32,0,17,35.03068275577558,0.6302083333333333,44.94949494949495,1020.2020202020203,31.881313131313135,8
1125,4,1,0,33,0.030303030303030304,0.0,1.0,33,450,200,250,0.4444444444444444,7,2,5,378.20373488161357,0.41137941919191917,-0.03213517129064125,0.21653202843222036,130450.30757400989,3267.3587081891474,133717.66628219903,924,0,269.72727272727275,33,0,18,34.948816378758806,0.6313131313131313,44.607843137254896,1021.5686274509795,30.956625074272107,0
1126,4,0,0,33,0.0,0.0,1.0,33,900,700,200,0.7777777777777778,11,7,4,379.143288503976,0.4109059343434343,-0.032131316766077056,0.2172451956190823,130481.60750973182,3294.245152104963,133775.85266183678,925,1,270.72727272727275,33,0,18,34.893022070289085,0.6316287878787878,44.57720588235294,1021.6911764705881,30.96033868092691,0
1127,4,0,0,33,0.0,0.0,1.0,33,1100,800,300,0.7272727272727273,14,8,6,375.9156703414247,0.410116792929293,-0.035331734612310206,0.21591850486552897,130575.52984429065,3217.077566320645,133792.6074106113,926,2,271.72727272727275,33,0,17,34.88009592326139,0.6325757575757576,44.48529411764706,1022.0588235294117,30.971479500891263,0
1128,4,0,0,33,0.0,0.0,1.0,33,1150,900,250,0.782608695652174,14,9,5,374.92718443010295,0.4097616792929293,-0.03359012636251024,0.21587422358180444,130669.48596993928,3198.3084931276244,133867.7944630669,927,3,272.72727272727275,33,0,17,34.80999540532982,0.6335227272727273,44.39338235294117,1022.426470588234,30.982620320855574,0
1129,4,1,0,34,0.029411764705882353,0.0,1.0,34,1300,1000,300,0.7692307692307693,16,10,6,368.9044865265329,0.4109662804515746,-0.014471804755363138,0.21555742807426126,131236.6230867347,2882.7558106575993,134119.3788973923,928,0,265.6764705882353,34,0,18,34.38940203710158,0.6369485294117647,43.839285714285715,1024.6428571428573,30.136554621848745,0
1130,4,0,0,34,0.0,0.0,1.0,34,1200,800,400,0.6666666666666666,16,8,8,369.74477500678995,0.4103721033868093,-0.007533156136191321,0.21639243834353855,131297.6208191609,2909.3218537414828,134206.94267290237,929,1,266.6764705882353,34,0,18,34.306152476090915,0.6375612745098039,43.7797619047619,1024.8809523809516,30.143557422969167,0
1131,4,0,0,34,0.0,0.0,1.0,34,1000,700,300,0.7,13,7,6,371.63668510830166,0.40951797385620914,0.001792775626446863,0.21819405377217466,131419.6588010204,2968.0732709750555,134387.73207199547,930,2,267.6764705882353,34,0,18,34.13420604512558,0.6387867647058824,43.660714285714285,1025.357142857143,30.157563025210084,0
1132,4,0,0,34,0.0,0.0,1.0,34,1050,900,150,0.8571428571428571,12,9,3,369.4035367681988,0.4101307189542484,0.008363373204435254,0.21740306508161203,131511.2244897959,2916.1422902494287,134427.36678004533,931,3,268.6764705882353,34,0,19,34.09886645001547,0.6397058823529411,43.57142857142857,1025.7142857142853,30.168067226890745,0
1133,4,0,0,34,0.0,0.0,1.0,34,700,400,300,0.5714285714285714,10,4,6,368.68117591752275,0.4093694295900178,0.014209488458415187,0.21784786960829117,131663.90483276665,2908.40065192746,134572.3054846941,932,4,269.6764705882353,34,0,18,33.963093995282826,0.6412377450980392,43.42261904761906,1026.3095238095254,30.185574229691923,0
1134,4,0,0,34,0.0,0.0,1.0,34,1400,1100,300,0.7857142857142857,17,11,6,367.4690191136314,0.4088123885918003,0.020409207161125487,0.21782957318591564,131786.1128826531,2885.462726757374,134671.57560941047,933,5,270.6764705882353,34,0,18,33.870772946859894,0.6424632352941176,43.30357142857143,1026.7857142857147,30.199579831932784,0
1135,4,0,0,34,0.0,0.0,1.0,34,900,700,200,0.7777777777777778,11,7,4,366.4332735635942,0.4090352049910873,0.020638339934421435,0.21791541816542065,131908.37762188207,2867.123724489798,134775.50134637186,934,6,271.6764705882353,34,0,18,33.773950245296874,0.6436887254901961,43.18452380952381,1027.2619047619046,30.213585434173666,0
1136,4,0,2,32,0.0,0.058823529411764705,0.9411764705882353,34,950,600,350,0.631578947368421,13,6,7,368.16026426554424,0.40844102792632203,0.0275511664519823,0.2192954617581721,131969.53125000012,2917.187500000015,134886.71875000015,935,7,272.6764705882353,34,0,19,33.667883211678834,0.6443014705882353,43.12500000000001,1027.500000000001,30.220588235294144,0
1137,4,0,0,32,0.0,0.0,1.0,32,1050,700,350,0.6666666666666666,14,7,7,376.91838969691315,0.40601898521505375,0.014831745543945951,0.2239759751778224,131878.73247946642,3541.503896286099,135420.23637575252,936,8,265.96875,32,0,19,33.53462405244827,0.6481119791666667,43.21338383838384,1027.146464646465,32.09832702020203,0
1138,4,0,0,32,0.0,0.0,1.0,32,750,400,350,0.5333333333333333,11,4,7,381.04856378611726,0.40549395161290325,0.01951492995822046,0.22701121611211,131976.01807213548,3657.8544281195723,135633.87250025506,937,9,266.96875,32,0,19,33.33026132546899,0.6490885416666667,43.118686868686865,1027.5252525252522,32.11016414141413,0
1139,4,0,0,32,0.0,0.0,1.0,32,950,700,250,0.7368421052631579,12,7,5,380.75944290293097,0.4050949260752688,0.015584684850718844,0.22703304804300015,132008.45457415044,3652.6931244260622,135661.1476985765,938,10,267.96875,32,0,20,33.30492075193514,0.6494140625,43.087121212121204,1027.6515151515139,32.11410984848481,0
1140,4,0,0,32,0.0,0.0,1.0,32,1200,1100,100,0.9166666666666666,13,11,2,379.5027720018314,0.4050739247311828,0.018238761974944673,0.22686575401166728,132105.78799357195,3626.9025482093525,135732.6905417813,939,11,268.96875,32,0,20,33.23891549987717,0.650390625,42.992424242424235,1028.030303030302,32.12594696969694,0
1141,4,1,0,33,0.030303030303030304,0.0,1.0,33,650,500,150,0.7692307692307693,8,5,3,372.2401612876787,0.4080255681818182,0.015212857318120498,0.22425199960501635,132398.0034722223,3257.0936639118518,135655.09713613417,940,0,261.7878787878788,32,1,21,33.130904183535755,0.6533203125,42.708333333333336,1029.1666666666672,32.16145833333335,0
1142,4,0,1,32,0.0,0.030303030303030304,0.9696969696969697,33,1550,1300,250,0.8387096774193549,18,13,5,393.9282698672787,0.40818339646464646,-0.05861420706324705,0.23190385973925876,131522.3255280073,3762.07242883378,135284.39795684107,941,1,262.7878787878788,32,1,21,33.45873338257015,0.64453125,43.560606060606055,1025.7575757575753,32.05492424242423,8
1143,4,1,0,33,0.030303030303030304,0.0,1.0,33,900,700,200,0.7777777777777778,11,7,4,389.9152067189139,0.4088541666666667,-0.046410247811944916,0.23130418499233593,131813.89534550047,3679.2484504132176,135493.1437959137,942,0,263.72727272727275,32,1,19,33.26647608508546,0.6474609375,43.27651515151515,1026.8939393939393,32.0904356060606,0
1144,4,0,0,33,0.0,0.0,1.0,33,750,600,150,0.8,9,6,3,390.8092298187452,0.4079861111111111,-0.042594082417091284,0.2324286472079904,131911.15702479324,3710.419536271791,135621.57656106504,943,1,264.72727272727275,32,1,19,33.14512659783677,0.6484375,43.18181818181817,1027.2727272727261,32.10227272727269,0
1145,4,0,1,32,0.0,0.030303030303030304,0.9696969696969697,33,1150,900,250,0.782608695652174,14,9,5,390.0096024374238,0.4075126262626263,-0.037632187245256965,0.23294704133844946,132073.33953486884,3701.9741289154117,135775.31366378424,944,2,265.72727272727275,32,1,20,33.00167874544486,0.6500651041666667,43.023989898989896,1027.90404040404,32.12200126262625,0
1146,4,0,0,32,0.0,0.0,1.0,32,950,800,150,0.8421052631578947,11,8,3,394.3357260690004,0.40519993279569894,-0.025447276757441184,0.23567604521686272,132096.66146172408,4018.0865817599724,136114.74804348405,945,3,272.875,31,1,20,32.8669252691577,0.6528897849462365,43.00130208333333,1027.9947916666658,33.16112231182793,0
1147,4,0,0,32,0.0,0.0,1.0,32,750,400,350,0.5333333333333333,11,4,7,395.3720906357273,0.40473790322580644,-0.021643137503164933,0.23692327555697826,132197.0706515841,4053.406439887144,136250.47709147126,946,4,273.875,31,1,20,32.7387735291635,0.6538978494623655,42.90364583333333,1028.3854166666658,33.17372311827954,0
1148,4,0,0,32,0.0,0.0,1.0,32,950,900,50,0.9473684210526315,10,9,1,396.9677537657868,0.40408686155913975,-0.025435862549044508,0.23851271654018863,132297.5179884168,4103.569708930112,136401.08769734693,947,5,274.875,31,1,20,32.59621672362148,0.6549059139784946,42.80598958333333,1028.776041666666,33.18632392473116,0
1149,4,0,0,32,0.0,0.0,1.0,32,900,700,200,0.7777777777777778,11,7,4,394.5979061390504,0.40467489919354843,-0.030833768607991585,0.23793943033172044,132432.58794369298,4051.5625284040466,136484.15047209704,948,6,275.875,30,2,21,32.52072995560199,0.6590277777777778,42.6747311827957,1029.3010752688178,34.31003584229393,0
1150,4,0,0,32,0.0,0.0,1.0,32,1100,700,400,0.6363636363636364,15,7,8,392.4376991800826,0.40423387096774194,-0.0341380041770003,0.2372900720930241,132536.36845661356,4002.453498959427,136538.821955573,949,7,276.875,30,2,22,32.47155506243746,0.6600694444444444,42.5739247311828,1029.7043010752693,34.32347670250898,0
1151,4,0,1,31,0.0,0.03125,0.96875,32,1000,900,100,0.9,11,9,2,389.71741821028627,0.40423387096774194,-0.045775691699604826,0.22107288521794266,130091.13228407913,3743.04850994335,133834.18079402248,950,8,277.875,30,2,20,35.02031181379006,0.6354166666666667,44.95967741935484,1020.161290322581,34.00537634408603,8
1152,4,1,0,32,0.03125,0.0,1.0,32,750,500,250,0.6666666666666666,10,5,5,385.51187451300075,0.4080351142473118,-0.03530587731999468,0.22004009847297273,130331.20022907274,3648.845061567815,133980.04529064056,951,0,274.84375,30,2,21,34.88328726251591,0.6378472222222222,44.7244623655914,1021.1021505376345,34.036738351254485,0
1153,4,1,0,33,0.030303030303030304,0.0,1.0,33,1200,800,400,0.6666666666666666,16,8,8,376.21595389087406,0.4090909090909091,-0.025433865006057488,0.21694567561372446,130728.22570800791,3236.408827039944,133964.63453504787,952,0,267.4848484848485,31,2,20,34.717447585094654,0.6391129032258065,44.33593750000001,1022.6562500000008,32.988911290322605,0
1154,4,0,1,32,0.0,0.030303030303030304,0.9696969696969697,33,1050,800,250,0.7619047619047619,13,8,5,376.90897355432907,0.40873579545454547,-0.021480238412129316,0.21753269561126054,130761.51741875551,3257.037862141936,134018.55528089745,953,1,268.4848484848485,31,2,20,34.66595056227456,0.6394489247311828,44.30338541666667,1022.786458333334,32.993111559139805,0
1155,4,0,0,32,0.0,0.0,1.0,32,1000,700,300,0.7,13,7,6,388.60072617728747,0.40505292338709675,-0.008415199106321714,0.22417459632168157,130743.26014929471,3761.385167360387,134504.6453166551,954,2,277.53125,30,2,21,34.38554124501686,0.6420138888888889,44.321236559139784,1022.7150537634408,34.090501792114694,0
1156,4,0,0,32,0.0,0.0,1.0,32,750,500,250,0.6666666666666666,10,5,5,386.4703151039905,0.40517893145161293,-0.0025415517014848454,0.22334286774916237,130812.00003251806,3710.9909743900826,134522.99100690815,955,3,278.53125,30,2,21,34.37020978408444,0.6427083333333333,44.254032258064505,1022.9838709677407,34.09946236559136,0
1157,4,0,0,32,0.0,0.0,1.0,32,850,500,350,0.5882352941176471,12,5,7,389.7068758355684,0.40322580645161293,0.0008002298095863836,0.22601811572641675,130949.53399598214,3806.38675713955,134755.9207531217,956,4,279.53125,30,2,21,34.147789450645654,0.6440972222222222,44.119623655913976,1023.5215053763437,34.11738351254479,0
1158,4,0,1,31,0.0,0.03125,0.96875,32,900,600,300,0.6666666666666666,12,6,6,390.4281601399162,0.40288978494623656,0.002596987002756901,0.22684144132614356,131018.32807622272,3830.6489550815154,134848.97703130424,957,5,280.53125,30,2,21,34.05950505448339,0.6447916666666667,44.05241935483871,1023.7903225806455,34.12634408602152,0
1159,4,0,0,31,0.0,0.0,1.0,31,950,600,350,0.631578947368421,13,6,7,394.57051136324503,0.4029569892473119,0.009965286597239942,0.22986447221620238,131121.55306971906,4147.339649092384,135268.89271881143,958,6,286.83870967741933,30,1,21,33.84869860017498,0.6458333333333333,43.95161290322581,1024.1935483870968,34.13978494623656,0
1160,4,1,0,32,0.03125,0.0,1.0,32,750,700,50,0.9333333333333333,8,7,1,389.516215085216,0.40778309811827956,0.055043479656013306,0.21296286538448553,128639.39285278332,3621.425882975276,132260.8187357586,959,0,278.84375,31,1,19,36.50807020921577,0.6179435483870968,46.38671875000001,1014.4531250000009,32.72429435483874,8
1161,4,1,0,33,0.030303030303030304,0.0,1.0,33,750,500,250,0.6666666666666666,10,5,5,381.7749830911502,0.4135495580808081,0.061969602802418366,0.21051266202661445,128976.8442792828,3248.0265087746275,132224.87078805742,960,0,271.3636363636364,32,1,20,36.35928112699399,0.6188151041666667,46.054292929292934,1015.7828282828289,31.743213383838402,0
1162,4,0,1,32,0.0,0.030303030303030304,0.9696969696969697,33,800,400,400,0.5,12,4,8,396.2434418384164,0.41327335858585856,0.018564928681610526,0.21808769251219523,128903.70898776565,3660.2316454811366,132563.9406332468,961,1,272.3636363636364,31,2,18,36.0667232978587,0.6206317204301075,46.12630208333332,1015.4947916666652,32.757896505376294,8
1163,4,0,0,32,0.0,0.0,1.0,32,1050,800,250,0.7619047619047619,13,8,5,408.0207532597792,0.40746807795698925,0.03328561498742211,0.2241295090451716,128825.87808200352,4112.726362874293,132938.6044448778,962,3,281.84375,30,2,18,35.84751092281213,0.6225694444444445,46.2029569892473,1015.1881720430092,33.83960573476698,0
1164,4,0,0,32,0.0,0.0,1.0,32,650,500,150,0.7692307692307693,8,5,3,380.372697430127,0.4068800403225807,-0.025757259411537614,0.20659041898804442,128375.34798516161,3366.641965917469,131741.98995107907,963,4,282.84375,31,1,19,37.010284166345464,0.615255376344086,46.647135416666664,1013.4114583333328,32.69069220430106,8
1165,4,0,0,32,0.0,0.0,1.0,32,1050,600,450,0.5714285714285714,15,6,9,378.25008899663345,0.40620799731182794,-0.027749678869621208,0.20577756413967804,128441.33377075198,3316.5891859266503,131757.92295667864,964,5,283.84375,31,1,20,36.99649432669663,0.6159274193548387,46.58203125,1013.6718750000002,32.699092741935495,0
1166,4,0,0,32,0.0,0.0,1.0,32,750,400,350,0.5333333333333333,11,4,7,375.0728366859053,0.40603998655913975,-0.030254751508925315,0.20438713640819792,128507.33651055238,3239.9222479926293,131747.258758545,965,6,284.84375,31,1,20,37.00946556226188,0.6165994623655914,46.516927083333336,1013.9322916666674,32.70749327956992,0
1167,4,0,0,32,0.0,0.0,1.0,32,650,400,250,0.6153846153846154,9,4,5,376.9188637382477,0.40549395161290325,-0.03198822056746664,0.20573377923316113,128573.35620456266,3292.344665527339,131865.70087009,966,7,285.84375,31,1,20,36.89511383575128,0.617271505376344,46.451822916666664,1014.1927083333328,32.71589381720428,0
1168,4,1,0,33,0.030303030303030304,0.0,1.0,33,500,400,100,0.8,6,4,2,365.9011477983198,0.41062973484848486,-0.02357781470053011,0.20143346555385955,128912.7245466024,2833.862775482094,131746.5873220845,967,0,278.1515151515151,32,1,21,36.827831654855146,0.6181640625,46.11742424242424,1015.5303030303032,31.735321969696976,0
1169,4,0,1,32,0.0,0.030303030303030304,0.9696969696969697,33,1050,1000,50,0.9523809523809523,11,10,1,363.9305415344805,0.4099984217171717,-0.019697534419859997,0.20132487483237335,129105.1315713958,2797.060089531682,131902.1916609275,968,1,279.1515151515151,32,1,21,36.68157535097528,0.6201171875,45.928030303030305,1016.287878787879,31.758996212121218,0
1170,4,0,0,32,0.0,0.0,1.0,32,800,300,500,0.375,13,3,10,374.02380462472945,0.40809811827956993,-0.027559401818880502,0.2072394494467895,129168.29639010967,3262.403530544715,132430.69992065438,969,2,276.71875,31,1,22,36.360664574527135,0.6233198924731183,45.86588541666667,1016.5364583333339,32.791498655914,0
1171,4,1,0,33,0.030303030303030304,0.0,1.0,33,1050,700,350,0.6666666666666666,14,7,7,364.89865164816706,0.4105508207070707,-0.020635367938529603,0.20451060636153368,129618.91842987962,2859.5537126313643,132478.472142511,970,0,269.3030303030303,32,1,20,36.13349865674728,0.6253255208333333,45.4229797979798,1018.308080808081,31.82212752525253,0
1172,4,1,0,34,0.029411764705882353,0.0,1.0,34,1150,600,550,0.5217391304347826,17,6,11,353.49204215581193,0.41499554367201424,-0.018122114847621607,0.19995970651111578,129981.25908604868,2389.468143262212,132370.7272293109,971,0,262.3529411764706,33,1,22,36.0557374914874,0.6265782828282829,45.067401960784316,1019.7303921568631,30.900920974450397,0
1173,4,1,0,35,0.02857142857142857,0.0,1.0,35,900,700,200,0.7777777777777778,11,7,4,343.438528991006,0.4183823529411765,-0.01725079957356046,0.1958330335523182,130292.97052154187,1949.5252267573617,132242.49574829923,972,0,255.82857142857142,34,1,23,35.99604516480101,0.6274509803921569,44.76190476190476,1020.9523809523803,30.02801120448177,0
1174,4,0,2,33,0.0,0.05714285714285714,0.9428571428571428,35,500,200,300,0.4,8,2,6,358.84504458802417,0.4183823529411765,-0.08777640879320392,0.20322252782195827,130026.38996056246,2331.865140603575,132358.25510116603,973,1,256.8285714285714,35,0,20,35.87343017097898,0.6226190476190476,45.02314814814815,1019.9074074074078,29.140211640211653,7
1175,4,0,0,33,0.0,0.0,1.0,33,1050,600,450,0.5714285714285714,15,6,9,386.28415804543675,0.41208964646464646,-0.028055959316188206,0.196557019049001,125727.06428234368,3134.708104473475,128861.77238681716,974,3,272.72727272727275,32,1,18,39.588841327793865,0.5856119791666667,49.2739898989899,1002.9040404040408,31.340751262626274,8
1176,4,5,2,36,0.13157894736842105,0.05263157894736842,0.9473684210526316,38,1000,900,100,0.9,11,9,2,348.31839067944037,0.43181009957325744,0.02061544407139948,0.18377379498559326,127208.74592764054,1269.5969940708949,128478.34292171143,975,0,237.71052631578948,35,3,20,39.01636836469327,0.594047619047619,47.800925925925924,1008.7962962962958,28.82275132275131,0
1177,4,1,1,36,0.02702702702702703,0.02702702702702703,0.972972972972973,37,750,700,50,0.9333333333333333,8,7,1,350.2779707893714,0.43190065065065064,0.03365545562077332,0.18523433302442313,127302.17013888896,1518.2291666666708,128820.39930555563,976,0,244.8918918918919,34,3,21,38.871112028626484,0.5971200980392157,47.708333333333336,1009.1666666666673,29.681372549019628,0
1178,4,4,1,39,0.1,0.025,0.975,40,500,300,200,0.6,7,3,4,331.9471402561272,0.4368723290598291,0.07268323048608849,0.17962482334773586,128227.80957842815,512.9709381733038,128740.78051660144,977,0,227.3,37,3,20,38.387621341705476,0.6005067567567568,46.79276315789475,1012.8289473684224,27.373755334281686,0
1179,4,0,0,39,0.0,0.0,1.0,39,1050,600,450,0.5714285714285714,15,6,9,341.58047400364575,0.43378879892037786,0.06107205373382851,0.1848480615637061,128230.06071950353,960.1769844168778,129190.2377039204,978,1,234.07692307692307,36,3,21,38.14139982210362,0.6024305555555556,46.790540540540555,1012.8378378378397,28.134384384384436,0
1180,4,0,0,39,0.0,0.0,1.0,39,1000,600,400,0.6,14,6,8,340.48090005277453,0.4339293747188484,0.05672546119361699,0.18464777925104367,128315.61872260788,937.8034707004447,129253.42219330832,979,2,235.07692307692307,36,3,21,38.08190693194027,0.6032986111111112,46.70608108108109,1013.1756756756768,28.143768768768798,0
1181,4,2,2,39,0.04878048780487805,0.04878048780487805,0.9512195121951219,41,700,500,200,0.7142857142857143,9,5,4,324.5932992864371,0.43704268292682924,0.06746521637582958,0.1784042870514179,128848.62075617304,164.67978395063565,129013.30054012367,980,0,224.5609756097561,38,3,18,37.941746466028256,0.6049890350877193,46.180555555555564,1015.2777777777794,26.717836257309983,0
1182,4,1,0,40,0.025,0.0,1.0,40,1250,900,350,0.72,16,9,7,332.90666800459053,0.4345352564102564,0.07996652990714725,0.18331638282155274,128922.84765504772,583.8551285010765,129506.7027835488,981,0,231.0,37,3,19,37.65520405959836,0.607545045045045,46.10745614035088,1015.5701754385966,27.44784257942153,0
1183,4,0,1,39,0.0,0.025,0.975,40,750,500,250,0.6666666666666666,10,5,5,332.6667354250586,0.43444177350427354,0.08407325493580697,0.18408883406894744,129117.79495854497,590.6390668282538,129708.43402537322,982,1,232.0,37,3,19,37.46302639623116,0.6095157657657657,45.915570175438596,1016.3377192982459,27.4685870080607,0
1184,4,0,1,38,0.0,0.02564102564102564,0.9743589743589743,39,1000,600,400,0.6,14,6,8,342.79220217915093,0.4307242465137202,0.07719023014966298,0.18926996622156056,129029.71172185699,1046.0758055352708,130075.78752739227,983,2,238.7948717948718,36,3,19,37.29540752235278,0.6105324074074074,46.002252252252255,1015.990990990991,28.22197197197197,0
1185,4,2,0,40,0.05,0.0,1.0,40,1200,900,300,0.75,15,9,6,337.7359314751814,0.4334001068376068,0.08094891690914996,0.18821932181130357,129396.54659366321,740.3726386964977,130136.91923235971,984,0,233.575,37,3,22,37.05084509825054,0.6123310810810811,45.64144736842104,1017.434210526314,27.498221906116594,0
1186,4,0,3,37,0.0,0.075,0.925,40,1550,1200,350,0.7741935483870968,19,12,7,340.09022764074035,0.43309294871794873,0.0823567427832832,0.19020467912148364,129536.03512619242,810.7879347491253,130346.82306094155,985,1,234.575,37,3,17,36.84923883383598,0.6137387387387387,45.50438596491227,1017.9824561403489,27.513039355144564,0
1187,4,1,0,38,0.02631578947368421,0.0,1.0,38,1100,700,400,0.6363636363636364,15,7,8,349.8751538531334,0.42733522996680895,0.08876191141865308,0.19515258581585865,129430.46932067192,1456.9010733706614,130887.37039404259,986,0,244.68421052631578,36,2,18,36.7075678766416,0.6145833333333333,45.608108108108105,1017.5675675675667,28.265765765765742,0
1188,4,0,0,38,0.0,0.0,1.0,38,900,600,300,0.6666666666666666,12,6,6,349.06683178009223,0.4277797534376482,0.0918316255239866,0.19527005936213082,129545.08562616675,1443.9785224413622,130989.06414860811,987,1,245.68421052631578,36,2,19,36.61158738938053,0.6157407407407407,45.4954954954955,1018.0180180180184,28.27827827827829,0
1189,4,0,0,38,0.0,0.0,1.0,38,850,400,450,0.47058823529411764,13,4,9,348.85324009520576,0.42780938833570414,0.09178959006138854,0.19586452865680562,129688.42734203808,1448.4456162243387,131136.87295826242,988,2,246.68421052631578,36,2,19,36.47134696885941,0.6171875,45.35472972972973,1018.5810810810818,28.29391891891894,0
1190,4,1,0,39,0.02564102564102564,0.0,1.0,39,850,500,350,0.5882352941176471,12,5,7,341.7129188776801,0.42976833108412055,0.09306660930666055,0.1930283547827867,129927.00277970135,1079.5470721760378,131006.54985187738,989,0,241.33333333333334,37,2,20,36.411056141105604,0.6176801801801801,45.12061403508771,1019.5175438596484,27.55452821242293,0
1191,4,0,0,39,0.0,0.0,1.0,39,1500,1200,300,0.8,18,12,6,339.82620988172,0.4292341430499325,0.09748607125233266,0.19237514169871442,130010.85820877574,1036.2194377115925,131047.07764648733,990,1,242.33333333333334,37,2,20,36.37411299860229,0.6185247747747749,45.03837719298245,1019.8464912280699,27.563418681839728,0
1192,4,0,2,37,0.0,0.05128205128205128,0.9487179487179487,39,1000,700,300,0.7,13,7,6,343.1764268287031,0.4281376518218623,0.10882419393057696,0.19496946447301056,130150.67737188369,1132.9288819636822,131283.60625384736,991,2,243.33333333333334,37,2,21,36.14693029586645,0.6199324324324325,44.901315789473685,1020.3947368421057,27.57823613086772,0
1193,4,0,0,37,0.0,0.0,1.0,37,800,700,100,0.875,9,7,2,349.83245106485225,0.4266766766766767,0.10778913275508839,0.19811848064161158,130026.38996056236,1697.49014060356,131723.8801011659,992,3,253.16216216216216,35,2,21,36.103230443334844,0.6226190476190476,45.023148148148145,1019.9074074074069,29.14021164021163,0
1194,4,0,0,37,0.0,0.0,1.0,37,1150,900,250,0.782608695652174,14,9,5,351.670449043317,0.42689564564564564,0.10850051503409053,0.19976331693079116,130144.46159122068,1753.592249657044,131898.05384087772,993,4,254.16216216216216,35,2,21,35.936554748941326,0.6238095238095238,44.9074074074074,1020.370370370369,29.153439153439113,0
1195,4,2,1,38,0.05128205128205128,0.02564102564102564,0.9743589743589743,39,1000,700,300,0.7,13,7,6,336.33071001361367,0.43187696806117853,0.12074322132224746,0.19385786165555996,130710.70545744844,992.4048745767907,131703.11033202522,994,0,242.07692307692307,37,2,21,35.754878833369084,0.6255630630630631,44.353070175438596,1022.5877192982456,27.63750592697961,0
1196,4,0,0,38,0.0,0.0,1.0,38,1050,800,250,0.7619047619047619,13,8,5,346.94988146229673,0.4294541251778094,0.12775203956790682,0.19944674313066954,130607.69120049124,1462.8645960149556,132070.5557965062,995,1,249.44736842105263,36,2,21,35.58765744923064,0.6264467592592593,44.45382882882884,1022.1846846846864,28.39401901901907,0
1197,4,1,0,39,0.02564102564102564,0.0,1.0,39,1050,700,350,0.6666666666666666,14,7,7,342.7486362012132,0.4319050832208727,0.13555075736348532,0.19870905405603237,130935.05333371805,1175.5621922129892,132110.61552593103,996,0,244.02564102564102,37,2,22,35.363991857724464,0.6278153153153153,44.13377192982456,1023.4649122807016,27.661213845424367,0
1198,4,0,0,39,0.0,0.0,1.0,39,850,500,350,0.5882352941176471,12,5,7,341.8962761791127,0.43201754385964913,0.13491403102627286,0.19864875735434817,131019.23338190601,1158.9976002231524,132178.23098212917,997,1,245.02564102564102,37,2,22,35.30075238299239,0.6286599099099099,44.0515350877193,1023.7938596491231,27.670104314841165,0
1199,4,0,0,39,0.0,0.0,1.0,39,1000,800,200,0.8,12,8,4,341.95764114650444,0.4312303193882141,0.13386042936364162,0.19911997308655557,131103.44048168664,1166.3646506617397,132269.80513234838,998,2,246.02564102564102,37,2,22,35.21413276231262,0.6295045045045045,43.969298245614034,1024.1228070175437,27.678994784257938,0
1200,4,2,2,39,0.04878048780487805,0.04878048780487805,0.9512195121951219,41,1200,1100,100,0.9166666666666666,13,11,2,325.6146996562063,0.4353404471544715,0.12753722920364807,0.1919834117632719,131581.12502164132,369.3344346337366,131950.45945627504,999,0,234.97560975609755,37,4,16,35.151379537601066,0.6342905405405406,43.50328947368421,1025.9868421052636,27.72937411095307,0
1201,4,1,0,40,0.025,0.0,1.0,40,1050,800,250,0.7619047619047619,13,8,5,332.90297078955257,0.43134348290598296,0.13242916758181456,0.19557512593610732,131443.57829112888,751.5915408651834,132195.16983199408,1000,0,241.825,36,4,23,35.10299985357641,0.634837962962963,43.637387387387385,1025.4504504504498,28.484734734734715,0
1202,4,0,0,40,0.0,0.0,1.0,40,750,400,350,0.5333333333333333,11,4,7,331.5768770171014,0.4315037393162393,0.1275087834870443,0.19509058112866678,131501.32395909436,720.5596643941369,132221.88362348848,1001,1,242.825,36,4,23,35.07882264675742,0.6354166666666667,43.58108108108109,1025.6756756756768,28.490990990991023,0
1203,4,0,1,39,0.0,0.025,0.975,40,950,700,250,0.7368421052631579,12,7,5,330.0404081872137,0.4316639957264958,0.12517101325352709,0.1944494999370008,131553.00188519547,683.5612880886438,132236.5631732841,1002,2,243.825,37,3,23,35.06617856633889,0.634009009009009,43.530701754385966,1025.8771929824563,27.72641062114747,0
1204,4,0,0,39,0.0,0.0,1.0,39,1050,700,350,0.6666666666666666,14,7,7,328.9416623175647,0.4323549257759784,0.125309245728094,0.19423123139622,131637.3803117305,860.2037405740155,132497.5840523045,1003,3,245.84615384615384,37,2,18,35.009416070092946,0.6348536036036037,43.4484649122807,1026.206140350877,27.735301090564242,0
1205,4,0,1,38,0.0,0.02564102564102564,0.9743589743589743,39,1250,1000,250,0.8,15,10,5,355.1612944518341,0.43218623481781376,0.0699471689762956,0.19667534047601554,129145.65659626026,1405.3955303554808,130551.05212661574,1004,4,246.84615384615384,37,2,20,36.86308881697232,0.6097972972972974,45.888157894736835,1016.4473684210516,27.471550497866257,8
1206,4,1,2,37,0.02564102564102564,0.05128205128205128,0.9487179487179487,39,850,700,150,0.8235294117647058,10,7,3,347.6814475232261,0.4301900584795322,0.07736637036000116,0.19396036082640877,129436.8355624142,1200.5813160934526,130637.41687850765,1005,0,247.6153846153846,35,4,16,36.75690021231423,0.6166666666666667,45.60185185185185,1017.592592592592,29.07407407407406,0
1207,4,0,0,37,0.0,0.0,1.0,37,1200,800,400,0.6666666666666666,16,8,8,361.96883349676347,0.4271146146146146,0.08592151299654449,0.20057869177300147,129171.97312510716,1951.2456865140625,131123.21881162122,1006,6,261.56756756756755,35,2,21,36.66327469733197,0.6139880952380952,45.86226851851852,1016.550925925926,29.04431216931217,0
1208,4,0,0,37,0.0,0.0,1.0,37,1250,900,350,0.72,16,9,7,362.80569739317366,0.4273023023023023,0.08351794417368197,0.2011922503725784,129201.38888888905,1975.0033489797863,131176.39223786883,1007,7,262.56756756756755,34,3,21,36.612021857923494,0.616421568627451,45.83333333333334,1016.666666666668,29.901960784313765,0
1209,4,1,1,37,0.02631578947368421,0.02631578947368421,0.9736842105263158,38,650,500,150,0.7692307692307693,8,5,3,362.35857728115883,0.42983937885253676,0.02834318095864008,0.19334141813574843,127662.84190759633,1669.3062641723334,129332.14817176867,1008,0,256.63157894736844,34,4,19,38.196244159107856,0.600796568627451,47.351190476190474,1010.5952380952378,29.723389355742288,8
1210,4,1,0,38,0.02631578947368421,0.0,1.0,38,900,600,300,0.6666666666666666,12,6,6,358.55065974643725,0.4329954954954955,0.05610804433020067,0.19291128727157558,127998.08873724719,1578.7598326046057,129576.84856985179,1009,0,257.39473684210526,35,3,20,37.949049715963255,0.6020833333333333,47.01967592592593,1011.9212962962971,28.91203703703706,0
1211,4,2,0,40,0.05,0.0,1.0,40,1150,900,250,0.782608695652174,14,9,5,342.15467640999407,0.4371527777777778,0.07611808328579572,0.18708582275318775,128643.06205257637,803.332502786358,129446.39455536273,1010,0,245.475,35,5,18,37.70548108005324,0.6086309523809523,46.383101851851855,1014.4675925925931,28.98478835978837,0
1212,4,0,0,40,0.0,0.0,1.0,40,950,600,350,0.631578947368421,13,6,7,339.4244800319948,0.4370192307692307,0.07531073132837651,0.18593033371235895,128715.26668137734,737.8224931012126,129453.08917447855,1011,1,246.475,36,4,19,37.70114304738652,0.607349537037037,46.31193693693694,1014.7522522522524,28.18756256256257,0
1213,4,2,0,42,0.047619047619047616,0.0,1.0,42,1150,900,250,0.782608695652174,14,9,5,325.9625537613638,0.4407786488579171,0.08974845752254379,0.18102348465345128,129258.63997443399,28.52776763250654,129287.1677420665,1012,0,235.6904761904762,36,6,21,37.49031007751936,0.6128472222222222,45.77702702702703,1016.8918918918927,28.24699699699702,0
1214,4,0,1,41,0.0,0.023809523809523808,0.9761904761904762,42,1000,600,400,0.6,14,6,8,326.5597271424015,0.4405487804878048,0.08932063913797528,0.18175070950568809,129344.54038075249,47.74356281958518,129392.28394357207,1013,1,236.6904761904762,36,6,21,37.38791099302556,0.6137152777777778,45.69256756756757,1017.2297297297307,28.25638138138141,0
1215,4,0,0,41,0.0,0.0,1.0,41,1400,1100,300,0.7857142857142857,17,11,6,331.2507606799464,0.43953252032520324,0.09731685123948597,0.18479420608490413,129436.83556241432,375.2100480109797,129812.0456104253,1014,2,242.65853658536585,35,6,19,37.17489384288747,0.6166666666666667,45.601851851851855,1017.592592592593,29.074074074074083,0
1216,4,0,0,41,0.0,0.0,1.0,41,700,300,400,0.42857142857142855,11,3,8,330.74166339041994,0.439354674796748,0.09970212506309717,0.18478667013058173,129495.73072059342,365.9266760974065,129861.65739669083,1015,3,243.65853658536585,35,6,19,37.12806079902963,0.6172619047619048,45.54398148148149,1017.8240740740753,29.080687830687864,0
1217,4,1,0,42,0.023809523809523808,0.0,1.0,42,1150,900,250,0.782608695652174,14,9,5,323.3354293214493,0.44069396051103366,0.10955011838989748,0.182203339686122,129831.8483179127,-4.1527169060699975,129827.69560100664,1016,0,238.83333333333334,36,6,20,36.97582872928178,0.6186342592592593,45.21396396396398,1019.1441441441458,28.309559559559606,0
1218,4,0,0,42,0.0,0.0,1.0,42,1250,900,350,0.72,16,9,7,324.0374165189745,0.4396414053426248,0.11085339812973949,0.18313575338094917,129946.64216581495,21.514842545297228,129968.15700836024,1017,1,239.83333333333334,36,6,21,36.841681393122734,0.6197916666666667,45.101351351351376,1019.5945945945986,28.32207207207218,0
1219,4,0,0,42,0.0,0.0,1.0,42,900,700,200,0.7777777777777778,11,7,4,324.1022083477856,0.4392058652729385,0.11321044546850989,0.18334249012374776,129982.9033933521,25.54920744847786,130008.45260080058,1018,2,240.83333333333334,37,5,21,36.803315412186365,0.6182432432432432,45.06578947368423,1019.7368421052655,27.560455192034205,0
1220,4,0,0,42,0.0,0.0,1.0,42,900,400,500,0.4444444444444444,14,4,10,320.17136728134324,0.438951800232288,0.10883585940019369,0.18150848444962472,130066.77685682155,-71.26844317479856,129995.50841364675,1019,3,241.83333333333334,37,5,21,36.818656168261136,0.6190878378378378,44.98355263157896,1020.065789473686,27.569345661450974,0
1221,4,0,0,42,0.0,0.0,1.0,42,1550,1100,450,0.7096774193548387,20,11,9,316.70137442732187,0.4386251451800232,0.11146744412050547,0.18044613194114875,130262.58680555577,-149.13194444442055,130113.45486111134,1020,4,242.83333333333334,38,4,21,36.70918367346939,0.6192434210526316,44.79166666666668,1020.8333333333351,26.864035087719344,0
1222,4,1,1,42,0.023255813953488372,0.023255813953488372,0.9767441860465116,43,1050,900,150,0.8571428571428571,12,9,3,309.8014359275621,0.439484126984127,0.1113206229485304,0.17830793756719687,130654.64854570644,-504.60045398583287,130150.04809172062,1021,0,238.1627906976744,37,6,18,36.489614614614624,0.625,44.40789473684211,1022.3684210526321,27.631578947368435,0
1223,4,0,1,41,0.0,0.023809523809523808,0.9761904761904762,42,800,400,400,0.5,12,4,8,311.734457870658,0.4393994386372435,0.08184658154564906,0.16898753727637794,128298.92223750749,-400.9610061801768,127897.96123132731,1022,1,242.5,40,2,19,38.82703046109608,0.59609375,46.72256097560976,1013.1097560975613,25.327743902439032,8
1224,4,1,2,40,0.023809523809523808,0.047619047619047616,0.9523809523809523,42,950,700,250,0.7368421052631579,12,7,5,308.3489174062976,0.4392663569492838,0.0889246926840912,0.16780035194368909,128453.40617563965,-478.30625371801113,127975.09992192165,1023,0,243.33333333333334,40,2,13,38.755639097744364,0.59765625,46.57012195121952,1013.7195121951231,25.342987804878078,0
1225,4,0,1,39,0.0,0.025,0.975,40,1350,1000,350,0.7407407407407407,17,10,7,322.98109277359384,0.4355101495726496,0.09294303797468384,0.17476374198023234,128225.67389875083,282.89365548981095,128508.56755424064,1024,12,256.45,38,2,20,38.616824894514785,0.5986842105263157,46.794871794871796,1012.8205128205129,26.653171390013497,0
1226,4,1,0,40,0.025,0.0,1.0,40,1250,900,350,0.72,16,9,7,320.4322679062443,0.4394230769230769,0.08665401644528781,0.1740905208109184,128388.0362426036,227.93392504931415,128615.97016765292,1025,0,255.025,38,2,17,38.51597090449083,0.600328947368421,46.63461538461539,1013.4615384615389,26.670040485829972,0
1227,4,2,0,42,0.047619047619047616,0.0,1.0,42,750,300,450,0.4,12,3,9,311.21505139386653,0.44125048393341076,0.10439775089643244,0.17159563334527728,128974.5540143141,-372.2355087868446,128602.31850552725,1026,0,243.83333333333334,41,1,19,38.15344516066021,0.6013719512195121,46.05654761904762,1015.7738095238099,24.77497096399536,0
1228,4,2,1,43,0.045454545454545456,0.022727272727272728,0.9772727272727273,44,1500,1300,200,0.8666666666666667,17,13,4,307.0670327467078,0.44412878787878785,0.13751610866538067,0.1723214939242203,129669.75509472091,-836.3393147449618,128833.41577997594,1027,0,233.70454545454547,42,2,15,37.554308185075946,0.6068948412698413,45.373062015503876,1018.5077519379848,24.25018456995202,0
1229,4,0,0,43,0.0,0.0,1.0,43,1400,1100,300,0.7857142857142857,17,11,6,311.4184591477135,0.4428525286083425,0.13778571299099163,0.17447593147882787,129605.142983119,-527.7132149156082,129077.4297682034,1028,1,239.74418604651163,41,2,15,37.50893089114055,0.6077235772357723,45.43650793650793,1018.2539682539668,24.835462640340655,0
1230,4,1,0,44,0.022727272727272728,0.0,1.0,44,1150,900,250,0.782608695652174,14,9,5,302.3847893732785,0.4442939570119803,0.14717629574586621,0.17080139781703657,129924.4621283862,-942.563776974283,128981.89835141192,1029,0,235.27272727272728,43,1,16,37.41601647160814,0.6080426356589148,45.12310606060606,1019.5075757575763,23.70947850599015,0
1231,4,0,0,44,0.0,0.0,1.0,44,1200,800,400,0.6666666666666666,16,8,8,301.76889789091,0.4440186751233263,0.1444851917185035,0.17098120984655393,130045.17049938296,-951.2824444731475,129093.88805490981,1030,1,236.27272727272728,43,1,16,37.30977083526752,0.6092538759689923,45.004734848484844,1019.98106060606,23.72048978153628,0
1232,4,0,2,42,0.0,0.045454545454545456,0.9545454545454546,44,1050,800,250,0.7619047619047619,13,8,5,302.2940252170267,0.4429175475687104,0.1414253897550115,0.17181014850942405,130165.93491735544,-930.3231175390165,129235.61179981643,1031,2,237.27272727272728,43,1,16,37.17443083395199,0.6104651162790697,44.88636363636364,1020.454545454546,23.731501057082465,0
1233,4,1,1,42,0.023255813953488372,0.023255813953488372,0.9767441860465116,43,1350,1000,350,0.7407407407407407,17,10,7,307.6803282737154,0.4427141011443337,0.14437042995688665,0.17553469726125734,130313.22830057958,-581.0007575497243,129732.22754302985,1032,0,241.13953488372093,41,2,18,36.88827892214015,0.6148373983739837,44.742063492063494,1021.0317460317467,24.90321331784748,0
1234,4,1,2,41,0.023255813953488372,0.046511627906976744,0.9534883720930233,43,1800,1400,400,0.7777777777777778,22,14,8,300.7541495524725,0.4441675895164267,0.1402662838103228,0.17270731598046676,130566.58340419497,-746.311649659875,129820.27175453509,1033,0,238.4418604651163,41,2,15,36.809600077654814,0.6173780487804879,44.49404761904761,1022.0238095238092,24.92740998838559,0
1235,4,0,0,41,0.0,0.0,1.0,41,950,700,250,0.7368421052631579,12,7,5,310.88152763566126,0.44164126016260163,0.1360121801952412,0.17761553012471024,130368.94531250026,-94.14062499997016,130274.80468750029,1034,2,250.5609756097561,39,2,21,36.75030599755202,0.6185897435897436,44.687500000000014,1021.250000000002,26.185897435897488,0
1236,4,0,1,40,0.0,0.024390243902439025,0.975609756097561,41,1250,1000,250,0.8,15,10,5,311.2518281959424,0.44146341463414634,0.13333797625147303,0.17807091174384004,130422.14084201427,-81.17404513884878,130340.96679687542,1035,3,251.5609756097561,39,2,22,36.687147324767146,0.6191239316239316,44.635416666666686,1021.4583333333364,26.191239316239397,0
1237,4,0,0,40,0.0,0.0,1.0,40,1100,600,500,0.5454545454545454,16,6,10,310.92264404793815,0.43876869658119655,0.13710537319673843,0.17852857220663743,130562.68376981534,118.97897034117051,130681.6627401565,1036,4,257.35,38,2,17,36.55372325597601,0.6222587719298245,44.49786324786326,1022.0085470085482,26.89496176338285,0
1238,4,1,0,41,0.024390243902439025,0.0,1.0,41,1350,1000,350,0.7407407407407407,17,10,7,304.6215715414146,0.44072662601626017,0.14887010439121262,0.17649822931082002,130911.7888244435,-224.28903100002196,130687.49979344348,1037,0,252.0487804878049,40,1,18,36.36295928500498,0.6223958333333333,44.15650406504067,1023.3739837398405,25.58434959349601,0
1239,4,2,0,43,0.046511627906976744,0.0,1.0,43,1450,1100,350,0.7586206896551724,18,11,7,292.19817682483904,0.44257567368032485,0.15058941383749436,0.17203614571010853,131526.8435265311,-913.6192236043323,130613.22430292677,1038,0,241.27906976744185,42,1,22,36.062960513886246,0.6254960317460317,43.556201550387605,1025.7751937984515,24.423218899963132,0
1240,4,0,2,41,0.0,0.046511627906976744,0.9534883720930233,43,1600,1200,400,0.75,20,12,8,291.1533016299414,0.4410760428202289,0.14724365376384196,0.17242980607988997,131750.5814422963,-928.0766442821775,130822.50479801412,1039,1,242.27906976744185,42,1,14,35.86538461538462,0.6277281746031746,43.33817829457365,1026.6472868217068,24.443983019564445,0
1241,4,0,0,41,0.0,0.0,1.0,41,900,600,300,0.6666666666666666,12,6,6,307.2658519722416,0.4370680894308943,0.15538329942443463,0.18095341364106227,131536.5409561109,-116.6625355277792,131419.87842058312,1040,3,255.0487804878049,40,1,20,35.66681526979724,0.6286458333333333,43.54674796747968,1025.8130081300824,25.64532520325206,0
1242,4,0,0,41,0.0,0.0,1.0,41,950,800,150,0.8421052631578947,11,8,3,345.7574664984075,0.4367378048780488,0.1911514463981845,0.19392483990562862,129647.68005540174,785.0930142510423,130432.77306965279,1041,4,256.0487804878049,37,4,19,36.59156976744186,0.6148648648648649,45.39473684210527,1018.4210526315795,27.524893314367013,8
1243,4,1,0,42,0.023809523809523808,0.0,1.0,42,1600,1200,400,0.75,20,12,8,335.4617833752123,0.4375362950058072,0.19072555708500394,0.19020125342437816,130071.7957849369,326.82331616627516,130398.61910110318,1042,0,250.92857142857142,38,4,21,36.423640203882144,0.6173245614035088,44.978632478632484,1020.0854700854708,26.844354475933443,0
1244,4,1,0,43,0.023255813953488372,0.0,1.0,43,1350,900,450,0.6666666666666666,18,9,9,326.74772632109625,0.438999630860096,0.18427873019360685,0.186707259076975,130374.54433094815,-79.80316422398272,130294.74116672417,1043,0,246.06976744186048,37,6,23,36.3395605182163,0.6221846846846847,44.68201754385966,1021.2719298245628,27.601944049312507,0
1245,4,0,0,43,0.0,0.0,1.0,43,1300,800,500,0.6153846153846154,18,8,10,325.90827266906234,0.4380998523440384,0.1778230202867741,0.1871713499413637,130570.5857210874,-89.19318925052178,130481.39253183687,1044,1,247.06976744186048,37,6,18,36.162853592246904,0.6241554054054055,44.49013157894738,1022.0394736842117,27.622688477951666,0
1246,4,0,1,42,0.0,0.023255813953488372,0.9767441860465116,43,1200,800,400,0.6666666666666666,16,8,8,387.59041625792287,0.4378691399040236,0.25545688825410595,0.20885267753754277,128059.03031409801,1352.2890129100406,129411.31932700805,1045,2,248.06976744186048,36,7,18,37.15185061563566,0.6006944444444444,46.95945945945947,1012.1621621621632,28.115615615615646,8
1247,4,0,0,42,0.0,0.0,1.0,42,850,700,150,0.8235294117647058,10,7,3,394.023683943987,0.43615708478513354,0.256088528732628,0.2121516682516147,128027.37054183811,1689.1632373113853,129716.5337791495,1046,3,252.73809523809524,35,7,18,37.021576700213494,0.6023809523809525,46.99074074074074,1012.0370370370368,28.91534391534391,0
1248,4,1,0,43,0.023255813953488372,0.0,1.0,43,1200,800,400,0.6666666666666666,16,8,8,385.038846087258,0.4381921373200443,0.24732252141982913,0.20902108787593987,128355.55555555547,1284.4821673525325,129640.037722908,1047,0,247.8372093023256,34,9,20,36.91234923245615,0.607843137254902,46.666666666666664,1013.3333333333327,29.80392156862743,0
1249,4,1,2,42,0.022727272727272728,0.045454545454545456,0.9545454545454546,44,1550,1300,250,0.8387096774193549,18,13,5,366.02324019588747,0.43910764622973925,0.1857448317994601,0.19656172375129552,127922.58795975683,567.3058056324998,128489.89376538932,1048,0,243.1818181818182,37,7,19,37.83736180359852,0.5974099099099099,47.094298245614034,1011.6228070175437,27.3411569464201,8
1250,4,0,0,42,0.0,0.0,1.0,42,1350,1100,250,0.8148148148148148,16,11,5,383.80386670041196,0.43443912117692607,0.22068360418097233,0.20574712805080983,127851.72994898837,1413.9976637517207,129265.7276127401,1049,1,255.61904761904762,35,7,19,37.46042191195544,0.6005952380952381,47.164351851851855,1011.3425925925928,28.895502645502653,0
1251,4,0,0,42,0.0,0.0,1.0,42,700,400,300,0.5714285714285714,10,4,6,382.36563747227814,0.43470528455284557,0.2184542199990196,0.2051254331412055,127880.99500868049,1379.459635416661,129260.45464409715,1050,2,256.6190476190476,35,7,19,37.46674390662547,0.6008928571428571,47.135416666666664,1011.4583333333328,28.898809523809508,0
1252,4,0,2,40,0.0,0.047619047619047616,0.9523809523809523,42,900,500,400,0.5555555555555556,13,5,8,379.6925735179474,0.4350561362756485,0.21020034643919394,0.20413729875116174,127968.8102816356,1317.7613811728165,129286.57166280842,1051,3,257.6190476190476,35,7,19,37.44423472889498,0.6017857142857144,47.0486111111111,1011.8055555555538,28.90873015873011,0
1253,4,1,0,41,0.024390243902439025,0.0,1.0,41,1050,500,550,0.47619047619047616,16,5,11,380.99067192824396,0.43790650406504067,0.20307323383712506,0.20542572500988315,128084.27047902493,1559.7824546485274,129644.05293367345,1052,0,261.0487804878049,34,7,21,37.292965227958774,0.6050857843137255,46.93452380952381,1012.2619047619046,29.77240896358543,0
1254,4,1,0,42,0.023809523809523808,0.0,1.0,42,750,600,150,0.8,9,6,3,372.8918737325738,0.44031891211769264,0.20821097145542145,0.20257999496396928,128385.71605725617,1174.8122165532814,129560.52827380945,1053,0,255.8095238095238,34,8,15,37.189200830102976,0.6081495098039216,46.63690476190476,1013.4523809523804,29.80742296918766,0
1255,4,0,0,42,0.0,0.0,1.0,42,1250,1000,250,0.8,15,10,5,369.80221985309487,0.44007694541231124,0.2102163790742264,0.20181583029650943,128566.75347222213,1108.8541666666556,129675.60763888879,1054,1,256.8095238095238,34,8,16,37.08230621747465,0.6099877450980392,46.45833333333333,1014.1666666666658,29.828431372548994,0
1256,4,1,1,42,0.023255813953488372,0.023255813953488372,0.9767441860465116,43,1150,900,250,0.782608695652174,14,9,5,365.24773357540005,0.4409145441122185,0.21481495217180546,0.20179420094766728,129054.34355977783,827.3612986539624,129881.7048584318,1055,0,251.8139534883721,35,8,18,36.69991361962256,0.612797619047619,45.97800925925925,1016.0879629629619,29.031084656084627,0
1257,4,1,1,42,0.023255813953488372,0.023255813953488372,0.9767441860465116,43,1200,1000,200,0.8333333333333334,14,10,4,362.6250182617768,0.43881506090808414,0.21670130110786068,0.20124199528930575,129230.80800165044,772.4648223165382,130003.27282396698,1056,0,252.72093023255815,35,8,20,36.586629671789034,0.6145833333333333,45.80439814814815,1016.782407407408,29.05092592592594,0
1258,4,0,2,40,0.0,0.047619047619047616,0.9523809523809523,42,1150,900,250,0.782608695652174,14,9,5,359.7939381632477,0.43931475029036005,0.20672214727283555,0.20026782283196845,129348.51794249396,907.7625332218743,130256.28047571583,1057,1,254.0,35,7,20,36.538689460310245,0.6157738095238094,45.688657407407405,1017.24537037037,29.06415343915343,0
1259,4,2,0,42,0.047619047619047616,0.0,1.0,42,1300,1100,200,0.8461538461538461,15,11,4,361.7306112518047,0.4445291327913279,0.22570470638821316,0.1954775242644865,128173.8297994897,887.9131301440073,129061.7429296337,1058,0,245.73809523809524,35,7,17,37.68871204328112,0.6038690476190476,46.8460648148148,1012.6157407407393,28.931878306878264,8
1260,4,0,0,42,0.0,0.0,1.0,42,750,400,350,0.5333333333333333,11,4,7,365.21712247960477,0.44434765776229196,0.2293897449290505,0.19779580791717183,128261.7455418379,968.6771262002455,129230.42266803814,1059,1,246.73809523809524,35,7,17,37.51047379646556,0.6047619047619048,46.759259259259245,1012.962962962961,28.941798941798886,0
1261,4,0,2,40,0.0,0.047619047619047616,0.9523809523809523,42,1400,1000,400,0.7142857142857143,18,10,8,366.58292022735833,0.44356126596980255,0.2360093551983904,0.19897293655241882,128349.69142500403,1010.1609385716393,129359.85236357567,1060,2,247.73809523809524,35,7,17,37.38589853417094,0.6056547619047619,46.67245370370369,1013.3101851851831,28.951719576719515,0
1262,4,0,1,39,0.0,0.025,0.975,40,850,600,250,0.7058823529411765,11,6,5,375.48336115942647,0.44314903846153847,0.2305407694168884,0.20339092158216357,128268.6421688772,1632.5481785851393,129901.19034746234,1061,3,247.1,33,7,19,37.24342688926527,0.6092171717171717,46.75245098039215,1012.9901960784301,30.696672608437275,0
1263,4,0,0,39,0.0,0.0,1.0,39,1050,700,350,0.6666666666666666,14,7,7,388.122080881913,0.44152046783625726,0.2385363327771708,0.21008875390247667,128240.42986685029,2154.5884986225883,130395.01836547288,1062,4,253.56410256410257,32,7,20,36.95228745948641,0.611328125,46.78030303030303,1012.8787878787876,31.652462121212114,0
1264,4,3,1,41,0.07142857142857142,0.023809523809523808,0.9761904761904762,42,800,600,200,0.75,10,6,4,361.2736244866983,0.4468157181571815,0.23898189272292436,0.19989563305719557,129113.15164448286,929.0352527005948,130042.18689718345,1063,0,236.38095238095238,35,7,17,36.74090365562007,0.6133928571428571,45.92013888888888,1016.3194444444431,29.037698412698376,0
1265,4,0,0,41,0.0,0.0,1.0,41,1050,700,350,0.6666666666666666,14,7,7,372.9043962442064,0.4448678861788618,0.25709036989631895,0.206317876262916,129110.63102324282,1429.1843820861882,130539.815405329,1064,1,242.97560975609755,34,7,18,36.44796181328335,0.6155024509803921,45.92261904761906,1016.3095238095254,29.8914565826331,0
1266,4,0,0,41,0.0,0.0,1.0,41,1100,500,600,0.45454545454545453,17,5,12,372.9043962442064,0.4447154471544716,0.25709036989631895,0.206317876262916,129110.63102324282,1429.1843820861882,130539.815405329,1065,2,243.97560975609755,34,7,18,36.44796181328335,0.6155024509803921,45.92261904761906,1016.3095238095254,29.8914565826331,0
1267,4,0,1,40,0.0,0.024390243902439025,0.975609756097561,41,1650,1200,450,0.7272727272727273,21,12,9,371.0296242495315,0.44410569105691056,0.2511721136878893,0.20606859885172302,129261.91184807272,1391.9997165533055,130653.91156462602,1066,3,244.97560975609755,34,7,19,36.34126473113244,0.6170343137254901,45.77380952380953,1016.9047619047631,29.908963585434208,0
1268,4,2,1,41,0.047619047619047616,0.023809523809523808,0.9761904761904762,42,1050,500,550,0.47619047619047616,16,5,11,365.7798751365435,0.44584785133565624,0.26436604404342745,0.20574825819980774,129760.92470689729,1092.7869673782616,130853.71167427555,1067,0,239.83333333333334,35,7,18,35.96655022908857,0.6199404761904762,45.28356481481482,1018.8657407407408,29.110449735449738,0
1269,4,0,0,41,0.0,0.0,1.0,41,1450,1000,450,0.6896551724137931,19,10,9,374.48492043414274,0.44466463414634144,0.2665001711949402,0.19803547539115618,127302.17013888917,1361.0758798439974,128663.24601873316,1068,1,246.6829268292683,34,7,22,38.26039086154694,0.5971200980392157,47.70833333333335,1009.1666666666689,29.681372549019674,8
1270,4,1,1,41,0.023809523809523808,0.023809523809523808,0.9761904761904762,42,1450,1000,450,0.6896551724137931,19,10,9,367.2198347794346,0.4461382113821138,0.2719948462627453,0.19689560215845409,127859.63909433097,990.5191086356832,128850.15820296665,1069,0,241.78571428571428,36,6,20,37.87161785992651,0.5986689814814814,47.15653153153154,1011.373873873875,28.09371871871875,0
1271,4,0,0,41,0.0,0.0,1.0,41,1050,800,250,0.7619047619047619,13,8,5,378.2037922385311,0.4452997967479675,0.28138639281129696,0.20304061082093128,127910.2634173525,1475.2293381344302,129385.49275548694,1070,1,248.17073170731706,35,6,21,37.5419527078566,0.6011904761904762,47.10648148148148,1011.5740740740737,28.90211640211639,0
1272,4,1,1,41,0.023809523809523808,0.023809523809523808,0.9761904761904762,42,1250,800,450,0.64,17,8,9,373.93524473636006,0.4472996515679442,0.2813017814129546,0.2025013561952775,128258.57688347135,1192.0804672916242,129450.65735076298,1071,0,243.23809523809524,36,6,22,37.292940522512524,0.6027199074074074,46.76238738738739,1012.9504504504507,28.13751251251252,0
1273,4,2,1,42,0.046511627906976744,0.023255813953488372,0.9767441860465116,43,1500,1300,200,0.8666666666666667,17,13,4,369.905004448305,0.4483896271686969,0.29396876939974215,0.20240869344530835,128672.41753472215,919.3142361111063,129591.73177083326,1072,0,238.34883720930233,37,6,18,36.971680355920604,0.6050112612612613,46.354166666666664,1014.5833333333327,27.421171171171153,0
1274,4,0,0,42,0.0,0.0,1.0,42,1100,900,200,0.8181818181818182,13,9,4,382.1453272002719,0.4460535230352303,0.3027052312766596,0.20903140575271725,128658.13607103738,1433.2211011687482,130091.35717220613,1073,1,245.0,36,6,18,36.67582417582418,0.6067708333333333,46.36824324324325,1014.5270270270281,28.181306306306336,0
1275,4,1,0,43,0.023255813953488372,0.0,1.0,43,1050,600,450,0.5714285714285714,15,6,9,376.7022139639731,0.4456672203765227,0.3125095655184704,0.2084568848496754,129117.7949585448,1127.791844606017,130245.58680315081,1074,0,240.27906976744185,37,6,20,36.34415345056999,0.6095157657657657,45.91557017543859,1016.3377192982445,27.46858700806066,0
1276,4,2,1,44,0.044444444444444446,0.022222222222222223,0.9777777777777777,45,1350,900,450,0.6666666666666666,18,9,9,363.84408741498873,0.44732744107744105,0.3089193572165705,0.20413188130156062,129659.75265806337,435.2680308436313,130095.020688907,1075,0,230.55555555555554,36,9,17,36.11878962111158,0.6168981481481481,45.382882882882875,1018.4684684684677,28.29079079079077,0
1277,4,1,0,45,0.022222222222222223,0.0,1.0,45,1250,800,450,0.64,17,8,9,365.06863678614377,0.4476641414141414,0.3193683072993423,0.2054192180125016,129774.47041636221,475.3178009090105,130249.78821727121,1076,0,231.46666666666667,36,9,19,35.97088675213676,0.6180555555555556,45.27027027027027,1018.918918918918,28.30330330330328,0
1278,4,0,0,45,0.0,0.0,1.0,45,1250,800,450,0.64,17,8,9,363.4696516597441,0.44724326599326597,0.3177784947007456,0.20546530643063543,129954.95158366008,446.93619671434567,130401.88778037443,1077,1,232.46666666666667,37,8,20,35.82811323798258,0.6179617117117118,45.09320175438595,1019.6271929824538,27.557491702228482,0
1279,4,1,0,46,0.021739130434782608,0.0,1.0,46,1150,600,550,0.5217391304347826,17,6,11,355.4684664117047,0.44773550724637684,0.3166951919343006,0.20313443742203835,130377.57087746522,69.75042213218015,130447.3212995974,1078,0,228.3913043478261,36,10,21,35.60319954423493,0.6241319444444444,44.67905405405405,1021.2837837837832,28.36899399399398,0
1280,4,0,0,46,0.0,0.0,1.0,46,1250,700,550,0.56,18,7,11,354.4853886508734,0.4469303542673108,0.31875754498246667,0.2036271764174258,130578.91506371237,57.66349119389636,130636.57855490627,1079,1,229.3913043478261,36,10,13,35.424241589540166,0.6261574074074074,44.48198198198198,1022.0720720720722,28.390890890890894,0
1281,4,0,1,45,0.0,0.021739130434782608,0.9782608695652174,46,1250,1000,250,0.8,15,10,5,354.69154478716473,0.44622584541062804,0.3180551165263368,0.20404878603155133,130636.47050766974,67.13030598164539,130703.60081365138,1080,2,230.3913043478261,36,10,13,35.36067048542264,0.6267361111111112,44.42567567567567,1022.2972972972966,28.397147147147127,0
1282,4,1,1,45,0.021739130434782608,0.021739130434782608,0.9782608695652174,46,1200,400,800,0.3333333333333333,20,4,16,357.44344445794013,0.4471014492753623,0.32524945562441676,0.20670742793764388,130838.01442912503,153.43810871682274,130991.45253784186,1081,0,231.32608695652175,36,10,16,35.0862227114291,0.6287615740740741,44.2286036036036,1023.0855855855852,28.419044044044036,0
1283,4,0,0,45,0.0,0.0,1.0,45,1500,1000,500,0.6666666666666666,20,10,10,368.7689321721489,0.44589646464646465,0.33935965606969165,0.21318172606079938,130824.4133257244,648.7958408350414,131473.20916655945,1082,1,237.33333333333334,35,10,17,34.810333936719836,0.6306547619047619,44.241898148148145,1023.0324074074069,29.22949735449734,0
1284,4,0,0,45,0.0,0.0,1.0,45,1250,900,350,0.72,16,9,7,371.7995688266451,0.4450547138047138,0.3419267299864319,0.21576085214585625,130972.4633487654,739.1010802469107,131711.56442901233,1083,2,238.33333333333334,35,10,17,34.58276797829036,0.6321428571428571,44.09722222222222,1023.611111111111,29.246031746031743,0
1285,4,0,1,44,0.0,0.022222222222222223,0.9777777777777777,45,1600,1000,600,0.625,22,10,12,373.2628092624867,0.44436026936026934,0.3401514295400607,0.21744585906278782,131120.59709630063,788.4884848679714,131909.0855811686,1084,3,239.33333333333334,35,10,18,34.39524710890119,0.6336309523809525,43.9525462962963,1024.1898148148152,29.26256613756615,0
1286,4,0,0,44,0.0,0.0,1.0,44,1100,800,300,0.7272727272727273,14,8,6,385.50293614095455,0.44223484848484845,0.3513453530891337,0.22436375214374105,131084.19075963725,1306.6680839002317,132390.85884353748,1085,4,245.5681818181818,34,10,19,34.11876114081996,0.6354166666666667,43.98809523809524,1024.0476190476195,30.11904761904763,0
1287,4,0,0,44,0.0,0.0,1.0,44,1200,800,400,0.6666666666666666,16,8,8,387.32496106435246,0.44170630725863286,0.35287220332537483,0.22614101865127711,131206.1295351477,1363.8818027211196,132570.0113378688,1086,5,246.5681818181818,34,10,20,33.94845650321481,0.6366421568627452,43.869047619047635,1024.523809523812,30.133053221288584,0
1288,4,1,0,45,0.022222222222222223,0.0,1.0,45,1350,700,650,0.5185185185185185,20,7,13,372.9994455240872,0.44149831649831645,0.34184068058778005,0.22022296030257768,131633.3616780046,819.8908730158798,132453.2525510205,1087,0,242.06666666666666,34,11,17,33.88316898685228,0.6409313725490196,43.452380952380956,1026.1904761904768,30.18207282913167,0
1289,4,0,0,45,0.0,0.0,1.0,45,1000,600,400,0.6,14,6,8,369.9329832535459,0.4414141414141414,0.33142974897930255,0.2196429350673325,131847.23816609982,754.9284297052188,132602.16659580503,1088,1,243.06666666666666,34,11,18,33.745798075808516,0.6430759803921569,43.24404761904762,1027.0238095238099,30.20658263305323,0
1290,4,1,1,45,0.021739130434782608,0.021739130434782608,0.9782608695652174,46,1350,1000,350,0.7407407407407407,17,10,7,360.9711973453909,0.44243156199677935,0.32650602409638596,0.21596769539734056,132137.3632923463,339.5564483402243,132476.9197406865,1089,0,238.7608695652174,36,10,20,33.6833698430084,0.6417824074074074,42.96171171171171,1028.1531531531523,28.559809809809785,0
1291,4,0,0,45,0.0,0.0,1.0,45,1400,1000,400,0.7142857142857143,18,10,8,369.4122888328411,0.4428030303030303,0.3263311944163012,0.2209757145927358,132130.12695312488,762.0985243055404,132892.22547743042,1090,1,243.66666666666666,35,10,20,33.47369976359338,0.64375,42.96874999999999,1028.124999999999,29.374999999999975,0
1292,4,0,0,45,0.0,0.0,1.0,45,1400,1000,400,0.7142857142857143,18,10,8,371.16544574150066,0.44217171717171716,0.32420389332733235,0.22272432925757688,132249.14969403707,817.2629190243347,133066.4126130614,1091,2,244.66666666666666,35,10,20,33.308601515321996,0.6449404761904762,42.85300925925925,1028.587962962962,29.388227513227484,0
1293,4,0,1,44,0.0,0.022222222222222223,0.9777777777777777,45,1800,1600,200,0.8888888888888888,20,16,4,372.48719955398894,0.4419191919191919,0.2897085708140663,0.2105628248420999,129954.95158366037,681.3949212085449,130636.34650486891,1092,3,245.66666666666666,37,8,15,35.598249811807726,0.6179617117117118,45.093201754385966,1019.6271929824562,27.557491702228546,8
1294,4,0,2,42,0.0,0.045454545454545456,0.9545454545454546,44,600,200,400,0.3333333333333333,10,2,8,378.8402608857467,0.44038495419309376,0.3102026674165428,0.21379439161706876,129889.23890106338,1041.4546303059979,130930.69353136938,1093,6,252.1818181818182,36,8,15,35.503203711886876,0.619212962962963,45.157657657657666,1019.3693693693706,28.31581581581585,0
1295,4,0,0,42,0.0,0.0,1.0,42,1000,400,600,0.4,16,4,12,389.7956012266681,0.4403673054587689,0.3170762928827444,0.21883800289339705,129685.96938775506,1710.2040816326466,131396.1734693877,1094,13,260.0238095238095,34,8,15,35.431276297335195,0.6213235294117647,45.357142857142854,1018.5714285714282,29.9579831932773,0
1296,4,0,0,42,0.0,0.0,1.0,42,850,500,350,0.5882352941176471,12,5,7,390.3018600762291,0.4401132404181185,0.3160952158381469,0.21946145325442623,129746.6057256235,1728.0683106575889,131474.6740362811,1095,14,261.0238095238095,34,8,15,35.356537742463196,0.6219362745098039,45.297619047619044,1018.8095238095232,29.96498599439774,0
1297,4,0,0,42,0.0,0.0,1.0,42,1000,800,200,0.8,12,8,4,390.6523173649776,0.4401737320944638,0.3150138223727763,0.22016948577758844,129837.58680555536,1744.2708333333107,131581.85763888867,1096,15,262.0238095238095,34,8,15,35.2548378304715,0.6228553921568627,45.20833333333332,1019.166666666665,29.975490196078383,0
1298,4,0,0,42,0.0,0.0,1.0,42,1000,700,300,0.7,13,7,6,388.38625352845384,0.4396897986837011,0.3105303548489349,0.21923213506685207,129898.25857426284,1690.1395975056435,131588.3981717685,1097,16,263.0238095238095,34,8,15,35.25073961617812,0.623468137254902,45.14880952380951,1019.4047619047603,29.982492997198833,0
1299,4,1,1,42,0.023255813953488372,0.023255813953488372,0.9767441860465116,43,1100,700,400,0.6363636363636364,15,7,8,389.74176459122316,0.44068383167220376,0.32190971017007963,0.22223572959669727,130292.9705215418,1556.6326530612068,131849.60317460302,1098,0,257.8837209302326,34,9,16,34.81421019900497,0.6274509803921569,44.76190476190475,1020.9523809523798,30.02801120448176,0
1300,4,0,0,42,0.0,0.0,1.0,42,1150,800,350,0.6956521739130435,15,8,7,364.6807953047049,0.44070605884630276,0.182708178592061,0.19665497092599477,128089.02739304373,942.3216759002447,129031.34906894396,1099,1,262.8809523809524,37,5,16,37.70084127671865,0.5990990990990991,46.92982456140349,1012.2807017543837,27.358937885253614,8
1301,4,1,0,43,0.023255813953488372,0.0,1.0,43,950,600,350,0.631578947368421,13,6,7,356.48376738813556,0.44130675526024365,0.1914509953860386,0.1940185534478834,128458.27880245086,558.6822817988802,129016.96108424975,1100,0,257.74418604651163,36,7,17,37.530780196993256,0.6047453703703703,46.5653153153153,1013.7387387387369,28.159409409409356,0
1302,4,0,0,43,0.0,0.0,1.0,43,1150,700,450,0.6086956521739131,16,7,9,359.5429003354416,0.4417220376522702,0.19528275342228874,0.19666800176818383,128658.13607103695,651.6238789464821,129309.75994998343,1101,1,258.74418604651163,36,7,17,37.249093499093505,0.6067708333333333,46.36824324324323,1014.5270270270246,28.18130630630624,0
1303,4,0,0,43,0.0,0.0,1.0,43,1450,1000,450,0.6896551724137931,19,10,9,355.65797388186513,0.4412375415282392,0.19490237257767284,0.1952112310717268,128794.39153928291,561.3504684417674,129355.74200772468,1102,2,259.74418604651163,38,5,18,37.208583307020305,0.6044407894736843,46.233974358974336,1015.0641025640989,26.712213225371023,0
1304,4,2,0,45,0.044444444444444446,0.0,1.0,45,1200,800,400,0.6666666666666666,16,8,8,338.5905832921411,0.44473905723905727,0.19781045751634085,0.18828167949422744,129310.02995105516,-242.08420081821725,129067.94575023693,1103,0,249.15555555555557,38,7,20,37.11703431372551,0.6096491228070176,45.726495726495706,1017.0940170940136,26.76563202878983,0
1305,4,0,0,45,0.0,0.0,1.0,45,1200,800,400,0.6666666666666666,16,8,8,335.50861560689583,0.4445496632996633,0.19710619710619715,0.18705754322192672,129413.28124999987,-316.1458333333489,129097.13541666653,1104,1,250.15555555555557,39,6,20,37.09049959049958,0.608974358974359,45.62499999999999,1017.499999999999,26.089743589743563,0
1306,4,1,2,44,0.021739130434782608,0.043478260869565216,0.9565217391304348,46,1300,1100,200,0.8461538461538461,15,11,4,331.8541551358512,0.44622584541062804,0.2011644801040875,0.18658653422528929,129744.3870732533,-588.7572088373378,129155.62986441595,1105,0,245.69565217391303,40,6,18,36.8474646716542,0.6106770833333333,45.29979674796748,1018.8008130081297,25.470020325203244,0
1307,4,1,1,44,0.022222222222222223,0.022222222222222223,0.9777777777777777,45,1150,800,350,0.6956521739130435,15,8,7,339.5616902911836,0.44574915824915823,0.21777096462839962,0.19150496481263604,129864.12896050357,-180.6233723958236,129683.50558810774,1106,0,251.04444444444445,39,6,19,36.529658490887414,0.6135149572649572,45.18229166666667,1019.2708333333342,26.135149572649595,0
1308,4,0,1,43,0.0,0.022727272727272728,0.9772727272727273,44,1550,800,750,0.5161290322580645,23,8,15,346.16032368251746,0.4451968816067653,0.21599841830949673,0.1953113925638617,129881.14458917755,191.93981024911812,130073.08439942668,1107,1,255.61363636363637,38,6,19,36.34424239248157,0.6154057017543859,45.1655982905983,1019.3376068376077,26.82467386414757,0
1309,4,2,0,45,0.044444444444444446,0.0,1.0,45,1000,700,300,0.7,13,7,6,341.50695281088474,0.4474747474747475,0.2141404980538868,0.1947273969453661,130292.12648158864,-98.62938425443991,130193.4970973342,1108,0,248.0888888888889,35,10,21,36.04620129992821,0.625297619047619,44.76273148148148,1020.9490740740739,29.16997354497354,0
1310,4,0,0,45,0.0,0.0,1.0,45,1600,1100,500,0.6875,21,11,10,342.53368139908844,0.4474116161616162,0.20647256523545154,0.19620667136338454,130469.43486636237,-61.96483303325829,130407.47003332911,1109,1,249.0888888888889,35,10,22,35.84043748347871,0.6270833333333333,44.589120370370374,1021.643518518519,29.18981481481483,0
1311,4,1,2,44,0.021739130434782608,0.043478260869565216,0.9565217391304348,46,1200,800,400,0.6666666666666666,16,8,8,336.24137663878474,0.4482185990338164,0.2075673037353214,0.19459166548662396,130866.81909950482,-399.4321179287457,130467.38698157607,1110,0,244.65217391304347,36,10,20,35.599411182038295,0.6290509259259259,44.20045045045045,1023.1981981981975,28.422172172172154,0
1312,4,1,1,44,0.022222222222222223,0.022222222222222223,0.9777777777777777,45,950,700,250,0.7368421052631579,12,7,5,340.5713273698998,0.4468434343434344,0.22248633579105714,0.19724484715170681,130895.62694028488,-84.1405172063929,130811.48642307849,1111,0,250.37777777777777,36,9,21,35.45953926855217,0.6293402777777778,44.1722972972973,1023.3108108108108,28.4253003003003,0
1313,4,0,0,44,0.0,0.0,1.0,44,1200,800,400,0.6666666666666666,16,8,8,344.0934803515599,0.44600070472163494,0.23017725319240823,0.19937578986032045,130913.23329260966,209.27801354594502,131122.5113061556,1112,1,256.1818181818182,35,9,22,35.35163613058885,0.631547619047619,44.15509259259259,1023.379629629629,29.239417989417973,0
1314,4,0,0,44,0.0,0.0,1.0,44,1700,1100,600,0.6470588235294118,23,11,12,343.58168955787704,0.4452959830866807,0.2285237251504122,0.19977371214766215,131047.29940943362,205.0905086180298,131252.38991805166,1113,2,257.1818181818182,37,7,22,35.2292603698151,0.6289414414414414,44.02412280701754,1023.9035087719294,27.67306780464674,0
1315,4,0,0,44,0.0,0.0,1.0,44,1100,700,400,0.6363636363636364,15,7,8,355.23539195986405,0.444899577167019,0.24013313981075735,0.1984565474465313,129492.78564453126,400.38466613525475,129893.17031066652,1114,3,258.1818181818182,39,5,15,36.50779944052127,0.609775641025641,45.546875,1017.8125000000001,26.097756410256412,8
1316,4,1,0,45,0.022222222222222223,0.0,1.0,45,1350,800,550,0.5925925925925926,19,8,11,350.607627152372,0.44663299663299666,0.2404803846622574,0.19765283264255978,129847.94439693642,105.13593512460506,129953.08033206103,1115,0,253.42222222222222,40,5,16,36.26462425632333,0.61171875,45.19817073170732,1019.2073170731712,25.48018292682928,0
1317,4,0,3,42,0.0,0.06666666666666667,0.9333333333333333,45,1800,1300,500,0.7222222222222222,23,13,10,346.85667162359294,0.4462752525252525,0.17752911784369618,0.18679779706027852,128036.38100162557,-107.57366727774314,127928.80733434783,1116,1,254.42222222222222,38,7,16,38.2057338400366,0.596765350877193,46.981837606837615,1012.072649572651,26.633490778227657,8
1318,4,0,0,42,0.0,0.0,1.0,42,950,500,450,0.5263157894736842,14,5,9,356.9690828614675,0.44457752613240414,0.19622715515413636,0.1918068325614488,127945.07345183019,734.4871053485838,128679.56055717877,1117,2,269.04761904761904,36,6,16,38.04332702582367,0.599537037037037,47.07207207207207,1011.7117117117116,28.1031031031031,0
1319,4,0,0,42,0.0,0.0,1.0,42,1100,500,600,0.45454545454545453,17,5,12,355.4613318356107,0.4446985094850948,0.19346728343056396,0.19140389390093657,128030.53634293067,701.9809928171337,128732.5173357478,1118,3,270.04761904761904,36,6,16,37.994000593449805,0.6004050925925926,46.98761261261261,1012.0495495495488,28.112487487487467,0
1320,4,0,1,41,0.0,0.023809523809523808,0.9761904761904762,42,1200,900,300,0.75,15,9,6,356.14489661128886,0.44388792102206737,0.19586517734665887,0.19231824417009602,128144.53125000001,727.654893068745,128872.18614306876,1119,4,271.04761904761904,35,7,16,37.86008230452674,0.6035714285714286,46.875,1012.5000000000001,28.92857142857143,0
1321,4,1,1,41,0.023809523809523808,0.023809523809523808,0.9761904761904762,42,1050,700,350,0.6666666666666666,14,7,7,351.48113475217946,0.44344028261711194,0.192174980683538,0.1907495325995242,128344.14439777612,622.1091023455847,128966.2535001217,1120,0,271.64285714285717,36,6,17,37.77413499296139,0.603587962962963,46.677927927927925,1013.2882882882881,28.14689689689689,0
1322,4,0,0,41,0.0,0.0,1.0,41,950,500,450,0.5263157894736842,14,5,9,361.45278751509215,0.44166666666666665,0.1949268075856665,0.19630136601377887,128372.67324334476,1080.1321169142163,129452.80536025898,1121,1,278.9268292682927,36,5,16,37.49236026225135,0.6038773148148149,46.64977477477478,1013.4009009009014,28.15002502502504,0
1323,4,1,0,42,0.023809523809523808,0.0,1.0,42,1200,800,400,0.6666666666666666,16,8,8,356.4929343678081,0.44108110723964383,0.20849344382886548,0.19561678087983403,128783.68975309715,782.0950917590067,129565.78484485616,1122,0,273.26190476190476,37,5,17,37.19831388858882,0.6061373873873874,46.24451754385965,1015.0219298245617,27.43302513039356,0
1324,4,0,0,42,0.0,0.0,1.0,42,1000,700,300,0.7,13,7,6,357.48262824288224,0.44043989547038326,0.2101006673453225,0.19684923322149656,128922.8476550476,817.5356840566174,129740.38333910423,1123,1,274.26190476190476,37,5,17,37.03123875332899,0.607545045045045,46.10745614035087,1015.5701754385957,27.447842579421504,0
1325,4,1,0,43,0.023255813953488372,0.0,1.0,43,1100,700,400,0.6363636363636364,15,7,8,354.2497486557192,0.4413298265042451,0.21997003567916562,0.19730531623648395,129373.18019032558,566.6844595494074,129939.86464987499,1124,0,268.86046511627904,36,7,18,36.65458268762454,0.6140046296296297,45.66441441441442,1017.3423423423433,28.259509509509535,0
1326,4,1,0,44,0.022727272727272728,0.0,1.0,44,1200,900,300,0.75,15,9,6,348.9288736843138,0.4413319238900634,0.22991429577740385,0.19626193064616493,129759.37307633118,255.35837950138563,130014.73145583256,1125,0,263.72727272727275,37,7,16,36.39734897402784,0.615990990990991,45.28508771929825,1018.859649122807,27.536747273589377,0
1327,4,0,2,42,0.0,0.045454545454545456,0.9545454545454546,44,950,400,550,0.42105263157894735,15,4,11,384.3694373076928,0.44155214940098664,0.2553292253887631,0.20545181551073344,127734.70320001694,1159.9030456070764,128894.60624562402,1126,1,264.72727272727275,35,9,18,37.566311731928856,0.5994047619047619,47.28009259259258,1010.879629629628,28.882275132275083,8
1328,4,0,0,42,0.0,0.0,1.0,42,950,700,250,0.7368421052631579,12,7,5,397.6572312869363,0.43930265195509094,0.26462023780635846,0.21145102582367253,127524.87775134546,1742.2379613609944,129267.11571270645,1127,2,263.9761904761905,33,9,18,37.446412683005754,0.6016414141414141,47.487745098039206,1010.0490196078416,30.607546048722472,0
1329,4,2,0,44,0.045454545454545456,0.0,1.0,44,1600,1100,500,0.6875,21,11,10,390.5789993287984,0.4426092318534179,0.31155076852751273,0.20058463135316923,126107.23913695033,1140.4316420116736,127247.670778962,1128,0,252.9318181818182,32,12,20,39.087575948041064,0.5895182291666667,48.89520202020202,1004.419191919192,31.38809974747475,8
1330,4,0,0,44,0.0,0.0,1.0,44,1550,1300,250,0.8387096774193549,18,13,5,393.04537548078326,0.4427193446088795,0.3159210796739056,0.20294599737859892,126329.27284205689,1130.627295684109,127459.900137741,1129,1,253.9318181818182,32,12,18,38.795999748806835,0.591796875,48.67424242424242,1005.30303030303,31.41571969696969,0
1331,4,2,0,46,0.043478260869565216,0.0,1.0,46,750,500,250,0.6666666666666666,10,5,5,372.5859528897652,0.4445450885668277,0.3128642122030747,0.19531040889892756,126946.17419249404,259.6722554441062,127205.84644793815,1130,0,243.84782608695653,35,11,20,38.674462118601895,0.5913690476190476,48.061342592592595,1007.75462962963,28.79298941798943,0
1332,4,0,1,45,0.0,0.021739130434782608,0.9782608695652174,46,1950,1100,850,0.5641025641025641,28,11,17,371.76371021889776,0.4447262479871175,0.3149710555487124,0.19586953687652384,127152.04081632652,254.18661565062663,127406.22743197715,1131,1,244.84782608695653,34,12,20,38.483386449480626,0.5955882352941176,47.857142857142854,1008.5714285714286,29.66386554621849,0
1333,4,0,1,44,0.0,0.022222222222222223,0.9777777777777777,45,1450,1100,350,0.7586206896551724,18,11,7,371.710502140124,0.4442760942760943,0.3187772009857903,0.19642258205359653,127272.13718820852,461.67800453513877,127733.81519274366,1132,2,249.3111111111111,34,11,21,38.36125530910807,0.5968137254901961,47.738095238095234,1009.0476190476184,29.677871148459364,0
1334,4,1,1,44,0.022222222222222223,0.022222222222222223,0.9777777777777777,45,800,500,300,0.625,11,5,6,374.15328586027726,0.44515993265993264,0.3287893668565438,0.1990401649231632,127542.56129535152,544.0936791383219,128086.65497448985,1133,0,249.57777777777778,34,11,18,38.021754075820056,0.5995710784313726,47.470238095238095,1010.119047619048,29.709383753501413,0
1335,4,4,2,46,0.08333333333333333,0.041666666666666664,0.9583333333333334,48,1550,1100,450,0.7096774193548387,20,11,9,341.32601898169634,0.45173980496453897,0.32662013912013865,0.1867034672134855,128658.1360710374,-814.2916539332905,127843.8444171041,1134,0,233.4375,36,12,19,37.71113146113145,0.6067708333333333,46.36824324324325,1014.5270270270282,28.18130630630634,0
1336,4,1,1,46,0.02127659574468085,0.02127659574468085,0.9787234042553191,47,1150,900,250,0.782608695652174,14,9,5,351.94529796933006,0.45295636756090035,0.34127074066729035,0.192927677937932,128743.8367421476,-337.84240321401217,128405.99433893358,1135,0,239.29787234042553,36,11,20,37.35436085219709,0.6076388888888888,46.28378378378379,1014.8648648648654,28.190690690690705,0
1337,4,1,3,44,0.02127659574468085,0.06382978723404255,0.9361702127659575,47,1450,1100,350,0.7586206896551724,18,11,7,321.14298182752214,0.4544596053037311,0.19317299555974277,0.1776117307658337,129095.50781250003,-1108.3767361111113,127987.13107638892,1136,0,238.19148936170214,39,8,21,37.778461117944516,0.6057692307692308,45.9375,1016.2500000000002,26.057692307692314,8
1338,4,0,0,44,0.0,0.0,1.0,44,1300,800,500,0.6153846153846154,18,8,10,338.50226891706524,0.45150634249471455,0.22908183833904427,0.18663144655451877,128972.51136271398,-68.50245515787378,128904.00890755611,1137,1,255.0,36,8,21,37.46258314855876,0.6099537037037037,46.05855855855855,1015.7657657657651,28.215715715715696,0
1339,4,0,0,44,0.0,0.0,1.0,44,1150,900,250,0.782608695652174,14,9,5,367.71968718269466,0.45149533121916846,0.22943558717458568,0.197472749356667,127922.58795975683,629.2485761056773,128551.8365358625,1138,2,256.0,37,7,20,37.79445769202977,0.5974099099099099,47.094298245614034,1011.6228070175437,27.3411569464201,8
1340,4,2,0,46,0.043478260869565216,0.0,1.0,46,1250,900,350,0.72,16,9,7,350.7139310079085,0.45489130434782604,0.23014883789134077,0.19080124870430262,128442.17985243634,-190.51527246333052,128251.664579973,1139,0,245.82608695652175,38,8,19,37.693446107363705,0.6008771929824561,46.581196581196586,1013.6752136752143,26.675663517768797,0
1341,4,0,1,45,0.0,0.021739130434782608,0.9782608695652174,46,1600,1200,400,0.75,20,12,8,316.5082133591129,0.45464975845410627,0.1208439897698208,0.1680694175657492,127469.34125940541,-1126.5069124844704,126342.83434692094,1140,1,246.82608695652175,38,8,18,39.55225525461982,0.5910087719298245,47.542735042735046,1009.8290598290603,26.574448942870006,8
1342,4,1,0,46,0.021739130434782608,0.0,1.0,46,1550,1100,450,0.7096774193548387,20,11,9,316.46238377007614,0.45431763285024157,0.13598901098901095,0.16940045248868804,127793.20987654343,-1111.6512345678734,126681.55864197556,1141,0,247.54347826086956,38,8,19,39.22275641025642,0.5942982456140351,47.222222222222236,1011.1111111111129,26.60818713450297,0
1343,4,2,0,48,0.041666666666666664,0.0,1.0,48,800,300,500,0.375,13,3,10,305.7100502077558,0.45631094858156024,0.1561814692982455,0.1659568843984964,128355.5555555558,-1751.6010802468888,126603.9544753089,1142,0,238.1875,39,9,21,38.92201206140352,0.5982905982905983,46.66666666666668,1013.3333333333353,25.982905982906033,0
1344,4,0,0,48,0.0,0.0,1.0,48,1100,500,600,0.45454545454545453,17,5,12,303.9346725634567,0.4560616134751773,0.14805064721594352,0.16564950183273755,128513.93771701412,-1788.0316840277524,126725.90603298637,1143,1,239.1875,39,9,15,38.80598931580029,0.5998931623931624,46.51041666666668,1013.9583333333353,25.998931623931675,0
1345,4,0,0,48,0.0,0.0,1.0,48,1300,800,500,0.6153846153846154,18,8,10,303.83724408188823,0.45595079787234044,0.14545672418515476,0.16581611033527283,128566.75347222241,-1787.3263888888673,126779.42708333355,1144,2,240.1875,39,9,16,38.75479320734044,0.6004273504273504,46.45833333333334,1014.1666666666682,26.004273504273545,0
1346,4,1,3,46,0.02040816326530612,0.061224489795918366,0.9387755102040817,49,1350,900,450,0.6666666666666666,18,9,9,297.8512768139948,0.45696924603174605,0.1577278435135936,0.16420427533126736,128969.02394614648,-2117.2823096371194,126851.74163650937,1145,0,236.26530612244898,40,9,18,38.49841587460396,0.6028645833333333,46.0619918699187,1015.7520325203253,25.393800813008134,0
1347,4,0,1,45,0.0,0.021739130434782608,0.9782608695652174,46,900,600,300,0.6666666666666666,12,6,6,318.00888159758864,0.45344202898550723,0.1635037231752774,0.17371555361838364,128604.67916757982,-1020.5139619402452,127584.16520563957,1146,1,252.08695652173913,38,8,18,38.356900849659425,0.6025219298245614,46.42094017094017,1014.3162393162394,26.692532613585247,0
1348,4,0,0,45,0.0,0.0,1.0,45,1150,900,250,0.782608695652174,14,9,5,329.4476171548722,0.45147306397306397,0.14206906331986113,0.16926046428907696,126124.31171926369,-659.8123949886711,125464.49932427502,1147,2,258.44444444444446,38,7,16,40.605057434588375,0.5773026315789473,48.87820512820513,1004.4871794871799,26.43387314439947,8
1349,4,0,0,45,0.0,0.0,1.0,45,1250,700,550,0.56,18,7,11,330.4589444832535,0.4513257575757576,0.14461691119143794,0.17022436099723348,126231.65155416762,-657.1243334063815,125574.52722076124,1148,3,259.44444444444446,38,7,17,40.469292650081506,0.5783991228070176,48.77136752136752,1004.9145299145302,26.445119208277113,0
1350,4,1,0,46,0.021739130434782608,0.0,1.0,46,1150,600,550,0.5217391304347826,17,6,11,325.7333179018299,0.4537238325281803,0.16198577729768648,0.16917117478127305,126567.38281250013,-954.5572916666517,125612.82552083347,1149,0,254.7826086956522,39,7,13,40.24327122153209,0.5801282051282051,48.43750000000001,1006.250000000001,25.801282051282076,0
1351,4,4,0,50,0.08,0.0,1.0,50,1550,1200,350,0.7741935483870968,19,12,7,315.101661219079,0.4589540816326531,0.2168472528526224,0.16809182735824907,127654.4483974068,-1954.089180149954,125700.35921725685,1150,0,235.32,42,8,16,39.3987518777767,0.5865575396825398,47.359496124031,1010.5620155038744,24.061000369139865,0
1352,4,1,1,50,0.0196078431372549,0.0196078431372549,0.9803921568627451,51,1500,1100,400,0.7333333333333333,19,11,8,314.6878025386356,0.45941176470588235,0.2290419161676649,0.16952536459339368,128048.66850321366,-2140.9291781451197,125907.73932506854,1151,0,231.68627450980392,43,8,18,39.007141966067856,0.5891472868217054,46.969696969696955,1012.1212121212096,23.537702607469992,0
1353,4,1,0,51,0.0196078431372549,0.0,1.0,51,1450,1100,350,0.7586206896551724,18,11,7,309.03670730512437,0.4590196078431372,0.2270247555585576,0.16718693916941788,128218.12466197906,-2275.142717460552,125942.98194451851,1152,0,232.49019607843138,42,9,19,38.97758802143129,0.5922619047619048,46.80232558139533,1012.7906976744155,24.114064230343224,0
1354,4,3,1,53,0.05555555555555555,0.018518518518518517,0.9814814814814815,54,1200,800,400,0.6666666666666666,16,8,8,298.16914875667135,0.46236606102958305,0.254264302710532,0.16422239269982786,128931.14028469361,-3111.342330617207,125819.7979540764,1153,0,220.5185185185185,46,8,17,38.52875494646181,0.5942028985507246,46.09929078014183,1015.60283687943,22.078322540857176,0
1355,4,1,2,52,0.018518518518518517,0.037037037037037035,0.962962962962963,54,1500,1100,400,0.7333333333333333,19,11,8,309.39263638806784,0.46273002562310733,0.2747419550698236,0.17157228017883747,129201.3888888888,-2804.0765995171378,126397.31228937166,1154,0,221.4814814814815,42,12,18,37.96960382513659,0.6021825396825398,45.83333333333333,1016.666666666666,24.206349206349188,0
1356,4,1,3,50,0.018867924528301886,0.05660377358490566,0.9433962264150944,53,1900,1400,500,0.7368421052631579,24,14,10,320.08295365680704,0.46170476536042576,0.27802030344746376,0.17795501306342634,129302.26836104789,-2322.509605694152,126979.75875535373,1155,0,226.49056603773585,41,12,20,37.59550981922227,0.6046747967479675,45.73412698412697,1017.0634920634902,24.806426635694883,0
1357,4,1,0,51,0.0196078431372549,0.0,1.0,51,1500,900,600,0.6,21,9,12,328.46561102089356,0.45934640522875814,0.27874933757286713,0.18313082696644342,129413.28125,-1698.4375000000011,127714.84375,1156,0,234.64705882352942,39,12,21,37.26965601965602,0.608974358974359,45.625,1017.5,26.08974358974359,0
1358,4,1,2,50,0.019230769230769232,0.038461538461538464,0.9615384615384616,52,1350,1000,350,0.7407407407407407,17,10,7,316.2281340294575,0.4595116892911011,0.15401861065856481,0.17427462149825318,128955.22072742031,-2241.368457424427,126713.85226999588,1157,0,231.1153846153846,42,10,17,38.045776887362464,0.5997023809523809,46.07558139534884,1015.6976744186054,24.18327796234775,8
1359,4,1,1,50,0.0196078431372549,0.0196078431372549,0.9803921568627451,51,1500,1200,300,0.8,18,12,6,319.87102129167005,0.4565196078431373,0.16874275578482667,0.17750204882478623,129227.86593967005,-1932.0458990243455,127295.8200406457,1158,0,235.72549019607843,39,12,20,37.67640354471879,0.6071047008547008,45.807291666666664,1016.7708333333326,26.07104700854699,0
1360,4,4,6,48,0.07407407407407407,0.1111111111111111,0.8888888888888888,54,1400,700,700,0.5,21,7,14,295.9061483834315,0.4594179478220359,0.17509537283387577,0.16742560782727056,129990.70443482959,-3106.9902650081112,126883.71416982148,1159,0,223.0,42,12,14,37.514253135689856,0.6101190476190477,45.05813953488372,1019.7674418604647,24.28017718715392,0
1361,4,0,1,47,0.0,0.020833333333333332,0.9791666666666666,48,1350,900,450,0.6666666666666666,18,9,9,328.78273516459166,0.4548611111111111,0.16899744916289428,0.1831000130166314,129368.65790435512,-1093.1637619267585,128275.49414242836,1160,2,247.79166666666666,37,11,21,37.306890852913696,0.6120495495495495,45.6688596491228,1017.3245614035081,27.49525841631103,0
1362,4,0,0,47,0.0,0.0,1.0,47,1800,1400,400,0.7777777777777778,22,14,8,330.9804699609399,0.45332254085723095,0.1674384318981399,0.18468593886221157,129445.8954840565,-831.1873356344563,128614.70814842204,1161,3,253.87234042553192,38,9,16,37.172572178477694,0.6110197368421053,45.592948717948715,1017.6282051282049,26.77968960863697,0
1363,4,0,1,46,0.0,0.02127659574468085,0.9787234042553191,47,1800,1300,500,0.7222222222222222,23,13,10,331.98148482474033,0.45293709528214615,0.1687614292763635,0.18575757891338537,129554.63927469144,-798.051697530856,128756.58757716058,1162,4,254.87234042553192,38,9,16,37.036721236925864,0.6121162280701755,45.486111111111114,1018.0555555555562,26.79093567251464,0
1364,4,0,2,44,0.0,0.043478260869565216,0.9565217391304348,46,1100,900,200,0.8181818181818182,13,9,4,336.06946744975585,0.45130837359098225,0.17471854335649906,0.18795595998816464,129536.03512619268,-493.37873191751197,129042.65639427517,1163,5,261.1304347826087,37,9,16,36.95156541720522,0.6137387387387387,45.50438596491228,1017.9824561403509,27.51303935514462,0
1365,4,0,2,42,0.0,0.045454545454545456,0.9545454545454546,44,1350,1200,150,0.8888888888888888,15,12,3,352.18581462800955,0.4488856589147287,0.1819267762953769,0.19617955073385354,129377.95380015454,313.0160108024975,129690.96981095705,1164,6,272.95454545454544,35,9,21,36.70221843003414,0.6160714285714286,45.659722222222236,1017.3611111111129,29.06746031746037,0
1366,4,1,2,41,0.023255813953488372,0.046511627906976744,0.9534883720930233,43,800,300,500,0.375,13,3,10,352.64075758111545,0.44552879291251385,0.16891398838795624,0.19731730939462427,129554.63927469142,537.2492283950694,130091.88850308649,978,0,252.88372093023256,35,8,19,36.51091405184174,0.6178571428571429,45.486111111111114,1018.0555555555561,29.087301587301603,0
1367,4,0,1,40,0.0,0.024390243902439025,0.975609756097561,41,1400,900,500,0.6428571428571429,19,9,10,360.30794269708895,0.4426321138211382,0.16213598786210448,0.20219576716782606,129669.02941476826,1144.1562439926834,130813.18565876094,979,1,262.0487804878049,33,8,19,36.19938936349416,0.6234217171717171,45.373774509803916,1018.5049019607835,30.86378490790253,0
1368,4,1,0,41,0.024390243902439025,0.0,1.0,41,650,200,450,0.3076923076923077,11,2,9,359.5299290344985,0.4430640243902439,0.16678984971667843,0.202564423431632,129825.097318339,1135.2016051518472,130960.29892349085,980,0,261.6585365853659,33,8,20,36.060505852172504,0.625,45.22058823529411,1019.1176470588227,30.882352941176446,0
1369,4,0,1,40,0.0,0.024390243902439025,0.975609756097561,41,1500,1000,500,0.6666666666666666,20,10,10,364.4841234721542,0.44174288617886176,0.1683126049463528,0.2068628435865137,130110.72137188185,1284.6584467119883,131395.37981859385,981,1,262.6585365853659,34,7,21,35.64396149358225,0.6256127450980392,44.940476190476176,1020.2380952380934,30.007002801120393,0
1370,4,0,0,40,0.0,0.0,1.0,40,900,500,400,0.5555555555555556,13,5,8,375.1777723669616,0.4395299145299145,0.17265765765765795,0.21290763155793843,130106.25608239618,1762.595065599771,131868.85114799594,982,2,269.85,33,7,21,35.375750750750754,0.6278409090909092,44.94485294117647,1020.220588235294,30.915775401069517,0
1371,4,0,0,40,0.0,0.0,1.0,40,1150,600,550,0.5217391304347826,17,6,11,379.3419408579759,0.438795405982906,0.18295918367346964,0.21613668723303284,130262.58680555562,1882.9063641388025,132145.4931696944,983,3,270.85,32,8,21,35.11054421768707,0.6318359375,44.79166666666667,1020.8333333333339,31.901041666666686,0
1372,4,0,0,40,0.0,0.0,1.0,40,750,500,250,0.6666666666666666,10,5,5,376.8368572920396,0.4381009615384615,0.15101016210984786,0.20412408010327654,128268.64216887738,1684.6315119185028,129953.27368079589,984,4,271.85,33,7,22,37.209149931446106,0.6092171717171717,46.75245098039216,1012.9901960784316,30.69667260843732,8
1373,4,0,0,40,0.0,0.0,1.0,40,1500,1300,200,0.8666666666666667,17,13,4,376.0279210268901,0.43775373931623934,0.14677750906892406,0.2043200333043615,128392.81316080347,1655.856521530172,130048.66968233365,985,5,272.85,33,7,20,37.10247883917775,0.610479797979798,46.62990196078431,1013.4803921568622,30.71152703505643,0
1374,4,0,0,40,0.0,0.0,1.0,40,850,500,350,0.5882352941176471,12,5,7,374.8080378502673,0.43772702991452994,0.1469448809379914,0.2041334362827689,128485.98082768645,1631.5156730584404,130117.49650074489,986,6,273.85,33,7,20,37.038030339659144,0.6114267676767677,46.53799019607843,1013.8480392156861,30.72266785502079,0
1375,4,0,0,40,0.0,0.0,1.0,40,1050,800,250,0.7619047619047619,13,8,5,375.51389901552557,0.4375267094017094,0.13040225417800233,0.19362670584507963,126272.75466918945,1516.5126115622224,127789.26728075168,987,7,274.85,31,9,17,39.294948611650916,0.59375,48.73046875,1005.078125,32.421875,8
1376,4,0,2,38,0.0,0.05,0.95,40,1350,1000,350,0.7407407407407407,17,10,7,377.86912606419725,0.4378205128205128,0.1309966325605496,0.1951523426315494,126338.19792005733,1547.8608873155151,127886.05880737284,988,8,275.85,31,9,17,39.1682046798774,0.5944220430107527,48.66536458333332,1005.3385416666652,32.43027553763436,0
1377,4,0,0,38,0.0,0.0,1.0,38,1750,1500,250,0.8571428571428571,20,15,5,381.2628880104372,0.43687766714082504,0.1318532900012659,0.19727585948091914,126415.27380332987,2039.4904757775416,128454.7642791074,989,9,283.1578947368421,30,8,19,39.00333021473759,0.5979166666666667,48.58870967741935,1005.6451612903226,33.52150537634409,0
1378,4,0,1,37,0.0,0.02631578947368421,0.9736842105263158,38,600,400,200,0.6666666666666666,8,4,4,379.5094168009668,0.4366850403034614,0.13774325161940726,0.19694219366158955,126534.62939792199,2004.216681586362,128538.84607950835,990,10,284.1578947368421,31,7,19,38.92425369915016,0.5964381720430108,48.47005208333333,1006.1197916666658,32.45547715053761,0
1379,4,1,0,38,0.02631578947368421,0.0,1.0,38,1100,800,300,0.7272727272727273,14,8,6,365.65873512106674,0.43747036510194404,0.14324213598945068,0.191493383450026,126906.72607891186,1680.9105872741134,128587.63666618598,991,0,284.05263157894734,33,5,20,38.889564582826566,0.5953282828282829,48.100490196078425,1007.5980392156855,30.533273915626832,0
1380,4,2,0,40,0.05,0.0,1.0,40,1300,1200,100,0.9230769230769231,14,12,2,349.84745332102705,0.44177350427350426,0.16045004712535293,0.1865267075244269,127632.7664399092,930.5348242237903,128563.301264133,992,0,270.8,34,6,18,38.54313933396166,0.6004901960784313,47.38095238095237,1010.4761904761897,29.71988795518205,0
1381,4,1,1,40,0.024390243902439025,0.024390243902439025,0.975609756097561,41,1250,800,450,0.64,17,8,9,338.2975030083351,0.4436229674796748,0.15778772539011854,0.1822804475543986,128056.65569540886,464.2493730709768,128520.90506847984,993,0,265.1707317073171,35,6,19,38.401586620926224,0.6026785714285714,46.96180555555555,1012.152777777777,28.918650793650773,0
1382,4,2,1,41,0.047619047619047616,0.023809523809523808,0.9761904761904762,42,1200,1000,200,0.8333333333333334,14,10,4,331.95849588926336,0.4465495547812621,0.16571652135032378,0.18130040929336702,128596.93877551028,137.82955601222412,128734.7683315225,994,0,259.76190476190476,34,8,17,38.011052425665085,0.6102941176470589,46.42857142857143,1014.2857142857149,29.831932773109262,0
1383,4,2,0,43,0.046511627906976744,0.0,1.0,43,1400,1000,400,0.7142857142857143,18,10,8,325.22637192968983,0.44659007013658175,0.18110872404283973,0.1796829653348488,129054.34355977799,-205.624812457133,128848.71874732086,995,0,254.67441860465115,35,8,19,37.7165442153624,0.612797619047619,45.97800925925926,1016.0879629629633,29.031084656084666,0
1384,4,0,0,43,0.0,0.0,1.0,43,1250,900,350,0.72,16,9,7,324.8454716474065,0.44615171650055374,0.18661837590545138,0.1801415797317438,129201.38888888905,-205.81905328358923,128995.56983560546,996,1,255.67441860465115,34,9,20,37.57684426229508,0.616421568627451,45.83333333333334,1016.666666666668,29.901960784313765,0
1385,4,4,4,43,0.0851063829787234,0.0851063829787234,0.9148936170212766,47,1250,1100,150,0.88,14,11,3,296.04866066074817,0.44900555041628126,0.1866118004393058,0.16787519014769595,130076.56385633691,-1698.201497395828,128378.36235894109,997,0,234.82978723404256,39,8,17,37.42394652643043,0.6156517094017093,44.973958333333336,1020.1041666666675,26.156517094017115,0
1386,4,0,1,42,0.0,0.023255813953488372,0.9767441860465116,43,1250,700,550,0.56,18,7,11,325.55031830574745,0.4442368032484312,0.19277567344520374,0.18161411158274954,129436.8355624143,-172.35939643346495,129264.47616598084,998,1,257.6279069767442,35,8,17,37.319912041249616,0.6166666666666667,45.601851851851855,1017.5925925925928,29.07407407407408,0
1387,4,1,0,43,0.023255813953488372,0.0,1.0,43,1150,700,450,0.6086956521739131,16,7,9,330.97383969659,0.44292174234034704,0.22395739780015433,0.186310337895702,129790.40745027439,-8.55409807955516,129781.85335219484,999,0,258.1860465116279,35,8,18,36.82322429198849,0.6202380952380953,45.25462962962963,1018.9814814814818,29.11375661375662,0
1388,4,0,1,42,0.0,0.023255813953488372,0.9767441860465116,43,1350,1000,350,0.7407407407407407,17,10,7,332.5768067722078,0.4429448135843485,0.22952638000517522,0.1874949654568544,129849.38298396782,36.97863082990341,129886.36161479773,1000,1,259.1860465116279,35,8,18,36.722594443182665,0.6208333333333333,45.19675925925926,1019.2129629629635,29.120370370370384,0
1389,4,0,0,42,0.0,0.0,1.0,42,1500,1200,300,0.8,18,12,6,339.61071927679274,0.4400043554006969,0.22699710725411681,0.19125445769798327,129807.25623582759,416.7871315192657,130224.04336734685,1001,2,266.1904761904762,34,8,18,36.58610786604361,0.6225490196078431,45.238095238095234,1019.0476190476185,29.97198879551819,0
1390,4,0,0,42,0.0,0.0,1.0,42,750,300,450,0.4,12,3,9,339.261902500871,0.43985917537746805,0.22967565404540258,0.19126378447008105,129849.38298396762,410.5897419410013,130259.97272590862,1002,3,267.1904761904762,35,7,18,36.55225603755016,0.6208333333333333,45.19675925925925,1019.2129629629617,29.120370370370335,0
1391,4,1,0,43,0.023255813953488372,0.0,1.0,43,1200,900,300,0.75,15,9,6,332.57079926093616,0.4429448135843485,0.21866572237233406,0.1892083586755723,130205.11379200163,60.483752333435746,130265.59754433508,1003,0,261.95348837209303,36,7,19,36.362361616830334,0.6223958333333333,44.84797297297298,1020.6081081081095,28.350225225225262,0
1392,4,0,0,43,0.0,0.0,1.0,43,1500,1200,300,0.8,18,12,6,331.8539191412799,0.44266795865633074,0.21968975979566752,0.1893753203243353,130323.35778061232,49.68877023052653,130373.04655084285,1004,1,262.95348837209303,34,9,21,36.260978974777515,0.6277573529411764,44.73214285714286,1021.0714285714292,30.031512605042035,0
1393,4,0,0,43,0.0,0.0,1.0,43,1100,700,400,0.6363636363636364,15,7,8,332.411667806551,0.4425987449243263,0.21950756857240372,0.19043771249104302,130475.34722222232,74.3055555555627,130549.65277777788,1005,2,263.95348837209303,34,9,21,36.09298531810766,0.6292892156862745,44.583333333333336,1021.6666666666674,30.04901960784316,0
1394,4,2,1,44,0.044444444444444446,0.022222222222222223,0.9777777777777777,45,1100,600,500,0.5454545454545454,16,6,10,316.38846482482563,0.4441077441077441,0.2245213190056281,0.18382819515055396,131019.23338190623,-709.4051775546104,130309.82820435162,1006,0,253.17777777777778,37,8,20,35.953620898932556,0.6286599099099099,44.05153508771931,1023.7938596491249,27.670104314841215,0
1395,4,1,0,45,0.022222222222222223,0.0,1.0,45,1000,700,300,0.7,13,7,6,318.0690786497032,0.44577020202020207,0.23108144130361707,0.18536949890666934,131136.55495516502,-657.9033576228774,130478.65159754214,1007,0,253.95555555555555,38,7,21,35.79239247592226,0.628015350877193,43.93696581196583,1024.252136752139,26.9540035987405,0
1396,4,2,1,46,0.0425531914893617,0.02127659574468085,0.9787234042553191,47,1050,600,450,0.5714285714285714,15,6,9,304.7478523923797,0.4476564909034844,0.23740481348093634,0.18003738438383796,131656.85609796218,-1375.291520563919,130281.56457739827,1008,0,244.10638297872342,38,9,14,35.61055590256092,0.6332236842105263,43.4294871794872,1026.2820512820538,27.00742240215931,0
1397,4,0,0,46,0.0,0.0,1.0,46,1200,700,500,0.5833333333333334,17,7,10,309.32865804660685,0.44660829307568434,0.23949275362318834,0.18278511611844955,131665.51246537405,-1054.4167436134076,130611.09572176065,1009,1,250.41304347826087,37,9,15,35.4843304843305,0.6351351351351351,43.42105263157895,1026.3157894736848,27.73826458036986,0
1398,4,1,1,46,0.02127659574468085,0.02127659574468085,0.9787234042553191,47,1000,600,400,0.6,14,6,8,300.60519982537215,0.44761794634597596,0.2393121113593044,0.1795624765058581,132076.58420138905,-1459.4184027777565,130617.1657986113,1010,0,246.06382978723406,39,8,16,35.29590595865424,0.6356837606837606,43.02083333333334,1027.916666666668,26.356837606837644,0
1399,4,0,1,45,0.0,0.021739130434782608,0.9782608695652174,46,1200,900,300,0.75,15,9,6,307.5269014278457,0.4451892109500805,0.2447183564106854,0.18343775148047936,132023.0523003473,-1079.8719618055452,130943.18033854176,1011,1,252.34782608695653,39,7,17,35.171717683627264,0.6351495726495726,43.07291666666667,1027.7083333333342,26.35149572649575,0
1400,4,1,1,45,0.021739130434782608,0.021739130434782608,0.9782608695652174,46,1650,1200,450,0.7272727272727273,21,12,9,307.9477354182337,0.4431662640901772,0.25229980621903736,0.18449515303120814,132188.9058781975,-1058.5451574790113,131130.36072071848,1012,0,253.2173913043478,40,6,18,34.994605856968754,0.63515625,42.91158536585366,1028.3536585365853,25.708841463414632,0
1401,4,0,0,45,0.0,0.0,1.0,45,1450,1000,450,0.6896551724137931,19,10,9,311.60117896440516,0.44080387205387206,0.2444444444444449,0.18733078003774586,132319.57250974953,-753.8130411791826,131565.75946857035,1013,1,254.9111111111111,40,5,21,34.76968918740947,0.6364583333333333,42.78455284552846,1028.8617886178865,25.721544715447163,0
1402,4,0,0,45,0.0,0.0,1.0,45,2050,1600,450,0.7804878048780488,25,16,9,310.8075691049516,0.440530303030303,0.24274252370532512,0.18738662147884289,132426.97934420916,-768.0455425983113,131658.93380161084,1014,2,255.9111111111111,36,9,21,34.682485412107965,0.6446759259259259,42.68018018018019,1029.27927927928,28.591091091091112,0
1403,4,0,0,45,0.0,0.0,1.0,45,1600,1300,300,0.8125,19,13,6,314.1260680669508,0.44059343434343434,0.24493049479926077,0.18997147925953697,132542.9145361579,-672.9630813245582,131869.95145483335,1015,3,256.9111111111111,36,9,21,34.480943788276456,0.6458333333333333,42.56756756756757,1029.7297297297307,28.60360360360363,0
1404,4,0,1,44,0.0,0.022222222222222223,0.9777777777777777,45,1250,1000,250,0.8,15,10,5,316.09894944221514,0.43977272727272726,0.24227055780231033,0.19190373513250333,132687.90486009658,-611.4985340069809,132076.4063260896,1016,4,257.9111111111111,36,9,14,34.28494006630962,0.6472800925925926,42.4268018018018,1030.2927927927926,28.61924424424424,0
1405,4,0,0,44,0.0,0.0,1.0,44,850,600,250,0.7058823529411765,11,6,5,315.73332016541156,0.43929483791402396,0.2402107835346472,0.1921270841857611,132774.93709926153,-415.70565497929,132359.23144428225,1017,5,262.3863636363636,36,8,15,34.20723157051282,0.6481481481481481,42.34234234234235,1030.6306306306315,28.62862862862865,0
1406,4,0,0,44,0.0,0.0,1.0,44,1050,900,150,0.8571428571428571,12,9,3,311.1527635102211,0.4387883192389006,0.23060580279021137,0.18986174142028614,132878.0384950177,-530.9262224915377,132347.11227252617,1018,6,263.3863636363636,37,7,15,34.222123258534516,0.647240990990991,42.24232456140351,1031.030701754386,27.865694642010432,0
1407,4,0,0,44,0.0,0.0,1.0,44,1200,900,300,0.75,15,9,6,357.93128536355204,0.43855708245243125,0.24123693163948956,0.2016719746652641,129826.69850107745,493.80741379939406,130320.50591487685,1019,7,264.3863636363636,38,6,15,36.09960862424433,0.6148574561403508,45.21901709401709,1019.1239316239312,26.819050832208717,8
1408,4,0,0,44,0.0,0.0,1.0,44,950,600,350,0.631578947368421,13,6,7,354.96588437066134,0.4386561839323467,0.2368095120138718,0.20041919932928098,129908.37191358021,422.6080246913507,130330.97993827156,1020,8,265.3863636363636,38,6,15,36.092188919164386,0.6156798245614035,45.138888888888886,1019.4444444444441,26.82748538011695,0
1409,4,0,0,44,0.0,0.0,1.0,44,1150,800,350,0.6956521739130435,15,8,7,354.26236341270044,0.4386451726568006,0.24037097004619246,0.20044067923972889,129990.07100819999,410.117955109938,130400.18896330992,1021,9,266.3863636363636,38,6,15,36.02715208660728,0.6165021929824561,45.05876068376068,1019.764957264957,26.835919928025184,0
1410,4,1,0,45,0.022222222222222223,0.0,1.0,45,1250,800,450,0.64,17,8,9,347.55619619513226,0.4399200336700337,0.24523673157693793,0.19831147665251656,130318.5595567866,59.1752843488444,130377.73484113545,1022,0,261.44444444444446,37,8,16,35.86501288659794,0.6216216216216216,44.73684210526315,1021.0526315789465,27.596017069701258,0
1411,4,0,0,45,0.0,0.0,1.0,45,1200,900,300,0.75,15,9,6,345.20042347279,0.43973063973063975,0.2408395216678869,0.19751413817015828,130426.23325525968,4.638190335304671,130430.87144559498,1023,1,262.44444444444446,38,7,17,35.81607572429662,0.6208881578947368,44.631410256410255,1021.4743589743588,26.88090418353576,0
1412,4,1,0,46,0.021739130434782608,0.0,1.0,46,1200,800,400,0.6666666666666666,16,8,8,321.879279277055,0.4411332528180354,0.17950410127067573,0.17584439444248942,128607.98306439609,-920.7510203913096,127687.23204400478,1024,0,257.7173913043478,40,6,15,38.25539358113749,0.59921875,46.417682926829265,1014.3292682926821,25.358231707317053,8
1413,4,0,1,45,0.0,0.021739130434782608,0.9782608695652174,46,1950,1200,750,0.6153846153846154,27,12,15,320.326520835166,0.43975442834138484,0.17370487123059575,0.17605916295526766,128848.62075617272,-945.2739197530983,127903.34683641962,1025,1,258.7173913043478,41,5,16,38.0500455996352,0.6001016260162602,46.18055555555555,1015.2777777777768,24.762872628726264,0
1414,4,0,0,45,0.0,0.0,1.0,45,1200,700,500,0.5833333333333334,17,7,10,324.82330940813506,0.4375420875420875,0.17309403078017982,0.1787243671589254,128891.61544054467,-626.5997835283185,128265.01565701635,1026,2,265.4,40,5,16,37.89218875100081,0.6020833333333333,46.13821138211382,1015.4471544715449,25.386178861788622,0
1415,4,1,2,44,0.021739130434782608,0.043478260869565216,0.9565217391304348,46,1200,700,500,0.5833333333333334,17,7,10,318.6248429288901,0.4394021739130434,0.17447100105651225,0.17657916525107292,129176.17517203651,-968.2522951310075,128207.9228769055,1027,0,260.60869565217394,41,5,17,37.760543736378125,0.6034044715447154,45.858134920634924,1016.5674603174613,24.794328300425885,0
1416,4,3,2,45,0.06382978723404255,0.0425531914893617,0.9574468085106383,47,1600,1100,500,0.6875,21,11,10,310.01156629653025,0.44270351526364476,0.20049519971841612,0.17474285392855857,129842.52467550016,-1349.4631106904708,128493.06156480969,1028,0,255.19148936170214,42,5,16,37.3045018064271,0.6086309523809523,45.20348837209302,1019.1860465116271,24.266334440753024,0
1417,4,0,0,45,0.0,0.0,1.0,45,1300,800,500,0.6153846153846154,18,8,10,318.963048568966,0.4392676767676768,0.2000776147867256,0.1788656244941023,129640.87106095906,-729.8705094520511,128911.00055150701,1029,1,267.5111111111111,40,5,16,37.280668928583296,0.6096354166666667,45.40142276422764,1018.3943089430893,25.459857723577233,0
1418,4,0,1,44,0.0,0.022222222222222223,0.9777777777777777,45,1800,1400,400,0.7777777777777778,22,14,8,316.3391624104894,0.43956228956228954,0.19376572144099824,0.17809841558057124,129796.16057117116,-788.0782561636713,129008.08231500749,1030,2,268.5111111111111,40,5,17,37.190211429141314,0.6111979166666667,45.24898373983739,1019.0040650406496,25.47510162601624,0
1419,4,0,0,44,0.0,0.0,1.0,44,1000,700,300,0.7,13,7,6,321.6958914803252,0.43854607117688515,0.19504651876086254,0.18093775241915253,129757.97661675354,-451.4784071180498,129306.4982096355,1031,3,273.90909090909093,39,5,17,37.09242834747639,0.6124465811965811,45.286458333333336,1018.8541666666672,26.124465811965827,0
1420,4,1,0,45,0.022222222222222223,0.0,1.0,45,1050,600,450,0.5714285714285714,15,6,9,317.87566833641114,0.4401304713804714,0.20589596271572952,0.1801534773061862,130055.18297846844,-731.724358021025,129323.45862044742,1032,0,268.8,40,5,18,36.88892763441932,0.6138020833333333,44.99491869918699,1020.0203252032516,25.50050813008129,0
1421,4,1,0,46,0.021739130434782608,0.0,1.0,46,1400,700,700,0.5,21,7,14,308.7578596987412,0.4421195652173913,0.2019430875665762,0.17639043388929204,130366.35068618196,-1149.507671524906,129216.84301465706,1033,0,263.9347826086956,40,6,19,36.80714498955119,0.6169270833333333,44.690040650406495,1021.2398373983724,25.53099593495931,0
1422,4,0,2,44,0.0,0.043478260869565216,0.9565217391304348,46,1500,1100,400,0.7333333333333333,19,11,8,355.89926798378906,0.44178743961352657,0.16479749667917676,0.19657086409478372,129042.5835503473,32.35817154761128,129074.94172189492,1034,1,264.9347826086956,39,7,13,36.94937119814093,0.6052350427350428,45.989583333333336,1016.0416666666673,26.052350427350444,8
1423,4,0,0,44,0.0,0.0,1.0,44,1300,1000,300,0.7692307692307693,16,10,6,362.56714481023414,0.4368943798449612,0.18051534452808382,0.19978937908252242,128950.68825263555,550.6565722145419,129501.3448248501,1035,3,277.8181818181818,37,7,13,36.87374050883442,0.6078265765765766,46.08004385964913,1015.6798245614044,27.450806069227145,0
1424,4,1,0,45,0.022222222222222223,0.0,1.0,45,1150,800,350,0.6956521739130435,15,8,7,354.71580270246824,0.43869949494949495,0.18223324111003314,0.19740242961432505,129340.77222077949,176.0866324253613,129516.85885320485,1036,0,272.6222222222222,37,8,14,36.6757168265603,0.6117680180180181,45.69627192982456,1017.2149122807018,27.492294926505455,0
1425,4,0,0,45,0.0,0.0,1.0,45,1100,700,400,0.6363636363636364,15,7,8,374.8496930006181,0.43956228956228954,0.21117312892262752,0.19775639280915963,127205.5903031407,805.07934740439,128010.6696505451,1037,1,273.6222222222222,36,9,18,38.350496762670254,0.5920138888888888,47.80405405405404,1008.7837837837816,28.02177177177171,8
1426,4,2,0,47,0.0425531914893617,0.0,1.0,47,1100,900,200,0.8181818181818182,13,9,4,362.7788758818672,0.4445536540240518,0.22905890683481167,0.19432382910140739,127820.21747616681,-125.90503780409648,127694.31243836271,1038,0,262.93617021276594,38,9,14,38.024300052826206,0.5945723684210527,47.19551282051281,1011.2179487179473,26.610998650472297,0
1427,4,0,0,47,0.0,0.0,1.0,47,950,500,450,0.5263157894736842,14,5,9,364.8009464740953,0.4440333024976873,0.23497289863279747,0.19580132433201405,127901.25739644941,-68.30004930969795,127832.95734713972,1039,1,263.93617021276594,38,9,14,37.89012991128008,0.5953947368421053,47.1153846153846,1011.538461538459,26.619433198380502,0
1428,4,0,2,45,0.0,0.0425531914893617,0.9574468085106383,47,1500,1100,400,0.7333333333333333,19,11,8,363.07335596523507,0.4432624113475177,0.22766766101207625,0.1953994788467444,128009.35057345293,-104.64309847324762,127904.70747497969,1040,2,264.93617021276594,38,9,15,37.82310142173423,0.5964912280701755,47.008547008547,1011.9658119658103,26.630679262258166,0
1429,4,0,1,44,0.0,0.022222222222222223,0.9777777777777777,45,1200,900,300,0.75,15,9,6,371.25167556777177,0.442276936026936,0.2284116912192169,0.1993397370965507,127916.59216226357,497.8498346319245,128414.44199689549,1041,3,274.2,36,9,15,37.71127871164052,0.5992476851851851,47.10022522522522,1011.5990990990987,28.099974974974963,0
1430,4,2,0,46,0.043478260869565216,0.0,1.0,46,1350,900,450,0.6666666666666666,18,9,9,361.2698765432099,0.445390499194847,0.24235748792270528,0.1963423242082663,128401.20525931347,77.70042001462173,128478.90567932809,1042,0,268.5652173913044,36,10,12,37.46782407407407,0.6041666666666667,46.62162162162163,1013.5135135135143,28.153153153153177,0
1431,4,0,0,46,0.0,0.0,1.0,46,850,700,150,0.8235294117647058,10,7,3,362.2276340279559,0.4450281803542673,0.24478135293606185,0.19714468933008833,128458.27880245117,106.22768038308897,128564.50648283426,1043,1,269.5652173913044,36,10,12,37.38521069391985,0.6047453703703703,46.56531531531532,1013.7387387387394,28.159409409409427,0
1432,4,1,0,47,0.02127659574468085,0.0,1.0,47,1400,1000,400,0.7142857142857143,18,10,8,353.87889875511746,0.4450932778291705,0.24921516985884584,0.19431855543741847,128811.51532202207,-283.2645621729854,128528.25075984908,1044,0,264.8085106382979,37,10,15,37.23626413192194,0.6064189189189189,46.21710526315789,1015.1315789473676,27.435988620199126,0
1433,4,2,2,47,0.04081632653061224,0.04081632653061224,0.9591836734693877,49,1150,1000,150,0.8695652173913043,13,10,3,324.64872277253926,0.4469777494331066,0.19748561857571523,0.17854807509816994,128873.80248685139,-1374.8835021690634,127498.91898468233,1045,0,254.9591836734694,41,8,16,37.91473294251748,0.6003556910569106,46.155753968253975,1015.3769841269855,24.76529229578013,8
1434,4,0,0,47,0.0,0.0,1.0,47,1650,1200,450,0.7272727272727273,21,12,9,334.6468871039624,0.4454209065679926,0.19691494820038624,0.18372585435651373,128804.55864800369,-779.1910807291458,128025.36756727454,1046,1,264.78723404255317,39,8,18,37.73142209680178,0.6028311965811965,46.22395833333334,1015.1041666666684,26.028311965812012,0
1435,4,0,2,45,0.0,0.0425531914893617,0.9574468085106383,47,1000,700,300,0.7,13,7,6,334.65418970305404,0.44468855997533147,0.192263968561871,0.18446653497990295,128963.21750217034,-768.3837890624819,128194.83371310786,1047,2,265.78723404255317,39,8,18,37.56975780261854,0.6044337606837606,46.06770833333334,1015.7291666666683,26.04433760683765,0
1436,4,0,0,45,0.0,0.0,1.0,45,1000,700,300,0.7,13,7,6,344.6039626518975,0.442276936026936,0.19658119658119655,0.1889605615110167,128755.8671899045,-126.04359033550048,128629.823599569,1048,3,278.24444444444447,37,8,19,37.528359982713916,0.6058558558558558,46.2719298245614,1014.9122807017537,27.43006164058794,0
1437,4,0,0,45,0.0,0.0,1.0,45,1200,700,500,0.5833333333333334,17,7,10,346.7096045767818,0.4425084175084175,0.19020609899469765,0.1909170248270006,128922.84765504759,-60.24209372115962,128862.60556132643,1049,4,279.24444444444447,37,8,20,37.304757791693646,0.607545045045045,46.10745614035087,1015.5701754385956,27.4478425794215,0
1438,4,1,0,46,0.021739130434782608,0.0,1.0,46,1500,1200,300,0.8,18,12,6,339.27962010128704,0.4437097423510467,0.1954881403752151,0.18881205972883236,129340.77222077922,-423.1618142120928,128917.61040656714,1050,0,274.1521739130435,37,9,21,37.068264704825545,0.6117680180180181,45.69627192982455,1017.2149122806998,27.492294926505398,0
1439,4,0,0,46,0.0,0.0,1.0,46,1200,700,500,0.5833333333333334,17,7,10,338.0365953087349,0.4435386473429952,0.19799424786637054,0.1887879469106906,129480.23069598337,-446.18873114804853,129034.04196483531,1051,1,275.1521739130435,37,9,16,36.958180708180706,0.6131756756756757,45.55921052631579,1017.7631578947367,27.507112375533424,0
1440,4,0,0,46,0.0,0.0,1.0,46,1350,800,550,0.5925925925925926,19,8,11,340.2653192783191,0.44308574879227053,0.20180983821497978,0.1904378233573955,129563.94184989601,-382.7767918975197,129181.1650579985,1052,2,276.1521739130435,37,9,16,36.81643780290791,0.6140202702702703,45.47697368421052,1018.092105263157,27.51600284495019,0
1441,4,1,2,45,0.02127659574468085,0.0425531914893617,0.9574468085106383,47,1400,800,600,0.5714285714285714,20,8,12,340.3766528332868,0.44210607462226337,0.2145451383547261,0.1923158317340468,129935.60209155137,-554.5909352399992,129381.01115631136,1053,0,271.25531914893617,38,9,18,36.43639316776694,0.615953947368421,45.112179487179475,1019.55128205128,26.830296896086317,0
1442,4,0,0,45,0.0,0.0,1.0,45,1150,700,450,0.6086956521739131,16,7,9,351.3562796239096,0.4390993265993266,0.21413203654582968,0.1977034588331552,129774.47041636237,119.41502313124528,129893.88543949362,1054,1,282.1777777777778,36,9,19,36.32018125552609,0.6180555555555556,45.270270270270274,1018.9189189189193,28.303303303303313,0
1443,4,0,3,42,0.0,0.06666666666666667,0.9333333333333333,45,1450,900,550,0.6206896551724138,20,9,11,385.692461807049,0.4396043771043771,0.2432751297781972,0.20381105400726576,127272.13718820842,1017.0274840822397,128289.16467229066,1055,2,283.1777777777778,34,11,20,38.0085437313198,0.5968137254901961,47.73809523809523,1009.0476190476174,29.677871148459335,8
1444,4,2,1,43,0.045454545454545456,0.022727272727272728,0.9772727272727273,44,1000,600,400,0.6,14,6,8,380.15576929220106,0.44434901338971106,0.23035430504054455,0.19587240676464243,126241.80768606468,812.8227752021465,127054.63046126683,1056,0,268.72727272727275,36,8,18,39.210275661138496,0.5821759259259259,48.761261261261275,1004.9549549549569,27.915415415415467,8
1445,4,1,1,43,0.022727272727272728,0.022727272727272728,0.9772727272727273,44,1050,700,350,0.6666666666666666,14,7,7,364.66448416519336,0.44581351303735023,0.21006085964244958,0.17786696268465538,123960.50347222207,274.9691837107203,124235.4726559328,1057,0,267.9318181818182,34,10,16,41.963040446304035,0.5628063725490196,51.04166666666666,995.8333333333321,29.289215686274474,8
1446,4,5,3,45,0.10416666666666667,0.0625,0.9375,48,1350,1000,350,0.7407407407407407,17,10,7,337.46114270339916,0.454223921394799,0.20998227727837482,0.16895282896489605,125054.83057286852,-1155.4305170821883,123899.40005578633,1058,0,245.97916666666666,37,11,15,41.50679675509756,0.5681306306306306,49.945175438596486,1000.2192982456136,27.032954006638203,0
1447,4,1,2,44,0.021739130434782608,0.043478260869565216,0.9565217391304348,46,1150,800,350,0.6956521739130435,15,8,7,349.72202836495757,0.45126811594202904,0.2205570545057458,0.17474293133666075,124971.8484320471,-458.91833556527484,124512.93009648182,1059,0,257.60869565217394,36,10,17,41.28608702181175,0.5691550925925926,50.02815315315316,999.887387387389,27.774649649649696,0
1448,4,2,3,43,0.043478260869565216,0.06521739130434782,0.9347826086956522,46,1850,1400,450,0.7567567567567568,23,14,9,348.22366777805854,0.45259661835748793,0.2244148703592952,0.17545037565218313,125318.48965031288,-472.2240083121503,124846.26564200074,1060,0,257.0869565217391,35,11,13,40.96503776056719,0.574702380952381,49.68171296296296,1001.2731481481478,28.607804232804224,0
1449,4,2,1,44,0.044444444444444446,0.022222222222222223,0.9777777777777777,45,1500,1000,500,0.6666666666666666,20,10,10,346.7464946323303,0.4503367003367003,0.2358523996610431,0.17507258836337136,125405.4207926097,-303.22198645405325,125102.19880615565,1061,0,263.26666666666665,35,10,14,40.91219859795086,0.575595238095238,49.594907407407405,1001.62037037037,28.617724867724856,0
1450,4,5,4,45,0.10204081632653061,0.08163265306122448,0.9183673469387755,49,1150,700,450,0.6086956521739131,16,7,9,318.9992854708481,0.4551799886621315,0.2553296653269339,0.16518477851609237,126446.46819526597,-1731.1124928724519,124715.35570239353,1062,0,242.6734693877551,38,11,14,40.536700658593574,0.580592105263158,48.55769230769229,1005.7692307692283,26.467611336032324,0
1451,4,6,4,47,0.11764705882352941,0.0784313725490196,0.9215686274509804,51,1100,500,600,0.45454545454545453,17,5,12,306.985001027527,0.45789215686274515,0.26863850655042554,0.16252532143952003,127348.32523630103,-2381.1948492960664,124967.13038700496,1063,0,233.64705882352942,40,11,16,39.916221976104175,0.5864583333333333,47.662601626016254,1009.349593495934,25.23373983739835,0
1452,4,2,1,48,0.04081632653061224,0.02040816326530612,0.9795918367346939,49,1450,1200,250,0.8275862068965517,17,12,5,321.9690685979438,0.45502054988662133,0.2852735886352,0.17040010033864292,127334.51727892834,-1600.4448142669294,125734.07246466141,1064,0,244.10204081632654,38,11,18,39.55223880597015,0.5896381578947368,47.67628205128205,1009.2948717948718,26.560391363022944,0
1453,4,1,2,47,0.02040816326530612,0.04081632653061224,0.9591836734693877,49,1150,500,650,0.43478260869565216,18,5,13,326.33819634465,0.45634920634920634,0.29582558335239373,0.1739857193363982,127631.22420374044,-1469.8112992183244,126161.4129045221,1065,0,244.55102040816325,38,11,19,39.13860400366535,0.5926535087719298,47.382478632478644,1010.4700854700872,26.591318038686506,0
1454,4,0,0,47,0.0,0.0,1.0,47,1950,1400,550,0.717948717948718,25,14,11,334.9023138622296,0.45432469935245146,0.28937832086158854,0.17886034352155483,127700.83703639593,-846.538838873488,126854.29819752244,1066,1,244.17021276595744,37,10,19,38.85107036956679,0.5951576576576576,47.313596491228076,1010.7456140350887,27.31744902797537,0
1455,4,2,1,48,0.04081632653061224,0.02040816326530612,0.9795918367346939,49,1050,600,450,0.5714285714285714,15,6,9,321.6271430860438,0.4562783446712018,0.29367088607594893,0.17403112536847576,128225.67389875086,-1551.0590992039401,126674.61479954692,1067,0,235.16326530612244,38,11,22,38.6511075949367,0.5986842105263157,46.794871794871796,1012.8205128205132,26.653171390013505,0
1456,4,2,1,49,0.04,0.02,0.98,50,1950,1700,250,0.8717948717948718,22,17,5,316.5284109725326,0.4557312925170068,0.30151160402546706,0.17297158619812145,128619.58007812501,-1857.6497395833353,126761.93033854169,1068,0,231.32,39,11,20,38.37928732799342,0.6009615384615384,46.40625,1014.3750000000001,26.009615384615387,0
1457,4,0,1,48,0.0,0.02040816326530612,0.9795918367346939,49,1600,1200,400,0.75,20,12,8,325.77114884439806,0.454187925170068,0.30329359466558947,0.17795577026057027,128604.67916757964,-1420.86118416248,127183.81798341716,1069,1,236.9387755102041,38,11,21,38.16006600660066,0.6025219298245614,46.42094017094016,1014.3162393162379,26.692532613585207,0
1458,4,3,2,49,0.058823529411764705,0.0392156862745098,0.9607843137254902,51,1000,700,300,0.7,13,7,6,308.3345346887769,0.4586274509803922,0.2950050874817347,0.17142329987143923,129302.26836104806,-2226.3290501385777,127075.93931090948,1070,0,224.13725490196077,41,10,25,37.894232019768516,0.6046747967479675,45.73412698412698,1017.0634920634916,24.806426635694915,0
1459,4,1,2,48,0.02,0.04,0.96,50,1100,800,300,0.7272727272727273,14,8,6,307.2493483715943,0.45960034013605444,0.2756069026031007,0.1713679481374356,129428.42306193302,-2046.6402706916151,127381.7827912414,1071,0,217.2,41,9,17,37.794006532124435,0.6059451219512195,45.610119047619044,1017.5595238095231,24.818524970963978,0
1460,4,1,1,48,0.02040816326530612,0.02040816326530612,0.9795918367346939,49,1350,1000,350,0.7407407407407407,17,10,7,316.3041517650004,0.45796130952380953,0.27886470551083575,0.17690779945449517,129537.3963600535,-1605.356744497328,127932.03961555618,1072,0,222.42857142857142,40,9,19,37.45320455226116,0.60859375,45.5030487804878,1017.9878048780485,25.449695121951212,0
1461,4,0,2,46,0.0,0.041666666666666664,0.9583333333333334,48,1450,1200,250,0.8275862068965517,17,12,5,322.21400958915774,0.4571605348699764,0.27991261722080174,0.18049524032859682,129598.82948133671,-1248.2883029513964,128350.54117838532,1073,1,227.97916666666666,39,9,20,37.24051577152599,0.610844017094017,45.44270833333333,1018.2291666666658,26.10844017094015,0
1462,4,1,0,47,0.02127659574468085,0.0,1.0,47,1350,1000,350,0.7407407407407407,17,10,7,338.7214887119242,0.4552304964539007,0.30159474043624424,0.19018672988100602,129690.6332182773,-614.1991288626064,129076.4340894147,1074,0,233.68085106382978,38,9,22,36.72710824417873,0.6134868421052632,45.352564102564095,1018.5897435897424,26.80499325236164,0
1463,4,0,0,47,0.0,0.0,1.0,47,1250,500,750,0.4,20,5,15,340.6847039278513,0.4546330558125193,0.30358624381105326,0.19208818412953285,129853.92011834307,-552.1511341223002,129301.76898422078,1075,1,234.68085106382978,38,9,22,36.511399371069196,0.6151315789473684,45.192307692307686,1019.2307692307681,26.821862348178108,0
1464,4,0,1,46,0.0,0.02127659574468085,0.9787234042553191,47,1100,800,300,0.7272727272727273,14,8,6,344.66343325770634,0.45388143694110394,0.3156585581127891,0.19514573747793976,130017.3097468771,-437.5575279421389,129579.75221893497,1076,2,235.68085106382978,38,9,22,36.24423842447097,0.6167763157894737,45.032051282051285,1019.8717948717951,26.838731443994607,0
1465,4,2,0,48,0.041666666666666664,0.0,1.0,48,2050,1700,350,0.8292682926829268,24,17,7,361.7171182346832,0.4538545360520094,0.33159575591216206,0.19466957635902943,128009.35057345309,-248.52767276646262,127760.82290068663,1077,0,231.54166666666666,38,10,19,37.857413077139626,0.5964912280701755,47.008547008547005,1011.9658119658116,26.630679262258198,8
1466,4,0,0,48,0.0,0.0,1.0,48,2050,1400,650,0.6829268292682927,27,14,13,351.65320003181887,0.4537067819148936,0.256777886901685,0.18416575007622002,126908.26958550353,-654.7306049365552,126253.53898056697,1078,1,232.54166666666666,39,9,16,39.240777593990146,0.5836004273504274,48.098958333333336,1007.6041666666672,25.836004273504287,8
1467,4,1,1,48,0.02040816326530612,0.02040816326530612,0.9795918367346939,49,1350,700,650,0.5185185185185185,20,7,13,342.87028594040936,0.45477253401360546,0.25960638547964265,0.1811189650530222,127257.91229032006,-1073.0098819468546,126184.90240837321,1079,0,228.77551020408163,37,12,17,39.103365210461476,0.5906531531531531,47.75219298245614,1008.9912280701751,27.270033191085815,0
1468,4,2,3,47,0.04,0.06,0.94,50,1600,1200,400,0.75,20,12,8,339.9473808862255,0.45721938775510207,0.26830691185795774,0.18172780327375498,127739.20323800117,-1315.0784845496614,126424.1247534515,1080,0,225.12,38,12,15,38.684342633692644,0.59375,47.275641025641015,1010.8974358974347,26.60256410256407,0
1469,4,1,3,45,0.020833333333333332,0.0625,0.9375,48,2150,1600,550,0.7441860465116279,27,16,11,350.58853874732756,0.45481493794326244,0.2851985894580551,0.18784517171545356,127831.1673159646,-636.771568866167,127194.39574709843,1081,0,234.875,36,12,17,38.32126948775056,0.5983796296296297,47.18468468468468,1011.2612612612611,28.090590590590587,0
1470,4,0,0,45,0.0,0.0,1.0,45,1400,900,500,0.6428571428571429,19,9,10,372.79200765224743,0.4518728956228956,0.30405498281786913,0.1986858502322419,127617.7300347223,514.9739583333389,128132.70399305565,1082,1,250.44444444444446,33,12,17,37.97895189003435,0.6025883838383839,47.395833333333336,1010.4166666666674,30.618686868686893,0
1471,4,0,1,44,0.0,0.022222222222222223,0.9777777777777777,45,1250,900,350,0.72,16,9,7,375.7381503178386,0.45176767676767676,0.3088802672701798,0.2007181518019126,127710.61610918869,597.1501345636157,128307.76624375231,1083,2,251.44444444444446,33,12,18,37.8091658583899,0.6035353535353536,47.303921568627445,1010.7843137254896,30.6298276886512,0
1472,4,0,0,44,0.0,0.0,1.0,44,1600,1300,300,0.8125,19,13,6,380.0135915169393,0.45092274489076817,0.31842876119758823,0.2032577706931285,127761.29548324157,910.205750688712,128671.50123393028,1084,3,257.90909090909093,32,12,19,37.64908829773948,0.6064453125,47.25378787878788,1010.984848484849,31.59327651515153,0
1473,4,1,0,45,0.022222222222222223,0.0,1.0,45,1300,800,500,0.6153846153846154,18,8,10,369.95116345877614,0.45288299663299664,0.30729082593489343,0.19946453068991452,128082.49831795465,476.85385428681604,128559.35217224147,1085,0,253.15555555555557,33,12,20,37.57415254237287,0.6073232323232323,46.93627450980392,1012.2549019607845,30.67439096850862,0
1474,4,2,3,44,0.0425531914893617,0.06382978723404255,0.9361702127659575,47,1250,500,750,0.4,20,5,15,355.06975630978235,0.4549992291088498,0.29818189080360735,0.19436477411870745,128687.51594387747,-261.3759964770346,128426.13994740044,1086,0,243.3404255319149,34,13,17,37.33256091360631,0.6112132352941176,46.33928571428571,1014.6428571428565,29.842436974789898,0
1475,4,1,0,45,0.022222222222222223,0.0,1.0,45,1600,1200,400,0.75,20,12,8,369.71951889247674,0.45128367003367004,0.3174437109920982,0.20125274692797923,128464.332800862,499.15426359553305,128963.48706445753,1087,0,255.11111111111111,32,13,18,37.189147673018645,0.6136067708333333,46.559343434343425,1013.762626262625,31.68008207070703,0
1476,4,1,1,45,0.021739130434782608,0.021739130434782608,0.9782608695652174,46,750,600,150,0.8,9,6,3,342.70093948128044,0.4526167471819646,0.19368338156111475,0.1874589931632625,128658.86843450936,-381.69698297904483,128277.17145153032,1088,0,250.54347826086956,38,8,16,37.67551249648975,0.6030701754385965,46.36752136752136,1014.5299145299138,26.698155645524047,8
1477,4,1,2,44,0.021739130434782608,0.043478260869565216,0.9565217391304348,46,1400,900,500,0.6428571428571429,19,9,10,341.86598418471135,0.451298309178744,0.21394075761109654,0.1884127485011044,128957.11343277451,-382.7898997370144,128574.32353303749,1089,0,251.34782608695653,38,8,18,37.39284211633533,0.6060855263157895,46.07371794871795,1015.7051282051284,26.72908232118759,0
1478,4,0,0,44,0.0,0.0,1.0,44,1000,700,300,0.7,13,7,6,355.38174285961463,0.4491719520789288,0.22443496844694422,0.19565522326666718,128915.32368517177,362.83048250954783,129278.15416768132,1090,1,263.1363636363636,36,8,18,37.09225068381753,0.609375,46.11486486486487,1015.5405405405414,28.209459459459485,0
1479,4,0,0,44,0.0,0.0,1.0,44,1650,1300,350,0.7878787878787878,20,13,7,357.0495622347894,0.44880857998590556,0.23093175522538423,0.19757034329668768,129115.5360385724,420.12912405649433,129535.6651626289,1091,2,264.1363636363636,36,8,20,36.845798707294556,0.611400462962963,45.917792792792795,1016.3288288288293,28.23135635635637,0
1480,4,1,0,45,0.022222222222222223,0.0,1.0,45,1100,900,200,0.8181818181818182,13,9,4,347.86313405568114,0.4498526936026936,0.23600905021887764,0.19403032588439112,129430.4693206721,4.846273638512685,129435.31559431061,1092,0,259.24444444444447,36,9,16,36.75875202892135,0.6145833333333333,45.60810810810811,1017.5675675675682,28.26576576576578,0
1481,4,0,1,44,0.0,0.022222222222222223,0.9777777777777777,45,1300,1100,200,0.8461538461538461,15,11,4,349.28274388566456,0.44953703703703707,0.2403314034246664,0.19524840581215347,129516.42679419288,47.57058578850058,129563.99737998139,1093,1,260.24444444444447,36,9,16,36.635228823247424,0.6154513888888888,45.52364864864865,1017.9054054054058,28.27515015015016,0
1482,4,0,0,44,0.0,0.0,1.0,44,1300,800,500,0.6153846153846154,18,8,10,360.77349241597415,0.44650722339675825,0.2470399528872087,0.20232287825163509,129643.02722318663,554.3535397376432,130197.38076292427,1094,2,266.8636363636364,35,9,18,36.21398738493011,0.61875,45.39930555555555,1018.4027777777769,29.097222222222197,0
1483,4,0,0,44,0.0,0.0,1.0,44,900,600,300,0.6666666666666666,12,6,6,357.75229157069293,0.44627598661028894,0.23785021635186387,0.20123280656209633,129760.92470689717,484.4536340449135,130245.37834094209,1095,3,267.8636363636364,35,9,18,36.17102597599305,0.6199404761904762,45.28356481481481,1018.8657407407399,29.11044973544971,0
1484,4,0,1,43,0.0,0.022727272727272728,0.9772727272727273,44,1250,800,450,0.64,17,8,9,360.28300124890325,0.44597868217054265,0.23676757359086276,0.20388269261426356,129996.88042534703,567.1332465277528,130564.01367187478,1096,4,268.8636363636364,35,9,19,35.86674327545114,0.6223214285714286,45.05208333333332,1019.791666666665,29.136904761904717,0
1485,4,0,3,40,0.0,0.06976744186046512,0.9302325581395349,43,1450,1000,450,0.6896551724137931,19,10,9,363.8179262453236,0.44462901439645625,0.23515413737155266,0.20650708434336928,130114.93866008647,867.6294313700167,130982.56809145649,1097,5,275.2093023255814,35,8,19,35.65666950274155,0.6235119047619048,44.93634259259259,1020.2546296296287,29.150132275132247,0
1486,4,2,1,41,0.047619047619047616,0.023809523809523808,0.9761904761904762,42,1000,800,200,0.8,12,8,4,345.5484507963175,0.44513404955478125,0.17751448782198054,0.18685512245636907,128200.04712988589,459.86553554937547,128659.91266543526,1098,0,257.0238095238095,37,5,17,38.07158582358884,0.6002252252252251,46.82017543859648,1012.7192982456122,27.370791844476006,8
1487,4,2,2,41,0.046511627906976744,0.046511627906976744,0.9534883720930233,43,1300,900,400,0.6923076923076923,17,9,8,335.91527840176866,0.44652085640457734,0.20227810057123818,0.1845009812354684,128821.50472094378,54.62232449411243,128876.12704543788,1099,0,251.6046511627907,38,5,17,37.68197923244228,0.6047149122807017,46.207264957264954,1015.1709401709397,26.715024741340518,0
1488,4,1,0,42,0.023809523809523808,0.0,1.0,42,1650,1400,250,0.8484848484848485,19,14,5,345.45660799528474,0.444904181184669,0.2213864397722829,0.1910317328699464,129089.93632656205,518.9943059402867,129608.93063250234,1100,0,256.6904761904762,37,5,19,37.166414904330296,0.6092342342342343,45.94298245614035,1016.2280701754388,27.465623518255104,0
1489,4,1,0,43,0.023255813953488372,0.0,1.0,43,1150,900,250,0.782608695652174,14,9,5,340.52512506667557,0.4458979328165375,0.2256701273831072,0.18963938237506692,129368.6579043552,210.70377423822967,129579.36167859343,1101,0,251.69767441860466,37,6,21,37.00824531148956,0.6120495495495495,45.66885964912281,1017.3245614035088,27.49525841631105,0
1490,4,0,1,42,0.0,0.023255813953488372,0.9767441860465116,43,1200,700,500,0.5833333333333334,17,7,10,338.11124364725333,0.4455749354005168,0.21854314334251024,0.1890565686309293,129527.44904668008,158.9373767258651,129686.38642340594,1102,1,252.69767441860466,38,5,17,36.90832283795129,0.611842105263158,45.512820512820525,1017.9487179487201,26.788124156545265,0
1491,4,1,1,42,0.023255813953488372,0.023255813953488372,0.9767441860465116,43,1000,500,500,0.5,15,5,10,344.4107756242666,0.44382152085640453,0.23295329811055576,0.19338117401659372,129690.63321827765,333.3703155818682,130024.00353385952,1103,0,253.65116279069767,38,5,18,36.58223201174743,0.6134868421052632,45.35256410256411,1018.5897435897452,26.804993252361715,0
1492,4,0,1,41,0.0,0.023809523809523808,0.9761904761904762,42,1050,700,350,0.6666666666666666,14,7,7,352.7160355070034,0.4442750677506775,0.2334461017991698,0.1981095507775132,129703.52055440159,749.7023122499511,130453.22286665154,1104,1,255.38095238095238,37,5,18,36.357642626480114,0.615427927927928,45.33991228070177,1018.6403508771948,27.530820293978238,0
1493,4,1,0,42,0.023809523809523808,0.0,1.0,42,1750,1300,450,0.7428571428571429,22,13,9,347.6703303896723,0.4437548393341076,0.2246577236896692,0.19625325207242178,129899.0569814752,632.4096116112773,130531.46659308647,1105,0,256.07142857142856,37,5,19,36.2875793266645,0.6173986486486487,45.14802631578948,1019.4078947368431,27.551564722617382,0
1494,4,1,1,42,0.023255813953488372,0.023255813953488372,0.9767441860465116,43,1200,700,500,0.5833333333333334,17,7,10,337.3999037281737,0.44372923588039864,0.21935863712763592,0.1917151657146865,130156.27170138908,182.94270833335457,130339.21440972244,1106,0,251.09302325581396,39,4,20,36.2886212059344,0.6164529914529915,44.89583333333334,1020.4166666666682,26.164529914529954,0
1495,4,0,0,42,0.0,0.0,1.0,42,800,400,400,0.5,12,4,8,343.28371412819195,0.4437790360046458,0.2151781663351131,0.19504478010936133,130153.54624379077,535.9185523047832,130689.46479609555,1107,1,251.33333333333334,38,4,20,36.14128538023944,0.6181469298245614,44.89850427350428,1020.4059829059839,26.852789023841684,0
1496,4,1,0,43,0.023255813953488372,0.0,1.0,43,1250,900,350,0.72,16,9,7,336.8344445607323,0.44541343669250644,0.22260098772949455,0.19316678085301334,130514.55886667053,192.45110278267597,130707.00996945321,1108,0,246.46511627906978,37,6,16,35.94035035948062,0.6235923423423424,44.54495614035088,1021.8201754385966,27.61676149834045,0
1497,4,0,0,43,0.0,0.0,1.0,43,1150,600,550,0.5217391304347826,17,6,11,335.86604495101597,0.444905869324474,0.22647259683036536,0.19325930151150178,130644.58832137125,175.8162347505372,130820.4045561218,1109,1,247.46511627906978,38,5,17,35.83359459365311,0.6230811403508771,44.417735042735046,1022.3290598290605,26.903396311291065,0
1498,4,1,1,43,0.022727272727272728,0.022727272727272728,0.9772727272727273,44,1350,900,450,0.6666666666666666,18,9,9,333.020892054461,0.4448555320648344,0.22961457726486723,0.19383827056171743,131088.00048828125,-68.99142795138914,131019.00906032986,1110,0,242.8181818181818,39,5,19,35.458519818261955,0.625801282051282,43.984375,1024.0625,26.25801282051282,0
1499,4,1,2,42,0.022727272727272728,0.045454545454545456,0.9545454545454546,44,1400,900,500,0.6428571428571429,19,9,10,339.0831601033845,0.4457584566596195,0.23758937185000883,0.19820147845347383,131250.01161882796,100.9337406636146,131350.94535949157,1111,0,243.70454545454547,40,4,20,35.13979800985155,0.62578125,43.82621951219512,1024.6951219512187,25.617378048780466,0
1500,4,1,0,43,0.023255813953488372,0.0,1.0,43,1300,900,400,0.6923076923076923,17,9,8,340.07535197303196,0.4445136581764489,0.24465872565702407,0.19918699186991845,131328.12499999977,332.3381419789514,131660.46314197872,1112,0,250.02325581395348,37,6,21,35.035569105691046,0.6317567567567568,43.749999999999986,1024.9999999999982,27.702702702702652,0
1501,4,0,0,43,0.0,0.0,1.0,43,1000,600,400,0.6,14,6,8,342.50147741674726,0.4436138796603913,0.2476542804719779,0.20149426539347506,131496.76462950138,407.56723222529695,131904.33186172668,1113,1,251.02325581395348,37,6,21,34.803292709001504,0.6334459459459459,43.58552631578947,1025.657894736842,27.720483641536273,0
1502,4,0,0,43,0.0,0.0,1.0,43,1400,1000,400,0.7142857142857143,18,10,8,342.4469356202773,0.44282945736434104,0.24617226841695983,0.20250447026793536,131693.64762474992,419.6172139504442,132113.26483870036,1114,2,252.02325581395348,37,6,16,34.60623419862549,0.6354166666666667,43.39364035087719,1026.4254385964912,27.74122807017544,0
1503,4,0,0,43,0.0,0.0,1.0,43,1350,800,550,0.5925925925925926,19,8,11,341.6317619943487,0.44227574750830567,0.24898595943837765,0.20314096422855074,131903.67408366225,412.4969181459804,132316.17100180822,1115,3,253.02325581395348,38,5,16,34.415626625065016,0.6356907894736843,43.189102564102576,1027.2435897435912,27.03272604588398,0
1504,4,0,1,42,0.0,0.023255813953488372,0.9767441860465116,43,800,600,200,0.75,10,6,4,345.8363769174579,0.44130675526024365,0.2561282212445002,0.20638622493461203,132040.89506172843,532.9089506172871,132573.8040123457,1116,4,254.02325581395348,38,5,16,34.16948198198198,0.6370614035087719,43.05555555555556,1027.777777777778,27.046783625731003,0
1505,4,0,1,41,0.0,0.023809523809523808,0.9761904761904762,42,1400,1100,300,0.7857142857142857,17,11,6,357.30548274424154,0.43931475029036005,0.26027867128069926,0.21286139089614028,131975.16453379884,1031.089974799941,133006.2545085988,1117,5,260.95238095238096,37,5,16,33.94103706470316,0.6382319819819819,43.11951754385965,1027.5219298245613,27.770862968231388,0
1506,4,1,0,42,0.023809523809523808,0.0,1.0,42,1050,600,450,0.5714285714285714,15,6,9,357.43632012590706,0.44047619047619047,0.26085830107592445,0.21341452642421982,132059.67821829786,1040.5850838719557,133100.26330216983,1118,0,256.3333333333333,37,5,17,33.85249982220327,0.6390765765765766,43.03728070175438,1027.850877192982,27.77975343764816,0
1507,4,0,0,42,0.0,0.0,1.0,42,1000,800,200,0.8,12,8,4,361.4284798440324,0.4405850754936121,0.26020353753104075,0.21628046301834702,132144.21895439003,1152.1368353724527,133296.35578976249,1119,1,257.3333333333333,37,5,17,33.664707084710834,0.6399211711711712,42.95504385964914,1028.1798245614054,27.788643907065012,0
1508,4,1,0,43,0.023255813953488372,0.0,1.0,43,1150,600,550,0.5217391304347826,17,6,11,351.4484148834799,0.44119139904023624,0.25966617474937626,0.21188908390732286,132426.97934420948,708.7373243363402,133135.71666854582,1120,0,252.32558139534885,36,7,18,33.636715900802336,0.6446759259259259,42.6801801801802,1029.2792792792825,28.59109109109118,0
1509,4,0,0,43,0.0,0.0,1.0,43,700,200,500,0.2857142857142857,12,2,10,354.40390325225053,0.4404300479881875,0.25925756373476516,0.2143299795858853,132542.9145361581,794.7452520088043,133337.6597881669,1121,1,253.32558139534885,36,7,18,33.44406167979003,0.6458333333333333,42.567567567567586,1029.7297297297323,28.603603603603673,0
1510,4,0,1,42,0.0,0.023255813953488372,0.9767441860465116,43,600,200,400,0.3333333333333333,10,2,8,355.20107519906577,0.44003783684016246,0.2600022887077691,0.21497775199837618,132571.90626014562,817.9367289587226,133389.84298910433,1122,2,254.32558139534885,36,7,18,33.39438673227629,0.6461226851851851,42.53941441441443,1029.842342342345,28.60673173173181,0
1511,4,0,0,42,0.0,0.0,1.0,42,1500,1000,500,0.6666666666666666,20,10,10,363.25494943827107,0.4379113433991482,0.267588860878734,0.21970627363373912,132546.9409749017,1229.666468407103,133776.6074433088,1123,3,260.8333333333333,35,7,18,33.21215484620287,0.6479166666666667,42.563657407407426,1029.7453703703727,29.42129629629636,0
1512,4,0,0,42,0.0,0.0,1.0,42,1000,500,500,0.5,15,5,10,363.9302475958962,0.4372338366240805,0.23548920675625484,0.20800516949534897,130384.14292800431,1120.2138240198124,131504.35675202412,1124,4,261.8333333333333,34,8,20,35.3804833508179,0.6283700980392157,44.67261904761904,1021.309523809522,30.038515406162414,8
1513,4,0,2,40,0.0,0.047619047619047616,0.9523809523809523,42,1350,900,450,0.6666666666666666,18,9,9,366.0171394350666,0.4370886566008518,0.2452161803787114,0.20985471661798097,130505.75573979582,1153.4686791383112,131659.2244189341,1125,5,262.8333333333333,34,8,19,35.203794322109594,0.6295955882352942,44.55357142857142,1021.7857142857134,30.052521008403335,0
1514,4,0,1,39,0.0,0.025,0.975,40,1050,800,250,0.7619047619047619,13,8,5,377.4118683510852,0.4358974358974359,0.2468157831614297,0.21642779630752026,130512.9112000191,1851.4243319876832,132364.33553200678,1126,6,272.975,33,7,21,34.90545294635004,0.6319444444444444,44.546568627450974,1021.813725490195,30.964052287581666,0
1515,4,0,0,39,0.0,0.0,1.0,39,1150,800,350,0.6956521739130435,15,8,7,379.62251890359175,0.4348009446693657,0.23292920847268683,0.2182829483695652,130617.28395061726,2117.052469135799,132734.33641975306,1127,7,256.8205128205128,32,7,21,34.74298007246377,0.6354166666666667,44.44444444444444,1022.2222222222221,31.94444444444444,0
1516,4,1,0,40,0.025,0.0,1.0,40,600,200,400,0.3333333333333333,10,2,8,366.3283319012054,0.4355502136752137,0.24905420054200555,0.19658981162237463,127894.85857427292,1372.2310523964757,129267.08962666939,1128,0,251.375,37,3,19,37.85806233062332,0.5971283783783784,47.121710526315795,1011.5131578947373,27.338193456614523,8
1517,4,1,1,40,0.024390243902439025,0.024390243902439025,0.975609756097561,41,1150,700,450,0.6086956521739131,16,7,9,359.2542813641124,0.4369156504065041,0.2530700275584956,0.1947091470452059,128291.05748724712,1018.5527256101395,129309.61021285725,1129,0,246.21951219512195,35,6,20,37.631502532465056,0.6050595238095238,46.730324074074076,1013.078703703704,28.94510582010583,0
1518,4,1,0,41,0.024390243902439025,0.0,1.0,41,1150,700,450,0.6086956521739131,16,7,9,345.2984972273917,0.4380081300813008,0.19481288793880513,0.18558324453708291,127955.29827781442,636.5544415224057,128591.85271933682,1130,0,246.6829268292683,38,3,19,38.328053502287936,0.5959429824561404,47.06196581196582,1011.7521367521377,26.625056230319416,8
1519,4,0,0,41,0.0,0.0,1.0,41,1100,800,300,0.7272727272727273,14,8,6,343.89657549028453,0.4383130081300813,0.19489027607954146,0.18545361711840916,128090.45041867567,609.9734503981383,128700.42386907381,1131,1,247.6829268292683,38,3,20,38.225373790677224,0.5973135964912281,46.92841880341881,1012.2863247863255,26.63911381016646,0
1520,4,0,1,40,0.0,0.024390243902439025,0.975609756097561,41,850,500,350,0.5882352941176471,12,5,7,346.4425281835463,0.43899898373983737,0.20386587942383394,0.18734561972066338,128201.54772593541,682.9164907917989,128884.46421672721,1132,2,248.6829268292683,36,5,21,38.04741650913675,0.6021412037037037,46.818693693693696,1012.7252252252254,28.13125625625626,0
1521,4,3,0,43,0.06976744186046512,0.0,1.0,43,1000,400,600,0.4,16,4,12,332.6348800757778,0.4435908084163898,0.2174469881443284,0.18335346046460774,128963.2175021702,-20.46712239582905,128942.75037977437,1133,0,234.2093023255814,39,4,19,37.62103459474241,0.6044337606837606,46.067708333333336,1015.7291666666672,26.04433760683762,0
1522,4,1,1,43,0.022727272727272728,0.022727272727272728,0.9772727272727273,44,1100,900,200,0.8181818181818182,13,9,4,330.09092132171764,0.4460227272727273,0.23035378461714662,0.18393539167622694,129391.54071015054,-257.3659700249703,129134.17474012557,1134,0,229.86363636363637,38,6,20,37.250385032727785,0.6104714912280702,45.64636752136752,1017.4145299145304,26.774066576698168,0
1523,4,1,1,43,0.022727272727272728,0.022727272727272728,0.9772727272727273,44,1300,900,400,0.6923076923076923,17,9,8,329.62537656138613,0.4458795806906272,0.2373106855377105,0.1848228876107723,129636.22708013713,-253.72196654249944,129382.50511359464,1135,0,230.72727272727272,38,6,16,37.01391803049377,0.6129385964912281,45.405982905982896,1018.3760683760668,26.79937022042281,0
1524,4,0,0,43,0.0,0.0,1.0,43,1350,900,450,0.6666666666666666,18,9,9,342.5972032004455,0.4443983019564415,0.24456792565752083,0.1920157046543474,129619.76431450056,281.47374672975565,129901.23806123031,1136,2,237.09302325581396,37,6,17,36.70038315207638,0.6145833333333333,45.422149122807014,1018.3114035087715,27.52192982456139,0
1525,4,0,0,43,0.0,0.0,1.0,43,1000,600,400,0.6,14,6,8,342.5972032004455,0.4442829457364341,0.24456792565752083,0.1920157046543474,129619.76431450056,281.47374672975565,129901.23806123031,1137,3,238.09302325581396,37,6,17,36.70038315207638,0.6145833333333333,45.422149122807014,1018.3114035087715,27.52192982456139,0
1526,4,1,1,43,0.022727272727272728,0.022727272727272728,0.9772727272727273,44,900,700,200,0.7777777777777778,11,7,4,334.251497895151,0.4446022727272727,0.2455412434976465,0.18872353804233893,129908.37191358012,-115.58641975310832,129792.78549382702,1138,0,233.6590909090909,38,6,18,36.62011807447774,0.6156798245614035,45.13888888888888,1019.4444444444434,26.827485380116933,0
1527,4,0,0,43,0.0,0.0,1.0,43,1100,700,400,0.6363636363636364,15,7,8,334.4677828686338,0.4446520856404577,0.2389568997446343,0.18910903552714695,129962.83512309153,93.6762637884433,130056.51138687997,1139,1,234.25581395348837,38,5,18,36.5594003213188,0.6162280701754386,45.085470085470085,1019.6581196581196,26.83310841205578,0
1528,4,0,1,42,0.0,0.023255813953488372,0.9767441860465116,43,750,500,250,0.6666666666666666,10,5,5,329.91631674918824,0.44435215946843853,0.16315510153171942,0.1820762771890906,129011.3768924867,34.37625557017154,129045.75314805687,1140,2,235.25581395348837,38,5,18,37.6410944017948,0.6066337719298245,46.02029914529915,1015.9188034188037,26.73470535312641,8
1529,4,1,0,43,0.023255813953488372,0.0,1.0,43,1750,1500,250,0.8571428571428571,20,15,5,327.53292125772623,0.4451365817644887,0.16279069767441823,0.18163189269746638,129201.38888888896,-136.31850847395177,129065.07038041501,1141,0,235.58139534883722,37,6,19,37.50853825136612,0.6103603603603603,45.833333333333336,1016.6666666666673,27.477477477477496,0
1530,4,1,1,43,0.022727272727272728,0.022727272727272728,0.9772727272727273,44,1600,1100,500,0.6875,21,11,10,321.54407809667146,0.44868745595489784,0.11510092417153217,0.16541578284579297,126177.97592957834,-646.5813107239552,125531.39461885439,1142,0,231.20454545454547,38,6,19,40.74839607259324,0.5778508771929824,48.82478632478632,1004.7008547008535,26.43949617633825,8
1531,4,0,0,43,0.0,0.0,1.0,43,1050,700,350,0.6666666666666666,14,7,7,328.3345672422999,0.44848191214470284,0.11193669786741323,0.16835878873488122,126043.83680555543,-323.09027777778726,125720.74652777765,1143,1,237.25581395348837,37,6,19,40.71576763485477,0.5782657657657657,48.95833333333333,1004.1666666666656,27.13963963963961,0
1532,4,0,1,42,0.0,0.023255813953488372,0.9767441860465116,43,1600,1000,600,0.625,22,10,12,330.25516925661435,0.44758213362864524,0.11459872171710273,0.16979785974910763,126153.96684556782,-267.4000654047412,125886.56678016308,1144,2,238.25581395348837,37,6,19,40.55428218001894,0.5793918918918919,48.848684210526315,1004.6052631578943,27.15149359886201,0
1533,4,2,1,43,0.045454545454545456,0.022727272727272728,0.9772727272727273,44,850,500,350,0.5882352941176471,12,5,7,321.27532802661085,0.4491609408033827,0.12596461509504997,0.16685589616865906,126567.3828125,-667.4045138888899,125899.97829861111,1145,0,233.6590909090909,39,5,16,40.35541752933059,0.5801282051282051,48.4375,1006.25,25.80128205128205,0
1534,4,1,2,42,0.022727272727272728,0.045454545454545456,0.9545454545454546,44,1850,1300,550,0.7027027027027027,24,13,11,321.4541779729584,0.449667459478506,0.1339768612143164,0.16748542480370027,126698.4388563367,-654.451497395839,126043.98735894085,1146,0,234.63636363636363,39,5,17,40.21652440075877,0.5814636752136753,48.307291666666664,1006.7708333333325,25.814636752136728,0
1535,4,3,1,44,0.06666666666666667,0.022222222222222223,0.9777777777777777,45,1500,1100,400,0.7333333333333333,19,11,8,317.5419676481483,0.45235690235690235,0.1525723989168848,0.16748782215167038,127197.07031249999,-921.3080512152782,126275.7622612847,1147,0,225.04444444444445,39,6,20,39.804488503373264,0.5865384615384616,47.8125,1008.7499999999999,25.865384615384613,0
1536,4,2,3,43,0.043478260869565216,0.06521739130434782,0.9347826086956522,46,1150,700,450,0.6086956521739131,16,7,9,297.97819963572806,0.454116344605475,0.10771460874844374,0.15298278166233237,126094.86669847638,-1678.2644775761814,124416.6022209002,1148,0,220.80434782608697,40,6,13,41.4255118216466,0.5736979166666667,48.90752032520325,1004.3699186991865,25.109247967479664,8
1537,4,1,0,44,0.022727272727272728,0.0,1.0,44,1600,1100,500,0.6875,21,11,10,316.7261633527775,0.4519798273431994,0.10828023938201503,0.16283084275594148,126151.14239763694,-808.9265331652994,125342.21586447164,1149,0,231.61363636363637,38,6,15,40.89696550746215,0.5775767543859649,48.851495726495735,1004.5940170940183,26.436684660368904,0
1538,4,3,2,45,0.06382978723404255,0.0425531914893617,0.9574468085106383,47,1500,800,700,0.5333333333333333,22,8,14,305.6092643166195,0.4559628430465618,0.12993404862683366,0.16028314487313075,126967.00330884689,-1639.5415052594876,125327.4618035874,1150,0,217.7659574468085,41,6,16,40.34056419595106,0.5810467479674797,48.040674603174615,1007.8373015873033,24.581397599690323,0
1539,4,1,0,46,0.021739130434782608,0.0,1.0,46,1100,500,600,0.45454545454545453,17,5,12,306.8641887283774,0.4549718196457327,0.13399520712084878,0.16104029739051226,126992.00050390547,-1406.1405580750593,125585.85994583041,1151,0,223.34782608695653,41,5,17,40.28338254593176,0.5813008130081301,48.01587301587303,1007.9365079365095,24.583817266744134,0
1540,4,4,2,48,0.08,0.04,0.96,50,1650,1200,450,0.7272727272727273,21,12,9,294.82161292259815,0.4584948979591837,0.17403788086741767,0.1586462534530318,128003.94483024692,-2452.294737339374,125551.65009290756,1152,0,206.4,44,6,13,39.55531155640958,0.5873579545454546,47.01388888888889,1011.9444444444446,22.998737373737377,0
1541,4,0,3,45,0.0,0.0625,0.9375,48,1200,700,500,0.5833333333333334,17,7,10,303.36931868143955,0.4566156914893617,0.15954919341958096,0.16242477375273592,127801.37466385741,-1845.796808334833,125955.57785552257,1153,1,216.0,42,6,13,39.5454000958313,0.5880456349206349,47.21414728682171,1011.1434108527137,24.0748431155408,0
1542,4,0,1,44,0.0,0.022222222222222223,0.9777777777777777,45,900,500,400,0.5555555555555556,13,5,8,320.76490136913617,0.45368265993265994,0.15178344168128466,0.16995804588126312,127381.02349175366,-828.127712673592,126552.89577908006,1154,2,230.82222222222222,39,6,13,39.53507120008254,0.5884081196581197,47.63020833333334,1009.4791666666682,25.884081196581235,0
1543,4,1,1,44,0.022222222222222223,0.022222222222222223,0.9777777777777777,45,1250,900,350,0.72,16,9,7,319.7996651481941,0.4543560606060606,0.16374172564648748,0.17066536585631364,127670.36132812512,-834.2122395833178,126836.1490885418,1155,0,225.4,39,6,14,39.26381158524018,0.5913461538461539,47.34375000000001,1010.6250000000009,25.91346153846156,0
1544,4,1,0,45,0.022222222222222223,0.0,1.0,45,1250,800,450,0.64,17,8,9,327.14161254339103,0.45376683501683507,0.18297638660076831,0.17573005204764466,127933.68055555565,-629.5138888888841,127304.16666666676,1156,0,226.22222222222223,39,6,15,38.809376716090036,0.594017094017094,47.083333333333336,1011.6666666666674,25.940170940170958,0
1545,4,1,1,45,0.021739130434782608,0.021739130434782608,0.9782608695652174,46,1200,900,300,0.75,15,9,6,318.11607948274036,0.4542874396135266,0.1827750254860223,0.17223612232127888,128250.02170138896,-1040.1475694444398,127209.87413194453,1157,0,222.2826086956522,39,7,16,38.715206362265185,0.5972222222222222,46.770833333333336,1012.9166666666673,25.97222222222224,0
1546,4,1,0,46,0.021739130434782608,0.0,1.0,46,900,500,400,0.5555555555555556,13,5,8,315.1781076869807,0.4551831723027375,0.1752717391304348,0.17109668703007516,128355.55555555549,-1109.0277777777833,127246.52777777771,1158,0,223.04347826086956,39,7,17,38.68215460526316,0.5982905982905983,46.666666666666664,1013.3333333333328,25.98290598290597,0
1547,4,0,2,44,0.0,0.043478260869565216,0.9565217391304348,46,1300,1000,300,0.7692307692307693,16,10,6,316.1607361716526,0.45524355877616746,0.17813935202558984,0.1720848033793358,128461.1328125,-1077.12673611111,127384.00607638889,1159,1,224.04347826086956,39,7,13,38.54980134264969,0.5993589743589743,46.5625,1013.75,25.993589743589745,0
1548,4,0,0,44,0.0,0.0,1.0,44,950,800,150,0.8421052631578947,11,8,3,324.69652540119284,0.4531139887244538,0.1707460468960631,0.17594552482003653,128283.34349270939,-469.3688202139002,127813.97467249549,1160,3,233.13636363636363,37,7,17,38.514607461124946,0.6010698198198199,46.73793859649123,1013.0482456140359,27.37968231389286,0
1549,4,2,3,43,0.043478260869565216,0.06521739130434782,0.9347826086956522,46,1450,1000,450,0.6896551724137931,19,10,9,297.53734197016394,0.4543075684380032,0.061484366363659726,0.16270678390304283,128647.25548784352,-1479.5766357705984,127167.67885207292,1161,0,223.95652173913044,41,5,18,38.83279548862377,0.598069105691057,46.37896825396827,1014.4841269841288,24.743515292295825,8
1550,4,0,0,43,0.0,0.0,1.0,43,400,200,200,0.5,6,2,4,311.40196983913074,0.45302694721299375,0.08013017330157024,0.1696069038860808,128487.53390842034,-597.7457682291471,127889.7881401912,1162,1,239.06976744186048,39,4,19,38.643553717593065,0.5996260683760684,46.53645833333334,1013.8541666666683,25.996260683760728,0
1551,4,2,0,45,0.044444444444444446,0.0,1.0,45,1100,800,300,0.7272727272727273,14,8,6,300.47885116902046,0.45555555555555555,0.09094577881924093,0.1659926857428863,129050.14349489808,-1244.6322278911468,127805.51126700692,1163,0,229.4,41,4,21,38.349443468072614,0.6021341463414633,45.98214285714286,1016.0714285714295,24.782229965156816,0
1552,4,0,1,44,0.0,0.022222222222222223,0.9777777777777777,45,1050,900,150,0.8571428571428571,12,9,3,301.44590762054395,0.45498737373737375,0.08253782332845261,0.16684566848041457,129125.75511975627,-1215.1139101473923,127910.64120960888,1164,1,230.4,41,4,21,38.24823084431431,0.6028963414634146,45.907738095238095,1016.3690476190479,24.789488966318242,0
1553,4,0,1,43,0.0,0.022727272727272728,0.9772727272727273,44,1300,800,500,0.6153846153846154,18,8,10,312.2258444357371,0.4550189393939394,0.11631285171798522,0.16561472314303527,127425.26898877995,-824.2620784804956,126601.00691029946,1165,2,236.27272727272728,40,4,16,39.70537661466197,0.5872395833333333,47.586382113821145,1009.6544715447164,25.241361788617912,6
1554,4,0,0,43,0.0,0.0,1.0,43,1550,1200,350,0.7741935483870968,19,12,7,319.7470395469034,0.4539728682170543,0.11827105383156922,0.16930867831745877,127354.73632812499,-455.7400173611118,126898.99631076388,1166,3,242.67441860465115,39,4,17,39.5876332989336,0.5881410256410257,47.65625,1009.3749999999999,25.881410256410252,0
1555,4,1,0,44,0.022727272727272728,0.0,1.0,44,900,700,200,0.7777777777777778,11,7,4,335.77405682638584,0.45488680408738547,0.15875567148551584,0.1740047965689826,126477.92009551193,-232.07187716885227,126245.84821834308,1167,0,238.13636363636363,40,4,15,40.08259244291774,0.5776041666666667,48.52642276422764,1005.8943089430894,25.147357723577237,8
1556,4,2,0,46,0.043478260869565216,0.0,1.0,46,1700,1000,700,0.5882352941176471,24,10,14,331.4776867258016,0.456219806763285,0.18678409943019747,0.1747250103737584,127170.80213758707,-764.6817076914316,126406.12042989564,1168,0,228.7391304347826,39,7,20,39.47995197769284,0.5862713675213675,47.83854166666668,1008.6458333333355,25.862713675213733,0
1557,4,0,0,46,0.0,0.0,1.0,46,1650,1400,250,0.8484848484848485,19,14,5,329.6168278531297,0.45605877616747187,0.18541988295695222,0.174308287567747,127302.17013888908,-807.8124999999818,126494.3576388891,1169,1,229.7391304347826,39,7,20,39.39237544728875,0.5876068376068376,47.70833333333334,1009.1666666666682,25.876068376068417,0
1558,4,1,1,46,0.02127659574468085,0.02127659574468085,0.9787234042553191,47,1750,1300,450,0.7428571428571429,22,13,9,345.9607965344142,0.457022818378045,0.16770458430324986,0.18040945116120966,126733.6117720936,-582.9374669508571,126150.67430514275,1170,0,225.82978723404256,40,7,15,39.56356816040911,0.5802083333333333,48.27235772357725,1006.9105691056933,25.172764227642332,8
1559,4,3,2,47,0.061224489795918366,0.04081632653061224,0.9591836734693877,49,1350,1100,250,0.8148148148148148,16,11,5,331.3121313509326,0.4594494047619047,0.18460838730869944,0.1756606770816871,127407.31336805565,-1356.1640981310634,126051.14926992459,1171,0,217.40816326530611,39,10,13,39.24198651809053,0.5886752136752137,47.60416666666667,1009.5833333333342,25.886752136752158,0
1560,4,0,0,47,0.0,0.0,1.0,47,1550,1000,550,0.6451612903225806,21,10,11,351.6464549960553,0.45492213999383285,0.18861102184532785,0.18588181075983315,127285.57254395568,-448.0959285549595,126837.47661540072,1172,1,227.6595744680851,37,10,19,38.85361204679631,0.5909346846846847,47.724780701754376,1009.1008771929813,27.27299668089139,0
1561,4,0,3,44,0.0,0.06382978723404255,0.9361702127659575,47,1850,1500,350,0.8108108108108109,22,15,7,350.0299290233024,0.4547294172062905,0.1968685879069081,0.18566103608563184,127423.91889812253,-479.5629424438239,126944.35595567871,1173,2,228.6595744680851,37,10,15,38.75253402838112,0.5923423423423424,47.58771929824562,1009.6491228070178,27.2878141299194,0
1562,4,0,1,43,0.0,0.022727272727272728,0.9772727272727273,44,1150,700,450,0.6086956521739131,16,7,9,364.1654742866761,0.4528827519379845,0.2023144286905756,0.1926894985303288,127325.53155006877,473.51251714680114,127799.04406721557,1174,3,240.13636363636363,35,9,15,38.49675076452601,0.5952380952380952,47.6851851851852,1009.2592592592607,28.835978835978878,0
1563,4,2,1,44,0.044444444444444446,0.022222222222222223,0.9777777777777777,45,1700,1000,700,0.5882352941176471,24,10,14,353.9810336587424,0.4530092592592592,0.20962278390181743,0.18979723362920406,127859.639094331,51.97744196901647,127911.61653630002,1175,0,235.46666666666667,36,9,18,38.206352299298516,0.5986689814814814,47.15653153153154,1011.3738738738753,28.09371871871876,0
1564,4,0,1,43,0.0,0.022727272727272728,0.9772727272727273,44,1100,900,200,0.8181818181818182,13,9,4,348.0612743348467,0.4522771317829457,0.20175323230075026,0.18728614438161306,128002.04554216402,110.51101777455608,128112.55655993857,1176,1,238.86363636363637,36,8,19,38.21036427034646,0.6001157407407407,47.01576576576578,1011.9369369369388,28.10935935935941,0
1565,4,0,0,43,0.0,0.0,1.0,43,1200,800,400,0.6666666666666666,16,8,8,350.7516066610581,0.45231173864894797,0.1917440929487777,0.18871515674077732,127998.08873724713,379.1070548268268,128377.19579207397,1177,2,238.32558139534885,35,8,20,38.14635041366428,0.6020833333333333,47.01967592592593,1011.9212962962966,28.91203703703705,0
1566,4,1,0,44,0.022727272727272728,0.0,1.0,44,1450,1200,250,0.8275862068965517,17,12,5,343.5251514376699,0.4527175828047921,0.19692170117311836,0.18629872136737302,128315.61872260785,15.928470700442773,128331.54719330829,1178,0,233.88636363636363,36,8,21,38.004797895594834,0.6032986111111112,46.70608108108109,1013.1756756756765,28.143768768768794,0
1567,4,0,0,44,0.0,0.0,1.0,44,1250,800,450,0.64,17,8,9,338.5489241402646,0.45234319943622264,0.18982829986202643,0.18418303854603413,128442.17985243649,-103.20763934543518,128338.97221309105,1179,1,234.88636363636363,38,6,14,38.00173025576168,0.6008771929824561,46.58119658119659,1013.6752136752154,26.67566351776883,0
1568,4,0,1,43,0.0,0.022727272727272728,0.9772727272727273,44,1050,500,550,0.47619047619047616,16,5,11,335.895845253279,0.4515944326990839,0.18989505333512025,0.18348648761994435,128604.67916757993,-160.44451749578724,128444.23465008415,1180,2,235.88636363636363,38,6,14,37.90332490695877,0.6025219298245614,46.42094017094018,1014.3162393162404,26.692532613585275,0
1569,4,1,0,44,0.022727272727272728,0.0,1.0,44,1500,1200,300,0.8,18,12,6,334.9838532659785,0.4507135306553911,0.19626615047343643,0.18391085352546271,128804.55864800363,-170.51052517359275,128634.04812283003,1181,0,236.0,39,5,15,37.722870702924574,0.6028311965811965,46.22395833333334,1015.104166666668,26.028311965812,0
1570,4,2,3,43,0.043478260869565216,0.06521739130434782,0.9347826086956522,46,1450,800,650,0.5517241379310345,21,8,13,324.7764181425116,0.4527073268921095,0.1919844745931707,0.18107397559452348,129413.28124999997,-792.702907986112,128620.57834201386,1182,0,226.69565217391303,39,7,17,37.363499863499875,0.608974358974359,45.625,1017.4999999999998,26.089743589743584,0
1571,4,1,0,44,0.022727272727272728,0.0,1.0,44,1250,800,450,0.64,17,8,9,334.87315499954656,0.4512861169837914,0.19783486760193325,0.18583355872596005,129229.25954380177,-144.9180276623805,129084.3415161394,1183,0,237.4090909090909,37,7,18,37.293643732700666,0.6106418918918919,45.80592105263157,1016.7763157894723,27.480440967283034,0
1572,4,0,0,44,0.0,0.0,1.0,44,1050,600,450,0.5714285714285714,15,6,9,332.80869741673496,0.45076858703312195,0.19427678378961,0.18534208251095205,129368.65790435494,-188.9970952601066,129179.66080909484,1184,1,238.4090909090909,37,7,19,37.20449809585401,0.6120495495495495,45.668859649122794,1017.3245614035068,27.495258416310993,0
1573,4,0,1,43,0.0,0.022727272727272728,0.9772727272727273,44,1000,700,300,0.7,13,7,6,331.5853522592154,0.4503942036645525,0.19594435736677096,0.18492260029840815,129424.4382887039,-216.95040781782754,129207.48788088607,1185,2,239.4090909090909,37,7,19,37.17896910919541,0.6126126126126126,45.61403508771928,1017.5438596491202,27.501185395922167,0
1574,4,0,0,43,0.0,0.0,1.0,43,1150,700,450,0.6086956521739131,16,7,9,340.9887818125916,0.44926633444075303,0.19491837422989078,0.18978137191085254,129344.54038075225,221.00745170844579,129565.5478324607,1186,3,245.46511627906978,36,7,19,37.02096940846524,0.6137152777777778,45.69256756756756,1017.2297297297287,28.256381381381352,0
1575,4,0,0,43,0.0,0.0,1.0,43,1300,600,700,0.46153846153846156,20,6,14,344.48715306339415,0.4489202657807309,0.1955021439797513,0.19284881429387885,129573.74762854059,327.29828646212263,129901.0459150027,1187,4,246.46511627906978,36,7,14,36.69901928252773,0.6160300925925926,45.467342342342334,1018.1306306306296,28.28140640640638,0
1576,4,0,2,41,0.0,0.046511627906976744,0.9534883720930233,43,1350,1000,350,0.7407407407407407,17,10,7,345.1390718506534,0.44834348468069396,0.19593855519094494,0.19399196107467725,129731.44531249972,355.0781249999704,130086.5234374997,1188,5,247.46511627906978,37,6,17,36.522239263803684,0.6157094594594594,45.312499999999986,1018.7499999999978,27.533783783783726,0
1577,4,0,0,41,0.0,0.0,1.0,41,1250,700,550,0.56,18,7,11,359.6588086728986,0.44425813008130083,0.19764675417158917,0.20148915415243793,129602.41280131479,1122.5298778508165,130724.9426791656,1189,7,259.390243902439,36,5,19,36.28368539408686,0.6163194444444444,45.439189189189186,1018.2432432432429,28.284534534534526,0
1578,4,0,0,41,0.0,0.0,1.0,41,1200,900,300,0.75,15,9,6,357.8187018656251,0.4436991869918699,0.18973905351614362,0.20075138583577612,129659.75265806343,1078.9368760652524,130738.68953412869,1190,8,260.390243902439,36,5,20,36.272206250921435,0.6168981481481481,45.38288288288288,1018.4684684684681,28.29079079079078,0
1579,4,1,1,41,0.023809523809523808,0.023809523809523808,0.9761904761904762,42,900,400,500,0.4444444444444444,14,4,10,352.11422097810174,0.4444202477739063,0.1988667496248966,0.19904620917175447,129954.95158366008,751.797307825457,130706.74889148553,1191,0,255.16666666666666,37,5,21,36.117570885758326,0.6179617117117118,45.09320175438595,1019.6271929824538,27.557491702228482,0
1580,4,0,0,41,0.0,0.0,1.0,41,1250,900,350,0.72,16,9,7,359.77412166905754,0.4420731707317073,0.20412882360867735,0.20273697391687243,129831.84831791249,1142.027838649456,130973.87615656195,1192,1,262.1463414634146,36,5,21,36.047421731123386,0.6186342592592593,45.21396396396396,1019.1441441441441,28.30955955955956,0
1581,4,1,1,41,0.023809523809523808,0.023809523809523808,0.9761904761904762,42,1350,900,450,0.6666666666666666,18,9,9,360.34026699433366,0.44409359272164145,0.23645685593648613,0.19673905044681267,128584.36113522365,925.7306389652448,129510.0917741889,1193,0,256.8809523809524,35,7,16,37.304219445395404,0.6080357142857142,46.440972222222214,1014.2361111111102,28.978174603174576,8
1582,4,1,0,42,0.023809523809523808,0.0,1.0,42,1150,900,250,0.782608695652174,14,9,5,361.9829059829057,0.44483159117305454,0.23792429792429792,0.19939736346516013,128936.76757812515,934.5811631944596,129871.3487413196,1194,0,255.38095238095238,35,7,17,36.90277777777778,0.6116071428571428,46.09375000000001,1015.6250000000011,29.017857142857174,0
1583,4,0,1,41,0.0,0.023809523809523808,0.9761904761904762,42,1400,1000,400,0.7142857142857143,18,10,8,362.1338349905936,0.4443113627564847,0.23868071818891456,0.20081967213114754,129201.38888888898,957.9101562500063,130159.29904513898,1195,1,256.3809523809524,34,8,19,36.62909836065572,0.616421568627451,45.833333333333336,1016.6666666666674,29.901960784313747,0
1584,4,0,0,41,0.0,0.0,1.0,41,1050,500,550,0.47619047619047616,16,5,11,361.54992302054086,0.44326727642276426,0.22659139130906603,0.20064963564122426,129231.64859693882,1144.738520408169,130376.38711734698,1196,2,248.1951219512195,34,7,19,36.61310151036178,0.6167279411764706,45.80357142857143,1016.7857142857147,29.90546218487396,0
1585,4,0,0,41,0.0,0.0,1.0,41,950,700,250,0.7368421052631579,12,7,5,359.68190279883413,0.4427083333333333,0.22355772662256634,0.19991948572611845,129292.17864229018,1100.811366213142,130392.99000850332,1197,3,249.1951219512195,34,7,19,36.59892114401654,0.6173406862745099,45.74404761904761,1017.023809523809,29.91246498599438,0
1586,4,0,0,41,0.0,0.0,1.0,41,1050,800,250,0.7619047619047619,13,8,5,357.8743448366658,0.44298780487804873,0.2216547934575146,0.19983460313577112,129473.85381235827,1067.0741213151932,130540.92793367346,1198,4,250.1951219512195,34,7,15,36.45991733925996,0.6191789215686274,45.56547619047619,1017.7380952380952,29.93347338935574,0
1587,4,2,0,43,0.046511627906976744,0.0,1.0,43,1400,1100,300,0.7857142857142857,17,11,6,344.22231681064517,0.44502122554448137,0.22778837440345856,0.19526048641124866,130090.20580969503,355.99040763739345,130446.19621733243,1199,0,239.51162790697674,36,7,17,36.1815597748096,0.6212384259259259,44.9605855855856,1020.1576576576593,28.337712712712758,0
1588,4,0,0,43,0.0,0.0,1.0,43,1150,700,450,0.6086956521739131,16,7,9,346.23780385901694,0.4445828719084533,0.23128539499985945,0.196983880500582,130205.11379200158,416.3865301112138,130621.50032211278,1200,1,240.51162790697674,36,7,18,36.01364522417155,0.6223958333333333,44.84797297297298,1020.608108108109,28.350225225225252,0
1589,4,1,3,41,0.022727272727272728,0.06818181818181818,0.9318181818181819,44,850,700,150,0.8235294117647058,10,7,3,339.4717903980971,0.4458795806906272,0.22761590332955928,0.1945690179584293,130492.60567577713,59.72437809431011,130552.33005387144,1201,0,236.02272727272728,36,8,15,35.895192696278336,0.6252893518518519,44.56644144144144,1021.7342342342342,28.381506506506508,0
1590,4,0,1,40,0.0,0.024390243902439025,0.975609756097561,41,750,600,150,0.8,9,6,3,354.5967544780499,0.4425304878048781,0.2326716619160596,0.20187998491997328,130232.2066326529,1035.9835600906847,131268.19019274358,1202,3,252.0731707317073,34,7,18,35.77287924733692,0.6268382352941176,44.82142857142856,1020.7142857142844,30.021008403361307,0
1591,4,1,2,39,0.024390243902439025,0.04878048780487805,0.9512195121951219,41,1100,800,300,0.7272727272727273,14,8,6,346.72786673716155,0.4445121951219512,0.22703983768254332,0.19879527589880136,130505.75573979582,849.9999999999891,131355.7557397958,1203,0,250.53658536585365,34,7,16,35.69653190415163,0.6295955882352942,44.55357142857142,1021.7857142857134,30.052521008403335,0
1592,4,1,0,40,0.025,0.0,1.0,40,1250,800,450,0.64,17,8,9,376.40886736315343,0.44149305555555557,0.25870323761583336,0.20222433371981097,127939.5351750043,1631.515105238342,129571.05028024265,1204,0,256.575,35,5,18,37.55732086336423,0.6014880952380952,47.0775462962963,1011.689814814815,28.905423280423285,8
1593,4,1,0,41,0.024390243902439025,0.0,1.0,41,950,500,450,0.5263157894736842,14,5,9,371.56287702024207,0.44402947154471545,0.2672185383039971,0.20216344395063024,128446.04768990938,1345.4848043255424,129791.53249423493,1205,0,251.29268292682926,34,7,15,37.16113720884713,0.6087622549019608,46.577380952380956,1013.6904761904768,29.81442577030814,0
1594,4,0,1,40,0.0,0.024390243902439025,0.975609756097561,41,1100,600,500,0.5454545454545454,16,6,10,371.5244564962817,0.44408028455284554,0.24046839506436135,0.18923751269643552,125768.722106802,1145.2312249922898,126913.95333179428,1206,1,252.29268292682926,37,4,16,39.9158285964145,0.5754504504504505,49.23245614035087,1003.0701754385957,27.11000474158367,8
1595,4,2,0,42,0.047619047619047616,0.0,1.0,42,1700,1300,400,0.7647058823529411,21,13,8,373.7793662543479,0.4473359465737514,0.2704422160118358,0.19357227012814607,126450.94548396813,1053.8525728120944,127504.79805678022,1207,0,247.07142857142858,35,7,16,39.15467970847718,0.5863095238095238,48.55324074074076,1005.78703703704,28.736772486772573,0
1596,4,0,1,41,0.0,0.023809523809523808,0.9761904761904762,42,1350,700,650,0.5185185185185185,20,7,13,367.3534361531988,0.4459204413472706,0.2643735733171304,0.19146839671040627,126713.00482521032,909.6915455675925,127622.6963707779,1208,1,248.07142857142858,35,7,17,39.04627447599343,0.5889880952380953,48.29282407407409,1006.8287037037059,28.766534391534453,0
1597,4,3,2,42,0.06818181818181818,0.045454545454545456,0.9545454545454546,44,1700,1400,300,0.8235294117647058,20,14,6,351.7712536885152,0.452156007751938,0.25085875037015115,0.18684044097296604,127479.27847991721,168.70912203759053,127647.9876019548,1209,0,231.20454545454547,37,7,17,38.651827723488985,0.5929054054054055,47.532894736842124,1009.8684210526342,27.293741109530654,0
1598,4,1,0,43,0.023255813953488372,0.0,1.0,43,800,600,200,0.75,10,6,4,360.6021982927773,0.4494047619047619,0.2780694616488981,0.19239263540305515,127660.40322417032,606.9244075156513,128267.32763168597,1210,0,237.32558139534885,36,7,18,38.24311901047471,0.5966435185185186,47.35360360360362,1010.5855855855873,28.07182182182187,0
1599,4,2,1,44,0.044444444444444446,0.022222222222222223,0.9777777777777777,45,1750,1400,350,0.8,21,14,7,346.7795460473469,0.45191498316498313,0.18344931229376993,0.18690922917702507,128069.20750070871,-65.13550510140959,128004.0719956073,1211,0,227.73333333333332,41,4,21,38.174127707537004,0.5922256097560976,46.949404761904766,1012.2023809523816,24.68786295005809,8
1600,4,2,2,44,0.043478260869565216,0.043478260869565216,0.9565217391304348,46,1050,800,250,0.7619047619047619,13,8,5,338.3854914000477,0.45317028985507246,0.19234186753547666,0.18498159776315898,128633.7549160555,-494.39643787067973,128139.35847818483,1212,0,220.43478260869566,40,6,16,37.81055900621119,0.5994791666666667,46.39227642276424,1014.4308943089451,25.360772357723626,0
1601,4,1,1,44,0.022222222222222223,0.022222222222222223,0.9777777777777777,45,1100,600,500,0.5454545454545454,16,6,10,346.3369315365135,0.4525462962962963,0.21472653424581356,0.18969688762436052,128711.08596280341,-84.51948658203867,128626.56647622137,1213,0,226.24444444444444,40,5,17,37.53004506760142,0.6002604166666667,46.31605691056912,1014.735772357725,25.368394308943124,0
1602,4,2,0,46,0.043478260869565216,0.0,1.0,46,1300,700,600,0.5384615384615384,19,7,12,330.38729362769305,0.4547805958132045,0.216546380947084,0.17370543534083033,127067.00685193083,-793.5079486928938,126273.49890323794,1214,0,222.2391304347826,41,5,16,39.61377464003413,0.5820630081300813,47.94146825396827,1008.2341269841289,24.591076267905585,8
1603,4,3,3,46,0.061224489795918366,0.061224489795918366,0.9387755102040817,49,1050,700,350,0.6666666666666666,14,7,7,317.0584673185306,0.4566326530612245,0.22497770748860058,0.16942375368166465,127723.00347222266,-1700.8680555555152,126022.13541666714,1215,0,209.57142857142858,44,5,14,39.27933498213795,0.5845170454545454,47.291666666666686,1010.8333333333369,22.97348484848493,0
1604,4,0,4,42,0.0,0.08695652173913043,0.9130434782608696,46,750,200,550,0.26666666666666666,13,2,11,335.5055036508737,0.45420692431561993,0.22902010533194916,0.1781486970089852,127467.41470025522,-646.7961663832119,126820.61853387201,1216,1,220.0,41,5,14,39.074626682385286,0.5861280487804879,47.54464285714286,1009.8214285714295,24.629790940766572,0
1605,4,1,1,42,0.023255813953488372,0.023255813953488372,0.9767441860465116,43,1400,900,500,0.6428571428571429,19,9,10,346.45272559241295,0.4494970468807678,0.23659984640529252,0.18348012059400903,127361.47636788677,224.94612462562205,127586.4224925124,1217,0,234.1627906976744,38,5,15,38.90682331357604,0.5899122807017544,47.649572649572654,1009.4017094017106,26.563202878992385,0
1606,4,0,1,41,0.0,0.023809523809523808,0.9761904761904762,42,1100,800,300,0.7272727272727273,14,8,6,356.20782106883445,0.4488482384823848,0.23898243708129674,0.1885504883805992,127340.9020684249,671.9650517466921,128012.86712017159,1218,3,240.73809523809524,37,5,16,38.68176262900596,0.5914977477477478,47.66995614035088,1009.3201754385965,27.278923660502606,0
1607,4,0,2,39,0.0,0.04878048780487805,0.9512195121951219,41,950,500,450,0.5263157894736842,14,5,9,379.30737809963114,0.4489329268292683,0.2040209035033982,0.18952206127256832,124971.06648930442,1296.5100680758767,126267.5765573803,1219,4,223.1951219512195,35,6,18,40.54734826561715,0.5711309523809525,50.02893518518517,999.8842592592569,28.568121693121626,8
1608,4,4,1,42,0.09302325581395349,0.023255813953488372,0.9767441860465116,43,1300,1000,300,0.7692307692307693,16,10,6,368.0536304815714,0.4548265042451089,0.2397256497623701,0.1888625563712003,126073.72448979577,689.5512569418088,126763.27574673758,1220,0,212.7906976744186,34,9,19,39.687796348980584,0.5845588235294117,48.92857142857142,1004.2857142857131,29.537815126050386,0
1609,4,2,3,41,0.045454545454545456,0.06818181818181818,0.9318181818181819,44,1000,600,400,0.6,14,6,8,381.12626343818204,0.4552721987315011,0.29329218848544913,0.18577603855513303,123933.20691222291,685.1620087381607,124618.36892096107,1221,0,208.9090909090909,37,7,17,41.581667767866975,0.5565878378378378,51.06907894736842,995.7236842105257,26.9114509246088,8
1610,4,7,5,43,0.14583333333333334,0.10416666666666667,0.8958333333333334,48,950,700,250,0.7368421052631579,12,7,5,350.1396212978633,0.4617870862884161,0.3045445169516958,0.17602041595562293,125225.32667802963,-817.0091389971378,124408.31753903249,1222,0,190.6875,36,12,14,41.013398214821514,0.5717592592592593,49.77477477477479,1000.9009009009029,27.80280280280286,0
1611,4,5,2,46,0.10416666666666667,0.041666666666666664,0.9583333333333334,48,1050,600,450,0.5714285714285714,15,6,9,355.2447923242011,0.4642989066193854,0.32771535580524325,0.1800500371119245,125563.69714308922,-678.8300969888636,124884.86704610035,1223,0,191.58333333333334,36,12,17,40.535814606741575,0.5752314814814814,49.436936936936945,1002.2522522522537,27.84034034034038,0
1612,4,3,1,48,0.061224489795918366,0.02040816326530612,0.9795918367346939,49,1600,1200,400,0.75,20,12,8,350.73367121440174,0.4620890022675737,0.3394575357880458,0.18058837554795756,126213.51662050556,-945.617746124512,125267.89887438105,1224,0,188.6122448979592,36,13,21,39.978613321379214,0.5818865740740741,48.78941441441441,1004.8423423423417,27.91228728728727,0
1613,4,2,0,50,0.04,0.0,1.0,50,1450,1100,350,0.7586206896551724,18,11,7,338.94240466363436,0.46380952380952384,0.3416808186370557,0.17710608243686843,126815.75701177282,-1403.3524738381134,125412.40453793471,1225,0,184.88,37,13,18,39.655907540460106,0.5861486486486487,48.190789473684205,1007.2368421052629,27.222617354196295,0
1614,4,1,7,44,0.0196078431372549,0.13725490196078433,0.8627450980392157,51,1300,700,600,0.5384615384615384,19,7,12,330.62142574325384,0.4651143790849673,0.2835202586642416,0.1712276426259017,126452.36512864359,-1831.5025427560397,124620.86258588755,1226,0,182.23529411764707,40,11,16,40.23841399750766,0.57734375,48.55182926829268,1005.7926829268288,25.14481707317072,8
1615,4,3,3,44,0.06382978723404255,0.06382978723404255,0.9361702127659575,47,1000,900,100,0.9,11,9,2,346.83458459371496,0.4643655565834104,0.31450988752276676,0.18073979317477226,126705.33842143722,-610.8413165589619,126094.49710487826,1227,0,177.59574468085106,37,10,19,39.57062731431059,0.5850225225225225,48.30043859649122,1006.7982456140339,27.21076339497389,0
1616,4,0,0,44,0.0,0.0,1.0,44,1700,1400,300,0.8235294117647058,20,14,6,362.9843859598966,0.46309020436927417,0.3052848918814459,0.1888448452683093,126638.21549590121,393.538978167344,127031.75447406856,1228,1,181.8181818181818,36,8,19,39.233236369060926,0.5862268518518519,48.36711711711711,1006.5315315315307,27.959209209209188,0
1617,4,0,0,44,0.0,0.0,1.0,44,1500,1000,500,0.6666666666666666,20,10,10,361.24289046965805,0.4625396405919662,0.30033792809998316,0.1888866496724387,126843.36917368798,364.2530634425891,127207.62223713058,1229,2,182.8181818181818,37,7,20,39.06595823809005,0.5864301801801801,48.16337719298245,1007.3464912280697,27.225580844001882,0
1618,4,1,0,45,0.022222222222222223,0.0,1.0,45,1150,700,450,0.6086956521739131,16,7,9,353.763732309609,0.4630681818181818,0.29679635967845575,0.1865239641480597,127182.05959467126,-0.546125652468163,127181.51346901878,1230,0,179.73333333333332,34,11,22,38.90642826232347,0.5958946078431373,47.827380952380956,1008.6904761904767,29.667366946778728,0
1619,4,1,3,43,0.021739130434782608,0.06521739130434782,0.9347826086956522,46,1700,1400,300,0.8235294117647058,20,14,6,346.9894923971734,0.46296296296296297,0.2966564380504524,0.1846661152221054,127559.26354595333,-347.6551783264771,127211.60836762686,1231,0,176.80434782608697,35,11,16,38.690612587839894,0.5976190476190476,47.4537037037037,1010.185185185185,28.862433862433857,0
1620,4,1,2,42,0.022727272727272728,0.045454545454545456,0.9545454545454546,44,1550,1100,450,0.7096774193548387,20,11,9,356.9786325889643,0.46151559196617337,0.30162500633777767,0.1892556736345397,127404.47108848717,296.1347749776801,127700.60586346485,1232,0,185.27272727272728,36,8,17,38.59709053727457,0.5940393518518519,47.60698198198198,1009.5720720720724,28.043668668668676,0
1621,4,0,2,40,0.0,0.047619047619047616,0.9523809523809523,42,1700,1100,600,0.6470588235294118,23,11,12,348.3315237975004,0.45963995354239257,0.23275548421615877,0.17654615955568057,125563.69714308892,360.14211001540855,125923.83925310434,1233,1,191.45238095238096,36,6,18,40.709035580524336,0.5752314814814814,49.43693693693693,1002.2522522522514,27.84034034034032,8
1622,4,3,1,42,0.06976744186046512,0.023255813953488372,0.9767441860465116,43,1200,800,400,0.6666666666666666,16,8,8,343.03571576331467,0.46036360280546323,0.25953102739065703,0.17689561494588016,126276.38996056233,65.29485410083868,126341.68481466317,1234,0,187.5581395348837,35,8,18,40.10728542914172,0.5845238095238094,48.72685185185185,1005.0925925925919,28.716931216931197,0
1623,4,2,0,44,0.045454545454545456,0.0,1.0,44,1150,700,450,0.6086956521739131,16,7,9,349.4012588251355,0.46129536645525016,0.28899565780753944,0.18319149856599112,126953.8478786743,71.5668523007214,127025.41473097503,1235,0,184.25,37,7,20,39.25069361331739,0.5875563063063063,48.053728070175445,1007.7850877192991,27.2374348032243,0
1624,4,3,1,46,0.06382978723404255,0.02127659574468085,0.9787234042553191,47,1350,1000,350,0.7407407407407407,17,10,7,334.6956687686096,0.4631128584643848,0.3051525358223812,0.1797636578315354,127928.27641034788,-836.441707857948,127091.83470248994,1236,0,173.4255319148936,38,9,20,38.62384271482382,0.5956688596491229,47.088675213675224,1011.6452991453004,26.62224471435001,0
1625,4,1,0,47,0.02127659574468085,0.0,1.0,47,1150,900,250,0.782608695652174,14,9,5,335.55899317146304,0.4640186555658341,0.3030836502816945,0.180844522276601,128065.4418945317,-805.2978515624582,127260.14404296924,1237,0,174.29787234042553,39,8,22,38.46190953998147,0.5953525641025641,46.95312500000002,1012.1875000000036,25.953525641025735,0
1626,4,1,1,47,0.020833333333333332,0.020833333333333332,0.9791666666666666,48,1200,700,500,0.5833333333333334,17,7,10,332.2922129802324,0.465093085106383,0.3110125486802251,0.1806887774581922,128422.23087873185,-1065.1852989020726,127357.04557982978,1238,0,171.64583333333334,37,11,17,38.18062166450309,0.6024774774774775,46.60087719298245,1013.5964912280697,27.394499762920802,0
1627,4,0,1,46,0.0,0.02127659574468085,0.9787234042553191,47,1350,900,450,0.6666666666666666,18,9,9,340.65953556348336,0.46482809127351216,0.31259428809238976,0.18487662852836081,128344.1443977761,-655.6686754321936,127688.4757223439,1239,1,176.17021276595744,36,11,23,38.0482699859228,0.603587962962963,46.677927927927925,1013.2882882882878,28.146896896896884,0
1628,4,0,1,45,0.0,0.021739130434782608,0.9782608695652174,46,1200,600,600,0.5,18,6,12,347.4132594567731,0.4626811594202898,0.3145232193682661,0.1882915331284911,128291.05748724689,-285.99711183987296,128005.06037540702,1240,2,180.6304347826087,35,11,23,37.93139971057542,0.6050595238095238,46.73032407407406,1013.0787037037021,28.945105820105773,0
1629,4,1,1,45,0.021739130434782608,0.021739130434782608,0.9782608695652174,46,1000,700,300,0.7,13,7,6,340.38947518858436,0.4651871980676328,0.304352788225837,0.18570937618943775,128555.01570001685,-448.24513460222875,128106.77056541463,1241,0,181.0,35,11,19,37.840009891196836,0.6077380952380953,46.46990740740739,1014.120370370368,28.974867724867657,0
1630,4,0,1,44,0.0,0.022222222222222223,0.9777777777777777,45,1300,800,500,0.6153846153846154,18,8,10,341.8011653415568,0.4652356902356902,0.30218570921446397,0.18675470156193247,128613.70991940978,-207.9368141289842,128405.7731052808,1242,1,185.44444444444446,35,10,19,37.74437091130382,0.6083333333333334,46.41203703703702,1014.3518518518489,28.981481481481396,0
1631,4,1,0,45,0.022222222222222223,0.0,1.0,45,1100,700,400,0.6363636363636364,15,7,8,341.1334847354683,0.4647727272727273,0.30014193025141966,0.18694114963503614,128731.13854595303,-217.0996227709606,128514.03892318207,1243,0,186.3111111111111,35,10,20,37.64161344282238,0.6095238095238096,46.296296296296276,1014.8148148148122,28.99470899470892,0
1632,4,1,1,45,0.021739130434782608,0.021739130434782608,0.9782608695652174,46,1950,1600,350,0.8205128205128205,23,16,7,352.97222231864555,0.4662640901771336,0.2500717904788792,0.18300063041047385,126496.56994409973,-260.1319381192755,126236.43800598045,1244,0,183.2391304347826,36,10,14,39.6309097354379,0.5847800925925926,48.507882882882896,1005.9684684684702,27.943568568568615,8
1633,4,1,1,45,0.021739130434782608,0.021739130434782608,0.9782608695652174,46,1300,800,500,0.6153846153846154,18,8,10,355.54279336766615,0.46723027375201287,0.2518772492948158,0.18523033640483313,126694.89590942296,-190.90856058761034,126503.98734883535,1245,0,184.19565217391303,36,10,15,39.36218307233408,0.5868055555555556,48.310810810810814,1006.756756756757,27.96546546546547,0
1634,4,3,2,46,0.0625,0.041666666666666664,0.9583333333333334,48,1750,1400,350,0.8,21,14,7,347.26588173919816,0.46865765366430256,0.27208848606560276,0.1855156695163495,127712.20419908306,-729.9817599897924,126982.22243909327,1246,0,177.0625,38,10,16,38.527023218123524,0.5934758771929824,47.30235042735042,1010.790598290597,26.599752586594658,0
1635,4,1,1,46,0.02127659574468085,0.02127659574468085,0.9787234042553191,47,1200,700,500,0.5833333333333334,17,7,10,355.52016664654013,0.46827782917052113,0.2858896422726209,0.1903078539107952,127793.20987654332,-313.3873456789995,127479.82253086432,1247,0,181.59574468085106,38,9,17,38.23546245421247,0.5942982456140351,47.22222222222223,1011.111111111112,26.60818713450295,0
1636,4,1,0,47,0.02127659574468085,0.0,1.0,47,1850,1400,450,0.7567567567567568,23,14,9,361.15906499078227,0.46916435399321615,0.2885204351040236,0.19397703836629152,127928.27641034778,-159.5086611512832,127768.7677491965,1248,0,182.3404255319149,38,9,18,37.95455345513431,0.5956688596491229,47.08867521367522,1011.6452991452996,26.62224471434999,0
1637,4,0,1,46,0.0,0.02127659574468085,0.9787234042553191,47,1600,900,700,0.5625,23,9,14,360.8388134307055,0.46916435399321615,0.2856834895862572,0.19459008294000804,128090.45041867575,-155.99877182406976,127934.45164685168,1249,1,183.3404255319149,38,9,19,37.79661389621811,0.5973135964912281,46.928418803418815,1012.2863247863263,26.63911381016648,0
1638,4,1,2,45,0.02127659574468085,0.0425531914893617,0.9574468085106383,47,1600,1400,200,0.875,18,14,4,338.25486449802054,0.46777674992291085,0.22990455991516456,0.17701128591655554,126876.64936262679,-811.8743836292049,126064.7749789976,1250,0,184.0,38,9,14,39.6107281724991,0.5849780701754386,48.130341880341874,1007.4786324786313,26.51259559154293,8
1639,4,1,2,44,0.021739130434782608,0.043478260869565216,0.9565217391304348,46,1450,1000,450,0.6896551724137931,19,10,9,362.59177804927185,0.46811594202898554,0.25575857170709937,0.18199542300157992,125160.3077744905,30.101495726498683,125190.409270217,1251,0,188.45652173913044,38,8,17,40.769138372837915,0.5674342105263157,49.83974358974359,1000.641025641026,26.332658569500683,8
1640,4,5,6,43,0.10204081632653061,0.12244897959183673,0.8775510204081632,49,1200,600,600,0.5,18,6,12,345.74155817256724,0.47146045918367346,0.2610905599638549,0.17685607106117476,125944.23678036034,-1091.1686665406878,124853.06811381965,1252,0,177.6734693877551,41,8,17,40.381415958358026,0.5706300813008129,49.057539682539684,1003.7698412698417,24.482191250483943,0
1641,4,3,1,45,0.06521739130434782,0.021739130434782608,0.9782608695652174,46,1500,1100,400,0.7333333333333333,19,11,8,362.05446390896554,0.46968599033816427,0.25832326991589705,0.18508868172647844,125919.34292524896,-82.02859268705578,125837.3143325619,1253,0,189.43478260869566,41,5,18,39.99775542815724,0.5703760162601625,49.08234126984128,1003.6706349206362,24.47977158343015,8
1642,4,5,5,45,0.1,0.1,0.9,50,1400,900,500,0.6428571428571429,19,9,10,339.10987558863405,0.4730187074829932,0.26865045772221663,0.17785323831207694,126967.00330884664,-1388.6010133219988,125578.40229552465,1254,0,175.16,41,9,13,39.49648505430323,0.5810467479674797,48.0406746031746,1007.8373015873012,24.581397599690273,0
1643,4,1,2,44,0.021739130434782608,0.043478260869565216,0.9565217391304348,46,1100,600,500,0.5454545454545454,16,6,10,362.1587082640274,0.4672403381642512,0.27394073663805063,0.18827456025646422,126607.7005259695,-29.58374424723428,126578.11678172226,1255,0,177.2391304347826,38,8,15,39.28542993630574,0.5822368421052632,48.397435897435884,1006.4102564102543,26.484480431848798,0
1644,4,2,0,46,0.043478260869565216,0.0,1.0,46,1500,1100,400,0.7333333333333333,19,11,8,357.13176731741646,0.46754227053140096,0.2769128143852442,0.1877609112365712,127065.7565646702,-124.15635850693832,126941.60020616326,1256,0,175.58695652173913,39,7,18,38.940941729517505,0.5852029914529915,47.942708333333336,1008.2291666666672,25.85202991452993,0
1645,4,3,4,45,0.061224489795918366,0.08163265306122448,0.9183673469387755,49,1800,1300,500,0.7222222222222222,23,13,10,336.8606552027075,0.46883857709750565,0.2769330520990516,0.18099604645717626,127943.71712805472,-1180.1564111611272,126763.5607168936,1257,0,165.77551020408163,41,8,16,38.55331110675296,0.5909552845528455,47.07341269841269,1011.7063492063475,24.675764614788964,0
1646,4,1,1,45,0.021739130434782608,0.021739130434782608,0.9782608695652174,46,1500,1000,500,0.6666666666666666,20,10,10,352.9316030449997,0.46782407407407406,0.27779921449734757,0.18904910146128573,127820.2174761668,-177.64114891520754,127642.57632725159,1258,0,176.45652173913044,38,8,17,38.27324352879028,0.5945723684210527,47.19551282051281,1011.2179487179471,26.610998650472293,0
1647,4,2,1,46,0.0425531914893617,0.02127659574468085,0.9787234042553191,47,1400,900,500,0.6428571428571429,19,9,10,344.2931360920453,0.46852836879432624,0.28382408714405294,0.18642165752648107,128252.72715547164,-568.2823571845877,127684.44479828705,1259,0,173.59574468085106,38,9,19,38.04956404036142,0.5989583333333333,46.7681623931624,1012.9273504273513,26.655982905982928,0
1648,4,2,1,47,0.041666666666666664,0.020833333333333332,0.9791666666666666,48,1600,1300,300,0.8125,19,13,6,336.59542351656364,0.46792811761229314,0.28152806297056787,0.1841819901714236,128672.41753472258,-937.8906249999613,127734.52690972263,1260,0,170.83333333333334,39,9,15,37.816563997262165,0.6014957264957265,46.354166666666686,1014.5833333333362,26.01495726495734,0
1649,4,0,2,45,0.0,0.0425531914893617,0.9574468085106383,47,1450,1000,450,0.6896551724137931,19,10,9,340.20962465564713,0.46698658649398705,0.26755587792821833,0.18711529356060622,128875.73964497067,-631.0465976331075,128244.69304733757,1261,1,172.0212765957447,38,9,16,37.51775568181819,0.6052631578947368,46.15384615384617,1015.3846153846174,26.720647773279406,0
1650,4,1,2,44,0.021739130434782608,0.043478260869565216,0.9565217391304348,46,1150,800,350,0.6956521739130435,15,8,7,350.0297046196133,0.4654991948470209,0.2740219621319888,0.19260992837089944,128895.01006319259,-176.58354012772008,128718.42652306487,1262,0,175.93478260869566,37,9,17,37.24883471907283,0.6072635135135135,46.13486842105264,1015.46052631579,27.44487908961595,0
1651,4,0,0,44,0.0,0.0,1.0,44,1550,1200,350,0.7741935483870968,19,12,7,365.0931765487417,0.46369582452431285,0.2848323447524519,0.20013501867744873,128743.83674214748,600.69926345264,129344.53600560012,1263,1,184.70454545454547,36,8,19,37.020777851753216,0.6076388888888888,46.28378378378378,1014.8648648648643,28.190690690690676,0
1652,4,1,0,45,0.022222222222222223,0.0,1.0,45,1550,1200,350,0.7741935483870968,19,12,7,359.55863071599913,0.4642045454545454,0.29276561057767303,0.19897008645412473,129117.79495854466,285.08351127266866,129402.87846981733,1264,0,181.57777777777778,37,8,20,36.779745208041135,0.6095157657657657,45.91557017543858,1016.3377192982433,27.46858700806063,0
1653,4,0,1,44,0.0,0.022222222222222223,0.9777777777777777,45,1300,700,600,0.5384615384615384,19,7,12,357.87100213182345,0.46319444444444446,0.28853230150601306,0.19890022110893923,129289.65627411245,253.85787440470352,129543.51414851715,1265,1,182.57777777777778,35,10,21,36.64753328781153,0.6151785714285714,45.746527777777764,1017.0138888888872,29.057539682539634,0
1654,4,0,0,44,0.0,0.0,1.0,44,700,300,400,0.42857142857142855,11,3,8,360.6705966967778,0.46271582100070474,0.27362953847426663,0.20105613288277524,129407.39300679407,534.6883305469408,129942.081337341,1266,2,180.9318181818182,35,9,23,36.45643745497288,0.6163690476190475,45.63078703703702,1017.476851851849,29.070767195767115,0
1655,4,0,0,44,0.0,0.0,1.0,44,1150,900,250,0.782608695652174,14,9,5,358.5605770759099,0.4623524489076815,0.27098538259557126,0.20032920678561292,129495.73072059303,486.41278720847504,129982.1435078015,1267,3,181.9318181818182,35,9,17,36.42019179743764,0.6172619047619048,45.54398148148147,1017.8240740740721,29.080687830687776,0
1656,4,0,0,44,0.0,0.0,1.0,44,1050,800,250,0.7619047619047619,13,8,5,358.71186412731356,0.4622313248766737,0.2636926844895475,0.2008649439037537,129584.09857520978,496.67071223419237,130080.76928744397,1268,4,182.9318181818182,35,9,17,36.32642283354173,0.6181547619047619,45.45717592592591,1018.1712962962941,29.090608465608405,0
1657,4,0,2,42,0.0,0.045454545454545456,0.9545454545454546,44,1050,800,250,0.7619047619047619,13,8,5,372.1520046304508,0.4617358174770965,0.2951361904137675,0.19951539552496142,127854.65630425366,775.5167810678347,128630.1730853215,1269,5,183.9318181818182,39,5,17,37.75202132042435,0.593215811965812,47.16145833333334,1011.3541666666682,25.93215811965816,8
1658,4,0,3,39,0.0,0.07142857142857142,0.9285714285714286,42,1100,600,500,0.5454545454545454,16,6,10,409.0828240653246,0.4593253968253968,0.3154809858112886,0.2117046252712091,126421.84452428397,1944.7139703360588,128366.55849462003,1270,8,193.35714285714286,35,7,14,38.29710457666782,0.5860119047619048,48.58217592592592,1005.671296296295,28.733465608465572,8
1659,4,2,0,41,0.04878048780487805,0.0,1.0,41,1000,700,300,0.7,13,7,6,403.8849033366499,0.460645325203252,0.29712892297788995,0.21070821503129075,126751.58900454507,2038.610654573491,128790.19965911856,1271,0,193.73170731707316,36,5,17,38.08688399314097,0.5873842592592593,48.2545045045045,1006.9819819819818,27.971721721721718,0
1660,4,2,0,43,0.046511627906976744,0.0,1.0,43,1200,900,300,0.75,15,9,6,388.11977321273014,0.46214008859357697,0.3022093781103323,0.20558289022994203,127368.57133925825,1287.3087421431715,128655.88008140142,1272,0,185.67441860465115,37,6,13,37.84805199507568,0.5917792792792793,47.64254385964912,1009.4298245614037,27.281887150308208,0
1661,4,1,1,43,0.022727272727272728,0.022727272727272728,0.9772727272727273,44,1350,900,450,0.6666666666666666,18,9,9,376.9549211428419,0.4620771670190275,0.2992431859313014,0.20135304219584904,127707.59489226002,828.0012723907853,128535.59616465081,1273,0,182.4318181818182,40,4,14,37.78152020912929,0.5901041666666667,47.306910569105696,1010.7723577235782,25.269308943089456,0
1662,4,2,1,44,0.044444444444444446,0.022222222222222223,0.9777777777777777,45,1050,700,350,0.6666666666666666,14,7,7,359.2732853147198,0.46327861952861954,0.2441496222590751,0.18516392396989415,126253.125,414.69239539956504,126667.81739539957,1274,0,177.86666666666667,34,11,19,39.72325870646767,0.5863970588235294,48.75,1005.0,29.558823529411764,8
1663,4,0,0,44,0.0,0.0,1.0,44,1350,900,450,0.6666666666666666,18,9,9,368.0587575105785,0.4626387420718816,0.2586495597595859,0.1892939582228183,126166.92648260288,487.36844002306816,126654.29492262595,1275,1,182.88636363636363,33,11,19,39.59146539806455,0.5877525252525253,48.83578431372549,1004.6568627450984,30.444147355912072,0
1664,4,2,2,44,0.043478260869565216,0.043478260869565216,0.9565217391304348,46,1400,800,600,0.5714285714285714,20,8,12,355.856552247791,0.4654991948470209,0.27040427154843627,0.18655889197806003,126950.11470507685,-164.7939747179405,126785.32073035892,1276,0,175.8913043478261,36,10,17,39.091891086527376,0.5894097222222222,48.05743243243244,1007.7702702702716,27.993618618618655,0
1665,4,2,2,44,0.043478260869565216,0.043478260869565216,0.9565217391304348,46,1250,500,750,0.4,20,5,15,342.0896708565609,0.46639492753623185,0.2873875669615047,0.18166356532096756,127471.58893014846,-478.4986998580315,126993.09023029043,1277,0,176.1304347826087,35,11,17,38.904130850047736,0.5967261904761905,47.54050925925927,1009.8379629629641,28.85251322751326,0
1666,4,2,1,45,0.043478260869565216,0.021739130434782608,0.9782608695652174,46,1400,800,600,0.5714285714285714,20,8,12,345.4946226839398,0.46580112721417066,0.3070758073807991,0.18524699739250533,127859.63909433087,-365.03644691988563,127494.60264741098,1278,0,176.58695652173913,36,10,19,38.420925657870306,0.5986689814814814,47.156531531531535,1011.3738738738742,28.09371871871873,0
1667,4,1,1,45,0.021739130434782608,0.021739130434782608,0.9782608695652174,46,1750,1400,350,0.8,21,14,7,348.53676675145687,0.4647443639291466,0.31767087309610287,0.1879422313334643,128087.52745566533,-271.3574638827754,127816.16999178256,1279,0,177.43478260869566,36,10,20,38.110931879704815,0.6009837962962963,46.93130630630632,1012.2747747747765,28.118743743743792,0
1668,4,1,0,46,0.021739130434782608,0.0,1.0,46,1050,700,350,0.6666666666666666,14,7,7,346.8311405469834,0.46454307568438,0.31144677404125654,0.18742592023752697,128173.82979949003,-309.05220287305474,127864.77759661699,1280,0,177.0,35,11,21,38.065898007391326,0.6038690476190476,46.846064814814824,1012.615740740742,28.931878306878342,0
1669,4,0,3,43,0.0,0.06521739130434782,0.9347826086956522,46,1450,1100,350,0.7586206896551724,18,11,7,352.6147305596242,0.4642612721417069,0.24494882708995536,0.185639404674683,127121.19187510706,-230.93653549384152,126890.25533961323,1281,1,178.0,35,11,18,38.99788151803818,0.5931547619047619,47.887731481481474,1008.4490740740732,28.812830687830665,7
1670,4,1,0,44,0.022727272727272728,0.0,1.0,44,1250,1000,250,0.8,15,10,5,362.0805724043934,0.46314526074700496,0.2770971588838711,0.19121291549745767,127246.52364775537,414.69882376966507,127661.22247152503,1282,0,186.27272727272728,33,11,20,38.630486052066885,0.598800505050505,47.76348039215684,1008.9460784313701,30.574123588829398,0
1671,4,1,1,44,0.022222222222222223,0.022222222222222223,0.9777777777777777,45,1200,800,400,0.6666666666666666,16,8,8,354.19906390121514,0.4643097643097643,0.2852423397599504,0.18898779720034029,127662.84190759624,43.61181972787392,127706.45372732411,1283,0,183.11111111111111,34,11,19,38.40239329328148,0.600796568627451,47.35119047619047,1010.5952380952372,29.72338935574227,0
1672,4,1,2,43,0.022222222222222223,0.044444444444444446,0.9555555555555556,45,1500,1000,500,0.6666666666666666,20,10,10,348.21189278845014,0.4644781144781145,0.2936659214809585,0.1871886702599009,127963.79145408144,-88.29719387757567,127875.49426020386,1284,0,183.88888888888889,34,11,20,38.24567596187787,0.6038602941176471,47.053571428571416,1011.7857142857127,29.75840336134449,0
1673,4,1,2,42,0.022727272727272728,0.045454545454545456,0.9545454545454546,44,1150,900,250,0.782608695652174,14,9,5,352.5389501720399,0.46481897463002114,0.29203086813888435,0.18978270211999387,128020.48040417141,226.44115244135958,128246.92155661277,1285,0,183.72727272727272,33,11,21,38.07822717364979,0.6066919191919191,46.99754901960784,1012.0098039215682,30.666963755199035,0
1674,4,1,0,43,0.023255813953488372,0.0,1.0,43,1050,600,450,0.5714285714285714,15,6,9,363.682253755961,0.46435492801771866,0.2867984960311929,0.19591914960401782,128048.66850321396,713.80567033976,128762.47417355372,1286,0,188.09302325581396,32,11,22,37.767433882235515,0.609375,46.96969696969697,1012.1212121212121,31.62878787878788,0
1675,4,2,0,45,0.044444444444444446,0.0,1.0,45,1600,1200,400,0.75,20,12,8,346.59498820902394,0.4646885521885522,0.2824836917129745,0.18950550280015177,128641.33536380234,-82.67570721369378,128558.65965658864,1287,0,180.6888888888889,33,12,20,37.59462833212533,0.6130050505050505,46.384803921568626,1014.4607843137251,30.7412358882947,0
1676,4,0,2,43,0.0,0.044444444444444446,0.9555555555555556,45,1050,800,250,0.7619047619047619,13,8,5,361.49269875608434,0.4648358585858586,0.22899799023830059,0.18956324446965397,126960.75439453125,189.22949368932598,127149.98388822058,1288,1,181.6888888888889,39,6,17,38.938953488372086,0.5841346153846154,48.046875,1007.8125,25.841346153846153,8
1677,4,3,4,42,0.06521739130434782,0.08695652173913043,0.9130434782608696,46,1950,1600,350,0.8205128205128205,23,16,7,346.0104455983578,0.46726046698872786,0.229037267080745,0.18521735617323845,127793.20987654307,-356.2394507137501,127436.97042582932,1289,0,172.34782608695653,38,8,17,38.475847069597066,0.5942982456140351,47.222222222222214,1011.1111111111101,26.608187134502895,0
1678,4,1,3,40,0.023255813953488372,0.06976744186046512,0.9302325581395349,43,650,300,350,0.46153846153846156,10,3,7,355.9993014780671,0.4656238464377999,0.22642946323571356,0.1904744772747366,127774.23327043238,497.50755823388647,128271.74082866627,1290,0,178.0,36,7,18,38.24278792604143,0.5978009259259259,47.24099099099098,1011.0360360360343,28.084334334334287,0
1679,4,1,0,41,0.024390243902439025,0.0,1.0,41,1300,1000,300,0.7692307692307693,16,10,6,374.85536049589007,0.4649644308943089,0.24930884069546022,0.20036638424547723,127734.70320001683,1376.4076431755445,129111.11084319236,1291,0,187.09756097560975,35,6,19,37.80675139302341,0.5994047619047619,47.280092592592574,1010.8796296296271,28.88227513227506,0
1680,4,3,0,44,0.06818181818181818,0.0,1.0,44,1300,900,400,0.6923076923076923,17,9,8,356.92503504441845,0.46496212121212116,0.2717275393228473,0.19567755136679515,128747.9184382085,393.29666022786324,129141.21509843635,1292,0,175.27272727272728,34,10,19,37.2238514173998,0.6118259803921569,46.2797619047619,1014.8809523809514,29.849439775910334,0
1681,4,0,0,44,0.0,0.0,1.0,44,1450,1200,250,0.8275862068965517,17,12,5,353.31349970998843,0.46426841085271314,0.2664846550759479,0.19447758133346515,128907.38195516102,308.94365140601695,129216.32560656704,1293,1,176.27272727272728,35,9,20,37.15285692576553,0.6113095238095239,46.122685185185176,1015.5092592592579,29.014550264550223,0
1682,4,1,2,43,0.022222222222222223,0.044444444444444446,0.9555555555555556,45,1500,900,600,0.6,21,9,12,351.1569649801184,0.4652356902356902,0.27385911004893604,0.19516864334473755,129289.65627411267,80.52755808470653,129370.18383219738,1294,0,173.33333333333334,35,10,21,36.818240013656535,0.6151785714285714,45.74652777777778,1017.013888888889,29.057539682539687,0
1683,4,1,2,42,0.022727272727272728,0.045454545454545456,0.9545454545454546,44,1550,1200,350,0.7741935483870968,19,12,7,352.1923920153761,0.465435606060606,0.277291335001137,0.19677127670795522,129495.73072059314,321.48223165293416,129817.21295224607,1295,0,177.54545454545453,35,9,17,36.58223409900689,0.6172619047619048,45.543981481481474,1017.824074074073,29.0806878306878,0
1684,4,0,0,42,0.0,0.0,1.0,42,1800,1200,600,0.6666666666666666,24,12,12,367.1463928397802,0.4620717189314751,0.28190235255649077,0.20440524526914916,129357.17520004314,1098.6040525278584,130455.779252571,1296,2,185.3095238095238,33,9,22,36.3428853953339,0.6202651515151515,45.68014705882352,1017.2794117647051,30.8266488413547,0
1685,4,0,1,41,0.0,0.023809523809523808,0.9761904761904762,42,1500,1000,500,0.6666666666666666,20,10,10,368.07079056456337,0.46167247386759586,0.2821728233627545,0.20524457851293268,129419.51600646375,1127.108714196445,130546.62472066018,1297,3,186.3095238095238,33,9,22,36.255846280460865,0.6208964646464646,45.6188725490196,1017.5245098039206,30.834076054664262,0
1686,4,1,0,42,0.023809523809523808,0.0,1.0,42,1450,1100,350,0.7586206896551724,18,11,7,363.1170002077306,0.4591923151374371,0.27432500446479335,0.20363712459068325,129643.02722318664,1015.1174286265314,130658.14465181317,1298,0,186.66666666666666,35,7,18,36.154321513808384,0.61875,45.39930555555555,1018.402777777777,29.0972222222222,0
1687,4,3,2,43,0.06666666666666667,0.044444444444444446,0.9555555555555556,45,1000,400,600,0.4,16,4,12,335.2209816942368,0.46109006734006736,0.20570935630696607,0.18957124146764198,129970.32470703124,-283.29023196373464,129687.0344750675,1299,0,175.15555555555557,39,6,18,36.53260888071645,0.6145833333333333,45.078125,1019.6874999999999,26.145833333333332,7
1688,4,0,2,41,0.0,0.046511627906976744,0.9534883720930233,43,1600,1300,300,0.8125,19,13,6,349.78961647325957,0.4607327427094869,0.2130106445268518,0.1970269512425744,129815.23762119129,481.6044359803226,130296.84205717161,1300,1,184.11627906976744,37,6,18,36.31868230399542,0.6165540540540541,45.23026315789475,1019.0789473684223,27.5426742532006,0
1689,4,0,0,41,0.0,0.0,1.0,41,1500,1200,300,0.8,18,12,6,385.2292231716892,0.45952743902439025,0.19179588203615694,0.20696303870582283,127939.53517500432,1657.2095496827887,129596.7447246871,1301,2,187.85365853658536,35,6,16,37.33423426000077,0.6014880952380952,47.0775462962963,1011.6898148148151,28.90542328042329,8
1690,4,0,0,41,0.0,0.0,1.0,41,1350,900,450,0.6666666666666666,18,9,9,384.7570659774374,0.45927337398373985,0.18733848328310732,0.20792091230615192,128173.82979948989,1663.157337748633,129836.98713723852,1302,3,188.85365853658536,35,6,16,37.10578828056541,0.6038690476190476,46.84606481481482,1012.6157407407408,28.931878306878307,0
1691,4,2,0,43,0.046511627906976744,0.0,1.0,43,1600,1100,500,0.6875,21,11,10,371.58040527447906,0.45879475821336285,0.20708999731306332,0.20446857595050189,128895.01006319239,978.9720154278073,129873.98207862019,1303,0,181.02325581395348,37,6,17,36.70173757333621,0.6072635135135135,46.13486842105262,1015.4605263157883,27.444879089615903,0
1692,4,1,2,42,0.022727272727272728,0.045454545454545456,0.9545454545454546,44,1100,500,600,0.45454545454545453,17,5,12,364.11371711788865,0.4593353594080338,0.2124505928853757,0.20221890762312075,129260.23046339171,614.1756788176176,129874.40614220932,1304,0,177.88636363636363,35,9,18,36.518798846649986,0.6148809523809524,45.77546296296297,1016.8981481481487,29.05423280423282,0
1693,4,0,0,42,0.0,0.0,1.0,42,1200,1000,200,0.8333333333333334,14,10,4,368.07428550781833,0.45956736353077815,0.2196646655853025,0.2045841653281259,129292.17864229038,1117.8252551020591,130410.00389739244,1305,1,186.02380952380952,34,8,18,36.38553981817473,0.6173406862745099,45.74404761904763,1017.0238095238105,29.91246498599443,0
1694,4,2,2,42,0.045454545454545456,0.045454545454545456,0.9545454545454546,44,1300,800,500,0.6153846153846154,18,8,10,355.81889283567034,0.4609540169133193,0.20252732575839416,0.19524691707052755,128783.68975309713,384.267002189846,129167.95675528698,1306,0,178.52272727272728,37,7,14,37.21541806200714,0.6061373873873874,46.24451754385965,1015.0219298245615,27.433025130393556,8
1695,4,1,0,43,0.023255813953488372,0.0,1.0,43,1450,900,550,0.6206896551724138,20,9,11,355.86246163207954,0.460640457733481,0.22478611880949528,0.1962327288428323,128978.53185595559,579.7235687903848,129558.25542474598,1307,0,183.09302325581396,37,6,15,37.01559801381691,0.6081081081081081,46.05263157894736,1015.7894736842098,27.453769559032697,0
1696,4,0,2,41,0.0,0.046511627906976744,0.9534883720930233,43,1250,800,450,0.64,17,8,9,353.8710915757951,0.46052510151347364,0.22546118886471422,0.1955470128582521,129062.08070031146,534.2678756924995,129596.34857600396,1308,1,184.09302325581396,37,6,15,36.981021366137895,0.6089527027027026,45.970394736842096,1016.1184210526301,27.462660028449463,0
1697,4,0,1,40,0.0,0.024390243902439025,0.975609756097561,41,1100,600,500,0.5454545454545454,16,6,10,365.2540408123924,0.4580538617886179,0.24147897814438557,0.2013485843071327,128966.15655006845,1221.0819615912096,130187.23851165966,1309,2,193.34146341463415,35,6,15,36.78972956548161,0.611904761904762,46.06481481481481,1015.7407407407396,29.02116402116399,0
1698,4,1,1,40,0.024390243902439025,0.024390243902439025,0.975609756097561,41,750,600,150,0.8,9,6,3,365.1572158022037,0.4580284552845528,0.23350659736105572,0.20249627421758568,129201.3888888889,1235.9782235939674,130437.36711248287,1310,0,193.09756097560975,34,7,16,36.552254098360656,0.616421568627451,45.833333333333336,1016.6666666666669,29.90196078431373,0
1699,4,0,0,40,0.0,0.0,1.0,40,1200,1000,200,0.8333333333333334,14,10,4,376.59168059759975,0.45627670940170945,0.2428196938652527,0.20900208521192534,129232.53864198866,1733.5797830161516,130966.11842500481,1311,1,198.75,33,7,19,36.229837089711154,0.6190025252525253,45.802696078431374,1016.7892156862746,30.811794414735594,0
1700,4,0,1,39,0.0,0.025,0.975,40,1150,800,350,0.6956521739130435,15,8,7,365.5434327294114,0.4562099358974359,0.17672563020664267,0.19863127270534672,128394.44739006223,1386.749408471826,129781.19679853405,1312,2,199.75,37,3,16,37.366452991452995,0.6021959459459459,46.628289473684205,1013.4868421052624,27.3915362731152,8
1701,4,0,0,39,0.0,0.0,1.0,39,1150,700,450,0.6086956521739131,16,7,9,367.75910738727316,0.4542566351776878,0.1907113583221547,0.20029856284377617,128486.82032962012,1650.4396710900064,130137.26000071013,1313,3,205.74358974358975,36,3,16,37.21583546225334,0.6050347222222222,46.53716216216216,1013.851351351351,28.162537537537528,0
1702,4,0,0,39,0.0,0.0,1.0,39,1100,600,500,0.5454545454545454,16,6,10,365.2082301423802,0.4535537561853351,0.18483854807123046,0.1996235277380191,128629.5755214672,1595.3159240321133,130224.8914454993,1314,4,206.74358974358975,36,3,17,37.13458407341622,0.6064814814814814,46.39639639639638,1014.4144144144126,28.17817817817813,0
1703,4,1,0,40,0.025,0.0,1.0,40,600,300,300,0.5,9,3,6,357.1459712533171,0.454821047008547,0.17682465990066976,0.1966638517091685,128922.84765504731,1208.855128501032,130131.70278354835,1315,0,202.55,37,3,19,37.0397862232779,0.607545045045045,46.107456140350855,1015.5701754385933,27.44784257942144,0
1704,4,0,0,40,0.0,0.0,1.0,40,1500,1100,400,0.7333333333333333,19,11,8,354.87080256660704,0.45419337606837606,0.16970220112214118,0.19623762519017368,129089.93632656186,1162.0498614958278,130251.9861880577,1316,1,203.55,37,3,20,36.92724068479355,0.6092342342342343,45.94298245614034,1016.2280701754372,27.46562351825506,0
1705,4,0,0,40,0.0,0.0,1.0,40,1550,1300,250,0.8387096774193549,18,13,5,358.87810770457895,0.453886217948718,0.17397575964492962,0.19945995777356965,129289.6562741127,1279.941621326862,130569.59789543955,1317,2,204.55,35,5,21,36.621927278934784,0.6151785714285714,45.74652777777778,1017.0138888888893,29.057539682539694,0
1706,4,0,0,40,0.0,0.0,1.0,40,1450,1100,350,0.7586206896551724,18,11,7,362.8491119704063,0.4534321581196581,0.18155066530194475,0.20257347565433548,129466.28146701396,1395.3450520833435,130861.6265190973,1318,3,205.55,35,5,18,36.34105254179462,0.6169642857142856,45.57291666666667,1017.7083333333339,29.07738095238097,0
1707,4,0,1,39,0.0,0.025,0.975,40,1400,900,500,0.6428571428571429,19,9,10,362.1333894588455,0.4540331196581197,0.17903761061946888,0.2025795693507404,129545.08562616675,1382.5201891080299,130927.60581527479,1319,4,206.55,36,4,18,36.27903761061947,0.6157407407407407,45.4954954954955,1018.0180180180184,28.27827827827829,0
1708,4,0,2,37,0.0,0.05128205128205128,0.9487179487179487,39,1050,600,450,0.5714285714285714,15,6,9,364.6930136247695,0.453525641025641,0.18438751477327808,0.20505765657323122,129745.78622118742,1663.476356423988,131409.2625776114,1320,5,211.64102564102564,36,3,18,36.00963486975423,0.6177662037037037,45.29842342342342,1018.8063063063064,28.300175175175177,0
1709,4,1,1,37,0.02631578947368421,0.02631578947368421,0.9736842105263158,38,750,500,250,0.6666666666666666,10,5,5,373.6766058109953,0.4548512328117591,0.1844548913739139,0.20995519106622743,129717.1051964125,2094.4495170846394,131811.55471349714,1321,0,214.78947368421052,36,2,19,35.810026531063464,0.6174768518518519,45.32657657657657,1018.6936936936927,28.29704704704702,0
1710,4,3,1,39,0.075,0.025,0.975,40,1200,900,300,0.75,15,9,6,351.8126169453229,0.45606303418803423,0.20822708746995544,0.20243505300960896,130644.58832137124,1192.482901417203,131837.07122278845,1322,0,204.3,38,2,17,35.42602849479221,0.6230811403508771,44.417735042735046,1022.3290598290604,26.90339631129106,0
1711,4,0,1,38,0.0,0.02564102564102564,0.9743589743589743,39,1050,700,350,0.6666666666666666,14,7,7,354.4951951388756,0.4543690958164643,0.20862658382769927,0.20388394227512263,130626.62459843411,1461.3021554709076,132087.92675390502,1323,1,210.35897435897436,37,2,17,35.375661446601576,0.6247184684684685,44.435307017543856,1022.2587719298243,27.62861545756282,0
1712,4,1,0,39,0.02564102564102564,0.0,1.0,39,1000,700,300,0.7,13,7,6,354.94294448753766,0.45431286549707606,0.2207948195728242,0.2050317479333891,130794.81336805534,1484.9392361110872,132279.75260416642,1324,0,210.89743589743588,37,2,18,35.193906992532234,0.6264076576576576,44.27083333333332,1022.9166666666649,27.646396396396348,0
1713,4,1,1,39,0.025,0.025,0.975,40,1050,600,450,0.5714285714285714,15,6,9,347.73523771738417,0.4545405982905983,0.22413928012519602,0.2023705071961824,131081.84633875726,1116.3553994082652,132198.20173816552,1325,0,206.6,38,2,19,35.08802816901406,0.627467105263158,43.990384615384606,1024.0384615384603,26.948380566801585,0
1714,4,0,0,39,0.0,0.0,1.0,39,900,500,400,0.5555555555555556,13,5,8,356.1055636692861,0.45324448942869994,0.2325709138048475,0.20675382726470456,130991.17036011058,1529.3369113573162,132520.5072714679,1326,1,212.7948717948718,37,2,19,34.965456298200515,0.6283783783783784,44.07894736842104,1023.684210526314,27.667140825035514,0
1715,4,0,0,39,0.0,0.0,1.0,39,1400,1000,400,0.7142857142857143,18,10,8,360.81597961998875,0.4527665317139002,0.23636293771168537,0.21040841957615053,131159.5935768696,1664.8954485995434,132824.48902546914,1327,2,213.7948717948718,37,2,19,34.67449867979732,0.6300675675675675,43.91447368421051,1024.3421052631563,27.68492176386909,0
1716,4,0,0,39,0.0,0.0,1.0,39,1100,900,200,0.8181818181818182,13,9,4,362.61316405942716,0.451951192082771,0.2382335755610605,0.21223201280297196,131300.02891514683,1722.223785203123,133022.25270034996,1328,3,214.7948717948718,37,2,20,34.48644395706286,0.6314752252252251,43.777412280701746,1024.8903508771918,27.69973921289708,0
1717,4,0,0,39,0.0,0.0,1.0,39,1400,1000,400,0.7142857142857143,18,10,8,362.6724200604521,0.45167004048583,0.23995140948229676,0.2127612317139382,131389.1439909297,1730.252781369934,133119.39677229963,1329,4,215.7948717948718,34,5,22,34.394836662021994,0.6384803921568627,43.69047619047619,1025.2380952380952,30.15406162464986,0
1718,4,1,0,40,0.025,0.0,1.0,40,1050,800,250,0.7619047619047619,13,8,5,351.0380272562952,0.4519364316239316,0.23697024346257844,0.20818244504130026,131803.09070644717,1253.5793895747483,133056.6700960219,1330,0,211.375,35,5,20,34.27543582807331,0.6404761904761904,43.28703703703703,1026.8518518518515,29.338624338624328,0
1719,4,0,0,40,0.0,0.0,1.0,40,1300,1000,300,0.7692307692307693,16,10,6,350.2335020233339,0.451428952991453,0.23230731279465,0.20810943139770885,131876.97991488117,1237.5473023699449,133114.5272172511,1331,1,212.375,36,4,20,34.22162226364069,0.6391782407407407,43.215090090090094,1027.13963963964,28.53165665665667,0
1720,4,0,1,39,0.0,0.025,0.975,40,1100,500,600,0.45454545454545453,17,5,12,349.70180920553736,0.451428952991453,0.16972607410775242,0.1959666571586189,129613.56122470846,1102.671308304675,130716.23253301314,1332,2,213.375,35,5,15,36.5258202621808,0.618452380952381,45.42824074074074,1018.2870370370367,29.093915343915334,8
1721,4,0,0,39,0.0,0.0,1.0,39,1500,1000,500,0.6666666666666666,20,10,10,346.17588306853395,0.4498144399460189,0.15537696134711076,0.19436131982339502,129688.42734203818,1179.0011717799096,130867.42851381809,1333,3,215.64102564102564,36,3,15,36.53952459922611,0.6171875,45.35472972972974,1018.5810810810826,28.293918918918962,0
1722,4,0,0,39,0.0,0.0,1.0,39,1500,1100,400,0.7333333333333333,19,11,8,332.0562266207308,0.4489428699955016,0.07481570946649496,0.17943471344894357,128172.28768707666,713.3494013954214,128885.63708847208,1334,4,216.64102564102564,37,2,21,38.441504241111716,0.5999436936936937,46.84758771929824,1012.609649122806,27.367828354670433,8
1723,4,0,1,38,0.0,0.02564102564102564,0.9743589743589743,39,1050,900,150,0.8571428571428571,12,9,3,332.8941365851423,0.4491959064327486,0.08041478619525844,0.18026237009223575,128255.57503270218,739.1057825484559,128994.68081525064,1335,5,217.64102564102564,37,2,21,38.33531788987516,0.6007882882882882,46.76535087719297,1012.9385964912266,27.376718824087206,0
1724,4,2,0,40,0.05,0.0,1.0,40,1450,900,550,0.6206896551724138,20,9,11,325.6656180342576,0.4496260683760684,0.09716608778023406,0.17874922223821355,128794.3915392832,388.781023997354,129183.17256328055,1336,0,212.825,38,2,21,37.96968740132616,0.6044407894736843,46.23397435897435,1015.0641025641013,26.712213225371087,0
1725,4,0,0,40,0.0,0.0,1.0,40,1200,800,400,0.6666666666666666,16,8,8,326.2864443106548,0.44966613247863246,0.10535977277508946,0.17970329893494094,128929.98598327104,413.6213383008021,129343.60732157184,1337,1,213.825,38,2,21,37.81602847324496,0.6058114035087719,46.10042735042734,1015.5982905982889,26.72627080521813,0
1726,4,0,1,39,0.0,0.025,0.975,40,900,600,300,0.6666666666666666,12,6,6,327.2955248833206,0.4491052350427351,0.09940063091482632,0.18075380032754784,129038.51290269538,446.74556213015137,129485.25846482553,1338,2,214.825,38,2,22,37.680073606729735,0.606907894736842,45.99358974358973,1016.0256410256393,26.73751686909577,0
1727,4,2,0,41,0.04878048780487805,0.0,1.0,41,700,500,200,0.7142857142857143,9,5,4,325.29008169516135,0.45195630081300814,0.049091447114347764,0.17635291719995208,128302.783203125,190.296204696745,128493.07940782174,1339,0,210.14634146341464,39,2,18,38.479762149564735,0.5977564102564102,46.71875,1013.125,25.977564102564102,8
1728,4,1,2,40,0.023809523809523808,0.047619047619047616,0.9523809523809523,42,950,600,350,0.631578947368421,13,6,7,321.142054886074,0.4543166860240031,0.05926503627595481,0.1756691032289138,128659.52934967614,-136.40287279397108,128523.12647688217,1340,0,206.11904761904762,40,2,17,38.2216434605496,0.5997395833333333,46.36686991869919,1014.5325203252034,25.363313008130085,0
1729,4,0,1,39,0.0,0.025,0.975,40,800,600,200,0.75,10,6,4,329.6823681260032,0.4536458333333333,0.059429339234903455,0.17948112399011143,128469.2559377054,470.809705785659,128940.06564349106,1341,1,216.125,38,2,17,38.198835493729575,0.6011513157894737,46.554487179487175,1013.7820512820508,26.67847503373818,0
1730,4,2,0,41,0.04878048780487805,0.0,1.0,41,1500,1200,300,0.8,18,12,6,326.09072978303755,0.45350609756097565,0.07654784240150114,0.1796262494567578,128936.76757812485,209.0169270833185,129145.78450520817,1342,0,210.21951219512195,39,2,19,37.814102564102555,0.6041666666666667,46.09374999999999,1015.6249999999989,26.041666666666636,0
1731,4,2,2,41,0.046511627906976744,0.046511627906976744,0.9534883720930233,43,850,600,250,0.7058823529411765,11,6,5,313.8839098399848,0.4548957179771133,0.09437485195145401,0.17520810887054647,129459.8174449731,-472.65799927913207,128987.15944569396,1343,0,201.3953488372093,40,3,16,37.59341089141867,0.6078125,45.57926829268292,1017.6829268292672,25.442073170731682,0
1732,4,1,0,42,0.023809523809523808,0.0,1.0,42,1350,1100,250,0.8148148148148148,16,11,5,314.2759550319041,0.4538448509485095,0.08171649060781827,0.17623723253355963,129640.87106095906,-251.39828722982887,129389.47277372924,1344,0,203.0,40,2,17,37.400001663173995,0.6096354166666667,45.40142276422764,1018.3943089430893,25.459857723577233,0
1733,4,0,2,40,0.0,0.047619047619047616,0.9523809523809523,42,800,400,400,0.5,12,4,8,314.79336571290037,0.45353029423151375,0.08898943118394564,0.1769940264313976,129744.38707325309,-231.46554217068623,129512.92153108241,1345,1,204.0,40,2,17,37.282003325020796,0.6106770833333333,45.29979674796747,1018.800813008128,25.4700203252032,0
1734,4,0,0,40,0.0,0.0,1.0,40,1300,900,400,0.6923076923076923,17,9,8,324.72636134222904,0.4523103632478633,0.08379760780610646,0.18194985008540762,129609.02829142011,417.4936308349736,130026.52192225508,1346,2,209.75,38,2,17,37.166220753331224,0.6126644736842105,45.43269230769231,1018.2692307692307,26.79655870445344,0
1735,4,0,0,40,0.0,0.0,1.0,40,1200,700,500,0.5833333333333334,17,7,10,324.4715015959459,0.45177617521367525,0.0843412357075426,0.18205925984191587,129663.42872242315,414.41748392870477,130077.84620635185,1347,3,210.75,38,2,17,37.11755655792161,0.6132127192982456,45.379273504273506,1018.4829059829062,26.80218173639227,0
1736,4,1,0,41,0.024390243902439025,0.0,1.0,41,1100,600,500,0.5454545454545454,16,6,10,318.5237941340712,0.4530233739837399,0.09062436931448659,0.18012879380580163,129970.3247070314,79.7281901041818,130050.05289713558,1348,0,206.58536585365854,39,2,18,36.95825671672285,0.6145833333333333,45.07812500000001,1019.6875000000011,26.145833333333364,0
1737,4,0,3,38,0.0,0.07317073170731707,0.926829268292683,41,950,300,650,0.3157894736842105,16,3,13,318.2937821043489,0.45218495934959346,0.08939354324630511,0.1807355127949042,130129.69970703125,83.89485677083348,130213.59456380208,1349,1,207.58536585365854,39,2,18,36.80289688616641,0.6161858974358974,44.921875,1020.3125,26.161858974358974,0
1738,4,0,0,38,0.0,0.0,1.0,38,1000,500,500,0.5,15,5,10,338.9348446219514,0.45012446657183497,0.08910485011024338,0.19057448970135477,129745.78622118759,1195.0735786462405,130940.85979983384,1350,2,222.78947368421052,36,2,18,36.66569949522863,0.6177662037037037,45.298423423423436,1018.8063063063078,28.300175175175216,0
1739,4,0,0,38,0.0,0.0,1.0,38,1100,800,300,0.7272727272727273,14,8,6,339.0475260217939,0.4497540303461356,0.09386449549287512,0.19105729206084915,129831.84831791263,1203.8333942050272,131035.68171211766,1351,3,223.78947368421052,36,2,18,36.57550644567219,0.6186342592592593,45.21396396396397,1019.1441441441452,28.309559559559588,0
1740,4,0,0,38,0.0,0.0,1.0,38,1200,800,400,0.6666666666666666,16,8,8,338.74244664650155,0.4491761498340446,0.09152243804031257,0.19130601182100926,129917.93894823882,1201.7441005194496,131119.68304875828,1352,4,224.78947368421052,36,2,18,36.495958982289515,0.6195023148148149,45.12950450450451,1019.4819819819822,28.31894394394395,0
1741,4,0,0,38,0.0,0.0,1.0,38,1250,800,450,0.64,17,8,9,339.3558650376457,0.44828710289236606,0.08832178724195616,0.19207541961130745,130004.05811216618,1223.5279198117,131227.58603197787,1353,5,225.78947368421052,36,2,19,36.39299911660777,0.6203703703703703,45.04504504504504,1019.8198198198195,28.32832832832832,0
1742,4,0,0,38,0.0,0.0,1.0,38,1200,800,400,0.6666666666666666,16,8,8,341.5532286955095,0.4477684921763869,0.0887776622259917,0.19374644325313833,130090.20580969483,1286.5459631929182,131376.75177288774,1354,6,226.78947368421052,36,2,20,36.24963204180004,0.6212384259259259,44.960585585585584,1020.1576576576576,28.33771271271271,0
1743,4,1,0,39,0.02564102564102564,0.0,1.0,39,1300,1100,200,0.8461538461538461,15,11,4,332.84392102134416,0.44975820962663066,0.0924953854068622,0.1904875209832561,130435.08193582075,883.0189564564354,131318.1008922772,1355,0,221.94871794871796,36,3,22,36.1226711498181,0.6247106481481481,44.62274774774774,1021.5090090090073,28.375250250250204,0
1744,4,0,1,38,0.0,0.02564102564102564,0.9743589743589743,39,1100,600,500,0.5454545454545454,16,6,10,337.3127724682841,0.44843679712100765,0.09560935924271852,0.19390677870136883,130607.69120049095,1011.1284849038166,131618.81968539476,1356,1,222.94871794871796,36,3,16,35.8339300796886,0.6264467592592593,44.453828828828826,1022.184684684684,28.394019019019,0
1745,4,0,0,38,0.0,0.0,1.0,38,1000,500,500,0.5,15,5,10,345.26368041692183,0.44527916073968704,0.10199761029198484,0.1980355648611346,130521.3723013554,1412.8578747666531,131934.23017612204,1357,9,229.78947368421052,36,2,16,35.71812320916905,0.6255787037037037,44.538288288288285,1021.8468468468468,28.384634634634633,0
1746,4,0,0,38,0.0,0.0,1.0,38,1050,800,250,0.7619047619047619,13,8,5,343.5166065472096,0.4449235419630157,0.10279858968708644,0.19732637474825795,130578.9150637124,1371.2051578605624,131950.12022157296,1358,10,230.78947368421052,36,2,17,35.70451373586014,0.6261574074074074,44.48198198198198,1022.0720720720724,28.3908908908909,0
1747,4,0,0,38,0.0,0.0,1.0,38,1300,1000,300,0.7692307692307693,16,10,6,345.6206250493299,0.44455310573731627,0.1058806816534561,0.19868261010593835,130607.69120049097,1428.1423737927055,132035.83357428366,1359,11,231.78947368421052,36,2,17,35.621626087914514,0.6264467592592593,44.453828828828826,1022.1846846846842,28.394019019019005,0
1748,4,1,0,39,0.02564102564102564,0.0,1.0,39,1250,900,350,0.72,16,9,7,343.27065960056086,0.4441632928475034,0.11225052921166023,0.19973860996944798,131075.368442694,1198.8656365420238,132274.23407923602,1360,0,226.82051282051282,37,2,19,35.208868722561306,0.629222972972973,43.996710526315795,1024.0131578947373,27.67603129445236,0
1749,4,0,1,38,0.0,0.02564102564102564,0.9743589743589743,39,1150,800,350,0.6956521739130435,15,8,7,342.9309715526167,0.4434604138551507,0.110237473825187,0.20012517596602736,131187.67463306017,1197.6633435287818,132385.33797658895,1361,1,227.82051282051282,37,2,20,35.10415551749975,0.6303490990990991,43.887061403508774,1024.451754385965,27.68788525367473,0
1750,4,0,0,38,0.0,0.0,1.0,38,850,700,150,0.8235294117647058,10,7,3,350.09171029341354,0.44188596491228066,0.11687127750091153,0.20367139614190718,131068.54056336742,1577.2019062981913,132645.74246966562,1362,2,208.81578947368422,36,2,20,35.04114886909343,0.6310763888888888,44.00337837837838,1023.9864864864866,28.444069069069073,0
1751,4,0,1,37,0.0,0.02631578947368421,0.9736842105263158,38,1000,600,400,0.6,14,6,8,355.0450662215155,0.4416044333807492,0.09464112710251982,0.19546986612854877,128915.32368517175,1554.4067293645107,130469.73041453626,1363,3,209.81578947368422,36,2,18,37.10079840319361,0.609375,46.11486486486487,1015.5405405405413,28.20945945945948,8
1752,4,0,1,36,0.0,0.02702702702702703,0.972972972972973,37,1100,600,500,0.5454545454545454,16,6,10,361.6712819144735,0.43931431431431434,0.10086641665589036,0.1996698435625944,129024.94454089513,1932.9234182098876,130957.86795910502,1364,4,214.48648648648648,35,2,19,36.82074504442926,0.6125,46.00694444444445,1015.9722222222229,29.027777777777796,0
1753,4,1,1,36,0.02702702702702703,0.02702702702702703,0.972972972972973,37,950,600,350,0.631578947368421,13,6,7,355.649042669805,0.4408158158158158,0.10208023225774676,0.19781289791026918,129319.08543381374,1798.441786694136,131117.52722050788,1365,0,213.8918918918919,35,2,20,36.6740631163708,0.6154761904761905,45.71759259259261,1017.1296296296321,29.06084656084663,0
1754,4,0,0,36,0.0,0.0,1.0,36,1000,700,300,0.7,13,7,6,357.1940030248955,0.4397817460317461,0.08502313731607103,0.19930119698804244,129443.56575963732,2047.2930839002418,131490.85884353757,1366,1,210.55555555555554,34,2,17,36.50805256590236,0.6188725490196079,45.5952380952381,1017.6190476190487,29.92997198879555,0
1755,4,2,1,37,0.05263157894736842,0.02631578947368421,0.9736842105263158,38,1150,900,250,0.782608695652174,14,9,5,340.60789570277916,0.4428787339971551,0.10116674995060992,0.19306797992964828,130061.48674011882,1259.9938621053802,131321.4806022242,1367,0,200.42105263157896,36,2,19,36.30285383086773,0.6209490740740741,44.98873873873875,1020.0450450450477,28.334584584584658,0
1756,4,0,1,36,0.0,0.02702702702702703,0.972972972972973,37,850,400,450,0.47058823529411764,13,4,9,351.0256248381455,0.4400963463463463,0.10857440868791568,0.1984939508872954,129967.37423911184,1724.37575017147,131691.7499892833,1368,1,206.78378378378378,35,2,19,36.13270904275443,0.6220238095238095,45.08101851851852,1019.6759259259263,29.133597883597893,0
1757,4,0,0,36,0.0,0.0,1.0,36,1250,800,450,0.64,17,8,9,358.87364044079845,0.440162037037037,0.09653150699146495,0.20304568058229022,129989.29280045332,2129.9461451246902,132119.23894557802,1369,2,211.91666666666666,34,2,19,35.91038213090513,0.6243872549019608,45.059523809523796,1019.7619047619031,29.992997198879504,0
1758,4,0,0,36,0.0,0.0,1.0,36,1000,600,400,0.6,14,6,8,369.791944163248,0.4398148148148148,0.05877433090024353,0.20264598540145978,128731.13854595326,2320.7475994512915,131051.88614540455,1370,3,212.91666666666666,35,1,18,36.91453771289537,0.6095238095238096,46.29629629629629,1014.8148148148141,28.994708994708976,8
1759,4,0,1,35,0.0,0.027777777777777776,0.9722222222222222,36,1050,500,550,0.47619047619047616,16,5,11,366.10800015317653,0.4392857142857143,0.06528759212825785,0.20152017524115248,128907.38195516117,2238.804762517143,131146.1867176783,1371,4,213.91666666666666,35,1,18,36.828033584074156,0.6113095238095239,46.12268518518518,1015.5092592592591,29.014550264550262,0
1760,4,1,0,36,0.027777777777777776,0.0,1.0,36,1050,800,250,0.7619047619047619,13,8,5,360.5481420980145,0.44150132275132276,0.05690906853697553,0.20023061027952477,129258.63997443399,2120.7924985796703,131379.43247301364,1372,0,211.86111111111111,36,0,21,36.6110649686231,0.6128472222222222,45.77702702702703,1016.8918918918927,28.24699699699702,0
1761,4,0,1,35,0.0,0.027777777777777776,0.9722222222222222,36,1150,800,350,0.6956521739130435,15,8,7,358.9465404327704,0.4412037037037037,0.05915922564140397,0.19992127288962086,129373.18019032561,2087.611090820569,131460.79128114617,1373,1,212.86111111111111,36,0,21,36.53512655892553,0.6140046296296297,45.66441441441442,1017.3423423423435,28.25950950950954,0
1762,4,0,0,35,0.0,0.0,1.0,35,1250,900,350,0.72,16,9,7,385.1886695244582,0.4411764705882353,0.07565506419882251,0.20219420116947232,127002.00007086174,2786.993041372879,129788.99311223462,1374,2,218.71428571428572,34,1,20,38.29942718790599,0.5940563725490196,48.00595238095239,1007.976190476191,29.646358543417385,8
1763,4,2,2,35,0.05405405405405406,0.05405405405405406,0.9459459459459459,37,650,500,150,0.7692307692307693,8,5,3,370.146694284679,0.44625875875875876,0.07968206410716716,0.1975624043089129,127676.20991941002,2051.817295848363,129728.02721525838,1375,0,207.83783783783784,35,2,18,37.98576118491373,0.5988095238095238,47.337962962962955,1010.648148148147,28.875661375661345,0
1764,4,1,0,36,0.027777777777777776,0.0,1.0,36,1000,500,500,0.5,15,5,10,376.35460400623117,0.4468419312169312,0.09684278013293568,0.20125965347738742,127753.08956916085,2416.0926870748094,130169.18225623565,1376,0,213.69444444444446,34,2,20,37.7499901868425,0.6017156862745099,47.26190476190475,1010.9523809523797,29.73389355742293,0
1765,4,2,0,38,0.05263157894736842,0.0,1.0,38,800,400,400,0.5,12,4,8,361.3976476631693,0.45093942626837363,0.11588777535286598,0.1963355567681276,128385.7160572562,1680.8567176870683,130066.57277494327,1377,0,203.39473684210526,34,4,17,37.48042209953404,0.6081495098039216,46.63690476190476,1013.4523809523806,29.807422969187666,0
1766,4,1,1,38,0.02564102564102564,0.02564102564102564,0.9743589743589743,39,700,400,300,0.5714285714285714,10,4,6,352.57198415389485,0.45032051282051283,0.11698553470705408,0.1933523282705128,128760.50407503838,1279.4692804783722,130039.97335551675,1378,0,199.15384615384616,35,4,18,37.32145911734519,0.6098214285714285,46.2673611111111,1014.9305555555538,28.998015873015824,0
1767,4,1,1,38,0.02564102564102564,0.02564102564102564,0.9743589743589743,39,1050,500,550,0.47619047619047616,16,5,11,345.45660799528525,0.45074224021592446,0.10386994677024886,0.1910317328699462,129089.93632656176,1118.9943059402563,130208.93063250202,1379,0,177.4102564102564,37,2,20,37.16641490433032,0.6092342342342343,45.942982456140335,1016.2280701754364,27.46562351825504,0
1768,4,0,0,38,0.0,0.0,1.0,38,850,400,450,0.47058823529411764,13,4,9,348.6456979304946,0.45090979137031767,0.10430966613208903,0.19292013634719254,129115.53603857219,1403.1152351675753,130518.65127373976,1380,1,182.57894736842104,36,2,20,37.05932594644504,0.611400462962963,45.91779279279278,1016.3288288288275,28.23135635635632,0
1769,4,1,1,38,0.02564102564102564,0.02564102564102564,0.9743589743589743,39,1100,700,400,0.6363636363636364,15,7,8,337.498440419787,0.4507984705353127,0.09931511580040842,0.18835375980373048,129452.33298947723,937.9920985302808,130390.3250880075,1381,0,178.87179487179486,37,2,16,37.00021100456127,0.6128941441441442,45.58662280701753,1017.6535087719275,27.50414888572777,0
1770,4,0,0,38,0.0,0.0,1.0,38,800,400,400,0.5,12,4,8,347.36441062035,0.4511172356567093,0.1053418168469995,0.19332980413639073,129344.54038075234,1385.9380072640145,130730.47838801636,1382,3,184.57894736842104,36,2,20,36.858832429240934,0.6137152777777778,45.692567567567565,1017.2297297297293,28.25638138138137,0
1771,4,0,0,38,0.0,0.0,1.0,38,950,600,350,0.631578947368421,13,6,7,344.12642722490443,0.45059862494073016,0.10951421483560608,0.19222587449064804,129487.77113261909,1312.032809836862,130799.80394245595,1383,4,185.57894736842104,36,2,16,36.79556686582578,0.615162037037037,45.5518018018018,1017.7927927927926,28.272022022022018,0
1772,4,0,1,37,0.0,0.02631578947368421,0.9736842105263158,38,1050,600,450,0.5714285714285714,15,6,9,343.0899816338463,0.450080014224751,0.10409343792918846,0.19248795247496933,129659.75265806344,1296.992431620807,130956.74508968425,1384,5,186.57894736842104,36,2,17,36.64722467934543,0.6168981481481481,45.38288288288288,1018.4684684684682,28.290790790790783,0
1773,4,0,0,37,0.0,0.0,1.0,37,1250,1000,250,0.8,15,10,5,349.6395382335121,0.44948073073073075,0.11251751364495965,0.19659346814161505,129745.7862211875,1672.8513564240034,131418.63757761152,1385,6,191.40540540540542,36,1,18,36.39304926126525,0.6177662037037037,45.29842342342343,1018.8063063063071,28.300175175175198,0
1774,4,1,1,37,0.02631578947368421,0.02631578947368421,0.9736842105263158,38,800,500,300,0.625,11,5,6,343.621119049737,0.45194701280227595,0.0756557442855339,0.17858180241441,126594.96792282216,1100.1409087411241,127695.1088315633,1386,0,187.3421052631579,37,1,14,39.76492699934625,0.5838963963963963,48.41008771929823,1006.3596491228051,27.19890943575149,8
1775,4,0,1,36,0.0,0.02702702702702703,0.972972972972973,37,1150,700,450,0.6086956521739131,16,7,9,352.5645713795668,0.4512012012012012,0.09175760361973428,0.1831695935958025,126581.54776397994,1525.63382639393,128107.18159037386,1387,1,193.21621621621622,36,1,15,39.553724634437486,0.5856481481481481,48.42342342342341,1006.3063063063041,27.95295295295289,0
1776,4,2,1,37,0.05263157894736842,0.02631578947368421,0.9736842105263158,38,1350,1100,250,0.8148148148148148,16,11,5,342.5292244142801,0.4539029160739687,0.09964081035015226,0.18093880155339848,127257.91229031993,1117.9107994767403,128375.82308979667,1388,0,184.68421052631578,37,1,18,39.111968412663906,0.5906531531531531,47.75219298245613,1008.9912280701741,27.270033191085787,0
1777,4,0,0,37,0.0,0.0,1.0,37,1150,900,250,0.782608695652174,14,9,5,351.05175906743256,0.45426676676676675,0.10094875058052977,0.18572171574748123,127319.21744379523,1539.127049346657,128858.34449314189,1389,1,189.27027027027026,36,1,17,38.83410511046643,0.5931712962962963,47.69144144144145,1009.2342342342349,28.034284284284304,0
1778,4,1,0,38,0.02631578947368421,0.0,1.0,38,1500,1200,300,0.8,18,12,6,344.956027874892,0.4556810099573258,0.11080031967119464,0.1844834441419088,127756.25673284105,1214.0581717451673,128970.31490458622,1390,0,185.26315789473685,37,1,19,38.54031091829356,0.5957207207207207,47.25877192982457,1010.9649122807032,27.32337600758657,0
1779,4,1,1,38,0.02564102564102564,0.02564102564102564,0.9743589743589743,39,1600,1200,400,0.75,20,12,8,338.3782941570555,0.4547627080521817,0.10984807477175118,0.18310488008955597,128227.80957842791,878.4906173053179,129106.30019573323,1391,0,181.48717948717947,37,2,20,38.22477987080942,0.6005067567567568,46.79276315789473,1012.8289473684206,27.373755334281636,0
1780,4,1,2,37,0.02564102564102564,0.05128205128205128,0.9487179487179487,39,1300,700,600,0.5384615384615384,19,7,12,337.7618579786783,0.45456590193432295,0.11059529554013636,0.1839190894505809,128477.80687326897,878.9805517082445,129356.78742497721,1392,0,182.07692307692307,37,2,17,37.98534501406012,0.6030405405405406,46.54605263157896,1013.8157894736864,27.400426742532066,0
1781,4,1,0,38,0.02631578947368421,0.0,1.0,38,1300,1100,200,0.8461538461538461,15,11,4,345.9230617874358,0.4526730678046467,0.1256459117585158,0.18854063246574296,128515.36502718947,1291.2857113870723,129806.65073857654,1393,0,187.44736842105263,36,2,18,37.74017103509551,0.6053240740740741,46.50900900900901,1013.9639639639649,28.165665665665692,0
1782,4,0,0,38,0.0,0.0,1.0,38,1100,800,300,0.7272727272727273,14,8,6,350.7718093132677,0.4522433617828355,0.13229752703436892,0.19187026290851433,128658.13607103738,1425.929434502083,130084.06550553947,1394,1,188.44736842105263,36,2,18,37.47155622155623,0.6067708333333333,46.36824324324325,1014.5270270270281,28.181306306306336,0
1783,4,1,1,38,0.02564102564102564,0.02564102564102564,0.9743589743589743,39,1000,700,300,0.7,13,7,6,343.7916385230956,0.4525416104363473,0.12792460362416191,0.18934434042876871,128929.98598327128,1065.0102271897204,129994.996210461,1395,0,184.5897435897436,38,1,19,37.37157234027633,0.6058114035087719,46.10042735042735,1015.598290598291,26.726270805218185,0
1784,4,1,1,38,0.02564102564102564,0.02564102564102564,0.9743589743589743,39,1100,700,400,0.6363636363636364,15,7,8,338.5676012669087,0.4531320287899235,0.11744048754724945,0.18788374425781224,129229.25954380188,950.8534403046169,130180.1129841065,1396,0,181.74358974358975,37,2,21,37.19973309608542,0.6106418918918919,45.805921052631575,1016.7763157894731,27.480440967283055,0
1785,4,1,0,39,0.02564102564102564,0.0,1.0,39,850,600,250,0.7058823529411765,11,6,5,339.0776296555532,0.4541722896986055,0.11779562894984852,0.1889670465810135,129396.54659366324,975.0948609187212,130371.64145458196,1397,0,182.25641025641025,37,2,23,37.01671785752773,0.6123310810810811,45.64144736842104,1017.4342105263142,27.4982219061166,0
1786,4,0,1,38,0.0,0.02564102564102564,0.9743589743589743,39,1500,1400,100,0.9333333333333333,16,14,2,333.5093236830717,0.45405982905982906,0.1113648406211083,0.18713033447149624,129663.42872242305,848.792483928692,130512.22120635174,1398,1,183.25641025641025,38,1,15,36.88743487534528,0.6132127192982456,45.3792735042735,1018.4829059829054,26.80218173639225,0
1787,4,0,0,38,0.0,0.0,1.0,38,1400,800,600,0.5714285714285714,20,8,12,340.5397528978242,0.4522433617828355,0.10625187686624216,0.19113436644518947,129675.59880203508,1231.9392745844705,130907.53807661954,1399,2,189.02631578947367,37,1,15,36.69606972404637,0.6151463963963963,45.3673245614035,1018.5307017543847,27.52785680417256,0
1788,4,1,1,38,0.02564102564102564,0.02564102564102564,0.9743589743589743,39,850,500,350,0.5882352941176471,12,5,7,332.1300418970962,0.4532726045883941,0.10486384250005387,0.1877872701342349,129962.83512309151,832.9123748995554,130795.74749799108,1400,0,185.15384615384616,38,1,16,36.61899273540096,0.6162280701754386,45.085470085470085,1019.6581196581195,26.833108412055775,0
1789,4,2,1,39,0.05,0.025,0.975,40,1100,900,200,0.8181818181818182,13,9,4,322.50462125914635,0.45607638888888885,0.10784198714679238,0.18413004089711169,130342.35161675338,407.20214843749613,130749.55376519088,1401,0,181.35,39,1,20,36.48043541092865,0.6183226495726496,44.713541666666664,1021.1458333333326,26.183226495726476,0
1790,4,0,2,37,0.0,0.05128205128205128,0.9487179487179487,39,950,600,350,0.631578947368421,13,6,7,338.726572827809,0.4563652721547458,0.07090799582337182,0.18646218850922114,128910.32036675331,933.0702039930375,129843.39057074634,1402,1,185.53846153846155,39,0,19,37.52019437891065,0.6038995726495726,46.11979166666666,1015.520833333332,26.038995726495692,7
1791,4,2,1,38,0.05128205128205128,0.02564102564102564,0.9743589743589743,39,1450,1200,250,0.8275862068965517,17,12,5,336.346297278737,0.4545377867746289,0.10428898397850483,0.18704725740752812,129312.88954293646,899.4387846500981,130212.32832758657,1403,0,186.4102564102564,37,2,21,37.17119448037947,0.6114864864864865,45.72368421052632,1017.1052631578962,27.489331436699896,0
1792,4,0,1,37,0.0,0.02631578947368421,0.9736842105263158,38,850,500,350,0.5882352941176471,12,5,7,342.4805003918744,0.4538288288288288,0.10790872220409242,0.19047314529183607,129315.9037415797,1257.635084408762,130573.53882598846,1404,1,190.6315789473684,36,2,21,37.01215124003542,0.6134259259259259,45.720720720720735,1017.1171171171195,28.25325325325332,0
1793,4,2,1,38,0.05128205128205128,0.02564102564102564,0.9743589743589743,39,1200,1000,200,0.8333333333333334,14,10,4,332.03845142439764,0.4551282051282051,0.14473180873180924,0.18130789112607282,128588.99493113243,775.5960605173317,129364.59099164976,1405,0,172.23076923076923,37,2,18,38.01711711711712,0.6041666666666667,46.43640350877192,1014.2543859649104,27.412280701754334,8
1794,4,0,1,37,0.0,0.02631578947368421,0.9736842105263158,38,1400,1000,400,0.7142857142857143,18,10,8,340.57623734497724,0.4535472972972973,0.14737776946807557,0.1861596326458465,128629.57552146718,1161.6353684765586,129791.21088994374,1406,1,177.6578947368421,36,2,19,37.75926028715217,0.6064814814814814,46.39639639639638,1014.4144144144125,28.178178178178126,0
1795,4,0,0,37,0.0,0.0,1.0,37,1150,600,550,0.5217391304347826,17,6,11,348.2280687234994,0.4527652652652652,0.148055207026349,0.19068803738281784,128701.77636584765,1563.514205032549,130265.2905708802,1407,2,182.97297297297297,35,2,19,37.49156400897303,0.6092261904761904,46.32523148148147,1014.699074074072,28.991402116402057,0
1796,4,3,1,39,0.075,0.025,0.975,40,1450,1200,250,0.8275862068965517,17,12,5,330.8333735389974,0.4562232905982906,0.17153353428786744,0.18568647775249195,129675.59880203496,581.17101862595,130256.7698206609,1408,0,170.175,37,3,16,36.94322585854236,0.6151463963963963,45.36732456140349,1018.5307017543838,27.527856804172536,0
1797,4,0,0,39,0.0,0.0,1.0,39,1400,900,500,0.6428571428571429,19,9,10,335.2551061929775,0.45557804768331084,0.16988773725813666,0.1885054658625147,129745.78622118715,899.5874675350703,130645.37368872222,1409,1,171.10256410256412,36,3,17,36.75942301315351,0.6177662037037037,45.29842342342341,1018.8063063063042,28.300175175175116,0
1798,4,0,1,38,0.0,0.02564102564102564,0.9743589743589743,39,1150,700,450,0.6086956521739131,16,7,9,339.7356332759156,0.455353126405758,0.1738174938970165,0.1920078916154896,129946.64216581466,1029.5009536563805,130976.14311947103,1410,2,172.10256410256412,36,3,18,36.44153596936897,0.6197916666666667,45.10135135135136,1019.5945945945962,28.322072072072118,0
1799,4,0,0,38,0.0,0.0,1.0,38,1250,800,450,0.64,17,8,9,343.7586619769013,0.45579954954954954,0.17018778641461174,0.19423797648200933,129937.87140185625,1333.45376264576,131271.325164502,1411,3,175.31578947368422,35,3,18,36.347887577099186,0.6217261904761905,45.10995370370371,1019.560185185186,29.130291005291028,0
1800,4,1,1,38,0.02564102564102564,0.02564102564102564,0.9743589743589743,39,650,400,250,0.6153846153846154,9,4,5,339.17512008507964,0.4566464237516869,0.1753275255145783,0.1933977850207169,130292.12648158881,1038.7747556584495,131330.90123724725,1412,0,171.7948717948718,35,4,20,36.105718361485856,0.625297619047619,44.76273148148149,1020.9490740740754,29.169973544973583,0
1801,4,1,0,39,0.02564102564102564,0.0,1.0,39,1150,900,250,0.782608695652174,14,9,5,342.75153298302274,0.4568713450292398,0.18612538839039416,0.1967812767386275,130558.13426997603,1149.800132887521,131707.93440286355,1413,0,172.23076923076923,35,4,18,35.74509248773122,0.6279761904761905,44.50231481481482,1021.990740740741,29.199735449735456,0
1802,4,0,1,38,0.0,0.02564102564102564,0.9743589743589743,39,1250,800,450,0.64,17,8,9,346.90895045269656,0.4560841205578048,0.18990901571546703,0.1999308921884916,130706.03358892754,1268.6185860339585,131974.6521749615,1414,1,173.23076923076923,35,4,19,35.4891765704584,0.6294642857142857,44.35763888888889,1022.569444444445,29.21626984126986,0
1803,4,0,0,38,0.0,0.0,1.0,38,1250,900,350,0.72,16,9,7,355.31772572710844,0.45536984352773824,0.187367072625082,0.20436123984050078,130627.4252409296,1682.8479308389897,132310.27317176858,1415,2,177.68421052631578,34,4,19,35.35382943208727,0.6308210784313726,44.4345238095238,1022.2619047619039,30.06652661064423,0
1804,4,0,1,37,0.0,0.02631578947368421,0.9736842105263158,38,1300,700,600,0.5384615384615384,19,7,12,352.7037515301576,0.4547178757705073,0.1830160246986181,0.20365797265773616,130779.59183673467,1625.2905328798172,132404.8823696145,1416,3,178.68421052631578,34,4,19,35.26657549658598,0.6323529411764706,44.285714285714285,1022.8571428571427,30.08403361344537,0
1805,4,0,0,37,0.0,0.0,1.0,37,650,400,250,0.6153846153846154,9,4,5,355.2713258428409,0.4539852352352352,0.16711905668032756,0.2053023875566599,130810.03578514738,1894.6109693877536,132704.64675453515,1417,4,175.0,34,3,19,35.170099693549005,0.6326593137254901,44.25595238095238,1022.9761904761904,30.0875350140056,0
1806,4,0,0,37,0.0,0.0,1.0,37,1000,600,400,0.6,14,6,8,354.82444223633604,0.45339089089089085,0.17088299186705624,0.20569290154455705,130931.84700963716,1891.563917233555,132823.4109268707,1418,5,176.0,34,3,20,35.058256756232794,0.6338848039215687,44.13690476190476,1023.4523809523807,30.101540616246492,0
1807,4,0,0,37,0.0,0.0,1.0,37,1100,700,400,0.6363636363636364,15,7,8,350.7367935553614,0.4525462962962963,0.16717042548244598,0.2041297630692297,131084.19075963701,1795.2097505668705,132879.40051020388,1419,6,177.0,34,3,20,35.00881577927613,0.6354166666666667,43.98809523809523,1024.0476190476177,30.119047619047578,0
1808,4,0,1,36,0.0,0.02702702702702703,0.972972972972973,37,1150,1000,150,0.8695652173913043,13,10,3,350.48812294979973,0.45192067067067065,0.1726969314812501,0.2044937624409144,131179.8740381727,1795.3975640860451,132975.27160225876,1420,7,178.0,35,2,20,34.9184884947087,0.6342261904761906,43.89467592592591,1024.421296296294,29.26917989417983,0
1809,4,1,0,37,0.02702702702702703,0.0,1.0,37,1300,1000,300,0.7692307692307693,16,10,6,355.1236389728327,0.4518581081081081,0.18194997505342347,0.20849897085705546,131419.65880102027,1934.1292176914335,133353.7880187117,1421,0,178.64864864864865,34,3,21,34.55750029025891,0.6387867647058824,43.66071428571428,1025.3571428571418,30.157563025210052,0
1810,4,0,0,37,0.0,0.0,1.0,37,1450,1300,150,0.896551724137931,16,13,3,355.22266052137076,0.45101351351351354,0.17867693639334425,0.20939185282990222,131572.28599773228,1947.4914965986204,133519.7774943309,1422,1,179.64864864864865,34,3,20,34.400866403651264,0.6403186274509804,43.51190476190475,1025.9523809523798,30.17507002801117,0
1811,4,0,0,37,0.0,0.0,1.0,37,1050,700,350,0.6666666666666666,14,7,7,354.5063005269221,0.4510760760760761,0.18307903077651377,0.20947216016741552,131663.90483276625,1935.136763038528,133599.04159580477,1423,2,180.64864864864865,34,3,20,34.326789235587526,0.6412377450980392,43.42261904761904,1026.3095238095223,30.18557422969183,0
1812,4,0,0,37,0.0,0.0,1.0,37,850,500,350,0.5882352941176471,12,5,7,354.3625611401585,0.4508571071071071,0.1844068094068092,0.2098916708291706,131755.5555555554,1937.8472222221983,133693.40277777758,1424,3,181.64864864864865,34,3,20,34.23802759740259,0.642156862745098,43.33333333333332,1026.6666666666654,30.196078431372513,0
1813,4,0,0,37,0.0,0.0,1.0,37,1250,700,550,0.56,18,7,11,354.69390663254416,0.4505755755755756,0.18442155646606295,0.21076439575933817,131877.80612244888,1955.2508503401236,133833.056972789,1425,4,182.64864864864865,34,3,20,34.10625289754289,0.6433823529411764,43.21428571428571,1027.1428571428564,30.210084033613423,0
1814,4,0,0,37,0.0,0.0,1.0,37,1150,900,250,0.782608695652174,14,9,5,357.3070646436304,0.4500125125125125,0.18684377808465413,0.2128307298094666,131969.53124999988,2030.7291666666517,134000.26041666654,1426,5,183.64864864864865,34,3,20,33.94667477696675,0.6443014705882353,43.12499999999999,1027.499999999999,30.22058823529409,0
1815,4,0,0,37,0.0,0.0,1.0,37,1350,1000,350,0.7407407407407407,17,10,7,357.5189416814818,0.44941816816816815,0.18467007999198803,0.2138181149834679,132122.47732426305,2047.2576530612198,134169.73497732426,1427,6,184.64864864864865,34,3,20,33.78710243940096,0.6458333333333333,42.976190476190474,1028.095238095238,30.238095238095237,0
1816,4,0,0,37,0.0,0.0,1.0,37,750,300,450,0.4,12,3,9,356.72662680041145,0.4485422922922923,0.18293293293293278,0.21403597608024685,132244.89795918364,2035.0552721088363,134279.9532312925,1428,7,185.64864864864865,34,3,20,33.68417245370369,0.6470588235294117,42.857142857142854,1028.5714285714282,30.252100840336123,0
1817,4,1,0,38,0.02631578947368421,0.0,1.0,38,1250,800,450,0.64,17,8,9,346.81803171591264,0.44781294452347087,0.17431217072002592,0.21043130881413338,132666.15125868045,1602.2026909722167,134268.35394965266,1429,0,181.73684210526315,35,3,19,33.51554600606675,0.6491071428571429,42.447916666666664,1030.2083333333326,29.43452380952379,0
1818,4,0,1,37,0.0,0.02631578947368421,0.9736842105263158,38,750,300,450,0.4,12,3,9,345.93616727573897,0.4468646277856804,0.17250673854447385,0.21039724272016253,132755.59413580244,1584.9922839506087,134340.58641975306,1430,1,182.73684210526315,35,3,19,33.44845013477087,0.65,42.36111111111111,1030.5555555555552,29.444444444444436,0
1819,4,0,0,37,0.0,0.0,1.0,37,1150,1000,150,0.8695652173913043,13,10,3,353.4557290342267,0.4449136636636637,0.16718875209441242,0.214970615527374,132755.59413580253,1984.6450617284008,134740.23919753093,1431,2,186.97297297297297,35,2,19,33.25471698113207,0.65,42.361111111111114,1030.5555555555559,29.444444444444454,0
1820,4,0,2,35,0.0,0.05405405405405406,0.9459459459459459,37,950,600,350,0.631578947368421,13,6,7,380.81993049560685,0.4450075075075075,0.12531255799031915,0.2200662853227135,130810.03578514737,2623.2953829679996,133433.33116811537,1432,3,187.97297297297297,34,3,18,34.516709337057286,0.6326593137254901,44.25595238095238,1022.9761904761903,30.087535014005596,8
1821,4,0,0,35,0.0,0.0,1.0,35,800,400,400,0.5,12,4,8,381.93059062370065,0.44303221288515404,0.1062744120335748,0.22105679639129333,130870.93431122442,2996.722647392288,133867.65695861672,1433,4,191.2,34,1,18,34.42650765949196,0.6332720588235294,44.19642857142857,1023.2142857142851,30.09453781512603,0
1822,4,0,0,35,0.0,0.0,1.0,35,1100,900,200,0.8181818181818182,13,9,4,385.51000543735836,0.44278711484593836,0.10438972518525924,0.22365823392377912,130962.30867346935,3097.456065759632,134059.764739229,1434,5,192.2,34,1,18,34.242217182290446,0.6341911764705883,44.107142857142854,1023.5714285714283,30.105042016806717,0
1823,4,0,0,35,0.0,0.0,1.0,35,1100,700,400,0.6363636363636364,15,7,8,385.8572201189834,0.4426470588235294,0.1084053156146183,0.22421433060967946,131023.24263038543,3111.2528344671146,134134.49546485255,1435,6,193.2,34,1,18,34.17151162790698,0.6348039215686274,44.047619047619044,1023.8095238095233,30.112044817927156,0
1824,4,0,0,35,0.0,0.0,1.0,35,1150,900,250,0.782608695652174,14,9,5,387.65575946479015,0.4413515406162465,0.11207463231632397,0.22633415644192575,131206.12953514745,3172.562358276648,134378.6918934241,1436,7,194.2,34,1,19,33.93998373227979,0.6366421568627452,43.86904761904762,1024.5238095238099,30.133053221288524,0
1825,4,0,1,34,0.0,0.02857142857142857,0.9714285714285714,35,1100,1000,100,0.9090909090909091,12,10,2,388.64708608185475,0.4405112044817927,0.11691572026300068,0.2278229064523276,131359.53006355732,3210.556406999074,134570.0864705564,1437,8,195.2,33,2,19,33.75909045626617,0.6404671717171717,43.71936274509804,1025.122549019608,31.064319667260847,0
1826,4,0,1,33,0.0,0.029411764705882353,0.9705882352941176,34,750,500,250,0.6666666666666666,10,5,5,393.2844206490847,0.4391154188948307,0.10856049736967988,0.23035230352303512,131328.12499999988,3529.8611111110968,134857.98611111098,1438,9,197.05882352941177,32,2,19,33.6720867208672,0.642578125,43.74999999999999,1024.999999999999,32.03124999999997,0
1827,4,1,1,33,0.029411764705882353,0.029411764705882353,0.9705882352941176,34,1200,1000,200,0.8333333333333334,14,10,4,394.1994253890878,0.4385398098633393,0.12481007163012836,0.2332490049791328,131716.66953627186,3584.527089072552,135301.19662534443,1439,0,197.05882352941177,32,2,19,33.2549200492005,0.646484375,43.371212121212125,1026.515151515152,32.0785984848485,0
1828,4,0,0,33,0.0,0.0,1.0,33,950,800,150,0.8421052631578947,11,8,3,398.77496731702905,0.4356455176767677,0.13862588846731905,0.23582468622356653,131695.4061720107,3903.3662584092926,135598.77243041998,1440,1,203.4848484848485,31,2,19,33.159039494270374,0.6488575268817205,43.391927083333336,1026.4322916666672,33.110719086021525,0
1829,4,0,0,33,0.0,0.0,1.0,33,1400,900,500,0.6428571428571429,19,9,10,396.5842233093092,0.4343434343434343,0.1332995224208613,0.2353543844424772,131829.0901184082,3856.267462836372,135685.35758124458,1441,2,204.4848484848485,31,2,20,33.07988356367017,0.6502016129032258,43.26171875,1026.953125,33.12752016129032,0
1830,4,0,0,33,0.0,0.0,1.0,33,1150,600,550,0.5217391304347826,17,6,11,393.7496120531423,0.4328440656565657,0.13289725222839,0.23511796048014402,132063.20020887582,3799.96676974826,135863.16697862407,1442,3,205.4848484848485,31,2,20,32.91582214340005,0.6525537634408602,43.033854166666664,1027.864583333333,33.156922043010745,0
1831,4,0,1,32,0.0,0.030303030303030304,0.9696969696969697,33,1200,900,300,0.75,15,9,6,401.2291509915778,0.433041351010101,0.15253615385228936,0.22921346535594056,130365.51371545851,3916.3900600525617,134281.90377551108,1443,4,206.4848484848485,30,3,18,34.44711327542336,0.6381944444444445,44.69086021505377,1021.2365591397855,34.04121863799285,8
1832,4,0,1,31,0.0,0.03125,0.96875,32,900,600,300,0.6666666666666666,12,6,6,418.3738786354319,0.43266969086021506,0.06694600818833174,0.23357215967246667,129466.28146701374,4433.0620659722035,133899.34353298595,1444,5,205.78125,31,1,16,34.92835209825998,0.6263440860215054,45.57291666666666,1017.7083333333321,32.82930107526878,8
1833,4,2,1,32,0.06060606060606061,0.030303030303030304,0.9696969696969697,33,1000,700,300,0.7,13,7,6,403.57939099705345,0.4350931186868687,0.07280593460139206,0.22829259772171856,129981.25908604855,3891.5514765955318,133872.8105626441,1445,0,197.57575757575756,33,0,18,34.77884769458799,0.6265782828282829,45.06740196078431,1019.7303921568621,30.900920974450365,0
1834,4,0,0,32,0.0,0.0,1.0,32,1000,700,300,0.7,13,7,6,407.2626298407568,0.43512684811827956,0.07263043074637943,0.23089647624445445,130069.31889921952,4194.474575298445,134263.79347451797,1446,1,203.4375,32,0,19,34.595092214382966,0.6298828125,44.98106060606061,1020.0757575757581,31.87736742424244,0
1835,4,0,1,31,0.0,0.03125,0.96875,32,1050,700,350,0.6666666666666666,14,7,7,407.4605529673435,0.434580813172043,0.07616680069281223,0.23177365585046,130198.14822785938,4210.121894449544,134408.27012230892,1447,2,204.4375,32,0,19,34.458637469586385,0.6311848958333333,44.85479797979798,1020.5808080808079,31.893150252525245,0
1836,4,0,0,31,0.0,0.0,1.0,31,600,500,100,0.8333333333333334,7,5,2,411.95460954968365,0.4345430107526882,0.07849270304307376,0.23431786862484907,130196.13477918833,4526.979573567699,134723.11435275603,1448,3,210.41935483870967,31,0,19,34.346027898273356,0.633736559139785,44.85677083333333,1020.5729166666663,32.9217069892473,0
1837,4,0,0,31,0.0,0.0,1.0,31,800,400,400,0.5,12,4,8,415.32694710537254,0.43418458781362007,0.07952600394996678,0.236639772187945,130262.58680555563,4620.32945421008,134882.9162597657,1449,4,211.41935483870967,30,1,19,34.1921768707483,0.6371527777777778,44.79166666666667,1020.833333333334,34.0277777777778,0
1838,4,0,1,30,0.0,0.03225806451612903,0.967741935483871,31,600,400,200,0.6666666666666666,8,4,4,413.9712603878116,0.4332885304659498,0.07640067911714787,0.23691126347495245,130434.15423748411,4599.198245461906,135033.352482946,1450,5,212.41935483870967,30,1,20,34.05180921052631,0.6388888888888888,44.623655913978496,1021.5053763440861,34.05017921146954,0
1839,4,0,2,28,0.0,0.06666666666666667,0.9333333333333333,30,600,200,400,0.3333333333333333,10,2,8,423.548125197249,0.4328304597701149,0.06192548273048648,0.24220629181186418,130404.40779321,5046.508487654338,135450.91628086433,1451,6,205.76666666666668,29,1,20,33.83759405312303,0.6415229885057472,44.652777777777786,1021.3888888888898,35.220306513409994,0
1840,4,0,1,27,0.0,0.03571428571428571,0.9642857142857143,28,1000,800,200,0.8,12,8,4,395.0369270484562,0.42928791887125217,0.018772504753812758,0.21625975029582947,128690.63986325813,4567.5109822962195,133258.15084555434,1452,7,218.35714285714286,28,0,21,36.31555036344755,0.6272321428571428,46.33620689655173,1014.6551724137939,36.23768472906407,8
1841,4,0,0,27,0.0,0.0,1.0,27,800,400,400,0.5,12,4,8,396.7854111209546,0.42729107312440645,-0.006083220630807906,0.21732367216335655,128710.16521843107,4814.0631643282295,133524.2283827593,1453,8,218.92592592592592,27,0,21,36.25119152368384,0.630787037037037,46.316964285714285,1014.7321428571424,37.58267195767194,0
1842,4,1,0,28,0.03571428571428571,0.0,1.0,28,550,300,250,0.5454545454545454,8,3,5,383.85558495935794,0.42961860670194,-0.010837508080155045,0.2120802106900454,129055.35737878193,4307.72393975427,133363.0813185362,1454,0,212.07142857142858,28,0,22,36.22619720965311,0.6309523809523809,45.97701149425288,1016.091954022989,36.28899835796389,0
1843,4,0,0,28,0.0,0.0,1.0,28,650,300,350,0.46153846153846156,10,3,7,382.4239716670228,0.4291225749559083,-0.013762672159618461,0.21167974769738035,129128.36281212851,4276.356272294901,133404.7190844234,1455,1,213.07142857142858,28,0,24,36.187977099236655,0.6316964285714286,45.90517241379311,1016.3793103448284,36.29926108374387,0
1844,4,1,1,28,0.034482758620689655,0.034482758620689655,0.9655172413793104,29,700,500,200,0.7142857142857143,9,5,4,369.83820625399,0.43123973727422005,-0.012701698264101502,0.2069400039573853,129554.6392746914,3782.8510802469204,133337.49035493832,1456,0,206.68965517241378,29,0,18,36.0732150977717,0.6329022988505747,45.486111111111114,1018.055555555556,35.10536398467435,0
1845,4,0,0,28,0.0,0.0,1.0,28,450,300,150,0.6666666666666666,6,3,3,379.73228899453295,0.42920524691358025,0.00043880000807039465,0.21155659625257972,129384.04439572597,4226.259867551861,133610.30426327782,1457,1,214.67857142857142,28,0,25,35.99538671562399,0.6343005952380952,45.65373563218391,1017.3850574712642,36.33518062397372,0
1846,4,0,0,28,0.0,0.0,1.0,28,700,500,200,0.7142857142857143,9,5,4,380.10269671309663,0.42854387125220456,-0.005995240112139477,0.21215661156965027,129457.14272443515,4241.401811666,133698.54453610114,1458,2,215.67857142857142,28,0,19,35.911395830392024,0.6350446428571428,45.581896551724135,1017.672413793103,36.34544334975368,0
1847,4,0,0,28,0.0,0.0,1.0,28,550,400,150,0.7272727272727273,7,4,3,380.10269671309663,0.42854387125220456,-0.005995240112139477,0.21215661156965027,129457.14272443515,4241.401811666,133698.54453610114,1459,3,216.67857142857142,28,0,19,35.911395830392024,0.6350446428571428,45.581896551724135,1017.672413793103,36.34544334975368,0
1848,4,0,0,28,0.0,0.0,1.0,28,700,500,200,0.7142857142857143,9,5,4,380.10269671309663,0.42854387125220456,-0.005995240112139477,0.21215661156965027,129457.14272443515,4241.401811666,133698.54453610114,1460,4,217.67857142857142,28,0,19,35.911395830392024,0.6350446428571428,45.581896551724135,1017.672413793103,36.34544334975368,0
1849,4,0,0,28,0.0,0.0,1.0,28,550,400,150,0.7272727272727273,7,4,3,380.26978667859544,0.4286816578483245,-0.0049709607163022085,0.21244725306239512,129493.69963006997,4248.508306909761,133742.20793697974,1461,5,218.67857142857142,28,0,19,35.869859307359306,0.6354166666666667,45.54597701149425,1017.8160919540226,36.35057471264366,0
1850,4,0,0,28,0.0,0.0,1.0,28,500,300,200,0.6,7,3,4,381.57274097696876,0.4281305114638448,-0.005846538446030225,0.21357223085014224,129566.82892390013,4287.834010437313,133854.66293433745,1462,6,219.67857142857142,28,0,19,35.7621248471164,0.6361607142857143,45.474137931034484,1018.1034482758621,36.360837438423644,0
1851,4,1,1,28,0.034482758620689655,0.034482758620689655,0.9655172413793104,29,900,800,100,0.8888888888888888,10,8,2,371.48493415775374,0.42785303776683087,0.005915354099669257,0.2106993699914056,130085.4190779322,3864.954668209893,133950.37374614208,1463,0,213.06896551724137,29,0,20,35.49112207851148,0.6382902298850575,44.965277777777786,1020.1388888888896,35.17720306513412,0
1852,4,2,2,28,0.06666666666666667,0.06666666666666667,0.9333333333333333,30,950,700,250,0.7368421052631579,12,7,5,369.2169710385882,0.42890325670498086,0.032720185696141435,0.213372085540979,130812.00003251815,3659.6020855012052,134471.60211801936,1464,0,206.6,30,0,18,34.81145710156353,0.6427083333333333,44.25403225806451,1022.9838709677414,34.09946236559138,0
1853,4,0,0,28,0.0,0.0,1.0,28,950,500,450,0.5263157894736842,14,5,9,393.2275397294577,0.42540233686067025,0.052579504590474,0.22532159830911958,130482.68688482628,4661.877188201886,135144.56407302816,1465,1,221.67857142857142,28,0,23,34.532180190315486,0.6454613095238095,44.57614942528736,1021.6954022988507,36.489121510673236,0
1854,4,0,0,28,0.0,0.0,1.0,28,600,400,200,0.6666666666666666,8,4,4,392.8748049032501,0.4246307319223986,0.05169106866702822,0.22554628630159948,130556.09486474433,4658.440059783329,135214.53492452766,1466,2,222.67857142857142,28,0,18,34.46652842213787,0.6462053571428572,44.50431034482759,1021.9827586206895,36.499384236453196,0
1855,4,1,0,29,0.034482758620689655,0.0,1.0,29,1050,800,250,0.7619047619047619,13,8,5,381.5203003116895,0.4250821018062398,0.060075796565760786,0.2214019380548939,130972.46334876548,4193.730709876555,135166.19405864202,1467,0,215.9655172413793,29,0,19,34.3340117593849,0.6472701149425287,44.09722222222223,1023.6111111111115,35.2969348659004,0
1856,4,0,0,29,0.0,0.0,1.0,29,950,700,250,0.7368421052631579,12,7,5,382.25797184717055,0.42405582922824303,0.051338398597311485,0.22285790848797488,131150.23389274694,4226.644483024698,135376.87837577163,1468,1,216.9655172413793,29,0,21,34.13488700564972,0.649066091954023,43.923611111111114,1024.3055555555557,35.32088122605364,0
1857,4,0,0,29,0.0,0.0,1.0,29,800,300,500,0.375,13,3,10,382.6710884863947,0.4239018883415435,0.05216586501381304,0.22351263814442845,131221.37586805547,4242.925347222217,135464.3012152777,1469,2,217.9655172413793,29,0,21,34.05220618137455,0.6497844827586207,43.854166666666664,1024.5833333333328,35.33045977011493,0
1858,4,0,0,29,0.0,0.0,1.0,29,650,400,250,0.6153846153846154,9,4,5,381.3768350801146,0.4230295566502463,0.053539142906530834,0.22358557742067728,131363.7176890433,4219.815779321004,135583.5334683643,1470,3,218.9655172413793,29,0,21,33.94117215372805,0.6512212643678161,43.715277777777786,1025.1388888888896,35.349616858237574,0
1859,4,0,1,28,0.0,0.034482758620689655,0.9655172413793104,29,950,800,150,0.8421052631578947,11,8,3,381.15670127448203,0.4225164203612479,0.05434325891481584,0.22449947333439574,131541.75347222213,4227.604166666662,135769.3576388888,1471,4,219.9655172413793,29,0,21,33.76658543189819,0.6530172413793103,43.541666666666664,1025.8333333333328,35.373563218390785,0
1860,4,0,0,28,0.0,0.0,1.0,28,750,500,250,0.6666666666666666,10,5,5,388.30717748272593,0.4200562169312169,0.05235861323944224,0.22897618120595753,131585.97414205974,4619.155643083635,136205.12978514336,1472,5,225.92857142857142,28,0,20,33.538428324697755,0.6566220238095238,43.49856321839081,1026.005747126437,36.64306239737275,0
1861,4,1,0,29,0.034482758620689655,0.0,1.0,29,800,300,500,0.375,13,3,10,374.54063010388165,0.42102832512315275,0.049780462566769934,0.22309594054013815,131969.53125,4085.5902777777783,136055.12152777778,1473,0,219.10344827586206,29,0,21,33.50398756420655,0.6573275862068966,43.125,1027.5,35.43103448275862,0
1862,4,0,0,29,0.0,0.0,1.0,29,950,600,350,0.631578947368421,13,6,7,374.6104826747787,0.41995073891625617,0.05534384928584046,0.22397954707259396,132112.27816358034,4098.128858024698,136210.40702160503,1474,1,220.10344827586206,29,0,21,33.35810141403225,0.6587643678160919,42.986111111111114,1028.055555555556,35.450191570881245,0
1863,4,0,0,29,0.0,0.0,1.0,29,550,400,150,0.7272727272727273,7,4,3,375.6670380297324,0.4197454844006568,0.05673375658516844,0.22482320796557068,132147.9769483025,4128.727816358034,136276.70476466054,1475,2,221.10344827586206,29,0,21,33.294919852312134,0.6591235632183908,42.95138888888889,1028.1944444444448,35.45498084291189,0
1864,4,0,0,29,0.0,0.0,1.0,29,800,600,200,0.75,10,6,4,373.8053152217078,0.4201046798029557,0.05588023004028053,0.22413185094872448,132219.38898533955,4084.8620756172963,136304.25106095686,1476,3,222.10344827586206,29,0,21,33.270734863830754,0.6598419540229885,42.88194444444445,1028.4722222222226,35.46455938697319,0
1865,4,0,0,29,0.0,0.0,1.0,29,1300,1000,300,0.7692307692307693,16,10,6,373.5407756053557,0.4197454844006568,0.05782042150249267,0.22439712286365535,132290.82031250003,4083.203125000001,136374.02343750003,1477,4,223.10344827586206,29,0,22,33.20549817739976,0.6605603448275862,42.8125,1028.7500000000002,35.47413793103449,0
1866,4,0,0,29,0.0,0.0,1.0,29,800,600,200,0.75,10,6,4,376.8097111950763,0.4184626436781609,0.06281436262033568,0.22722024163276744,132433.74083719144,4180.463927469141,136614.20476466056,1478,5,224.10344827586206,29,0,22,32.9773028831017,0.6619971264367817,42.673611111111114,1029.305555555556,35.49329501915711,0
1867,4,0,0,29,0.0,0.0,1.0,29,1050,800,250,0.7619047619047619,13,8,5,375.7533155547286,0.4180521346469623,0.060285518915977,0.22701380017988615,132505.23003472216,4157.855902777773,136663.08593749994,1479,6,225.10344827586206,29,0,22,32.932432888169444,0.6627155172413793,42.604166666666664,1029.583333333333,35.50287356321838,0
1868,4,0,0,29,0.0,0.0,1.0,29,600,400,200,0.6666666666666666,8,4,4,376.6822063028055,0.4176929392446634,0.0633470693841105,0.22779134400725948,132540.981867284,4185.16589506174,136726.14776234573,1480,7,226.10344827586206,29,0,22,32.87249348080209,0.6630747126436782,42.56944444444445,1029.7222222222226,35.50766283524906,0
1869,4,0,0,29,0.0,0.0,1.0,29,650,300,350,0.46153846153846156,10,3,7,378.17733371037167,0.4170258620689655,0.06472491909385103,0.2291309727774605,132612.5,4230.208333333333,136842.70833333334,1481,8,227.10344827586206,29,0,22,32.76193365695792,0.6637931034482758,42.5,1030.0,35.51724137931034,0
1870,4,0,0,29,0.0,0.0,1.0,29,600,300,300,0.5,9,3,6,376.24459815011403,0.41589696223316913,0.06330437692597268,0.22861250398654362,132719.81336805562,4187.02256944445,136906.83593750006,1482,9,228.10344827586206,29,0,20,32.70361571640383,0.6648706896551724,42.395833333333336,1030.4166666666672,35.53160919540232,0
1871,4,0,0,29,0.0,0.0,1.0,29,450,300,150,0.6666666666666666,6,3,3,378.63263612125303,0.41487068965517243,0.06995963152735896,0.2309441296571949,132862.96537422846,4261.2509645061855,137124.21633873464,1483,10,229.10344827586206,29,0,20,32.49795118774979,0.6663074712643677,42.25694444444445,1030.9722222222229,35.55076628352493,0
1872,4,0,0,29,0.0,0.0,1.0,29,700,600,100,0.8571428571428571,8,6,2,378.4252401774536,0.41420361247947457,0.07076720190941455,0.23148153488943757,132970.3800154322,4263.869598765448,137234.24961419764,1484,11,230.10344827586206,29,0,21,32.39518807792441,0.6673850574712643,42.152777777777786,1031.3888888888896,35.565134099616884,0
1873,4,0,0,29,0.0,0.0,1.0,29,900,600,300,0.6666666666666666,12,6,6,377.5722584975881,0.41394704433497537,0.06936480595033045,0.23118129957638806,133006.19454089509,4243.889853395064,137250.08439429014,1485,12,231.10344827586206,29,0,21,32.381148736591726,0.6677442528735632,42.11805555555556,1031.5277777777778,35.56992337164751,0
1874,4,0,0,29,0.0,0.0,1.0,29,600,500,100,0.8333333333333334,7,5,2,378.8612967327174,0.41292077175697867,0.06683064927832172,0.23263962270447042,133113.6670524692,4286.323302469144,137399.99035493835,1486,13,232.10344827586206,29,0,21,32.23979362943024,0.6688218390804598,42.01388888888889,1031.944444444445,35.58429118773948,0
1875,4,0,1,28,0.0,0.034482758620689655,0.9655172413793104,29,900,500,400,0.5555555555555556,13,5,8,395.6420570342241,0.4118944991789819,0.03853153863373149,0.22144704708882396,129566.82892390012,4500.642652412621,134067.47157631273,1487,14,233.10344827586206,28,1,19,35.404024367297026,0.6361607142857143,45.474137931034484,1018.103448275862,36.360837438423644,8
1876,4,0,0,28,0.0,0.0,1.0,28,500,400,100,0.8,6,4,2,399.5978549873493,0.4114307760141094,0.037572556061302054,0.223735558414357,129579.88989866774,4755.969210600896,134335.85910926864,1488,15,238.14285714285714,27,1,19,35.28999805125206,0.6396604938271605,45.46130952380952,1018.1547619047614,37.70943562610227,0
1877,4,1,0,29,0.034482758620689655,0.0,1.0,29,750,400,350,0.5333333333333333,11,4,7,385.99178271728516,0.4132286535303777,0.027761172267988243,0.21786887019722664,129896.1662083829,4227.7705525829015,134123.9367609658,1489,0,230.89655172413794,28,1,21,35.31389476156917,0.6395089285714286,45.150862068965516,1019.3965517241381,36.4070197044335,0
1878,4,0,0,29,0.0,0.0,1.0,29,300,200,100,0.6666666666666666,4,2,2,388.36085453591613,0.4127155172413793,0.022991744933507308,0.21961728961286037,129969.4090409896,4295.0061517373515,134264.41519272694,1490,1,231.89655172413794,28,1,21,35.17889014137428,0.6402529761904762,45.07902298850575,1019.6839080459773,36.417282430213476,0
1879,4,1,0,30,0.03333333333333333,0.0,1.0,30,850,500,350,0.5882352941176471,12,5,7,378.2829545050273,0.4154214559386973,0.021131357084579916,0.21632137227293693,130404.40779320979,3865.952932098752,134270.36072530854,1491,0,225.13333333333333,29,1,22,34.99342761309038,0.6415229885057472,44.65277777777777,1021.3888888888881,35.22030651340994,0
1880,4,0,1,29,0.0,0.03333333333333333,0.9666666666666667,30,650,500,150,0.7692307692307693,8,5,3,377.1865161841449,0.41479885057471266,0.022512234910277096,0.21608909758960834,130475.34722222228,3842.7083333333385,134318.05555555562,1492,1,226.13333333333333,29,1,23,34.94936106579662,0.6422413793103448,44.583333333333336,1021.6666666666671,35.22988505747128,0
1881,4,0,0,29,0.0,0.0,1.0,29,750,600,150,0.8,9,6,3,376.37787724470155,0.41379310344827586,-0.012372177596985612,0.2160209376572943,130546.30594135798,4026.9483024691312,134573.2542438271,1493,2,195.24137931034483,29,0,17,34.897956872338504,0.6429597701149425,44.513888888888886,1021.944444444444,35.23946360153255,0
1882,4,1,0,30,0.03333333333333333,0.0,1.0,30,550,200,350,0.36363636363636365,9,2,7,368.2328981959588,0.4146791187739463,0.0001356614590168892,0.21394584176648496,131018.32807622262,3649.0517328592805,134667.3798090819,1494,0,189.7,30,0,18,34.627587414117535,0.6447916666666667,44.052419354838705,1023.7903225806447,34.12634408602149,0
1883,4,0,0,30,0.0,0.0,1.0,30,550,300,250,0.5454545454545454,8,3,5,367.9276260340782,0.4138170498084291,0.002848142800892184,0.21415130502319624,131087.1402221353,3646.1160611053015,134733.2562832406,1495,1,190.7,30,0,18,34.56572384827405,0.6454861111111111,43.985215053763426,1024.0591397849446,34.13530465949815,0
1884,4,0,1,29,0.0,0.03333333333333333,0.9666666666666667,30,950,600,350,0.631578947368421,13,6,7,369.703466487686,0.41345785440613025,0.008676637802851106,0.2157641517281118,131190.39231414022,3700.308561683414,134890.70087582362,1496,2,191.7,30,0,18,34.415726406017676,0.6465277777777778,43.88440860215053,1024.4623655913967,34.14874551971322,0
1885,4,1,1,29,0.03333333333333333,0.03333333333333333,0.9666666666666667,30,850,500,350,0.5882352941176471,12,5,7,369.31595543039754,0.4156609195402299,0.020319874147875838,0.21670323907869785,131397.0184414383,3705.403081281068,135102.42152271938,1497,0,192.43333333333334,30,0,19,34.21659237895472,0.6486111111111111,43.68279569892473,1025.2688172043008,34.17562724014336,0
1886,4,0,1,28,0.0,0.034482758620689655,0.9655172413793104,29,750,500,250,0.6666666666666666,10,5,5,382.37699308247056,0.4147680623973728,0.01009388245300058,0.2237557360789492,131292.5371334876,4240.649112654319,135533.18624614194,1498,1,193.0,29,0,19,33.98763947237657,0.6505028735632183,43.78472222222222,1024.8611111111109,35.34003831417623,0
1887,4,0,0,28,0.0,0.0,1.0,28,1300,1200,100,0.9230769230769231,14,12,2,395.6034887420857,0.41264329805996475,0.026142533020014458,0.21459967712378378,128326.43843308231,4553.277348394767,132879.71578147708,1499,2,199.78571428571428,28,0,21,36.674584042352066,0.6235119047619048,46.695402298850574,1013.2183908045977,36.1863711001642,7
1888,4,1,1,28,0.034482758620689655,0.034482758620689655,0.9655172413793104,29,450,400,50,0.8888888888888888,5,4,1,386.11990290950257,0.41764162561576357,0.022368725312996718,0.21165627386044533,128742.88435570989,4142.038001543208,132884.9223572531,1500,0,193.86206896551724,29,0,20,36.488270380000905,0.6246408045977012,46.28472222222222,1014.8611111111112,34.99521072796935,0
1889,4,0,0,28,0.0,0.0,1.0,28,800,700,100,0.875,9,7,2,397.98148816308696,0.4126708553791887,0.037403645780646144,0.21767213694187149,128654.19649639995,4640.397716012706,133294.59421241266,1501,1,201.67857142857142,28,0,21,36.2782065807487,0.6268601190476191,46.37212643678162,1014.5114942528749,36.2325533661741,0
1890,4,2,0,30,0.06666666666666667,0.0,1.0,30,650,500,150,0.7692307692307693,8,5,3,373.32656522956563,0.42181513409961685,0.02608944701476079,0.20720583022462694,129235.55333347793,3649.413046305939,132884.96637978387,1502,0,189.16666666666666,30,0,23,36.309759858999776,0.6267361111111112,45.7997311827957,1016.8010752688178,33.893369175627264,0
1891,4,0,0,30,0.0,0.0,1.0,30,750,500,250,0.6666666666666666,10,5,5,373.0222022898566,0.4207375478927203,0.020475561426684274,0.20793652955332947,129406.44330269397,3654.2952942536717,133060.73859694763,1503,1,190.16666666666666,30,0,23,36.1432188463232,0.6284722222222222,45.63172043010753,1017.4731182795699,33.915770609319,0
1892,4,1,1,30,0.03225806451612903,0.03225806451612903,0.967741935483871,31,1000,900,100,0.9,11,9,2,364.2931852795968,0.4228494623655914,0.008702137215233607,0.20562735022018502,129897.31046888571,3264.140997992626,133161.45146687835,1504,0,185.0,31,0,20,35.86571826968109,0.6307123655913979,45.149739583333336,1019.4010416666673,32.88390456989249,0
1893,4,1,0,31,0.03225806451612903,0.0,1.0,31,650,500,150,0.7692307692307693,8,5,3,366.02689363131026,0.41935483870967744,0.014494305220420944,0.20748586720026682,130063.28158908436,3321.331787109399,133384.61337619377,1505,0,185.90322580645162,31,0,21,35.65281678155052,0.6323924731182795,44.98697916666668,1020.0520833333346,32.90490591397854,0
1894,4,0,0,31,0.0,0.0,1.0,31,950,700,250,0.7368421052631579,12,7,5,368.7365298269972,0.4192652329749104,0.012644733213416748,0.20955679363699642,130162.91512383374,3399.1643269857022,133562.07945081944,1506,1,186.90322580645162,31,0,21,35.48246033771426,0.6334005376344086,44.88932291666668,1020.4427083333348,32.917506720430154,0
1895,4,0,0,31,0.0,0.0,1.0,31,850,700,150,0.8235294117647058,10,7,3,365.6809662640567,0.41890681003584235,0.014746543778801913,0.20835310868533471,130262.58680555562,3326.909722222231,133589.49652777784,1507,2,187.90322580645162,31,0,22,35.45918367346939,0.6344086021505376,44.79166666666667,1020.8333333333339,32.93010752688174,0
1896,4,0,0,31,0.0,0.0,1.0,31,1100,700,400,0.6363636363636364,15,7,8,370.5900911816537,0.4166666666666667,0.013414488798655366,0.21278431789940022,130561.83073255759,3476.9841512044377,134038.81488376204,1508,3,188.90322580645162,31,0,17,35.03007283305728,0.6374327956989247,44.49869791666667,1022.005208333334,32.96790994623658,0
1897,4,1,0,32,0.03125,0.0,1.0,32,600,300,300,0.5,9,3,6,363.3051851451551,0.41870379704301075,0.01692242442936487,0.21047809332390863,130907.84940631058,3111.900093102749,134019.74949941333,1509,0,183.96875,32,0,18,34.8655665227226,0.6383463541666667,44.160353535353536,1023.3585858585858,31.979955808080806,0
1898,4,0,0,32,0.0,0.0,1.0,32,1350,1000,350,0.7407407407407407,17,10,7,368.1132096379235,0.41840977822580644,0.01385849463691291,0.2143407209887436,131101.73906042756,3252.056390929504,134353.79545135706,1510,1,184.96875,32,0,19,34.5461924135947,0.6402994791666667,43.9709595959596,1024.116161616162,32.00363005050506,0
1899,4,0,2,30,0.0,0.0625,0.9375,32,1000,600,400,0.6,14,6,8,365.76950354378255,0.4183257728494623,0.009279089116233319,0.2133348657261474,131166.40082963486,3195.3338626160767,134361.73469225093,1511,2,185.96875,32,0,19,34.54075763178439,0.6409505208333333,43.90782828282829,1024.368686868688,32.0115214646465,0
1900,4,0,0,30,0.0,0.0,1.0,30,1000,600,400,0.6,14,6,8,387.28250564648215,0.4122844827586207,0.024567625552782246,0.22421153729936627,130880.75798141393,4137.565578390552,135018.32355980447,1512,3,198.83333333333334,30,0,19,34.279631332370066,0.6434027777777778,44.18682795698924,1023.2526881720422,34.10842293906807,0
1901,4,0,0,30,0.0,0.0,1.0,30,1300,1000,300,0.7692307692307693,16,10,6,391.232894812337,0.41206896551724137,0.026321778711484667,0.22710592430569787,130983.92877789328,4249.044325933619,135232.9731038269,1513,4,199.83333333333334,30,0,19,34.07382484243698,0.6444444444444444,44.08602150537634,1023.6559139784936,34.12186379928312,0
1902,4,0,0,30,0.0,0.0,1.0,30,650,400,250,0.6153846153846154,9,4,5,392.42892761189097,0.4111350574712644,0.02698954368464812,0.2284122230309393,131087.14022213538,4288.477172216425,135375.6173943518,1514,5,200.83333333333334,30,0,19,33.9384543028394,0.6454861111111111,43.98521505376343,1024.0591397849453,34.135304659498175,0
1903,4,0,0,30,0.0,0.0,1.0,30,850,500,350,0.5882352941176471,12,5,7,394.7143888165564,0.41065613026819925,0.028338363294405866,0.23015442671545328,131155.9704337206,4353.8297418776665,135509.80017559827,1515,6,201.83333333333334,30,0,19,33.81008616542011,0.6461805555555555,43.91801075268817,1024.3279569892468,34.144265232974895,0
1904,4,0,0,30,0.0,0.0,1.0,30,500,300,200,0.6,7,3,4,392.653576797257,0.41027298850574717,0.025619834710744138,0.22936384796363904,131224.8187109781,4305.178886287435,135529.99759726555,1516,7,202.83333333333334,30,0,20,33.79301674756222,0.646875,43.850806451612904,1024.5967741935483,34.15322580645161,0
1905,4,0,0,30,0.0,0.0,1.0,30,850,700,150,0.8235294117647058,10,7,3,393.4291568969126,0.40948275862068967,0.028718755462331824,0.23085212375458838,131397.01844143827,4339.083636836624,135736.10207827488,1517,8,203.83333333333334,30,0,20,33.598529540290166,0.6486111111111111,43.68279569892473,1025.2688172043006,34.175627240143356,0
1906,4,0,0,30,0.0,0.0,1.0,30,1100,900,200,0.8181818181818182,13,9,4,391.9363026251602,0.40886015325670494,0.029516072676450067,0.23080693376814965,131534.8595213318,4310.657301422114,135845.5168227539,1518,9,204.83333333333334,30,0,21,33.49711740041929,0.65,43.548387096774185,1025.806451612902,34.19354838709673,0
1907,4,0,0,30,0.0,0.0,1.0,30,1050,700,350,0.6666666666666666,14,7,7,389.4849534792805,0.40677681992337167,0.02908321333507846,0.23082044682918718,131776.255293242,4264.973732512428,136041.2290257544,1519,10,205.83333333333334,30,0,19,33.31560631845354,0.6524305555555556,43.31317204301075,1026.747311827957,34.22491039426523,0
1908,4,0,1,29,0.0,0.03333333333333333,0.9666666666666667,30,700,500,200,0.7142857142857143,9,5,4,391.65019450840373,0.40677681992337167,0.02339571609300717,0.23252518541093334,131845.26616155042,4327.444827436691,136172.71098898712,1520,11,206.83333333333334,30,0,19,33.1901910744667,0.653125,43.24596774193548,1027.0161290322576,34.23387096774192,0
1909,4,0,0,29,0.0,0.0,1.0,29,900,600,300,0.6666666666666666,12,6,6,399.43503272683637,0.40604474548440067,0.029392691017500194,0.23636703978254994,131719.9098186729,4722.70929783951,136442.61911651242,1521,12,213.3448275862069,29,0,19,33.11727664276373,0.6548132183908046,43.36805555555556,1026.527777777778,35.397509578544074,0
1910,4,0,0,29,0.0,0.0,1.0,29,750,500,250,0.6666666666666666,10,5,5,399.43503272683637,0.40604474548440067,0.029392691017500194,0.23636703978254994,131719.9098186729,4722.70929783951,136442.61911651242,1522,13,214.3448275862069,29,0,19,33.11727664276373,0.6548132183908046,43.36805555555556,1026.527777777778,35.397509578544074,0
1911,4,0,0,29,0.0,0.0,1.0,29,850,700,150,0.8235294117647058,10,7,3,402.0999880682497,0.4051724137931034,0.04084773029306854,0.2388377037562012,131862.52170138885,4804.383680555551,136666.9053819444,1523,14,215.3448275862069,29,0,20,32.90441176470588,0.65625,43.229166666666664,1027.083333333333,35.41666666666666,0
1912,4,0,0,29,0.0,0.0,1.0,29,700,600,100,0.8571428571428571,8,6,2,402.3753075653424,0.40506978653530373,0.04055698256049789,0.2394505350008717,131933.85657793193,4817.385223765416,136751.24180169735,1524,15,216.3448275862069,29,0,20,32.8251036456221,0.6569683908045977,43.159722222222214,1027.36111111111,35.42624521072793,0
1913,4,0,0,29,0.0,0.0,1.0,29,1050,900,150,0.8571428571428571,12,9,3,402.0452885317753,0.4046079638752052,0.04249767008387706,0.2399302528334786,132040.89506172828,4817.283950617273,136858.17901234556,1525,16,217.3448275862069,29,0,20,32.72522522522524,0.6580459770114943,43.05555555555555,1027.777777777777,35.440613026819896,0
1914,4,0,0,29,0.0,0.0,1.0,29,900,700,200,0.7777777777777778,11,7,4,403.9129406540999,0.4047105911330049,0.041921495013671484,0.2417273645644544,132147.97694830247,4875.25559413581,137023.2325424383,1526,17,218.3448275862069,29,0,21,32.5688628483948,0.6591235632183908,42.95138888888889,1028.1944444444446,35.45498084291188,0
1915,4,0,0,29,0.0,0.0,1.0,29,700,300,400,0.42857142857142855,11,3,8,402.0359621603557,0.4040948275862069,0.04386598058162017,0.24105880970019716,132219.38898533958,4831.389853395074,137050.77883873467,1527,18,219.3448275862069,29,0,21,32.544873959036686,0.6598419540229885,42.88194444444445,1028.4722222222229,35.4645593869732,0
1916,4,0,0,29,0.0,0.0,1.0,29,700,500,200,0.7142857142857143,9,5,4,402.0359621603557,0.4040948275862069,0.04386598058162017,0.24105880970019716,132219.38898533958,4831.389853395074,137050.77883873467,1528,19,220.3448275862069,29,0,21,32.544873959036686,0.6598419540229885,42.88194444444445,1028.4722222222229,35.4645593869732,0
1917,4,0,0,29,0.0,0.0,1.0,29,1150,800,350,0.6956521739130435,15,8,7,403.6837370685366,0.40301724137931033,0.051089014931206655,0.24342556349999386,132433.7408371914,4892.269483024697,137326.0103202161,1529,20,221.3448275862069,29,0,21,32.285763279809295,0.6619971264367817,42.673611111111114,1029.3055555555559,35.4932950191571,0
1918,4,0,0,29,0.0,0.0,1.0,29,550,400,150,0.7272727272727273,7,4,3,406.8710600226898,0.40332512315270935,0.053866227549923984,0.24581378711884264,132505.23003472216,4982.508680555551,137487.73871527772,1530,21,222.3448275862069,29,0,21,32.131475111290975,0.6627155172413793,42.604166666666664,1029.583333333333,35.50287356321838,0
1919,4,0,1,28,0.0,0.034482758620689655,0.9655172413793104,29,550,400,150,0.7272727272727273,7,4,3,407.7181307231567,0.4028633004926108,0.051340479456832844,0.2467942807601801,132576.73852237652,5010.788001543208,137587.52652391972,1531,22,223.3448275862069,29,0,21,32.03739604405485,0.663433908045977,42.53472222222222,1029.8611111111109,35.512452107279685,0
1920,4,0,0,28,0.0,0.0,1.0,28,650,500,150,0.7692307692307693,8,5,3,417.8072087724761,0.40214395943562614,0.05306535569693427,0.25170336723610137,132398.0034722222,5463.368055555546,137861.37152777772,1532,23,228.07142857142858,28,0,21,31.958502024291494,0.6648065476190477,42.70833333333333,1029.1666666666663,36.755952380952365,0
1921,4,0,0,28,0.0,0.0,1.0,28,600,200,400,0.3333333333333333,10,2,8,418.3597953952088,0.40084876543209874,0.05750757334183665,0.25327728153655893,132582.90395032373,5493.471313912012,138076.37526423574,1533,24,229.07142857142858,28,0,21,31.75717308407737,0.6666666666666667,42.52873563218391,1029.8850574712646,36.78160919540231,0
1922,4,0,0,28,0.0,0.0,1.0,28,800,400,400,0.5,12,4,8,417.4382940974102,0.3991677689594357,0.05993884096659152,0.2534674010984359,132693.90616742632,5478.303565530448,138172.20973295678,1534,25,230.07142857142858,28,0,20,31.668642216334316,0.6677827380952381,42.42097701149425,1030.3160919540228,36.79700328407224,0
1923,4,0,1,27,0.0,0.03571428571428571,0.9642857142857143,28,850,600,250,0.7058823529411765,11,6,5,419.4247835957704,0.39927799823633153,0.05528621204579398,0.25568163316054815,132841.9813755119,5543.443858171482,138385.4252336834,1535,26,231.07142857142858,28,0,21,31.467770034843205,0.6692708333333333,42.27729885057471,1030.8908045977007,36.817528735632166,0
1924,4,0,0,27,0.0,0.0,1.0,27,750,500,250,0.6666666666666666,10,5,5,421.04044359296455,0.3974358974358974,0.060165808758679384,0.2570386990004977,132896.20812517704,5790.935684169485,138687.14380934654,1536,27,235.74074074074073,27,0,21,31.37131981526916,0.6732253086419753,42.22470238095237,1031.1011904761895,38.18893298059961,0
1925,4,0,0,27,0.0,0.0,1.0,27,950,700,250,0.7368421052631579,12,7,5,422.53441965332956,0.39767331433998104,0.06224316944270791,0.2584806763122001,132972.93803589148,5837.128640518713,138810.0666764102,1537,28,236.74074074074073,27,0,21,31.255260183715666,0.6739969135802469,42.15029761904762,1031.3988095238096,38.19995590828925,0
1926,4,0,0,27,0.0,0.0,1.0,27,550,300,250,0.5454545454545454,8,3,5,424.7202236858999,0.3964268755935423,0.0577211674544047,0.26088881764939925,133126.46429014325,5908.300338364527,139034.76462850778,1538,29,237.74074074074073,27,0,21,31.043769526556115,0.6755401234567902,42.0014880952381,1031.9940476190484,38.22200176366846,0
1927,4,0,0,27,0.0,0.0,1.0,27,700,500,200,0.7142857142857143,9,5,4,427.0421686194926,0.3967830009496676,0.05620959001382819,0.2628563907465325,133203.2606336806,5976.681857638893,139179.9424913195,1539,30,238.74074074074073,27,0,21,30.906281533804236,0.6763117283950617,41.927083333333336,1032.291666666667,38.23302469135803,0
1928,4,0,0,27,0.0,0.0,1.0,27,950,800,150,0.8421052631578947,11,8,3,428.98753245112283,0.39654558404558404,0.05738899297048916,0.2645995100158524,133280.0791214923,6035.098453443874,139315.17757493618,1540,31,239.74074074074073,27,0,21,30.778480328577604,0.6770833333333333,41.85267857142857,1032.5892857142853,38.244047619047606,0
1929,4,0,0,27,0.0,0.0,1.0,27,850,600,250,0.7058823529411765,11,6,5,432.83520780175286,0.3958333333333333,0.06275112455778076,0.2675253051960789,133356.91975357852,6144.314014668369,139501.2337682469,1541,32,240.74074074074073,27,0,21,30.601528358065604,0.6778549382716049,41.77827380952381,1032.8869047619048,38.255070546737215,0
1930,4,0,0,27,0.0,0.0,1.0,27,600,400,200,0.6666666666666666,8,4,4,432.83520780175286,0.3958333333333333,0.06275112455778076,0.2675253051960789,133356.91975357852,6144.314014668369,139501.2337682469,1542,33,241.74074074074073,27,0,21,30.601528358065604,0.6778549382716049,41.77827380952381,1032.8869047619048,38.255070546737215,0
1931,4,0,0,27,0.0,0.0,1.0,27,750,400,350,0.5333333333333333,11,4,7,433.2751403342723,0.395477207977208,0.0648334880544621,0.26807451196083043,133395.3483737244,6159.377657312915,139554.72603103734,1543,34,242.74074074074073,27,0,21,30.551354076634972,0.6782407407407407,41.74107142857142,1033.0357142857138,38.26058201058199,0
1932,4,0,0,27,0.0,0.0,1.0,27,1050,1000,50,0.9523809523809523,11,10,1,435.9815442887027,0.394883665716999,0.0677626388622361,0.271433671121676,133626.03635204077,6251.6971371882,139877.73348922897,1544,35,243.74074074074073,27,0,21,30.24851276146613,0.6805555555555556,41.51785714285714,1033.9285714285709,38.29365079365078,0
1933,4,0,0,27,0.0,0.0,1.0,27,600,400,200,0.6666666666666666,8,4,4,436.02794886393013,0.3942307692307692,0.06744471089794812,0.27202820867184174,133702.97663336177,6259.646931689354,139962.62356505112,1545,36,244.74074074074073,27,0,21,30.16966426858513,0.6813271604938271,41.44345238095239,1034.2261904761913,38.304673721340414,0
1934,4,0,0,27,0.0,0.0,1.0,27,350,200,150,0.5714285714285714,5,2,3,436.02794886393013,0.3942307692307692,0.06744471089794812,0.27202820867184174,133702.97663336177,6259.646931689354,139962.62356505112,1546,37,245.74074074074073,27,0,21,30.16966426858513,0.6813271604938271,41.44345238095239,1034.2261904761913,38.304673721340414,0
1935,4,0,0,27,0.0,0.0,1.0,27,800,400,400,0.5,12,4,8,437.3608743419913,0.39399335232668564,0.07081023246765916,0.2477414407223144,130034.82187145676,5974.428677721067,136009.25054917784,1547,38,246.74074074074073,27,0,20,33.86282949129461,0.6442901234567902,45.01488095238094,1019.9404761904749,37.77557319223981,8
1936,4,0,0,27,0.0,0.0,1.0,27,500,300,200,0.6,7,3,4,439.3818664180539,0.39494301994301995,0.07711998963092581,0.24985744941086338,130186.64301658157,6040.330038265298,136226.97305484687,1548,39,247.74074074074073,27,0,21,33.65594925634294,0.6458333333333333,44.86607142857142,1020.5357142857138,37.79761904761903,0
1937,4,0,0,27,0.0,0.0,1.0,27,1000,900,100,0.9,11,9,2,441.8667691265564,0.3942307692307692,0.07979533015965568,0.2522537246045282,130338.55273880386,6118.455038265307,136457.00777706917,1549,40,248.74074074074073,27,0,21,33.43716603516953,0.6473765432098766,44.717261904761905,1021.1309523809524,37.819664902998234,0
1938,4,1,0,28,0.03571428571428571,0.0,1.0,28,500,300,200,0.6,7,3,4,429.1392861425729,0.400270061728395,0.08217645996750034,0.24824539858824213,130849.93321855592,5630.569386642879,136480.5026051988,1550,0,240.82142857142858,28,0,20,33.24029864719375,0.6491815476190477,44.2169540229885,1023.1321839080456,36.540435139573056,0
1939,4,0,0,28,0.0,0.0,1.0,28,900,800,100,0.8888888888888888,10,8,2,429.8486274365852,0.40046296296296297,0.08371757347339703,0.2498451320646906,131033.74991742641,5664.9355099749055,136698.6854274013,1551,1,241.82142857142858,28,0,21,33.034837215829356,0.6510416666666667,44.037356321839084,1023.8505747126442,36.56609195402301,0
1940,4,0,0,28,0.0,0.0,1.0,28,900,800,100,0.8888888888888888,10,8,2,450.5116306742341,0.4000496031746032,0.09456483163190743,0.2524857566505967,129617.77044802302,6085.927834195392,135703.69828221842,1552,2,242.82142857142858,27,1,18,33.955167080715086,0.6400462962962963,45.424107142857146,1018.3035714285719,37.71494708994711,7
1941,4,1,0,29,0.034482758620689655,0.0,1.0,29,1050,700,350,0.6666666666666666,14,7,7,436.36421344971234,0.4051211001642036,0.1003885381253038,0.24745893893713738,130079.31199630085,5552.391333069122,135631.70332936998,1553,0,235.41379310344828,28,1,20,33.84272300469484,0.6413690476190477,44.971264367816104,1020.1149425287368,36.43267651888346,0
1942,4,0,0,29,0.0,0.0,1.0,29,900,700,200,0.7777777777777778,11,7,4,434.75142160741825,0.4047105911330049,0.09861369990680324,0.24747388614576105,130225.92152199757,5523.180902364901,135749.10242436247,1554,1,236.41379310344828,28,1,21,33.73392924174174,0.6428571428571428,44.82758620689655,1020.6896551724134,36.45320197044334,0
1943,4,1,0,30,0.03333333333333333,0.0,1.0,30,850,400,450,0.47058823529411764,13,4,9,421.71254725897904,0.4066570881226053,0.08876811594202882,0.24248471467391297,130617.28395061727,5016.589506172837,135633.8734567901,1555,0,229.5,29,1,19,33.66734601449275,0.6436781609195402,44.44444444444444,1022.2222222222222,35.24904214559387,0
1944,4,0,0,30,0.0,0.0,1.0,30,650,300,350,0.46153846153846156,10,3,7,421.6384586727406,0.4063936781609196,0.08510570872379897,0.24311072601467404,130723.78713348755,5023.635223765421,135747.42235725297,1556,1,230.5,29,1,19,33.56068065552991,0.6447557471264368,44.34027777777777,1022.6388888888881,35.263409961685795,0
1945,4,0,0,30,0.0,0.0,1.0,30,900,600,300,0.6666666666666666,12,6,6,419.73920147693866,0.4058429118773947,0.08072747014115089,0.24313195255362294,130901.38888888888,4988.888888888885,135890.27777777775,1557,2,231.5,29,1,19,33.42833876221498,0.646551724137931,44.166666666666664,1023.3333333333331,35.28735632183908,0
1946,4,0,0,30,0.0,0.0,1.0,30,950,700,250,0.7368421052631579,12,7,5,420.62415196743564,0.4056034482758621,0.07620985979194916,0.24409448818897633,130972.46334876532,5018.036265432083,135990.4996141974,1558,3,232.5,29,1,19,33.333333333333336,0.6472701149425287,44.097222222222214,1023.6111111111103,35.296934865900354,0
1947,4,0,0,30,0.0,0.0,1.0,30,1150,900,250,0.782608695652174,14,9,5,418.3303648376901,0.4054837164750958,0.07726553672316339,0.24388825618007628,131150.2338927469,4972.825038580241,136123.05893132716,1559,4,233.5,29,1,20,33.21115819209039,0.649066091954023,43.92361111111111,1024.3055555555554,35.320881226053636,0
1948,4,0,0,30,0.0,0.0,1.0,30,500,300,200,0.6,7,3,4,418.72392474483115,0.4052442528735632,0.0770909583841668,0.2445705774222184,131221.37586805553,4989.105902777775,136210.4817708333,1560,5,234.5,29,1,20,33.1287278026298,0.6497844827586207,43.854166666666664,1024.5833333333333,35.33045977011494,0
1949,4,0,0,30,0.0,0.0,1.0,30,950,800,150,0.8421052631578947,11,8,3,416.1732370699189,0.405411877394636,0.07234678624813129,0.24422797859629458,131401.77037917828,4937.223429861943,136338.99380904023,1561,6,235.5,28,2,20,33.01073196935724,0.6547619047619048,43.67816091954023,1025.2873563218395,36.61740558292284,0
1950,4,0,0,30,0.0,0.0,1.0,30,850,700,150,0.8235294117647058,10,7,3,416.03286616000327,0.40557950191570885,0.0723413198823033,0.24438078730732032,131438.60081004753,4936.555563812915,136375.15637386043,1562,7,236.5,28,2,20,32.976916071178366,0.6551339285714286,43.64224137931034,1025.4310344827584,36.6225369458128,0
1951,4,1,0,31,0.03225806451612903,0.0,1.0,31,700,500,200,0.7142857142857143,9,5,4,380.80694634618527,0.4057795698924731,0.029124037269970815,0.2232447793837318,131362.5694625099,3808.2445251947547,135170.81398770466,1563,0,229.83870967741936,30,1,18,33.956940256107686,0.6482638888888889,43.71639784946235,1025.1344086021488,34.171146953404964,7
1952,4,0,0,31,0.0,0.0,1.0,31,850,600,250,0.7058823529411765,11,6,5,379.6636371912626,0.40573476702508965,0.027066334080243726,0.22317669890364633,131465.92994854876,3782.5666261995348,135248.49657474828,1564,1,230.83870967741936,30,1,20,33.88160768894714,0.6493055555555556,43.61559139784945,1025.5376344086005,34.18458781362002,0
1953,4,0,0,31,0.0,0.0,1.0,31,1050,700,350,0.6666666666666666,14,7,7,379.3709458936278,0.405152329749104,0.030224762323460608,0.2232058356294735,131500.39247673133,3777.4856558561623,135277.8781325875,1565,2,231.83870967741936,30,1,20,33.854234918970874,0.6496527777777779,43.581989247311824,1025.6720430107518,34.1890681003584,0
1954,4,0,0,31,0.0,0.0,1.0,31,1100,700,400,0.6363636363636364,15,7,8,381.0662130977967,0.40519713261648743,0.028953662308687456,0.22481139650607246,131603.80715978716,3829.9528847265487,135433.7600445137,1566,3,232.83870967741936,30,1,18,33.706117369662046,0.6506944444444445,43.48118279569892,1026.0752688172036,34.202508960573454,0
1955,4,0,0,31,0.0,0.0,1.0,31,850,500,350,0.5882352941176471,12,5,7,382.2388748212836,0.4043906810035842,0.03216093982914514,0.22652620362760162,131776.255293242,3874.0015102902044,135650.2568035322,1567,4,233.83870967741936,30,1,18,33.501603613038355,0.6524305555555556,43.31317204301075,1026.747311827957,34.22491039426523,0
1956,4,0,1,30,0.0,0.03225806451612903,0.967741935483871,31,1050,800,250,0.7619047619047619,13,8,5,381.37289918347733,0.4029121863799283,0.027789615814679536,0.22724830976287483,131983.3420951844,3866.973963753031,135850.31605893743,1568,5,234.83870967741936,30,1,20,33.31453019402659,0.6545138888888888,43.111559139784944,1027.5537634408602,34.25179211469534,0
1957,4,0,0,30,0.0,0.0,1.0,30,700,500,200,0.7142857142857143,9,5,4,383.407492045238,0.40088601532567053,0.034187698879734496,0.22887721246447587,132052.40716050993,4125.976449589553,136178.3836100995,1569,6,238.5,30,0,20,33.19248289089403,0.6552083333333334,43.04435483870968,1027.8225806451617,34.260752688172055,0
1958,4,0,0,30,0.0,0.0,1.0,30,800,700,100,0.875,9,7,2,382.1110840698055,0.4002155172413793,0.03309800845426447,0.22851975621969833,132121.49029150762,4097.017176841253,136218.50746834886,1570,7,239.5,30,0,20,33.15602257375694,0.6559027777777777,42.97715053763441,1028.091397849462,34.26971326164873,0
1959,4,0,0,30,0.0,0.0,1.0,30,1000,800,200,0.8,12,8,4,383.5335527216457,0.4004789272030651,0.027008189580066233,0.2299999016791561,132225.14886113998,4142.556220372295,136367.70508151228,1571,8,240.5,30,0,20,33.01478916187491,0.6569444444444444,42.876344086021504,1028.4946236559138,34.283154121863795,0
1960,4,0,0,30,0.0,0.0,1.0,30,900,600,300,0.6666666666666666,12,6,6,384.6178518511239,0.39990421455938696,0.03428247997213507,0.2314964051707708,132363.42351716963,4181.867123366863,136545.2906405365,1572,9,241.5,30,0,20,32.84733106931384,0.6583333333333333,42.74193548387097,1029.0322580645163,34.30107526881721,0
1961,4,0,0,30,0.0,0.0,1.0,30,650,500,150,0.7692307692307693,8,5,3,383.7826552336189,0.39980842911877396,0.03157482371376319,0.23141791919520116,132432.5879436929,4165.066048098041,136597.65399179092,1573,10,242.5,30,0,21,32.799033690258554,0.6590277777777778,42.674731182795696,1029.3010752688172,34.31003584229391,0
1962,4,0,0,30,0.0,0.0,1.0,30,600,400,200,0.6666666666666666,8,4,4,385.8527224263576,0.39990421455938696,0.036422976501305104,0.23309399477806786,132501.77043588858,4225.233769799981,136727.00420568857,1574,11,243.5,30,0,21,32.675968233246294,0.6597222222222222,42.60752688172043,1029.5698924731187,34.31899641577062,0
1963,4,0,1,29,0.0,0.03333333333333333,0.9666666666666667,30,550,200,350,0.36363636363636365,9,2,7,406.874610281216,0.39949712643678165,0.11475431431958882,0.23100861381037488,130125.41415553827,4588.945434443295,134714.35958998156,1575,12,244.5,30,0,17,34.54776489702718,0.6357638888888889,44.92607526881721,1020.2956989247316,34.00985663082439,8
1964,4,0,0,29,0.0,0.0,1.0,29,1000,900,100,0.9,11,9,2,415.52650858843134,0.39875821018062396,0.13379967606394216,0.2356789347939791,130085.41907793222,5010.788001543226,135096.20707947545,1576,21,253.51724137931035,29,0,17,34.36790900839574,0.6382902298850575,44.965277777777786,1020.1388888888898,35.17720306513413,0
1965,4,0,0,29,0.0,0.0,1.0,29,750,500,250,0.6666666666666666,10,5,5,416.2814431970383,0.3988095238095238,0.13263682572760183,0.23653671795581135,130156.27170138892,5036.3281250000055,135192.59982638893,1577,22,254.51724137931035,29,0,17,34.27632026677555,0.6390086206896552,44.895833333333336,1020.416666666667,35.186781609195414,0
1966,4,1,0,30,0.03333333333333333,0.0,1.0,30,750,500,250,0.6666666666666666,10,5,5,406.02807679123856,0.4049090038314176,0.13356563664255972,0.23339709176095016,130605.8345798648,4605.927166435437,135211.76174630024,1578,0,247.0,30,0,16,34.07982686828841,0.640625,44.45564516129033,1022.1774193548393,34.07258064516131,0
1967,4,0,0,30,0.0,0.0,1.0,30,1050,700,350,0.6666666666666666,14,7,7,402.6381720485035,0.40363984674329506,0.13032054650551728,0.23289375118793398,130846.3767487572,4536.749190657891,135383.1259394151,1579,1,248.0,30,0,17,33.92176826064108,0.6430555555555555,44.22043010752689,1023.1182795698934,34.10394265232978,0
1968,4,1,0,31,0.03225806451612903,0.0,1.0,31,700,300,400,0.42857142857142855,11,3,8,391.97595580097345,0.4075716845878136,0.1291142666180085,0.22858968452826245,131161.3485548232,4082.418992784299,135243.7675476075,1580,0,240.96774193548387,31,0,18,33.874756366255674,0.643481182795699,43.91276041666667,1024.348958333334,33.043514784946254,0
1969,4,0,0,31,0.0,0.0,1.0,31,350,300,50,0.8571428571428571,4,3,1,392.19309765166923,0.40707885304659497,0.13145940272561796,0.22891508103288846,131194.6953667536,4090.7307942708517,135285.42616102446,1581,1,241.96774193548387,31,0,18,33.835366886968316,0.6438172043010753,43.88020833333334,1024.4791666666679,33.04771505376348,0
1970,4,0,0,31,0.0,0.0,1.0,31,750,500,250,0.6666666666666666,10,5,5,394.5789989489301,0.40730286738351257,0.1327376316760258,0.23070852315959,131261.40170627178,4158.598497178829,135420.00020345062,1582,2,242.96774193548387,31,0,18,33.706586192291404,0.644489247311828,43.81510416666667,1024.739583333334,33.05611559139787,0
1971,4,0,0,31,0.0,0.0,1.0,31,1250,1100,150,0.88,14,11,3,398.0733519704697,0.40685483870967737,0.12901586885353367,0.2333604988878264,131361.49300469286,4258.3019680447,135619.79497273755,1583,3,243.96774193548387,31,0,18,33.51552246073078,0.645497311827957,43.717447916666664,1025.130208333333,33.06871639784945,0
1972,4,0,0,31,0.0,0.0,1.0,31,1250,1100,150,0.88,14,11,3,400.59468343813285,0.4059139784946237,0.12816407097838978,0.23565977008530054,131495.00740898986,4335.240173339848,135830.2475823297,1584,4,244.96774193548387,31,0,18,33.31548072447209,0.6468413978494624,43.587239583333336,1025.651041666667,33.08551747311829,0
1973,4,1,0,32,0.03125,0.0,1.0,32,800,500,300,0.625,11,5,6,391.9793423277871,0.4076780913978495,0.11841498647651827,0.2327270051455637,131846.31191970222,3936.2061269258384,135782.51804662804,1585,0,238.28125,32,0,17,33.18068191131874,0.6477864583333333,43.2449494949495,1027.020202020203,32.09438131313134,0
1974,4,0,0,32,0.0,0.0,1.0,32,800,400,400,0.5,12,4,8,390.209181832641,0.407237063172043,0.11925847978370374,0.23227008870316032,131943.5855556832,3897.119713549653,135840.70526923286,1586,1,239.28125,32,0,17,33.12773954364835,0.6487630208333333,43.15025252525253,1027.398989898991,32.10621843434347,0
1975,4,0,0,32,0.0,0.0,1.0,32,800,700,100,0.875,9,7,2,392.644596727903,0.40646001344086025,0.11677873986735476,0.23472190209681243,132105.78799357207,3974.1247704315874,136079.91276400365,1587,2,240.28125,32,0,18,32.90116064848932,0.650390625,42.99242424242424,1028.030303030303,32.12594696969697,0
1976,4,0,0,32,0.0,0.0,1.0,32,800,600,200,0.75,10,6,4,393.878800040677,0.40532594086021506,0.11874693100908451,0.2362692713646063,132235.62168401177,4016.9615983062877,136252.58328231805,1588,3,241.28125,32,0,19,32.73820484491367,0.6516927083333333,42.86616161616161,1028.535353535353,32.14172979797978,0
1977,4,0,0,32,0.0,0.0,1.0,32,700,400,300,0.5714285714285714,10,4,6,396.58609657871943,0.405241935483871,0.12071319018404902,0.23871319698054386,132365.5191434548,4098.8649117437,136464.3840551985,1589,4,242.28125,32,0,19,32.53732106339468,0.6529947916666667,42.73989898989899,1029.0404040404042,32.15751262626263,0
1978,4,0,0,32,0.0,0.0,1.0,32,650,500,150,0.7692307692307693,8,5,3,396.83119811184395,0.4049479166666667,0.12191869021339263,0.23968604365955348,132495.48037190063,4115.668044077114,136611.14841597775,1590,5,243.28125,32,0,19,32.39974245768948,0.654296875,42.61363636363635,1029.5454545454531,32.17329545454541,0
1979,4,0,0,32,0.0,0.0,1.0,32,900,600,300,0.6666666666666666,12,6,6,401.493763673696,0.40452788978494625,0.12792657514096595,0.24334220832466655,132625.50536935008,4249.662661973267,136875.16803132335,1591,6,244.28125,32,0,14,32.14840238620577,0.6555989583333333,42.48737373737374,1030.050505050505,32.189078282828284,0
1980,4,0,0,32,0.0,0.0,1.0,32,850,500,350,0.5882352941176471,12,5,7,403.56929044133733,0.4041288642473118,0.1247204693052324,0.2452367073188201,132723.0659658453,4312.5907114070005,137035.65667725232,1592,7,245.28125,32,0,15,31.99643630274068,0.6565755208333333,42.39267676767677,1030.4292929292928,32.2009154040404,0
1981,4,0,1,31,0.0,0.03125,0.96875,32,1050,700,350,0.6666666666666666,14,7,7,409.6912520041955,0.40389784946236557,0.10731960408684538,0.23144895405431787,129930.4962158201,4277.847175765479,134208.34339158557,1593,8,246.28125,31,1,17,34.674861643252434,0.6310483870967742,45.117187499999986,1019.5312499999983,32.88810483870962,8
1982,4,0,0,31,0.0,0.0,1.0,31,850,600,250,0.7058823529411765,11,6,5,417.1242096064012,0.4012544802867384,0.11923955537216124,0.23517121795132614,129851.2856435713,4632.8229780899255,134484.10862166123,1594,14,254.96774193548387,30,1,17,34.56635456503582,0.6329861111111111,45.194892473118266,1019.2204301075252,33.974014336917506,0
1983,4,0,0,31,0.0,0.0,1.0,31,600,500,100,0.8333333333333334,7,5,2,416.98382480063776,0.4011200716845878,0.11573522929959923,0.2357689770407068,129963.68620130727,4638.550991482173,134602.23719278944,1595,15,255.96774193548387,31,0,18,34.45507704422592,0.6313844086021505,45.08463541666665,1019.6614583333314,32.89230510752682,0
1984,4,0,0,31,0.0,0.0,1.0,31,600,500,100,0.8333333333333334,7,5,2,403.8583848460843,0.4014336917562724,0.01617045247444393,0.22025553929841082,128540.34423828135,4182.419162326404,132722.76340060774,1596,16,256.96774193548384,31,0,15,36.24593391542544,0.6169354838709677,46.48437500000001,1014.0625000000008,32.711693548387125,8
1985,4,1,0,32,0.03125,0.0,1.0,32,850,500,350,0.5882352941176471,12,5,7,392.2069805448764,0.4048009072580645,0.021919670602859043,0.21626491833334688,128976.84427928278,3717.123730996849,132693.96801027964,1597,0,249.90625,32,0,17,36.094365030039356,0.6188151041666667,46.054292929292934,1015.7828282828287,31.7432133838384,0
1986,4,2,1,33,0.058823529411764705,0.029411764705882353,0.9705882352941176,34,1150,700,450,0.6086956521739131,16,7,9,372.9159709221568,0.40987076648841353,0.03478894564802104,0.20977154142400609,129762.65889321406,2878.308878692895,132640.96777190696,1598,0,236.14705882352942,33,1,14,35.783016598508524,0.6243686868686869,45.28186274509803,1018.8725490196072,30.874925727866884,0
1987,4,0,0,33,0.0,0.0,1.0,33,650,300,350,0.46153846153846156,10,3,7,375.5771600889446,0.4060921717171717,0.0592213622516653,0.21160566824523452,129825.09731833899,3151.868271818514,132976.9655901575,1599,1,243.6969696969697,33,0,14,35.65165544332211,0.625,45.22058823529411,1019.1176470588226,30.882352941176443,0
1988,4,0,0,33,0.0,0.0,1.0,33,1050,900,150,0.8571428571428571,12,9,3,373.19306603336713,0.405105744949495,0.05448063133437553,0.21110397705395273,129981.25908604843,3101.620921039962,133082.8800070884,1600,2,244.6969696969697,33,0,15,35.55349417137363,0.6265782828282829,45.0674019607843,1019.7303921568612,30.90092097445034,0
1989,4,1,1,33,0.029411764705882353,0.029411764705882353,0.9705882352941176,34,950,700,250,0.7368421052631579,12,7,5,363.4926365523987,0.4090352049910873,0.049088190715250946,0.20743022912241654,130323.35778061207,2674.3161848072364,132997.67396541932,1601,0,238.47058823529412,34,0,16,35.453344215149045,0.6277573529411764,44.73214285714285,1021.0714285714271,30.03151260504197,0
1990,4,0,0,33,0.0,0.0,1.0,33,1450,1100,350,0.7586206896551724,18,11,7,370.96701090406646,0.4053819444444444,0.06230774265331451,0.21204657536862073,130387.71896626303,3073.908472702812,133461.62743896584,1602,1,246.06060606060606,33,0,17,35.19718422526198,0.6306818181818181,44.669117647058826,1021.3235294117652,30.94919786096258,0
1991,4,0,0,33,0.0,0.0,1.0,33,850,600,250,0.7058823529411765,11,6,5,371.8821493436881,0.4053819444444444,0.06105682545221902,0.2129127470418257,130450.30757400989,3102.428152633591,133552.73572664347,1603,2,247.06060606060606,33,0,17,35.11026471529112,0.6313131313131313,44.607843137254896,1021.5686274509795,30.956625074272107,0
1992,4,0,0,33,0.0,0.0,1.0,33,600,400,200,0.6666666666666666,8,4,4,372.7560922803353,0.4053424873737374,0.0600536426873679,0.21375792967217583,130512.91120001925,3129.8965542099204,133642.80775422917,1604,3,248.06060606060606,33,0,15,35.024386343647556,0.6319444444444444,44.54656862745098,1021.8137254901964,30.96405228758171,0
1993,4,0,0,33,0.0,0.0,1.0,33,700,300,400,0.42857142857142855,11,3,8,373.0113960209421,0.4049479166666667,0.06251748810808655,0.21407722170809593,130544.21864487206,3138.896247837356,133683.11489270942,1605,4,249.06060606060606,33,0,15,34.98608446256546,0.632260101010101,44.51593137254901,1021.9362745098031,30.967765894236457,0
1994,4,0,0,33,0.0,0.0,1.0,33,900,700,200,0.7777777777777778,11,7,4,374.2628705322463,0.4051846590909091,0.06372244559946827,0.21549172731887745,130669.48596993955,3180.9473820165417,133850.43335195608,1606,5,250.06060606060606,33,0,16,34.826975708178516,0.6335227272727273,44.39338235294118,1022.4264705882362,30.98262032085564,0
1995,4,0,1,32,0.0,0.030303030303030304,0.9696969696969697,33,750,600,150,0.8,9,6,3,375.3510231001197,0.4047900883838384,0.07208541628093523,0.21682041452018694,130794.81336805562,3218.7934027777833,134013.6067708334,1607,6,251.06060606060606,33,0,16,34.672012898845885,0.6347853535353536,44.270833333333336,1022.9166666666672,30.997474747474765,0
1996,4,1,0,33,0.030303030303030304,0.0,1.0,33,850,800,50,0.9411764705882353,9,8,1,394.0968745847847,0.4058554292929293,0.047506529038676915,0.21660512430186268,128848.62075617272,3582.8944830246787,132431.5152391974,1608,0,251.75757575757575,32,1,18,36.177610579115374,0.6175130208333333,46.18055555555555,1015.2777777777768,31.727430555555525,7
1997,4,0,0,33,0.0,0.0,1.0,33,1150,900,250,0.782608695652174,14,9,5,394.1825555969377,0.4058554292929293,0.0460479468312367,0.2170027580195871,128912.72454660227,3563.0294421487456,132475.753988751,1609,1,252.75757575757575,32,1,19,36.1098159890588,0.6181640625,46.117424242424235,1015.5303030303021,31.73532196969694,0
1998,4,0,1,32,0.0,0.030303030303030304,0.9696969696969697,33,550,400,150,0.7272727272727273,7,4,3,396.25064158493603,0.4053030303030303,0.04783856461708824,0.21867165035613115,129008.91012396684,3623.9726813590305,132632.88280532588,1610,2,253.75757575757575,32,1,20,35.95886154610987,0.619140625,46.022727272727266,1015.90909090909,31.74715909090906,0
1999,4,0,0,32,0.0,0.0,1.0,32,1050,600,450,0.5714285714285714,15,6,9,401.29082574385257,0.399424563172043,0.06625528147135618,0.22163262009339607,129040.97995421378,3956.592280124468,132997.57223433824,1611,3,262.40625,32,0,20,35.798019966032896,0.6194661458333333,45.99116161616161,1016.0353535353529,31.751104797979778,0
2000,4,3,0,35,0.08571428571428572,0.0,1.0,35,850,500,350,0.5882352941176471,12,5,7,351.50971822825494,0.4160014005602241,0.04094635746076358,0.19462970001509977,129140.88010204068,2078.9545143508662,131219.83461639154,1612,0,240.82857142857142,34,1,22,36.96074412430701,0.6158088235294117,45.89285714285713,1016.4285714285703,29.894957983193244,8
2001,4,0,1,34,0.0,0.02857142857142857,0.9714285714285714,35,1150,700,450,0.6086956521739131,16,7,9,353.3078824152534,0.41526610644257705,0.02848829153387822,0.18873597241975432,127710.61610918866,2024.2476402325506,129734.86374942122,1613,1,241.82857142857142,33,2,18,38.375969932104745,0.6035353535353536,47.303921568627445,1010.7843137254894,30.629827688651194,8
2002,4,2,1,35,0.05555555555555555,0.027777777777777776,0.9722222222222222,36,1000,800,200,0.8,12,8,4,340.08475087188197,0.4168650793650794,0.04931559630631033,0.1839225032210487,128204.80619331052,1520.0999149659706,129724.9061082765,1614,0,236.02777777777777,34,2,20,38.20505662003843,0.6063112745098039,46.81547619047618,1012.738095238094,29.786414565826295,0
2003,4,1,1,35,0.027777777777777776,0.027777777777777776,0.9722222222222222,36,850,400,450,0.47058823529411764,13,4,9,338.7472609969906,0.4162037037037037,0.055395669368417444,0.18403034032338095,128385.71605725617,1498.0619331065698,129883.77799036274,1615,0,236.94444444444446,34,2,16,38.054299306942326,0.6081495098039216,46.63690476190476,1013.4523809523804,29.80742296918766,0
2004,4,0,0,35,0.0,0.0,1.0,35,1350,1100,250,0.8148148148148148,16,11,5,346.6591326789094,0.4128151260504202,0.04970025741582185,0.1882156512227119,128361.76478097371,1899.5556096213068,130261.32039059502,1616,2,244.71428571428572,33,2,21,37.87829544080301,0.6101641414141414,46.66053921568628,1013.3578431372553,30.707813428401675,0
2005,4,0,0,35,0.0,0.0,1.0,35,950,500,450,0.5263157894736842,14,5,9,347.58024115414156,0.4128851540616247,0.04881772803426809,0.18900961042642375,128423.86529519895,1927.519613850447,130351.3849090494,1617,3,245.71428571428572,33,2,17,37.79155583766576,0.6107954545454546,46.599264705882355,1013.6029411764705,30.715240641711226,0
2006,4,0,1,34,0.0,0.02857142857142857,0.9714285714285714,35,900,600,300,0.6666666666666666,12,6,6,348.7146101708998,0.41250000000000003,0.053952139231327356,0.19007013732239963,128517.04422577866,1963.154195501746,130480.19842128041,1618,4,246.71428571428572,33,2,17,37.66769398114575,0.6117424242424243,46.50735294117648,1013.970588235295,30.726381461675608,0
2007,4,0,0,34,0.0,0.0,1.0,34,1150,800,350,0.6956521739130435,15,8,7,355.86731688363284,0.40695558526440884,0.05129567084026343,0.1937124533734703,128464.33280086212,2343.251485817771,130807.58428667989,1619,5,254.85294117647058,32,2,18,37.5402187902188,0.6136067708333333,46.55934343434343,1013.7626262626259,31.68008207070706,0
2008,4,4,2,36,0.10526315789473684,0.05263157894736842,0.9473684210526316,38,850,400,450,0.47058823529411764,13,4,9,321.0218019822373,0.42037102892366046,0.06101648252995484,0.1793561452752094,129495.73072059326,716.2989276533567,130212.02964824662,1620,0,228.92105263157896,35,3,16,37.375388522477444,0.6172619047619048,45.54398148148148,1017.8240740740739,29.080687830687825,0
2009,4,1,1,36,0.02702702702702703,0.02702702702702703,0.972972972972973,37,1000,500,500,0.5,15,5,10,329.65996842421737,0.418262012012012,0.06340424354753926,0.18404445094312036,129466.28146701399,1135.9700520833426,130602.25151909734,1621,0,236.0810810810811,35,2,19,37.185474240873425,0.6169642857142856,45.57291666666667,1017.7083333333342,29.077380952380977,0
2010,4,0,0,36,0.0,0.0,1.0,36,1300,1100,200,0.8461538461538461,15,11,4,337.7464461197837,0.41673280423280423,0.07143321374720468,0.18845017111174364,129443.56575963723,1543.8208616780034,130987.38662131524,1622,1,241.75,34,2,19,37.00280767430977,0.6188725490196079,45.595238095238095,1017.619047619048,29.92997198879553,0
2011,4,0,0,36,0.0,0.0,1.0,36,1300,700,600,0.5384615384615384,19,7,12,337.38516609572554,0.4164517195767196,0.0710829208724677,0.18897546336717366,129595.04145408176,1544.6889172335705,131139.73037131532,1623,2,242.75,34,2,20,36.85816867375968,0.6204044117647058,45.44642857142858,1018.2142857142868,29.94747899159667,0
2012,4,0,0,36,0.0,0.0,1.0,36,1100,700,400,0.6363636363636364,15,7,8,338.7016365145905,0.41572420634920637,0.07666069504485229,0.19059482622803287,129776.92920918373,1591.1316609977393,131368.06087018148,1624,3,243.75,34,2,20,36.64003777699887,0.6222426470588236,45.267857142857146,1018.9285714285718,29.968487394957993,0
2013,4,0,0,36,0.0,0.0,1.0,36,1000,800,200,0.8,12,8,4,340.9399327533299,0.41641865079365076,0.08196439461767047,0.19245014134256852,129898.25857426306,1657.500708616784,131555.75928287985,1625,4,244.75,34,2,20,36.45991474950369,0.623468137254902,45.148809523809526,1019.404761904762,29.982492997198882,0
2014,4,1,0,37,0.02702702702702703,0.0,1.0,37,1150,700,450,0.6086956521739131,16,7,9,334.20031981840486,0.41938813813813813,0.09121583313668591,0.19027195742275743,130233.05047850228,1304.785424168388,131537.83590267066,1626,0,239.1081081081081,35,2,21,36.29249820463394,0.624702380952381,44.820601851851855,1020.717592592593,29.1633597883598,0
2015,4,0,0,37,0.0,0.0,1.0,37,1150,700,450,0.6086956521739131,16,7,9,329.6936818367856,0.41844969969969975,0.08314217900620147,0.18856427363639855,130410.31867551857,1199.091622728038,131609.4102982466,1627,1,240.1081081081081,35,2,22,36.22816336166193,0.6264880952380952,44.64699074074073,1021.4120370370362,29.183201058201032,0
2016,4,0,0,37,0.0,0.0,1.0,37,1050,800,250,0.7619047619047619,13,8,5,329.78636353725665,0.4189189189189189,0.08134431146888699,0.18933768465760561,130558.13426997591,1211.2584662208399,131769.39273619675,1628,2,241.1081081081081,35,2,19,36.07634956587392,0.6279761904761905,44.50231481481481,1021.9907407407401,29.19973544973543,0
2017,4,0,2,35,0.0,0.05405405405405406,0.9459459459459459,37,900,700,200,0.7777777777777778,11,7,4,354.91387245233415,0.4190753253253254,0.018295218295218296,0.1955034043169636,128936.76757812499,1752.289496527778,130689.05707465277,1629,3,242.1081081081081,35,2,18,37.08226495726496,0.6116071428571428,46.09375,1015.6249999999999,29.01785714285714,8
2018,4,1,0,36,0.027777777777777776,0.0,1.0,36,1250,1000,250,0.8,15,10,5,362.4025227108041,0.41347552910052915,0.05469019348254811,0.2017883293352418,129361.89746263136,2176.758131345018,131538.65559397638,1630,0,249.25,32,4,19,36.45872119482024,0.6227213541666667,45.67550505050505,1017.2979797979798,31.79056186868687,0
2019,4,0,0,36,0.0,0.0,1.0,36,1050,700,350,0.6666666666666666,14,7,7,366.9384018244812,0.4133101851851852,0.050542678440029354,0.19106102991550578,126672.22222222226,2096.18055555556,128768.40277777782,1631,1,250.25,34,2,19,39.09871688741721,0.5906862745098039,48.333333333333336,1006.6666666666671,29.607843137254914,8
2020,4,2,0,38,0.05263157894736842,0.0,1.0,38,1300,900,400,0.6923076923076923,17,9,8,350.7067441077278,0.4203413940256045,0.053706432211782174,0.18503389719388358,127208.74592764067,1323.2874657064572,128532.03339334713,1632,0,238.02631578947367,35,3,22,38.95613431237571,0.594047619047619,47.80092592592593,1008.7962962962969,28.82275132275134,0
2021,4,3,2,39,0.07317073170731707,0.04878048780487805,0.9512195121951219,41,1050,700,350,0.6666666666666666,14,7,7,326.0165449033728,0.42898882113821135,0.0451459238752181,0.17428070891953162,127739.20323800117,210.14442354361847,127949.34766154479,1633,0,221.53658536585365,38,3,15,39.03640879306699,0.59375,47.275641025641015,1010.8974358974347,26.60256410256407,8
2022,4,2,1,40,0.04878048780487805,0.024390243902439025,0.975609756097561,41,1200,600,600,0.5,18,6,12,327.20839527649605,0.4279979674796748,0.08411029871909603,0.17706057101165745,128227.8095784279,192.08521332120392,128419.8947917491,1634,0,222.4390243902439,37,4,19,38.50760979394464,0.6005067567567568,46.79276315789473,1012.8289473684205,27.373755334281633,0
2023,4,2,2,40,0.047619047619047616,0.047619047619047616,0.9523809523809523,42,800,500,300,0.625,11,5,6,314.7326158501035,0.43169279907084784,0.10539060854916871,0.1723950625919426,128713.0691157134,-297.9598126232646,128415.10930309014,1635,0,217.76190476190476,38,4,13,38.329779953674475,0.6036184210526316,46.31410256410257,1014.7435897435902,26.7037786774629,0
2024,4,0,0,40,0.0,0.0,1.0,40,950,700,250,0.7368421052631579,12,7,5,331.14317927127786,0.42586805555555557,0.1017940457676072,0.1802267774969797,128458.27880245114,507.6165692719776,128965.89537172312,1636,1,229.625,36,4,15,38.172998592905266,0.6047453703703703,46.56531531531532,1013.7387387387391,28.15940940940942,0
2025,4,1,2,39,0.024390243902439025,0.04878048780487805,0.9512195121951219,41,1450,1300,150,0.896551724137931,16,13,3,351.0332743706064,0.42771849593495936,0.12093579834253387,0.1859095023977745,127362.24666950104,927.1139995138442,128289.36066901489,1637,0,225.0,34,7,18,38.790443055391755,0.5977328431372548,47.64880952380952,1009.4047619047611,29.688375350140035,7
2026,4,0,0,39,0.0,0.0,1.0,39,1200,900,300,0.75,15,9,6,366.55331053679424,0.4254385964912281,0.12450178107249443,0.19344524116175604,127219.36058820531,1526.5355575961664,128745.89614580148,1638,1,232.97435897435898,32,7,19,38.545577805590334,0.6009114583333333,47.79040404040404,1008.8383838383841,31.526199494949502,0
2027,4,1,0,40,0.025,0.0,1.0,40,1250,800,450,0.64,17,8,9,358.7995011289476,0.42823183760683764,0.13032641998585892,0.19101459012423144,127572.62613378685,1154.598922902493,128727.22505668935,1639,0,228.125,34,6,19,38.378653075654015,0.5998774509803921,47.44047619047619,1010.2380952380953,29.712885154061627,0
2028,4,1,0,41,0.024390243902439025,0.0,1.0,41,1050,600,450,0.5714285714285714,15,6,9,349.7007367687951,0.43056402439024394,0.13424122341909928,0.18773860192624503,127910.26341735253,746.0626714677637,128656.3260888203,1640,0,223.53658536585365,35,6,20,38.2627765064836,0.6011904761904762,47.10648148148148,1011.5740740740739,28.9021164021164,0
2029,4,1,2,40,0.023809523809523808,0.047619047619047616,0.9523809523809523,42,1200,600,600,0.5,18,6,12,358.8286313257005,0.43493515292295776,0.18068396460880853,0.17719475711856736,124479.7092013887,534.0197402263129,125013.72894161502,1641,0,219.1904761904762,33,9,13,41.56880654140569,0.5703914141414141,50.52083333333332,997.916666666665,30.23989898989894,8
2030,4,0,0,40,0.0,0.0,1.0,40,1000,700,300,0.7,13,7,6,377.6241643916269,0.430448717948718,0.2057727450724447,0.18604364780734775,124382.2754753962,1393.9505683051411,125776.22604370135,1642,1,230.975,31,9,13,41.20124113475177,0.574260752688172,50.61848958333334,997.526041666668,32.178259408602194,0
2031,4,7,4,43,0.14893617021276595,0.0851063829787234,0.9148936170212766,47,1100,800,300,0.7272727272727273,14,8,6,329.78285401608514,0.4476564909034844,0.2339961180196326,0.16978258843839344,126209.04989996926,-1064.659389168271,125144.390510801,1643,0,197.4255319148936,37,10,17,40.50951185799506,0.579954954954955,48.79385964912281,1004.824561403509,27.157420578473218,0
2032,4,5,2,46,0.10416666666666667,0.041666666666666664,0.9583333333333334,48,650,100,550,0.15384615384615385,12,1,11,330.6217403157114,0.4492095153664302,0.2773557641319333,0.17290251743964735,126849.74163790265,-1212.1435322156576,125637.598105687,1644,0,194.125,38,10,19,39.83057588291441,0.584703947368421,48.15705128205128,1007.3717948717945,26.50978407557354,0
2033,4,2,1,47,0.041666666666666664,0.020833333333333332,0.9791666666666666,48,1500,1000,500,0.6666666666666666,20,10,10,330.16659998930174,0.45161975472813237,0.2826495108171414,0.1732479404282259,126987.00086805565,-1214.6267361111068,125772.37413194454,1645,0,195.0625,39,9,21,39.70132286068623,0.5844017094017093,48.020833333333336,1007.9166666666674,25.844017094017115,0
2034,4,1,0,48,0.020833333333333332,0.0,1.0,48,1150,800,350,0.6956521739130435,15,8,7,324.7758259416684,0.4506870567375887,0.27655064407976004,0.17165683693447445,127280.60766171748,-1332.4237012838676,125948.18396043361,1646,0,195.54166666666666,38,10,22,39.536571378154235,0.5890899122807017,47.72970085470086,1009.081196581197,26.55476833108413,0
2035,4,1,0,49,0.02040816326530612,0.0,1.0,49,1550,1200,350,0.7741935483870968,19,12,7,320.67169731108487,0.45204435941043086,0.28453608247422646,0.17090744307239164,127617.7300347224,-1615.3211805555363,126002.40885416686,1647,0,192.53061224489795,39,10,18,39.295532646048116,0.5908119658119658,47.39583333333334,1010.4166666666681,25.908119658119695,0
2036,4,1,3,47,0.02,0.06,0.94,50,1500,1000,500,0.6666666666666666,20,10,10,314.0368444780981,0.4526360544217687,0.2752269987946969,0.16882023885658465,127964.52591050317,-1962.8848155859432,126001.64109491723,1648,0,189.66,40,10,19,39.109372907459495,0.5927083333333334,47.05284552845529,1011.7886178861802,25.294715447154505,0
2037,4,0,1,46,0.0,0.02127659574468085,0.9787234042553191,47,1300,900,400,0.6923076923076923,17,9,8,334.3884215792833,0.4441489361702127,0.27540883669162075,0.17809565990933632,127590.03371229625,-867.0740035395352,126722.95970875672,1649,1,202.53191489361703,37,10,19,38.977371391360975,0.5940315315315315,47.423245614035096,1010.307017543861,27.305595068753,0
2038,4,1,0,47,0.02127659574468085,0.0,1.0,47,1750,1200,550,0.6857142857142857,23,12,11,325.3798434567592,0.44551726796176383,0.2051149341224383,0.17312697917184341,127550.26989051426,-1089.4313457901117,126460.83854472415,1650,0,202.4255319148936,38,9,17,39.245549092191055,0.5918311403508771,47.462606837606835,1010.1495726495725,26.582883490778226,8
2039,4,1,0,48,0.020833333333333332,0.0,1.0,48,1550,1200,350,0.7741935483870968,19,12,7,319.53420602993356,0.4479536052009456,0.2098332303361139,0.1713063283459209,127854.65630425356,-1429.2127821180507,126425.44352213551,1651,0,199.1875,39,9,18,39.08240206681085,0.593215811965812,47.161458333333336,1011.3541666666674,25.93215811965814,0
2040,4,2,1,49,0.04,0.02,0.98,50,1750,1300,450,0.7428571428571429,22,13,9,305.9485832238695,0.4500170068027211,0.21742465753424667,0.16667348190554074,128496.33487654307,-2136.3609784915275,126359.97389805154,1652,0,192.18,38,12,17,38.772831050228305,0.6014254385964912,46.52777777777777,1013.8888888888878,26.681286549707572,0
2041,4,2,2,49,0.0392156862745098,0.0392156862745098,0.9607843137254902,51,1150,900,250,0.782608695652174,14,9,5,293.87867279577256,0.4515359477124183,0.22128095162457484,0.16243741565975275,129072.27143441388,-2613.682435223758,126458.58899919012,1653,0,183.2941176470588,40,11,19,38.49468280161349,0.60390625,45.96036585365853,1016.1585365853646,25.403963414634113,0
2042,4,0,0,49,0.0,0.0,1.0,49,1200,700,500,0.5833333333333334,17,7,10,305.0782282455824,0.4495287698412698,0.21249737008205405,0.1680228063558809,128929.98598327111,-1933.2536616991852,126996.73232157192,1654,1,190.9387755102041,38,11,19,38.354504172803146,0.6058114035087719,46.100427350427346,1015.5982905982895,26.726270805218146,0
2043,4,1,2,48,0.02,0.04,0.96,50,1950,1300,650,0.6666666666666666,26,13,13,302.67614398700664,0.44903911564625854,0.21793277310924375,0.1683105660488494,129310.02995105549,-2171.902394258177,127138.12755679732,1655,0,188.1,38,12,21,38.03024334733894,0.6096491228070176,45.72649572649572,1017.0940170940163,26.765632028789902,0
2044,4,2,4,46,0.04,0.08,0.92,50,2150,1700,450,0.7906976744186046,26,17,9,306.2938289660376,0.4480952380952381,0.22325922818791932,0.17221803968279084,129745.05077069173,-2051.978322010382,127693.07244868134,1656,0,188.46,38,12,18,37.497815296420555,0.6140350877192983,45.299145299145295,1018.8034188034183,26.81061628430048,0
2045,4,0,0,46,0.0,0.0,1.0,46,1400,1100,300,0.7857142857142857,17,11,6,326.3844841384762,0.4454911433172302,0.22323026569498938,0.18235229691955254,129495.73072059316,-746.9205461248446,128748.81017446831,1657,1,202.7391304347826,35,11,18,37.23893184747175,0.6172619047619048,45.543981481481474,1017.8240740740731,29.080687830687804,0
2046,4,0,0,46,0.0,0.0,1.0,46,2000,1400,600,0.7,26,14,12,324.679081344123,0.4459037842190016,0.21480491510105137,0.1821586607739609,129659.7526580636,-780.4381239347322,128879.31453412888,1658,2,203.7391304347826,36,10,18,37.11599771487542,0.6168981481481481,45.38288288288289,1018.4684684684695,28.29079079079082,0
2047,4,1,1,46,0.02127659574468085,0.02127659574468085,0.9787234042553191,47,1350,800,550,0.5925925925925926,19,8,11,314.7882370678957,0.4472132284921369,0.20765097324241055,0.1782011803389225,130010.8582087757,-1214.822228955071,128796.03597982062,1659,0,200.38297872340425,37,10,19,37.01248521664337,0.6185247747747749,45.03837719298245,1019.8464912280696,27.563418681839718,0
2048,4,2,1,47,0.041666666666666664,0.020833333333333332,0.9791666666666666,48,1800,1200,600,0.6666666666666666,24,12,12,292.3965367425908,0.44739029255319146,0.10750730019678767,0.16316410355317176,129447.79178685191,-2029.982798509689,127417.80898834222,1660,0,197.02083333333334,42,6,13,38.152256713007034,0.6046626984126984,45.59108527131784,1017.63565891473,24.229420450350716,8
2049,4,0,0,47,0.0,0.0,1.0,47,1300,1000,300,0.7692307692307693,16,10,6,321.34557340428853,0.4457678075855689,0.17192791371680016,0.17255191216448298,127918.6264349491,-1176.2268474126054,126742.39958753649,1661,1,202.19148936170214,41,6,18,38.97132735118171,0.5907012195121951,47.09821428571429,1011.6071428571437,24.673344947735213,8
2050,4,1,0,48,0.020833333333333332,0.0,1.0,48,1150,500,650,0.43478260869565216,18,5,13,319.7702551857757,0.4485261524822695,0.16682968833600853,0.17323205998325086,128273.18395135188,-1396.0116499380645,126877.17230141381,1662,0,198.95833333333334,40,8,19,38.649720773140736,0.5958333333333333,46.747967479674806,1013.0081300813022,25.325203252032555,0
2051,4,0,1,47,0.0,0.020833333333333332,0.9791666666666666,48,1550,900,650,0.5806451612903226,22,9,13,323.89173434840234,0.44768580082742315,0.17937134502924001,0.17625859520596374,128453.40617563961,-1279.0006981624542,127174.40547747715,1663,1,199.95833333333334,40,8,16,38.36173767752716,0.59765625,46.57012195121952,1013.7195121951228,25.34298780487807,0
2052,4,1,1,47,0.020833333333333332,0.020833333333333332,0.9791666666666666,48,1150,800,350,0.6956521739130435,15,8,7,323.10111530382005,0.4469377955082742,0.18374213375069282,0.17635145230918067,128571.78411005613,-1291.6626314877742,127280.12147856836,1664,0,200.875,41,7,17,38.2612532198637,0.5973069105691057,46.45337301587302,1014.1865079365085,24.736256291134353,0
2053,4,0,3,44,0.0,0.06382978723404255,0.9361702127659575,47,1350,700,650,0.5185185185185185,20,7,13,330.9873681697978,0.44339731729879744,0.18269503546099286,0.1801199671300456,128453.40617563964,-896.7090314957875,127556.69714414385,1665,1,206.10638297872342,40,7,17,38.18191311612364,0.59765625,46.57012195121952,1013.719512195123,25.342987804878074,0
2054,4,0,1,43,0.0,0.022727272727272728,0.9772727272727273,44,1150,700,450,0.6086956521739131,16,7,9,345.37763372532095,0.43959214235377025,0.1864069170388145,0.18754289605695743,128366.6669071252,66.99513311786794,128433.66204024307,1666,2,219.6818181818182,37,7,20,37.90575632979872,0.6019144144144144,46.65570175438596,1013.3771929824555,27.38857278330961,0
2055,4,1,0,44,0.022727272727272728,0.0,1.0,44,1050,700,350,0.6666666666666666,14,7,7,348.75608852135156,0.44039596546863985,0.1884419516894913,0.19003815854784548,128505.59937913586,163.42203851184763,128669.02141764772,1667,0,220.1590909090909,37,7,18,37.678323600446994,0.603322072072072,46.51864035087719,1013.9254385964911,27.403390232337596,0
2056,4,0,0,44,0.0,0.0,1.0,44,1400,1200,200,0.8571428571428571,16,12,4,348.2399415631852,0.4399004580690627,0.18734643734643752,0.1901546316091769,128588.99493113243,155.96481609723565,128744.95974722967,1668,1,221.1590909090909,37,7,18,37.606306306306315,0.6041666666666667,46.43640350877192,1014.2543859649104,27.412280701754334,0
2057,4,1,0,45,0.022222222222222223,0.0,1.0,45,1700,1200,500,0.7058823529411765,22,12,10,349.3034130161582,0.43985690235690234,0.21029468446687094,0.19330560605134992,129119.93805473341,20.407010190637493,129140.34506492405,1669,0,217.22222222222223,38,7,19,37.03813202985389,0.6077302631578947,45.913461538461526,1016.3461538461513,26.745951417003983,0
2058,4,1,3,43,0.021739130434782608,0.06521739130434782,0.9347826086956522,46,1600,1200,400,0.75,20,12,8,341.52180038021095,0.44192834138486314,0.21080234045244373,0.19059914788507124,129452.33298947733,-357.78987056898006,129094.54311890836,1670,0,213.47826086956522,37,9,16,36.89785134504185,0.6128941441441442,45.586622807017534,1017.6535087719283,27.50414888572779,0
2059,4,1,0,44,0.022727272727272728,0.0,1.0,44,1850,1500,350,0.8108108108108109,22,15,7,355.5210891287268,0.4387773079633545,0.20560073248704214,0.19759416889146875,129289.65627411252,393.03988233023347,129682.69615644276,1671,0,223.3181818181818,35,9,20,36.70728064185728,0.6151785714285714,45.74652777777777,1017.0138888888879,29.057539682539655,0
2060,4,0,0,44,0.0,0.0,1.0,44,950,700,250,0.7368421052631579,12,7,5,355.25620403651584,0.4387993305144468,0.20686497474188426,0.1978658783764418,129373.18019032551,392.12497970944366,129765.30517003496,1672,1,224.3181818181818,36,8,21,36.628984945760465,0.6140046296296297,45.664414414414416,1017.3423423423427,28.25950950950952,0
2061,4,0,1,43,0.0,0.022727272727272728,0.9772727272727273,44,1200,900,300,0.75,15,9,6,355.13219094343884,0.43859011627906974,0.2061614855732503,0.1983355593463896,129480.23069598322,396.5196021852702,129876.7502981685,1673,2,225.3181818181818,37,7,16,36.52319902319903,0.6131756756756757,45.55921052631578,1017.7631578947355,27.507112375533392,0
2062,4,0,0,43,0.0,0.0,1.0,43,900,500,400,0.5555555555555556,13,5,8,364.36287733548227,0.4367386489479513,0.20567720755280106,0.20367817243261752,129516.42679419288,838.1955857884998,130354.62237998139,1674,3,230.88372093023256,36,7,17,36.251475089427295,0.6154513888888888,45.52364864864865,1017.9054054054058,28.27515015015016,0
2063,4,0,1,42,0.0,0.023255813953488372,0.9767441860465116,43,1050,700,350,0.6666666666666666,14,7,7,363.6775095757265,0.43669250645994834,0.20448244111459202,0.20374052302253556,129602.412801315,826.6965445175132,130429.10934583252,1675,4,231.88372093023256,36,7,17,36.18138501806385,0.6163194444444444,45.4391891891892,1018.2432432432446,28.284534534534572,0
2064,4,0,2,40,0.0,0.047619047619047616,0.9523809523809523,42,950,700,250,0.7368421052631579,12,7,5,348.5182204158218,0.4347294812233837,0.15089083612962062,0.18713324411209342,127916.59216226345,516.2526124096886,128432.84477467314,1676,7,238.3095238095238,36,6,20,38.286207280418566,0.5992476851851851,47.100225225225216,1011.5990990990978,28.099974974974938,8
2065,4,0,0,40,0.0,0.0,1.0,40,1250,1100,150,0.88,14,11,3,366.81550377069794,0.4288862179487179,0.18438787522071842,0.19659922426069867,127843.36911848045,1378.9859693877188,129222.35508786817,1677,8,250.7,34,6,20,37.89851873651166,0.6026348039215687,47.17261904761903,1011.3095238095216,29.744397759103578,0
2066,4,1,0,41,0.024390243902439025,0.0,1.0,41,1000,700,300,0.7,13,7,6,357.2607134372836,0.4315548780487805,0.18251105389022415,0.1930660500951416,128174.66695011313,958.708900226728,129133.37585033986,1678,0,245.5609756097561,34,7,21,37.801013010424015,0.6060049019607843,46.84523809523808,1012.6190476190455,29.782913165266045,0
2067,4,0,0,41,0.0,0.0,1.0,41,850,300,550,0.35294117647058826,14,3,11,391.08444988435474,0.4317073170731707,0.19161392780108555,0.20637225586205182,127215.61418685122,1792.827498646523,129008.44168549775,1679,1,246.5609756097561,33,8,19,37.930737771299,0.5984848484848485,47.794117647058826,1008.8235294117649,30.57040998217469,8
2068,4,1,0,42,0.023809523809523808,0.0,1.0,42,1350,1100,250,0.8148148148148148,16,11,5,384.27478083335984,0.43240660085172283,0.2052172888941235,0.20534154588143866,127723.00347222229,1416.1458333333446,129139.14930555563,1680,0,241.66666666666666,34,8,19,37.580722726023644,0.6014093137254901,47.29166666666667,1010.8333333333339,29.730392156862763,0
2069,4,0,1,41,0.0,0.023809523809523808,0.9761904761904762,42,1250,900,350,0.72,16,9,7,382.1549183293572,0.43250338753387535,0.20666390860197947,0.20446882340649428,127774.23327043279,1365.9103360117094,129140.1436064445,1681,1,242.66666666666666,36,6,19,37.58168114650628,0.5978009259259259,47.240990990991,1011.0360360360376,28.084334334334375,0
2070,4,1,0,42,0.023809523809523808,0.0,1.0,42,1050,600,450,0.5714285714285714,15,6,9,381.83189159271393,0.4332534843205575,0.23401021256382837,0.2063538928957929,128176.49347005412,1390.517782366171,129567.01125242029,1682,0,242.73809523809524,32,10,20,37.17710931005819,0.6106770833333333,46.843434343434346,1012.626262626263,31.64457070707072,0
2071,4,1,0,43,0.023255813953488372,0.0,1.0,43,750,500,250,0.6666666666666666,10,5,5,372.59404350088073,0.434985234403839,0.23526171573104748,0.203244278837824,128548.11137843628,979.2521205786386,129527.36349901491,1683,0,238.06976744186048,33,10,18,37.03058912386707,0.6120580808080809,46.47671568627452,1014.0931372549029,30.730095068330392,0
2072,4,0,0,43,0.0,0.0,1.0,43,1100,600,500,0.5454545454545454,16,6,10,372.4065967288394,0.43496216315983754,0.23794565000832435,0.20354564533203612,128627.1276218822,980.3181689342595,129607.44579081646,1684,1,239.06976744186048,34,9,18,36.954533896647504,0.6106004901960784,46.39880952380953,1014.4047619047628,29.835434173669494,0
2073,4,1,0,44,0.022727272727272728,0.0,1.0,44,1250,700,550,0.56,18,7,11,363.8035281005773,0.4369053911205074,0.2340647560255622,0.20069789856309056,128995.54887099218,585.807157707498,129581.35602869968,1685,0,234.61363636363637,35,9,19,36.796575329459564,0.6122023809523809,46.03587962962964,1015.8564814814835,29.024470899470955,0
2074,4,2,1,45,0.043478260869565216,0.021739130434782608,0.9782608695652174,46,1400,900,500,0.6428571428571429,19,9,10,343.33143980862997,0.4403683574879227,0.22802581759967477,0.19260330934838216,129655.65653344666,-296.53505258199533,129359.12148086466,1686,0,225.3695652173913,34,12,18,36.645236703682045,0.6210171568627452,45.38690476190476,1018.4523809523805,29.954481792717075,0
2075,4,2,1,46,0.0425531914893617,0.02127659574468085,0.9787234042553191,47,1100,1000,100,0.9090909090909091,12,10,2,334.03752275892833,0.44066065371569535,0.2336393770324785,0.1893165715803495,130055.90284475737,-711.2896787122787,129344.61316604509,1687,0,221.53191489361703,35,12,20,36.4760628238587,0.6229166666666667,44.99421296296296,1020.023148148148,29.143518518518515,0
2076,4,1,2,45,0.02127659574468085,0.0425531914893617,0.9574468085106383,47,1800,1400,400,0.7777777777777778,22,14,8,326.61305316209416,0.4416049953746531,0.13163684379544027,0.17376466025336976,127545.97757582947,-1062.1715054940357,126483.80607033544,1688,0,222.46808510638297,43,4,14,39.21879394393927,0.5840600775193798,47.46685606060607,1010.132575757577,23.49145525017621,8
2077,4,1,0,46,0.021739130434782608,0.0,1.0,46,1550,1200,350,0.7741935483870968,19,12,7,330.4648314567104,0.4399557165861514,0.15630131237445632,0.17623139512616479,127641.65200477796,-763.7845966769919,126877.86740810097,1689,0,228.15217391304347,43,3,15,39.02369740417954,0.5850290697674418,47.37215909090909,1010.5113636363642,23.50026427061312,0
2078,4,0,1,45,0.0,0.021739130434782608,0.9782608695652174,46,1250,1000,250,0.8,15,10,5,332.20604133241784,0.4402475845410628,0.15354228093896127,0.17768695878080643,127761.29548324169,-711.3851584021814,127049.91032483951,1690,1,229.15217391304347,43,3,16,38.85740601973275,0.5862403100775193,47.25378787878789,1010.9848484848499,23.5112755461593,0
2079,4,3,0,48,0.0625,0.0,1.0,48,1300,900,400,0.6923076923076923,17,9,8,321.98544463476327,0.4447399527186761,0.19236847552625713,0.17580707610808927,128586.40861614404,-1317.1139254348243,127269.29469070921,1691,0,219.29166666666666,42,6,16,38.27465685806186,0.5959821428571428,46.4389534883721,1014.244186046513,24.14867109634555,0
2080,4,1,0,49,0.02040816326530612,0.0,1.0,49,1650,1300,350,0.7878787878787878,20,13,7,311.49683871778285,0.44559594671201813,0.19519039493247803,0.17140922379417603,128895.62864369016,-1769.8838305898355,127125.74481310032,1692,0,215.79591836734693,44,5,17,38.22642168931036,0.5963541666666667,46.13425925925927,1015.4629629629643,23.078703703703734,0
2081,4,1,0,50,0.02,0.0,1.0,50,1800,1300,500,0.7222222222222222,23,13,10,311.01858663157947,0.44710034013605443,0.21061648404001931,0.17279725075163743,129275.28511094593,-1957.510030725086,127317.77508022085,1693,0,212.46,42,8,18,37.85334286168016,0.6029265873015873,45.76065891472869,1016.9573643410858,24.213270579549665,0
2082,4,1,0,51,0.0196078431372549,0.0,1.0,51,1100,700,400,0.6363636363636364,15,7,8,305.713634919671,0.44815359477124184,0.21258722901581573,0.1716208693734857,129683.21352731879,-2270.8146808998945,127412.39884641889,1694,0,209.27450980392157,43,8,15,37.57515185322921,0.6056201550387597,45.35984848484849,1018.5606060606073,23.687455954897843,0
2083,4,0,1,50,0.0,0.0196078431372549,0.9803921568627451,51,900,700,200,0.7777777777777778,11,7,4,304.2392763496302,0.4479901960784314,0.21275913228277,0.17100345532755112,129731.44531250029,-2306.1197916666397,127425.32552083365,1695,1,210.27450980392157,43,8,15,37.563905930470355,0.6061046511627908,45.312500000000014,1018.7500000000023,23.69186046511633,0
2084,4,1,1,50,0.0196078431372549,0.0196078431372549,0.9803921568627451,51,1400,1000,400,0.7142857142857143,18,10,8,297.64138937487775,0.44745098039215686,0.21991618510487476,0.16845952017342786,130002.78206447206,-2461.158264746212,127541.62379972586,1696,0,207.6078431372549,44,7,17,37.45781883663216,0.6074810606060606,45.046296296296305,1019.8148148148163,23.17760942760946,0
2085,4,0,2,48,0.0,0.04,0.96,50,1450,1100,350,0.7586206896551724,18,11,7,301.1203087228061,0.4456547619047619,0.2110818973174633,0.17035238369856037,129985.33412754678,-2171.7552116151983,127813.57891593159,1697,1,212.68,45,5,17,37.386747201989714,0.6060185185185185,45.06340579710145,1019.7463768115946,22.661030595813212,0
2086,4,0,0,48,0.0,0.0,1.0,48,1350,900,450,0.6666666666666666,18,9,9,310.40226852695275,0.44391807033096925,0.21204486345903772,0.17533005367057586,129924.46212838631,-1534.2304436409363,128390.23168474538,1698,2,221.10416666666666,43,5,18,37.21166945321693,0.6080426356589148,45.12310606060607,1019.5075757575771,23.709478505990166,0
2087,4,0,0,48,0.0,0.0,1.0,48,1600,1200,400,0.75,20,12,8,306.6981042852263,0.44323470744680854,0.21201202905129368,0.1736904688278546,130026.38996056264,-1624.2305384087576,128402.15942215388,1699,3,222.10416666666666,44,4,18,37.20305643819035,0.607717803030303,45.02314814814816,1019.9074074074092,23.179713804713845,0
2088,4,0,1,47,0.0,0.020833333333333332,0.9791666666666666,48,1250,900,350,0.72,16,9,7,304.83117325711817,0.4431608303782506,0.21047345289887254,0.1729628969468474,130100.82018122502,-1668.2428684887645,128432.57731273625,1700,4,223.10416666666666,45,3,18,37.175467607801345,0.607175925925926,44.95018115942029,1020.1992753623185,22.671095008051523,0
2089,4,0,1,46,0.0,0.02127659574468085,0.9787234042553191,47,1300,700,600,0.5384615384615384,19,7,12,308.11638464052714,0.44264569842738205,0.2142369033692768,0.17523523175995337,130191.7052469138,-1377.1604938271403,128814.54475308667,1701,5,227.70212765957447,44,3,19,36.99986390854654,0.609375,44.86111111111112,1020.5555555555572,23.194444444444482,0
2090,4,0,0,46,0.0,0.0,1.0,46,2000,1700,300,0.85,23,17,6,309.1849972875312,0.4418780193236715,0.2151182645951324,0.17652536566160007,130342.35161675372,-1139.9429132908701,129202.40870346285,1702,6,232.95652173913044,39,7,19,36.82046737393313,0.6183226495726496,44.71354166666668,1021.1458333333353,26.183226495726547,0
2091,4,0,0,46,0.0,0.0,1.0,46,1400,1000,400,0.7142857142857143,18,10,8,304.4313461441928,0.44118357487922705,0.2133288651546923,0.17461820795663793,130522.0739659761,-1252.9978642011852,129269.07610177492,1703,7,233.95652173913044,40,6,16,36.76052544339467,0.6184895833333333,44.53760162601627,1021.8495934959363,25.54623983739841,0
2092,4,0,0,46,0.0,0.0,1.0,46,1500,1100,400,0.7333333333333333,19,11,8,304.48774538602777,0.44064009661835746,0.21131627744135684,0.17511962440469162,130625.9411250744,-1245.2003395796112,129380.7407854948,1704,8,234.95652173913044,40,6,16,36.65436425091956,0.61953125,44.4359756097561,1022.256097560976,25.5564024390244,0
2093,4,0,1,45,0.0,0.021739130434782608,0.9782608695652174,46,1700,1100,600,0.6470588235294118,23,11,12,302.3351796336009,0.4403985507246377,0.20464127905015683,0.1747578684070454,130820.18455530348,-1289.6912005543074,129530.49335474917,1705,9,235.95652173913044,41,5,16,36.513689552624776,0.6199186991869918,44.24603174603174,1023.0158730158721,24.95160665892371,0
2094,4,0,1,44,0.0,0.022222222222222223,0.9777777777777777,45,1150,700,450,0.6086956521739131,16,7,9,310.4309842850103,0.43989898989898985,0.2068291175561734,0.17962179021732672,130859.79327781092,-875.4131138872294,129984.38016392369,1706,10,240.93333333333334,40,5,16,36.266719639782806,0.621875,44.207317073170735,1023.1707317073178,25.579268292682947,0
2095,4,0,1,43,0.0,0.022727272727272728,0.9772727272727273,44,600,400,200,0.6666666666666666,8,4,4,304.96594555959126,0.4397903453136011,0.19650866853785587,0.1770560213038479,130989.80150910497,-810.5142648225303,130179.28724428244,1707,11,242.8409090909091,40,4,16,36.27560475197725,0.6231770833333333,44.08028455284553,1023.6788617886174,25.591971544715435,0
2096,4,1,0,44,0.022727272727272728,0.0,1.0,44,1550,1100,450,0.7096774193548387,20,11,9,301.52813870524153,0.4400656272022551,0.18587858834300253,0.17602493433629302,131201.04762101578,-887.8384629314844,130313.2091580843,1708,0,243.25,41,3,18,36.151088570414146,0.623729674796748,43.87400793650793,1024.5039682539666,24.98790166473089,0
2097,4,0,2,42,0.0,0.045454545454545456,0.9545454545454546,44,950,600,350,0.631578947368421,13,6,7,316.9654691968571,0.43982337914023956,0.09389552541000246,0.18014872869542894,130165.93491735541,-548.3786730945743,129617.55624426084,1709,1,244.25,43,1,16,36.80014229151201,0.6104651162790697,44.88636363636364,1020.4545454545457,23.731501057082458,8
2098,4,1,0,43,0.023255813953488372,0.0,1.0,43,1300,800,500,0.6153846153846154,18,8,10,322.32663787070453,0.4383997785160576,0.13084635609539297,0.18401920780254782,130340.40584308289,-197.49130105062784,130142.91454203226,1710,0,250.34883720930233,40,3,17,36.486945992569005,0.6166666666666667,44.71544715447155,1021.1382113821144,25.52845528455286,0
2099,4,0,0,43,0.0,0.0,1.0,43,1100,900,200,0.8181818181818182,13,9,4,326.87190463448854,0.43844592100406055,0.13278789799927337,0.18698858927041812,130418.24811826629,-73.98776769779539,130344.2603505685,1711,1,251.34883720930233,40,3,17,36.29220143932611,0.6174479166666667,44.639227642276424,1021.4430894308946,25.536077235772364,0
2100,4,0,0,43,0.0,0.0,1.0,43,1250,900,350,0.72,16,9,7,323.7487599255363,0.43837670727205613,0.10204817605991989,0.18632222682213367,130651.91436975349,-38.07267912617576,130613.84169062732,1712,2,252.34883720930233,40,3,18,36.13589297548046,0.6197916666666667,44.41056910569106,1022.357723577236,25.5589430894309,8
2101,4,0,2,41,0.0,0.046511627906976744,0.9534883720930233,43,1200,900,300,0.75,15,9,6,327.26052389668297,0.4368078626799557,0.1072229523266206,0.1894874189255723,130885.78976014616,-33.24957449268683,130852.54018565347,1713,3,253.34883720930233,40,3,18,35.809994372165406,0.6221354166666666,44.181910569105696,1023.2723577235779,25.58180894308945,0
2102,4,0,1,40,0.0,0.024390243902439025,0.975609756097561,41,850,400,450,0.47058823529411764,13,4,9,329.14086537228343,0.43628048780487805,0.10692293755134519,0.1910494556416676,130981.34901258693,422.26291232639835,131403.61192491333,1714,4,253.6341463414634,39,2,19,35.66544978121502,0.624732905982906,44.08854166666667,1023.6458333333344,26.247329059829088,0
2103,4,0,0,40,0.0,0.0,1.0,40,950,600,350,0.631578947368421,13,6,7,334.89726549741647,0.4362179487179487,0.10538509705698207,0.1944839756361359,130999.80481591051,774.2952827087379,131774.10009861924,1715,5,258.05,38,2,19,35.499504278856186,0.6266447368421053,44.07051282051282,1023.7179487179482,26.939946018893373,0
2104,4,0,1,39,0.0,0.025,0.975,40,1400,1000,400,0.7142857142857143,18,10,8,351.2303825133291,0.43595085470085465,0.0933916316139034,0.19562362981661024,129373.1801903256,1096.2022726088662,130469.38246293446,1716,6,259.05,36,4,19,36.73137591321674,0.6140046296296297,45.66441441441442,1017.3423423423434,28.259509509509538,8
2105,4,0,0,39,0.0,0.0,1.0,39,1050,900,150,0.8571428571428571,12,9,3,350.88116375185865,0.4340137201979308,0.09633261824496886,0.19571371578159258,129430.46932067221,1282.9427400373588,130713.41206070957,1717,7,264.7692307692308,36,3,14,36.68197580050169,0.6145833333333333,45.60810810810812,1017.5675675675692,28.26576576576581,0
2106,4,0,0,39,0.0,0.0,1.0,39,1350,1000,350,0.7407407407407407,17,10,7,348.27248944821906,0.43409806567701303,0.08778407318553327,0.19511027568716244,129602.41280131502,1227.3909889619579,130829.80379027697,1718,8,265.7692307692308,36,3,14,36.573536459485375,0.6163194444444444,45.4391891891892,1018.2432432432447,28.284534534534576,0
2107,4,2,0,41,0.04878048780487805,0.0,1.0,41,1250,900,350,0.72,16,9,7,342.2366916942986,0.43607723577235774,0.11383728000086091,0.1951394872264469,130291.32806793257,721.4488982225234,131012.7769661551,1719,0,253.7560975609756,36,5,16,36.028384440032376,0.6232638888888888,44.7635135135135,1020.945945945944,28.359609609609556,0
2108,4,0,1,40,0.0,0.024390243902439025,0.975609756097561,41,1050,600,450,0.5714285714285714,15,6,9,345.48856792981223,0.4354166666666666,0.11279042566635589,0.19772408830860072,130435.08193582065,812.7659331628579,131247.84786898352,1720,1,254.7560975609756,36,5,17,35.79975563149964,0.6247106481481481,44.62274774774773,1021.5090090090065,28.37525025025018,0
2109,4,1,1,40,0.024390243902439025,0.024390243902439025,0.975609756097561,41,1250,800,450,0.64,17,8,9,346.05687225371656,0.4370680894308943,0.1183041053551026,0.19863795798244627,130550.14209733365,835.5547692962975,131385.69686662994,1721,0,254.9268292682927,36,5,13,35.668732782369126,0.6258680555555556,44.51013513513512,1021.9594594594581,28.387762762762726,0
2110,4,1,0,41,0.024390243902439025,0.0,1.0,41,1200,900,300,0.75,15,9,6,345.0140708827972,0.4354166666666666,0.12472402716305164,0.19857476524143186,130654.64854570616,815.5384349030267,131470.1869806092,1722,0,255.90243902439025,37,4,14,35.589607464607475,0.625,44.407894736842096,1022.3684210526299,27.631578947368375,0
2111,4,0,1,40,0.0,0.024390243902439025,0.975609756097561,41,1200,700,500,0.5833333333333334,17,7,10,338.765809001954,0.4348069105691057,0.12140479856937092,0.19568707319995204,130794.81336805543,661.762152777767,131456.5755208332,1723,1,256.9024390243902,39,2,14,35.60760353021045,0.6228632478632479,44.27083333333333,1022.9166666666656,26.228632478632452,0
2112,4,0,0,40,0.0,0.0,1.0,40,1200,1000,200,0.8333333333333334,14,10,4,341.2933757814151,0.4323450854700855,0.12180417754569195,0.19721690242046155,130808.47447083422,928.8131665936098,131737.28763742783,1724,2,264.225,38,2,15,35.52915578764142,0.6247258771929824,44.25747863247863,1022.9700854700852,26.920265407107507,0
2113,4,0,0,40,0.0,0.0,1.0,40,1100,900,200,0.8181818181818182,13,9,4,340.9290790999099,0.43233173076923076,0.12124099404824085,0.1972856671021048,130863.12601587028,923.009008145212,131786.1350240155,1725,3,265.225,38,2,16,35.483232397062416,0.6252741228070176,44.20405982905982,1023.1837606837596,26.925888439046304,0
2114,4,0,1,39,0.0,0.025,0.975,40,1300,1200,100,0.9230769230769231,14,12,2,341.7752209658578,0.43185096153846153,0.1191940532081377,0.19890197285717934,131081.84633875726,960.1053994082645,132041.95173816552,1726,4,266.225,38,2,17,35.240610328638475,0.627467105263158,43.990384615384606,1024.0384615384603,26.948380566801585,0
2115,4,2,1,40,0.04878048780487805,0.024390243902439025,0.975609756097561,41,1150,700,450,0.6086956521739131,16,7,9,334.5798629983119,0.43376524390243903,0.11979745198349989,0.19683396468466707,131496.76462950124,599.6961769984582,132096.4608064997,1727,0,249.8780487804878,37,4,19,35.00641436818473,0.6334459459459459,43.585526315789465,1025.657894736841,27.72048364153624,0
2116,4,0,3,37,0.0,0.075,0.925,40,800,500,300,0.625,11,5,6,342.530840418382,0.4313701923076923,0.09558143043959344,0.18238345391532587,127579.22620670559,739.9639145019419,128319.19012120753,1728,1,256.3,40,0,16,38.78277671595748,0.5888020833333334,47.43394308943089,1010.2642276422758,25.256605691056897,8
2117,4,2,0,39,0.05128205128205128,0.0,1.0,39,800,700,100,0.875,9,7,2,355.51799087931965,0.43182073774179036,0.1432453631444257,0.1905976904167487,127854.65630425364,1290.9261067708528,129145.5824110245,1729,0,262.8205128205128,39,0,18,38.172593298314276,0.593215811965812,47.16145833333334,1011.3541666666681,25.93215811965816,0
2118,4,0,1,38,0.0,0.02564102564102564,0.9743589743589743,39,800,500,300,0.625,11,5,6,355.51799087931965,0.43182073774179036,0.1432453631444257,0.1905976904167487,127854.65630425364,1290.9261067708528,129145.5824110245,1730,1,263.8205128205128,39,0,18,38.172593298314276,0.593215811965812,47.16145833333334,1011.3541666666681,25.93215811965816,0
2119,4,3,3,38,0.07317073170731707,0.07317073170731707,0.926829268292683,41,1150,800,350,0.6956521739130435,15,8,7,332.871402184931,0.43696646341463413,0.1541177649686094,0.18146366904866085,128523.41666894975,357.3386845591375,128880.75535350888,1731,0,250.9268292682927,38,3,13,38.062813893864366,0.6016995614035088,46.50106837606839,1013.9957264957284,26.684098065677063,0
2120,4,2,1,39,0.05,0.025,0.975,40,950,700,250,0.7368421052631579,12,7,5,340.31233626707706,0.43336004273504275,0.1641532388882878,0.18543713455873098,128505.59937913601,746.4081496229727,129252.00752875899,1732,0,258.15,37,3,15,37.89235698064236,0.603322072072072,46.5186403508772,1013.9254385964922,27.403390232337628,0
2121,4,1,0,40,0.025,0.0,1.0,40,1050,600,450,0.5714285714285714,15,6,9,337.9824559887515,0.4350026709401709,0.16342662632375227,0.18507039335620734,128700.2310807171,699.6840373961192,129399.91511811322,1733,0,259.125,37,3,17,37.75304372883799,0.6052927927927928,46.32675438596491,1014.6929824561399,27.424134660976755,0
2122,4,3,1,42,0.06976744186046512,0.023255813953488372,0.9767441860465116,43,1100,900,200,0.8181818181818182,13,9,4,336.36985013399874,0.4405915466961978,0.21349551257586796,0.177784736122866,127280.60766171737,17.736804833383303,127298.34446655076,1734,0,241.97674418604652,38,5,18,39.24408858302452,0.5890899122807017,47.72970085470085,1009.0811965811961,26.55476833108411,8
2123,4,2,1,43,0.045454545454545456,0.022727272727272728,0.9772727272727273,44,950,700,250,0.7368421052631579,12,7,5,340.22178499629223,0.44340204369274133,0.16351402220967426,0.17669583027226785,126567.3828125,-153.27563988421366,126414.10717261578,1735,0,237.3181818181818,41,3,12,39.878795721187025,0.5769817073170731,48.4375,1006.25,24.54268292682927,8
2124,4,1,2,42,0.022727272727272728,0.045454545454545456,0.9545454545454546,44,1550,1400,150,0.9032258064516129,17,14,3,345.396280382367,0.44226788231148695,0.1885553386932146,0.18059494495378792,126842.05424067803,-37.845253842250855,126804.20898683577,1736,0,238.27272727272728,41,3,13,39.4663843477119,0.5797764227642277,48.16468253968255,1007.3412698412722,24.56929926442127,0
2125,4,1,2,41,0.023255813953488372,0.046511627906976744,0.9534883720930233,43,1200,900,300,0.75,15,9,6,352.5175851134371,0.4413298265042451,0.20128307939053713,0.1849877994261943,126989.56164485437,353.21072113161176,127342.77236598599,1737,0,244.65116279069767,40,3,15,39.135494387309265,0.5828125,48.018292682926834,1007.9268292682937,25.198170731707343,0
2126,4,2,1,42,0.046511627906976744,0.023255813953488372,0.9767441860465116,43,1800,1400,400,0.7777777777777778,22,14,8,354.64390453709154,0.445344222960502,0.2370395877657936,0.18869769934711325,127550.26989051438,447.0677705238213,127997.3376610382,1738,0,243.88372093023256,38,5,14,38.50652212233385,0.5918311403508771,47.46260683760684,1010.1495726495734,26.582883490778247,0
2127,4,3,2,43,0.06666666666666667,0.044444444444444446,0.9555555555555556,45,1250,900,350,0.72,16,9,7,347.67735270707374,0.44589646464646465,0.25368084133516233,0.18774577046181987,128144.53125000001,-86.64746785740431,128057.88378214261,1739,0,233.9777777777778,38,7,17,38.0744170096022,0.5978618421052632,46.875,1012.5000000000001,26.644736842105267,0
2128,4,2,0,45,0.044444444444444446,0.0,1.0,45,1350,900,450,0.6666666666666666,18,9,9,356.42871207952453,0.44452861952861955,0.28706537491584205,0.19464645931117966,128593.1654188369,166.85926649306555,128760.02468532996,1740,0,234.82222222222222,39,6,16,37.39441049604601,0.6006944444444444,46.43229166666667,1014.2708333333342,26.006944444444464,0
2129,4,1,1,45,0.021739130434782608,0.021739130434782608,0.9782608695652174,46,1300,1000,300,0.7692307692307693,16,10,6,301.8404194074137,0.4457830112721417,0.2218923577858649,0.16229751078538696,127972.89544648764,-1471.6515044496555,126501.24394203798,1741,0,230.69565217391303,42,4,17,39.40935644512545,0.589781746031746,47.04457364341086,1011.821705426357,24.09099298634183,8
2130,4,0,0,45,0.0,0.0,1.0,45,1250,900,350,0.72,16,9,7,306.5738542873278,0.4442760942760943,0.23375276443224213,0.16482586926075146,127968.81028163579,-1153.6217206790197,126815.18856095677,1742,1,236.77777777777777,41,4,18,39.29378288721115,0.5912093495934959,47.04861111111111,1011.8055555555554,24.678184281842814,0
2131,4,0,1,44,0.0,0.022222222222222223,0.9777777777777777,45,1300,800,500,0.6153846153846154,18,8,10,306.57833888370016,0.44404461279461277,0.23220719248948973,0.1651379204483375,128044.10450522814,-1148.8902273872382,126895.2142778409,1743,2,237.77777777777777,41,4,18,39.21698359798731,0.5919715447154472,46.974206349206355,1012.1031746031756,24.685443283004282,0
2132,4,1,0,45,0.022222222222222223,0.0,1.0,45,1100,800,300,0.7272727272727273,14,8,6,303.76297058279766,0.4441919191919192,0.22450439608197148,0.16487863797937274,128350.40655570438,-1202.3011106280985,127148.10544507627,1744,0,227.7111111111111,40,5,19,38.9765737304851,0.5966145833333334,46.67174796747968,1013.3130081300822,25.332825203252053,0
2133,4,1,1,45,0.021739130434782608,0.021739130434782608,0.9782608695652174,46,1300,900,400,0.6923076923076923,17,9,8,300.92995846441437,0.4445450885668277,0.23690296033054992,0.1647704290778391,128697.58204207632,-1454.2083963214689,127243.37364575485,1745,0,223.7391304347826,41,5,16,38.69565571633426,0.5985772357723578,46.32936507936509,1014.6825396825416,24.748354626403454,0
2134,4,1,0,46,0.021739130434782608,0.0,1.0,46,1700,1500,200,0.8823529411764706,19,15,4,307.14067721003136,0.4440418679549114,0.24650539641455693,0.1692664867778944,128955.22072742034,-1278.5212352022027,127676.69949221813,1746,0,224.69565217391303,42,4,18,38.27652960630923,0.5997023809523809,46.07558139534884,1015.6976744186056,24.183277962347752,0
2135,4,0,0,46,0.0,0.0,1.0,46,1200,700,500,0.5833333333333334,17,7,10,307.3294296709722,0.44352858293075687,0.24425576911115265,0.16968662823065542,129029.04652852904,-1269.1153438795604,127759.93118464948,1747,1,225.69565217391303,42,4,18,38.196828803052,0.6004464285714286,46.00290697674419,1015.988372093024,24.190199335548193,0
2136,4,1,1,46,0.02127659574468085,0.02127659574468085,0.9787234042553191,47,2000,1600,400,0.8,24,16,8,299.24366711269823,0.443686401480111,0.23584001773709518,0.16716584896711426,129490.37606175386,-1650.1650022956883,127840.21105945818,1748,0,221.87234042553192,43,4,13,37.93496464458504,0.6036821705426356,45.54924242424242,1017.80303030303,23.669837914023955,0
2137,4,0,1,45,0.0,0.021739130434782608,0.9782608695652174,46,1600,1100,500,0.6875,21,11,10,324.57315036302987,0.4423913043478261,0.18212860910135897,0.16696042854674278,126174.6215820314,-907.8370934128075,125266.78448861859,1749,3,227.69565217391303,39,7,14,40.67576032486608,0.5761217948717949,48.82812500000001,1004.6875000000011,25.761217948717977,8
2138,4,2,1,46,0.0425531914893617,0.02127659574468085,0.9787234042553191,47,1150,800,350,0.6956521739130435,15,8,7,332.41697986214945,0.44626888683317917,0.21260278678317568,0.1735643978100056,126784.7810909514,-970.9171954524197,125813.86389549897,1750,0,223.74468085106383,40,7,15,39.85200134544232,0.5807291666666667,48.221544715447166,1007.1138211382134,25.177845528455336,0
2139,4,3,0,49,0.061224489795918366,0.0,1.0,49,1100,600,500,0.5454545454545454,16,6,10,329.94334615677,0.4490681689342404,0.24999743383924367,0.17568113573350055,127579.22620670583,-1380.47303605656,126198.75317064927,1751,0,215.55102040816325,40,9,16,39.100694095161465,0.5888020833333334,47.433943089430905,1010.2642276422778,25.256605691056944,0
2140,4,2,1,50,0.0392156862745098,0.0196078431372549,0.9803921568627451,51,1250,900,350,0.72,16,9,7,320.0265544192505,0.4527124183006536,0.24877779530042576,0.17228646053374516,128021.92251066657,-2005.9170497566074,126016.00546090996,1752,0,208.05882352941177,42,9,19,38.89932816290056,0.5902777777777778,46.99612403100776,1012.0155038759701,24.095607235142147,0
2141,4,2,0,52,0.038461538461538464,0.0,1.0,52,1400,1000,400,0.7142857142857143,18,10,8,318.4528018285677,0.45475898692810457,0.26884900741928974,0.17318692723217793,128427.65239771339,-2220.194799965882,126207.4575977475,1753,0,204.80769230769232,40,12,16,38.52579205935432,0.5973958333333333,46.59552845528457,1013.617886178865,25.340447154471626,0
2142,4,0,2,50,0.0,0.038461538461538464,0.9615384615384616,52,1650,1100,550,0.6666666666666666,22,11,11,319.5169108050105,0.45464900703871297,0.2623658027174707,0.1745538197452008,128607.98306439658,-2181.514909280154,126426.46815511642,1754,1,205.80769230769232,40,12,16,38.315299068229635,0.59921875,46.417682926829286,1014.329268292686,25.358231707317152,0
2143,4,1,2,49,0.0196078431372549,0.0392156862745098,0.9607843137254902,51,1500,900,600,0.6,21,9,12,333.70052354981954,0.45383986928104575,0.291379705460203,0.1843100173672108,129042.58355034741,-1587.6844618055338,127454.89908854188,1755,0,210.2549019607843,39,12,17,37.51324243045588,0.6052350427350428,45.98958333333334,1016.0416666666682,26.05235042735047,0
2144,4,1,3,47,0.02,0.06,0.94,50,1800,1100,700,0.6111111111111112,25,11,14,323.8562109311085,0.45125850340136053,0.12986511119212496,0.1787399570591615,129013.18587105657,-1643.655692729736,127369.53017832684,1756,0,215.32,44,6,17,37.79317049459231,0.5975378787878788,46.01851851851853,1015.9259259259286,23.08922558922565,8
2145,4,0,1,46,0.0,0.02127659574468085,0.9787234042553191,47,1300,900,400,0.6923076923076923,17,9,8,338.64595214440425,0.44806120875732347,0.1300053862166921,0.1857740877420593,128773.09032698757,-678.302843127964,128094.7874838596,1757,1,229.51063829787233,41,6,17,37.661987260938986,0.599339430894309,46.25496031746033,1014.9801587301611,24.755613627564905,0
2146,4,0,0,46,0.0,0.0,1.0,46,1700,1500,200,0.8823529411764706,19,15,4,343.0071919825686,0.44582326892109503,0.12832439864935385,0.18872950783534317,128891.6154405449,-357.84978352830194,128533.7656570166,1758,2,235.41304347826087,40,6,19,37.43056945556444,0.6020833333333333,46.13821138211383,1015.4471544715468,25.38617886178867,0
2147,4,0,0,46,0.0,0.0,1.0,46,1400,1100,300,0.7857142857142857,17,11,6,347.0088983095726,0.44491747181964575,0.1373854776782022,0.19180442090643557,129072.2714344141,-242.15465744596145,128830.11677696813,1759,3,236.41304347826087,40,6,21,37.14496449644964,0.60390625,45.96036585365854,1016.1585365853664,25.40396341463416,0
2148,4,0,0,46,0.0,0.0,1.0,46,1250,700,550,0.56,18,7,11,346.970102509797,0.44505837359098227,0.13859700986423062,0.19203364666300385,129123.91067031857,-239.57269565074193,128884.33797466783,1760,4,237.41304347826087,40,6,21,37.09337399593373,0.6044270833333334,45.90955284552845,1016.361788617886,25.40904471544715,0
2149,4,0,0,46,0.0,0.0,1.0,46,1750,1400,350,0.8,21,14,7,348.6442617136169,0.44480676328502416,0.04827230891483292,0.187664840980768,128015.9430976936,-244.94317618476953,127770.99992150883,1761,5,238.41304347826087,40,6,18,38.18140356162549,0.5932291666666667,47.00203252032522,1011.9918699187027,25.29979674796757,8
2150,4,1,0,47,0.02127659574468085,0.0,1.0,47,1150,900,250,0.782608695652174,14,9,5,343.4549761077515,0.44596053037311134,0.05507449981509094,0.1858326506786685,128223.64501953151,-592.0611145838194,127631.58390494769,1762,0,234.31914893617022,39,8,19,38.10048767527171,0.5969551282051282,46.796875000000014,1012.812500000002,25.969551282051334,0
2151,4,0,1,46,0.0,0.02127659574468085,0.9787234042553191,47,1000,600,400,0.6,14,6,8,344.547022554701,0.44617252543940794,0.052857846086528104,0.18666962642587615,128276.40109592053,-560.5495876735713,127715.85150824697,1763,1,235.31914893617022,39,8,19,38.0189588688946,0.5974893162393162,46.744791666666686,1013.0208333333366,25.974893162393244,0
2152,4,0,2,44,0.0,0.043478260869565216,0.9565217391304348,46,1050,600,450,0.5714285714285714,15,6,9,344.5888315947751,0.4461453301127214,0.061721966198970524,0.18693896067609492,128329.16802300369,-355.8403862847015,127973.32763671898,1764,2,240.93478260869566,39,7,19,37.96402196634797,0.5980235042735043,46.69270833333334,1013.2291666666684,25.98023504273509,0
2153,4,0,1,43,0.0,0.022727272727272728,0.9772727272727273,44,1350,900,450,0.6666666666666666,18,9,9,348.7622752483304,0.4430937279774489,0.06151719577987125,0.18961075674962247,128415.10662073562,157.26895226093976,128572.37557299656,1765,3,250.97727272727272,38,6,18,37.770545658971926,0.6006030701754386,46.60790598290598,1013.568376068376,26.672852001799367,0
2154,4,0,1,42,0.0,0.023255813953488372,0.9767441860465116,43,1750,1500,250,0.8571428571428571,20,15,5,345.02822881573917,0.4425064599483204,0.059691514254333944,0.1887963454306347,128672.41753472215,279.1232638888843,128951.54079861104,1766,4,256.04651162790697,39,4,18,37.60266940451746,0.6014957264957265,46.354166666666664,1014.5833333333327,26.01495726495725,0
2155,4,1,0,43,0.023255813953488372,0.0,1.0,43,1100,900,200,0.8181818181818182,13,9,4,348.65093169501466,0.4418835363602805,0.07233975536773585,0.19154182527055305,128830.99500868036,383.40928819442524,129214.40429687478,1767,0,256.93023255813955,39,4,19,37.34908338463642,0.6030982905982907,46.19791666666666,1015.2083333333318,26.030982905982867,0
2156,4,0,0,43,0.0,0.0,1.0,43,1500,1100,400,0.7333333333333333,19,11,8,343.52515143766976,0.44160668143226284,-0.017535560949257123,0.1862987213673731,128315.61872260801,289.1381061171251,128604.75682872513,1768,1,257.93023255813955,36,7,18,38.00479789559481,0.6032986111111112,46.706081081081095,1013.1756756756778,28.143768768768826,8
2157,4,0,2,41,0.0,0.046511627906976744,0.9534883720930233,43,1450,900,550,0.6206896551724138,20,9,11,344.7887445024463,0.4413298265042451,-0.015550372098189547,0.1877878443288281,128486.82032962039,260.16189331225934,128746.98222293265,1769,2,258.93023255813955,36,7,15,37.79804879854863,0.6050347222222222,46.537162162162176,1013.8513513513533,28.16253753753759,0
2158,4,0,1,40,0.0,0.024390243902439025,0.975609756097561,41,1350,900,450,0.6666666666666666,18,9,9,348.7333458434979,0.43892276422764226,-0.005078516538590261,0.18998159885503987,128496.33487654322,762.1913580246937,129258.52623456791,1770,14,269.6829268292683,35,6,16,37.68835616438356,0.6071428571428572,46.52777777777778,1013.8888888888889,28.96825396825397,0
2159,4,0,0,40,0.0,0.0,1.0,40,1250,1000,250,0.8,15,10,5,351.26418438735453,0.4398103632478632,-0.004868796349115856,0.19206678578634817,128643.06205257626,1037.5400537980038,129680.60210637427,1771,15,276.15,35,5,18,37.47444856436583,0.6086309523809523,46.38310185185185,1014.4675925925923,28.98478835978835,0
2160,4,0,0,40,0.0,0.0,1.0,40,1250,800,450,0.64,17,8,9,353.11334472388546,0.4393830128205128,0.0019493844049247588,0.194079590220421,128848.62075617274,1099.6334876543096,129948.25424382705,1772,16,277.15,35,5,18,37.21785225718193,0.6107142857142858,46.18055555555555,1015.2777777777769,29.007936507936485,0
2161,4,3,2,41,0.06976744186046512,0.046511627906976744,0.9534883720930233,43,1650,1300,350,0.7878787878787878,20,13,7,330.95496774839137,0.44511351052048725,0.015827730142084606,0.1862239146882736,129774.47041636203,-9.134359584845555,129765.33605677719,1773,0,258.74418604651163,36,7,14,36.839863321544335,0.6180555555555556,45.27027027027025,1018.9189189189167,28.30330330330324,0
2162,4,0,1,40,0.0,0.024390243902439025,0.975609756097561,41,800,300,500,0.375,13,3,10,351.497951965028,0.44080284552845533,0.003194605680122864,0.19657678137690957,129534.44054705181,906.2181122448525,130440.65865929666,1774,1,272.3658536585366,34,7,14,36.5605387284138,0.6197916666666667,45.50595238095236,1017.9761904761876,29.940476190476108,0
2163,4,1,0,41,0.024390243902439025,0.0,1.0,41,900,600,300,0.6666666666666666,12,6,6,347.1952472673862,0.4396849593495935,0.025726422431844753,0.19567732138618096,129837.58680555537,815.7986111110874,130653.38541666645,1775,0,272.390243902439,34,7,15,36.36208776233305,0.6228553921568627,45.20833333333332,1019.1666666666652,29.975490196078386,0
2164,4,0,1,40,0.0,0.024390243902439025,0.975609756097561,41,1150,800,350,0.6956521739130435,15,8,7,347.855104715203,0.4396595528455285,0.022721707487913356,0.19681154735735962,129989.29280045327,843.4878117913556,130832.78061224463,1776,1,273.390243902439,34,7,17,36.191289205385644,0.6243872549019608,45.059523809523796,1019.7619047619028,29.992997198879493,0
2165,4,0,0,40,0.0,0.0,1.0,40,1550,1000,550,0.6451612903225806,21,10,11,356.83119874522845,0.43675213675213675,0.032907703401034105,0.20184856592515593,129981.25908604852,1276.273698817753,131257.5327848663,1777,2,280.6,33,7,20,35.97061150502745,0.6265782828282829,45.06740196078431,1019.7303921568619,30.900920974450358,0
2166,4,1,0,41,0.024390243902439025,0.0,1.0,41,1050,700,350,0.6666666666666666,14,7,7,346.5076408895875,0.43973577235772354,0.0340388503570237,0.19773759387292023,130323.3577806122,831.6078514739165,131154.96563208612,1778,0,274.7317073170732,34,7,21,35.88691655979169,0.6277573529411764,44.732142857142854,1021.0714285714283,30.03151260504201,0
2167,4,1,1,41,0.023809523809523808,0.023809523809523808,0.9761904761904762,42,1600,1200,400,0.75,20,12,8,337.95037011640704,0.44024632210607817,0.05276035266981394,0.19491706725512878,130735.62349965707,436.43046982166993,131172.05396947873,1779,0,269.1666666666667,35,7,17,35.68828278255619,0.6297619047619047,44.3287037037037,1022.6851851851852,29.21957671957672,0
2168,4,0,0,41,0.0,0.0,1.0,41,750,600,150,0.8,9,6,3,348.9675046191556,0.43663617886178857,0.05805037090892551,0.20086681834244663,130657.85147392277,919.068877551006,131576.92035147376,1780,1,276.7073170731707,34,7,17,35.48531866169849,0.6311274509803921,44.4047619047619,1022.3809523809513,30.07002801120445,0
2169,4,0,0,41,0.0,0.0,1.0,41,1000,600,400,0.6,14,6,8,345.98092415092617,0.4365091463414634,0.061195584608005005,0.1999336974599131,130810.03578514734,851.5554138321961,131661.59119897953,1781,2,277.7073170731707,34,7,18,35.40769618681873,0.6326593137254901,44.25595238095238,1022.97619047619,30.08753501400559,0
2170,4,0,0,41,0.0,0.0,1.0,41,1200,600,600,0.5,18,6,12,346.99307154452583,0.4361788617886179,0.06474934456184966,0.20099409993239495,130901.38888888872,884.3749999999802,131785.7638888887,1782,3,278.7073170731707,34,7,18,35.289427252985895,0.633578431372549,44.16666666666666,1023.3333333333319,30.09803921568623,0
2171,4,0,0,41,0.0,0.0,1.0,41,1300,800,500,0.6153846153846154,18,8,10,353.4622834926962,0.43602642276422765,0.006291035274733625,0.1973329434127797,129466.28146701398,952.2894965277876,130418.57096354176,1783,4,279.7073170731707,35,6,16,36.57987888092801,0.6169642857142856,45.57291666666667,1017.708333333334,29.077380952380974,8
2172,4,0,1,40,0.0,0.024390243902439025,0.975609756097561,41,1000,700,300,0.7,13,7,6,354.69259525821644,0.43572154471544716,0.014539324658905395,0.198614306841918,129584.09857521013,992.5040455675688,130576.60262077769,1784,5,280.7073170731707,35,6,17,36.428730438407044,0.6181547619047619,45.45717592592593,1018.1712962962969,29.090608465608483,0
2173,4,0,0,40,0.0,0.0,1.0,40,1200,900,300,0.75,15,9,6,362.53424819362914,0.43406784188034186,0.015136810102900133,0.2029052938842878,129564.73922902494,1394.3310657596348,130959.07029478457,1785,6,287.45,34,6,18,36.2488306828812,0.6200980392156863,45.476190476190474,1018.0952380952381,29.943977591036415,0
2174,4,0,0,40,0.0,0.0,1.0,40,1050,700,350,0.6666666666666666,14,7,7,357.0959134660047,0.4341613247863248,0.019193246874634973,0.20094568858353268,129776.92920918361,1268.5622165532802,131045.4914257369,1786,7,288.45,34,6,18,36.171476418584724,0.6222426470588236,45.26785714285714,1018.9285714285709,29.968487394957968,0
2175,4,0,0,40,0.0,0.0,1.0,40,1400,1000,400,0.7142857142857143,18,10,8,361.7347975308132,0.43422809829059833,0.007347082259199,0.19967948008589653,129019.90504535152,1360.4024943310746,130380.3075396826,1787,8,289.45,34,6,18,36.824271541285846,0.6145833333333333,46.011904761904766,1015.9523809523813,29.88095238095239,8
2176,4,0,0,40,0.0,0.0,1.0,40,900,600,300,0.6666666666666666,12,6,6,360.67459808570817,0.4344284188034188,0.0055119493908153405,0.199398858112669,129080.38548752852,1311.2032312925385,130391.58871882106,1788,9,290.45,34,6,18,36.78952866291784,0.6151960784313726,45.95238095238096,1016.1904761904776,29.887955182072872,0
2177,4,0,2,38,0.0,0.05,0.95,40,1400,900,500,0.6428571428571429,19,9,10,360.89717136639484,0.434107905982906,0.014487094272737311,0.19998887451961023,129172.76810171679,1323.617325095389,130496.38542681218,1789,10,291.45,36,4,18,36.68969942025775,0.6119791666666667,45.8614864864865,1016.5540540540558,28.23761261261266,0
2178,4,0,0,38,0.0,0.0,1.0,38,500,200,300,0.4,8,2,6,374.7002781365053,0.4313952110004742,0.025279564785630315,0.20667856970515858,128989.67013888899,2066.4930555555648,131056.16319444455,1790,11,305.7631578947368,34,4,18,36.52584085315831,0.6142769607843137,46.04166666666667,1015.8333333333342,29.877450980392183,0
2179,4,5,4,39,0.11627906976744186,0.09302325581395349,0.9069767441860466,43,1200,900,300,0.75,15,9,6,332.17155389535594,0.4424141749723145,0.03649558424422339,0.18871724545483406,130150.67737188368,46.817770852571016,130197.49514273625,1791,0,271.09302325581393,37,6,19,36.42766315638656,0.6199324324324325,44.901315789473685,1020.3947368421055,27.57823613086772,0
2180,4,0,0,39,0.0,0.0,1.0,39,900,700,200,0.7777777777777778,11,7,4,362.089091380695,0.4343229869545659,0.038941516731332504,0.20255044323901894,129544.24267409154,1581.3114246924024,131125.55409878393,1792,1,295.84615384615387,33,6,19,36.28102303278357,0.6221590909090908,45.496323529411754,1018.0147058823517,30.848930481283386,0
2181,4,0,0,39,0.0,0.0,1.0,39,1100,700,400,0.6363636363636364,15,7,8,358.9690639232238,0.43409806567701303,0.038009557922925596,0.20144442203010876,129669.02941476827,1509.4340217704598,131178.46343653873,1793,2,296.84615384615387,33,6,20,36.233480728351985,0.6234217171717171,45.373774509803916,1018.5049019607836,30.863784907902534,0
2182,4,1,0,40,0.025,0.0,1.0,40,1400,900,500,0.6428571428571429,19,9,10,352.5220000854373,0.4350293803418803,0.04893790849673252,0.19976246671508116,130049.99999999997,1169.0972222222206,131219.0972222222,1794,0,290.4,34,6,23,36.010688997821354,0.625,45.0,1019.9999999999998,29.999999999999993,0
2183,4,1,3,38,0.024390243902439025,0.07317073170731707,0.926829268292683,41,1750,1500,250,0.8571428571428571,20,15,5,349.04984211806357,0.4354166666666666,0.06889498132022664,0.20044099629321588,130566.58340419503,915.0226757369644,131481.60607993198,1795,0,284.2926829268293,34,7,18,35.57561638516792,0.6302083333333333,44.49404761904762,1022.0238095238096,30.059523809523814,0
2184,4,0,0,38,0.0,0.0,1.0,38,1250,1000,250,0.8,15,10,5,361.95553598720284,0.4344476055002371,0.08263681124810462,0.2072921996609925,130462.04460991772,1844.291856553843,132306.33646647158,1796,1,296.42105263157896,31,7,24,35.35187781459767,0.6364247311827957,44.59635416666668,1021.6145833333348,32.955309139784994,0
2185,4,0,0,38,0.0,0.0,1.0,38,850,500,350,0.5882352941176471,12,5,7,366.0961811653135,0.4337660028449502,0.0885673296730558,0.21056564969442332,130628.37600708015,1964.509921603748,132592.88592868389,1797,2,297.42105263157896,31,7,18,35.0774052137732,0.6381048387096775,44.43359375000001,1022.2656250000006,32.97631048387099,0
2186,4,0,0,38,0.0,0.0,1.0,38,600,300,300,0.5,9,3,6,365.2170066458501,0.43349928876244664,0.09136635680631544,0.21042180140791372,130694.93823581278,1946.402825249571,132641.34106106235,1798,3,298.42105263157896,31,7,19,35.032392079460074,0.6387768817204301,44.368489583333336,1022.5260416666672,32.98471102150539,0
2187,4,0,0,38,0.0,0.0,1.0,38,1300,600,700,0.46153846153846156,20,6,14,366.95127836206944,0.43346965386439074,0.09759455928171823,0.21178562024497105,130761.51741875536,1996.6211954752562,132758.13861423061,1799,4,299.42105263157896,31,7,19,34.920565457245935,0.6394489247311828,44.303385416666664,1022.7864583333328,32.99311155913977,0
2188,4,0,1,37,0.0,0.02631578947368421,0.9736842105263158,38,900,700,200,0.7777777777777778,11,7,4,364.8229891681075,0.4334103840682788,0.09058048675928965,0.21100361750386684,130843.25140610657,1946.9252180899985,132790.17662419658,1800,5,300.42105263157896,32,6,19,34.89216956682709,0.6376953125,44.22348484848485,1023.106060606061,31.972064393939405,0
2189,4,0,1,36,0.0,0.02702702702702703,0.972972972972973,37,1000,500,500,0.5,15,5,10,397.9866691015342,0.4318380880880881,0.127595742460608,0.219316058079356,128952.32602845057,2873.444078247081,131825.77010669766,1801,6,309.2972972972973,33,4,18,35.97269144144146,0.6161616161616161,46.07843137254902,1015.6862745098036,30.778371954842534,8
2190,4,1,0,37,0.02702702702702703,0.0,1.0,37,750,500,250,0.6666666666666666,10,5,5,396.716614328261,0.4319319319319319,0.14050795822947726,0.21982393559471766,129170.24289035458,2848.796286284113,132019.0391766387,1802,0,310.0,33,4,19,35.78197207152904,0.6183712121212122,45.86397058823529,1016.5441176470581,30.804367201426004,0
2191,4,3,2,38,0.075,0.05,0.95,40,1150,800,350,0.6956521739130435,15,8,7,369.3884889434812,0.4393162393162393,0.1478726508696162,0.20915738167738285,130019.64462868469,1605.559521602744,131625.20415028743,1803,0,287.675,34,6,17,35.611454807205945,0.6246936274509804,45.0297619047619,1019.8809523809515,29.99649859943975,0
2192,4,0,0,38,0.0,0.0,1.0,38,1600,1200,400,0.75,20,12,8,389.5662027887953,0.43493658131816026,0.14936411661123117,0.21923286307570278,129779.6860651974,2511.555899908173,132291.24196510558,1804,1,302.39473684210526,32,6,17,35.34154275092939,0.626953125,45.265151515151516,1018.9393939393937,31.84185606060605,0
2193,4,1,0,39,0.02564102564102564,0.0,1.0,39,1150,900,250,0.782608695652174,14,9,5,372.19645332651663,0.43735942420152946,0.1467450199554201,0.19851235393975653,127646.9683025762,1702.8465276272052,129349.81483020341,1805,0,295.61538461538464,35,4,19,37.963983697934566,0.5985119047619047,47.366898148148145,1010.5324074074067,28.87235449735448,8
2194,4,0,1,38,0.0,0.02564102564102564,0.9743589743589743,39,1100,700,400,0.6363636363636364,15,7,8,370.7778990051173,0.43730319388214123,0.14521498652481024,0.1981869137032248,127734.70320001706,1672.240976508907,129406.94417652597,1806,1,296.61538461538464,35,4,20,37.90979696206397,0.5994047619047619,47.28009259259259,1010.8796296296289,28.88227513227511,0
2195,4,0,0,38,0.0,0.0,1.0,38,1100,900,200,0.8181818181818182,13,9,4,378.3930413351828,0.43493658131816026,0.15103379031658326,0.20234972966110645,127753.08956916093,2068.176020408156,129821.26558956908,1807,2,305.3421052631579,34,4,22,37.69847111006437,0.6017156862745099,47.26190476190476,1010.9523809523804,29.733893557422952,0
2196,4,2,0,40,0.05,0.0,1.0,40,1150,800,350,0.6956521739130435,15,8,7,361.3687023891969,0.4389022435897436,0.15189144736842142,0.19617158129699228,128355.55555555527,1277.9336734693543,129633.48922902462,1808,0,291.025,34,6,24,37.511992872807014,0.607843137254902,46.66666666666665,1013.3333333333311,29.803921568627384,0
2197,4,1,1,40,0.024390243902439025,0.024390243902439025,0.975609756097561,41,1350,800,550,0.5925925925925926,19,8,11,351.2236583426668,0.44148882113821136,0.16057675458725185,0.19261289931249773,128760.50407503829,844.7470582561368,129605.25113329443,1809,0,284.9024390243902,35,6,20,37.35567054396167,0.6098214285714285,46.26736111111109,1014.9305555555532,28.998015873015806,0
2198,4,0,0,40,0.0,0.0,1.0,40,900,700,200,0.7777777777777778,11,7,4,362.4897543112016,0.4403846153846154,0.16915698697641712,0.19842647244665154,128687.51594387722,1329.5812074829528,130017.09715136018,1810,1,293.0,34,6,21,37.14434471430248,0.6112132352941176,46.339285714285694,1014.6428571428545,29.842436974789837,0
2199,4,1,0,41,0.024390243902439025,0.0,1.0,41,750,300,450,0.4,12,3,9,354.6555818309649,0.44059959349593497,0.1720025958574447,0.19553749071609391,128972.5113627138,948.1642115087781,129920.67557422258,1811,0,286.8292682926829,36,5,22,37.05238359201774,0.6099537037037037,46.058558558558545,1015.7657657657637,28.21571571571566,0
2200,4,0,1,40,0.0,0.024390243902439025,0.975609756097561,41,900,600,300,0.6666666666666666,12,6,6,356.8605058195452,0.4397103658536585,0.17315099893767472,0.19718018028228718,129058.31665702826,1011.1632324892032,130069.47988951746,1812,1,287.8292682926829,36,5,22,36.90891795042299,0.6108217592592593,45.97409909909908,1016.1036036036005,28.225100100100015,0
2201,4,1,1,40,0.024390243902439025,0.024390243902439025,0.975609756097561,41,1300,800,500,0.6153846153846154,18,8,10,352.68644794864724,0.44377540650406505,0.1601259761091951,0.19651026113219255,129388.34372597079,926.9408509439941,130315.28457691478,1813,0,278.8780487804878,33,8,23,36.67891271179635,0.6205808080808081,45.64950980392157,1017.4019607843138,30.83036244800951,0
2202,4,0,1,39,0.0,0.025,0.975,40,900,700,200,0.7777777777777778,11,7,4,361.9540908396292,0.4443376068376068,0.08218163578425641,0.19084237782726654,127182.05959467098,1206.8133503401145,128388.8729450111,1814,1,282.65,34,6,19,38.69988984617807,0.5958946078431373,47.82738095238094,1008.6904761904743,29.667366946778657,8
2203,4,1,2,38,0.025,0.05,0.95,40,1300,900,400,0.6923076923076923,17,9,8,363.46707637319406,0.4454861111111111,0.0267681832576796,0.1957432413009249,128036.38100162543,1307.4018144130355,129343.78281603847,1815,0,283.55,38,2,17,37.78546043140152,0.596765350877193,46.98183760683761,1012.0726495726499,26.63349077822763,8
2204,4,1,2,37,0.02564102564102564,0.05128205128205128,0.9487179487179487,39,1150,800,350,0.6956521739130435,15,8,7,378.7528115798659,0.44090193432298697,0.05437584962265052,0.2051265227071152,128261.74554183791,1915.9906626163468,130177.73620445425,1816,0,291.61538461538464,35,4,19,37.167695003046916,0.6047619047619048,46.759259259259245,1012.9629629629611,28.94179894179889,0
2205,4,1,1,37,0.02631578947368421,0.02631578947368421,0.9736842105263158,38,1550,1100,450,0.7096774193548387,20,11,9,379.6123283431692,0.4393373636794689,0.06488343160058441,0.2063479304345829,128408.33875868046,2149.077690972213,130557.41644965268,1817,0,296.8157894736842,35,3,17,36.99576053442961,0.60625,46.61458333333333,1013.5416666666658,28.95833333333331,0
2206,4,1,0,38,0.02631578947368421,0.0,1.0,38,850,600,250,0.7058823529411765,11,6,5,381.83524113342105,0.4396781650071124,0.075630857966835,0.20801472091596804,128496.3348765431,2212.885802469123,130709.22067901223,1818,0,297.7894736842105,35,3,18,36.849315068493134,0.6071428571428572,46.52777777777777,1013.888888888888,28.968253968253943,0
2207,4,0,1,37,0.0,0.02631578947368421,0.9736842105263158,38,1000,600,400,0.6,14,6,8,383.64697204300995,0.43976706970128027,0.07445530759806851,0.20961858248035772,128613.70991941006,2268.4520747599336,130882.16199416999,1819,1,298.7894736842105,35,3,18,36.683211623307464,0.6083333333333334,46.41203703703703,1014.3518518518512,28.981481481481463,0
2208,4,0,1,36,0.0,0.02702702702702703,0.972972972972973,37,600,400,200,0.6666666666666666,8,4,4,386.24126692469423,0.43865740740740744,0.08865854470830414,0.21110723768218864,128627.12762188213,2536.220946712021,131163.34856859414,1820,2,307.18918918918916,34,3,18,36.60368501349606,0.6106004901960784,46.398809523809526,1014.4047619047623,29.83543417366948,0
2209,4,1,0,37,0.02702702702702703,0.0,1.0,37,1500,1200,300,0.8,18,12,6,380.3985178771308,0.44109734734734735,0.0897287442410506,0.20969707241769475,128966.1565500686,2411.706961591225,131377.86351165982,1821,0,301.0,35,2,20,36.4051580066849,0.611904761904762,46.06481481481482,1015.7407407407408,29.021164021164022,0
2210,4,0,0,37,0.0,0.0,1.0,37,1000,700,300,0.7,13,7,6,380.8455457914031,0.44109734734734735,0.09621104357946453,0.21025548433691438,129024.94454089516,2427.715084876555,131452.65962577172,1822,1,302.0,35,2,20,36.33373205741627,0.6125,46.00694444444445,1015.9722222222231,29.027777777777803,0
2211,4,0,0,37,0.0,0.0,1.0,37,750,400,350,0.5333333333333333,11,4,7,376.58185847420566,0.44141016016016016,0.09121852437725808,0.20852092566963892,129142.56071030517,2326.54910408093,131469.10981438612,1823,2,303.0,35,2,20,36.32192742731345,0.6136904761904762,45.8912037037037,1016.4351851851849,29.04100529100528,0
2212,4,0,1,36,0.0,0.02702702702702703,0.972972972972973,37,1400,1000,400,0.7142857142857143,18,10,8,377.6492824618541,0.44059684684684686,0.040508096984603004,0.20378150978987272,128115.23604948986,2321.883975265772,130437.12002475563,1824,3,304.0,35,2,19,37.3457804580618,0.6032738095238095,46.90393518518518,1012.3842592592591,28.925264550264547,8
2213,4,1,0,37,0.02702702702702703,0.0,1.0,37,1500,1300,200,0.8666666666666667,17,13,4,373.58413499488927,0.4406594094094094,0.06575497273171704,0.2031095354627388,128415.88010204092,2194.8304464854455,130610.71054852636,1825,0,304.8918918918919,34,3,16,37.14078772218307,0.6084558823529411,46.60714285714286,1013.5714285714294,29.810924369747923,0
2214,4,0,0,37,0.0,0.0,1.0,37,900,600,300,0.6666666666666666,12,6,6,370.19538473833126,0.4404091591591592,0.06528120230127987,0.20172451003303699,128506.393494898,2114.4947562358357,130620.88825113385,1826,1,305.8918918918919,34,3,16,37.13406520292749,0.609375,46.517857142857146,1013.9285714285718,29.821428571428584,0
2215,4,0,0,37,0.0,0.0,1.0,37,1400,1000,400,0.7142857142857143,18,10,8,368.84761322655993,0.4395332832832833,0.05734408032988991,0.20252180283212362,128808.33510487543,2102.129393424051,130910.46449829948,1827,2,306.8918918918919,34,3,18,36.85963214886048,0.6124387254901961,46.2202380952381,1015.1190476190487,29.856442577030844,0
2216,4,1,0,38,0.02631578947368421,0.0,1.0,38,1200,1000,200,0.8333333333333334,14,10,4,359.7776470898816,0.4412932669511617,0.06618202303755294,0.19921609689428363,129142.56071030517,1692.5213263031537,130835.08203660832,1828,0,299.7894736842105,35,3,20,36.74893722007136,0.6136904761904762,45.8912037037037,1016.4351851851849,29.04100529100528,0
2217,4,0,0,38,0.0,0.0,1.0,38,1150,1000,150,0.8695652173913043,13,10,3,359.404972629017,0.44173779042200095,0.06798245614035081,0.1999190160248908,129322.44897959188,1695.8396430846026,131018.28862267648,1829,1,300.7894736842105,34,4,20,36.57513069600498,0.6176470588235294,45.714285714285715,1017.1428571428575,29.91596638655463,0
2218,4,0,0,38,0.0,0.0,1.0,38,850,700,150,0.8235294117647058,10,7,3,360.86343211650336,0.44107100521574205,0.07118841329367642,0.2011937217416669,129413.2812499999,1740.1041666666524,131153.38541666654,1830,2,301.7894736842105,34,4,20,36.44553644553644,0.6185661764705883,45.62499999999999,1017.4999999999992,29.926470588235272,0
2219,4,0,1,37,0.0,0.02631578947368421,0.9736842105263158,38,1500,1000,500,0.6666666666666666,20,10,10,361.86426995671013,0.440493124703651,0.07710107823346957,0.20253031653598047,129564.73922902481,1776.9699546485085,131341.70918367332,1831,3,302.7894736842105,34,4,18,36.26588322419706,0.6200980392156863,45.47619047619047,1018.095238095237,29.943977591036383,0
2220,4,1,0,38,0.02631578947368421,0.0,1.0,38,850,600,250,0.7058823529411765,11,6,5,359.3996422228911,0.4414562588904694,0.07965486480666906,0.20161730748962828,129655.65653344666,1719.6393140589519,131375.29584750562,1832,0,303.0263157894737,34,4,19,36.23611922852134,0.6210171568627452,45.38690476190476,1018.4523809523805,29.954481792717075,0
2221,4,0,0,38,0.0,0.0,1.0,38,750,400,350,0.5333333333333333,11,4,7,359.60531613826834,0.4415896159317212,0.07762496693996246,0.2020448253575287,129716.28578514732,1729.3331916099703,131445.61897675728,1833,1,304.0263157894737,34,4,19,36.16921818394297,0.6216299019607843,45.32738095238095,1018.6904761904757,29.961484593837522,0
2222,4,0,0,38,0.0,0.0,1.0,38,850,300,550,0.35294117647058826,14,3,11,360.44032745717084,0.4417970602181129,0.07925483178679249,0.20282766355725992,129776.9292091836,1755.367772108835,131532.29698129243,1834,2,305.0263157894737,34,4,19,36.08628344432761,0.6222426470588236,45.26785714285714,1018.9285714285708,29.968487394957965,0
2223,4,0,0,38,0.0,0.0,1.0,38,1400,1000,400,0.7142857142857143,18,10,8,356.64399667185694,0.44135253674727354,0.08165178214718138,0.20131460405412713,129898.25857426295,1665.4868197278797,131563.74539399083,1835,3,306.0263157894737,34,4,19,36.059694811008605,0.623468137254902,45.14880952380952,1019.4047619047611,29.982492997198857,0
2224,4,0,0,38,0.0,0.0,1.0,38,1300,1000,300,0.7692307692307693,16,10,6,359.3739766207328,0.4403597676623992,0.08254133056465163,0.20348690401254582,130019.64462868478,1745.1353458049887,131764.77997448976,1836,4,307.0263157894737,34,4,19,35.86679506633984,0.6246936274509804,45.029761904761905,1019.8809523809522,29.99649859943977,0
2225,4,0,0,38,0.0,0.0,1.0,38,450,300,150,0.6666666666666666,6,3,3,359.19678328847897,0.4403745851114272,0.08389232886136955,0.20354484386347138,130049.99999999997,1742.708333333333,131792.7083333333,1837,5,308.0263157894737,34,4,20,35.84048202614379,0.625,45.0,1019.9999999999998,29.999999999999993,0
2226,4,1,0,39,0.02564102564102564,0.0,1.0,39,1200,800,400,0.6666666666666666,16,8,8,350.51767142505605,0.4414642375168691,0.08249746552680737,0.20077997960213936,130469.43486636224,1346.368500300061,131815.8033666623,1838,0,301.1025641025641,35,4,21,35.636517691930074,0.6270833333333333,44.58912037037037,1021.643518518518,29.1898148148148,0
2227,4,0,1,38,0.0,0.02564102564102564,0.9743589743589743,39,750,500,250,0.6666666666666666,10,5,5,351.33385496710713,0.44160481331533963,0.08301314723333131,0.20155468521797193,130528.56445312496,1371.8207465277767,131900.38519965272,1839,1,302.1025641025641,35,4,15,35.555767923887196,0.6276785714285714,44.53125,1021.8749999999997,29.196428571428562,0
2228,4,0,0,38,0.0,0.0,1.0,38,1200,800,400,0.6666666666666666,16,8,8,358.33918177609263,0.4398115220483641,0.07759799802501255,0.20513065502472663,130444.94224773246,1748.7067743764233,132193.64902210888,1840,8,311.0263157894737,34,4,21,35.46158178922427,0.6289828431372548,44.61309523809524,1021.5476190476193,30.04551820728292,0
2229,4,1,0,39,0.02564102564102564,0.0,1.0,39,1500,1200,300,0.8,18,12,6,379.53836474113996,0.44121120107962214,0.11948405913387927,0.21064248458031692,129233.48263251186,2281.648959706302,131515.13159221815,1841,0,304.02564102564105,32,7,19,36.15396953516288,0.6214192708333333,45.80176767676767,1016.7929292929283,31.77477904040401,8
2230,4,1,1,39,0.025,0.025,0.975,40,1050,700,350,0.6666666666666666,14,7,7,371.5033443069103,0.44246794871794876,0.11411620294599034,0.20824637006561658,129625.34722222219,1631.2499999999966,131256.5972222222,1842,0,297.4,34,6,17,35.95881069285325,0.6207107843137255,45.416666666666664,1018.333333333333,29.950980392156854,0
2231,4,1,0,40,0.025,0.0,1.0,40,1200,900,300,0.75,15,9,6,370.0523008524153,0.440892094017094,0.11910391126678377,0.2092077859274543,129958.94451530589,1618.321286848047,131577.26580215394,1843,0,298.125,34,6,18,35.656256080949596,0.6240808823529411,45.0892857142857,1019.6428571428553,29.989495798319272,0
2232,4,1,1,40,0.024390243902439025,0.024390243902439025,0.975609756097561,41,1200,1100,100,0.9166666666666666,13,11,2,363.0154102457312,0.44283536585365857,0.12005973120955682,0.20683436165163713,130262.5868055553,1257.4652777777453,131520.05208333305,1844,0,291.8292682926829,35,6,19,35.527210884353714,0.625,44.79166666666665,1020.8333333333313,29.16666666666661,0
2233,4,0,0,40,0.0,0.0,1.0,40,1200,1000,200,0.8333333333333334,14,10,4,367.9569855888303,0.441653311965812,0.12502267059623695,0.20996872748154305,130321.66950660128,1590.5537337105384,131912.2232403118,1845,1,298.5,35,5,19,35.3410980125444,0.6255952380952381,44.73379629629628,1021.064814814813,29.17328042328037,0
2234,4,0,1,39,0.0,0.025,0.975,40,800,600,200,0.75,10,6,4,370.192888594446,0.4413060897435897,0.12055757026291958,0.21156619488065992,130380.76560356637,1653.2064471879116,132033.97205075427,1846,2,299.5,35,5,19,35.22401027500755,0.6261904761904762,44.67592592592592,1021.296296296295,29.179894179894145,0
2235,4,0,0,39,0.0,0.0,1.0,39,1150,700,450,0.6086956521739131,16,7,9,382.60496302454334,0.4387370670265407,0.12372243141473893,0.21885003885003879,130414.54081632651,2179.450113378679,132593.99092970518,1847,3,307.71794871794873,34,5,20,34.87276612276612,0.6286764705882353,44.64285714285714,1021.4285714285712,30.042016806722682,0
2236,4,1,0,40,0.025,0.0,1.0,40,750,400,350,0.5333333333333333,11,4,7,373.7747893861405,0.4399973290598291,0.13029531568228148,0.215909907751288,130794.81336805543,1777.5607638888807,132572.37413194432,1848,0,301.0,35,5,16,34.712321792260695,0.6303571428571428,44.27083333333333,1022.9166666666656,29.226190476190446,0
2237,4,0,2,38,0.0,0.05,0.95,40,1200,1000,200,0.8333333333333334,14,10,4,374.8590336899558,0.4394898504273504,0.12912755852086466,0.2173690776996901,130942.84664619752,1817.02179248112,132759.86843867865,1849,1,302.0,35,5,16,34.534495269327905,0.6318452380952381,44.1261574074074,1023.4953703703688,29.242724867724824,0
2238,4,0,0,38,0.0,0.0,1.0,38,800,400,400,0.5,12,4,8,392.39935873453004,0.43692211948790893,0.13021648079931358,0.22611742053045025,130700.81218762013,2657.3829777008796,133358.195165321,1850,2,313.57894736842104,33,5,16,34.3315556088207,0.6338383838383839,44.36274509803921,1022.5490196078431,30.986333927510398,0
2239,4,0,2,36,0.0,0.05263157894736842,0.9473684210526316,38,1000,500,500,0.5,15,5,10,395.75196719418295,0.43578117591275484,0.1393211106347565,0.22879068020339594,130826.15460399838,2754.941608996529,133581.09621299492,1851,3,314.57894736842104,33,5,16,34.118451525315436,0.6351010101010102,44.24019607843137,1023.0392156862739,31.00118835412951,0
2240,4,0,0,36,0.0,0.0,1.0,36,1000,600,400,0.6,14,6,8,410.149359970825,0.433316798941799,0.14188997890743305,0.23549834136144898,130561.83073255759,3509.9702623155486,134071.80099487313,1852,4,332.5833333333333,31,5,17,34.01932836454748,0.6374327956989247,44.49869791666667,1022.005208333334,32.96790994623658,0
2241,4,0,1,35,0.0,0.027777777777777776,0.9722222222222222,36,800,300,500,0.375,13,3,10,406.67567104910745,0.4331183862433863,0.13518381293483173,0.2340336111218639,130649.5530589991,3426.3989325068897,134075.95199150598,1853,5,333.5833333333333,32,4,18,34.01877238483388,0.6357421875,44.41287878787879,1022.348484848485,31.948390151515156,0
2242,4,0,0,35,0.0,0.0,1.0,35,1250,900,350,0.72,16,9,7,418.6440488829384,0.4323529411764706,0.1407175605851101,0.24099655951824303,130661.65500217021,3940.1448567708426,134601.79985894106,1854,6,343.1142857142857,31,4,18,33.70054338597385,0.6384408602150538,44.40104166666667,1022.3958333333339,32.98051075268819,0
2243,4,0,0,35,0.0,0.0,1.0,35,1050,500,550,0.47619047619047616,16,5,11,418.71293972134293,0.43214285714285716,0.14018698388446293,0.24145164673799044,130728.22570800791,3947.519938151056,134675.74564615896,1855,7,344.1142857142857,31,4,18,33.63095238095239,0.6391129032258065,44.33593750000001,1022.6562500000008,32.988911290322605,0
2244,4,0,0,35,0.0,0.0,1.0,35,1000,600,400,0.6,14,6,8,417.4088411752463,0.43203781512605044,0.1426498663612068,0.24132312473244388,130828.1135559083,3921.762254503053,134749.87581041135,1856,8,345.1142857142857,31,4,19,33.562560985957326,0.6401209677419355,44.23828125000001,1023.0468750000008,33.00151209677422,0
2245,4,0,0,35,0.0,0.0,1.0,35,1300,900,400,0.6923076923076923,17,9,8,416.01046300073153,0.4317577030812325,0.13929480189022203,0.2411388081995392,130928.03955078134,3893.4868706597367,134821.52642144109,1857,9,346.1142857142857,31,4,19,33.49660729431723,0.6411290322580645,44.14062500000001,1023.4375000000007,33.01411290322583,0
2246,4,0,0,35,0.0,0.0,1.0,35,550,500,50,0.9090909090909091,6,5,1,412.59616970714785,0.4309873949579832,0.13923029400007247,0.2395739354680649,130994.67807345925,3809.5804850260465,134804.2585584853,1858,10,347.1142857142857,31,4,19,33.51617484948697,0.6418010752688172,44.075520833333336,1023.6979166666671,33.02251344086023,0
2247,4,0,0,35,0.0,0.0,1.0,35,550,400,150,0.7272727272727273,7,4,3,414.35379046197966,0.43032212885154064,0.14587594223957856,0.24122076698619327,131094.66764662004,3863.914489746098,134958.58213636614,1859,11,348.1142857142857,31,4,20,33.369490358126725,0.6428091397849462,43.977864583333336,1024.088541666667,33.03511424731184,0
2248,4,0,0,35,0.0,0.0,1.0,35,1050,900,150,0.8571428571428571,12,9,3,416.2416897991781,0.4300070028011205,0.14932984635501811,0.24253015792298777,131128.0059814453,3916.188557942707,135044.19453938803,1860,12,349.1142857142857,31,4,20,33.28724891939995,0.6431451612903225,43.9453125,1024.21875,33.03931451612903,0
2249,4,0,0,35,0.0,0.0,1.0,35,1000,600,400,0.6,14,6,8,419.3784319202283,0.4291666666666667,0.1531457614812124,0.24520863738575024,131261.40170627178,4009.6401638454945,135271.04187011727,1861,13,350.1142857142857,31,4,20,33.07126217704362,0.644489247311828,43.81510416666667,1024.739583333334,33.05611559139787,0
2250,4,0,0,35,0.0,0.0,1.0,35,950,700,250,0.7368421052631579,12,7,5,417.1514360671939,0.4282913165266107,0.15145441944969917,0.24455142220480314,131362.56946251015,3959.633853562599,135322.20331607276,1862,14,351.1142857142857,30,5,20,33.02549058170535,0.6482638888888889,43.71639784946237,1025.1344086021509,34.17114695340503,0
2251,4,1,0,36,0.027777777777777776,0.0,1.0,36,1200,800,400,0.6666666666666666,16,8,8,401.7667023541117,0.42870370370370375,0.14520171878730004,0.23804819181914794,131768.13755526743,3388.0100201845707,135156.147575452,1863,0,342.3333333333333,33,3,17,33.00857404312883,0.6445707070707071,43.32107843137256,1026.7156862745114,31.112596553773074,0
2252,4,1,0,37,0.02702702702702703,0.0,1.0,37,1050,700,350,0.6666666666666666,14,7,7,396.2076573146262,0.42986736736736736,0.1481998142106924,0.23791732917690686,132275.51197562378,3081.7141439909515,135357.22611961473,1864,0,334.05405405405406,34,3,19,32.63800486054854,0.6473651960784313,42.82738095238096,1028.6904761904777,30.255602240896405,0
2253,4,0,0,37,0.0,0.0,1.0,37,950,500,450,0.5263157894736842,14,5,9,393.7488548582236,0.4294294294294294,0.14533242023696724,0.23682472877798383,132336.75063775515,3021.488803854881,135358.23944161003,1865,1,335.05405405405406,34,3,19,32.63937097458445,0.6479779411764706,42.767857142857146,1028.9285714285718,30.262605042016816,0
2254,4,0,0,37,0.0,0.0,1.0,37,600,400,200,0.6666666666666666,8,4,4,393.7795357298667,0.42864739739739743,0.1487348486857809,0.2374327496501383,132430.49178655224,3029.7118591084845,135460.20364566072,1866,2,336.05405405405406,32,5,19,32.54390538109257,0.6536458333333333,42.67676767676767,1029.2929292929282,32.165404040404006,0
2255,4,0,1,36,0.0,0.02702702702702703,0.972972972972973,37,900,600,300,0.6666666666666666,12,6,6,392.48820601109605,0.4280217717717718,0.14922020218084953,0.23767826996529412,132592.9931416438,3008.2372015610727,135601.23034320486,1867,3,337.05405405405406,32,5,20,32.413111438028686,0.6552734375,42.5189393939394,1029.924242424243,32.18513257575759,0
2256,4,0,0,36,0.0,0.0,1.0,36,950,700,250,0.7368421052631579,12,7,5,392.4898933488553,0.4267030423280423,0.1428586019528535,0.23809108102849907,132658.02158261917,3213.3865485664764,135871.40813118566,1868,4,334.6666666666667,32,4,17,32.347458838909986,0.6559244791666667,42.45580808080808,1030.1767676767681,32.193023989899004,0
2257,4,1,1,36,0.02702702702702703,0.02702702702702703,0.972972972972973,37,1350,1100,250,0.8148148148148148,16,11,5,397.68531008366085,0.42817817817817816,0.20327424198391952,0.2340805939100027,131516.6116998268,3076.343310600658,134592.95501042748,1869,0,326.5945945945946,33,4,15,33.368180007964945,0.6420454545454546,43.566176470588225,1025.7352941176457,31.08288770053472,8
2258,4,0,0,36,0.0,0.0,1.0,36,1100,800,300,0.7272727272727273,14,8,6,369.3938680647297,0.42624007936507935,0.15219448333074115,0.20997640829249767,130171.45691609987,2419.8511757644364,132591.3080918643,1870,1,336.5,34,2,19,35.4570111992534,0.6262254901960784,44.88095238095239,1020.4761904761912,30.014005602240918,8
2259,4,3,2,37,0.07692307692307693,0.05128205128205128,0.9487179487179487,39,1300,900,400,0.6923076923076923,17,9,8,345.52774721109654,0.4338731443994602,0.1515603041026765,0.19996593064713541,130866.81909950504,1243.655325381926,132110.47442488695,1871,0,311.53846153846155,36,3,15,35.36186624110351,0.6290509259259259,44.200450450450454,1023.1981981981993,28.422172172172203,0
2260,4,0,0,37,0.0,0.0,1.0,37,1300,1100,200,0.8461538461538461,15,11,4,363.25152523782396,0.4274587087087087,0.15729679376628658,0.20908874656450616,130657.85147392288,2092.332766439911,132750.18424036278,1872,1,329.3783783783784,34,3,15,35.12022589659992,0.6311274509803921,44.404761904761905,1022.3809523809522,30.070028011204474,0
2261,4,0,0,37,0.0,0.0,1.0,37,950,400,550,0.42105263157894735,15,4,11,362.66007051728866,0.42705205205205204,0.16076551411746953,0.20940694394385387,130779.59183673479,2085.707199546498,132865.2990362813,1873,2,330.3783783783784,34,3,17,35.0119781967722,0.6323529411764706,44.28571428571429,1022.8571428571436,30.0840336134454,0
2262,4,0,0,37,0.0,0.0,1.0,37,1400,1100,300,0.7857142857142857,17,11,6,362.18930019938523,0.4270833333333333,0.16502255308225422,0.21018386948578516,130972.46334876555,2087.364969135816,133059.82831790138,1874,3,331.3783783783784,35,2,17,34.82869742198099,0.6321428571428571,44.09722222222223,1023.6111111111121,29.246031746031775,0
2263,4,0,0,37,0.0,0.0,1.0,37,900,500,400,0.5555555555555556,13,5,8,360.80527388010194,0.42623873873873874,0.16421484775915207,0.21002664890073294,131090.96364883397,2059.662208504801,133150.62585733877,1875,4,332.3783783783784,35,2,17,34.7441983122363,0.6333333333333333,43.98148148148148,1024.0740740740737,29.25925925925925,0
2264,4,0,0,37,0.0,0.0,1.0,37,1000,600,400,0.6,14,6,8,360.43700789616844,0.4256443943943944,0.16771227343914563,0.21062368520823624,131239.16437596452,2060.690345293214,133299.85472125773,1876,5,333.3783783783784,35,2,17,34.60373602168756,0.6348214285714286,43.83680555555556,1024.6527777777778,29.275793650793652,0
2265,4,0,0,37,0.0,0.0,1.0,37,750,500,250,0.6666666666666666,10,5,5,375.3203108590634,0.42486236236236236,0.04090612351481959,0.20553255118472522,128703.50346020766,2302.300705991828,131005.8041661995,1877,6,334.3783783783784,33,4,16,36.802536231884055,0.6136363636363636,46.32352941176471,1014.7058823529416,30.74866310160429,8
2266,4,1,0,38,0.02631578947368421,0.0,1.0,38,1050,800,250,0.7619047619047619,13,8,5,365.84488204224044,0.4274834044570887,0.0364080812315426,0.20241203875532154,129110.63102324285,1846.8927154195226,130957.52373866238,1878,0,326.55263157894734,34,4,17,36.6273281012065,0.6155024509803921,45.92261904761906,1016.3095238095257,29.891456582633108,0
2267,4,0,0,38,0.0,0.0,1.0,38,1300,1100,200,0.8461538461538461,15,11,4,357.32184797150757,0.42751303935514456,0.0830072830980273,0.18512753747572525,126468.25034493944,1437.973784595394,127906.22412953484,1879,1,327.55263157894734,36,2,17,39.55067920585163,0.5844907407407407,48.53603603603603,1005.8558558558551,27.94044044044042,8
2268,4,2,0,40,0.05,0.0,1.0,40,800,500,300,0.625,11,5,6,349.97334174800886,0.431784188034188,0.0997668503603224,0.18387240828141457,127038.15563591183,891.9935714807261,127930.14920739255,1880,0,312.125,38,2,19,39.14971032923555,0.5866228070175439,47.97008547008546,1008.1196581196563,26.529464687359376,0
2269,4,0,0,40,0.0,0.0,1.0,40,900,600,300,0.6666666666666666,12,6,6,348.5175904553602,0.4315838675213675,0.09633593481005409,0.18348240275755603,127121.19187510716,860.8285404478745,127982.02041555505,1881,1,313.125,35,5,19,39.10117544665059,0.5931547619047619,47.88773148148148,1008.449074074074,28.812830687830687,0
2270,4,0,0,40,0.0,0.0,1.0,40,850,500,350,0.5882352941176471,12,5,7,348.5917310886796,0.43175747863247865,0.09268754301445292,0.18418319464430952,127267.13204089495,872.85397376542,128139.98601466038,1882,2,314.125,35,5,20,38.94958706125256,0.5946428571428571,47.74305555555555,1009.0277777777769,28.829365079365054,0
2271,4,1,1,40,0.024390243902439025,0.024390243902439025,0.975609756097561,41,1000,500,500,0.5,15,5,10,349.82273982352626,0.4345020325203252,0.11735902786835362,0.18690529241999837,127717.3119065011,735.6839948056174,128452.99590130671,1883,0,307.4390243902439,36,5,19,38.45718211527035,0.5972222222222222,47.2972972972973,1010.8108108108108,28.07807807807808,0
2272,4,1,1,40,0.024390243902439025,0.024390243902439025,0.975609756097561,41,1100,800,300,0.7272727272727273,14,8,6,343.9923289431753,0.43948170731707314,0.11044823112375335,0.18509671065169914,128002.04554216388,606.344351107875,128608.38989327176,1884,0,296.0243902439024,36,5,20,38.31330217375178,0.6001157407407407,47.01576576576577,1011.9369369369376,28.109359359359377,0
2273,4,0,1,39,0.0,0.025,0.975,40,1400,1100,300,0.7857142857142857,17,11,6,353.5159666524435,0.4377938034188034,0.10933029908972713,0.19010753731169855,127978.05574792232,1048.4572176054044,129026.51296552773,1885,1,304.325,37,3,20,38.096915185666816,0.597972972972973,47.03947368421052,1011.8421052631569,27.347083926031267,0
2274,4,1,0,40,0.025,0.0,1.0,40,700,500,200,0.7142857142857143,9,5,4,367.3980090082908,0.440491452991453,0.09062499999999996,0.19409706136287067,127262.39753266788,1362.9366977640675,128625.33423043194,1886,0,304.775,36,4,20,38.4800502232143,0.5925925925925926,47.74774774774775,1009.0090090090096,28.028028028028043,8
2275,4,1,1,40,0.024390243902439025,0.024390243902439025,0.975609756097561,41,900,700,200,0.7777777777777778,11,7,4,369.46284554761775,0.44275914634146346,0.10637819299967965,0.19718234206209542,127673.13169677192,1234.0957073330053,128907.22740410492,1887,0,298.3170731707317,37,4,15,38.00619778669847,0.5948761261261262,47.341008771929815,1010.6359649122793,27.31448553816971,0
2276,4,0,0,40,0.0,0.0,1.0,40,1000,800,200,0.8,12,8,4,374.930796626345,0.4382077991452991,0.11887743732590539,0.20017869718747464,127688.85598013562,1574.896898587784,129263.7528787234,1888,1,306.7,36,4,16,37.85190343546889,0.5969328703703703,47.325450450450454,1010.6981981981988,28.074949949949968,0
2277,4,0,0,40,0.0,0.0,1.0,40,1250,800,450,0.64,17,8,9,372.20170349973864,0.4375801282051282,0.08955909535718165,0.19594385043429258,127119.65610812916,1462.8305103493076,128582.48661847846,1889,2,307.7,37,3,15,38.5056494871516,0.5892454954954955,47.8892543859649,1008.4429824561382,27.25521574205779,8
2278,4,0,0,40,0.0,0.0,1.0,40,1050,800,250,0.7619047619047619,13,8,5,375.0954631379964,0.43744658119658114,0.08613043478260884,0.19787145991224564,127202.60080024613,1542.6236919051917,128745.22449215132,1890,3,308.7,37,3,15,38.34737318840581,0.5900900900900901,47.807017543859644,1008.7719298245606,27.264106211474612,0
2279,4,2,1,41,0.047619047619047616,0.023809523809523808,0.9761904761904762,42,1150,700,450,0.6086956521739131,16,7,9,369.46774518789357,0.44265389082462253,0.12756747747482766,0.1987270031425913,127986.376953125,1057.3676215277785,129043.74457465278,1891,0,294.95238095238096,39,3,14,37.68487063345001,0.594551282051282,47.03125,1011.875,25.94551282051282,0
2280,4,0,0,41,0.0,0.0,1.0,41,1150,600,550,0.5217391304347826,17,6,11,376.9747927033879,0.4412855691056911,0.13878646176664455,0.2028809793458229,128009.35057345283,1451.2596793045147,129460.61025275734,1892,1,302.6585365853659,38,3,15,37.47140695382881,0.5964912280701755,47.00854700854699,1011.9658119658095,26.630679262258145,0
2281,4,1,1,41,0.023809523809523808,0.023809523809523808,0.9761904761904762,42,1100,700,400,0.6363636363636364,15,7,8,369.4966985662961,0.4435733643050716,0.13684099329592248,0.20050023437763595,128338.88942992064,1084.3018668320449,129423.19129675269,1893,0,296.42857142857144,37,5,17,37.3231387295747,0.6016328828828829,46.68311403508771,1013.2675438596483,27.385609293504007,0
2282,4,0,0,41,0.0,0.0,1.0,41,1000,800,200,0.8,12,8,4,379.3796677486595,0.4424288617886179,0.14500226362717106,0.20574315073747373,128315.61872260773,1536.0673595893188,129851.68608219705,1894,1,304.2926829268293,36,5,18,37.09662480085955,0.6032986111111112,46.70608108108108,1013.1756756756756,28.143768768768766,0
2283,4,0,1,40,0.0,0.024390243902439025,0.975609756097561,41,1350,900,450,0.6666666666666666,18,9,9,336.23126793495567,0.44189532520325203,0.07281870756851827,0.1792001812620369,127617.73003472229,431.42782774328873,128049.15786246558,1895,2,305.2926829268293,37,4,15,38.902491408934694,0.5943130630630631,47.395833333333336,1010.4166666666673,27.308558558558577,8
2284,4,1,0,41,0.024390243902439025,0.0,1.0,41,1150,700,450,0.6086956521739131,16,7,9,336.5050626254449,0.4407520325203252,0.09831177002426883,0.18070987821783202,127922.58795975681,409.3196945213886,128331.9076542782,1896,0,306.219512195122,37,4,17,38.58389334489487,0.5974099099099099,47.094298245614034,1011.6228070175436,27.341156946420096,0
2285,4,2,2,41,0.046511627906976744,0.046511627906976744,0.9534883720930233,43,1450,1300,150,0.896551724137931,16,13,3,325.3355144234841,0.44229881875230714,0.11467674124599392,0.177476132351018,128550.50131492446,-235.39893818033318,128315.10237674412,1897,0,292.93023255813955,38,5,15,38.22626949009692,0.6019736842105263,46.47435897435898,1014.1025641025647,26.68690958164644,0
2286,4,2,0,43,0.046511627906976744,0.0,1.0,43,1250,1000,250,0.8,15,10,5,320.45822810815645,0.4425064599483204,0.14609696718242904,0.1768777079082541,129016.12548828125,-331.1442057291663,128684.98128255208,1898,0,293.48837209302326,39,4,17,37.87648672203426,0.6049679487179487,46.015625,1015.9375,26.049679487179485,0
2287,4,1,1,43,0.022727272727272728,0.022727272727272728,0.9772727272727273,44,1850,1400,450,0.7567567567567568,23,14,9,374.89378680608854,0.44315979563072583,0.21703265739323263,0.19709923750657932,127065.7565646699,864.0001085069202,127929.75667317682,1899,0,287.79545454545456,39,5,17,38.49323707683302,0.5852029914529915,47.94270833333332,1008.2291666666647,25.852029914529865,8
2288,4,1,0,44,0.022727272727272728,0.0,1.0,44,1200,700,500,0.5833333333333334,17,7,10,375.58319714604625,0.44443710359408034,0.22530945616883158,0.19842131169979774,127262.39753266763,759.5317663789012,128021.92929904653,1900,0,286.6363636363636,36,8,19,38.27357700892858,0.5925925925925926,47.74774774774774,1009.0090090090075,28.028028028027986,0
2289,4,3,1,46,0.06382978723404255,0.02127659574468085,0.9787234042553191,47,1350,900,450,0.6666666666666666,18,9,9,369.2882031023473,0.44883209990749307,0.2657350814732009,0.20044130304780225,128349.69142500426,91.79240111529612,128441.48382611955,1901,0,269.27659574468083,35,12,16,37.317366266895114,0.6056547619047619,46.6724537037037,1013.310185185185,28.951719576719572,0
2290,4,1,0,47,0.02127659574468085,0.0,1.0,47,1700,1100,600,0.6470588235294118,23,11,12,367.0815662670192,0.44823465926611167,0.27011066037475473,0.20072332453324257,128644.60699445991,44.612765466305234,128689.21975992621,1902,0,270.17021276595744,37,10,15,37.07171422395158,0.6047297297297297,46.381578947368425,1014.473684210527,27.418207681365594,0
2291,4,1,0,48,0.020833333333333332,0.0,1.0,48,1450,1100,350,0.7586206896551724,18,11,7,362.06117011843946,0.44884013002364065,0.2752541431744402,0.20010802915044668,129069.04432508704,-253.82215711803167,128815.22216796901,1903,0,265.5208333333333,39,9,16,36.765867930975574,0.6055021367521367,45.96354166666668,1016.1458333333353,26.05502136752142,0
2292,4,1,1,48,0.02040816326530612,0.02040816326530612,0.9795918367346939,49,1300,900,400,0.6923076923076923,17,9,8,352.306016255072,0.44922760770975056,0.2867827298968715,0.19689685423815945,129508.13140822161,-674.4977796653947,128833.63362855621,1904,0,261.0816326530612,37,12,15,36.566730403246076,0.6134572072072072,45.53179824561403,1017.8728070175426,27.51007586533899,0
2293,4,0,1,47,0.0,0.020833333333333332,0.9791666666666666,48,1500,1000,500,0.6666666666666666,20,10,10,308.4926280245524,0.4482214095744681,0.17678875360041912,0.16431427425742917,127592.67132779055,-1715.0210811310817,125877.65024665947,1905,1,267.4375,41,7,17,39.628747708824314,0.5873983739837398,47.42063492063493,1010.3174603174618,24.641889276035656,8
2294,4,0,1,46,0.0,0.02127659574468085,0.9787234042553191,47,1650,1200,450,0.7272727272727273,21,12,9,314.37615680579927,0.44684705519580636,0.18058642955435533,0.16202463466145062,126253.12500000017,-1275.8920697908643,124977.23293020931,1906,2,274.06382978723406,39,8,18,40.85129906025428,0.5769230769230769,48.75000000000001,1005.0000000000014,25.769230769230806,8
2295,4,2,0,48,0.041666666666666664,0.0,1.0,48,1050,700,350,0.6666666666666666,14,7,7,309.73340752668315,0.4489601802600473,0.19669401465129233,0.16125525326697027,126667.22888518823,-1753.3855150856748,124913.84337010256,1907,0,269.2708333333333,41,7,15,40.54348986564174,0.5779979674796748,48.338293650793645,1006.6468253968245,24.552361595044502,0
2296,4,1,0,49,0.02040816326530612,0.0,1.0,49,1550,1100,450,0.7096774193548387,20,11,9,305.2359516410322,0.4505739795918367,0.21190119804530494,0.16029124709347103,127018.74441327159,-2045.8625345531923,124972.8818787184,1908,0,264.7551020408163,42,7,18,40.29706975551926,0.580109126984127,47.98934108527133,1008.042635658916,24.001015134736093,0
2297,4,3,0,52,0.057692307692307696,0.0,1.0,52,1050,700,350,0.6666666666666666,14,7,7,293.8277725194468,0.45435834590246355,0.2323265777827892,0.1569189806664521,127699.60562414266,-2895.6407392847927,124803.96488485787,1909,0,250.42307692307693,44,8,14,39.89022230365215,0.584280303030303,47.31481481481482,1010.7407407407406,22.97138047138047,0
2298,4,1,1,52,0.018867924528301886,0.018867924528301886,0.9811320754716981,53,1100,800,300,0.7272727272727273,14,8,6,294.98022159950466,0.45484095307208516,0.24340686526988087,0.15883441040632607,128029.91694398501,-3046.7413456994227,124983.17559828558,1910,0,246.67924528301887,45,8,15,39.52487768131511,0.5863425925925926,46.988224637681164,1012.0471014492756,22.48993558776168,0
2299,4,0,0,52,0.0,0.0,1.0,52,1300,700,600,0.5384615384615384,19,7,12,298.2392810726194,0.45307786576168924,0.23727130000068852,0.16040592242957327,127984.08557977597,-2766.0236655901945,125218.06191418578,1911,1,252.3653846153846,45,7,15,39.48906021543879,0.5858796296296296,47.03351449275363,1011.865942028987,22.48590982286638,0
2300,4,0,0,52,0.0,0.0,1.0,52,1450,1000,450,0.6896551724137931,19,10,9,299.1877471358247,0.45296788587229764,0.23220775287704387,0.16137655704584847,128098.67937408118,-2734.8889413988577,125363.79043268233,1912,2,253.3653846153846,45,7,15,39.348455022667615,0.587037037037037,46.92028985507247,1012.318840579711,22.49597423510469,0
2301,4,0,3,49,0.0,0.057692307692307696,0.9423076923076923,52,1500,700,800,0.4666666666666667,23,7,16,301.0477297658456,0.4530307315233786,0.23183191282770466,0.1628581421267436,128216.45184981928,-2680.129241028226,125536.32260879106,1913,3,254.3653846153846,43,9,15,39.18156848994854,0.590843023255814,46.80397727272727,1012.7840909090914,23.553118393234683,0
2302,4,1,0,50,0.02,0.0,1.0,50,2150,1400,750,0.6511627906976745,29,14,15,306.73340394151376,0.4521853741496598,0.2242073054121254,0.16655337167291523,128365.3748647916,-2125.210323898818,126240.16454089279,1914,0,261.42,42,8,18,38.88609995537706,0.59375,46.65697674418604,1013.3720930232545,24.127906976744153,0
2303,4,1,2,49,0.0196078431372549,0.0392156862745098,0.9607843137254902,51,1850,1100,750,0.5945945945945946,26,11,15,303.2991711770925,0.4523529411764706,0.22445189702268897,0.16626379629181068,128744.48609855655,-2390.380814537421,126354.10528401913,1915,0,257.27450980392155,43,8,16,38.58793272370998,0.596172480620155,46.28314393939394,1014.8674242424239,23.601568005637766,0
2304,4,0,2,47,0.0,0.04081632653061224,0.9591836734693877,49,1250,700,550,0.56,18,7,11,320.12367214447556,0.4498476473922903,0.22184521730452555,0.17494733018050562,128622.09590143916,-1565.004468222487,127057.09143321667,1916,1,268.46938775510205,41,8,16,38.28555419722901,0.5978150406504066,46.403769841269835,1014.3849206349196,24.74109562524194,0
2305,4,1,4,44,0.020833333333333332,0.08333333333333333,0.9166666666666666,48,1600,1000,600,0.625,22,10,12,325.99586321350563,0.4487662529550827,0.2363723334961736,0.17928896614670764,128873.80248685121,-1197.5347025384222,127676.26778431279,1917,0,270.875,41,7,17,37.88053655756391,0.6003556910569106,46.15575396825397,1015.3769841269841,24.7652922957801,0
2306,4,1,0,45,0.022222222222222223,0.0,1.0,45,1200,500,700,0.4166666666666667,19,5,14,327.2036595154541,0.446233164983165,0.22339444064558833,0.18018202595264687,128924.17332963276,-563.1077373078929,128361.06559232487,1918,0,278.4222222222222,41,4,18,37.79865113477255,0.6008638211382114,46.10615079365079,1015.5753968253966,24.77013162988772,0
2307,4,0,1,44,0.0,0.022222222222222223,0.9777777777777777,45,950,600,350,0.631578947368421,13,6,7,328.17238522890204,0.44539141414141414,0.22532087795245714,0.18117592437354102,129024.94454089504,-531.5152391975333,128493.42930169751,1919,1,279.4222222222222,41,4,18,37.67159375712007,0.6018800813008129,46.00694444444444,1015.9722222222221,24.779810298102976,0
2308,4,1,0,45,0.022222222222222223,0.0,1.0,45,1300,700,600,0.5384615384615384,19,7,12,325.0014341673374,0.44610690235690237,0.2221289728133573,0.18081930820349512,129330.57089240853,-593.3552323857475,128737.21566002279,1920,0,277.8222222222222,40,5,19,37.44171911945916,0.6065104166666666,45.70630081300813,1017.1747967479668,25.42936991869917,0
2309,4,0,1,44,0.0,0.022222222222222223,0.9777777777777777,45,1000,700,300,0.7,13,7,6,325.1954626082737,0.4455176767676768,0.21599414036489528,0.18128379574799763,129408.11107806208,-583.4138905413406,128824.69718752074,1921,1,278.8222222222222,40,5,19,37.3580869623119,0.6072916666666667,45.63008130081301,1017.4796747967486,25.436991869918714,0
2310,4,0,0,44,0.0,0.0,1.0,44,1150,900,250,0.782608695652174,14,9,5,329.689099626915,0.44498766737138834,0.2082290726770415,0.1844334041587777,129545.80213758702,-258.0322265624759,129287.76991102454,1922,2,282.3863636363636,39,5,15,37.10403236808897,0.610309829059829,45.49479166666668,1018.0208333333351,26.103098290598336,0
2311,4,1,0,45,0.022222222222222223,0.0,1.0,45,1100,1000,100,0.9090909090909091,12,10,2,327.5684078890132,0.44617003367003366,0.21883749778486594,0.18503188445622662,129925.63950029765,-488.09302498510766,129437.54647531254,1923,0,277.0888888888889,40,5,16,36.772951555023944,0.6125,45.121951219512205,1019.5121951219529,25.487804878048824,0
2312,4,0,2,43,0.0,0.044444444444444446,0.9555555555555556,45,850,600,250,0.7058823529411765,11,6,5,332.2922129802328,0.44534932659932663,0.21826049329294706,0.18068877745819203,128422.23087873157,-341.6806856464152,128080.55019308516,1924,1,278.0888888888889,37,8,17,38.1806216645031,0.6024774774774775,46.60087719298244,1013.5964912280674,27.39449976292074,8
2313,4,1,1,43,0.022727272727272728,0.022727272727272728,0.9772727272727273,44,1300,800,500,0.6153846153846154,18,8,10,338.8308488591181,0.44365530303030304,0.21689855013933212,0.18467511883338364,128515.36502718931,-91.00595527961184,128424.3590719097,1925,0,284.90909090909093,36,8,17,37.91995224344734,0.6053240740740741,46.509009009009006,1013.9639639639636,28.165665665665657,0
2314,4,1,0,44,0.022727272727272728,0.0,1.0,44,1350,1200,150,0.8888888888888888,15,12,3,343.2446305820459,0.44199260042283295,0.2327490570224091,0.18842917783596605,128800.98637488842,42.04939737034363,128843.03577225877,1926,0,285.8863636363636,36,8,18,37.51687190296575,0.6082175925925926,46.22747747747748,1015.0900900900903,28.19694694694695,0
2315,4,1,0,45,0.022222222222222223,0.0,1.0,45,1350,1000,350,0.7407407407407407,17,10,7,338.23174251533015,0.4433922558922559,0.24246258552308353,0.18769736375491652,129229.25954380189,-258.1124721068112,128971.14707169509,1927,0,280.5111111111111,37,8,20,37.2082704266868,0.6106418918918919,45.805921052631575,1016.7763157894732,27.48044096728306,0
2316,4,0,1,44,0.0,0.022222222222222223,0.9777777777777777,45,1150,1000,150,0.8695652173913043,13,10,3,338.02450499380694,0.44305555555555554,0.24416654688323502,0.1879805340720954,129312.88954293617,-257.81490458604344,129055.07463835012,1928,1,281.5111111111111,37,8,21,37.12852163288773,0.6114864864864865,45.72368421052631,1017.1052631578938,27.489331436699832,0
2317,4,1,1,44,0.022222222222222223,0.022222222222222223,0.9777777777777777,45,1150,800,350,0.6956521739130435,15,8,7,337.70138755119194,0.44313973063973067,0.24575163398692834,0.18860073882371597,129480.2306959832,-254.86928670362005,129225.36140927959,1929,0,282.0444444444444,37,8,19,36.96670976082742,0.6131756756756757,45.55921052631578,1017.7631578947354,27.50711237553339,0
2318,4,1,0,45,0.022222222222222223,0.0,1.0,45,1150,700,450,0.6086956521739131,16,7,9,335.65285645647674,0.4426136363636364,0.2518024319380179,0.18892925469715555,129787.30384589492,-287.3041464681395,129499.99969942677,1930,0,282.1777777777778,37,8,20,36.7071765486567,0.6162725225225225,45.25767543859649,1018.9692982456143,27.53971076339498,0
2319,4,1,0,46,0.021739130434782608,0.0,1.0,46,1150,700,450,0.6086956521739131,16,7,9,321.6711750952712,0.4444142512077294,0.24336766506310292,0.18302112779542126,130208.0608175359,-823.1640139893452,129384.89680354655,1931,0,277.0217391304348,38,8,21,36.63748735126836,0.6186951754385965,44.845085470085465,1020.6196581196574,26.85841205578046,0
2320,4,0,3,43,0.0,0.06521739130434782,0.9347826086956522,46,1350,1000,350,0.7407407407407407,17,10,7,354.5346019305055,0.4436392914653784,0.25434430652995177,0.19563806354294974,129006.37846500812,-52.54357860823066,128953.8348863999,1932,1,278.0217391304348,37,9,16,37.02093452059722,0.6083896396396397,46.025219298245595,1015.8991228070147,27.456733048838235,8
2321,4,0,0,43,0.0,0.0,1.0,43,1500,1000,500,0.6666666666666666,20,10,10,380.5230433174806,0.4382613510520487,0.2990383959626266,0.20861472310492127,128747.91843820877,1198.3099489796073,129946.22838718837,1933,6,298.27906976744185,34,9,17,36.625122189638326,0.6118259803921569,46.27976190476191,1014.8809523809537,29.8494397759104,0
2322,4,1,0,44,0.022727272727272728,0.0,1.0,44,1250,700,550,0.56,18,7,11,360.1801178210101,0.4386561839323467,0.26377905468382146,0.19241468631872263,127712.2041990832,399.8793511213377,128112.08355020454,1934,0,292.47727272727275,38,6,16,38.20068350773348,0.5934758771929824,47.302350427350426,1010.7905982905983,26.59975258659469,8
2323,4,1,0,45,0.022222222222222223,0.0,1.0,45,1850,1500,350,0.8108108108108109,22,15,7,353.35969871614424,0.4409090909090909,0.27734906426129835,0.19068866806342055,128118.16541883674,54.35926649305111,128172.52468532979,1935,0,286.9555555555556,39,6,17,37.957544500463015,0.5958867521367521,46.901041666666664,1012.3958333333328,25.95886752136751,0
2324,4,3,1,47,0.0625,0.020833333333333332,0.9791666666666666,48,1700,1300,400,0.7647058823529411,21,13,8,337.36343383789085,0.4484615100472813,0.2840250651041667,0.1861315497036637,128999.74804736683,-896.0376942299204,128103.7103531369,1936,0,269.9583333333333,41,7,19,37.463785807291664,0.6016260162601625,46.03174603174602,1015.8730158730137,24.777390631049116,0
2325,4,1,0,48,0.020833333333333332,0.0,1.0,48,1400,800,600,0.5714285714285714,20,8,12,336.73934433609406,0.447122488179669,0.28596266471449505,0.18638004228650876,129125.75511975597,-903.6555768140875,128222.09954294188,1937,0,270.9375,41,7,20,37.35145192776963,0.6028963414634146,45.90773809523808,1016.3690476190454,24.78948896631818,0
2326,4,1,0,49,0.02040816326530612,0.0,1.0,49,1650,1300,350,0.7878787878787878,20,13,7,330.041604723702,0.4472611961451247,0.28269900353073263,0.18459110857159786,129537.39636005323,-1249.4096781708272,128287.98668188241,1938,0,266.38775510204084,40,9,17,37.103590562710046,0.60859375,45.50304878048779,1017.9878048780463,25.44969512195116,0
2327,4,0,2,47,0.0,0.04081632653061224,0.9591836734693877,49,1550,1100,450,0.7096774193548387,20,11,9,330.9868558578434,0.4471371882086168,0.2809248225332841,0.18573069817510082,129666.74619108965,-1216.4022737788673,128450.34391731079,1939,1,267.38775510204084,40,9,17,36.948297079757864,0.6098958333333333,45.37601626016259,1018.4959349593472,25.46239837398368,0
2328,4,1,0,48,0.020833333333333332,0.0,1.0,48,1400,900,500,0.6428571428571429,19,9,10,330.4824159890602,0.44769503546099293,0.2761997853419196,0.1861318063109369,129811.04736328113,-1019.9462890625146,128791.10107421862,1940,0,263.4791666666667,39,9,19,36.81481907390372,0.6129807692307692,45.23437499999999,1019.0624999999991,26.12980769230767,0
2329,4,0,1,47,0.0,0.020833333333333332,0.9791666666666666,48,1350,800,550,0.5925925925925926,19,8,11,333.8611819270328,0.4475749852245863,0.27682486297957243,0.18896203951707657,130003.35784131449,-919.385059323167,129083.97278199132,1941,1,264.4791666666667,40,8,19,36.533798372363435,0.61328125,45.04573170731707,1019.81707317073,25.49542682926825,0
2330,4,0,0,47,0.0,0.0,1.0,47,1350,700,650,0.5185185185185185,20,7,13,341.89985671830283,0.444650015417823,0.2795626006611851,0.19334822053237793,129970.32470703113,-512.6329210069595,129457.69178602418,1942,2,271.0,39,8,19,36.362349746313875,0.6145833333333333,45.07812499999999,1019.6874999999991,26.14583333333331,0
2331,4,0,0,47,0.0,0.0,1.0,47,1250,1000,250,0.8,15,10,5,345.51969687039275,0.44457292630280604,0.27636757160831626,0.19566126963898273,130023.4388563366,-414.8681640625208,129608.57069227408,1943,3,272.0,39,8,19,36.21618918734892,0.6151175213675213,45.02604166666666,1019.8958333333317,26.15117521367517,0
2332,4,0,0,47,0.0,0.0,1.0,47,1050,500,550,0.47619047619047616,16,5,11,345.8757031566634,0.4441489361702127,0.27722574394223165,0.19626342043547834,130103.13042534702,-400.09765625002,129703.032769097,1944,4,273.0,39,8,19,36.12628480021782,0.6159188034188035,44.94791666666666,1020.2083333333317,26.15918803418799,0
2333,4,1,0,48,0.020833333333333332,0.0,1.0,48,1550,1100,450,0.7096774193548387,20,11,9,337.8671471036723,0.44478612588652483,0.27542142468732944,0.19356314128462745,130475.34722222232,-783.2356770833287,129692.11154513899,1945,0,268.2916666666667,39,9,21,35.953643284393685,0.6196581196581197,44.583333333333336,1021.6666666666674,26.196581196581217,0
2334,4,1,0,49,0.02040816326530612,0.0,1.0,49,1300,900,400,0.6923076923076923,17,9,8,331.23982015403675,0.44556051587301587,0.2805093832150001,0.19179147493565252,130885.78976014616,-1129.082907826018,129756.70685232015,1946,0,263.7959183673469,40,9,18,35.708196775581825,0.6221354166666666,44.181910569105696,1023.2723577235779,25.58180894308945,0
2335,4,0,0,49,0.0,0.0,1.0,49,1300,800,500,0.6153846153846154,18,8,10,336.4048134126557,0.44508219954648526,0.287897484575226,0.19547847265870522,131023.2426303854,-984.6301020408239,130038.61252834457,1947,1,264.7959183673469,41,8,18,35.43725775193799,0.6219512195121951,44.047619047619044,1023.8095238095231,24.97096399535422,0
2336,4,0,0,49,0.0,0.0,1.0,49,1150,600,550,0.5217391304347826,17,6,11,336.8641195058891,0.44483418367346944,0.290750605326876,0.19639311315066652,131150.23389274688,-964.0383873456865,130186.19550540119,1948,2,265.7959183673469,41,8,18,35.29731638418078,0.6232215447154472,43.92361111111111,1024.3055555555552,24.983062330623298,0
2337,4,2,4,47,0.0392156862745098,0.0784313725490196,0.9215686274509804,51,1700,1200,500,0.7058823529411765,22,12,10,324.45477718975314,0.447483660130719,0.28637356874399034,0.19120671195157976,131562.6045694529,-1662.4151997680863,129900.18936968481,1949,0,256.3333333333333,40,11,14,35.19976886247317,0.62890625,43.52134146341464,1025.914634146343,25.647865853658573,0
2338,4,0,0,47,0.0,0.0,1.0,47,1250,900,350,0.72,16,9,7,349.27800010117625,0.4419133518347209,0.29416857415556685,0.20319429151382534,131067.83743142328,-244.17757287326765,130823.65985855002,1950,4,278.72340425531917,40,7,19,35.06269022098718,0.6239583333333334,44.00406504065042,1023.9837398373998,25.599593495934993,0
2339,4,0,0,47,0.0,0.0,1.0,47,1250,900,350,0.72,16,9,7,353.7076296422153,0.4417013567684243,0.3035497576017243,0.2064694044251984,131197.9489411893,-118.85689321829602,131079.092047971,1951,5,279.72340425531917,40,7,20,34.817767747908626,0.6252604166666667,43.877032520325216,1024.4918699187008,25.61229674796752,0
2340,4,0,0,47,0.0,0.0,1.0,47,1350,700,650,0.5185185185185185,20,7,13,351.2411319503143,0.44079555966697503,0.3070347721795257,0.205877952514325,131356.22409058534,-172.2645852061043,131183.95950537923,1952,6,280.72340425531917,37,10,20,34.721070881021134,0.6320382882882882,43.72258771929823,1025.1096491228052,27.70566619250825,0
2341,4,0,0,47,0.0,0.0,1.0,47,1250,800,450,0.64,17,8,9,357.6317612039185,0.4396584952204749,0.3083987261965182,0.2105225345995599,131519.83486969463,7.134035539485012,131526.96890523413,1953,7,281.72340425531917,38,9,21,34.392033815921955,0.6318530701754386,43.56303418803419,1025.747863247863,26.993364822312184,0
2342,4,0,0,47,0.0,0.0,1.0,47,1100,800,300,0.7272727272727273,14,8,6,356.48126595865233,0.4392345050878816,0.3087864829474831,0.2101466910375038,131574.6348002958,-19.221523668648047,131555.41327662717,1954,8,282.72340425531917,38,9,17,34.36621368322399,0.6324013157894737,43.50961538461538,1025.9615384615379,26.998987854251,0
2343,4,0,0,47,0.0,0.0,1.0,47,1250,800,450,0.64,17,8,9,355.3974302398188,0.43882978723404253,0.3119799614199752,0.2101109607577807,131684.26890432087,-39.94984567902486,131644.31905864185,1955,9,283.72340425531917,38,9,17,34.283378439332424,0.6334978070175439,43.40277777777777,1026.388888888888,27.01023391812863,0
2344,4,1,1,47,0.020833333333333332,0.020833333333333332,0.9791666666666666,48,1500,1200,300,0.8,18,12,6,350.0945460625675,0.4395500886524823,0.3093896249423249,0.20902339072472276,132058.30379569027,-353.42161577104906,131704.88217991922,1956,0,278.7916666666667,40,8,18,34.042540043504054,0.6338541666666666,43.038617886178855,1027.8455284552833,25.696138211382085,0
2345,4,0,0,47,0.0,0.0,1.0,47,1100,600,500,0.5454545454545454,16,6,10,355.69647925658364,0.44019811902559364,0.30880719500490716,0.21202089231819907,131996.29041883667,-9.876844618065093,131986.4135742186,1957,1,280.8936170212766,39,8,18,33.96107872951512,0.6348824786324787,43.09895833333333,1027.6041666666656,26.34882478632476,0
2346,4,0,1,46,0.0,0.02127659574468085,0.9787234042553191,47,1500,1300,200,0.8666666666666667,17,13,4,351.01628886287574,0.44021739130434784,0.3025075294873485,0.20982312264007993,132103.35422092007,-125.91417100694872,131977.44004991313,1958,2,281.8936170212766,39,8,18,33.97349022190699,0.6359508547008548,42.994791666666664,1028.0208333333328,26.359508547008534,0
2347,4,1,1,46,0.02127659574468085,0.02127659574468085,0.9787234042553191,47,1600,1100,500,0.6875,21,11,10,353.34707685957966,0.44027520814061055,0.30743776014063773,0.21226616369009782,132290.8203125,-51.085069444445026,132239.73524305556,1959,0,282.59574468085106,39,8,19,33.72485486701769,0.6378205128205128,42.8125,1028.75,26.378205128205128,0
2348,4,0,0,46,0.0,0.0,1.0,46,1400,1100,300,0.7857142857142857,17,11,6,366.0279708798892,0.43903985507246374,0.3159454907503152,0.21986795580801324,132288.07259706687,484.22695686316797,132772.29955393003,1960,1,288.4347826086956,38,8,19,33.401486827984904,0.6395285087719298,42.81517094017094,1028.7393162393155,27.072087269455672,0
2349,4,0,0,46,0.0,0.0,1.0,46,1550,1000,550,0.6451612903225806,21,10,11,365.35593109213386,0.4388385668276973,0.31235697940503404,0.2201046706823345,132398.00347222236,474.5704808605635,132872.57395308293,1961,2,289.4347826086956,36,10,19,33.30802968960865,0.6443865740740741,42.70833333333334,1029.1666666666679,28.587962962962997,0
2350,4,0,0,46,0.0,0.0,1.0,46,1400,1100,300,0.7857142857142857,17,11,6,364.07836123185615,0.4384057971014493,0.31268635068881334,0.22001113395524563,132513.92598257065,449.0906024267798,132963.01658499744,1962,3,290.4347826086956,36,10,19,33.22418790331402,0.6455439814814814,42.595720720720735,1029.617117117119,28.60047547547553,0
2351,4,0,0,46,0.0,0.0,1.0,46,1350,1100,250,0.8148148148148148,16,11,5,365.2748779497789,0.4375503220611916,0.31666211695684554,0.22188028623749667,132708.51518015168,495.0173370652638,133203.53251721695,1963,4,291.4347826086956,37,9,19,32.997565712461444,0.6455518018018018,42.40679824561404,1030.3728070175446,27.84791370317688,0
2352,4,0,0,46,0.0,0.0,1.0,46,1800,1400,400,0.7777777777777778,22,14,8,367.5898893983684,0.43689613526570054,0.3208636485499541,0.2248082249467527,132962.8407298401,575.1591835949702,133537.99991343508,1964,5,292.4347826086956,37,9,19,32.68215323552342,0.6480855855855856,42.160087719298254,1031.3596491228082,27.874585111427248,0
2353,4,0,0,46,0.0,0.0,1.0,46,2000,1500,500,0.75,25,15,10,366.22236796419895,0.43592995169082127,0.3226167971914664,0.22504504290929786,133141.2310979619,551.8593852728518,133693.09048323473,1965,6,293.4347826086956,38,8,19,32.53817287784681,0.6480263157894737,41.98717948717949,1032.0512820512822,27.159244264507425,0
2354,4,0,0,46,0.0,0.0,1.0,46,1050,500,550,0.47619047619047616,16,5,11,367.78258948440623,0.43520531400966184,0.3207741964506623,0.22684229274835901,133279.0941289539,603.5460725765191,133882.64020153042,1966,7,294.4347826086956,38,8,19,32.35945852733229,0.6493969298245614,41.85363247863248,1032.58547008547,27.173301844354473,0
2355,4,0,0,46,0.0,0.0,1.0,46,1350,1000,350,0.7407407407407407,17,10,7,368.4313215400626,0.43476247987117556,0.32065217391304346,0.22842741935483857,133472.22222222207,635.4889190225535,134107.71114124462,1967,8,295.4347826086956,35,11,20,32.14885752688171,0.6571428571428571,41.66666666666666,1033.3333333333321,29.52380952380949,0
2356,4,0,0,46,0.0,0.0,1.0,46,1250,700,550,0.56,18,7,11,369.2203996494218,0.434591384863124,0.32600908210397184,0.22984291498733697,133621.76254125944,667.1761134687927,134288.93865472823,1968,9,296.4347826086956,35,11,20,31.978455352811658,0.6586309523809524,41.52199074074074,1033.9120370370372,29.540343915343918,0
2357,4,0,0,46,0.0,0.0,1.0,46,1150,700,450,0.6086956521739131,16,7,9,369.92445712442407,0.4335245571658615,0.32910601730044875,0.23153037548087246,133821.54959013063,700.772816735649,134522.32240686627,1969,10,297.4347826086956,36,10,16,31.75994957190538,0.6585648148148149,41.328828828828826,1034.6846846846843,28.74124124124123,0
2358,4,0,0,46,0.0,0.0,1.0,46,1050,600,450,0.5714285714285714,15,6,9,368.0443957031953,0.4332024959742351,0.3249513832701669,0.23053578405703215,133850.68081172393,652.5985867624422,134503.27939848637,1970,11,298.4347826086956,36,10,16,31.779392026698588,0.6588541666666667,41.30067567567568,1034.7972972972975,28.744369369369377,0
2359,4,0,1,45,0.0,0.021739130434782608,0.9782608695652174,46,1250,1100,150,0.88,14,11,3,368.83611851528696,0.4328301127214171,0.3173931963522161,0.23158071047763076,133938.09349890417,680.2413054946719,134618.33480439885,1971,12,299.4347826086956,36,10,16,31.671335581665225,0.6597222222222222,41.21621621621621,1035.135135135134,28.753753753753724,0
2360,4,0,0,45,0.0,0.0,1.0,45,1350,600,750,0.4444444444444444,21,6,15,387.08280118135167,0.43137626262626266,0.2869314910765688,0.22152858608934003,130435.08193582091,1188.385175716251,131623.46711153717,1972,13,294.24444444444447,36,9,20,34.7375335317679,0.6247106481481481,44.622747747747745,1021.5090090090087,28.37525025025024,8
2361,4,1,0,46,0.021739130434782608,0.0,1.0,46,1650,1200,450,0.7272727272727273,21,12,9,385.89574365672615,0.43347423510466987,0.2992077916025908,0.22307356185360946,130822.85534972306,896.7966104955451,131719.65196021862,1973,0,288.82608695652175,37,9,17,34.373883529832085,0.6266891891891893,44.24342105263158,1023.0263157894742,27.649359886202006,0
2362,4,1,0,47,0.02127659574468085,0.0,1.0,47,1100,800,300,0.7272727272727273,14,8,6,378.07326670878234,0.43428152944804194,0.3058815698977211,0.2208113658792465,131218.6392815401,522.0519212506576,131740.69120279074,1974,0,283.6595744680851,38,9,18,34.17274939172748,0.6288377192982456,43.856837606837615,1024.572649572651,26.96243814664871,0
2363,4,0,1,46,0.0,0.02127659574468085,0.9787234042553191,47,1600,1300,300,0.8125,19,13,6,378.33560579362,0.43356845513413506,0.3099614704496785,0.22175922122661773,131356.22409058549,539.3929803117632,131895.61707089725,1975,1,284.6595744680851,37,10,18,34.02670071665418,0.6320382882882882,43.72258771929824,1025.1096491228063,27.70566619250828,0
2364,4,0,0,46,0.0,0.0,1.0,46,1200,800,400,0.6666666666666666,16,8,8,375.853515625,0.4327495974235105,0.2954076086956521,0.22109030330882357,131492.4391847469,684.3791091387288,132176.81829388565,1976,2,286.0869565217391,38,8,19,33.952473958333336,0.631578947368421,43.58974358974359,1025.6410256410259,26.990553306342786,0
2365,4,0,0,46,0.0,0.0,1.0,46,1200,700,500,0.5833333333333334,17,7,10,380.3568384829065,0.43198470209339773,0.3025303849897014,0.224543788176295,131629.44614517142,813.2319974066872,132442.6781425781,1977,3,287.0869565217391,38,8,15,33.698377581120944,0.6329495614035088,43.456196581196586,1026.1752136752145,27.004610886189855,0
2366,4,0,0,46,0.0,0.0,1.0,46,1700,1200,500,0.7058823529411765,22,12,10,375.3869619010034,0.4310487117552335,0.30139922757572735,0.22305131345588677,131876.23844875448,700.9240996420499,132577.16254839653,1978,4,288.0869565217391,38,8,15,33.57646834477498,0.6354166666666667,43.215811965811966,1027.1367521367522,27.02991452991453,0
2367,4,0,0,46,0.0,0.0,1.0,46,1500,900,600,0.6,21,9,12,374.3402294647183,0.4307165861513687,0.2944059989965513,0.22323488327471322,132013.44515897796,683.5886706479575,132697.03382962593,1979,5,289.0869565217391,38,8,15,33.464800568319646,0.6367872807017544,43.082264957264954,1027.6709401709397,27.043972109761572,0
2368,4,0,0,46,0.0,0.0,1.0,46,1350,900,450,0.6666666666666666,18,9,9,373.80976604435295,0.43003220611916265,0.2998338731059016,0.22368154822654007,132142.87682665663,679.2595742000548,132822.1364008567,1980,6,290.0869565217391,41,5,15,33.34780650971311,0.6331300813008129,42.95634920634921,1028.1746031746036,25.077429345722038,0
2369,4,0,2,44,0.0,0.043478260869565216,0.9565217391304348,46,1550,1100,450,0.7096774193548387,20,11,9,372.5744634287824,0.4296698872785829,0.29931045474754403,0.22324317271114222,132193.88247197028,650.4129661123714,132844.29543808266,1981,7,291.0869565217391,41,5,16,33.32810791690785,0.6336382113821138,42.90674603174603,1028.373015873016,25.082268679829657,0
2370,4,0,0,44,0.0,0.0,1.0,44,1600,1300,300,0.8125,19,13,6,379.8282619369033,0.4307721106412967,0.2865303321943986,0.22736717850692365,132156.9023980034,1239.3853081597126,133396.28770616313,1982,8,300.3181818181818,39,5,16,33.17894590213757,0.6364850427350428,42.94270833333333,1028.229166666666,26.36485042735041,0
2371,4,0,0,44,0.0,0.0,1.0,44,1450,800,650,0.5517241379310345,21,8,13,364.421016885084,0.4301444679351656,0.2518999969920892,0.20794243927608916,130320.07250071016,845.2066343951637,131165.27913510532,1983,9,301.3181818181818,36,8,17,35.432980405132156,0.6235532407407407,44.73536036036036,1021.0585585585584,28.36273773773773,7
2372,4,0,0,44,0.0,0.0,1.0,44,1150,600,550,0.5217391304347826,17,6,11,359.6354694321135,0.4298361522198732,0.24846859149434275,0.20639178418148377,130542.57079101262,589.5477454601437,131132.11853647276,1984,10,302.3181818181818,37,7,16,35.32948855507869,0.6238738738738738,44.51754385964912,1021.9298245614035,27.61972498814604,0
2373,4,0,1,43,0.0,0.022727272727272728,0.9772727272727273,44,1300,900,400,0.6923076923076923,17,9,8,361.1405138725113,0.42947278012684986,0.24826918763956174,0.2077059229385209,130626.62459843421,634.9132665820337,131261.53786501623,1985,11,303.3181818181818,37,7,17,35.20583056240838,0.6247184684684685,44.43530701754386,1022.2587719298251,27.62861545756284,0
2374,4,1,0,44,0.022727272727272728,0.0,1.0,44,1550,1000,550,0.6451612903225806,21,10,11,362.24522368658353,0.4310804263565891,0.2563654870790846,0.20985938377820496,130906.99932912046,684.0870508233297,131591.0863799438,1986,0,301.65909090909093,37,7,19,34.89354530518947,0.6275337837837838,44.161184210526315,1023.3552631578943,27.658250355618765,0
2375,4,0,0,44,0.0,0.0,1.0,44,1150,700,450,0.6086956521739131,16,7,9,358.1714378566517,0.4305518851303735,0.24172093566568353,0.2084089132799546,131075.3684426939,589.4906365420096,131664.8590792359,1987,1,302.65909090909093,37,7,19,34.82740389763357,0.629222972972973,43.99671052631579,1024.0131578947367,27.676031294452343,0
2376,4,0,0,44,0.0,0.0,1.0,44,1250,900,350,0.72,16,9,7,365.4284271797868,0.43000132135306557,0.2435537543907449,0.2132540783972984,131187.6746330602,787.9411213065596,131975.61575436677,1988,2,303.65909090909093,37,7,19,34.52796657033787,0.6303490990990991,43.887061403508774,1024.4517543859652,27.687885253674732,0
2377,4,0,0,44,0.0,0.0,1.0,44,1100,700,400,0.6363636363636364,15,7,8,366.5799060139922,0.43002334390415786,0.24353706099185946,0.21455368700768862,131300.02891514706,826.3904518698209,132126.41936701688,1989,3,304.65909090909093,37,7,20,34.38480706822154,0.6314752252252251,43.77741228070176,1024.8903508771937,27.699739212897125,0
2378,4,0,0,44,0.0,0.0,1.0,44,1750,1300,450,0.7428571428571429,22,13,9,367.40302923954164,0.42947278012684986,0.24688052147698603,0.21600641622236982,131472.44953991167,860.6782502338108,132333.1277901455,1990,4,305.65909090909093,36,8,21,34.18935983309542,0.6351273148148149,43.60923423423424,1025.5630630630642,28.487862862862894,0
2379,4,0,0,44,0.0,0.0,1.0,44,1150,900,250,0.782608695652174,14,9,5,339.3853846947353,0.42905435165609584,0.21833921492139208,0.1903179037507524,129640.87106095921,-0.3566205631477146,129640.51444039606,1991,5,306.65909090909093,40,4,16,36.76071915643813,0.6096354166666667,45.40142276422765,1018.3943089430904,25.45985772357726,7
2380,4,1,0,45,0.022222222222222223,0.0,1.0,45,1150,800,350,0.6956521739130435,15,8,7,336.0512649699466,0.4310816498316498,0.22779939472546507,0.1902316632098597,130009.52695893182,-262.0268014613141,129747.50015747051,1992,0,300.8222222222222,41,4,18,36.47170881971466,0.6117886178861789,45.039682539682545,1019.8412698412706,24.87417731320172,0
2381,4,0,0,45,0.0,0.0,1.0,45,1000,800,200,0.8,12,8,4,334.50964081147384,0.4310185185185185,0.22777237459205968,0.1896046376418729,130060.1192444571,-298.72724552783393,129761.39199892928,1993,1,301.8222222222222,41,4,18,36.459751669584385,0.6122967479674797,44.99007936507937,1020.0396825396831,24.879016647309342,0
2382,4,0,2,43,0.0,0.044444444444444446,0.9555555555555556,45,1650,1100,550,0.6666666666666666,22,11,11,335.1992231582777,0.4313131313131313,0.23139706914612201,0.19086136176400198,130237.26974875583,-268.91367079240615,129968.35607796343,1994,2,302.8222222222222,41,4,18,36.26273609356268,0.6140752032520325,44.816468253968246,1020.7341269841259,24.895954316685998,0
2383,4,2,2,43,0.044444444444444446,0.044444444444444446,0.9555555555555556,45,1100,900,200,0.8181818181818182,13,9,4,336.16283286625276,0.4289983164983165,0.236946426548873,0.1928513093811663,130528.56445312513,-224.22467974456805,130304.33977338056,1995,0,300.5777777777778,39,6,15,35.943340129119946,0.6201923076923077,44.53125000000001,1021.875000000001,26.2019230769231,0
2384,4,0,0,43,0.0,0.0,1.0,43,1450,1000,450,0.6896551724137931,19,10,9,351.9574161845446,0.4284330011074197,0.23659937108646178,0.20067823037932014,130290.57167830497,571.3465922206949,130861.91827052567,1996,4,315.5581395348837,37,6,19,35.78104303153975,0.6213400900900901,44.76425438596492,1020.9429824561413,27.59305357989571,0
2385,4,0,0,43,0.0,0.0,1.0,43,1250,800,450,0.64,17,8,9,353.38982550025753,0.4283868586194168,0.2325631316598069,0.20236834690755365,130458.54403518383,620.5444223222486,131079.0884575061,1997,5,316.5581395348837,37,6,19,35.57419680870095,0.6230292792792793,44.59978070175438,1021.6008771929819,27.61083451872924,0
2386,4,0,0,43,0.0,0.0,1.0,43,1050,600,450,0.5714285714285714,15,6,9,352.9858719077529,0.4278100775193798,0.23158997903982437,0.20257563584853808,130542.57079101264,615.936634349033,131158.50742536166,1998,6,317.5581395348837,37,6,17,35.499374105865535,0.6238738738738738,44.51754385964912,1021.9298245614036,27.619724988146043,0
2387,4,0,0,43,0.0,0.0,1.0,43,1350,900,450,0.6666666666666666,18,9,9,351.50480170873976,0.42787929125138424,0.22701545814427404,0.20216405097659343,130626.6245984341,583.1771554709067,131209.801753905,1999,7,318.5581395348837,37,6,17,35.452085344488545,0.6247184684684685,44.435307017543856,1022.2587719298242,27.628615457562816,0
2388,4,0,0,43,0.0,0.0,1.0,43,1200,800,400,0.6666666666666666,16,8,8,351.51641418227746,0.4264950166112957,0.2216083609238506,0.20290501927551238,130766.77439212041,593.33352570019,131360.1079178206,2000,8,319.5581395348837,37,6,17,35.30990923384791,0.6261261261261262,44.298245614035075,1022.8070175438577,27.64343290659075,0
2389,4,0,1,42,0.0,0.023255813953488372,0.9767441860465116,43,1150,700,450,0.6086956521739131,16,7,9,353.02461713110097,0.426172019195275,0.226488805616875,0.20466656995662671,130935.05333371779,644.6594144351831,131579.71274815296,2001,9,320.5581395348837,37,6,18,35.10106420969932,0.6278153153153153,44.13377192982455,1023.4649122806995,27.66121384542431,0
2390,4,0,0,42,0.0,0.0,1.0,42,1500,1300,200,0.8666666666666667,17,13,4,350.6483544746811,0.42567992644212155,0.2207413806644154,0.2043015236353122,131126.20380092924,795.8375182614957,131922.04131919073,2002,10,324.6190476190476,36,6,18,34.96861828843687,0.6316550925925926,43.94707207207207,1024.2117117117111,28.45032532532531,0
2391,4,0,0,42,0.0,0.0,1.0,42,1100,700,400,0.6363636363636364,15,7,8,352.40582251317704,0.42535327138985674,0.22217860544965418,0.20578871458439554,131212.72243527306,848.025474799114,132060.74791007218,2003,11,325.6190476190476,36,6,18,34.83618194474976,0.6325231481481481,43.86261261261261,1024.549549549549,28.459709709709696,0
2392,4,0,0,42,0.0,0.0,1.0,42,1250,800,450,0.64,17,8,9,351.6425408156522,0.42491773132017036,0.2243515292295779,0.20596205962059622,131328.125,836.1618375131897,132164.28683751318,2004,12,326.6190476190476,35,7,20,34.739159891598916,0.6357142857142857,43.75,1025.0,29.285714285714285,0
2393,4,0,0,42,0.0,0.0,1.0,42,1150,700,450,0.6086956521739131,16,7,9,348.92721314319954,0.4246031746031746,0.22518956798383494,0.2051654967260708,131476.45968632094,775.1429344564226,132251.60262077735,2005,13,327.6190476190476,35,7,20,34.65901610051536,0.637202380952381,43.60532407407406,1025.578703703702,29.30224867724863,0
2394,4,0,0,42,0.0,0.0,1.0,42,1550,1400,150,0.9032258064516129,17,14,3,351.6981477409509,0.42439750290360045,0.23160465990229295,0.20824850270108364,131743.6731074245,866.8011616940976,132610.4742691186,2006,14,328.6190476190476,35,7,18,34.318395340097716,0.6398809523809523,43.344907407407405,1026.6203703703698,29.332010582010565,0
2395,4,0,0,42,0.0,0.0,1.0,42,1250,900,350,0.72,16,9,7,351.09079702302904,0.42424022454510263,0.23379709418314443,0.20814342569934843,131790.24252292837,854.068257446644,132644.310780375,2007,15,329.6190476190476,36,6,18,34.28703297506764,0.6383101851851851,43.29954954954955,1026.8018018018022,28.522272272272282,0
2396,4,0,0,42,0.0,0.0,1.0,42,1400,1100,300,0.7857142857142857,17,11,6,352.8664272119933,0.42401035617499033,0.23503323048329094,0.20967392069059246,131876.9799148813,906.9917468144039,132783.9716616957,2008,16,330.6190476190476,36,6,18,34.154012717903754,0.6391782407407407,43.2150900900901,1027.139639639641,28.531656656656693,0
2397,4,0,0,42,0.0,0.0,1.0,42,1100,900,200,0.8181818181818182,13,9,4,352.21992945702476,0.42352642276422764,0.23615176321432463,0.21024926724357546,132050.54029959033,902.166397816757,132952.7066974071,2009,17,331.6190476190476,36,6,18,33.995745224790916,0.6409143518518519,43.04617117117118,1027.8153153153169,28.55042542542547,0
2398,4,0,0,42,0.0,0.0,1.0,42,1200,700,500,0.5833333333333334,17,7,10,353.68723305973566,0.42352642276422764,0.23136515585316375,0.2117716803323575,132166.31063073233,949.1073421394673,133115.4179728718,2010,18,332.6190476190476,36,6,19,33.84144671996496,0.6420717592592593,42.93355855855857,1028.2657657657678,28.562937937937996,0
2399,4,0,0,42,0.0,0.0,1.0,42,1250,900,350,0.72,16,9,7,354.1755129318377,0.4239982578397212,0.23515077672860207,0.21241472578648607,132228.78674207465,966.4396737457905,133195.22641582045,2011,19,333.6190476190476,37,5,19,33.76599147121535,0.6407657657657657,42.87280701754387,1028.508771929826,27.797534376481785,0
2400,4,1,0,43,0.023255813953488372,0.0,1.0,43,800,500,300,0.625,11,5,6,346.06400719263047,0.4253183831672204,0.23193242256752522,0.20912513005698774,132513.92598257065,571.876459613607,133085.80244218427,2012,0,326.83720930232556,36,7,21,33.68788508512889,0.6455439814814814,42.595720720720735,1029.617117117119,28.60047547547553,0
2401,4,0,0,43,0.0,0.0,1.0,43,1400,1000,400,0.7142857142857143,18,10,8,347.5009575684256,0.4254337393872278,0.23014842135498292,0.21096790051715525,132687.90486009678,621.8347993263682,133309.73965942315,2013,1,327.83720930232556,36,7,17,33.47610850001819,0.6472800925925926,42.42680180180181,1030.2927927927942,28.619244244244285,0
2402,4,0,1,42,0.0,0.023255813953488372,0.9767441860465116,43,1450,900,550,0.6206896551724138,20,9,11,345.01397588291445,0.4245108896271687,0.23024652940952284,0.2104332411197923,132861.99787202742,567.8492259151027,133429.84709794252,2014,2,328.83720930232556,36,7,18,33.36541962497724,0.6490162037037037,42.25788288288288,1030.9684684684685,28.638013013013012,0
2403,4,0,0,42,0.0,0.0,1.0,42,1350,1000,350,0.7407407407407407,17,10,7,350.16066026023,0.4223649825783972,0.22545152307190675,0.21381640317055445,132904.73257726768,907.6017821930698,133812.33435946074,2015,23,337.6190476190476,35,7,19,33.189868859206044,0.6514880952380953,42.21643518518518,1031.1342592592594,29.46097883597884,0
2404,4,0,0,42,0.0,0.0,1.0,42,1200,800,400,0.6666666666666666,16,8,8,350.2985949333402,0.4219052458381727,0.2240787934157169,0.21458497433957802,133024.10361207562,919.6313175154296,133943.73492959104,2016,24,338.6190476190476,35,7,19,33.06651800740491,0.6526785714285714,42.10069444444444,1031.5972222222222,29.474206349206348,0
2405,4,0,1,41,0.0,0.023809523809523808,0.9761904761904762,42,1100,700,400,0.6363636363636364,15,7,8,353.409797586667,0.42105836236933797,0.22887322062868876,0.2168374635571326,133083.80922335814,1006.6244159379198,134090.43363929607,2017,25,339.6190476190476,35,7,19,32.9263647410731,0.6532738095238095,42.04282407407407,1031.8287037037032,29.480820105820094,0
2406,4,0,0,41,0.0,0.0,1.0,41,1450,1200,250,0.8275862068965517,17,12,5,354.36098460749275,0.4188262195121952,0.2244197713807652,0.21846954690279496,133263.00643272034,1244.642034250684,134507.64846697103,2018,26,342.9512195121951,35,6,20,32.72206497776781,0.6550595238095238,41.86921296296296,1032.523148148148,29.500661375661373,0
2407,4,0,0,41,0.0,0.0,1.0,41,1000,600,400,0.6,14,6,8,355.51782790008366,0.4188516260162602,0.22602391457673843,0.21935892534747906,133292.8843557099,1277.5993441358055,134570.4836998457,2019,27,343.9512195121951,35,6,20,32.66223940820445,0.6553571428571429,41.84027777777778,1032.638888888889,29.503968253968253,0
2408,4,0,0,41,0.0,0.0,1.0,41,1150,700,450,0.6086956521739131,16,7,9,357.7697551441082,0.41821646341463414,0.22476404911931702,0.22145997464745582,133412.42953746582,1346.186449759962,134758.61598722578,2020,28,344.9512195121951,35,6,21,32.484222122637995,0.656547619047619,41.724537037037045,1033.1018518518529,29.517195767195798,0
2409,4,0,0,41,0.0,0.0,1.0,41,1350,1100,250,0.8148148148148148,16,11,5,358.3506763787718,0.4178607723577236,0.22580645161290258,0.22217741935483884,133472.22222222245,1365.9722222222467,134838.1944444447,2021,29,345.9512195121951,35,6,21,32.409274193548384,0.6571428571428571,41.66666666666668,1033.333333333335,29.523809523809575,0
2410,4,0,0,41,0.0,0.0,1.0,41,1100,600,500,0.5454545454545454,16,6,10,359.1323889442526,0.41788617886178864,0.22850546561660878,0.22340298464125316,133595.26643990952,1395.6774376417436,134990.94387755127,2022,30,346.9512195121951,34,7,22,32.26575694764317,0.6605392156862745,41.54761904761906,1033.8095238095254,30.406162464986043,0
2411,4,0,0,41,0.0,0.0,1.0,41,1000,500,500,0.5,15,5,10,357.9576724553205,0.41778455284552846,0.08007259328512117,0.21195491019216908,131743.67310742452,1447.6189054582699,133191.2920128828,2023,31,347.9512195121951,35,6,16,34.15774145058249,0.6398809523809523,43.344907407407405,1026.62037037037,29.33201058201057,8
2412,4,0,0,41,0.0,0.0,1.0,41,1500,1000,500,0.6666666666666666,20,10,10,386.64049004460674,0.4172764227642276,0.03374049069950491,0.22102720310747892,130391.51178770035,1943.7316796968162,132335.24346739717,2024,32,348.9512195121951,32,9,19,34.79313470968807,0.6331380208333333,44.66540404040405,1021.3383838383847,31.916824494949523,8
2413,4,0,0,41,0.0,0.0,1.0,41,1150,700,450,0.6086956521739131,16,7,9,363.5716972743751,0.41603150406504064,0.03611467693624304,0.2031724190650918,129504.14540816315,1288.7477967158554,130792.893204879,2025,33,349.9512195121951,34,7,15,36.284113060428844,0.6194852941176471,45.53571428571428,1017.857142857142,29.93697478991594,8
2414,4,1,0,42,0.023809523809523808,0.0,1.0,42,850,500,350,0.5882352941176471,12,5,7,355.5863164009541,0.4185177119628339,0.0531044028829879,0.20061810945183878,129878.87577428408,836.6302029749563,130715.50597725903,2026,0,342.5952380952381,35,7,17,36.10634060028006,0.6211309523809524,45.16782407407407,1019.3287037037034,29.12367724867724,0
2415,4,0,1,41,0.0,0.023809523809523808,0.9761904761904762,42,1200,1100,100,0.9166666666666666,13,11,2,359.73427173985016,0.41832413859852885,0.0560022261486004,0.20388026603493878,130055.90284475728,957.1130990654849,131013.01594382276,2027,1,343.5952380952381,35,7,18,35.82078085404137,0.6229166666666667,44.994212962962955,1020.0231481481474,29.143518518518494,0
2416,4,2,1,42,0.046511627906976744,0.023255813953488372,0.9767441860465116,43,1600,1300,300,0.8125,19,13,6,344.24114716630464,0.4235418973791067,0.07350921233363272,0.19884988618665386,130794.81336805566,405.31951946159654,131200.13288751725,2028,0,333.30232558139534,35,8,16,35.467583163611664,0.6303571428571428,44.270833333333336,1022.9166666666675,29.2261904761905,0
2417,4,0,0,42,0.0,0.0,1.0,42,1500,1300,200,0.8666666666666667,17,13,4,351.34120934221346,0.4199332171893147,0.07464791686328875,0.20272432422147293,130751.61944038639,787.6864195276482,131539.30585991405,2029,1,342.23809523809524,36,6,17,35.329727299420114,0.6278935185185186,44.31306306306307,1022.7477477477482,28.409659659659674,0
2418,4,0,0,42,0.0,0.0,1.0,42,1300,900,400,0.6923076923076923,17,9,8,347.9883890329045,0.41906213704994194,0.06871418877204771,0.20159997733358795,130906.99932912066,710.8231619344547,131617.82249105512,2030,2,343.23809523809524,37,5,19,35.2582904746598,0.6275337837837838,44.16118421052632,1023.355263157896,27.65825035561881,0
2419,4,0,0,42,0.0,0.0,1.0,42,1300,1000,300,0.7692307692307693,16,10,6,347.8591411710238,0.4189169570267131,0.061544699276304904,0.20211330436302735,131019.23338190601,715.2476002231521,131734.48098212917,2031,3,344.23809523809524,37,5,20,35.14813376887652,0.6286599099099099,44.0515350877193,1023.7938596491231,27.670104314841165,0
2420,4,1,1,42,0.023255813953488372,0.023255813953488372,0.9767441860465116,43,1100,900,200,0.8181818181818182,13,9,4,339.08387864366455,0.42128091546696195,0.06863301191151461,0.1986062717770036,131328.12500000012,306.2500000000144,131634.37500000012,2032,0,337.2093023255814,38,5,21,35.0609756097561,0.6299342105263157,43.75000000000001,1025.000000000001,26.97368421052634,0
2421,4,0,0,42,0.0,0.0,1.0,42,1400,1000,400,0.7142857142857143,18,10,8,345.2218990429725,0.42109465737514523,0.06316250815394686,0.2016095890410958,131215.758694983,659.710680209287,131875.46937519228,2033,1,327.2857142857143,37,5,21,35.01712328767124,0.6306306306306306,43.859649122807014,1024.5614035087713,27.690848743480306,0
2422,4,0,0,42,0.0,0.0,1.0,42,800,500,300,0.625,11,5,6,345.29852379488824,0.42070751064653505,0.06297777634422497,0.20255988899172978,131387.44882758908,673.6746085096395,132061.12343609871,2034,2,328.2857142857143,35,7,22,34.8418567020396,0.6363095238095238,43.692129629629626,1025.2314814814808,29.292328042328023,0
2423,4,0,1,41,0.0,0.023809523809523808,0.9761904761904762,42,1350,900,450,0.6666666666666666,18,9,9,344.7566451675641,0.4209010840108401,0.059527840936577814,0.2023988813478761,131417.11576485337,661.3847897376518,132078.500554591,2035,3,329.2857142857143,35,7,22,34.82581273281408,0.6366071428571429,43.66319444444444,1025.3472222222222,29.29563492063492,0
2424,4,0,0,41,0.0,0.0,1.0,41,1650,1200,450,0.7272727272727273,21,12,9,342.3386540416752,0.42045223577235774,0.05026338893766469,0.2020330191468745,131616.85333982625,811.5072843113333,132428.3606241376,2036,4,322.5365853658537,36,5,18,34.68640254609306,0.6365740740740741,43.468468468468465,1026.1261261261257,28.50350350350349,0
2425,4,0,0,41,0.0,0.0,1.0,41,750,600,150,0.8,9,6,3,338.3082719823389,0.42032520325203254,0.05632525883045658,0.2002049331415078,131721.78578985826,712.5139465989384,132434.2997364572,2037,5,323.5365853658537,37,4,18,34.68409527878659,0.6356981981981982,43.36622807017543,1026.535087719297,27.744191559981,0
2426,4,0,0,41,0.0,0.0,1.0,41,1150,700,450,0.6086956521739131,16,7,9,338.4451005043943,0.42032520325203254,0.057230979230651347,0.20043399595336137,131749.92696069932,718.0234543320898,132467.9504150314,2038,6,324.5365853658537,37,4,19,34.65224376090284,0.6359797297297297,43.33881578947368,1026.6447368421043,27.747155049786603,0
2427,4,0,0,41,0.0,0.0,1.0,41,1050,800,250,0.7619047619047619,13,8,5,341.1063930220618,0.4205030487804878,0.05875949854950191,0.20245896559218168,131834.36850761753,793.9091835949312,132628.27769121245,2039,7,325.5365853658537,37,4,19,34.498896718627655,0.6368243243243243,43.25657894736841,1026.9736842105249,27.756045519203376,0
2428,4,0,0,41,0.0,0.0,1.0,41,1800,1500,300,0.8333333333333334,21,15,6,342.2223277989769,0.4201981707317073,0.06198880539288898,0.20378650937726034,131958.55391418256,831.8326986996442,132790.3866128822,2040,8,326.5365853658537,38,3,19,34.34521333749263,0.6362390350877193,43.13568376068374,1027.457264957262,27.038349077822684,0
2429,4,0,0,41,0.0,0.0,1.0,41,1050,700,350,0.6666666666666666,14,7,7,348.63809168009993,0.4197154471544715,0.06106939888771201,0.20835998249353507,132095.8034279345,1010.725765212909,133106.5291931474,2041,9,327.5365853658537,38,3,19,34.04221229127694,0.637609649122807,43.002136752136735,1027.9914529914502,27.052406657669742,0
2430,4,0,0,41,0.0,0.0,1.0,41,1050,900,150,0.8571428571428571,12,9,3,355.1157353156832,0.4189532520325203,0.05776530027922333,0.21284832304786813,132205.6544031702,1189.6616352545605,133395.31603842476,2042,10,328.5365853658537,38,3,19,33.765106655585555,0.6387061403508771,42.895299145299134,1028.4188034188016,27.063652721547413,0
2431,4,0,0,41,0.0,0.0,1.0,41,1350,800,550,0.5925925925925926,19,8,11,359.6439301515354,0.4183689024390244,0.058524732255523126,0.21620225794928233,132317.61203341992,1317.4452039930304,133635.05723741296,2043,11,329.5365853658537,39,2,20,33.53592943201377,0.6380876068376069,42.78645833333332,1028.854166666665,26.380876068376022,0
2432,4,1,1,41,0.023809523809523808,0.023809523809523808,0.9761904761904762,42,1000,500,500,0.5,15,5,10,351.21157958560883,0.41999370886566006,0.07294881345110094,0.2133377642770502,132708.51518015162,921.8266903638596,133630.3418705155,2044,0,322.6666666666667,37,5,18,33.35982671774678,0.6455518018018018,42.406798245614034,1030.3728070175441,27.847913703176868,0
2433,4,0,0,41,0.0,0.0,1.0,41,900,500,400,0.5555555555555556,13,5,8,351.0023801124968,0.41852134146341463,0.05979928564573278,0.21417750682659373,132878.03849501783,1128.1015552862527,134006.1400503041,2045,1,320.9024390243902,37,4,18,33.194968804282325,0.647240990990991,42.242324561403514,1031.0307017543869,27.865694642010457,0
2434,4,0,0,41,0.0,0.0,1.0,41,1050,600,450,0.5714285714285714,15,6,9,349.30921892508763,0.41801321138211384,0.05475299004077683,0.21370286435378955,132975.889628534,1089.9408284023823,134065.83045693638,2046,2,321.9024390243902,38,3,18,33.14040812098612,0.6463815789473684,42.147435897435905,1031.4102564102575,27.142375168690986,0
2435,4,0,0,41,0.0,0.0,1.0,41,1350,1000,350,0.7407407407407407,17,10,7,346.49155176191175,0.41770833333333335,0.04256802145573735,0.2126058073009241,133086.1058605451,1022.6422675140755,134108.74812805917,2047,3,322.9024390243902,38,3,18,33.10252295161179,0.6474780701754386,42.0405982905983,1031.8376068376078,27.15362123256863,0
2436,4,0,0,41,0.0,0.0,1.0,41,1000,600,400,0.6,14,6,8,346.4097858935347,0.41773373983739837,0.04308497075240947,0.21302768564719565,133168.7979970233,1026.1949603696555,134194.99295739294,2048,4,323.9024390243902,38,3,18,33.021728254494,0.6483004385964912,41.96047008547009,1032.1581196581208,27.162055780476862,0
2437,4,0,0,41,0.0,0.0,1.0,41,1450,1000,450,0.6896551724137931,19,10,9,346.9705674172869,0.4170477642276423,0.050703244462612096,0.214164591612739,133306.67529585792,1050.6985535831625,134357.37384944106,2049,5,324.9024390243902,38,3,19,32.869077177736386,0.649671052631579,41.82692307692307,1032.6923076923072,27.17611336032387,0
2438,4,0,0,41,0.0,0.0,1.0,41,1250,900,350,0.72,16,9,7,345.05207525700797,0.4167174796747968,0.05643806593184886,0.2136141848742166,133417.0284991598,1007.1645116516813,134424.19301081146,2050,6,325.9024390243902,38,3,19,32.80808341951052,0.6507675438596492,41.720085470085465,1033.119658119657,27.187359424201503,0
2439,4,0,1,40,0.0,0.024390243902439025,0.975609756097561,41,1100,700,400,0.6363636363636364,15,7,8,347.58937102659434,0.416234756097561,0.05301656862324822,0.2156659388030945,133499.82336410615,1080.6239270582141,134580.44729116437,2051,7,326.9024390243902,38,3,19,32.6596367896895,0.6515899122807017,41.63995726495726,1033.4401709401704,27.195793972109747,0
2440,4,0,0,40,0.0,0.0,1.0,40,1150,900,250,0.782608695652174,14,9,5,349.60812642263164,0.414823717948718,0.07160549485520318,0.21725483241833513,133557.21381819382,1338.5374586410935,134895.75127683493,2052,8,334.6,37,3,19,32.55001149181428,0.6539977477477478,41.58442982456139,1033.6622807017525,27.936818397344663,0
2441,4,0,0,40,0.0,0.0,1.0,40,900,600,300,0.6666666666666666,12,6,6,350.2159687556584,0.41467681623931624,0.06922057264050929,0.21813319586300217,133642.23246575834,1360.7287819328674,135002.96124769122,2053,9,335.6,37,3,19,32.44918699186992,0.6548423423423424,41.50219298245612,1033.9912280701726,27.94570886676142,0
2442,4,0,0,40,0.0,0.0,1.0,40,1450,800,650,0.5517241379310345,21,8,13,346.5099814113191,0.41348824786324784,0.06645733969263401,0.21665484921244463,133783.99032635006,1271.4976002231058,135055.48792657317,2054,10,336.6,37,3,16,32.40317523405757,0.65625,41.36513157894735,1034.5394736842077,27.960526315789398,0
2443,4,0,0,40,0.0,0.0,1.0,40,1150,800,350,0.6956521739130435,15,8,7,342.36733520297753,0.41247329059829063,0.05384757970553955,0.2150558889987561,133954.1989482337,1172.308426631229,135126.50737486494,2055,11,337.6,37,3,16,32.34021378385056,0.6579391891891893,41.20065789473682,1035.1973684210498,27.978307254622965,0
2444,4,0,0,40,0.0,0.0,1.0,40,1250,1100,150,0.88,14,11,3,362.03520077113654,0.4122729700854701,0.061240350511162056,0.21084261449526814,131109.19922017667,1493.229052523916,132602.42827270058,2056,12,338.6,38,2,17,34.694258988803114,0.6277412280701755,43.96367521367521,1024.1452991452984,26.951192082771012,8
2445,4,1,0,41,0.024390243902439025,0.0,1.0,41,1150,900,250,0.782608695652174,14,9,5,352.68162066191064,0.41468495934959354,0.06845831607987973,0.20760859840435325,131519.83486969452,1077.1083305938926,132596.9432002884,2057,0,331.3170731707317,38,3,18,34.518973718015474,0.6318530701754386,43.56303418803418,1025.7478632478621,26.993364822312163,0
2446,4,0,0,41,0.0,0.0,1.0,41,950,500,450,0.5263157894736842,14,5,9,354.85707129483797,0.4146341463414634,0.06965158970765217,0.2096406535583156,131656.8560979618,1143.873274161728,132800.72937212355,2058,1,332.3170731707317,38,3,15,34.32490110347699,0.6332236842105263,43.429487179487175,1026.2820512820508,27.007422402159232,0
2447,4,0,0,41,0.0,0.0,1.0,41,1250,1000,250,0.8,15,10,5,356.7809175151812,0.4141514227642276,0.07119849531308353,0.21123276872479174,131739.1030777447,1200.399613740939,132939.50269148563,2059,2,333.3170731707317,38,3,16,34.192553855760224,0.634046052631579,43.349358974358964,1026.6025641025624,27.01585695006743,0
2448,4,0,0,41,0.0,0.0,1.0,41,1550,1400,150,0.9032258064516129,17,14,3,355.9690294591105,0.4136432926829268,0.058141835838994904,0.21151336521754555,131876.23844875436,1188.771321864257,133065.0097706186,2060,3,334.3170731707317,38,3,17,34.075090146314395,0.6354166666666667,43.21581196581196,1027.1367521367513,27.029914529914507,0
2449,4,0,0,41,0.0,0.0,1.0,41,1450,1200,250,0.8275862068965517,17,12,5,356.19521206533165,0.41283028455284554,0.05436220855661045,0.21287641804301996,132095.80342793482,1210.3785429907175,133306.18197092554,2061,4,335.3170731707317,38,3,17,33.84799591214577,0.637609649122807,43.00213675213675,1027.9914529914527,27.052406657669806,0
2450,4,0,0,41,0.0,0.0,1.0,41,650,400,250,0.6153846153846154,9,4,5,351.4580131556754,0.41265243902439025,0.05017928413050399,0.21050301036859836,132178.18737900865,1091.0166237489918,133269.20400275764,2062,5,336.3170731707317,38,3,17,33.886796536796524,0.6384320175438596,42.922008547008545,1028.3119658119656,27.060841205578043,0
2451,4,0,0,41,0.0,0.0,1.0,41,1250,1000,250,0.8,15,10,5,353.2438543880592,0.41183943089430897,0.05177418129321487,0.212343215840013,132315.55103550287,1147.9310486521917,133463.48208415505,2063,6,337.3170731707317,38,3,17,33.702622014537894,0.6398026315789473,42.78846153846153,1028.8461538461531,27.07489878542508,0
2452,4,0,1,40,0.0,0.024390243902439025,0.975609756097561,41,1400,1000,400,0.7142857142857143,18,10,8,354.15499138374236,0.4122205284552845,0.04783879909375144,0.213668337005783,132452.98603121104,1181.7772253268872,133634.76325653793,2064,7,338.3170731707317,38,3,19,33.54090987718387,0.6411732456140351,42.65491452991452,1029.3803418803407,27.08895636527212,0
2453,4,0,0,40,0.0,0.0,1.0,40,1050,500,550,0.47619047619047616,16,5,11,356.2176588723886,0.4106837606837607,0.06039182282793898,0.2155667688227752,132567.32840874104,1444.5646737457569,134011.8930824868,2065,8,345.825,37,3,19,33.372817291311755,0.6441441441441442,42.5438596491228,1029.824561403508,27.833096254148863,0
2454,4,0,1,39,0.0,0.025,0.975,40,1200,900,300,0.75,15,9,6,353.8280071882453,0.41012286324786323,0.06659838246248828,0.21492707068829608,132708.51518015156,1391.197892620806,134099.71307277237,2066,9,346.825,37,3,15,33.29242932141464,0.6455518018018018,42.406798245614034,1030.3728070175437,27.847913703176857,0
2455,4,0,1,38,0.0,0.02564102564102564,0.9743589743589743,39,1000,700,300,0.7,13,7,6,361.0938710748659,0.40935672514619886,0.06872164734693431,0.21955946938246493,132745.92318247302,1786.7478542731958,134532.6710367462,2067,10,353.8974358974359,36,3,15,33.067651987032384,0.6478587962962963,42.3704954954955,1030.5180180180182,28.625500500500507,0
2456,4,0,0,38,0.0,0.0,1.0,38,1450,1000,450,0.6896551724137931,19,10,9,356.1955733938327,0.40820590327169276,0.08586758476402845,0.2175905847609957,132920.05423920543,1869.1069870546248,134789.16122626007,2068,11,360.7631578947368,36,2,16,33.018910851443344,0.6495949074074074,42.20157657657658,1031.1936936936938,28.644269269269273,0
2457,4,0,0,38,0.0,0.0,1.0,38,1150,800,350,0.6956521739130435,15,8,7,356.1955733938327,0.40820590327169276,0.08586758476402845,0.2175905847609957,132920.05423920543,1869.1069870546248,134789.16122626007,2069,12,361.7631578947368,36,2,16,33.018910851443344,0.6495949074074074,42.20157657657658,1031.1936936936938,28.644269269269273,0
2458,4,0,1,37,0.0,0.02631578947368421,0.9736842105263158,38,1000,800,200,0.8,12,8,4,352.25850075476114,0.40759838786154573,0.08106664522502216,0.21636038209896982,133123.35139193246,1778.766435354269,134902.11782728674,2070,13,362.7631578947368,36,2,17,32.91639386003201,0.6516203703703703,42.0045045045045,1031.9819819819818,28.66616616616616,0
2459,4,0,0,37,0.0,0.0,1.0,37,650,400,250,0.6153846153846154,9,4,5,359.17118185715344,0.40628128128128127,0.0896210393517396,0.2198443387850927,132994.25582990394,2153.5408093278384,135147.7966392318,2071,14,372.43243243243245,35,2,17,32.86766906044285,0.6523809523809524,42.129629629629626,1031.481481481481,29.470899470899457,0
2460,4,0,1,36,0.0,0.02702702702702703,0.972972972972973,37,1450,1200,250,0.8275862068965517,17,12,5,358.860419863535,0.40581206206206205,0.08110835356042223,0.22088861868618814,133203.26063368042,2160.275607638878,135363.5362413193,2072,15,373.43243243243245,35,2,18,32.665867810292646,0.6544642857142857,41.92708333333333,1032.2916666666656,29.49404761904759,0
2461,4,0,0,36,0.0,0.0,1.0,36,1150,800,350,0.6956521739130435,15,8,7,369.0284229006956,0.40150462962962963,0.08522960229602283,0.22728796046838315,133226.3038548754,2632.8585600907177,135859.16241496612,2073,29,384.3888888888889,34,2,18,32.38031403751538,0.6568627450980392,41.90476190476191,1032.3809523809534,30.364145658263336,0
2462,4,0,0,36,0.0,0.0,1.0,36,900,600,300,0.6666666666666666,12,6,6,367.2624408375209,0.4009424603174603,0.08337174906841827,0.22713729145738934,133379.97626133796,2597.0911281179247,135977.0673894559,2074,30,385.3888888888889,34,2,18,32.27161845491912,0.6583946078431373,41.75595238095239,1032.9761904761913,30.38165266106445,0
2463,4,0,0,36,0.0,0.0,1.0,36,950,700,250,0.7368421052631579,12,7,5,369.16186932258137,0.3999007936507937,0.0844275512554713,0.22926061154925978,133533.7372448979,2659.1128117913763,136192.8500566893,2075,31,386.3888888888889,34,2,18,32.06826384089689,0.6599264705882353,41.607142857142854,1033.571428571428,30.39915966386553,0
2464,4,0,0,36,0.0,0.0,1.0,36,1150,800,350,0.6956521739130435,15,8,7,381.8767787431534,0.3993386243386243,0.06978256949274808,0.2265522072516121,131816.6737528344,2883.9285714285616,134700.60232426296,2076,32,387.3888888888889,34,2,16,33.470032460004624,0.6427696078431373,43.27380952380952,1026.9047619047615,30.203081232492984,8
2465,4,0,0,36,0.0,0.0,1.0,36,500,200,300,0.4,8,2,6,380.03565280767987,0.3990079365079365,0.06831762221191973,0.22582283832125774,131877.80612244902,2823.6536281179174,134701.45975056695,2077,33,388.3888888888889,34,2,16,33.455513058259925,0.6433823529411764,43.214285714285715,1027.1428571428576,30.21008403361346,0
2466,4,0,1,35,0.0,0.027777777777777776,0.9722222222222222,36,1200,1000,200,0.8333333333333334,14,10,4,382.48980451641887,0.39818121693121694,0.07079600453094415,0.22801464037194244,132000.11337868482,2897.739512471655,134897.85289115648,2078,34,389.3888888888889,34,2,16,33.26889287920913,0.6446078431372548,43.095238095238095,1027.6190476190477,30.224089635854344,0
2467,4,0,0,35,0.0,0.0,1.0,35,850,600,250,0.7058823529411765,11,6,5,368.2418178732676,0.39824929971988793,0.05587925587925624,0.20530742448550662,129413.28124999988,2539.239654194998,131952.52090419488,2079,35,394.0285714285714,34,1,21,36.25784875784876,0.6185661764705883,45.62499999999999,1017.4999999999991,29.92647058823527,7
2468,4,0,0,35,0.0,0.0,1.0,35,800,600,200,0.75,10,6,4,366.5759882907458,0.39775910364145656,0.050413485473712605,0.20500923975632204,129534.44054705203,2496.843112244881,132031.2836592969,2080,36,395.0285714285714,34,1,15,36.17681167894594,0.6197916666666667,45.50595238095237,1017.9761904761895,29.94047619047616,0
2469,4,1,0,36,0.027777777777777776,0.0,1.0,36,900,600,300,0.6666666666666666,12,6,6,357.5273407627944,0.4020337301587302,0.05479866787768728,0.20186543701530066,129908.3719135801,2089.158950617263,131997.53086419735,2081,0,385.02777777777777,35,1,18,36.02690735694821,0.6214285714285714,45.13888888888888,1019.4444444444432,29.12698412698409,0
2470,4,0,0,36,0.0,0.0,1.0,36,1100,800,300,0.7272727272727273,14,8,6,357.6119969826001,0.4013723544973545,0.05853478606287643,0.20237118210749439,129996.88042534712,2097.6888020833235,132094.56922743045,2082,1,386.02777777777777,35,1,20,35.934839972761324,0.6223214285714286,45.05208333333333,1019.7916666666657,29.136904761904734,0
2471,4,0,0,36,0.0,0.0,1.0,36,950,800,150,0.8421052631578947,11,8,3,358.14719212501024,0.4001818783068783,0.0511848490577933,0.20328831285138185,130114.93866008637,2120.0599869255593,132234.99864701193,2083,2,387.02777777777777,35,1,20,35.801309321232736,0.6235119047619048,44.93634259259258,1020.2546296296279,29.150132275132226,0
2472,4,0,0,36,0.0,0.0,1.0,36,1050,800,250,0.7619047619047619,13,8,5,358.0312461145043,0.399702380952381,0.05673370126760924,0.20368513085404472,130203.51750042844,2123.3855238339925,132326.90302426243,2084,3,388.02777777777777,35,1,20,35.71435321690482,0.6244047619047619,44.849537037037024,1020.6018518518499,29.160052910052855,0
2473,4,1,0,37,0.02702702702702703,0.0,1.0,37,900,500,400,0.5555555555555556,13,5,8,340.86075962458625,0.40387262262262263,0.04143017377809888,0.1905829867068175,129525.1833231526,1501.410724236986,131026.59404738958,2085,0,378.5135135135135,35,2,16,36.840652833049084,0.6175595238095238,45.515046296296305,1017.9398148148161,29.083994708994748,8
2474,4,0,0,37,0.0,0.0,1.0,37,1300,900,400,0.6923076923076923,17,9,8,339.9101786934031,0.40362237237237236,0.03893661738136478,0.19019401601699593,129554.63927469144,1407.3881172839579,130962.0273919754,2086,1,379.5135135135135,35,2,16,36.83492496589357,0.6178571428571429,45.486111111111114,1018.0555555555562,29.087301587301607,0
2475,4,0,0,37,0.0,0.0,1.0,37,900,700,200,0.7777777777777778,11,7,4,342.6950037367093,0.4032782782782783,0.045392136084260404,0.19218440649326357,129643.02722318674,1485.603539737658,131128.6307629244,2087,2,380.5135135135135,35,2,16,36.67426696215479,0.61875,45.39930555555556,1018.4027777777778,29.097222222222225,0
2476,4,0,1,36,0.0,0.02702702702702703,0.972972972972973,37,1000,800,200,0.8,12,8,4,339.6370538266644,0.4026839339339339,0.0410516137943735,0.1913310466374782,129819.89354263128,1418.3292341821098,131238.2227768134,2088,3,381.5135135135135,35,2,17,36.572614991482126,0.6205357142857143,45.22569444444445,1019.0972222222231,29.117063492063515,0
2477,4,0,0,36,0.0,0.0,1.0,36,800,500,300,0.625,11,5,6,348.8214343314064,0.4021494708994709,0.03689205681493535,0.1961375712883168,129746.6057256238,1851.6794217687288,131598.28514739254,2089,4,387.4166666666667,34,2,17,36.41305406247565,0.6219362745098039,45.29761904761906,1018.8095238095256,29.96498599439781,0
2478,4,0,0,36,0.0,0.0,1.0,36,900,600,300,0.6666666666666666,12,6,6,350.87238396795124,0.40216600529100527,0.03227491596256904,0.19774973529622347,129837.58680555572,1911.2847222222413,131748.87152777796,2090,5,388.4166666666667,34,2,17,36.26839738348323,0.6228553921568627,45.20833333333334,1019.166666666668,29.97549019607847,0
2479,4,0,2,34,0.0,0.05555555555555555,0.9444444444444444,36,1150,900,250,0.782608695652174,14,9,5,349.00001921616524,0.4017526455026455,0.035635559704879416,0.19792065947473994,130080.35891439913,1879.6095521541956,131959.9684665533,2091,6,389.4166666666667,34,2,18,36.06969891469249,0.6253063725490196,44.970238095238095,1020.1190476190479,30.003501400560232,0
2480,4,0,1,33,0.0,0.029411764705882353,0.9705882352941176,34,950,600,350,0.631578947368421,13,6,7,358.20593236739023,0.3958333333333333,0.07148682696648834,0.20291637599325232,130037.12153096625,2516.013672074279,132553.13520304053,2092,7,411.11764705882354,32,2,18,35.87882726747543,0.6295572916666667,45.01262626262626,1019.9494949494951,31.873421717171723,0
2481,4,0,0,33,0.0,0.0,1.0,33,950,800,150,0.8421052631578947,11,8,3,365.3594834714633,0.39595170454545453,0.07087984774990108,0.2071075393281799,130063.2815890843,2903.9706759982746,132967.25226508258,2093,8,416.969696969697,31,2,20,35.669836609650226,0.6323924731182795,44.98697916666667,1020.0520833333342,32.904905913978524,0
2482,4,0,0,33,0.0,0.0,1.0,33,550,400,150,0.7272727272727273,7,4,3,366.0689326708342,0.39571496212121215,0.07415484434751995,0.20804077051061132,130162.91512383366,2929.719882541243,133092.6350063749,2094,9,417.969696969697,31,2,20,35.55051358938369,0.6334005376344086,44.88932291666667,1020.4427083333343,32.91750672043014,0
2483,4,0,1,32,0.0,0.030303030303030304,0.9696969696969697,33,750,400,350,0.5333333333333333,11,4,7,367.0740990015523,0.3964251893939394,0.0721739912734467,0.20897373354426405,130230.36552392619,2960.83881746761,133191.2043413938,2095,10,418.969696969697,32,1,20,35.456354115124526,0.6315104166666667,44.823232323232325,1020.7070707070712,31.897095959595976,0
2484,4,0,0,32,0.0,0.0,1.0,32,1100,800,300,0.7272727272727273,14,8,6,374.1816998338319,0.39411122311827956,0.08124361919346579,0.21247013042738458,130129.69970703126,3338.4304470486118,133468.13015407987,2096,11,429.28125,31,1,20,35.377318359707324,0.6330645161290323,44.921875,1020.3125000000001,32.913306451612904,0
2485,4,1,0,33,0.030303030303030304,0.0,1.0,33,1000,800,200,0.8,12,8,4,365.0676522505923,0.3963857323232323,0.07747411672478544,0.20925389826226437,130495.30241224507,2927.9905531141553,133423.29296535923,2097,0,417.24242424242425,31,2,15,35.23865277600781,0.636760752688172,44.563802083333336,1021.7447916666672,32.959509408602166,0
2486,4,0,0,33,0.0,0.0,1.0,33,700,500,200,0.7142857142857143,9,5,4,366.83739262085635,0.39634627525252525,0.0766688289624069,0.21044881997722814,130528.56445312501,2976.5516493055566,133505.11610243056,2098,1,418.24242424242425,31,2,15,35.15970098538907,0.6370967741935484,44.53125,1021.8750000000001,32.96370967741936,0
2487,4,1,0,34,0.029411764705882353,0.0,1.0,34,950,600,350,0.631578947368421,13,6,7,356.275684122206,0.4000482768865122,0.0805774925962488,0.20623272458045425,130875.54841342728,2525.5551091725447,133401.10352259982,2099,0,406.9117647058824,32,2,16,35.07809929253045,0.6380208333333333,44.1919191919192,1023.2323232323239,31.97601010101012,0
2488,4,1,0,35,0.02857142857142857,0.0,1.0,35,600,400,200,0.6666666666666666,8,4,4,345.7267234964285,0.40378151260504197,0.0803413694627082,0.20153338272108895,131145.15306122456,2068.076814058962,133213.22987528352,2100,0,396.25714285714287,34,1,17,35.07549783046643,0.6360294117647058,43.92857142857143,1024.285714285715,30.126050420168085,0
2489,4,0,1,34,0.0,0.02857142857142857,0.9714285714285714,35,900,600,300,0.6666666666666666,12,6,6,347.5070415175301,0.4033963585434173,0.08191051513542247,0.20321607427872954,131267.1201814058,2123.2497165532736,133390.36989795908,2101,1,397.25714285714287,34,1,19,34.90672436493184,0.6372549019607843,43.8095238095238,1024.761904761904,30.140056022408938,0
2490,4,0,0,34,0.0,0.0,1.0,34,850,300,550,0.35294117647058826,14,3,11,355.58348975768257,0.4029263220439691,0.07356106757460212,0.20792931058417796,131265.32613658224,2535.156550365261,133800.4826869475,2102,2,392.0882352941176,33,1,19,34.701626405166216,0.639520202020202,43.81127450980393,1024.7549019607854,31.05317884729653,0
2491,4,0,0,34,0.0,0.0,1.0,34,900,700,200,0.7777777777777778,11,7,4,357.59138079185664,0.40255496137849084,0.07771401243424214,0.2094463801780876,131328.12500000012,2592.3611111111245,133920.48611111124,2103,3,393.0882352941176,33,1,19,34.58672086720866,0.6401515151515151,43.75000000000001,1025.000000000001,31.060606060606087,0
2492,4,0,0,34,0.0,0.0,1.0,34,550,300,250,0.5454545454545454,8,3,5,357.59138079185664,0.40255496137849084,0.07771401243424214,0.2094463801780876,131328.12500000012,2592.3611111111245,133920.48611111124,2104,4,394.0882352941176,33,1,19,34.58672086720866,0.6401515151515151,43.75000000000001,1025.000000000001,31.060606060606087,0
2493,4,0,0,34,0.0,0.0,1.0,34,1100,900,200,0.8181818181818182,13,9,4,357.7549807080975,0.40203505644682114,0.07613010721529978,0.2098967083345198,131392.84256708508,2601.2887715539327,133994.131338639,2105,5,395.0882352941176,32,2,19,34.517138752052524,0.6432291666666667,43.68686868686869,1025.252525252526,32.03914141414144,0
2494,4,1,3,32,0.02857142857142857,0.08571428571428572,0.9142857142857143,35,1000,800,200,0.8,12,8,4,392.12602309859005,0.4039915966386554,0.08175500353831366,0.22987402679487734,131361.4930046931,3475.300392950351,134836.79339764346,2106,0,384.77142857142854,31,4,16,33.66794212286718,0.645497311827957,43.71744791666668,1025.1302083333348,33.068716397849514,8
2495,4,1,0,33,0.030303030303030304,0.0,1.0,33,1050,800,250,0.7619047619047619,13,8,5,403.1991539427587,0.3982402146464647,0.10766198571076635,0.23615950445218742,131328.12500000012,3990.2777777777924,135318.4027777779,2107,0,408.3939393939394,30,3,19,33.41802168021679,0.6479166666666667,43.75000000000001,1025.000000000001,34.1666666666667,0
2496,4,0,0,33,0.0,0.0,1.0,33,700,500,200,0.7142857142857143,9,5,4,402.2832357267813,0.39816130050505055,0.10902257132754078,0.2358350683234559,131362.56946251012,3968.9918993525303,135331.56136186264,2108,1,409.3939393939394,30,3,19,33.40653817577903,0.6482638888888889,43.71639784946237,1025.1344086021506,34.17114695340502,0
2497,4,0,0,33,0.0,0.0,1.0,33,850,700,150,0.8235294117647058,10,7,3,377.0862182247438,0.3976878156565657,0.08960302603991055,0.21105491340724913,129565.68611992725,3171.4869181315053,132737.17303805877,2109,2,410.3939393939394,31,2,18,35.87748326725498,0.6273521505376345,45.475260416666664,1018.0989583333329,32.84190188172042,8
2498,4,1,0,34,0.029411764705882353,0.0,1.0,34,800,300,500,0.375,13,3,10,376.1896408052279,0.401403743315508,0.1022594468250877,0.1958780543503081,126672.22222222206,2730.5555555555316,129402.77777777759,2110,0,399.29411764705884,34,0,15,38.86589403973509,0.5906862745098039,48.33333333333332,1006.6666666666653,29.60784313725486,8
2499,4,0,0,34,0.0,0.0,1.0,34,800,300,500,0.375,13,3,10,379.29123324755324,0.40203505644682114,0.1078827443524939,0.19183383527712758,125476.64399092953,2718.438208616755,128195.08219954629,2111,1,400.29411764705884,34,0,16,40.02346720532317,0.5784313725490196,49.52380952380951,1001.9047619047604,29.467787114845894,8
2500,4,1,1,34,0.02857142857142857,0.02857142857142857,0.9714285714285714,35,700,600,100,0.8571428571428571,8,6,2,379.2426078449753,0.4048319327731092,0.13921407160973698,0.1941883341468307,125985.73200660138,2555.831511488323,128541.56351808971,2112,0,389.8285714285714,35,0,18,39.49782876027976,0.581547619047619,49.016203703703695,1003.9351851851841,28.6838624338624,0
2501,4,2,2,34,0.05555555555555555,0.05555555555555555,0.9444444444444444,36,950,800,150,0.8421052631578947,11,8,3,376.88374059345557,0.414781746031746,0.14222271980892698,0.1952625041172124,126468.25034493943,2332.765451262062,128801.0157962015,2113,0,374.25,36,0,16,39.05876809971638,0.5844907407407407,48.53603603603603,1005.855855855855,27.940440440440415,0
2502,4,4,2,36,0.10526315789473684,0.05263157894736842,0.9473684210526316,38,1250,800,450,0.64,17,8,9,353.32785206754085,0.42604611190137504,0.1513345924353593,0.1869965388505354,127334.51727892834,1398.1662968441804,128732.68357577252,2114,0,350.7368421052632,38,0,17,38.760982322430394,0.5896381578947368,47.67628205128205,1009.2948717948718,26.560391363022944,0
2503,4,0,1,35,0.0,0.027777777777777776,0.9722222222222222,36,650,500,150,0.7692307692307693,8,5,3,370.02579939800023,0.42037037037037034,0.15683025518816374,0.19439383545838643,127035.24470416392,2201.263594675791,129236.50829883972,2115,1,371.22222222222223,36,0,19,38.64732275841526,0.5902777777777778,47.97297297297299,1008.1081081081106,28.003003003003073,0
2504,4,1,2,34,0.027777777777777776,0.05555555555555555,0.9444444444444444,36,1200,800,400,0.6666666666666666,16,8,8,358.7058093132067,0.41944444444444445,0.0933089842973569,0.18739864243559087,126808.29478126758,1897.3744014284412,128705.66918269603,1596,0,313.44444444444446,36,0,18,39.16592128801431,0.587962962962963,48.19819819819819,1007.2072072072058,27.97797797797794,8
2505,4,2,0,36,0.05555555555555555,0.0,1.0,36,1200,700,500,0.5833333333333334,17,7,10,367.08402475884293,0.416468253968254,0.13944979858242879,0.1936745980507308,127208.74592764053,2139.5767279416496,129348.32265558217,1597,0,314.27777777777777,35,1,20,38.54310081076946,0.594047619047619,47.800925925925924,1008.7962962962957,28.822751322751305,0
2506,4,1,0,37,0.02702702702702703,0.0,1.0,37,1000,700,300,0.7,13,7,6,356.55479866618424,0.420482982982983,0.1375274940492328,0.1896973039167066,127546.62390430974,1695.4721613505412,129242.09606566028,1598,0,306.7567567567568,36,1,17,38.46200297287252,0.5954861111111112,47.46621621621622,1010.1351351351354,28.059309309309317,0
2507,4,2,0,39,0.05128205128205128,0.0,1.0,39,800,500,300,0.625,11,5,6,349.7265002127232,0.42732231219073324,0.15894784963252073,0.18910767230555642,128198.62349559872,1166.891185440871,129365.51468103958,1599,0,291.97435897435895,38,1,19,37.9672609628301,0.5984100877192983,46.8215811965812,1012.7136752136757,26.6503598740441,0
2508,4,2,1,40,0.04878048780487805,0.024390243902439025,0.975609756097561,41,1000,700,300,0.7,13,7,6,338.29949232875146,0.4321138211382114,0.16563086303939967,0.18517445895889578,128685.30636525893,506.8347627074021,129192.14112796633,1600,0,278.6829268292683,40,1,14,37.76020799946582,0.6,46.341463414634156,1014.6341463414647,25.365853658536615,0
2509,4,1,0,41,0.024390243902439025,0.0,1.0,41,1300,1000,300,0.7692307692307693,16,10,6,342.546697528658,0.42980182926829263,0.1836797953689533,0.18859885115172928,128917.4156937838,632.0469999669889,129549.46269375079,1601,0,279.6341463414634,40,1,16,37.41598285466494,0.60234375,46.1128048780488,1015.5487804878076,25.388719512195188,0
2510,4,0,0,41,0.0,0.0,1.0,41,1200,900,300,0.75,15,9,6,341.45230721340124,0.4294461382113821,0.18061858889897375,0.18836408735679705,128994.83194527088,609.1165972635526,129603.94854253443,1602,1,280.6341463414634,40,1,17,37.364945978391354,0.603125,46.03658536585367,1015.8536585365871,25.39634146341468,0
2511,4,2,1,42,0.046511627906976744,0.023255813953488372,0.9767441860465116,43,800,500,300,0.625,11,5,6,331.7038983632577,0.4328857511997047,0.19353685266364495,0.18539878604946372,129511.53413973171,-7.773357459178442,129503.76078227253,1603,0,268.5348837209302,40,3,14,37.08753494408947,0.6083333333333334,45.52845528455285,1017.8861788617892,25.447154471544728,0
2512,4,1,0,43,0.023255813953488372,0.0,1.0,43,1250,1000,250,0.8,15,10,5,332.25945137779235,0.43087855297157623,0.19667334052056007,0.18663238767763535,129706.17992567405,19.220836482744744,129725.40076215679,1604,0,269.3720930232558,41,2,15,36.87589274120243,0.608739837398374,45.33730158730159,1018.6507936507943,24.84514130855596,0
2513,4,0,0,43,0.0,0.0,1.0,43,1150,600,550,0.5217391304347826,17,6,11,339.81918595748095,0.43020948689553346,0.20234414258616273,0.19161922703222584,129857.80915375393,225.63499937010357,130083.44415312403,1605,1,270.3720930232558,41,2,15,36.52950814353384,0.6102642276422765,45.188492063492056,1019.2460317460304,24.85965931087879,0
2514,4,1,0,44,0.022727272727272728,0.0,1.0,44,1050,600,450,0.5714285714285714,15,6,9,333.90818436719053,0.43242380197322056,0.20982042648709354,0.18964688141243338,130138.96869929685,-109.10664923983313,130029.86205005701,1606,0,265.20454545454544,42,2,16,36.39522000633113,0.6116071428571428,44.91279069767442,1020.3488372093018,24.294019933554804,0
2515,4,2,3,43,0.043478260869565216,0.06521739130434782,0.9347826086956522,46,850,400,450,0.47058823529411764,13,4,9,327.6070114699945,0.4366445249597424,0.22888297504665833,0.18905028460057466,130755.83316808754,-632.4597162125433,130123.373451875,1607,0,254.6304347826087,40,6,13,35.932324788023294,0.6208333333333333,44.30894308943088,1022.7642276422746,25.569105691056865,0
2516,4,0,0,43,0.0,0.0,1.0,43,1000,700,300,0.7,13,7,6,350.8444775960361,0.4294250645994832,0.23733112324882444,0.20076579565630648,130430.54112803932,552.1670129270468,130982.70814096637,1608,1,273.06976744186045,37,6,18,35.66757907542579,0.6227477477477478,44.62719298245614,1021.4912280701748,27.607871028923643,0
2517,4,0,0,43,0.0,0.0,1.0,43,1000,900,100,0.9,11,9,2,349.3974972308812,0.42937892211148027,0.2372407527125957,0.200082143927481,130458.54403518373,516.3777556555652,130974.9217908393,1609,2,274.06976744186045,37,6,18,35.67616096025187,0.6230292792792793,44.599780701754376,1021.6008771929811,27.61083451872922,0
2518,4,0,1,42,0.0,0.023255813953488372,0.9767441860465116,43,1200,1000,200,0.8333333333333334,14,10,4,352.32091215531705,0.4293558508674788,0.24512426389859288,0.20219402101524334,130542.57079101249,598.575523237905,131141.1463142504,1610,3,275.06976744186045,37,6,14,35.51636266094421,0.6238738738738738,44.517543859649116,1021.9298245614025,27.619724988146015,0
2519,4,0,1,41,0.0,0.023809523809523808,0.9761904761904762,42,800,400,400,0.5,12,4,8,356.7875186796666,0.4275914634146341,0.23944169362132683,0.20460940840466527,130514.55886667038,913.1931219221144,131427.7519885925,1611,4,282.07142857142856,37,5,14,35.43063901706191,0.6235923423423424,44.54495614035087,1021.8201754385955,27.616761498340416,0
2520,4,0,0,41,0.0,0.0,1.0,41,1700,1400,300,0.8235294117647058,20,14,6,359.43105955639675,0.42550813008130084,0.24248399549751665,0.20692927011493487,130665.25298524862,1193.0300655384963,131858.2830507871,1612,5,288.8292682926829,36,5,14,35.210375592025564,0.627025462962963,44.397522522522515,1022.4099099099087,28.40027527527524,0
2521,4,0,0,41,0.0,0.0,1.0,41,1200,1000,200,0.8333333333333334,14,10,4,358.40569964833344,0.4248475609756098,0.2412121016850861,0.2071092478120522,130809.21292914535,1176.5534960636337,131985.76642520897,1613,6,289.8292682926829,36,5,15,35.09077315426392,0.6284722222222222,44.25675675675676,1022.9729729729729,28.415915915915914,0
2522,4,1,0,42,0.023809523809523808,0.0,1.0,42,700,400,300,0.5714285714285714,10,4,6,359.6381075935034,0.42590979481223384,0.2558320214787535,0.2104907571494347,131300.02891514683,1044.098785203123,132344.12770034996,1614,0,283.9047619047619,37,5,16,34.56267162369387,0.6314752252252251,43.777412280701746,1024.8903508771918,27.69973921289708,0
2523,4,1,2,41,0.023255813953488372,0.046511627906976744,0.9534883720930233,43,800,500,300,0.625,11,5,6,354.50321048563023,0.42884828349944626,0.2626848154715584,0.20968830393098797,131703.53366457697,737.8711147440451,132441.40477932102,1615,0,278.27906976744185,36,7,16,34.28688974218321,0.6374421296296297,43.38400900900902,1026.4639639639656,28.512887887887935,0
2524,4,1,0,42,0.023809523809523808,0.0,1.0,42,1050,700,350,0.6666666666666666,14,7,7,354.1326798133956,0.4277003484320558,0.2598409987393768,0.21050221729009438,131890.6779008925,941.3598414896862,132832.0377423822,1616,0,276.1904761904762,37,5,17,34.107689296897256,0.6373873873873874,43.20175438596491,1027.1929824561398,27.76197249881459,0
2525,4,0,0,42,0.0,0.0,1.0,42,2150,1900,250,0.8837209302325582,24,19,5,355.46435812978416,0.42707123499806426,0.2625245105509666,0.21223712694959232,132059.678218298,988.5017505386381,133048.17996883666,1617,1,277.1904761904762,37,5,18,33.90317189389093,0.6390765765765766,43.03728070175439,1027.850877192983,27.77975343764819,0
2526,4,0,0,42,0.0,0.0,1.0,42,1350,1000,350,0.7407407407407407,17,10,7,354.53080975557924,0.42636953155245844,0.26469751901613714,0.21231097917546762,132172.40521121887,971.8379693751975,133144.24318059406,1618,2,278.1904761904762,37,5,19,33.81362408473734,0.6402027027027026,42.92763157894737,1028.2894736842109,27.791607396870564,0
2527,4,0,1,41,0.0,0.023809523809523808,0.9761904761904762,42,1100,500,600,0.45454545454545453,17,5,12,354.1131411760549,0.42629694154084397,0.2641684684959038,0.2126945896615716,132285.1802958603,968.7841451215737,133253.9644409819,1619,3,279.1904761904762,37,5,19,33.710829247495184,0.6413288288288288,42.81798245614035,1028.728070175439,27.803461356092942,0
2528,4,1,0,42,0.023809523809523808,0.0,1.0,42,1350,1100,250,0.8148148148148148,16,11,5,355.433752419433,0.42664779326364694,0.2639821388415944,0.2144659290378858,132457.56842635453,1016.0742998676558,133473.64272622217,1620,0,277.9047619047619,35,7,20,33.50339179971515,0.6470238095238094,42.650462962962955,1029.3981481481476,29.411375661375644,0
2529,4,0,1,41,0.0,0.023809523809523808,0.9761904761904762,42,900,600,300,0.6666666666666666,12,6,6,356.5225551615388,0.4269623499806427,0.26473139002650004,0.2152931519458172,132487.35592689036,1046.946132330235,133534.3020592206,1621,1,278.9047619047619,35,7,20,33.445404721753796,0.6473214285714286,42.62152777777777,1029.5138888888882,29.41468253968252,0
2530,4,0,0,41,0.0,0.0,1.0,41,1350,1100,250,0.8148148148148148,16,11,5,363.5561382957854,0.42746443089430897,0.2673987405847009,0.2197342445926096,132520.55165816302,1435.7320011337595,133956.28365929678,1622,2,262.1219512195122,34,7,21,33.23096119011831,0.6498161764705883,42.5892857142857,1029.6428571428553,30.283613445378098,0
2531,4,0,0,41,0.0,0.0,1.0,41,1150,800,350,0.6956521739130435,15,8,7,364.55059030916686,0.4272611788617886,0.26601235156001124,0.2210550986646966,132643.15653344675,1471.0282029478462,134114.18473639459,1623,3,263.1219512195122,34,7,19,33.08197542278209,0.6510416666666667,42.470238095238095,1030.1190476190477,30.29761904761905,0
2532,4,0,0,41,0.0,0.0,1.0,41,1400,1000,400,0.7142857142857143,18,10,8,364.67593986651536,0.4264989837398374,0.2654643386350706,0.22203686971619455,132796.4923469386,1485.537131519256,134282.02947845787,1624,4,264.1219512195122,34,7,19,32.92451104951105,0.6525735294117647,42.32142857142856,1030.7142857142844,30.31512605042013,0
2533,4,0,0,41,0.0,0.0,1.0,41,1350,900,450,0.6666666666666666,18,9,9,363.92106556115243,0.4261686991869919,0.2665921842781922,0.22186481389138818,132845.06715374207,1469.0236786265184,134314.0908323686,1625,5,265.1219512195122,35,6,19,32.89512462108455,0.6508928571428572,42.27430555555554,1030.902777777776,29.45436507936503,0
2534,4,0,0,41,0.0,0.0,1.0,41,1100,800,300,0.7272727272727273,14,8,6,363.72787435409344,0.4253810975609756,0.263615977500679,0.2223644775256868,132949.08717839463,1471.4577753429091,134420.54495373755,1626,6,266.1219512195122,36,5,19,32.79555215840429,0.6498842592592593,42.17342342342342,1031.3063063063064,28.6473973973974,0
2535,4,0,0,41,0.0,0.0,1.0,41,1450,800,650,0.5517241379310345,21,8,13,364.2296909872264,0.424364837398374,0.2656530231023455,0.22406237232140358,133181.46482631261,1501.7287557827844,134683.1935820954,1627,7,267.1219512195122,36,5,19,32.54918539530147,0.6521990740740741,41.948198198198185,1032.2072072072056,28.672422422422375,0
2536,4,0,1,40,0.0,0.024390243902439025,0.975609756097561,41,1450,1000,450,0.6896551724137931,19,10,9,365.4692465777118,0.4238313008130081,0.26608796019265446,0.2257049468258714,133326.8038942657,1545.369313570304,134872.173207836,1628,8,268.1219512195122,36,5,19,32.371288118344054,0.6536458333333333,41.80743243243242,1032.7702702702686,28.688063063063016,0
2537,4,0,1,39,0.0,0.025,0.975,40,1300,900,400,0.6923076923076923,17,9,8,338.7706511540626,0.42504006410256406,0.20852328767123285,0.20191261866628493,131992.67415641996,991.3023242837444,132983.9764807037,1629,9,270.275,36,4,19,34.399543378995425,0.6403356481481481,43.10247747747748,1027.5900900900904,28.544169169169177,7
2538,4,0,1,38,0.0,0.02564102564102564,0.9743589743589743,39,1000,700,300,0.7,13,7,6,343.305106707291,0.42448268106162845,0.20566546217103787,0.20439432811808303,131951.69331114955,1259.938030478372,133211.63134162792,1630,10,277.1025641025641,35,4,20,34.32430719837781,0.6419642857142858,43.1423611111111,1027.4305555555543,29.355158730158696,0
2539,4,2,0,40,0.05,0.0,1.0,40,1150,700,450,0.6086956521739131,16,7,9,332.0439432124177,0.427457264957265,0.1937951411687464,0.19988257925395725,132369.03077063544,790.466987257523,133159.49775789297,1631,0,264.775,36,4,22,34.19420733931569,0.6440972222222222,42.736486486486484,1029.0540540540535,28.58483483483482,0
2540,4,1,1,40,0.024390243902439025,0.024390243902439025,0.975609756097561,41,1200,900,300,0.75,15,9,6,335.29985248288284,0.4285060975609756,0.1360791388016398,0.1915798738723179,130371.67302441753,582.49321623586,130954.16624065339,1632,0,259.2926829268293,38,3,19,36.12411514454091,0.6203399122807017,44.68482905982906,1021.2606837606846,26.875281151596965,8
2541,4,0,1,39,0.0,0.025,0.975,40,1150,600,550,0.5217391304347826,17,6,11,335.1716883841546,0.4272970085470085,0.1531467968666167,0.19221322855704237,130514.5588666705,748.9570108110181,131263.51587748152,1633,1,266.75,37,3,17,35.982826304682185,0.6235923423423424,44.54495614035088,1021.8201754385964,27.61676149834044,0
2542,4,0,0,39,0.0,0.0,1.0,39,1000,800,200,0.8,12,8,4,343.64851907841336,0.42496063877642826,0.16301496857052422,0.19681687910854573,130463.84222059888,1166.7412344777106,131630.5834550766,1634,2,274.53846153846155,36,3,19,35.81762566137566,0.625,44.59459459459459,1021.6216216216208,28.378378378378354,0
2543,4,1,1,39,0.025,0.025,0.975,40,1150,700,450,0.6086956521739131,16,7,9,335.91665220116005,0.4256810897435897,0.16209262435677596,0.1939004041913625,130766.77439212053,785.3474145890926,131552.12180670962,1635,0,268.65,37,3,18,35.70879788450545,0.6261261261261262,44.29824561403508,1022.8070175438586,27.64343290659077,0
2544,4,0,0,39,0.0,0.0,1.0,39,1300,700,600,0.5384615384615384,19,7,12,328.3323696813932,0.4250168690958165,0.13591618619040902,0.1778196101145763,128261.74554183817,623.6988636579543,128885.44440549612,1636,1,270.38461538461536,35,4,21,38.444546008531375,0.6047619047619048,46.75925925925926,1012.9629629629633,28.94179894179895,8
2545,4,1,0,40,0.025,0.0,1.0,40,1200,700,500,0.5833333333333334,17,7,10,319.8057958153492,0.4277644230769231,0.13738618698645344,0.17455581800685077,128572.46393352824,223.6438296404644,128796.10776316871,1637,0,264.6,36,4,16,38.34411318380339,0.6059027777777778,46.45270270270271,1014.1891891891902,28.17192192192195,0
2546,4,1,1,40,0.024390243902439025,0.024390243902439025,0.975609756097561,41,1200,900,300,0.75,15,9,6,315.50767719912193,0.42947154471544713,0.14801574243481208,0.17410236028885423,129006.3784650084,-59.499437326878706,128946.87902768151,1638,0,259.1219512195122,37,4,17,38.01211998560892,0.6083896396396397,46.02521929824561,1015.8991228070171,27.4567330488383,0
2547,4,1,0,41,0.024390243902439025,0.0,1.0,41,800,500,300,0.625,11,5,6,315.8593008682217,0.43158028455284553,0.15037273471235046,0.17478805132821165,129117.79495854492,-43.38871094952415,129074.4062475954,1639,0,260.0243902439024,37,4,18,37.890077138849925,0.6095157657657657,45.915570175438596,1016.3377192982456,27.46858700806069,0
2548,4,0,0,41,0.0,0.0,1.0,41,1100,700,400,0.6363636363636364,15,7,8,319.08779367536346,0.43109756097560975,0.15412698287448734,0.17707367508986488,129229.25954380176,47.09586122650862,129276.35540502827,1640,1,261.0243902439024,37,4,19,37.69489827096587,0.6106418918918919,45.80592105263157,1016.7763157894722,27.48044096728303,0
2549,4,1,1,41,0.023809523809523808,0.023809523809523808,0.9761904761904762,42,1300,1000,300,0.7692307692307693,16,10,6,311.9483738303102,0.43141453735965934,0.146678054481705,0.1751540515958876,129690.63321827717,-308.6435733070648,129381.9896449701,1641,0,255.78571428571428,38,4,15,37.40887874973777,0.6134868421052632,45.35256410256409,1018.5897435897414,26.804993252361616,0
2550,4,0,0,41,0.0,0.0,1.0,41,1100,700,400,0.6363636363636364,15,7,8,319.33138285517936,0.42865853658536585,0.1483901808649788,0.17884868644108495,129591.85157933175,76.54903431821151,129668.40061364997,1642,3,263.0243902439024,37,4,15,37.32096704716777,0.6143018018018018,45.44956140350875,1018.2017543859621,27.51896633475573,0
2551,4,1,2,40,0.023809523809523808,0.047619047619047616,0.9523809523809523,42,1450,1000,450,0.6896551724137931,19,10,9,313.7723730112613,0.4307370305845915,0.1583278472679397,0.17790371837954372,130071.79578493652,-237.41279494487867,129834.38298999165,1643,0,257.73809523809524,38,4,17,36.97676651305684,0.6173245614035088,44.97863247863246,1020.0854700854677,26.84435447593336,0
2552,4,0,0,40,0.0,0.0,1.0,40,1050,700,350,0.6666666666666666,14,7,7,329.71549492042175,0.428258547008547,0.1717196819085487,0.18634482465727184,129946.64216581428,569.0842869896692,130515.72645280395,1644,1,271.225,36,4,19,36.69694794197775,0.6197916666666667,45.10135135135134,1019.5945945945932,28.322072072072032,0
2553,4,0,1,39,0.0,0.025,0.975,40,1250,800,450,0.64,17,8,9,327.9269276707051,0.4276709401709402,0.16801170236255292,0.1858799819049589,130061.48674011836,530.1327509942237,130591.61949111258,1645,2,272.225,36,4,20,36.62623279605505,0.6209490740740741,44.98873873873873,1020.0450450450439,28.334584584584555,0
2554,4,0,0,39,0.0,0.0,1.0,39,1400,1000,400,0.7142857142857143,18,10,8,335.038694797146,0.4252136752136752,0.17395630580698085,0.18988398824741132,130055.90284475728,914.7519879543729,130970.65483271165,1646,3,279.12820512820514,35,4,20,36.450532357502176,0.6229166666666667,44.994212962962955,1020.0231481481474,29.143518518518494,0
2555,4,0,0,39,0.0,0.0,1.0,39,1350,1000,350,0.7407407407407407,17,10,7,332.48200614982755,0.4255229419703104,0.17217410992245386,0.18873978544595482,130118.92804967136,852.4404472039658,130971.36849687532,1647,4,280.12820512820514,36,3,20,36.45189477557028,0.6215277777777778,44.932432432432435,1020.2702702702709,28.34084084084086,0
2556,4,0,0,39,0.0,0.0,1.0,39,1250,800,450,0.64,17,8,9,331.5133839860076,0.42484817813765186,0.17704836070100782,0.18902906012544107,130292.12648158865,838.796011332121,131130.92249292077,1648,5,281.12820512820514,35,4,20,36.30127442088955,0.625297619047619,44.76273148148148,1020.949074074074,29.169973544973544,0
2557,4,0,0,39,0.0,0.0,1.0,39,1300,800,500,0.6153846153846154,18,8,10,333.7906990393473,0.4236111111111111,0.18421098502675703,0.19105296431396107,130439.87509645063,907.9234182098812,131347.7985146605,1649,6,282.12820512820514,35,4,20,36.093643779741676,0.6267857142857143,44.61805555555556,1021.5277777777778,29.186507936507937,0
2558,4,0,0,39,0.0,0.0,1.0,39,1350,900,450,0.6666666666666666,18,9,9,333.8773737894448,0.42335807467386416,0.18484365641703682,0.19178930661474705,130578.91506371247,919.4690467494661,131498.38411046195,1650,7,283.12820512820514,36,3,18,35.95081350080799,0.6261574074074074,44.48198198198199,1022.072072072073,28.390890890890915,0
2559,4,0,0,39,0.0,0.0,1.0,39,1550,1000,550,0.6451612903225806,21,10,11,334.4685170604645,0.4220647773279352,0.18776130104986222,0.19313271077305796,130780.41459956585,948.3862663339086,131728.80086589974,1651,8,284.12820512820514,36,3,18,35.73204521266835,0.6281828703703703,44.28490990990991,1022.8603603603609,28.412787787787803,0
2560,4,0,0,39,0.0,0.0,1.0,39,1250,1000,250,0.8,15,10,5,332.29277735072407,0.42130566801619435,0.18471244131455422,0.192594181158379,130924.4379514652,901.0490219949947,131825.48697346018,1652,9,285.12820512820514,36,3,18,35.64223884976528,0.6296296296296297,44.14414414414416,1023.4234234234251,28.428428428428475,0
2561,4,2,0,41,0.04878048780487805,0.0,1.0,41,1100,900,200,0.8181818181818182,13,9,4,318.4929923133599,0.4235518292682927,0.20212932355916058,0.1876461231790805,131553.0018851956,180.36324206966816,131733.36512726528,1653,0,272.1707317073171,37,4,20,35.36233433091064,0.634009009009009,43.53070175438597,1025.8771929824575,27.7264106211475,0
2562,4,0,0,41,0.0,0.0,1.0,41,1250,800,450,0.64,17,8,9,304.2622321311682,0.42304369918699186,0.09499465991194667,0.1695429629365189,129391.54071015019,-278.5372829530148,129113.00342719718,1654,1,273.1707317073171,38,3,25,37.90734712450562,0.6104714912280702,45.64636752136751,1017.4145299145275,26.774066576698093,8
2563,4,0,2,39,0.0,0.04878048780487805,0.9512195121951219,41,500,300,200,0.6,7,3,4,303.2077850673142,0.4232215447154472,0.09166060581227398,0.1690720693782844,129418.71667031915,-351.8475144276561,129066.86915589149,1655,2,274.1707317073171,38,3,25,37.906648117037655,0.6107456140350878,45.61965811965811,1017.5213675213668,26.776878092667545,0
2564,4,1,1,39,0.025,0.025,0.975,40,1400,1000,400,0.7142857142857143,18,10,8,305.76122772875567,0.421474358974359,0.10670705438879935,0.1711267630778479,129563.94184989604,-76.87401411974014,129487.06783577631,1656,0,281.15,37,3,17,37.694646383055094,0.6140202702702703,45.47697368421052,1018.0921052631572,27.516002844950197,0
2565,4,2,0,41,0.04878048780487805,0.0,1.0,41,1600,1300,300,0.8125,19,13,6,297.4893423859022,0.4211890243902439,0.11213535321027113,0.16878940763178704,130099.04308431932,-459.38424556215256,129639.65883875717,1657,0,275.2439024390244,38,3,21,37.364514608859565,0.6175986842105263,44.951923076923066,1020.192307692306,26.84716599190279,0
2566,4,0,0,41,0.0,0.0,1.0,41,900,500,400,0.5555555555555556,13,5,8,297.54798388202084,0.42090955284552845,0.1129919550504408,0.16894073995679523,130126.2932372707,-456.23675944189927,129670.0564778288,1658,1,276.2439024390244,38,3,22,37.33551483420591,0.6178728070175439,44.92521367521367,1020.2991452991446,26.849977507872225,0
2567,4,0,1,40,0.0,0.024390243902439025,0.975609756097561,41,1150,700,450,0.6086956521739131,16,7,9,299.00446098895515,0.42096036585365854,0.11556068455063273,0.17012445597543088,130208.06081753576,-413.4417917671382,129794.61902576862,1659,2,277.2439024390244,38,3,23,37.21583970131547,0.6186951754385965,44.84508547008546,1020.6196581196564,26.85841205578043,0
2568,4,0,0,40,0.0,0.0,1.0,40,1400,1100,300,0.7857142857142857,17,11,6,300.0416493127866,0.42131410256410257,0.12622448979591905,0.17095396298054097,130262.58680555534,-183.14830794800747,130079.43849760733,1660,3,283.775,37,3,24,37.1343537414966,0.6210585585585586,44.79166666666666,1020.8333333333317,27.590090090090044,0
2569,4,1,0,41,0.024390243902439025,0.0,1.0,41,1000,700,300,0.7,13,7,6,314.88480299603816,0.4248983739837398,0.11164760202640389,0.1706287797583809,128283.34349270917,-60.341042436154225,128223.00245027302,1661,0,277.8292682926829,37,4,21,38.76310116534975,0.6010698198198199,46.73793859649122,1013.0482456140342,27.379682313892815,8
2570,4,0,0,41,0.0,0.0,1.0,41,1200,700,500,0.5833333333333334,17,7,10,312.5141629704203,0.4246443089430894,0.1310415334176056,0.16504973732450862,127249.61480034702,-246.53862847224138,127003.07617187477,1662,1,278.8292682926829,39,2,19,39.87757244132425,0.5870726495726496,47.76041666666666,1008.9583333333317,25.87072649572645,8
2571,4,0,2,39,0.0,0.04878048780487805,0.9512195121951219,41,1300,900,400,0.6923076923076923,17,9,8,314.9704174264888,0.4246443089430894,0.13195753796737097,0.16667112913409313,127328.45187716992,-179.06087239585338,127149.39100477406,1663,2,279.8292682926829,39,2,14,39.73503027488219,0.5878739316239316,47.68229166666666,1009.2708333333316,25.87873931623927,0
2572,4,3,0,42,0.07142857142857142,0.0,1.0,42,850,500,350,0.5882352941176471,12,5,7,295.34107669520176,0.4375362950058072,0.10578286662745162,0.15889988994992188,127997.40780489417,-839.4215529415694,127157.9862519526,1664,0,242.42857142857142,42,0,18,39.54882058156977,0.5900297619047619,47.02034883720928,1011.9186046511597,24.0933001107419,0
2573,4,0,0,42,0.0,0.0,1.0,42,800,500,300,0.625,11,5,6,296.14333778755685,0.4373064266356949,0.10702661305763028,0.15962400962480972,128070.95896430466,-814.5277477315403,127256.43121657312,1665,1,243.42857142857142,42,0,18,39.45369838534686,0.5907738095238095,46.947674418604635,1012.2093023255784,24.10022148394234,0
2574,4,0,1,41,0.0,0.023809523809523808,0.9761904761904762,42,1100,700,400,0.6363636363636364,15,7,8,296.08278198759194,0.4367499032133178,0.10032353611300993,0.15998268209774202,128169.06003996124,-810.269627726733,127358.7904122345,1666,2,244.42857142857142,42,0,18,39.35546251993619,0.591765873015873,46.850775193798434,1012.5968992248038,24.109449981542948,0
2575,4,2,0,43,0.046511627906976744,0.0,1.0,43,1200,800,400,0.6666666666666666,16,8,8,292.64008922149327,0.4389304171280915,0.11599893156592933,0.15964761668227023,128552.34809924503,-1076.0858765209125,127476.26222272412,1667,0,239.48837209302326,43,0,12,39.05330796526286,0.594234496124031,46.47253787878787,1014.1098484848465,23.58394996476387,0
2576,4,0,3,40,0.0,0.06976744186046512,0.9302325581395349,43,1150,1000,150,0.8695652173913043,13,10,3,283.60912953543385,0.43865356220007384,0.053213194742483205,0.1463989459797532,126317.93986402446,-1422.080164160269,124895.85969986419,1668,1,240.48837209302326,41,2,12,41.55800766472581,0.5744410569105691,48.68551587301588,1005.2579365079376,24.518486256291162,8
2577,4,1,0,41,0.024390243902439025,0.0,1.0,41,1000,700,300,0.7,13,7,6,298.5624668256287,0.43340955284552846,0.08607369655786123,0.15387450213320872,126253.12500000013,-661.1111111110959,125592.01388888904,1669,0,252.70731707317074,39,2,20,41.248618021006074,0.5769230769230769,48.75000000000001,1005.000000000001,25.769230769230795,0
2578,4,2,0,43,0.046511627906976744,0.0,1.0,43,1300,1000,300,0.7692307692307693,16,10,6,289.43089386710307,0.437938353636028,0.09004039010934917,0.15105465314369984,126767.11432547557,-1261.9361575648722,125505.17816791071,1670,0,241.90697674418604,41,2,18,40.95234870127739,0.5790142276422765,48.239087301587304,1007.0436507936508,24.562040263259778,0
2579,4,3,1,45,0.06521739130434782,0.021739130434782608,0.9782608695652174,46,1150,800,350,0.6956521739130435,15,8,7,281.0576381088802,0.4429649758454106,0.1324118255530713,0.14947677651260047,127532.07439456772,-2030.3956369807702,125501.67875758695,1671,0,227.06521739130434,42,4,13,40.38337010744437,0.5853174603174602,47.480620155038764,1010.0775193798457,24.049464747139183,0
2580,4,0,0,45,0.0,0.0,1.0,45,1150,500,650,0.43478260869565216,18,5,13,288.2996044842455,0.43973063973063975,0.1350314856650192,0.1532730168801097,127517.50996984425,-1647.3504621756226,125870.15950766862,1672,1,232.95555555555555,41,4,14,40.215331663556334,0.5866361788617886,47.49503968253968,1010.0198412698398,24.63463027487414,0
2581,4,0,2,43,0.0,0.044444444444444446,0.9555555555555556,45,1150,700,450,0.6086956521739131,16,7,9,288.1071314698694,0.43933080808080804,0.13873997709049268,0.15355160303613902,127617.73003472213,-1646.484375000011,125971.24565972212,1673,2,233.95555555555555,41,4,14,40.11812714776632,0.5876524390243902,47.39583333333333,1010.4166666666658,24.64430894308941,0
2582,4,1,0,44,0.022727272727272728,0.0,1.0,44,1450,1200,250,0.8275862068965517,17,12,5,293.5546882907099,0.4363878611698379,0.14032833363819242,0.15620629558938207,127553.56021548026,-1311.2108781148766,126242.34933736539,1674,0,240.11363636363637,40,4,15,40.04590040241445,0.5885416666666667,47.459349593495936,1010.1626016260168,25.25406504065042,0
2583,4,0,0,44,0.0,0.0,1.0,44,950,600,350,0.631578947368421,13,6,7,342.1965886819008,0.4365420190274842,0.20664821642417253,0.17557835611933015,126069.98833550386,-42.52554496172729,126027.46279054214,1675,1,241.11363636363637,39,5,18,40.34084033468173,0.5750534188034189,48.932291666666686,1004.2708333333366,25.75053418803427,8
2584,4,3,0,47,0.06382978723404255,0.0,1.0,47,950,700,250,0.7368421052631579,12,7,5,325.3170882962229,0.44399475794017884,0.22976022653569395,0.17042682121876185,126921.08464222406,-1142.0804601586415,125779.00418206542,1676,0,226.6595744680851,42,5,16,39.89105522966951,0.5791170634920635,48.08624031007752,1007.6550387596902,23.991786637135483,0
2585,4,1,0,48,0.020833333333333332,0.0,1.0,48,1600,1000,600,0.625,22,10,12,324.5202156678949,0.44640218676122934,0.2503871300757059,0.17146468122380018,127267.13204089481,-1339.6185307665728,125927.51351012824,1677,0,222.91666666666666,41,7,18,39.55680775407203,0.5840955284552846,47.74305555555554,1009.0277777777757,24.61043360433599,0
2586,4,1,0,49,0.02040816326530612,0.0,1.0,49,950,700,250,0.7368421052631579,12,7,5,321.1683934586433,0.4479698129251701,0.2588605330573224,0.1708679926694933,127545.97757582903,-1607.2526579717885,125938.72491785725,1678,0,219.3469387755102,43,6,16,39.35628964719853,0.5840600775193798,47.46685606060605,1010.1325757575735,23.491455250176127,0
2587,4,1,2,48,0.02,0.04,0.96,50,750,400,350,0.5333333333333333,11,4,7,322.6283250835839,0.44897108843537414,0.27212598425196877,0.17290218677933752,127840.0248628256,-1751.0373799725817,126088.98748285302,1679,0,215.94,44,6,17,39.019105169993274,0.5857007575757576,47.17592592592592,1011.2962962962947,22.984006734006698,0
2588,4,0,1,47,0.0,0.020833333333333332,0.9791666666666666,48,1750,1300,450,0.7428571428571429,22,13,9,334.244311392036,0.4443613327423168,0.26770993098159557,0.17862892707180925,127727.90096748975,-1061.5351391142526,126666.3658283755,1680,1,225.5625,42,6,17,38.840027479550095,0.5873015873015873,47.28682170542635,1010.8527131782931,24.067921742340314,0
2589,4,1,1,47,0.020833333333333332,0.020833333333333332,0.9791666666666666,48,1600,1100,500,0.6875,21,11,10,338.89261720354585,0.44566341607565013,0.2917919435946126,0.1832494648301433,128198.62349559873,-907.4946499957033,127291.12884560303,1681,0,225.16666666666666,38,10,19,38.24155149980659,0.5984100877192983,46.8215811965812,1012.7136752136759,26.650359874044103,0
2590,4,1,0,48,0.020833333333333332,0.0,1.0,48,1400,1200,200,0.8571428571428571,16,12,4,352.56528726506167,0.4464575945626477,0.32547645931704583,0.19317722320226308,128725.2658420142,-523.1879340277442,128202.07790798646,1682,0,222.625,39,9,14,37.35757544652023,0.6020299145299146,46.30208333333335,1014.7916666666691,26.02029914529921,0
2591,4,1,0,49,0.02040816326530612,0.0,1.0,49,1500,1100,400,0.7333333333333333,19,11,8,345.88271389492024,0.4471371882086168,0.32354171897229866,0.1910750137924368,129050.14349489816,-872.7572278911337,128177.38626700702,1683,0,219.0612244897959,41,8,16,37.19610427650851,0.6021341463414633,45.98214285714287,1016.0714285714301,24.782229965156834,0
2592,4,1,3,47,0.02,0.06,0.94,50,1350,1000,350,0.7407407407407407,17,10,7,341.8270746633258,0.4479166666666667,0.3263523683045597,0.19066354608998862,129430.4693206722,-1150.90079737761,128279.56852329458,1684,0,215.66,36,14,13,36.912304485760664,0.6145833333333333,45.60810810810812,1017.5675675675691,28.265765765765806,0
2593,4,2,0,49,0.04081632653061224,0.0,1.0,49,1400,800,600,0.5714285714285714,20,8,12,353.29586557675424,0.44589710884353745,0.3474849793932169,0.19792448677478408,129602.412801315,-642.4006777047086,128960.0121236103,1685,0,220.79591836734693,36,13,15,36.445660989456634,0.6163194444444444,45.4391891891892,1018.2432432432446,28.284534534534572,0
2594,4,1,1,49,0.02,0.02,0.98,50,1100,700,400,0.6363636363636364,15,7,8,343.71724947174636,0.44674319727891154,0.34344160034416005,0.19416057020585042,129927.00277970145,-1068.3695944906124,128858.63318521084,1686,0,217.36,37,13,16,36.35996988599699,0.6176801801801801,45.12061403508772,1019.5175438596492,27.55452821242295,0
2595,4,0,0,49,0.0,0.0,1.0,49,1700,1200,500,0.7058823529411765,22,12,10,347.7613238864531,0.44672973356009066,0.3440149818357754,0.19626253261550353,129890.67382812501,-765.8094618055552,129124.86436631945,1687,1,222.73469387755102,39,10,16,36.293770011581174,0.6137820512820513,45.15625,1019.3750000000001,26.137820512820515,0
2596,4,1,0,50,0.02,0.0,1.0,50,1700,1300,400,0.7647058823529411,21,13,8,340.358184089962,0.4475,0.3393469387755095,0.1939250118652111,130262.5868055557,-1132.280815972214,129130.30598958347,1688,0,219.26,40,10,19,36.105442176870746,0.6158854166666667,44.79166666666667,1020.8333333333345,25.520833333333364,0
2597,4,0,0,50,0.0,0.0,1.0,50,1400,900,500,0.6428571428571429,19,9,10,341.8726590580322,0.4471428571428571,0.3413806087229374,0.19561008337844668,130426.23325525965,-1082.1673652202526,129344.06589003939,1689,1,220.26,38,12,19,35.90105637485618,0.6208881578947368,44.631410256410255,1021.4743589743586,26.88090418353575,0
2598,4,0,2,48,0.0,0.04,0.96,50,800,400,400,0.5,12,4,8,341.0869271379727,0.4467261904761905,0.338632228380215,0.1954352477064369,130480.80490037616,-1098.940641208278,129381.86425916788,1690,2,221.26,38,12,19,35.86588065112061,0.6214364035087719,44.57799145299145,1021.6880341880337,26.886527215474572,0
2599,4,0,0,48,0.0,0.0,1.0,48,1650,1200,450,0.7272727272727273,21,12,9,347.8086353261461,0.4472055998817967,0.3338273956433091,0.19946022600642174,130514.55886667041,-521.1818780778844,129993.37698859253,1691,3,213.3125,37,11,14,35.660009121150324,0.6235923423423424,44.54495614035087,1021.8201754385957,27.616761498340423,0
2600,4,0,0,48,0.0,0.0,1.0,48,1350,900,450,0.6666666666666666,18,9,9,351.6579642705767,0.4465961140661938,0.3358090233090234,0.20239869499128763,130654.64854570647,-410.85045398583236,130243.79809172064,1692,4,214.3125,37,11,14,35.419794794794804,0.625,44.40789473684211,1022.3684210526324,27.631578947368443,0
2601,4,0,1,47,0.0,0.020833333333333332,0.9791666666666666,48,1400,900,500,0.6428571428571429,19,9,10,348.92576769846187,0.4467715721040189,0.3329089627076154,0.20134215636994424,130753.83434007232,-475.32359467455217,130278.51074539777,1693,5,215.3125,38,10,14,35.38924579546643,0.6241776315789473,44.31089743589744,1022.7564102564103,26.914642375168693,0
2602,4,0,0,47,0.0,0.0,1.0,47,1200,600,600,0.5,18,6,12,359.3186829079838,0.4452667283379587,0.34036162452582985,0.20650855499804105,130598.60365689448,-14.696348876571847,130583.90730801791,1694,8,220.7872340425532,37,10,14,35.280787384681396,0.6244369369369369,44.46271929824562,1022.149122807018,27.625651967757243,0
2603,4,1,1,47,0.020833333333333332,0.020833333333333332,0.9791666666666666,48,1450,900,550,0.6206896551724138,20,9,11,353.38974001419604,0.4457095892434988,0.33978174603174605,0.20435145835603494,130835.79881656797,-352.79421433268465,130483.00460223529,1695,0,217.16666666666666,38,10,15,35.192147034252294,0.625,44.230769230769226,1023.0769230769224,26.923076923076906,0
2604,4,0,0,47,0.0,0.0,1.0,47,1350,1000,350,0.7407407407407407,17,10,7,361.14179923445585,0.44536308973172983,0.3412831648479979,0.20846105836998796,130766.77439212069,45.0696368113293,130811.84402893201,1696,1,222.5744680851064,37,10,16,35.06378644939964,0.6261261261261262,44.29824561403509,1022.80701754386,27.64343290659081,0
2605,4,0,1,46,0.0,0.02127659574468085,0.9787234042553191,47,1050,600,450,0.5714285714285714,15,6,9,360.18555586931836,0.4452474560592044,0.3354278574750793,0.20851436770300757,130878.94833025557,28.14135118499084,130907.08968144057,1697,2,223.5744680851064,37,10,16,34.9746392341763,0.6272522522522522,44.188596491228076,1023.2456140350887,27.655286865813206,0
2606,4,0,2,44,0.0,0.043478260869565216,0.9565217391304348,46,1450,1000,450,0.6896551724137931,19,10,9,323.1503950798542,0.44354871175523347,0.16224587335151308,0.18089191268535013,129571.08126201824,-817.0460637845183,128754.03519823372,1698,3,229.19565217391303,42,4,15,37.24481298182163,0.6059027777777778,45.46996124031006,1018.1201550387575,24.24095607235137,8
2607,4,0,0,44,0.0,0.0,1.0,44,1100,800,300,0.7272727272727273,14,8,6,375.3813968171462,0.441232822410148,0.20332587525446089,0.19649055797493067,126887.15071220833,743.5692435155855,127630.71995572391,1699,14,238.1590909090909,40,4,16,38.664809024275414,0.5817708333333333,48.11991869918699,1007.5203252032519,25.188008130081297,8
2608,4,1,0,45,0.022222222222222223,0.0,1.0,45,1550,1100,450,0.7096774193548387,20,11,9,364.72880236250705,0.442276936026936,0.2115661778019191,0.19306087554611126,127340.90206842478,289.6399228551434,127630.54199127993,1700,0,233.84444444444443,37,8,15,38.46675267065,0.5914977477477478,47.66995614035087,1009.3201754385956,27.278923660502585,0
2609,4,0,1,44,0.0,0.022222222222222223,0.9777777777777777,45,950,700,250,0.7368421052631579,12,7,5,352.7797194277692,0.44252946127946124,0.06300174520069834,0.18211061192082142,126319.25207756228,188.34100396275352,126507.59308152503,1701,1,234.84444444444443,37,8,13,39.81829915648633,0.5810810810810811,48.68421052631579,1005.2631578947364,27.16927453769558,8
2610,4,2,0,46,0.043478260869565216,0.0,1.0,46,1300,900,400,0.6923076923076923,17,9,8,345.0099787928187,0.4474838969404187,0.08622798654458497,0.18010564119702865,126777.10503472216,-452.126736111115,126324.97829861105,1702,0,229.7391304347826,39,7,15,39.54282167976831,0.5822649572649572,48.229166666666664,1007.0833333333328,25.82264957264956,0
2611,4,2,1,47,0.041666666666666664,0.020833333333333332,0.9791666666666666,48,1550,1000,550,0.6451612903225806,21,10,11,331.9360761990733,0.45090868794326244,0.1081124062994292,0.1762206091278106,127459.90125868074,-1137.510850694425,126322.39040798631,1703,0,221.125,39,9,16,39.17242624303694,0.5892094017094017,47.55208333333334,1009.7916666666681,25.892094017094053,0
2612,4,1,0,48,0.020833333333333332,0.0,1.0,48,1400,1100,300,0.7857142857142857,17,11,6,325.73896497223825,0.4522292405437352,0.11118579756759495,0.17432904585846132,127784.64708713387,-1275.112263698864,126509.53482343501,1704,0,219.91666666666666,40,8,17,38.99700974972363,0.5908854166666666,47.230691056910565,1011.0772357723567,25.27693089430892,0
2613,4,2,2,48,0.04,0.04,0.96,50,1350,1000,350,0.7407407407407407,17,10,7,321.7428374257388,0.4546683673469388,0.15122342559165647,0.1747505215037836,128376.1525877453,-1738.1663527001224,126637.98623504517,1705,0,212.08,40,10,16,38.49486896643937,0.596875,46.64634146341463,1013.4146341463406,25.335365853658516,0
2614,4,1,1,48,0.02040816326530612,0.02040816326530612,0.9795918367346939,49,1300,900,400,0.6923076923076923,17,9,8,319.79429141476265,0.4541170634920635,0.16372015081692481,0.1753213076727233,128747.91843820835,-1565.4301303855177,127182.48830782283,1706,0,210.71428571428572,41,8,17,38.165933528836746,0.5990853658536586,46.27976190476189,1014.8809523809502,24.75319396051098,0
2615,4,1,1,48,0.02040816326530612,0.02040816326530612,0.9795918367346939,49,1450,900,550,0.6206896551724138,20,9,11,314.0570276724317,0.4536918934240363,0.1586406236314266,0.17340115508928097,129029.04652852892,-1695.5042327684646,127333.54229576046,1707,0,209.6530612244898,42,7,18,38.02594976951201,0.6004464285714286,46.002906976744185,1015.9883720930231,24.19019933554817,0
2616,4,3,3,48,0.058823529411764705,0.058823529411764705,0.9411764705882353,51,1700,1200,500,0.7058823529411765,22,12,10,303.0361702519015,0.4534477124183007,0.18376975185760425,0.17011779995978343,129683.21352731864,-2340.1441044621947,127343.06942285645,1708,0,202.31372549019608,43,8,17,37.643330854096924,0.6056201550387597,45.359848484848484,1018.5606060606061,23.687455954897818,0
2617,4,1,2,47,0.02040816326530612,0.04081632653061224,0.9591836734693877,49,1400,1100,300,0.7857142857142857,17,11,6,316.1246301412615,0.4508042800453515,0.18695696100222325,0.17662622952147905,129497.10053482343,-1612.5553978126507,127884.54513701078,1709,0,211.3265306122449,42,7,18,37.49861164001014,0.6051587301587302,45.54263565891472,1017.8294573643395,24.234034699150943,0
2618,4,0,1,46,0.0,0.02127659574468085,0.9787234042553191,47,1250,800,450,0.64,17,8,9,317.3524862783342,0.44968008017267963,0.17903689297843295,0.17757204003207552,129554.63927469132,-1177.1026234567976,128377.53665123452,1710,1,217.61702127659575,41,6,18,37.40904956798543,0.6072154471544715,45.48611111111111,1018.0555555555553,24.830623306233058,0
2619,4,0,0,46,0.0,0.0,1.0,46,1250,700,550,0.56,18,7,11,323.23135222323464,0.4486010466988728,0.1778318620575865,0.1803072718557797,129433.96297053662,-832.5770250842806,128601.38594545235,1711,2,223.2826086956522,40,6,18,37.38182030027632,0.6075520833333333,45.604674796747965,1017.5813008130074,25.439532520325184,0
2620,4,2,2,46,0.041666666666666664,0.041666666666666664,0.9583333333333334,48,1400,1200,200,0.8571428571428571,16,12,4,312.32683750461206,0.4513427157210402,0.18409839700943986,0.17649317852972776,129941.30179226007,-1483.1688299982034,128458.13296226187,1712,0,214.9375,42,6,20,37.14558385604764,0.6096230158730158,45.10658914728682,1019.5736434108527,24.275562938353637,0
2621,4,1,1,46,0.02127659574468085,0.02127659574468085,0.9787234042553191,47,1150,700,450,0.6086956521739131,16,7,9,318.3773641079242,0.45023897625655257,0.17937632827209504,0.18105563708340452,130188.40889970532,-1110.191507421454,129078.21739228387,1713,0,217.12765957446808,42,5,21,36.74139922775036,0.6121031746031746,44.864341085271306,1020.5426356589128,24.298634182355066,0
2622,4,0,0,46,0.0,0.0,1.0,46,1050,600,450,0.5714285714285714,15,6,9,321.92841163920195,0.44879227053140097,0.18362843082542746,0.1827103634270168,130110.72137188166,-822.7324263039013,129287.98894557776,1714,1,222.69565217391303,41,5,21,36.729385453131066,0.6128048780487805,44.94047619047617,1020.2380952380919,24.883855981416875,0
2623,4,0,0,46,0.0,0.0,1.0,46,1400,1100,300,0.7857142857142857,17,11,6,327.6694294601025,0.44839975845410623,0.1882829771554897,0.18708867424012307,130344.39718934911,-657.7594166364801,129686.63777271262,1715,2,223.69565217391303,38,8,21,36.34651600753296,0.6200657894736843,44.71153846153846,1021.1538461538461,26.872469635627528,0
2624,4,1,2,45,0.02127659574468085,0.0425531914893617,0.9574468085106383,47,1350,1000,350,0.7407407407407407,17,10,7,327.11003737718585,0.449872802960222,0.132435152788005,0.18212979618161906,129360.29188368062,-698.1976932322453,128662.09419044838,1716,0,219.91489361702128,39,8,18,37.357925455662496,0.608440170940171,45.677083333333336,1017.2916666666672,26.084401709401725,8
2625,4,1,2,44,0.021739130434782608,0.043478260869565216,0.9565217391304348,46,1200,800,400,0.6666666666666666,16,8,8,326.2286331370431,0.4501207729468599,0.1461538461538463,0.18348127394947567,129756.71315980064,-733.9289651045947,129022.78419469604,1717,0,222.5,41,5,15,36.978253813696845,0.6092479674796748,45.2876984126984,1018.8492063492038,24.849980642663507,0
2626,4,0,0,44,0.0,0.0,1.0,44,1550,1100,450,0.7096774193548387,20,11,9,342.5738171707461,0.446143851303735,0.15853295640529708,0.19202991035901426,129625.34722222203,81.24999999997999,129706.59722222202,1718,1,233.38636363636363,39,5,15,36.69530823786143,0.6111111111111112,45.41666666666666,1018.3333333333318,26.11111111111107,0
2627,4,0,0,44,0.0,0.0,1.0,44,1250,800,450,0.64,17,8,9,334.2513328056261,0.4458575581395349,0.20152398888320033,0.17831519599888138,127656.23967215298,-253.47273861456387,127402.76693353841,1719,2,234.38636363636363,40,4,17,38.91312181550013,0.5895833333333333,47.35772357723578,1010.5691056910582,25.264227642276456,8
2628,4,2,0,46,0.043478260869565216,0.0,1.0,46,1100,600,500,0.5454545454545454,16,6,10,323.4012262539219,0.447524154589372,0.21523418585680587,0.17508636730433702,128247.44824715801,-903.0594181703726,127344.38882898763,1720,0,225.15217391304347,40,6,19,38.58399384635966,0.5955729166666667,46.77337398373985,1012.9065040650426,25.322662601626064,0
2629,4,1,1,46,0.02127659574468085,0.02127659574468085,0.9787234042553191,47,1550,1200,350,0.7741935483870968,19,12,7,317.9429357314298,0.4487935553499846,0.21968537866345228,0.17331705312591725,128521.48216057272,-1227.5005314625732,127293.98162911015,1721,0,221.3404255319149,41,6,17,38.44321739555816,0.5967987804878049,46.5029761904762,1013.9880952380965,24.731416957026745,0
2630,4,1,1,46,0.02127659574468085,0.02127659574468085,0.9787234042553191,47,1150,900,250,0.782608695652174,14,9,5,319.0848927681895,0.45008479802651863,0.21998301867945225,0.1742694414349344,128596.93877551028,-1193.3319160997687,127403.60685941052,1722,0,221.9787234042553,41,6,18,38.33749021909232,0.5975609756097561,46.42857142857143,1014.2857142857149,24.738675958188168,0
2631,4,1,0,47,0.02127659574468085,0.0,1.0,47,1100,600,500,0.5454545454545454,16,6,10,314.8188106524246,0.45072078322540854,0.21615824000399098,0.1732519003138826,128898.98667800451,-1284.0348639455806,127614.95181405894,1723,0,220.51063829787233,41,6,19,38.13867721766315,0.600609756097561,46.13095238095238,1015.4761904761903,24.767711962833907,0
2632,4,0,0,47,0.0,0.0,1.0,47,1250,900,350,0.72,16,9,7,316.7351050216111,0.4499884366327474,0.2058143424324843,0.17486168250815712,129024.94454089485,-1226.6541280864367,127798.29041280842,1724,1,221.51063829787233,41,6,19,37.96209273182957,0.6018800813008129,46.006944444444436,1015.9722222222205,24.779810298102937,0
2633,4,0,1,46,0.0,0.02127659574468085,0.9787234042553191,47,1150,800,350,0.6956521739130435,15,8,7,320.7951464060248,0.4496222633364169,0.2015856732881749,0.177668490274385,129150.96391565855,-1113.799524439438,128037.1643912191,1725,2,222.51063829787233,41,6,19,37.73098444921595,0.603150406504065,45.88293650793649,1016.4682539682515,24.79190863337199,0
2634,4,0,0,46,0.0,0.0,1.0,46,1500,1300,200,0.8666666666666667,17,13,4,327.98594670343266,0.4483192431561997,0.20656405048858484,0.1821273499271281,129254.34570312499,-721.2683699058339,128533.07733321915,1726,3,227.80434782608697,39,7,19,37.44323226114869,0.6073717948717949,45.78125,1016.8749999999999,26.073717948717945,0
2635,4,0,0,46,0.0,0.0,1.0,46,1350,1000,350,0.7407407407407407,17,10,7,327.6861994152312,0.44849033816425116,0.20504806543675924,0.18231301667298763,129330.57089240853,-724.0313512129098,128606.53954119563,1727,4,228.80434782608697,40,6,19,37.37344723082558,0.6065104166666666,45.70630081300813,1017.1747967479668,25.42936991869917,0
2636,4,1,1,46,0.02127659574468085,0.02127659574468085,0.9787234042553191,47,1550,1100,450,0.7096774193548387,20,11,9,324.8977272744519,0.4484659266111625,0.2101716549660586,0.18249725731149158,129706.17992567373,-971.7513857395087,128734.42853993422,1728,0,224.91489361702128,41,6,17,37.06336839371509,0.608739837398374,45.337301587301575,1018.6507936507917,24.845141308555895,0
2637,4,0,2,44,0.0,0.043478260869565216,0.9565217391304348,46,1800,1300,500,0.7222222222222222,23,13,10,330.6392281110299,0.44736312399355876,0.2112649797957027,0.18627248199423632,129822.05119307281,-615.1474403463642,129206.90375272644,1729,1,230.3695652173913,40,6,17,36.799669259407,0.6114583333333333,45.22357723577235,1019.1056910569098,25.477642276422745,0
2638,4,1,0,45,0.022222222222222223,0.0,1.0,45,2200,1800,400,0.8181818181818182,26,18,8,333.7534842160944,0.44871632996632993,0.21314998241374195,0.18925581186613863,130076.56385633688,-317.2987196180505,129759.26513671884,1730,0,233.44444444444446,39,6,19,36.46237533612444,0.6156517094017093,44.973958333333336,1020.1041666666673,26.15651709401711,0
2639,4,1,2,44,0.021739130434782608,0.043478260869565216,0.9565217391304348,46,1200,900,300,0.75,15,9,6,327.4135430723729,0.44913446054750406,0.21752667793223868,0.18708771412123193,130374.54433094797,-662.3229398108039,129712.22139113717,1731,0,229.34782608695653,37,9,20,36.32256101925419,0.6221846846846847,44.68201754385965,1021.2719298245613,27.60194404931247,0
2640,4,1,0,45,0.022222222222222223,0.0,1.0,45,1100,700,400,0.6363636363636364,15,7,8,334.9698642526558,0.4480008417508417,0.22635281772435678,0.19195874508648503,130486.54994806102,-258.1876154201184,130228.3623326409,1732,0,234.95555555555555,37,8,21,36.0163125134149,0.6233108108108107,44.57236842105264,1021.71052631579,27.613798008534864,0
2641,4,1,1,45,0.021739130434782608,0.021739130434782608,0.9782608695652174,46,1000,500,500,0.5,15,5,10,333.61727521110333,0.44736312399355876,0.2463517376259965,0.19351377486566146,130954.69292534741,-462.2504340277584,130492.44249131966,1733,0,230.82608695652175,39,7,18,35.57780378587422,0.624465811965812,44.11458333333334,1023.5416666666681,26.24465811965816,0
2642,4,0,1,44,0.0,0.022222222222222223,0.9777777777777777,45,1300,900,400,0.6923076923076923,17,9,8,337.54037256151315,0.4464015151515151,0.2421293077763429,0.19543956361827958,130885.78976014632,-164.152352270449,130721.63740787587,1734,1,236.9111111111111,40,5,18,35.54701724765785,0.6221354166666666,44.1819105691057,1023.2723577235791,25.581808943089477,0
2643,4,1,0,45,0.022222222222222223,0.0,1.0,45,1650,1300,350,0.7878787878787878,20,13,7,335.2155731404609,0.4455808080808081,0.2440982901742894,0.19540993416325667,131145.89659139747,-207.57062181900451,130938.32596957847,1735,0,237.17777777777778,40,5,19,35.34390812580614,0.6247395833333333,43.92784552845529,1024.2886178861802,25.607215447154505,0
2644,4,0,0,45,0.0,0.0,1.0,45,1300,800,500,0.6153846153846154,18,8,10,335.1149064864171,0.44515993265993264,0.23921011162903438,0.195881947947974,131250.01161882837,-203.23292600300712,131046.77869282536,1736,1,238.17777777777778,40,5,19,35.24145426295085,0.62578125,43.82621951219514,1024.695121951222,25.61737804878055,0
2645,4,0,0,45,0.0,0.0,1.0,45,950,600,350,0.631578947368421,13,6,7,334.6844828378709,0.44490740740740736,0.2404715474026331,0.19589628609517895,131302.08462431445,-211.04594239537252,131091.03868191908,1737,2,239.17777777777778,40,5,19,35.19996694761196,0.6263020833333333,43.77540650406505,1024.8983739837417,25.622459349593544,0
2646,4,1,2,44,0.021739130434782608,0.043478260869565216,0.9565217391304348,46,1050,900,150,0.8571428571428571,12,9,3,328.10533929741985,0.44605475040257647,0.24390201887962482,0.19349015803427305,131588.67076475662,-565.0083242448052,131023.66244051182,1738,0,234.95652173913044,40,6,15,35.07989963021659,0.6291666666666667,43.495934959349604,1026.0162601626032,25.65040650406508,0
2647,4,0,0,44,0.0,0.0,1.0,44,1550,1000,550,0.6451612903225806,21,10,11,360.66939422519147,0.4438975510923185,0.29227851079263645,0.2002902971284087,129257.13320444747,614.3032375403434,129871.43644198781,1739,4,243.4090909090909,37,7,18,36.60951764790453,0.6109234234234234,45.77850877192982,1016.8859649122802,27.483404457088653,8
2648,4,0,0,44,0.0,0.0,1.0,44,1500,1100,400,0.7333333333333333,19,11,8,363.65028016254263,0.44248810782241016,0.2994117992771157,0.20294878233244473,129452.33298947748,615.0754318636436,130067.40842134113,1740,5,244.4090909090909,37,7,16,36.33487321768489,0.6128941441441442,45.58662280701754,1017.6535087719294,27.504148885727822,0
2649,4,2,1,45,0.043478260869565216,0.021739130434782608,0.9782608695652174,46,1500,1000,500,0.6666666666666666,20,10,10,347.3559640097893,0.4451086956521739,0.3017523030392315,0.19646954582154622,129977.44914568058,-170.31157049374116,129807.13757518685,1741,0,234.7391304347826,40,6,19,36.216032157331746,0.6130208333333333,45.07113821138212,1019.7154471544724,25.49288617886181,0
2650,4,0,0,45,0.0,0.0,1.0,45,1200,700,500,0.5833333333333334,17,7,10,351.19442158704453,0.44450757575757577,0.2993860574904381,0.19887475892184853,130023.43885633719,132.70128038198425,130156.14013671917,1742,1,240.42222222222222,39,6,19,36.07149848500323,0.6151175213675213,45.026041666666686,1019.8958333333364,26.151175213675295,0
2651,4,0,2,43,0.0,0.044444444444444446,0.9555555555555556,45,1750,1400,350,0.8,21,14,7,347.8213115652662,0.44417087542087547,0.29631746679822557,0.19777164186911916,130182.84640842053,56.07367621531773,130238.92008463586,1743,2,241.42222222222222,39,6,20,35.99581929842468,0.6167200854700854,44.869791666666686,1020.5208333333366,26.167200854700937,0
2652,4,1,0,44,0.022727272727272728,0.0,1.0,44,1300,1000,300,0.7692307692307693,16,10,6,345.1885973318048,0.44537306201550386,0.28891799174818056,0.19735126512176981,130395.54172092042,202.21082899308863,130597.75254991351,1744,0,239.77272727272728,39,5,21,35.847463029066844,0.6188568376068376,44.66145833333335,1021.3541666666689,26.188568376068435,0
2653,4,0,0,44,0.0,0.0,1.0,44,1250,900,350,0.72,16,9,7,339.1215572526846,0.4449326109936575,0.284604015900519,0.19468236385056165,130555.17713758726,54.81499565977242,130609.99213324704,1745,1,240.77272727272728,39,5,15,35.840829171338314,0.6204594017094017,44.50520833333336,1021.9791666666704,26.204594017094113,0
2654,4,2,3,43,0.043478260869565216,0.06521739130434782,0.9347826086956522,46,1400,1100,300,0.7857142857142857,17,11,6,336.3250745583502,0.4462661030595813,0.3053838249414613,0.19594921386796907,131124.83071932502,-379.886306374378,130744.94441295064,1746,0,231.2608695652174,41,5,17,35.336755779413664,0.6229674796747968,43.94841269841271,1024.2063492063512,24.98064266356954,0
2655,4,0,0,43,0.0,0.0,1.0,43,1300,1000,300,0.7692307692307693,16,10,6,350.2287701221061,0.44455980066445183,0.29381972436655035,0.20353197720316218,131027.14913662433,577.8954589451442,131605.04459556946,1747,1,243.41860465116278,38,5,17,35.07948102542697,0.6269188596491229,44.04380341880342,1023.8247863247865,26.942757534862803,0
2656,4,0,2,41,0.0,0.046511627906976744,0.9534883720930233,43,1400,1000,400,0.7142857142857143,18,10,8,348.9657827007408,0.4442137320044297,0.28496253364696766,0.20381131888551174,131218.63928153983,558.1630323617389,131776.80231390157,1748,2,244.41860465116278,38,5,19,34.918317692040326,0.6288377192982456,43.8568376068376,1024.5726495726487,26.96243814664865,0
2657,4,0,0,41,0.0,0.0,1.0,41,1150,1000,150,0.8695652173913043,13,10,3,367.9735756893809,0.4403455284552846,0.29613237735808573,0.21407445449414828,131068.5405633673,1445.951906298177,132514.49246966548,1749,3,257.0,36,5,19,34.58337915612742,0.6310763888888888,44.00337837837837,1023.9864864864857,28.444069069069045,0
2658,4,0,1,40,0.0,0.024390243902439025,0.975609756097561,41,1200,700,500,0.5833333333333334,17,7,10,366.29865723860485,0.4398628048780488,0.2912835305534853,0.21390148803317227,131212.72243527306,1412.6088081324472,132625.3312434055,1750,4,258.0,36,5,19,34.48033450575217,0.6325231481481481,43.86261261261261,1024.549549549549,28.459709709709696,0
2659,4,1,0,41,0.024390243902439025,0.0,1.0,41,1400,1100,300,0.7857142857142857,17,11,6,360.62119317953693,0.4409552845528455,0.2770157314929913,0.21153964837026426,131385.8453047641,1276.1040601412128,132661.94936490533,1751,0,255.1219512195122,36,5,20,34.45074509373169,0.6342592592592593,43.69369369369369,1025.2252252252244,28.478478478478458,0
2660,4,0,0,41,0.0,0.0,1.0,41,1550,1200,350,0.7741935483870968,19,12,7,359.3015661956487,0.4407520325203252,0.2742376040361194,0.21140301452906768,131501.32395909424,1249.7263310607893,132751.05029015502,1752,1,256.1219512195122,36,5,20,34.3679091641048,0.6354166666666667,43.58108108108108,1025.6756756756758,28.490990990990994,0
2661,4,0,0,41,0.0,0.0,1.0,41,1300,1000,300,0.7692307692307693,16,10,6,351.1238290329976,0.44032012195121956,0.25134572442584124,0.19699527976268227,129659.7526580639,919.9856951546572,130579.73835321855,1753,2,257.1219512195122,36,5,16,36.44266917293233,0.6168981481481481,45.3828828828829,1018.4684684684719,28.290790790790886,8
2662,4,1,0,42,0.023809523809523808,0.0,1.0,42,950,500,450,0.5263157894736842,14,5,9,348.44040516933427,0.44267808749516063,0.25177054368365237,0.19696944241152844,129954.95158366053,656.3111967143899,130611.26278037492,1754,0,251.97619047619048,37,5,17,36.211218948274,0.6179617117117118,45.09320175438597,1019.6271929824575,27.55749170222858,0
2663,4,0,0,42,0.0,0.0,1.0,42,800,600,200,0.75,10,6,4,345.3310794020887,0.44283536585365857,0.24963335428451616,0.19552375349776663,130017.3097468773,579.8035831689896,130597.1133300463,1755,1,252.97619047619048,38,4,17,36.227215587680696,0.6167763157894737,45.03205128205129,1019.8717948717969,26.838731443994654,0
2664,4,0,0,42,0.0,0.0,1.0,42,1700,1100,600,0.6470588235294118,23,11,12,343.9820017171279,0.44247241579558655,0.2510768126346008,0.19557833811916742,130180.80210387928,555.9705785667568,130736.77268244604,1756,2,253.97619047619048,38,4,17,36.095843802345065,0.618421052631579,44.87179487179488,1020.5128205128226,26.85560053981112,0
2665,4,0,3,39,0.0,0.07142857142857142,0.9285714285714286,42,1150,600,550,0.5217391304347826,17,6,11,346.7330222256028,0.4416013356562137,0.2525652708915762,0.18919962964982906,128561.1934080679,520.3416033164979,129081.5350113844,1757,3,254.97619047619048,37,5,16,37.67287904998737,0.6038851351351351,46.463815789473685,1014.1447368421057,27.409317211948803,8
2666,4,0,0,39,0.0,0.0,1.0,39,1150,900,250,0.782608695652174,14,9,5,368.4697454986149,0.43735942420152946,0.26712213225371095,0.20002643327067676,128355.55555555563,1659.027777777789,130014.58333333343,1758,7,270.6666666666667,34,5,20,37.33209978070175,0.607843137254902,46.66666666666667,1013.333333333334,29.803921568627473,0
2667,4,1,0,40,0.025,0.0,1.0,40,700,500,200,0.7142857142857143,9,5,4,360.0243392276731,0.440357905982906,0.2660771337288905,0.1967115529296339,128613.70991941019,1260.8131858710599,129874.52310528125,1759,0,264.875,35,5,18,37.28225315685379,0.6083333333333334,46.41203703703704,1014.3518518518522,28.98148148148149,0
2668,4,0,0,40,0.0,0.0,1.0,40,1300,1100,200,0.8461538461538461,15,11,4,358.328560392136,0.4401175213675214,0.26421076642335795,0.19636405109489055,128731.13854595338,1225.608710562417,129956.7472565158,1760,1,265.875,35,5,18,37.20536800486618,0.6095238095238096,46.2962962962963,1014.814814814815,28.994708994709,0
2669,4,0,0,40,0.0,0.0,1.0,40,1100,700,400,0.6363636363636364,15,7,8,359.9631821170283,0.43943643162393164,0.26669230769230756,0.19828480370853246,128936.76757812501,1282.4978298611113,130219.26540798612,1761,2,266.875,35,5,19,36.95405982905982,0.6116071428571428,46.09375,1015.6250000000001,29.017857142857146,0
2670,4,1,0,41,0.024390243902439025,0.0,1.0,41,1250,900,350,0.72,16,9,7,350.04031174415496,0.44189532520325203,0.25909636145541826,0.19411326378539476,129201.38888888869,845.4101562499749,130046.79904513866,1762,0,261.3414634146341,35,6,21,36.93647540983607,0.6142857142857143,45.83333333333332,1016.666666666665,29.047619047619,0
2671,4,0,0,41,0.0,0.0,1.0,41,1300,900,400,0.6923076923076923,17,9,8,351.7407599495647,0.4418191056910569,0.2641106260874875,0.19578527797319342,129348.51794249396,899.4291998885415,130247.9471423825,1763,1,262.3414634146341,35,6,21,36.74349091667616,0.6157738095238094,45.688657407407405,1017.24537037037,29.06415343915343,0
2672,4,1,1,41,0.023809523809523808,0.023809523809523808,0.9761904761904762,42,1500,1200,300,0.8,18,12,6,347.7393241964528,0.4442387727448703,0.26651933701657415,0.19595522316176237,129831.84831791275,629.5278386494874,130461.37615656224,1764,0,257.07142857142856,36,6,18,36.35405156537754,0.6186342592592593,45.21396396396398,1019.1441441441461,28.309559559559617,0
2673,4,0,0,41,0.0,0.0,1.0,41,950,600,350,0.631578947368421,13,6,7,358.4212568678469,0.44192073170731705,0.2771228212111725,0.20160909419857218,129760.92470689722,1101.8147451560262,130862.73945205324,1765,1,264.2926829268293,35,6,18,36.15398633041766,0.6199404761904762,45.28356481481481,1018.8657407407402,29.11044973544972,0
2674,4,1,0,42,0.023809523809523808,0.0,1.0,42,1350,1100,250,0.8148148148148148,16,11,5,352.8651256987151,0.44387582268679826,0.27489317059440666,0.20033007898880695,130122.70752779715,783.153109610663,130905.86063740781,1766,0,258.9761904761905,37,5,20,35.92815242701057,0.6196509009009009,44.928728070175445,1020.2850877192993,27.575272641062146,0
2675,4,0,1,41,0.0,0.023809523809523808,0.9761904761904762,42,1050,800,250,0.7619047619047619,13,8,5,354.1182165084711,0.44330720092915216,0.27576892381361584,0.20147508308440407,130206.62607725461,821.7076408125645,131028.33371806717,1767,1,259.9761904761905,37,5,21,35.81104068185074,0.6204954954954955,44.84649122807018,1020.6140350877199,27.584163110478915,0
2676,4,0,0,41,0.0,0.0,1.0,41,1200,900,300,0.75,15,9,6,360.4890353062824,0.440015243902439,0.27464247995869817,0.20495244053729825,130178.6502217029,1185.5952071791348,131364.24542888204,1768,2,267.1219512195122,37,4,21,35.676887468213884,0.6202139639639639,44.87390350877193,1020.5043859649129,27.58119962067332,0
2677,4,1,0,42,0.023809523809523808,0.0,1.0,42,900,600,300,0.6666666666666666,12,6,6,354.04448741567705,0.4408996322106078,0.2782604594907985,0.2029902361715937,130505.75573979596,841.0768855095187,131346.83262530548,1769,0,261.73809523809524,34,8,17,35.50963144199775,0.6295955882352942,44.55357142857143,1021.7857142857147,30.052521008403374,0
2678,4,0,1,41,0.0,0.023809523809523808,0.9761904761904762,42,1050,700,350,0.6666666666666666,14,7,7,353.7731327837372,0.44047619047619047,0.278615375490022,0.2032641857913586,130587.70743580667,839.6844725222832,131427.39190832895,1770,1,262.73809523809524,35,7,17,35.43353432982297,0.6282738095238095,44.473379629629626,1022.1064814814808,29.20304232804231,0
2679,4,0,1,40,0.0,0.024390243902439025,0.975609756097561,41,750,400,350,0.5333333333333333,11,4,7,360.69511842401283,0.44082825203252035,0.2719182597231382,0.20696570164115807,130536.16780045352,1216.7517006802755,131752.9195011338,1771,2,262.4146341463415,34,7,18,35.30890804597702,0.6299019607843137,44.523809523809526,1021.9047619047619,30.056022408963585,0
2680,4,0,0,40,0.0,0.0,1.0,40,1150,700,450,0.6086956521739131,16,7,9,361.20858515511816,0.4405181623931624,0.2550325998370011,0.20807649482879348,130688.28125,1441.1458333333333,132129.42708333334,1772,3,254.025,34,6,18,35.14160554197229,0.6314338235294117,44.375,1022.5,30.073529411764707,0
2681,4,1,1,40,0.024390243902439025,0.024390243902439025,0.975609756097561,41,1150,800,350,0.6956521739130435,15,8,7,354.4855323498951,0.4427083333333333,0.2584841925298844,0.2058716043095745,131002.08340031284,1087.668654621043,132089.7520549339,1773,0,248.8048780487805,35,6,21,34.99587808554738,0.6324404761904762,44.06828703703703,1023.7268518518512,29.249338624338606,0
2682,4,0,0,40,0.0,0.0,1.0,40,1400,1000,400,0.7142857142857143,18,10,8,358.82897776212354,0.442321047008547,0.2662530512611876,0.20900512496191956,131114.67013888902,1409.5486111111304,132524.21875000015,1774,1,254.6,34,6,21,34.770816381882284,0.6357230392156863,43.95833333333334,1024.1666666666679,30.122549019607877,0
2683,4,0,0,40,0.0,0.0,1.0,40,1050,400,650,0.38095238095238093,17,4,13,354.208084068839,0.44143963675213677,0.25725694041119773,0.20729961901758234,131297.62081916098,1301.3357426303862,132598.95656179136,1775,2,255.6,34,6,22,34.7042339412243,0.6375612745098039,43.779761904761905,1024.8809523809523,30.143557422969185,0
2684,4,0,0,40,0.0,0.0,1.0,40,1000,800,200,0.8,12,8,4,354.93264204938214,0.44082532051282053,0.25546856323212985,0.20823046868058426,131390.93888168022,1326.9901588086332,132717.92904048885,1776,3,256.6,33,7,22,34.59140170531518,0.6407828282828283,43.688725490196084,1025.2450980392164,31.06803327391565,0
2685,4,1,1,40,0.024390243902439025,0.024390243902439025,0.975609756097561,41,1250,800,450,0.64,17,8,9,348.6208906164719,0.4417682926829268,0.25772904378707584,0.20682281997645707,131816.6737528345,990.8092403628159,132807.4829931973,1777,0,251.3170731707317,34,7,17,34.32379820697117,0.6427696078431373,43.273809523809526,1026.9047619047622,30.203081232493005,0
2686,4,0,0,40,0.0,0.0,1.0,40,1400,900,500,0.6428571428571429,19,9,10,346.7924261258164,0.4405849358974359,0.23894864286518747,0.20679448969584438,132011.15779588904,1156.0939375428675,133167.2517334319,1778,1,248.325,35,5,18,34.17485546420393,0.6425595238095239,43.08449074074074,1027.662037037037,29.361772486772484,0
2687,4,0,0,40,0.0,0.0,1.0,40,1250,900,350,0.72,16,9,7,345.76136173497616,0.44055822649572646,0.2414640324214794,0.20682816001964932,132130.126953125,1137.098524305556,133267.22547743056,1779,2,249.325,35,5,18,34.0816024991557,0.64375,42.96875,1028.125,29.375,0
2688,4,0,1,39,0.0,0.025,0.975,40,1250,800,450,0.64,17,8,9,345.1902300672415,0.43998397435897435,0.23978334271243695,0.20681154377258523,132189.6316256215,1126.1138706704317,133315.74549629193,1780,3,250.325,35,5,18,34.036414368786346,0.6443452380952381,42.910879629629626,1028.3564814814808,29.38161375661374,0
2689,4,0,0,39,0.0,0.0,1.0,39,1100,700,400,0.6363636363636364,15,7,8,353.11642661179695,0.43558816914080073,0.25166191832858464,0.2118698559670782,132244.89795918364,1539.5691609977262,133784.46712018136,1781,4,257.56410256410254,34,5,18,33.77700617283949,0.6470588235294117,42.857142857142854,1028.5714285714282,30.252100840336123,0
2690,4,0,0,39,0.0,0.0,1.0,39,1500,1000,500,0.6666666666666666,20,10,10,353.12218907759785,0.43499775078722447,0.25473143124172504,0.2122314495409579,132308.68115837194,1544.2262249228475,133852.90738329478,1782,5,258.56410256410254,35,4,18,33.71266452919339,0.6455357142857143,42.79513888888889,1028.8194444444448,29.39484126984128,0
2691,4,0,0,39,0.0,0.0,1.0,39,1600,1400,200,0.875,18,14,4,353.9894933850277,0.4342948717948718,0.2536584497958383,0.21360412765529196,132459.27047902488,1577.8681510219733,134037.13863004686,1783,6,259.56410256410254,34,5,19,33.538847769939466,0.649203431372549,42.64880952380952,1029.4047619047615,30.27661064425769,0
2692,4,0,0,39,0.0,0.0,1.0,39,1200,600,600,0.5,18,6,12,356.04301063665196,0.43328272604588397,0.2591008898647875,0.21589629790041664,132643.15653344657,1645.3337585033862,134288.49029194994,1784,7,260.56410256410254,34,5,17,33.30107091952695,0.6510416666666667,42.47023809523809,1030.1190476190463,30.29761904761901,0
2693,4,1,0,40,0.025,0.0,1.0,40,1250,600,650,0.48,19,6,13,344.4838079803779,0.43350694444444443,0.2493967682061362,0.21076333983248366,132978.12328798388,1161.7620576657675,134139.88534564964,1785,0,255.025,36,4,18,33.26259234996543,0.6501736111111112,42.14527027027027,1031.4189189189185,28.650525525525513,0
2694,4,0,2,38,0.0,0.05,0.95,40,1350,1100,250,0.8148148148148148,16,11,5,352.5472552212208,0.4334802350427351,0.1759388382562861,0.2072722952420697,131472.44953991158,1279.2951312799323,132751.74467119153,1786,1,256.025,36,4,18,34.57024816075546,0.6351273148148149,43.609234234234236,1025.5630630630635,28.487862862862876,7
2695,4,0,0,38,0.0,0.0,1.0,38,1350,1100,250,0.8148148148148148,16,11,5,363.9121493533011,0.4337067330488383,0.16939954016432868,0.21364464752292195,131417.11576485337,1964.8570119598721,133381.97277681323,1787,10,261.3421052631579,35,3,19,34.33478665763629,0.6366071428571429,43.66319444444444,1025.3472222222222,29.29563492063492,0
2696,4,0,0,38,0.0,0.0,1.0,38,1800,1500,300,0.8333333333333334,21,15,6,362.0917123672571,0.4329954954954955,0.15078623059257978,0.19777805053316475,128601.01814229775,1713.072574263459,130314.0907165612,1788,11,262.3421052631579,36,2,17,37.24279264275935,0.6061921296296297,46.42454954954955,1014.3018018018022,28.17505005005006,8
2697,4,0,1,37,0.0,0.02631578947368421,0.9736842105263158,38,1000,800,200,0.8,12,8,4,365.7993965568848,0.43189900426742533,0.15470344006026338,0.20066646142222785,128772.40997331796,1820.9739722831002,130593.38394560106,1789,12,263.3421052631579,36,2,17,36.973676911128365,0.6079282407407407,46.255630630630634,1014.9774774774779,28.19381881881883,0
2698,4,0,0,37,0.0,0.0,1.0,37,900,500,400,0.5555555555555556,13,5,8,379.31825298049955,0.429491991991992,0.17303705164186134,0.20863692999360042,128877.99968117732,2377.1555373371284,131255.15521851444,1790,13,270.43243243243245,35,2,17,36.52268798206618,0.6110119047619047,46.15162037037038,1015.3935185185201,29.011243386243432,0
2699,4,1,1,37,0.02631578947368421,0.02631578947368421,0.9736842105263158,38,900,700,200,0.7777777777777778,11,7,4,373.2331783013617,0.431484115694642,0.17439087051121804,0.2071381725997591,129232.53864198868,2047.989907115946,131280.52854910464,1791,0,264.2894736842105,33,5,18,36.315209312602946,0.6190025252525253,45.802696078431374,1016.7892156862747,30.811794414735598,0
2700,4,1,2,36,0.02631578947368421,0.05263157894736842,0.9473684210526316,38,1300,1000,300,0.7692307692307693,16,10,6,382.7712521034286,0.43384009009009006,0.16081112139489573,0.20181834592858405,127182.059594671,2140.4159611148157,129322.47555578582,1792,0,261.8421052631579,34,4,19,38.174938038475155,0.5958946078431373,47.82738095238094,1008.6904761904744,29.66736694677866,8
2701,4,2,0,38,0.05263157894736842,0.0,1.0,38,850,500,350,0.5882352941176471,12,5,7,378.9716399689875,0.43481804172593647,0.178790178329449,0.20330467536457833,127880.99500868049,2092.6540798611054,129973.6490885416,1793,0,256.9736842105263,35,3,19,37.55256608307587,0.6008928571428571,47.135416666666664,1011.4583333333328,28.898809523809508,0
2702,4,1,0,39,0.02564102564102564,0.0,1.0,39,1050,700,350,0.6666666666666666,14,7,7,370.53484394101724,0.4367408906882591,0.17406238368634086,0.20023529028041734,128173.82979948969,1698.84527177638,129872.67507126607,1794,0,251.35897435897436,35,4,20,37.465829428125105,0.6038690476190476,46.8460648148148,1012.6157407407392,28.93187830687826,0
2703,4,3,1,41,0.07142857142857142,0.023809523809523808,0.9761904761904762,42,1050,900,150,0.8571428571428571,12,9,3,349.85112882740236,0.4422667440960124,0.18243114624347578,0.19268162402278588,128929.98598327112,621.2602271897056,129551.24621046083,1795,0,234.33333333333334,38,4,19,37.217722140402564,0.6058114035087719,46.100427350427346,1015.5982905982896,26.72627080521815,0
2704,4,1,0,42,0.023809523809523808,0.0,1.0,42,1150,800,350,0.6956521739130435,15,8,7,348.8794678869366,0.4428958575300039,0.1762044950458368,0.19280607896993904,129065.65176647293,605.6711821535382,129671.32294862648,1796,0,235.28571428571428,38,4,21,37.104186380682016,0.6071820175438596,45.966880341880334,1016.1324786324775,26.740328385065197,0
2705,4,0,0,42,0.0,0.0,1.0,42,1500,1300,200,0.8666666666666667,17,13,4,346.3450685299648,0.4425329074719319,0.16744730679156894,0.19206408345752607,129201.38888888896,549.7241169917509,129751.11300588072,1797,1,236.28571428571428,37,5,21,37.030396174863384,0.6103603603603603,45.833333333333336,1016.6666666666673,27.477477477477496,0
2706,4,0,0,42,0.0,0.0,1.0,42,950,500,450,0.5263157894736842,14,5,9,346.4155435691545,0.4415529423151374,0.16803219778640255,0.1926469173949327,129312.88954293627,559.198984302862,129872.08852723913,1798,2,237.28571428571428,37,5,21,36.91515739542908,0.6114864864864865,45.723684210526315,1017.1052631578946,27.489331436699853,0
2707,4,1,1,42,0.023255813953488372,0.023255813953488372,0.9767441860465116,43,1600,1100,500,0.6875,21,11,10,337.596193716087,0.4433831672203765,0.16302733903747257,0.18968969987724538,129718.50419723714,158.49465430630565,129876.99885154345,1799,0,232.74418604651163,40,3,16,36.72747905027934,0.6104166666666666,45.32520325203252,1018.6991869918702,25.467479674796756,0
2708,4,0,1,41,0.0,0.023809523809523808,0.9761904761904762,42,1350,900,450,0.6666666666666666,18,9,9,335.16336496244276,0.44284746418892756,0.16551306201720184,0.18876817498143805,129811.04736328128,301.5814887152786,130112.62885199656,1800,1,237.64285714285714,39,3,16,36.69556458482402,0.6129807692307692,45.234375,1019.0625000000002,26.129807692307697,0
2709,4,0,3,38,0.0,0.07317073170731707,0.926829268292683,41,1150,800,350,0.6956521739130435,15,8,7,377.5643002911307,0.4426067073170732,0.16337298097838682,0.205130295106625,128388.03624260383,1580.7171281743445,129968.75337077818,1801,2,243.6829268292683,38,3,16,37.0684429685853,0.600328947368421,46.6346153846154,1013.4615384615408,26.67004048583002,8
2710,4,3,1,40,0.07317073170731707,0.024390243902439025,0.975609756097561,41,1250,900,350,0.72,16,9,7,372.9788410735769,0.44466463414634144,0.22769186572925815,0.20584189203532458,129011.37689248667,1423.7027677332235,130435.0796602199,1802,0,244.26829268292684,38,3,18,36.54739369719916,0.6066337719298245,46.02029914529915,1015.9188034188035,26.734705353126408,0
2711,4,0,0,40,0.0,0.0,1.0,40,1350,800,550,0.5925925925925926,19,8,11,375.3338228725669,0.4412927350427351,0.22627773688085018,0.207141574097228,129011.37689248667,1684.4666566221126,130695.84354910879,1803,1,251.375,38,2,19,36.48758193991658,0.6066337719298245,46.02029914529915,1015.9188034188035,26.734705353126408,0
2712,4,1,0,41,0.024390243902439025,0.0,1.0,41,1150,600,550,0.5217391304347826,17,6,11,369.5113317420361,0.4417936991869919,0.22595199714866565,0.20565593713036445,129344.5403807525,1359.2741485088259,130703.81452926132,1804,0,246.21951219512195,36,5,20,36.29561976456694,0.6137152777777778,45.69256756756757,1017.2297297297308,28.256381381381413,0
2713,4,0,0,41,0.0,0.0,1.0,41,1650,1100,550,0.6666666666666666,22,11,11,403.83587449940603,0.44138719512195124,0.30480962043091986,0.20769425967039723,126166.92648260288,2067.8844289850035,128234.81091158789,1805,1,247.21951219512195,33,8,17,38.69287224526306,0.5877525252525253,48.83578431372549,1004.6568627450984,30.444147355912072,8
2714,4,1,0,42,0.023809523809523808,0.0,1.0,42,950,500,450,0.5263157894736842,14,5,9,393.6660012032304,0.44208526906697637,0.30379893052949525,0.20422783156344385,126522.46492346934,1561.5185657596312,128083.98348922897,1806,0,242.3095238095238,34,8,17,38.580739951879465,0.5891544117647058,48.482142857142854,1006.0714285714282,29.59033613445377,0
2715,4,3,1,44,0.06666666666666667,0.022222222222222223,0.9777777777777777,45,1300,800,500,0.6153846153846154,18,8,10,368.6478764542167,0.44936868686868686,0.3055485514167464,0.19576705551205326,127471.58893014808,400.98422004472764,127872.57315019281,1807,0,227.0888888888889,35,10,15,38.23364374403056,0.5967261904761905,47.540509259259245,1009.837962962961,28.85251322751317,0
2716,4,0,0,44,0.0,0.0,1.0,44,1200,700,500,0.5833333333333334,17,7,10,376.5264224418778,0.44897374911909793,0.3178328089513054,0.2000955884426201,127500.81045310338,801.4848036693851,128302.29525677276,1808,1,233.1818181818182,35,9,15,38.00471770188708,0.5970238095238095,47.51157407407406,1009.9537037037022,28.85582010582006,0
2717,4,0,1,43,0.0,0.022727272727272728,0.9772727272727273,44,1250,800,450,0.64,17,8,9,338.61573860811245,0.4482800387596899,0.23084232659699722,0.17310638845367698,125919.34292524858,-272.34573806376756,125646.99718718481,1809,2,234.1818181818182,41,3,17,40.585874435768176,0.5703760162601625,49.08234126984126,1003.6706349206331,24.479771583430075,8
2718,4,3,4,42,0.06521739130434782,0.08695652173913043,0.9130434782608696,46,1050,800,250,0.7619047619047619,13,8,5,323.76874402007644,0.45271739130434785,0.2316105044550154,0.1681007318952235,126555.1950003002,-1005.0151812341383,125550.17981906606,1810,0,224.8695652173913,42,4,15,40.30519709809966,0.5753968253968254,48.449612403100765,1006.2015503875947,23.957179771133205,0
2719,4,4,3,43,0.08695652173913043,0.06521739130434782,0.9347826086956522,46,850,500,350,0.5882352941176471,12,5,7,326.8361809631601,0.4529287439613527,0.23212321002012248,0.17060815814917724,126774.66540660097,-913.090503124832,125861.57490347614,1811,0,225.06521739130434,42,4,16,40.00288655826037,0.5776289682539683,48.23158914728681,1007.073643410851,23.977943890734547,0
2720,4,1,2,42,0.022727272727272728,0.045454545454545456,0.9545454545454546,44,800,500,300,0.625,11,5,6,346.0343867792541,0.44933712121212116,0.2589404092163261,0.1802647308539973,126692.19655454761,-32.02869110608674,126660.16786344153,1812,0,236.27272727272728,41,3,17,39.60427342004992,0.5782520325203252,48.313492063492056,1006.7460317460307,24.55478126209831,0
2721,4,1,1,42,0.023255813953488372,0.023255813953488372,0.9767441860465116,43,1300,900,400,0.6923076923076923,17,9,8,350.75321356565416,0.4459902177925434,0.2741999802956592,0.18359912139862156,126887.15071220817,301.2151744992864,127188.36588670746,1813,0,242.25581395348837,40,3,19,39.28514390424315,0.5817708333333333,48.11991869918698,1007.5203252032506,25.188008130081265,0
2722,4,4,2,44,0.08695652173913043,0.043478260869565216,0.9565217391304348,46,1450,800,650,0.5517241379310345,21,8,13,344.6699191558953,0.45066425120772946,0.28669610396252754,0.18553972798465854,128019.00397022197,-374.8095591233108,127644.19441109865,1814,0,218.45652173913044,41,5,17,38.278824788419406,0.5917174796747968,46.999007936507915,1012.0039682539651,24.68302361595037,0
2723,4,1,0,45,0.022222222222222223,0.0,1.0,45,1400,900,500,0.6428571428571429,19,9,10,351.74177378109715,0.4461489898989899,0.2990397805212621,0.18994055784179237,128144.53124999987,14.8799681909627,128159.41121819083,1815,0,224.13333333333333,38,7,20,37.971536351165966,0.5978618421052632,46.87499999999999,1012.499999999999,26.644736842105235,0
2724,4,0,2,43,0.0,0.044444444444444446,0.9555555555555556,45,1400,1100,300,0.7857142857142857,17,11,6,346.3709384634956,0.4455808080808081,0.29315236407804846,0.1880056955590373,128350.40655570429,-108.62984582589877,128241.7767098784,1816,1,225.13333333333333,40,5,20,37.89719352789756,0.5966145833333334,46.671747967479675,1013.3130081300815,25.332825203252035,0
2725,4,1,0,44,0.022727272727272728,0.0,1.0,44,1250,1000,250,0.8,15,10,5,388.63305430855985,0.44552721987315014,0.25440456935925204,0.20204849367979064,126609.88004474076,1163.7343247722692,127773.61436951303,1817,0,230.5909090909091,36,8,16,38.61707881093581,0.5859375,48.395270270270274,1006.4189189189194,27.956081081081095,8
2726,4,1,1,44,0.022222222222222223,0.022222222222222223,0.9777777777777777,45,1050,800,250,0.7619047619047619,13,8,5,384.2728551359788,0.4458122895622896,0.2632575345446635,0.2014747182860685,126953.84787867422,756.9835189673745,127710.8313976416,1818,0,226.44444444444446,37,8,17,38.37211674464149,0.5875563063063063,48.05372807017544,1007.7850877192984,27.237434803224282,0
2727,4,5,4,45,0.10204081632653061,0.08163265306122448,0.9183673469387755,49,1550,1100,450,0.7096774193548387,20,11,9,364.5075355234314,0.4509105725623583,0.29620561953668445,0.1971072364223896,128200.04712988615,-448.24032394582736,127751.80680594033,1819,0,208.77551020408163,37,12,18,37.5915800490833,0.6002252252252251,46.82017543859649,1012.7192982456143,27.37079184447606,0
2728,4,0,2,43,0.0,0.044444444444444446,0.9555555555555556,45,1400,1000,400,0.7142857142857143,18,10,8,386.8784297083271,0.44534932659932663,0.313689192192546,0.20797468526825238,127963.79145408153,901.286139455772,128865.0775935373,1820,1,227.82222222222222,34,11,19,37.26761971996705,0.6038602941176471,47.05357142857142,1011.7857142857134,29.758403361344513,0
2729,4,1,0,44,0.022727272727272728,0.0,1.0,44,1400,1100,300,0.7857142857142857,17,11,6,394.3495007885372,0.44726700140944325,0.3237288135593219,0.212619247814185,128082.49831795455,1301.8538542867993,129384.35217224136,1821,0,231.25,33,11,20,36.9567191283293,0.6073232323232323,46.936274509803916,1012.2549019607836,30.674390968508593,0
2730,4,1,1,44,0.022222222222222223,0.022222222222222223,0.9777777777777777,45,1650,1200,450,0.7272727272727273,21,12,9,382.70635615687485,0.4480008417508417,0.2741749264785971,0.19929818808146704,126677.74128818468,772.4432182386763,127450.18450642336,1822,0,227.0888888888889,37,8,15,38.69619776349707,0.584740990990991,48.32785087719297,1006.6885964912269,27.207799905168294,8
2731,4,3,1,46,0.06382978723404255,0.02127659574468085,0.9787234042553191,47,1450,1000,450,0.6896551724137931,19,10,9,370.8012176625588,0.450354609929078,0.2960304575275101,0.19644575148505772,127376.050036523,48.267760377783134,127424.31779690078,1823,0,218.3404255319149,36,11,16,38.27741521642125,0.59375,47.63513513513514,1009.4594594594594,28.040540540540537,0
2732,4,2,1,47,0.041666666666666664,0.020833333333333332,0.9791666666666666,48,1700,1000,700,0.5882352941176471,24,10,14,355.55456612774964,0.4520814864066194,0.1705236292727692,0.18786210348495283,127267.13204089507,-489.5409169022593,126777.59112399281,1824,0,214.75,41,7,16,38.77394471208993,0.5840955284552846,47.74305555555556,1009.0277777777778,24.610433604336045,8
2733,4,2,1,48,0.04081632653061224,0.02040816326530612,0.9795918367346939,49,1750,1300,450,0.7428571428571429,22,13,9,344.80212046189064,0.45303642290249435,0.1837164998259222,0.18449565768714707,127776.88108436998,-988.4520912204747,126788.4289931495,1825,0,210.10204081632654,42,7,17,38.523097565650765,0.5877976190476191,47.23837209302326,1011.0465116279073,24.07253599114065,0
2734,4,0,2,46,0.0,0.041666666666666664,0.9583333333333334,48,1600,1100,500,0.6875,21,11,10,350.95186521503,0.45156434692671393,0.19081829475611345,0.18833185356486543,127893.53820231784,-623.1048437893814,127270.43335852846,1826,1,215.3125,41,7,17,38.248250948084205,0.5904471544715447,47.123015873015866,1011.5079365079355,24.670925280681352,0
2735,4,1,1,46,0.02127659574468085,0.02127659574468085,0.9787234042553191,47,1550,1000,550,0.6451612903225806,21,10,11,352.415120628124,0.4527058279370953,0.18892880946663748,0.19081940369361772,128252.72715547166,-359.62179524449317,127893.10536022716,1827,0,198.04255319148936,38,9,18,37.84388953345285,0.5989583333333333,46.7681623931624,1012.9273504273514,26.65598290598293,0
2736,4,3,2,47,0.061224489795918366,0.04081632653061224,0.9591836734693877,49,1500,1000,500,0.6666666666666666,20,10,10,335.14796177116233,0.4553394274376417,0.1948686451324717,0.18420538349978924,128848.62075617285,-1163.3294753086388,127685.29128086421,1828,0,190.73469387755102,41,8,16,37.67384860921114,0.6001016260162602,46.18055555555556,1015.2777777777778,24.76287262872629,0
2737,4,2,0,49,0.04081632653061224,0.0,1.0,49,1200,600,600,0.5,18,6,12,336.93086087739397,0.4545776643990929,0.2110186563895946,0.18603054640860864,129029.04652852904,-1105.2264549906722,127923.82007353837,1829,0,191.69387755102042,42,7,18,37.4449610554761,0.6004464285714286,46.00290697674419,1015.988372093024,24.190199335548193,0
2738,4,0,1,48,0.0,0.02040816326530612,0.9795918367346939,49,1850,1500,350,0.8108108108108109,22,15,7,337.2716457169295,0.45431193310657597,0.2129577925173307,0.18668297055012523,129127.5137931164,-1089.7901831320232,128037.72360998439,1830,1,192.69387755102042,42,7,18,37.33613785870912,0.6014384920634921,45.906007751937985,1016.3759689922481,24.199427833148764,0
2739,4,1,0,49,0.02040816326530612,0.0,1.0,49,1000,600,400,0.6,14,6,8,343.8859649612105,0.4544005102040816,0.2389046546326905,0.1914703725091892,129360.29188368049,-902.8988607299086,128457.39302295058,1831,0,193.57142857142858,39,10,19,36.93127517236671,0.608440170940171,45.67708333333333,1017.2916666666661,26.084401709401693,0
2740,4,0,1,48,0.0,0.02040816326530612,0.9795918367346939,49,1400,1000,400,0.7142857142857143,18,10,8,343.21789695613427,0.4540639172335601,0.24392708926034912,0.19155218645136113,129453.6613835346,-913.8373173343654,128539.82406620024,1832,1,194.57142857142858,41,8,17,36.85335023071425,0.6061991869918699,45.58531746031745,1017.6587301587278,24.820944638017753,0
2741,4,0,2,46,0.0,0.041666666666666664,0.9583333333333334,48,900,700,200,0.7777777777777778,11,7,4,343.1486592876463,0.4536790780141844,0.23848908594815854,0.19200608187621707,129554.63927469114,-708.6998456790349,128845.93942901211,1833,2,196.27083333333334,41,7,17,36.752501136880404,0.6072154471544715,45.4861111111111,1018.0555555555537,24.83062330623302,0
2742,4,0,0,46,0.0,0.0,1.0,46,1250,900,350,0.72,16,9,7,379.4642037937989,0.45450885668276975,0.1913820296132387,0.20505277484117818,128172.28768707684,635.865963565715,128808.15365064255,1834,3,203.08695652173913,37,9,15,37.241359862840625,0.5999436936936937,46.84758771929825,1012.6096491228074,27.36782835467047,8
2743,4,1,3,44,0.02127659574468085,0.06382978723404255,0.9361702127659575,47,1650,1000,650,0.6060606060606061,23,10,13,376.2056671045224,0.45478723404255317,0.1994753716117752,0.20494786342261295,128496.33487654323,268.2098765432117,128764.54475308645,1835,0,199.74468085106383,38,9,15,36.99200913242009,0.6014254385964912,46.52777777777778,1013.888888888889,26.681286549707607,0
2744,4,1,0,45,0.022222222222222223,0.0,1.0,45,1050,700,350,0.6666666666666666,14,7,7,390.10416987027213,0.4525883838383838,0.22938701997212108,0.21307873001949906,128601.01814229763,1033.5586853745579,129634.5768276722,1836,0,208.9111111111111,36,9,17,36.53246548980424,0.6061921296296297,46.424549549549546,1014.3018018018012,28.175050050050032,0
2745,4,0,1,44,0.0,0.022222222222222223,0.9777777777777777,45,900,500,400,0.5555555555555556,13,5,8,389.91731050805527,0.45231481481481484,0.21880267992219626,0.2135085675409193,128700.23108071687,1036.4895929516458,129736.72067366852,1837,1,209.9111111111111,37,8,17,36.43559541819753,0.6052927927927928,46.3267543859649,1014.6929824561381,27.424134660976705,0
2746,4,3,1,46,0.06382978723404255,0.02127659574468085,0.9787234042553191,47,1600,1100,500,0.6875,21,11,10,331.0263262761899,0.456541011409189,0.14198364590537382,0.17996545596928007,128414.47704464887,-767.2716149941457,127647.20542965473,1838,0,199.70212765957447,42,5,16,38.22060229445507,0.5942460317460317,46.60852713178295,1013.5658914728691,24.1325212255445,8
2747,4,1,3,44,0.02127659574468085,0.06382978723404255,0.9361702127659575,47,1450,900,550,0.6206896551724138,20,9,11,315.74590101695617,0.45588575393154485,0.11061764098326798,0.1626091390237324,126222.48661510994,-1326.6581041943339,124895.82851091561,1839,0,200.48936170212767,40,7,20,40.84833468176915,0.575,48.78048780487804,1004.8780487804869,25.121951219512173,8
2748,4,1,1,44,0.022222222222222223,0.022222222222222223,0.9777777777777777,45,900,500,400,0.5555555555555556,13,5,8,322.7888077489314,0.4551767676767677,0.14018085179816397,0.16742719147363994,126514.97938368037,-832.476128472247,125682.50325520812,1840,0,208.4,39,6,17,40.371108580106295,0.579594017094017,48.48958333333332,1006.0416666666652,25.79594017094013,0
2749,4,2,0,46,0.043478260869565216,0.0,1.0,46,1200,600,600,0.5,18,6,12,323.4660940827922,0.4561191626409018,0.16739437298894488,0.16974268365677914,126989.56164485388,-984.6365010906541,126004.92514376322,1841,0,204.7826086956522,40,6,20,39.86753881831012,0.5828125,48.01829268292681,1007.9268292682897,25.198170731707243,0
2750,4,2,1,47,0.041666666666666664,0.020833333333333332,0.9791666666666666,48,1450,1000,450,0.6896551724137931,19,10,9,314.3051690881275,0.45720670803782504,0.20290471851922964,0.16746346438844667,127605.49175417626,-1578.5868675260078,126026.90488665024,1842,0,197.20833333333334,42,6,17,39.46884690387136,0.5860615079365079,47.4079457364341,1010.3682170542621,24.056386120339575,0
2751,4,0,1,46,0.0,0.02127659574468085,0.9787234042553191,47,1550,1200,350,0.7741935483870968,19,12,7,322.7973217132536,0.45617483811285847,0.19855231410397067,0.17204033080321737,127617.7300347221,-1161.067708333343,126456.66232638876,1843,1,202.0,41,6,17,39.24183848797251,0.5876524390243902,47.39583333333333,1010.4166666666656,24.644308943089406,0
2752,4,2,1,47,0.041666666666666664,0.020833333333333332,0.9791666666666666,48,1950,1500,450,0.7692307692307693,24,15,9,324.9495257082648,0.4569296690307329,0.22007227646946204,0.1751508124638047,128070.95896430498,-1276.6805255092897,126794.27843879569,1844,0,198.70833333333334,42,6,20,38.72475110089987,0.5907738095238095,46.94767441860465,1012.2093023255811,24.10022148394241,0
2753,4,0,1,46,0.0,0.02127659574468085,0.9787234042553191,47,1350,900,450,0.6666666666666666,18,9,9,325.0120173049191,0.456541011409189,0.2212227309453274,0.17586266689786711,128225.67389875081,-1064.959632323421,127160.7142664274,1845,1,202.80851063829786,38,9,22,38.56540084388186,0.5986842105263157,46.794871794871796,1012.8205128205128,26.653171390013494,0
2754,4,2,1,47,0.041666666666666664,0.020833333333333332,0.9791666666666666,48,1150,900,250,0.782608695652174,14,9,5,318.4096059706515,0.45722517730496454,0.22910246533127876,0.17365364224785965,128540.3442382814,-1414.3039279513764,127126.04031033002,1846,0,199.33333333333334,39,9,16,38.412193973634665,0.6001602564102564,46.48437500000001,1014.0625000000011,26.001602564102594,0
2755,4,2,1,48,0.04081632653061224,0.02040816326530612,0.9795918367346939,49,1300,900,400,0.6923076923076923,17,9,8,321.9019768188096,0.4588293650793651,0.26801864910724094,0.1780647643921766,129102.89345592192,-1488.3046767021335,127614.58877921979,1847,0,196.22448979591837,42,7,19,37.75167651919657,0.6011904761904762,45.93023255813953,1016.2790697674402,24.197120708748578,0
2756,4,1,1,48,0.02040816326530612,0.02040816326530612,0.9795918367346939,49,1650,1200,450,0.7272727272727273,21,12,9,324.1790066870877,0.4573767006802721,0.27387460319904644,0.1804084370147635,129340.77222077921,-1413.8995982700412,127926.87262250917,1848,0,197.14285714285714,37,12,22,37.45227893356328,0.6117680180180181,45.69627192982455,1017.2149122806997,27.492294926505394,0
2757,4,0,1,47,0.0,0.020833333333333332,0.9791666666666666,48,1550,1100,450,0.7096774193548387,20,11,9,330.1247225819728,0.45739140070921985,0.2670160594955815,0.18384736951473837,129368.65790435507,-1058.4415397045386,128310.21636465054,1849,1,183.41666666666666,37,11,22,37.27275993389381,0.6120495495495495,45.6688596491228,1017.3245614035078,27.49525841631102,0
2758,4,0,1,46,0.0,0.02127659574468085,0.9787234042553191,47,1700,1300,400,0.7647058823529411,21,13,8,330.0485212518402,0.45621338267036693,0.25880796448093824,0.1843620849860402,129487.7711326191,-852.5505234964694,128635.22060912264,1850,2,187.89361702127658,36,11,20,37.15377664675076,0.615162037037037,45.5518018018018,1017.7927927927927,28.27202202202202,0
2759,4,0,1,45,0.0,0.021739130434782608,0.9782608695652174,46,1600,1200,400,0.75,20,12,8,329.90275938719697,0.45536433172302737,0.2576376507225553,0.18549597664238499,129745.78622118759,-639.3014213537595,129106.48479983384,1851,3,192.3913043478261,36,10,20,36.89574813013524,0.6177662037037037,45.298423423423436,1018.8063063063078,28.300175175175216,0
2760,4,1,2,44,0.021739130434782608,0.043478260869565216,0.9565217391304348,46,1500,900,600,0.6,21,9,12,332.51874428329313,0.45459943639291467,0.27766394842164166,0.18866437844094894,130099.04308431971,-547.9259122287748,129551.11717209093,1852,0,193.30434782608697,38,8,22,36.47109644989004,0.6175986842105263,44.95192307692309,1020.1923076923092,26.847165991902873,0
2761,4,0,0,44,0.0,0.0,1.0,44,900,300,600,0.3333333333333333,15,3,12,341.5279184691655,0.45362050739957716,0.270374659200844,0.19361573586341577,130066.77685682155,84.28711238075749,130151.06396920231,996,1,159.70454545454547,37,7,22,36.2740289870651,0.6190878378378378,44.98355263157896,1020.065789473686,27.569345661450974,0
2762,4,0,0,44,0.0,0.0,1.0,44,1550,1200,350,0.7741935483870968,19,12,7,340.1744769675678,0.4528387068357999,0.2701739650214878,0.1939676187027093,130292.12648158854,64.70575756154597,130356.83223915008,997,2,160.70454545454547,35,9,22,36.0802110493897,0.625297619047619,44.762731481481474,1020.9490740740731,29.169973544973516,0
2763,4,0,1,43,0.0,0.022727272727272728,0.9772727272727273,44,1300,800,500,0.6153846153846154,18,8,10,341.3422786476099,0.4525303911205074,0.26979397373165126,0.19522654627771577,130410.31867551853,102.91106717248022,130513.22974269101,998,3,161.70454545454547,35,9,22,35.93071293673276,0.6264880952380952,44.64699074074073,1021.4120370370358,29.183201058201025,0
2764,4,0,0,43,0.0,0.0,1.0,43,1450,1000,450,0.6896551724137931,19,10,9,346.46110372785904,0.45275009228497604,0.27221758446066047,0.19906298028762015,130587.70743580669,448.7122503000603,131036.41968610675,999,4,163.1627906976744,35,8,19,35.62037613709281,0.6282738095238095,44.473379629629626,1022.106481481481,29.20304232804231,0
2765,4,0,0,43,0.0,0.0,1.0,43,950,500,450,0.5263157894736842,14,5,9,349.5279382430741,0.4527039497969731,0.2776427719519028,0.20113226570039583,130646.86381440761,532.9457893947196,131179.80960380234,1000,5,164.1627906976744,35,8,19,35.482117249707535,0.6288690476190476,44.41550925925926,1022.3379629629633,29.209656084656093,0
2766,4,1,0,44,0.022727272727272728,0.0,1.0,44,1400,1000,400,0.7142857142857143,18,10,8,341.89676393381916,0.4536645525017618,0.2754875487548756,0.1984573169960675,130982.06948502558,156.46913805697744,131138.53862308257,1001,0,161.4090909090909,36,8,20,35.33828382838283,0.6302083333333333,44.08783783783784,1023.6486486486488,28.434684684684687,0
2767,4,1,0,45,0.022222222222222223,0.0,1.0,45,1300,800,500,0.6153846153846154,18,8,10,339.21844868489484,0.4534511784511785,0.2873406616091243,0.19900199455547105,131389.1439909297,-84.70606741601057,131304.4379235137,1002,0,158.8,34,11,21,34.99598428549311,0.6384803921568627,43.69047619047619,1025.2380952380952,30.15406162464986,0
2768,4,0,0,45,0.0,0.0,1.0,45,1150,900,250,0.782608695652174,14,9,5,335.7160589599118,0.4535353535353535,0.28059585993422287,0.1974193752859822,131480.69905045352,-171.96357709750845,131308.735473356,1003,1,159.8,34,11,21,34.99347069065582,0.6393995098039216,43.601190476190474,1025.595238095238,30.16456582633053,0
2769,4,0,1,44,0.0,0.022222222222222223,0.9777777777777777,45,1600,1200,400,0.75,20,12,8,332.0066371600019,0.45294612794612793,0.23800172265288544,0.1843800697143186,129258.63997443409,-381.62388464027015,128877.01608979382,1004,2,160.8,36,9,17,37.33665559246954,0.6128472222222222,45.77702702702704,1016.8918918918935,28.24699699699704,8
2770,4,1,0,45,0.022222222222222223,0.0,1.0,45,1400,1000,400,0.7142857142857143,18,10,8,331.27115267472703,0.45294612794612793,0.24374838590665893,0.18464126245627147,129401.8231702988,-426.5817760327768,128975.24139426602,1005,0,161.7111111111111,36,9,18,37.20992436819775,0.6142939814814814,45.63626126126127,1017.454954954956,28.262637637637667,0
2771,4,1,2,44,0.021739130434782608,0.043478260869565216,0.9565217391304348,46,1550,1300,250,0.8387096774193549,18,13,5,324.3581018309987,0.4534219001610306,0.24625218850306396,0.18237493272761804,129745.05077069171,-783.2283220103836,128961.82244868133,1006,0,159.17391304347825,38,8,15,37.03771672259507,0.6140350877192983,45.299145299145295,1018.8034188034181,26.810616284300476,0
2772,4,0,0,44,0.0,0.0,1.0,44,1150,600,550,0.5217391304347826,17,6,11,335.77142952731066,0.4518256694855532,0.2449804796430568,0.1887267000446606,129731.44531249985,-87.97743055557106,129643.46788194428,1007,1,164.4090909090909,37,7,15,36.760821404226306,0.6157094594594594,45.31249999999999,1018.7499999999989,27.533783783783754,0
2773,4,1,0,45,0.022222222222222223,0.0,1.0,45,1300,800,500,0.6153846153846154,18,8,10,328.4544354114742,0.4508207070707071,0.24317832704929487,0.18622820364066228,130071.79578493665,-455.4683505004207,129616.32743443623,1008,0,161.73333333333332,38,7,16,36.60234254992319,0.6173245614035088,44.97863247863247,1020.0854700854688,26.84435447593339,0
2774,4,0,1,44,0.0,0.022222222222222223,0.9777777777777777,45,1450,1100,350,0.7586206896551724,18,11,7,321.6992919616829,0.44983164983164986,0.23074829931972807,0.18329378262933052,130262.58680555526,-618.9236111111459,129643.66319444412,1009,1,162.73333333333332,38,7,16,36.58163265306123,0.6192434210526316,44.79166666666665,1020.833333333331,26.864035087719238,0
2775,4,0,1,43,0.0,0.022727272727272728,0.9772727272727273,44,1200,900,300,0.75,15,9,6,318.2455317132507,0.44747621564482026,0.22502638560059385,0.18209129435729393,130426.23325525929,-498.48680966473944,129927.74644559454,1010,2,165.97727272727272,38,6,17,36.50441899382909,0.6208881578947368,44.631410256410234,1021.4743589743556,26.880904183535673,0
2776,4,0,0,43,0.0,0.0,1.0,43,1300,700,600,0.5384615384615384,19,7,12,324.65856311359823,0.44691306755260246,0.22276464157893927,0.1860497226994161,130486.54994806083,-127.2848376423695,130359.26511041846,1011,3,170.25581395348837,37,6,18,36.279691636259564,0.6233108108108107,44.57236842105262,1021.7105263157886,27.613798008534825,0
2777,4,0,1,42,0.0,0.023255813953488372,0.9767441860465116,43,1200,900,300,0.75,15,9,6,325.42028576306467,0.44638242894056845,0.2223297725310973,0.18702638125051074,130598.6036568942,-100.1130155432677,130498.49064135095,1012,4,171.25581395348837,37,6,13,36.14701780733748,0.6244369369369369,44.4627192982456,1022.1491228070157,27.625651967757182,0
2778,4,0,0,42,0.0,0.0,1.0,42,1600,1200,400,0.75,20,12,8,331.75625965020225,0.4448920828493999,0.22530699132769105,0.19142378336360497,130751.61944038661,275.5336417498848,131027.1530821365,1013,5,175.28571428571428,36,6,13,35.830488879101516,0.6278935185185186,44.313063063063076,1022.74774774775,28.409659659659724,0
2779,4,1,3,40,0.023255813953488372,0.06976744186046512,0.9302325581395349,43,1350,1100,250,0.8148148148148148,16,11,5,327.7905092237758,0.4459902177925434,0.22870481810769872,0.19062768449033188,131054.4963109067,-8.315983636480667,131046.18032727022,1014,0,172.1860465116279,38,5,14,35.62621730662216,0.6271929824561404,44.017094017094024,1023.931623931625,26.945569050832237,0
2780,4,0,2,38,0.0,0.05,0.95,40,550,300,250,0.5454545454545454,8,3,5,367.5087342112332,0.4452857905982906,0.16987704918032764,0.20380029806259317,129201.38888888908,1518.9111695522147,130720.3000584413,1015,1,169.075,36,4,17,36.4924863387978,0.6122685185185186,45.83333333333334,1016.6666666666682,28.240740740740783,8
2781,4,2,0,40,0.05,0.0,1.0,40,1450,1100,350,0.7586206896551724,18,11,7,361.1978872620974,0.44428418803418807,0.19872188139059332,0.2030181228404204,129731.4453125001,1371.7447916666815,131103.19010416677,1016,0,169.05,37,3,18,36.11324130879346,0.6157094594594594,45.31250000000001,1018.7500000000008,27.533783783783804,0
2782,4,1,0,41,0.024390243902439025,0.0,1.0,41,850,500,350,0.5882352941176471,12,5,7,356.81751050279456,0.4457571138211382,0.20769002830371752,0.20230959562236867,130071.79578493707,1082.378871721846,131154.17465665893,1017,0,165.90243902439025,38,3,19,35.87902353023321,0.6173245614035088,44.97863247863249,1020.0854700854723,26.844354475933482,0
2783,4,0,0,41,0.0,0.0,1.0,41,1100,700,400,0.6363636363636364,15,7,8,353.34972645818823,0.4453252032520325,0.20451145478588906,0.20118613150068765,130235.32238476178,1003.7231079699314,131239.0454927317,1018,1,166.90243902439025,38,3,19,35.80154036703649,0.6189692982456141,44.81837606837608,1020.7264957264981,26.86122357174995,0
2784,4,0,0,41,0.0,0.0,1.0,41,1400,1000,400,0.7142857142857143,18,10,8,354.28782074718896,0.4451473577235772,0.20658009403208277,0.20230994701105245,130348.82010388785,1036.2055894518885,131385.02569333973,1019,2,167.90243902439025,36,5,20,35.66249448610499,0.6238425925925926,44.70720720720722,1021.1711711711725,28.365865865865903,0
2785,4,0,1,40,0.0,0.024390243902439025,0.975609756097561,41,1550,1100,450,0.7096774193548387,20,11,9,351.70870235032515,0.4448678861788618,0.20862460525431725,0.2018821299069703,130550.14209733384,983.1242137407717,131533.2663110746,1020,3,168.90243902439025,36,5,16,35.52433425160699,0.6258680555555556,44.51013513513514,1021.9594594594596,28.387762762762765,0
2786,4,1,0,41,0.024390243902439025,0.0,1.0,41,1300,1100,200,0.8461538461538461,15,11,4,347.2029893730282,0.44601117886178865,0.21422187150230698,0.20108563189500983,130895.62694028478,889.4705939047044,131785.0975341895,1021,0,168.97560975609755,36,5,17,35.28988298301604,0.6293402777777778,44.17229729729729,1023.31081081081,28.42530030030028,0
2787,4,0,0,41,0.0,0.0,1.0,41,1300,800,500,0.6153846153846154,18,8,10,347.4808715870946,0.444994918699187,0.22055304582962232,0.20200102841878909,131039.71370018649,906.7587858128177,131946.47248599931,1022,1,169.97560975609755,36,5,17,35.137116879307804,0.630787037037037,44.03153153153152,1023.8738738738724,28.4409409409409,0
2788,4,0,2,39,0.0,0.04878048780487805,0.9512195121951219,41,1500,1100,400,0.7333333333333333,19,11,8,345.1286233712864,0.4443089430894309,0.2183808824239044,0.2015391665874173,131212.72243527306,857.0532525768934,132069.77568784993,1023,2,170.97560975609755,36,5,17,35.02257822231993,0.6325231481481481,43.86261261261261,1024.549549549549,28.459709709709696,0
2789,4,0,0,39,0.0,0.0,1.0,39,1350,1000,350,0.7407407407407407,17,10,7,358.5440258924939,0.4423639226270805,0.2271161674146751,0.2080684622698961,130972.4633487654,1591.878858024691,132564.3422067901,1024,3,179.71794871794873,35,4,17,34.92198100407056,0.6321428571428571,44.09722222222222,1023.611111111111,29.246031746031743,0
2790,4,0,1,38,0.0,0.02564102564102564,0.9743589743589743,39,800,600,200,0.75,10,6,4,359.4552370276232,0.44208277103013943,0.22928208027133956,0.20875781822122944,131002.08340031287,1617.8769879543786,132619.96038826724,1025,4,180.71794871794873,35,4,17,34.86868758243827,0.6324404761904762,44.06828703703703,1023.7268518518514,29.249338624338613,0
2791,4,0,1,37,0.0,0.02631578947368421,0.9736842105263158,38,800,700,100,0.875,9,7,2,372.855414911564,0.4395299905168326,0.2290416595234015,0.2159747403355664,130901.38888888895,2161.458333333344,133062.8472222223,1026,5,185.31578947368422,34,4,18,34.62778230184582,0.633578431372549,44.16666666666667,1023.3333333333338,30.09803921568629,0
2792,4,0,0,37,0.0,0.0,1.0,37,950,500,450,0.5263157894736842,14,5,9,389.42697674483657,0.4387825325325325,0.21581021103042253,0.21643863660068816,129289.65627411267,2669.7759934413584,131959.43226755402,1027,6,187.13513513513513,35,2,18,35.84521167634004,0.6151785714285714,45.74652777777778,1017.013888888889,29.057539682539687,8
2793,4,0,0,37,0.0,0.0,1.0,37,1500,1100,400,0.7333333333333333,19,11,8,394.2909469357948,0.4378753753753754,0.22383985441310283,0.21996230999108557,129436.83556241433,2807.1544924554246,132243.99005486976,1028,7,188.13513513513513,35,2,18,35.57116317864725,0.6166666666666667,45.601851851851855,1017.5925925925931,29.074074074074087,0
2794,4,1,0,38,0.02631578947368421,0.0,1.0,38,1300,1100,200,0.8461538461538461,15,11,4,396.8504219022317,0.439885609293504,0.24739283596665618,0.22428737327732862,129946.6421658144,2713.8759536563507,132660.51811947074,1029,0,184.1578947368421,36,2,19,34.985687725498856,0.6197916666666667,45.10135135135135,1019.5945945945941,28.32207207207206,0
2795,4,1,0,39,0.02564102564102564,0.0,1.0,39,1200,700,500,0.5833333333333334,17,7,10,392.3877051120177,0.44093004948268105,0.25191152494790714,0.22408004674455217,130351.21588059407,2430.410128420924,132781.626009015,1030,0,180.4102564102564,35,4,20,34.68739374362461,0.6258928571428571,44.70486111111111,1021.1805555555551,29.17658730158729,0
2796,4,0,0,39,0.0,0.0,1.0,39,1400,1100,300,0.7857142857142857,17,11,6,399.21609458404873,0.4408738191632928,0.25651480697352236,0.22902397005084923,130528.56445312513,2621.8207465277915,133150.38519965293,1031,1,181.4102564102564,35,4,18,34.332526333673115,0.6276785714285714,44.53125000000001,1021.875000000001,29.1964285714286,0
2797,4,0,1,38,0.0,0.02564102564102564,0.9743589743589743,39,900,600,300,0.6666666666666666,12,6,6,392.42849144057857,0.4408175888439046,0.16363554717320028,0.2218580877352184,129958.94451530627,2402.3599153203118,132361.3044306266,1032,2,182.4102564102564,34,5,18,35.08586300836738,0.6240808823529411,45.08928571428572,1019.6428571428584,29.989495798319364,8
2798,4,0,1,37,0.0,0.02631578947368421,0.9736842105263158,38,1300,1000,300,0.7692307692307693,16,10,6,390.5231357483611,0.4380334281650071,0.17418365734155228,0.22161588991854853,130106.25608239618,2561.900621155327,132668.1567035515,1033,3,187.92105263157896,33,5,18,34.98435935935937,0.6278409090909092,44.94485294117647,1020.220588235294,30.915775401069517,0
2799,4,1,0,38,0.02631578947368421,0.0,1.0,38,800,400,400,0.5,12,4,8,389.9718211217351,0.4368183973447131,0.19163819184346353,0.22273030743025482,130356.4302942378,2567.066903354486,132923.49719759228,1034,0,188.39473684210526,33,5,19,34.74376475059004,0.6303661616161615,44.69975490196079,1021.2009803921569,30.945484254307786,0
2800,4,0,0,38,0.0,0.0,1.0,38,1000,700,300,0.7,13,7,6,391.9381193924934,0.43638869132290187,0.19196569537594899,0.22403376454163512,130387.71896626298,2620.783472702812,133008.5024389658,1035,1,189.39473684210526,33,5,19,34.661727061835066,0.6306818181818181,44.669117647058826,1021.3235294117649,30.94919786096257,0
2801,4,0,1,37,0.0,0.02631578947368421,0.9736842105263158,38,1250,800,450,0.64,17,8,9,393.11396760164666,0.4361960644855382,0.19530880096967862,0.22525025071442786,130481.60750973174,2658.8284854382823,133140.43599517003,1036,2,190.39473684210526,33,5,19,34.536179081204274,0.6316287878787878,44.577205882352935,1021.6911764705874,30.960338680926892,0
2802,4,0,0,37,0.0,0.0,1.0,37,1550,1300,250,0.8387096774193549,18,13,5,400.03662455255574,0.43477852852852855,0.19861908627203428,0.22906555762595376,130455.99819214873,3037.4354338842963,133493.43362603302,1037,3,194.6216216216216,32,5,19,34.38542825361513,0.6337890625,44.60227272727273,1021.5909090909089,31.924715909090903,0
2803,4,0,0,37,0.0,0.0,1.0,37,1500,1100,400,0.7333333333333333,19,11,8,395.38061178642454,0.4338088088088088,0.19272403192373577,0.2275335333073689,130649.55305899908,2931.2600436180014,133580.81310261707,1038,4,195.6216216216216,32,5,19,34.30745955292084,0.6357421875,44.41287878787879,1022.3484848484849,31.948390151515152,0
2804,4,0,0,37,0.0,0.0,1.0,37,1300,1100,200,0.8461538461538461,15,11,4,392.8511723541642,0.43308933933933935,0.18813826788151,0.22683445097940708,130778.66934815307,2875.310714467893,133653.98006262095,1039,5,196.6216216216216,32,5,19,34.24088589886023,0.6370442708333333,44.28661616161615,1022.853535353534,31.964172979797937,0
2805,4,0,0,37,0.0,0.0,1.0,37,1150,700,450,0.6086956521739131,16,7,9,389.16625216306176,0.43283908908908914,0.18267669273221387,0.22546050563128037,130907.84940631043,2788.983426436053,133696.83283274647,1040,6,197.6216216216216,32,5,19,34.20393789841659,0.6383463541666667,44.16035353535352,1023.3585858585847,31.97995580808077,0
2806,4,0,1,36,0.0,0.02702702702702703,0.972972972972973,37,1000,700,300,0.7,13,7,6,388.25853463654965,0.4326826826826827,0.18247827203051092,0.22531223624184013,130972.4633487653,2770.235339506158,133742.69868827146,1041,7,198.6216216216216,32,5,19,34.16157847127996,0.6389973958333333,44.097222222222214,1023.6111111111102,31.987847222222193,0
2807,4,0,0,36,0.0,0.0,1.0,36,800,500,300,0.625,11,5,6,396.50832579151387,0.4315806878306878,0.17986438137259086,0.22923958173244452,130828.11355590809,3174.8872545030263,134003.00081041112,1042,8,200.61111111111111,31,5,19,34.09711615968775,0.6401209677419355,44.23828124999999,1023.0468749999991,33.001512096774164,0
2808,4,0,0,36,0.0,0.0,1.0,36,1450,1100,350,0.7586206896551724,18,11,7,394.2521051433774,0.43088624338624343,0.1800830046022357,0.22975381299734737,131134.06795224966,3139.9764692378158,134274.0444214875,1043,9,201.61111111111111,32,4,20,33.84415064102563,0.640625,43.93939393939393,1024.2424242424233,32.00757575757573,0
2809,4,0,0,36,0.0,0.0,1.0,36,1300,1100,200,0.8461538461538461,15,11,4,395.46810349834783,0.42982804232804234,0.1792462517970832,0.2310456198624256,131231.0785410927,3179.5411501377253,134410.61969123041,1044,10,202.61111111111111,32,4,20,33.714571780653095,0.6416015625,43.84469696969696,1024.6212121212116,32.01941287878786,0
2810,4,1,0,37,0.02702702702702703,0.0,1.0,37,1000,700,300,0.7,13,7,6,382.56200710059204,0.4313063063063063,0.16950020790020837,0.22540364812852118,131554.7062321445,2665.6023620038577,134220.30859414834,1045,0,198.1081081081081,32,5,19,33.717435897435905,0.6448567708333333,43.529040404040394,1025.883838383837,32.058869949494905,0
2811,4,1,0,38,0.02631578947368421,0.0,1.0,38,900,700,200,0.7777777777777778,11,7,4,372.97005953532033,0.4331288525367473,0.16819686132166134,0.22153522813362989,131862.52170138882,2236.154513888885,134098.6762152777,1046,0,193.8684210526316,33,5,20,33.65238336713996,0.6455176767676767,43.229166666666664,1027.0833333333328,31.123737373737356,0
2812,4,0,0,38,0.0,0.0,1.0,38,1300,1000,300,0.7692307692307693,16,10,6,370.6750299708513,0.4329806780464675,0.17154530734181006,0.22108682797550186,132019.90370290258,2187.2963523644507,134207.20005526702,1047,1,194.8684210526316,33,5,20,33.55244852531996,0.6470959595959596,43.07598039215685,1027.6960784313712,31.14230540701125,0
2813,4,0,0,38,0.0,0.0,1.0,38,1050,700,350,0.6666666666666666,14,7,7,368.96259151170665,0.43303994784257943,0.1671073957178204,0.2210193387987601,132183.68055555547,2154.166666666663,134337.84722222213,1048,2,195.8684210526316,34,4,21,33.43125337655321,0.6464460784313726,42.916666666666664,1028.3333333333328,30.24509803921567,0
2814,4,0,0,38,0.0,0.0,1.0,38,1100,700,400,0.6363636363636364,15,7,8,366.41197873162633,0.43256578947368424,0.15884220000947447,0.22004524776802017,132278.91375171486,2093.7157064472076,134372.62945816206,1049,3,196.8684210526316,35,3,21,33.400840084008415,0.6452380952380952,42.82407407407408,1028.703703703705,29.39153439153443,0
2815,4,0,0,38,0.0,0.0,1.0,38,1150,700,450,0.6086956521739131,16,7,9,363.71682866462373,0.4316322901849217,0.15373961218836585,0.21911721141502924,132398.0034722221,2031.1299725651493,134429.13344478727,1050,4,197.8684210526316,34,4,22,33.35020242914981,0.6485906862745099,42.70833333333333,1029.1666666666656,30.269607843137223,0
2816,4,0,0,38,0.0,0.0,1.0,38,950,500,450,0.5263157894736842,14,5,9,362.2395299367958,0.43141002844950216,0.14749492172770706,0.21983316213695847,132673.81660997713,2011.9401927437352,134685.75680272086,1051,5,198.8684210526316,34,4,17,33.11065210692549,0.6513480392156863,42.440476190476176,1030.2380952380936,30.301120448179223,0
2817,4,0,0,38,0.0,0.0,1.0,38,1000,600,400,0.6,14,6,8,360.81256198240385,0.43043207681365575,0.14669297131010506,0.21950487344214104,132765.8180980724,1980.7149943310496,134746.53309240344,1052,6,199.8684210526316,34,4,17,33.054897770590266,0.6522671568627452,42.35119047619047,1030.595238095237,30.31162464985991,0
2818,4,0,1,37,0.0,0.02631578947368421,0.9736842105263158,38,1250,1100,150,0.88,14,11,3,359.95445066110557,0.4299134660976766,0.14929500425428444,0.21952151709332182,132857.85147392275,1964.5549886621125,134822.40646258486,1053,7,200.8684210526316,34,4,17,32.984507313317934,0.6531862745098039,42.26190476190475,1030.9523809523798,30.322128851540583,0
2819,4,0,1,36,0.0,0.02702702702702703,0.972972972972973,37,1350,1100,250,0.8148148148148148,16,11,5,364.6684129135979,0.42705205205205204,0.16895792120913344,0.2227614804412964,132919.2247732426,2294.2885487528283,135213.51332199544,1054,8,206.32432432432432,34,3,17,32.801316093280995,0.6537990196078431,42.20238095238095,1031.190476190476,30.329131652661058,0
2820,4,0,0,36,0.0,0.0,1.0,36,650,400,250,0.6153846153846154,9,4,5,372.8221243792767,0.423859126984127,0.17825147659253915,0.22668555631998105,132745.06987997403,2698.059790705491,135443.12967067954,1055,10,212.83333333333334,33,3,17,32.76635648313313,0.6543560606060606,42.37132352941176,1030.514705882353,31.2277183600713,0
2821,4,0,0,36,0.0,0.0,1.0,36,500,500,0,1.0,5,5,0,372.26084635873315,0.423561507936508,0.17580265990464472,0.22710881076258313,132871.38848339574,2692.5631067377813,135563.9515901335,1056,11,213.83333333333334,33,3,17,32.65370557470581,0.6556186868686869,42.248774509803916,1031.0049019607839,31.24257278669042,0
2822,4,0,0,36,0.0,0.0,1.0,36,750,500,250,0.6666666666666666,10,5,5,373.40224779588766,0.4233630952380953,0.17317037741330576,0.22799756988059497,132902.97752066507,2725.254108996527,135628.2316296616,1057,12,214.83333333333334,33,3,17,32.5925045558989,0.6559343434343434,42.218137254901954,1031.1274509803916,31.2462863933452,0
2823,4,1,1,36,0.02702702702702703,0.02702702702702703,0.972972972972973,37,1150,800,350,0.6956521739130435,15,8,7,365.56727450148867,0.4248936436436436,0.16752830312152334,0.22534221547629066,133257.0312499999,2342.88194444443,135599.91319444435,1058,0,210.0,34,3,18,32.438794726930304,0.6571691176470589,41.87499999999999,1032.4999999999993,30.367647058823508,0
2824,4,0,0,36,0.0,0.0,1.0,36,1000,800,200,0.8,12,8,4,373.2754225688262,0.42291666666666666,0.17293076831730225,0.2292744225712679,133124.20590938575,2738.3988429930737,135862.60475237883,1059,1,216.47222222222223,33,3,18,32.37330780192377,0.6581439393939394,42.00367647058823,1031.9852941176466,31.272281639928686,0
2825,4,0,0,36,0.0,0.0,1.0,36,950,600,350,0.631578947368421,13,6,7,374.8893833916013,0.4216435185185185,0.1781720600258463,0.2312458231667373,133282.33882400996,2793.2267637447158,136075.56558775468,1060,2,217.47222222222223,33,3,19,32.17273914075482,0.6597222222222222,41.85049019607843,1032.5980392156862,31.29084967320261,0
2826,4,0,0,36,0.0,0.0,1.0,36,850,400,450,0.47058823529411764,13,4,9,376.91124591746404,0.42086640211640214,0.171695004613154,0.23328647599737326,133408.91273788936,2856.6639033064334,136265.5766411958,1061,3,218.47222222222223,33,3,19,31.99337682878608,0.6609848484848485,41.727941176470594,1033.0882352941185,31.30570409982177,0
2827,4,0,0,36,0.0,0.0,1.0,36,950,600,350,0.631578947368421,13,6,7,379.1623309053067,0.42061838624338627,0.17786738351254505,0.2350806451612905,133472.22222222242,2921.5277777778015,136393.75000000023,1062,4,219.47222222222223,33,3,19,31.871639784946233,0.6616161616161615,41.66666666666668,1033.3333333333348,31.313131313131358,0
2828,4,0,0,36,0.0,0.0,1.0,36,900,600,300,0.6666666666666666,12,6,6,380.0239566910249,0.42017195767195764,0.18096226042284136,0.23621975495127479,133567.21460796345,2951.7482759035192,136518.96288386697,1063,5,220.47222222222223,33,3,20,31.753976486860303,0.6625631313131313,41.574754901960794,1033.700980392158,31.324272133095697,0
2829,4,0,1,35,0.0,0.027777777777777776,0.9722222222222222,36,900,600,300,0.6666666666666666,12,6,6,377.5841176426582,0.41977513227513225,0.17036225302425967,0.23591321517555003,133757.30075271544,2900.926476595554,136658.22722931099,1064,6,221.47222222222223,33,3,16,31.626263673340446,0.6644570707070707,41.390931372549026,1034.436274509805,31.34655377302439,0
2830,4,0,1,34,0.0,0.02857142857142857,0.9714285714285714,35,1000,800,200,0.8,12,8,4,380.8315951715902,0.4184173669467787,0.15703827651118996,0.23863117385522598,133863.92332415073,3195.9222910927624,137059.84561524348,1065,7,223.11428571428573,32,3,16,31.435303806734993,0.66796875,41.287878787878796,1034.848484848486,32.339015151515184,0
2831,4,0,0,34,0.0,0.0,1.0,34,1100,900,200,0.8181818181818182,13,9,4,384.39894902614895,0.41757650029708854,0.15723754290448588,0.24183073122277995,134010.959201389,3502.7343750000196,137513.69357638902,1066,8,226.88235294117646,31,3,18,31.195506371562704,0.6720430107526882,41.14583333333334,1035.4166666666677,33.400537634408636,0
2832,4,0,1,33,0.0,0.029411764705882353,0.9705882352941176,34,900,500,400,0.5555555555555556,13,5,8,385.2605854506079,0.41677807486631013,0.15887529115983323,0.2430410751197133,134112.0931837294,3533.6207071940144,137645.7138909234,1067,9,227.88235294117646,31,3,18,31.07178399329563,0.6730510752688172,41.048177083333336,1035.8072916666667,33.413138440860216,0
2833,4,0,2,31,0.0,0.06060606060606061,0.9393939393939394,33,1250,800,450,0.64,17,8,9,390.39679702879505,0.4157986111111111,0.15020583412954025,0.24641999301399853,134132.75965790835,3872.9999494161084,138005.75960732446,1068,10,232.45454545454547,30,3,18,30.918050689849068,0.6760416666666667,41.02822580645161,1035.8870967741927,34.52956989247309,0
2834,4,0,0,31,0.0,0.0,1.0,31,850,500,350,0.5882352941176471,12,5,7,402.24970758348866,0.4092293906810036,0.13884466288245934,0.25330859964041286,134046.91358024674,4584.066358024667,138630.9799382714,1069,35,216.2258064516129,29,2,18,30.697313125894144,0.6781609195402298,41.1111111111111,1035.555555555554,35.70881226053635,0
2835,4,0,0,31,0.0,0.0,1.0,31,700,400,300,0.5714285714285714,10,4,6,401.5402803616884,0.408826164874552,0.14128077827917984,0.2532135352264458,134097.95388195151,4569.145999537505,138667.09988148903,1070,36,217.2258064516129,30,1,18,30.6644173371399,0.6756944444444444,41.06182795698924,1035.7526881720419,34.52508960573473,0
2836,4,0,0,31,0.0,0.0,1.0,31,850,500,350,0.5882352941176471,12,5,7,400.5990985447293,0.408826164874552,0.1382560222307787,0.25309982390022706,134167.5699502831,4549.481515204049,138717.05146548714,1071,37,218.2258064516129,30,1,20,30.618891627746073,0.6763888888888889,40.99462365591397,1036.0215053763427,34.53405017921143,0
2837,4,0,0,31,0.0,0.0,1.0,31,1150,900,250,0.782608695652174,14,9,5,417.078296245517,0.40860215053763443,0.13105845449535836,0.24081683114024158,130777.62783269743,4709.448527286396,135487.07635998382,1072,38,219.2258064516129,30,1,15,33.62242663162505,0.6423611111111112,44.28763440860215,1022.8494623655914,34.09498207885305,8
2838,4,0,0,31,0.0,0.0,1.0,31,850,600,250,0.7058823529411765,11,6,5,418.78647882391755,0.4090501792114695,0.12862548357436188,0.24245030139060716,130880.75798141402,4762.218356168345,135642.97633758237,1073,39,220.2258064516129,30,1,16,33.47371820132231,0.6434027777777778,44.18682795698925,1023.2526881720429,34.1084229390681,0
2839,4,0,0,31,0.0,0.0,1.0,31,900,600,300,0.6666666666666666,12,6,6,418.4043792149214,0.409005376344086,0.12829526972079175,0.24287863964183237,130983.9287778934,4760.84988148919,135744.77865938257,1074,40,221.2258064516129,30,1,16,33.37846857492997,0.6444444444444444,44.086021505376344,1023.6559139784946,34.121863799283155,0
2840,4,0,0,31,0.0,0.0,1.0,31,650,400,250,0.6153846153846154,9,4,5,418.9983407144767,0.40815412186379924,0.1268484268797454,0.24453333483351772,131190.39231414034,4793.711339461206,135984.10365360155,1075,41,222.2258064516129,30,1,18,33.153207819469955,0.6465277777777778,43.884408602150536,1024.4623655913977,34.14874551971325,0
2841,4,0,0,31,0.0,0.0,1.0,31,1050,600,450,0.5714285714285714,15,6,9,418.0712538832706,0.4069444444444445,0.12955677943876198,0.24487030584591557,131328.125,4780.975040467107,136109.1000404671,1076,42,223.2258064516129,29,2,19,33.036924119241185,0.6508620689655172,43.75,1025.0,35.3448275862069,0
2842,4,0,0,31,0.0,0.0,1.0,31,550,400,150,0.7272727272727273,7,4,3,417.6898694247088,0.40636200716845877,0.13521993340383331,0.24510227472918908,131399.31520061722,4776.832561728384,136176.1477623456,1077,43,224.2258064516129,29,2,19,32.97435202745416,0.6515804597701149,43.68055555555555,1025.2777777777771,35.354406130268174,0
2843,4,1,1,31,0.03125,0.03125,0.96875,32,1050,700,350,0.6666666666666666,14,7,7,395.52945498985855,0.40862315188172044,0.1623465549102432,0.221636919452897,129611.66030755,3873.0497303798766,133484.71003792988,1078,0,218.1875,30,2,19,35.36111844420979,0.6305555555555555,45.43010752688172,1018.2795698924731,33.9426523297491,8
2844,4,1,0,32,0.03125,0.0,1.0,32,1200,800,400,0.6666666666666666,16,8,8,397.15083025315704,0.4102822580645162,0.17938853936956867,0.20316096552233454,125945.79272799994,3603.8952297634164,129549.68795776335,1079,0,211.09375,31,1,18,39.08972737492973,0.5903897849462365,49.055989583333314,1003.7760416666644,32.37987231182788,8
2845,4,1,0,33,0.030303030303030304,0.0,1.0,33,1200,900,300,0.75,15,9,6,387.15004796499466,0.4143781565656566,0.16879305745178397,0.20042540016632787,126436.39458550316,3190.0093926323393,129626.40397813551,1080,0,205.66666666666666,31,2,16,38.83350595546349,0.5954301075268817,48.567708333333314,1005.7291666666641,32.44287634408594,0
2846,4,2,0,35,0.05714285714285714,0.0,1.0,35,700,400,300,0.5714285714285714,10,4,6,373.0021787973836,0.4205532212885154,0.18471470220741448,0.19683038050384985,127215.61418685107,2490.340253748547,129705.95444059963,1081,0,194.85714285714286,33,2,18,38.38678328474247,0.5984848484848485,47.79411764705882,1008.8235294117636,30.570409982174656,0
2847,4,0,0,35,0.0,0.0,1.0,35,900,800,100,0.8888888888888888,10,8,2,389.2319267225362,0.41981792717086835,0.1678087566040698,0.1994357208028604,126013.07377270756,2825.0409998558152,128838.11477256338,1082,1,195.85714285714286,33,2,20,39.218819927580455,0.5861742424242424,48.98897058823529,1004.0441176470584,30.425579322638136,8
2848,4,1,0,36,0.027777777777777776,0.0,1.0,36,1050,700,350,0.6666666666666666,14,7,7,381.8025039295983,0.4200892857142857,0.16798329339452778,0.19769420503155913,126444.09789804395,2455.338391484034,128899.43628952799,1083,0,191.38888888888889,33,3,19,38.960008732382924,0.5905934343434344,48.56004901960784,1005.759803921568,30.477569815805094,0
2849,4,3,0,39,0.07692307692307693,0.0,1.0,39,900,600,300,0.6666666666666666,12,6,6,355.6343670468467,0.433816914080072,0.1828354493403035,0.18881618456610938,127462.99500192233,1271.011600105724,128734.00660202805,1084,0,177.5897435897436,33,6,17,38.57099514563106,0.601010101010101,47.549019607843135,1009.8039215686275,30.600118835412957,0
2850,4,0,0,39,0.0,0.0,1.0,39,1000,700,300,0.7,13,7,6,357.5435105363443,0.43342330184435446,0.18344510668992253,0.1908518661095944,127679.65032980111,1330.206080594005,129009.8564103951,1085,1,178.5897435897436,33,6,18,38.300669940584434,0.603219696969697,47.33455882352941,1010.6617647058829,30.62611408199645,0
2851,4,1,1,39,0.025,0.025,0.975,40,1050,700,350,0.6666666666666666,14,7,7,344.2609515654389,0.43414797008547007,0.17718772053634435,0.18548204120464906,128054.1454081633,816.8083900226782,128870.95379818598,1086,0,175.1,34,6,19,38.25325413628166,0.6047794117647058,46.964285714285715,1012.1428571428575,29.76890756302522,0
2852,4,0,0,39,0.0,0.0,1.0,39,950,700,250,0.7368421052631579,12,7,5,353.13668186662227,0.4335076473234368,0.18678790024315006,0.18995762750310774,127989.4770791283,1239.5558499135016,129229.0329290418,1087,1,180.51282051282053,33,6,19,38.094823584029704,0.6063762626262627,47.02818627450981,1011.8872549019613,30.663250148544282,0
2853,4,3,1,41,0.07142857142857142,0.023809523809523808,0.9761904761904762,42,1000,900,100,0.9,11,9,2,327.06980621176046,0.4389155052264808,0.18451720603928257,0.1795497705963954,128800.98637488857,25.382730703693056,128826.36910559227,1088,0,168.54761904761904,36,6,19,37.92734450114636,0.6082175925925926,46.227477477477485,1015.0900900900915,28.196946946946987,0
2854,4,1,0,42,0.023809523809523808,0.0,1.0,42,1400,1100,300,0.7857142857142857,17,11,6,328.7683031477285,0.4376209833526907,0.19213142624829027,0.18113386231456136,128943.91593874303,78.5344888807943,129022.45042762381,1089,0,169.52380952380952,36,6,20,37.73884761799163,0.6096643518518519,46.08671171171172,1015.653153153155,28.212587587587638,0
2855,4,1,0,43,0.023255813953488372,0.0,1.0,43,1600,1200,400,0.75,20,12,8,319.30264964654447,0.43971483942414175,0.1914975239766814,0.17744350362322922,129285.00987082548,-343.7907577331658,128941.21911309232,1090,0,166.5581395348837,37,6,21,37.63286163522012,0.611204954954955,45.75109649122806,1016.9956140350864,27.486367946894227,0
2856,4,0,1,42,0.0,0.023255813953488372,0.9767441860465116,43,1050,900,150,0.8571428571428571,12,9,3,320.7308106603057,0.43897655961609455,0.19161106292956065,0.17861587402799006,129368.6579043551,-301.4970952600921,129067.16080909502,1091,1,167.5581395348837,37,6,21,37.51167636703313,0.6120495495495495,45.6688596491228,1017.324561403508,27.495258416311028,0
2857,4,0,1,41,0.0,0.023809523809523808,0.9761904761904762,42,1600,1200,400,0.75,20,12,8,318.6615447866768,0.438044425087108,0.1820302965036973,0.1784735286422846,129591.85157933203,-140.81207679286933,129451.03950253916,1092,2,169.47619047619048,37,5,15,37.33801780458037,0.6143018018018018,45.44956140350877,1018.2017543859643,27.518966334755792,0
2858,4,0,1,40,0.0,0.024390243902439025,0.975609756097561,41,900,700,200,0.7777777777777778,11,7,4,323.00536313596655,0.43816056910569107,0.17200461699442293,0.1812196342556873,129659.75265806333,176.15909828746064,129835.91175635079,1093,3,171.85365853658536,36,5,15,37.15861344537815,0.6168981481481481,45.382882882882875,1018.4684684684673,28.29079079079076,0
2859,4,0,0,40,0.0,0.0,1.0,40,1000,600,400,0.6,14,6,8,332.53984354788554,0.43556356837606836,0.17643246930422896,0.1860700040615268,129554.63927469136,616.415895061722,130171.05516975309,1094,5,177.075,35,5,16,37.022510231923576,0.6178571428571429,45.48611111111111,1018.0555555555557,29.08730158730159,0
2860,4,1,0,41,0.024390243902439025,0.0,1.0,41,1050,800,250,0.7619047619047619,13,8,5,324.037416518975,0.43607723577235774,0.18226683260868382,0.18313575338094912,129946.64216581464,221.51484254527045,130168.1570083599,1095,0,173.73170731707316,36,5,18,36.84168139312275,0.6197916666666667,45.10135135135136,1019.5945945945961,28.322072072072114,0
2861,4,0,1,40,0.0,0.024390243902439025,0.975609756097561,41,1450,900,550,0.6206896551724138,20,9,11,320.7376127962042,0.4353150406504065,0.18505468356747312,0.18220711658598188,130147.65346004815,148.64953636071584,130296.30299640886,1096,1,174.73170731707316,36,5,19,36.722400029430155,0.6218171296296297,44.904279279279294,1020.382882882885,28.34396896896903,0
2862,4,0,1,39,0.0,0.025,0.975,40,1550,1200,350,0.7741935483870968,19,12,7,327.47857062799375,0.43314636752136754,0.18742825607064018,0.1858994893414553,130118.92804967148,522.2321138706484,130641.16016354212,1097,2,179.9,36,4,19,36.579516188373816,0.6215277777777778,44.93243243243244,1020.2702702702718,28.340840840840883,0
2863,4,0,1,38,0.0,0.02564102564102564,0.9743589743589743,39,750,500,250,0.6666666666666666,10,5,5,336.57783838546163,0.4315677013045434,0.19302794583693528,0.190468036866686,129996.88042534712,950.8138020833248,130947.69422743045,1098,3,185.23076923076923,35,4,19,36.471101464079005,0.6223214285714286,45.05208333333333,1019.7916666666657,29.136904761904734,0
2864,4,0,1,37,0.0,0.02631578947368421,0.9736842105263158,38,1100,800,300,0.7272727272727273,14,8,6,342.34930567206055,0.43135075865339023,0.1905629311986632,0.19384709198232272,130019.6446286848,1302.4270124716572,131322.07164115645,1099,4,188.18421052631578,34,4,19,36.30087350686745,0.6246936274509804,45.029761904761905,1019.8809523809523,29.996498599439775,0
2865,4,0,0,37,0.0,0.0,1.0,37,900,600,300,0.6666666666666666,12,6,6,343.0814160105355,0.43074324324324326,0.1878774497707707,0.1945374459721865,130075.00120146097,1525.263119953867,131600.26432141484,1100,5,191.32432432432432,33,4,20,36.22607320198624,0.6275252525252526,44.97549019607843,1020.0980392156862,30.912061794414733,0
2866,4,1,0,38,0.02631578947368421,0.0,1.0,38,1400,700,700,0.5,21,7,14,333.7792658588995,0.4320619962067331,0.19029481005547821,0.19156127308997675,130544.21864487213,1114.7258566416765,131658.94450151382,1101,0,187.26315789473685,33,5,18,35.98840288603752,0.632260101010101,44.51593137254902,1021.9362745098036,30.967765894236475,0
2867,4,1,0,39,0.02564102564102564,0.0,1.0,39,1000,600,400,0.6,14,6,8,324.6587272633618,0.4331983805668016,0.19171863768816189,0.1882057369037844,130931.84700963715,701.6333616779991,131633.48037131515,1102,0,183.43589743589743,34,5,19,35.83008607653833,0.6338848039215687,44.13690476190476,1023.4523809523806,30.10154061624649,0
2868,4,0,0,39,0.0,0.0,1.0,39,1450,1000,450,0.6896551724137931,19,10,9,325.2416223259259,0.4331983805668016,0.19211393891700768,0.18929150441458828,131084.19075963716,726.8069727891057,131810.99773242627,1103,1,184.43589743589743,34,5,19,35.661522514144,0.6354166666666667,43.988095238095234,1024.0476190476188,30.119047619047613,0
2869,4,0,0,39,0.0,0.0,1.0,39,1000,800,200,0.8,12,8,4,325.46566018260387,0.43311403508771934,0.18809179046222968,0.19002425179996527,131206.12953514734,740.6179138321871,131946.74744897953,1104,2,185.43589743589743,34,5,20,35.53286466806104,0.6366421568627452,43.86904761904761,1024.523809523809,30.1330532212885,0
2870,4,0,1,38,0.0,0.02564102564102564,0.9743589743589743,39,1700,1500,200,0.8823529411764706,19,15,4,327.3817214652439,0.43277665317138997,0.20044238435043038,0.19221123155965544,131419.65880102038,804.8788265306109,132224.537627551,1105,3,186.43589743589743,34,5,20,35.2686346220829,0.6387867647058824,43.660714285714285,1025.3571428571427,30.157563025210077,0
2871,4,0,0,38,0.0,0.0,1.0,38,700,500,200,0.7142857142857143,9,5,4,343.7619418455877,0.4306247036510194,0.1490910606078637,0.19918368871551034,130913.2332926098,1400.5974579904037,132313.8307506002,1106,4,191.92105263157896,35,3,18,35.360118374425085,0.631547619047619,44.155092592592595,1023.3796296296302,29.23941798941801,8
2872,4,0,0,38,0.0,0.0,1.0,38,1050,700,350,0.6666666666666666,14,7,7,342.46967823683264,0.43041725936462777,0.14848816592691327,0.1990464371670842,131031.70680084024,1374.877293381351,132406.5840942216,1107,5,192.92105263157896,35,3,18,35.27347577059311,0.6327380952380952,44.039351851851855,1023.842592592593,29.252645502645514,0
2873,4,0,0,38,0.0,0.0,1.0,38,950,700,250,0.7368421052631579,12,7,5,341.6021111216479,0.42997273589378854,0.1471162082421238,0.19884838678975902,131090.96364883392,1356.189986282564,132447.15363511647,1108,6,193.92105263157896,35,3,18,35.23583484026521,0.6333333333333333,43.981481481481474,1024.0740740740732,29.259259259259235,0
2874,4,0,0,38,0.0,0.0,1.0,38,700,400,300,0.5714285714285714,10,4,6,341.8856431067876,0.42939485538169747,0.15351521386224576,0.19947460956744745,131179.8740381731,1369.703119641644,132549.57715781473,1109,7,194.92105263157896,35,3,19,35.13880258351222,0.6342261904761906,43.89467592592593,1024.421296296297,29.269179894179914,0
2875,4,1,0,39,0.02564102564102564,0.0,1.0,39,1100,800,300,0.7272727272727273,14,8,6,335.8747781998376,0.43041497975708504,0.1534575681292134,0.19732101485727235,131443.57829112894,1029.716540865186,132473.29483199414,1110,0,190.89743589743588,36,3,20,35.026813822388156,0.634837962962963,43.637387387387385,1025.4504504504503,28.48473473473473,0
2876,4,1,1,39,0.025,0.025,0.975,40,800,500,300,0.625,11,5,6,327.9456877873992,0.43285256410256406,0.155194423672685,0.19392922194427323,131693.64762474992,637.6727695060009,132331.32039425592,1111,0,187.1,37,3,16,34.97834544030195,0.6354166666666667,43.39364035087719,1026.4254385964912,27.74122807017544,0
2877,4,0,1,38,0.0,0.02564102564102564,0.9743589743589743,39,1250,800,450,0.64,17,8,9,336.0730979456894,0.43139901034637873,0.16026766619391708,0.1983353671296065,131616.85333982643,1046.5767287557921,132663.4300685822,1112,1,192.87179487179486,36,3,17,34.84713381621305,0.6365740740740741,43.46846846846847,1026.126126126127,28.503503503503527,0
2878,4,0,0,38,0.0,0.0,1.0,38,1150,800,350,0.6956521739130435,15,8,7,375.5892691795038,0.4304913466097677,0.22037551778403497,0.20003164921707695,127588.49511584801,1997.1598861867224,129585.65500203473,1113,2,198.6578947368421,35,3,16,37.93831385802116,0.5979166666666667,47.424768518518526,1010.3009259259268,28.865740740740765,8
2879,4,0,0,38,0.0,0.0,1.0,38,1050,700,350,0.6666666666666666,14,7,7,377.6044171287412,0.43066915599810335,0.22221519101773657,0.20168925839665425,127705.4548852238,2044.4287712191394,129749.88365644294,1114,3,199.6578947368421,35,3,16,37.76730504981106,0.5991071428571428,47.30902777777778,1010.763888888889,28.878968253968257,0
2880,4,0,1,37,0.0,0.02631578947368421,0.9736842105263158,38,900,500,400,0.5555555555555556,13,5,8,375.316930740473,0.43003200568990047,0.22131404271723,0.2011975055711813,127851.7299489884,1996.9837748628324,129848.71372385124,1115,4,200.6578947368421,35,3,17,37.675001907377734,0.6005952380952381,47.164351851851855,1011.3425925925931,28.89550264550266,0
2881,4,3,2,38,0.075,0.05,0.95,40,1150,900,250,0.782608695652174,14,9,5,353.6542251675536,0.4375667735042735,0.20539857888309054,0.19316941213366626,128601.01814229778,1096.7284813279316,129697.7466236257,1116,0,184.375,36,4,17,37.45674660449282,0.6061921296296297,46.42454954954955,1014.3018018018024,28.175050050050068,0
2882,4,0,0,38,0.0,0.0,1.0,38,1400,1200,200,0.8571428571428571,16,12,4,370.1604700484763,0.4336178283546705,0.21195463988919627,0.20094425516917308,128355.55555555574,1902.430555555581,130257.98611111131,1117,1,195.07894736842104,34,4,19,37.289268092105274,0.607843137254902,46.66666666666668,1013.3333333333348,29.803921568627494,0
2883,4,0,0,38,0.0,0.0,1.0,38,850,400,450,0.47058823529411764,13,4,9,369.8733436107532,0.4337808202939782,0.20655499582779568,0.20124418663549962,128446.04768990951,1901.7538265306346,130347.80151644014,1118,2,196.07894736842104,34,4,17,37.20395380700725,0.6087622549019608,46.57738095238096,1013.6904761904779,29.814425770308173,0
2884,4,0,0,38,0.0,0.0,1.0,38,1150,800,350,0.6956521739130435,15,8,7,375.0669961985489,0.43373636794689424,0.14512113913730795,0.1954369431208338,126702.18431122464,1976.9947562358482,128679.17906746049,1119,3,197.07894736842104,34,4,16,38.8632690867526,0.5909926470588236,48.30357142857144,1006.7857142857156,29.611344537815164,8
2885,4,3,3,38,0.07317073170731707,0.07317073170731707,0.926829268292683,41,800,500,300,0.625,11,5,6,349.4839104418278,0.44491869918699184,0.13504006094160248,0.1852822742230036,127404.47108848736,705.7613339346244,128110.23242242199,1120,0,183.58536585365854,36,5,14,38.78625209146682,0.5940393518518519,47.606981981981995,1009.5720720720739,28.04366866866872,0
2886,4,3,0,41,0.07317073170731707,0.0,1.0,41,1200,1000,200,0.8333333333333334,14,10,4,375.3398137213308,0.4372967479674797,0.20963892023261854,0.20282786087633448,128173.0379027676,1421.68883410437,129594.72673687196,1121,0,184.5121951219512,36,5,17,37.34500111209965,0.6018518518518519,46.846846846846844,1012.6126126126123,28.12812812812812,0
2887,4,2,2,41,0.046511627906976744,0.046511627906976744,0.9534883720930233,43,1000,600,400,0.6,14,6,8,360.7296431896059,0.4414451827242525,0.20401925125831188,0.19718641117359278,128631.77237426033,680.2586702827034,129312.03104454304,1122,0,176.88372093023256,38,5,16,37.24591890468666,0.602796052631579,46.39423076923077,1014.4230769230767,26.69534412955465,0
2888,4,1,1,41,0.023809523809523808,0.023809523809523808,0.9761904761904762,42,1150,900,250,0.782608695652174,14,9,5,369.64711361578986,0.43909698025551686,0.21749772225396513,0.2019849644453436,128616.79945992977,1108.5657365727684,129725.36519650253,1123,0,182.07142857142858,37,5,18,37.035072784924154,0.6044481981981982,46.408991228070164,1014.3640350877176,27.415244191559935,0
2889,4,0,0,41,0.0,0.0,1.0,41,1300,1000,300,0.7692307692307693,16,10,6,380.39233529146424,0.43607723577235774,0.227082701555257,0.20792318909620766,128629.5755214671,1585.9409240320992,130215.51644549919,1124,1,187.34146341463415,36,5,18,36.749509695085834,0.6064814814814814,46.396396396396376,1014.4144144144118,28.178178178178104,0
2890,4,0,0,41,0.0,0.0,1.0,41,1350,1100,250,0.8148148148148148,16,11,5,378.892540163289,0.43628048780487805,0.22697289533673293,0.20761696028485693,128728.04763244437,1554.8193915435213,130282.8670239879,1125,2,188.34146341463415,37,4,18,36.6868134341797,0.6055743243243243,46.29934210526314,1014.8026315789456,27.427098150782314,0
2891,4,1,0,42,0.023809523809523808,0.0,1.0,42,1700,1400,300,0.8235294117647058,20,14,6,367.0388307222226,0.4391090785907859,0.22030881535665525,0.202841738465953,129065.65176647279,1074.4211821535234,130140.07294862632,1126,0,184.83333333333334,38,4,20,36.64287842147688,0.6071820175438596,45.96688034188033,1016.1324786324762,26.740328385065165,0
2892,4,0,0,42,0.0,0.0,1.0,42,1000,700,300,0.7,13,7,6,376.2429454447732,0.4394357336430507,0.231850117096019,0.20864381520119216,129201.38888888867,1322.3649006501328,130523.75378953881,1127,1,185.83333333333334,36,6,20,36.270491803278695,0.6122685185185186,45.83333333333332,1016.6666666666649,28.24074074074069,0
2893,4,0,0,42,0.0,0.0,1.0,42,1000,800,200,0.8,12,8,4,375.1082062131727,0.4393994386372435,0.23176417429167073,0.20830859307909935,129257.13320444737,1297.0822753154616,130554.21547976283,1128,2,186.83333333333334,37,5,20,36.2424520163899,0.6109234234234234,45.778508771929815,1016.8859649122794,27.483404457088632,0
2894,4,0,0,42,0.0,0.0,1.0,42,1250,600,650,0.48,19,6,13,369.0423576860218,0.4387461285327139,0.22749668955747882,0.2055207079598383,129368.65790435496,1148.5029047398948,130517.16080909486,1129,3,187.83333333333334,37,5,20,36.28296328231659,0.6120495495495495,45.668859649122794,1017.3245614035069,27.495258416310996,0
2895,4,0,0,42,0.0,0.0,1.0,42,1400,1000,400,0.7142857142857143,18,10,8,368.1190067833846,0.4390364885791715,0.22214390690141328,0.20555109370565747,129473.07715136217,1132.3001132295767,130605.37726459175,1130,4,188.83333333333334,38,4,16,36.20004898873258,0.6112938596491229,45.566239316239304,1017.7350427350409,26.78250112460634,0
2896,4,0,0,42,0.0,0.0,1.0,42,800,400,400,0.5,12,4,8,367.0437091022004,0.4389638985675571,0.22465897166841575,0.20551859857485097,129581.83235627122,1112.439276061044,130694.27163233227,1131,5,189.83333333333334,38,4,17,36.116649178034265,0.612390350877193,45.459401709401696,1018.1623931623913,26.79374718848398,0
2897,4,0,1,41,0.0,0.023809523809523808,0.9761904761904762,42,1250,800,450,0.64,17,8,9,365.3366602055902,0.4387340301974448,0.21903513371788108,0.20527313229583402,129717.84056770032,1078.1365284169724,130795.97709611729,1132,6,190.83333333333334,38,4,17,36.021674532424406,0.6137609649122807,45.3258547008547,1018.6965811965811,26.80780476833108,0
2898,4,0,2,39,0.0,0.04878048780487805,0.9512195121951219,41,900,600,300,0.6666666666666666,12,6,6,373.79776858805064,0.43788109756097565,0.22180682086691683,0.20995050001106372,129703.52055440148,1496.5773122499372,131200.0978666514,1133,7,195.58536585365854,37,4,18,35.820775026910674,0.615427927927928,45.33991228070176,1018.6403508771939,27.530820293978213,0
2899,4,0,1,38,0.0,0.02564102564102564,0.9743589743589743,39,1600,1300,300,0.8125,19,13,6,354.50807293240996,0.43544759334233013,0.14271080804231473,0.1927345609117347,128415.10662073549,1304.8383967053696,129719.94501744086,1134,8,204.10256410256412,38,1,16,37.624951688275175,0.6006030701754386,46.607905982905976,1013.568376068375,26.672852001799342,8
2900,4,0,0,38,0.0,0.0,1.0,38,1100,600,500,0.5454545454545454,16,6,10,361.35757700130745,0.4323287102892366,0.1619485754628891,0.19649349657647555,128422.23087873185,1681.2692366882027,130103.50011542004,1135,12,210.26315789473685,37,1,16,37.444107889802396,0.6024774774774775,46.60087719298245,1013.5964912280697,27.394499762920802,0
2901,4,2,0,40,0.05,0.0,1.0,40,1050,800,250,0.7619047619047619,13,8,5,349.65417488494415,0.43409455128205127,0.1696666666666662,0.19260611328407937,128936.76757812501,1016.6558159722226,129953.42339409723,1136,0,200.7,39,1,18,37.215811965811966,0.6041666666666667,46.09375,1015.6250000000001,26.041666666666668,0
2902,4,0,0,40,0.0,0.0,1.0,40,1150,1000,150,0.8695652173913043,13,10,3,351.4082782700507,0.4339476495726496,0.1714318671178099,0.19396066428793468,129016.12548828125,1067.4669053819441,130083.59239366319,1137,1,201.7,39,1,18,37.090403807375516,0.6049679487179487,46.015625,1015.9375,26.049679487179485,0
2903,4,0,0,40,0.0,0.0,1.0,40,1300,900,400,0.6923076923076923,17,9,8,351.57808092968116,0.4332398504273504,0.1699989751998361,0.19470481916639187,129148.44292534704,1081.1523437499814,130229.59526909703,1138,2,202.7,39,1,20,36.951304912208776,0.6063034188034189,45.88541666666666,1016.4583333333319,26.063034188034152,0
2904,4,2,1,41,0.047619047619047616,0.023809523809523808,0.9761904761904762,42,1000,700,300,0.7,13,7,6,336.2270045858153,0.4352255129694154,0.17339376232926318,0.1889171767074688,129717.84056770017,322.96074716695824,130040.80131486713,1139,0,194.0,38,4,18,36.76302219891627,0.6137609649122807,45.32585470085469,1018.6965811965797,26.807804768331046,0
2905,4,0,0,41,0.0,0.0,1.0,41,1450,1100,350,0.7586206896551724,18,11,7,349.5978469807902,0.43409552845528454,0.18513696544628,0.19663820787805694,129759.37307633106,872.7194906124836,130632.09256694354,1140,1,199.73170731707316,37,4,20,36.38030922657483,0.615990990990991,45.28508771929824,1018.8596491228061,27.536747273589356,0
2906,4,2,1,42,0.046511627906976744,0.023255813953488372,0.9767441860465116,43,1050,600,450,0.5714285714285714,15,6,9,336.8672281337169,0.4363002953119232,0.20291023801335317,0.1925937709534168,130395.54172092033,185.19694010418726,130580.73866102452,1141,0,191.3953488372093,39,4,22,36.05993965663779,0.6188568376068376,44.66145833333334,1021.3541666666682,26.188568376068417,0
2907,4,0,1,41,0.0,0.023809523809523808,0.9761904761904762,42,1350,1100,250,0.8148148148148148,16,11,5,347.61773366461,0.4347294812233837,0.21168034113948964,0.19861792684399357,130371.67302441763,663.9011021623414,131035.57412657997,1142,1,196.83333333333334,38,4,24,35.80962095058758,0.6203399122807017,44.68482905982907,1021.2606837606854,26.875281151596983,0
2908,4,0,0,41,0.0,0.0,1.0,41,1100,800,300,0.7272727272727273,14,8,6,357.25557961771534,0.43434959349593494,0.2183133614980708,0.20472985798756899,130486.54994806102,1123.4096068021038,131609.95955486313,1143,2,201.14634146341464,37,4,24,35.44707376404094,0.6233108108108107,44.57236842105264,1021.71052631579,27.613798008534864,0
2909,4,0,0,41,0.0,0.0,1.0,41,1250,800,450,0.64,17,8,9,360.9803690425382,0.4337144308943089,0.2234315885317184,0.207463563515077,130598.60365689475,1228.7064289012353,131827.310085796,1144,3,202.14634146341464,37,4,18,35.23832510906101,0.6244369369369369,44.46271929824563,1022.1491228070201,27.6256519677573,0
2910,4,0,0,41,0.0,0.0,1.0,41,1500,1000,500,0.6666666666666666,20,10,10,357.8835768189842,0.4326473577235772,0.221817487104375,0.20680357562110904,130808.47447083435,1162.8409443714027,131971.31541520575,1145,4,203.14634146341464,38,3,18,35.104873803307235,0.6247258771929824,44.25747863247864,1022.9700854700862,26.920265407107532,0
2911,4,0,0,41,0.0,0.0,1.0,41,1400,1100,300,0.7857142857142857,17,11,6,359.96653254715875,0.4316056910569106,0.22044930200815882,0.20844978529242364,130890.45606874132,1223.2367229162064,132113.69279165752,1146,5,204.14634146341464,38,3,18,34.968591215981064,0.6255482456140351,44.177350427350426,1023.2905982905983,26.928699955015745,0
2912,4,0,1,40,0.0,0.024390243902439025,0.975609756097561,41,1250,900,350,0.72,16,9,7,363.3907345841393,0.43064024390243905,0.2251783068863875,0.2110309102294074,130999.80481591064,1320.8230604865296,132320.62787639716,1147,6,205.14634146341464,38,3,18,34.770272385723246,0.6266447368421053,44.070512820512825,1023.7179487179492,26.939946018893398,0
2913,4,0,1,39,0.0,0.025,0.975,40,1050,800,250,0.7619047619047619,13,8,5,368.09043998638333,0.42796474358974357,0.2314360676804459,0.2140241923158684,131047.2994094336,1647.4516197291398,132694.75102916276,1148,7,209.7,37,3,18,34.60189548083101,0.6289414414414414,44.02412280701754,1023.9035087719293,27.673067804646738,0
2914,4,0,1,38,0.0,0.02564102564102564,0.9743589743589743,39,750,500,250,0.6666666666666666,10,5,5,377.04546838710553,0.4260008996851102,0.23942346491042432,0.2183691632398745,130895.62694028503,2070.7205939047312,132966.34753418976,1149,8,215.84615384615384,36,3,18,34.52642969810351,0.6293402777777778,44.172297297297305,1023.310810810812,28.425300300300332,0
2915,4,0,0,38,0.0,0.0,1.0,38,1300,800,500,0.6153846153846154,18,8,10,378.32010855999675,0.42527560455192037,0.2373168373579424,0.2197640962887496,131010.89000740604,2312.8108260287286,133323.70083343476,1150,9,219.5,36,2,18,34.37694789718769,0.6304976851851851,44.05968468468468,1023.7612612612611,28.43781281281281,0
2916,4,0,0,38,0.0,0.0,1.0,38,1100,700,400,0.6363636363636364,15,7,8,376.7250278278641,0.42446064485538165,0.23385062259871314,0.21965967007193923,131155.04017531042,2281.877231961692,133436.91740727212,1151,10,220.5,36,2,19,34.27170367927295,0.6319444444444444,43.91891891891892,1024.3243243243242,28.45345345345345,0
2917,4,0,0,38,0.0,0.0,1.0,38,1750,1300,450,0.7428571428571429,22,13,9,378.30773670945786,0.42484589853010907,0.23696683871964064,0.22244093264648354,131476.45968632118,2347.8265133055697,133824.28619962675,1152,11,221.5,35,3,20,33.90571511868487,0.637202380952381,43.605324074074076,1025.578703703704,29.302248677248684,0
2918,4,0,1,37,0.0,0.02631578947368421,0.9736842105263158,38,1450,1100,350,0.7586206896551724,18,11,7,372.0323686413787,0.424268018018018,0.22661973001531566,0.21960312785449168,131624.87809713653,2193.743034122093,133818.62113125864,1153,12,222.5,35,3,17,33.9165538762313,0.6386904761904761,43.46064814814815,1026.1574074074078,29.31878306878308,0
2919,4,0,0,37,0.0,0.0,1.0,37,800,500,300,0.625,11,5,6,377.20825893729864,0.4226101101101101,0.22933944775099957,0.22231210154389744,131565.5006858712,2525.518689986297,134091.0193758575,1154,13,227.51351351351352,35,2,17,33.84382521058966,0.638095238095238,43.518518518518526,1025.925925925927,29.312169312169342,0
2920,4,0,0,37,0.0,0.0,1.0,37,850,500,350,0.5882352941176471,12,5,7,378.70566659107885,0.42160910910910915,0.22590072313829213,0.22406541407580247,131713.96933138292,2576.165310999662,134290.1346423826,1155,14,228.51351351351352,35,2,18,33.65526459202464,0.6395833333333334,43.373842592592595,1026.50462962963,29.328703703703713,0
2921,4,0,0,37,0.0,0.0,1.0,37,1100,700,400,0.6363636363636364,15,7,8,380.25356873636144,0.4207019519519519,0.2258576322801671,0.2260382064658548,131892.24222232954,2630.499158736295,134522.74138106583,1156,15,229.51351351351352,35,2,18,33.43532863849764,0.6413690476190477,43.20023148148149,1027.1990740740753,29.348544973545007,0
2922,4,0,1,36,0.0,0.02702702702702703,0.972972972972973,37,1500,1000,500,0.6666666666666666,20,10,10,380.0766321591444,0.42017017017017017,0.21911757304461865,0.22722459561105646,132108.4191243609,2642.2646041311687,134750.68372849206,1157,16,230.51351351351352,36,1,19,33.221510205572,0.6414930555555556,42.98986486486487,1028.040540540541,28.556681681681695,0
2923,4,0,0,36,0.0,0.0,1.0,36,950,900,50,0.9473684210526315,10,9,1,388.1359394519842,0.4193617724867725,0.22714736012608383,0.23217586196309603,132130.126953125,3056.8901909722217,135187.01714409722,1158,17,235.88888888888889,35,1,20,32.992443431273216,0.64375,42.96875,1028.125,29.375,0
2924,4,0,0,36,0.0,0.0,1.0,36,1550,1200,350,0.7741935483870968,19,12,7,389.12930742385487,0.4191633597883598,0.22580733442802448,0.23370783848237442,132282.1316882762,3094.9708576820162,135377.10254595822,1159,18,236.88888888888889,36,0,21,32.81335522714833,0.6432291666666667,42.82094594594595,1028.7162162162167,28.575450450450465,0
2925,4,0,0,36,0.0,0.0,1.0,36,1350,1000,350,0.7407407407407407,17,10,7,390.40876162550444,0.41848544973544977,0.22876997154738477,0.23501681579274425,132369.03077063547,3135.6058761464133,135504.63664678187,1160,19,237.88888888888889,36,0,21,32.692693514262785,0.6440972222222222,42.736486486486484,1029.0540540540537,28.584834834834826,0
2926,4,0,1,35,0.0,0.027777777777777776,0.9722222222222222,36,1750,1400,350,0.8,21,14,7,394.6002317246264,0.4178902116402117,0.22395237316767513,0.23875070400193255,132560.48489949998,3261.6922933748165,135822.1771928748,1161,20,238.88888888888889,32,4,21,32.39154201405916,0.6549479166666667,42.550505050505045,1029.7979797979792,32.18118686868685,0
2927,4,0,0,35,0.0,0.0,1.0,35,900,600,300,0.6666666666666666,12,6,6,393.94733996539804,0.4162464985994398,0.20831932773109285,0.2391823135504201,132690.5417814507,3454.6171946739946,136145.15897612472,1162,21,238.94285714285715,32,3,19,32.277113970588225,0.65625,42.424242424242415,1030.3030303030291,32.19696969696966,0
2928,4,0,1,34,0.0,0.02857142857142857,0.9714285714285714,35,950,700,250,0.7368421052631579,12,7,5,388.9015580355233,0.4152310924369748,0.20323046350867102,0.2368610430584203,132808.22167255374,3329.864865676654,136138.0865382304,1163,22,239.94285714285715,33,2,19,32.28844667697062,0.6549873737373737,42.31004901960784,1030.759803921568,31.235145573380848,0
2929,4,0,0,34,0.0,0.0,1.0,34,1150,800,350,0.6956521739130435,15,8,7,395.1499778346588,0.4137143493761141,0.1932881121600314,0.24179626733567974,132983.40292125792,3709.677743342503,136693.08066460042,1164,23,238.05882352941177,32,2,19,31.95082017382789,0.6591796875,42.14015151515151,1031.439393939393,32.232481060606034,0
2930,4,0,0,34,0.0,0.0,1.0,34,950,500,450,0.5263157894736842,14,5,9,395.1499778346588,0.4137143493761141,0.1932881121600314,0.24179626733567974,132983.40292125792,3709.677743342503,136693.08066460042,1165,24,239.05882352941177,32,2,19,31.95082017382789,0.6591796875,42.14015151515151,1031.439393939393,32.232481060606034,0
2931,4,0,0,34,0.0,0.0,1.0,34,450,200,250,0.4444444444444444,7,2,5,395.19602570229637,0.4136586452762923,0.194873641010872,0.242035347075544,133015.9629757166,3713.475984593386,136729.43896030998,1166,25,240.05882352941177,32,2,19,31.91681966544268,0.6595052083333333,42.10858585858585,1031.5656565656552,32.236426767676726,0
2932,4,1,0,35,0.02857142857142857,0.0,1.0,35,1050,700,350,0.6666666666666666,14,7,7,384.7097991846319,0.4144257703081233,0.19512343900909923,0.2383165552480258,133440.56560277296,3267.1786392252943,136707.74424199824,1167,0,234.17142857142858,33,2,21,31.760146087850387,0.661300505050505,41.697303921568626,1033.2107843137253,31.309417706476523,0
2933,4,0,0,35,0.0,0.0,1.0,35,600,400,200,0.6666666666666666,8,4,4,382.7393340270551,0.4146358543417367,0.1917050691244242,0.23729838709677428,133472.22222222228,3217.013888888899,136689.23611111118,1168,1,235.17142857142858,33,2,21,31.77923387096775,0.6616161616161615,41.66666666666667,1033.333333333334,31.313131313131333,0
2934,4,1,1,35,0.027777777777777776,0.027777777777777776,0.9722222222222222,36,1100,500,600,0.45454545454545453,17,5,12,372.2895365073645,0.4154596560846561,0.18191648023862772,0.2330720207546105,133831.2596450617,2764.7955246913543,136596.05516975306,1169,0,229.61111111111111,32,4,20,31.68903803131991,0.6676432291666667,41.31944444444444,1034.7222222222222,32.33506944444444,0
2935,4,0,0,35,0.0,0.0,1.0,35,900,600,300,0.6666666666666666,12,6,6,380.5117953817913,0.4138655462184874,0.18784760945425782,0.23720758861241628,133674.1214328341,3172.9159884982446,136847.03742133235,1170,3,237.17142857142858,31,4,21,31.63403424830017,0.6686827956989247,41.47135416666666,1034.1145833333323,33.358534946236524,0
2936,4,0,0,35,0.0,0.0,1.0,35,1000,700,300,0.7,13,7,6,381.634178423182,0.4140056022408964,0.18932527693857049,0.23834134539259078,133741.45507812488,3208.062065972207,136949.5171440971,1171,4,238.17142857142858,31,4,21,31.53742866733803,0.6693548387096775,41.40624999999999,1034.374999999999,33.36693548387094,0
2937,4,0,0,35,0.0,0.0,1.0,35,1000,500,500,0.5,15,5,10,381.6945182649431,0.4143557422969188,0.1882262703739217,0.23896001353561558,133831.25964506168,3216.5316358024647,137047.79128086416,1172,5,239.17142857142858,32,3,21,31.445749440715886,0.6676432291666667,41.31944444444444,1034.722222222222,32.335069444444436,0
2938,4,0,0,35,0.0,0.0,1.0,35,850,600,250,0.7058823529411765,11,6,5,410.1645177649499,0.4146008403361345,0.22786530326749554,0.23424708611103434,130353.74858276623,3693.296485260749,134047.045068027,1173,6,240.17142857142858,34,1,19,34.230978472060315,0.6280637254901961,44.70238095238094,1021.1904761904744,30.03501400560219,8
2939,4,0,1,34,0.0,0.02857142857142857,0.9714285714285714,35,1250,1100,150,0.88,14,11,3,411.0629291219772,0.4146008403361345,0.2314198320089338,0.23546090041269896,130469.43486636224,3726.229611411172,134195.66447777342,1174,7,241.17142857142858,35,0,20,34.09012593935274,0.6270833333333333,44.58912037037037,1021.643518518518,29.1898148148148,0
2940,4,0,0,34,0.0,0.0,1.0,34,1050,900,150,0.8571428571428571,12,9,3,410.2370499657354,0.413510101010101,0.21921769639822397,0.23539270300172935,130536.16780045342,3910.154478458038,134446.32227891145,1175,8,239.76470588235293,34,0,16,34.04322965206586,0.6299019607843137,44.52380952380952,1021.9047619047611,30.056022408963564,0
2941,4,0,0,34,0.0,0.0,1.0,34,900,700,200,0.7777777777777778,11,7,4,409.1859352727201,0.41302733214497916,0.2174881133445692,0.23515866400612928,130597.00255102028,3887.6913265305984,134484.6938775509,1176,9,240.76470588235293,34,0,16,34.00812368972746,0.6305147058823529,44.46428571428571,1022.1428571428562,30.063025210084007,0
2942,4,1,0,35,0.02857142857142857,0.0,1.0,35,550,400,150,0.7272727272727273,7,4,3,401.7811803906636,0.41432072829131655,0.21660257860212573,0.23280138905729023,130913.2332926098,3519.694680212625,134432.92797282242,1177,0,234.85714285714286,35,0,17,33.87572570308376,0.631547619047619,44.155092592592595,1023.3796296296302,29.23941798941801,0
2943,4,1,0,36,0.027777777777777776,0.0,1.0,36,650,400,250,0.6153846153846154,9,4,5,396.0599120099203,0.41631944444444446,0.21490617636645504,0.2318032964117226,131299.26960321813,3200.4754332034777,134499.7450364216,1178,0,229.30555555555554,36,0,19,33.630232941435004,0.6333912037037037,43.778153153153156,1024.8873873873877,28.469094094094103,0
2944,4,0,0,36,0.0,0.0,1.0,36,700,400,300,0.5714285714285714,10,4,6,395.98730782713426,0.41582341269841266,0.21761893701854196,0.2321202660108546,131358.63272392293,3203.2766072401682,134561.9093311631,1179,1,230.30555555555554,34,2,19,33.57188479851352,0.6381740196078431,43.720238095238095,1025.1190476190477,30.150560224089638,0
2945,4,0,1,35,0.0,0.027777777777777776,0.9722222222222222,36,1050,600,450,0.5714285714285714,15,6,9,398.4449494908262,0.415162037037037,0.21482087549687123,0.23428139996272157,131476.4596863213,3277.2262677897997,134753.6859541111,1180,2,231.30555555555554,35,1,19,33.38940770417185,0.637202380952381,43.60532407407408,1025.5787037037048,29.30224867724871,0
2946,4,1,1,35,0.027777777777777776,0.027777777777777776,0.9722222222222222,36,750,400,350,0.5333333333333333,11,4,7,390.20118968686063,0.4175429894179894,0.19758756276844913,0.2315889736516063,131832.8045294282,3088.2634334276463,134921.06796285583,1181,0,224.19444444444446,35,1,16,33.24000244186483,0.6407738095238096,43.258101851851855,1026.9675925925928,29.341931216931226,0
2947,4,0,1,34,0.0,0.02857142857142857,0.9714285714285714,35,1350,1000,350,0.7407407407407407,17,10,7,399.6571545732604,0.4157563025210084,0.2009075552316919,0.23710059252743787,131816.67375283458,3536.29535147394,135352.96910430852,1182,1,225.88571428571427,34,1,16,33.01356364479482,0.6427696078431373,43.27380952380953,1026.9047619047628,30.203081232493023,0
2948,4,0,0,34,0.0,0.0,1.0,34,950,700,250,0.7368421052631579,12,7,5,407.8404735169563,0.41412284610814026,0.19794746118573947,0.24144732485169942,131736.68368235786,3945.510290513278,135682.19397287114,1183,2,230.55882352941177,33,1,17,32.884559906092065,0.6442550505050505,43.35171568627452,1026.593137254903,31.108882947118275,0
2949,4,0,1,33,0.0,0.029411764705882353,0.9705882352941176,34,800,600,200,0.75,10,6,4,405.814681221446,0.4135286690433749,0.20058434872731978,0.24094723020629158,131847.23816609985,3901.1089852607884,135748.34715136065,1184,3,231.55882352941177,34,0,18,32.82451412232913,0.6430759803921569,43.24404761904763,1027.0238095238103,30.206582633053245,0
2950,4,0,2,31,0.0,0.06060606060606061,0.9393939393939394,33,1100,900,200,0.8181818181818182,13,9,4,409.8350538368803,0.4127604166666667,0.19128403712582154,0.24343214643564115,131862.521701389,4208.37673611112,136070.89843750012,1185,4,233.66666666666666,33,0,18,32.70579783637593,0.6455176767676767,43.22916666666667,1027.0833333333342,31.1237373737374,0
2951,4,0,0,31,0.0,0.0,1.0,31,1200,800,400,0.6666666666666666,16,8,8,420.56547488043907,0.40985663082437274,0.17989885599253674,0.24892929459139507,131728.82080078125,4880.118815104166,136608.9396158854,1186,5,228.16129032258064,31,0,18,32.56595636732622,0.6491935483870968,43.359375,1026.5625,33.11491935483871,0
2952,4,0,0,31,0.0,0.0,1.0,31,450,200,250,0.4444444444444444,7,2,5,422.5938046647194,0.40909498207885303,0.18166276068827014,0.2507898673732613,131829.0901184082,4942.031351725262,136771.12147013345,1187,6,229.16129032258064,31,0,19,32.41211804234816,0.6502016129032258,43.26171875,1026.953125,33.12752016129032,0
2953,4,0,0,31,0.0,0.0,1.0,31,500,200,300,0.4,8,2,6,423.89121940546625,0.4084229390681004,0.18423366140685915,0.252002850782948,131895.957522922,4981.907653808585,136877.8651767306,1188,7,230.16129032258064,31,0,19,32.31094456416107,0.6508736559139785,43.19661458333333,1027.2135416666658,33.13592069892471,0
2954,4,1,0,32,0.03125,0.0,1.0,32,800,700,100,0.875,9,7,2,413.849878194811,0.411143313172043,0.17176951638639992,0.2484624139759119,132268.0900705286,4547.826592949712,136815.9166634783,1189,0,223.9375,32,0,20,32.19180884579191,0.6520182291666667,42.834595959595966,1028.6616161616166,32.14567550505052,0
2955,4,0,0,32,0.0,0.0,1.0,32,950,400,550,0.42105263157894735,15,4,11,411.90644003343755,0.4113113239247312,0.1769989878542506,0.2481485138738027,132398.0034722223,4507.181824558724,136905.18529678104,1190,1,224.9375,31,1,20,32.11032388663966,0.6559139784946236,42.708333333333336,1029.1666666666672,33.198924731182814,0
2956,4,0,0,32,0.0,0.0,1.0,32,900,600,300,0.6666666666666666,12,6,6,409.7588336511892,0.4115843413978495,0.17600015812776704,0.24707426239608316,132431.5071105957,4452.995978461372,136884.50308905708,1191,2,225.9375,31,1,20,32.13169407547965,0.65625,42.67578125,1029.296875,33.203125,0
2957,4,0,0,32,0.0,0.0,1.0,32,750,400,350,0.5333333333333333,11,4,7,409.2587766703501,0.41255040322580644,0.1737775003160953,0.2476532260662434,132565.56404961488,4450.724114312076,137016.28816392695,1192,3,226.9375,31,1,20,32.00902452901757,0.6575940860215054,42.54557291666667,1029.8177083333342,33.219926075268845,0
2958,4,0,0,32,0.0,0.0,1.0,32,900,600,300,0.6666666666666666,12,6,6,409.18250400512795,0.4122773857526882,0.18013776541961524,0.24827085672458385,132666.15125868065,4456.93359375001,137123.08485243065,1193,4,227.9375,31,1,18,31.909336029659592,0.6586021505376345,42.44791666666667,1030.2083333333342,33.23252688172046,0
2959,4,0,0,32,0.0,0.0,1.0,32,1000,700,300,0.7,13,7,6,406.7523870380255,0.41236139112903225,0.1812867511944143,0.2476002785526772,132788.12629132226,4402.37746786042,137190.50375918267,1194,5,228.9375,32,0,18,31.8487382089918,0.6572265625,42.32954545454545,1030.6818181818178,32.208806818181806,0
2960,4,0,0,32,0.0,0.0,1.0,32,800,400,400,0.5,12,4,8,405.80292419976865,0.41206737231182794,0.179430176319334,0.2478827585594251,132918.2947690287,4387.7265393837415,137306.02130841243,1195,6,229.9375,32,0,19,31.741816660544462,0.6585286458333333,42.20328282828283,1031.186868686869,32.22458964646466,0
2961,4,0,0,32,0.0,0.0,1.0,32,750,500,250,0.6666666666666666,10,5,5,420.7546743721758,0.41204637096774194,0.1658997384203138,0.23911924460150394,130162.9151238334,4563.294900396534,134726.21002422995,1196,7,230.9375,31,1,16,34.155421930160344,0.6334005376344086,44.88932291666666,1020.4427083333321,32.91750672043007,8
2962,4,1,1,32,0.030303030303030304,0.030303030303030304,0.9696969696969697,33,1150,800,350,0.6956521739130435,15,8,7,411.5370960108041,0.41453598484848486,0.1602705253224288,0.23584689666568168,130488.247372717,4140.150877461474,134628.39825017846,1197,0,224.9090909090909,32,1,16,34.05884412588564,0.6341145833333333,44.570707070707066,1021.7171717171711,31.928661616161598,0
2963,4,0,0,32,0.0,0.0,1.0,32,900,600,300,0.6666666666666666,12,6,6,421.98310797911927,0.41231938844086025,0.17260424636572314,0.24084363411733992,130329.05578613271,4599.332004123252,134928.38779025598,1198,9,232.9375,31,1,16,33.954454645923654,0.6350806451612903,44.72656249999999,1021.0937499999992,32.93850806451611,0
2964,4,1,1,32,0.030303030303030304,0.030303030303030304,0.9696969696969697,33,800,600,200,0.75,10,6,4,406.2727565242425,0.41642992424242425,0.15238807831400458,0.2193872885230911,128144.5312500001,3812.3263888889037,131956.857638889,1199,0,226.84848484848484,33,0,16,36.59122085048012,0.6079545454545454,46.87500000000001,1012.5000000000008,30.681818181818205,8
2965,4,3,1,34,0.08571428571428572,0.02857142857142857,0.9714285714285714,35,800,600,200,0.75,10,6,4,385.6260711453543,0.4213235294117647,0.1659353542120252,0.212218734636766,128898.9866780046,2941.3619614512595,131840.34863945586,1200,0,214.5142857142857,34,1,18,36.34110003907778,0.6133578431372548,46.13095238095239,1015.4761904761909,29.866946778711498,0
2966,4,0,0,34,0.0,0.0,1.0,34,1100,800,300,0.7272727272727273,14,8,6,393.6796723779902,0.4183749257278669,0.16836397724609564,0.21609335495738194,128796.78376405715,3340.9351271145774,132137.71889117174,1201,1,221.8235294117647,33,1,18,36.24127228459896,0.6145833333333333,46.231617647058826,1015.0735294117652,30.759803921568643,0
2967,4,0,0,34,0.0,0.0,1.0,34,850,600,250,0.7058823529411765,11,6,5,395.42020836206245,0.41765077243018417,0.1741917621501894,0.21755988356494374,128890.0978589967,3393.1498702422305,132283.24772923894,1202,2,222.8235294117647,33,1,18,36.10155684286747,0.615530303030303,46.13970588235295,1015.4411764705895,30.770944741533015,0
2968,4,0,0,34,0.0,0.0,1.0,34,1300,900,400,0.6923076923076923,17,9,8,391.8934296163961,0.4170937314319667,0.17232768650151775,0.216638687891944,129076.82742214546,3316.872116493666,132393.69953863914,1203,3,223.8235294117647,33,1,18,36.00006029908344,0.6174242424242424,45.95588235294118,1016.1764705882364,30.793226381461707,0
2969,4,2,1,35,0.05555555555555555,0.027777777777777776,0.9722222222222222,36,950,700,250,0.7368421052631579,12,7,5,371.4507940335868,0.4219080687830688,0.166877719332424,0.20837780609556286,129655.65653344667,2432.19938710778,132087.85592055446,1204,0,212.33333333333334,34,2,18,35.929281122150776,0.6210171568627452,45.38690476190476,1018.4523809523806,29.954481792717075,0
2970,4,0,0,35,0.0,0.0,1.0,35,800,500,300,0.625,11,5,6,379.3235525460826,0.41845238095238096,0.16965747702589806,0.21197492642281096,129504.14540816336,2824.7945011338,132328.93990929716,1205,1,219.4,34,1,18,35.883284600389864,0.6194852941176471,45.53571428571429,1017.8571428571436,29.936974789915986,0
2971,4,0,0,35,0.0,0.0,1.0,35,1000,600,400,0.6,14,6,8,378.75129417149077,0.4175420168067227,0.16013490950377318,0.21263753759391563,129685.9693877551,2823.745748299314,132509.7151360544,1206,2,220.4,34,1,18,35.71251168770452,0.6213235294117647,45.357142857142854,1018.5714285714286,29.95798319327731,0
2972,4,0,0,35,0.0,0.0,1.0,35,1050,700,350,0.6666666666666666,14,7,7,383.63232911844375,0.41673669467787117,0.15773858194136237,0.21621305922205356,129837.58680555543,2961.979166666658,132799.5659722221,1207,3,221.4,34,1,18,35.433701281003,0.6228553921568627,45.20833333333333,1019.1666666666656,29.9754901960784,0
2973,4,0,1,34,0.0,0.02857142857142857,0.9714285714285714,35,900,700,200,0.7777777777777778,11,7,4,383.56471295829937,0.41645658263305324,0.15438713551744931,0.21667864127802572,129928.5997732424,2967.2052154194744,132895.80498866187,1208,4,222.4,34,1,18,35.342713685193836,0.6237745098039216,45.119047619047606,1019.5238095238076,29.985994397759047,0
2974,4,0,0,34,0.0,0.0,1.0,34,1100,800,300,0.7272727272727273,14,8,6,392.4401148571927,0.41224747474747475,0.16114623419461238,0.22100574889326102,129807.25623582752,3388.314909297029,133195.57114512456,1209,5,229.7058823529412,34,0,18,35.240216121495315,0.6225490196078431,45.23809523809523,1019.0476190476179,29.971988795518172,0
2975,4,0,1,33,0.0,0.029411764705882353,0.9705882352941176,34,900,600,300,0.6666666666666666,12,6,6,398.77397832378955,0.4114490493166964,0.1717489097215068,0.2254454867553304,129958.94451530604,3564.8490646258383,133523.79357993187,1210,6,230.7058823529412,34,0,18,34.9241097489784,0.6240808823529411,45.08928571428571,1019.6428571428565,29.98949579831931,0
2976,4,1,0,34,0.029411764705882353,0.0,1.0,34,700,400,300,0.5714285714285714,10,4,6,398.38188719931173,0.4155711527035057,0.15893473739128083,0.22592550571878872,130080.35891439886,3564.3317743763864,133644.69068877524,1211,0,220.11764705882354,34,0,19,34.81031431127707,0.6253063725490196,44.97023809523808,1020.1190476190458,30.003501400560168,0
2977,4,0,0,34,0.0,0.0,1.0,34,950,700,250,0.7368421052631579,12,7,5,400.83376137058485,0.41583110516934046,0.16510453475686337,0.2280257356489729,130201.83000283437,3637.857851473904,133839.68785430826,1212,1,221.11764705882354,34,0,19,34.62396477312492,0.626531862745098,44.85119047619047,1020.5952380952373,30.017507002801096,0
2978,4,1,0,35,0.02857142857142857,0.0,1.0,35,650,500,150,0.7692307692307693,8,5,3,390.1004156716474,0.42128851540616247,0.16036433602231237,0.22374788547346877,130520.50053884815,3183.2628197820377,133703.76335863018,1213,0,215.77142857142857,32,3,18,34.57360270192347,0.6344401041666667,44.53914141414142,1021.843434343435,31.932607323232343,0
2979,4,1,0,36,0.027777777777777776,0.0,1.0,36,600,400,200,0.6666666666666666,8,4,4,378.8322490127007,0.4227678571428572,0.1562982484161206,0.21900911459543096,130826.15460399841,2712.233275663194,133538.3878796616,1214,0,210.75,33,3,19,34.551189905765824,0.6351010101010102,44.24019607843137,1023.0392156862741,31.001188354129518,0
2980,4,0,1,35,0.0,0.027777777777777776,0.9722222222222222,36,850,600,250,0.7058823529411765,11,6,5,376.1431388719566,0.4227678571428572,0.15106453759148364,0.21780826696122307,130888.84833958095,2646.588451557094,133535.43679113803,1215,1,211.75,33,3,19,34.556387225548896,0.6357323232323233,44.17892156862745,1023.2843137254904,31.008615567439104,0
2981,4,0,0,35,0.0,0.0,1.0,35,850,600,250,0.7058823529411765,11,6,5,384.47095999989426,0.41922268907563026,0.15910444695491432,0.22190834247296798,130763.47588667815,3054.9518214148306,133818.427708093,1216,2,218.68571428571428,33,2,19,34.470604680885046,0.634469696969697,44.30147058823529,1022.7941176470584,30.993761140819952,0
2982,4,0,0,35,0.0,0.0,1.0,35,1000,700,300,0.7,13,7,6,384.10154541216957,0.41939775910364147,0.15323866552609067,0.22241663690649205,130888.84833958095,3054.9217848904273,133943.77012447137,1217,3,219.68571428571428,33,2,19,34.35279441117764,0.6357323232323233,44.17892156862745,1023.2843137254904,31.008615567439104,0
2983,4,0,1,34,0.0,0.02857142857142857,0.9714285714285714,35,850,500,350,0.5882352941176471,12,5,7,385.22738452366264,0.4194327731092437,0.15578630446311026,0.22325009633290138,130920.20083922059,3086.809310121121,134007.01014934172,1218,4,220.68571428571428,33,2,19,34.292175587753974,0.6360479797979798,44.1482843137255,1023.4068627450988,31.012329174093903,0
2984,4,1,0,35,0.02857142857142857,0.0,1.0,35,1200,900,300,0.75,15,9,6,380.8779635516515,0.4196078431372549,0.13657987332864208,0.223463082661807,131392.84256708494,3010.196703599286,134403.03927068424,801,0,186.85714285714286,32,3,22,33.92446633825945,0.6432291666666667,43.686868686868685,1025.252525252525,32.039141414141405,0
2985,4,0,0,35,0.0,0.0,1.0,35,1350,1000,350,0.7407407407407407,17,10,7,379.2627881656808,0.419187675070028,0.13470945054945105,0.2234597646008813,131554.7062321445,2978.760936384022,134533.46716852853,802,1,187.85714285714286,32,3,18,33.80205128205128,0.6448567708333333,43.529040404040394,1025.883838383837,32.058869949494905,0
2986,4,0,1,34,0.0,0.02857142857142857,0.9714285714285714,35,1150,700,450,0.6086956521739131,16,7,9,382.78808057596905,0.4182422969187675,0.14211571235307585,0.22668972200751658,131749.07415378527,3086.395042597691,134835.46919638297,803,2,188.85714285714286,32,3,18,33.51499405567172,0.6468098958333333,43.339646464646464,1026.6414141414139,32.08254419191918,0
2987,4,0,0,34,0.0,0.0,1.0,34,550,300,250,0.5454545454545454,8,3,5,393.0485705873472,0.41499554367201424,0.14717824701254711,0.23203114492875532,131628.58963012695,3547.2858005099815,135175.87543063692,804,8,195.35294117647058,31,3,18,33.3736465338578,0.6481854838709677,43.45703125,1026.171875,33.102318548387096,0
2988,4,0,0,34,0.0,0.0,1.0,34,850,600,250,0.7058823529411765,11,6,5,391.5707232290847,0.41438279857397503,0.14371623839794734,0.2317675361815393,131728.82080078122,3516.229926215278,135245.0507269965,805,9,196.35294117647058,31,3,18,33.31007948587858,0.6491935483870968,43.359375,1026.5624999999998,33.114919354838705,0
2989,4,0,0,34,0.0,0.0,1.0,34,800,400,400,0.5,12,4,8,388.7663955931128,0.41384432560903145,0.14037022307386438,0.23101640819210875,131878.73247946627,3454.003896286083,135332.73637575234,806,10,197.35294117647058,32,2,18,33.23038311821349,0.6481119791666667,43.213383838383834,1027.1464646464638,32.09832702020199,0
2990,4,0,0,34,0.0,0.0,1.0,34,750,500,250,0.6666666666666666,10,5,5,387.3352001781435,0.41354723707664887,0.1379306606534989,0.23095393364468175,132008.45457415047,3426.3042355371736,135434.75880968766,807,11,198.35294117647058,32,2,19,33.1359810787566,0.6494140625,43.087121212121204,1027.651515151514,32.114109848484816,0
2991,4,0,1,33,0.0,0.029411764705882353,0.9705882352941176,34,1200,900,300,0.75,15,9,6,390.66952086301995,0.4134358288770053,0.1376389681501975,0.23374150686168796,132138.24043783802,3524.476615906546,135662.71705374456,808,12,199.35294117647058,32,2,20,32.91912276392811,0.6507161458333333,42.96085858585859,1028.156565656566,32.12989267676769,0
2992,4,0,0,33,0.0,0.0,1.0,33,1050,800,250,0.7619047619047619,13,8,5,398.5242806946228,0.4083806818181818,0.14067728961345982,0.23838997881551074,132130.126953125,3931.4127604166665,136061.53971354166,809,13,206.0,31,2,20,32.72543059777103,0.6532258064516129,42.96875,1028.125,33.16532258064516,0
2993,4,0,0,33,0.0,0.0,1.0,33,1050,800,250,0.7619047619047619,13,8,5,396.1185707418684,0.4075520833333333,0.13400843881856517,0.23779154322650148,132264.0313042534,3878.447808159717,136142.47911241313,810,14,207.0,31,2,20,32.65189873417721,0.6545698924731183,42.838541666666664,1028.645833333333,33.18212365591397,0
2994,4,0,0,33,0.0,0.0,1.0,33,950,600,350,0.631578947368421,13,6,7,403.2230348225324,0.40743371212121215,0.10642649404259297,0.22785346439411838,129940.5533395828,3879.004852821155,133819.55819240396,811,15,208.0,32,1,20,34.82946336429309,0.6285807291666667,45.10732323232324,1019.5707070707078,31.86158459595962,8
2995,4,0,0,33,0.0,0.0,1.0,33,1250,800,450,0.64,17,8,9,408.8833514507954,0.4065656565656566,0.10688746142279104,0.2321986200333013,130133.72559241405,4041.9027714008794,134175.62836381493,812,16,209.0,32,1,20,34.48804809635772,0.6305338541666667,44.917929292929294,1020.3282828282829,31.88525883838384,0
2996,4,0,0,33,0.0,0.0,1.0,33,950,500,450,0.5263157894736842,14,5,9,408.49061252987775,0.40561868686868685,0.10808967628554633,0.2331308104113705,130327.04132550245,4047.474588052232,134374.51591355467,813,17,210.0,32,1,22,34.30093565805201,0.6324869791666667,44.72853535353535,1021.0858585858581,31.908933080808065,0
2997,4,0,0,33,0.0,0.0,1.0,33,950,800,150,0.8421052631578947,11,8,3,408.49061252987775,0.40561868686868685,0.10808967628554633,0.2331308104113705,130327.04132550245,4047.474588052232,134374.51591355467,814,18,211.0,32,1,22,34.30093565805201,0.6324869791666667,44.72853535353535,1021.0858585858581,31.908933080808065,0
2998,4,0,0,33,0.0,0.0,1.0,33,900,600,300,0.6666666666666666,12,6,6,405.15920248257794,0.40526357323232326,0.10683597407948486,0.23180607836520897,130423.75299714306,3968.4767498214414,134392.2297469645,815,19,212.0,32,1,22,34.28744334569428,0.6334635416666667,44.63383838383838,1021.4646464646459,31.920770202020183,0
2999,4,0,0,33,0.0,0.0,1.0,33,1100,900,200,0.8181818181818182,13,9,4,405.72961221268,0.4042376893939394,0.10879585425489324,0.2327122432060396,130520.50053884802,3991.2064138863343,134511.70695273436,816,20,213.0,32,1,16,34.17433790518556,0.6344401041666667,44.53914141414141,1021.8434343434338,31.932607323232308,0
3000,4,0,1,32,0.0,0.030303030303030304,0.9696969696969697,33,900,500,400,0.5555555555555556,13,5,8,405.25948481015763,0.40333017676767674,0.11024181810698663,0.23360829661761331,130714.10323245077,3994.6260266809486,134708.7292591317,817,21,214.0,32,1,17,33.98927851175042,0.6363932291666667,44.349747474747474,1022.60101010101,31.956281565656564,0
3001,4,0,1,31,0.0,0.03125,0.96875,32,950,500,450,0.5263157894736842,14,5,9,403.13360572145905,0.40146169354838707,0.11232979129549481,0.233271271999943,130861.41798231343,4150.927056206607,135012.34503852003,818,22,218.125,31,1,18,33.893802494273345,0.6404569892473118,44.20572916666667,1023.1770833333339,33.005712365591414,0
3002,4,0,0,31,0.0,0.0,1.0,31,800,600,200,0.75,10,6,4,417.4101785291847,0.39950716845878137,0.13034631851129697,0.2410084566469723,130777.62783269734,4717.582596253889,135495.21042895122,819,33,225.4516129032258,30,1,19,33.613939991239604,0.6423611111111112,44.287634408602145,1022.8494623655907,34.09498207885302,0
3003,4,2,0,33,0.06060606060606061,0.0,1.0,33,750,300,450,0.4,12,3,9,399.3763498264942,0.40546085858585856,0.1298178832661594,0.2343161821236368,131392.84256708506,3895.038771553934,135287.88133863898,820,0,212.72727272727272,32,1,21,33.450328407224966,0.6432291666666667,43.68686868686869,1025.2525252525259,32.03914141414143,0
3004,4,0,0,33,0.0,0.0,1.0,33,400,100,300,0.25,7,1,6,399.47801687889324,0.40546085858585856,0.13004708498429252,0.23477282583866652,131457.57607642084,3902.882358942973,135360.4584353638,821,1,213.72727272727272,32,1,21,33.382069276861195,0.6438802083333333,43.62373737373738,1025.505050505051,32.047032828282845,0
3005,4,0,0,33,0.0,0.0,1.0,33,1050,600,450,0.5714285714285714,15,6,9,404.0069301775145,0.4055397727272727,0.13420606060606022,0.23803889105818032,131554.70623214467,4029.802603050702,135584.50883519536,822,2,214.72727272727272,32,1,18,33.16743589743588,0.6448567708333333,43.5290404040404,1025.8838383838383,32.05886994949495,0
3006,4,0,0,33,0.0,0.0,1.0,33,600,200,400,0.3333333333333333,10,2,8,404.50493940229694,0.40526357323232326,0.13567374458341686,0.23853462536887285,131587.09092184482,4045.525647893087,135632.6165697379,823,3,215.72727272727272,32,1,18,33.12182090409385,0.6451822916666667,43.497474747474755,1026.010101010102,32.06281565656569,0
3007,4,0,0,33,0.0,0.0,1.0,33,800,500,300,0.625,11,5,6,400.9917216148069,0.40502683080808083,0.12703489564112025,0.2370663058186739,131684.26890432098,3960.8603395061737,135645.12924382716,824,4,216.72727272727272,32,1,18,33.113441587731174,0.6461588541666667,43.40277777777778,1026.388888888889,32.07465277777778,0
3008,4,1,0,34,0.029411764705882353,0.0,1.0,34,1150,900,250,0.782608695652174,14,9,5,393.12872555138665,0.4088495246583482,0.12110128420033872,0.23467406556579903,132051.39136690198,3582.639039071499,135634.0304059735,825,0,211.3235294117647,33,1,19,32.94371745956044,0.6474116161616161,43.045343137254896,1027.8186274509792,31.146019013666034,0
3009,4,0,0,34,0.0,0.0,1.0,34,1300,900,400,0.6923076923076923,17,9,8,392.93228856100404,0.408013963161022,0.12370102011631245,0.2353778854778051,132183.68055555542,3587.847222222203,135771.5277777776,826,1,212.3235294117647,34,0,20,32.81503241491085,0.6464460784313726,42.91666666666666,1028.3333333333321,30.24509803921565,0
3010,4,0,0,34,0.0,0.0,1.0,34,1000,500,500,0.5,15,5,10,394.69079355042425,0.4081068033273916,0.11999278238902944,0.23662274569619113,132214.28748582763,3636.7524092970466,135851.03989512468,827,2,213.3235294117647,34,0,20,32.7388876027318,0.6467524509803921,42.88690476190476,1028.4523809523807,30.248599439775905,0
3011,4,0,0,34,0.0,0.0,1.0,34,1250,900,350,0.72,16,9,7,393.67594286191087,0.4068441770647653,0.12047279783572518,0.22004524773963846,129513.05537533623,3397.3623885828642,132910.4177639191,828,3,214.3235294117647,33,1,18,35.5089694196966,0.6218434343434344,45.526960784313715,1017.8921568627436,30.845216874628594,8
3012,4,1,0,35,0.02857142857142857,0.0,1.0,35,1200,1000,200,0.8333333333333334,14,10,4,381.50296713132116,0.4101540616246499,0.11208329162078323,0.21517973679699398,129867.92091836713,2908.9994331065504,132776.92035147367,829,0,209.17142857142858,34,1,21,35.457058319707244,0.6231617647058824,45.178571428571416,1019.2857142857125,29.978991596638604,0
3013,4,0,0,35,0.0,0.0,1.0,35,950,700,250,0.7368421052631579,12,7,5,380.22420302795825,0.40952380952380957,0.11001534663374923,0.2147915616577462,129928.59977324256,2880.3996598639333,132808.99943310648,830,1,210.17142857142858,34,1,21,35.427856920442146,0.6237745098039216,45.11904761904761,1019.523809523809,29.985994397759086,0
3014,4,0,0,35,0.0,0.0,1.0,35,950,800,150,0.8421052631578947,11,8,3,380.40445249850455,0.4091036414565827,0.10574796978438883,0.21539490710870346,130019.64462868459,2892.01034580496,132911.65497448956,831,2,211.17142857142858,34,1,22,35.33058052215866,0.6246936274509804,45.02976190476189,1019.8809523809506,29.99649859943972,0
3015,4,1,0,36,0.027777777777777776,0.0,1.0,36,950,800,150,0.8421052631578947,11,8,3,371.34527280299915,0.4110780423280423,0.10510204081632701,0.2115804461319411,130262.58680555537,2474.9326814058754,132737.51948696125,832,0,206.27777777777777,33,3,23,35.31462585034012,0.6294191919191919,44.79166666666666,1020.8333333333319,30.93434343434339,0
3016,4,1,0,37,0.02702702702702703,0.0,1.0,37,1050,800,250,0.7619047619047619,13,8,5,364.288851031298,0.41388263263263264,0.10826547987372548,0.20952098886843606,130627.42524092946,2117.2229308389756,132744.64817176844,833,0,201.67567567567568,34,3,16,35.124558441054326,0.6308210784313726,44.434523809523796,1022.2619047619028,30.0665266106442,0
3017,4,0,1,36,0.0,0.02702702702702703,0.972972972972973,37,1000,800,200,0.8,12,8,4,360.8169881051281,0.41369494494494496,0.10703835383695681,0.20801462602839246,130718.7145691609,2033.1065759637033,132751.82114512462,834,1,202.67567567567568,34,3,17,35.1207799767171,0.6317401960784313,44.34523809523809,1022.6190476190468,30.077030812324907,0
3018,4,0,0,36,0.0,0.0,1.0,36,1450,1000,450,0.6896551724137931,19,10,9,368.948359349397,0.4115244708994709,0.11022880125720835,0.21243175721546026,130669.48596993943,2442.058493127638,133111.54446306705,835,2,209.25,33,3,18,34.96281813096806,0.6335227272727273,44.393382352941174,1022.4264705882351,30.98262032085561,0
3019,4,0,0,36,0.0,0.0,1.0,36,1300,900,400,0.6923076923076923,17,9,8,366.45274108411587,0.410433201058201,0.10869340366664115,0.21193101324878127,130840.48327664382,2389.3707482993027,133229.8540249431,836,3,210.25,34,2,19,34.85328911643782,0.6329656862745099,44.22619047619047,1023.0952380952368,30.09103641456579,0
3020,4,0,0,36,0.0,0.0,1.0,36,700,500,200,0.7142857142857143,9,5,4,366.758131676194,0.41011904761904766,0.11166362943145525,0.21261090074310451,130931.84700963716,2404.0639172335564,133335.9109268707,837,4,211.25,34,2,19,34.75291768446357,0.6338848039215687,44.13690476190476,1023.4523809523807,30.101540616246492,0
3021,4,0,0,36,0.0,0.0,1.0,36,1100,700,400,0.6363636363636364,15,7,8,370.11930202657993,0.4105820105820106,0.12323179475254831,0.21523976448482832,131053.71492346922,2501.1018990929488,133554.81682256216,838,5,212.25,34,2,20,34.54346393830175,0.6351102941176471,44.01785714285713,1023.9285714285701,30.115546218487356,0
3022,4,0,2,34,0.0,0.05555555555555555,0.9444444444444444,36,1350,1000,350,0.7407407407407407,17,10,7,366.2457602996108,0.4104662698412698,0.11512087401208748,0.21349447978440728,131145.1530612244,2406.2712585033914,133551.4243197278,839,6,213.25,34,2,21,34.550063923756376,0.6360294117647058,43.92857142857142,1024.2857142857138,30.126050420168053,0
3023,4,0,0,34,0.0,0.0,1.0,34,1100,800,300,0.7272727272727273,14,8,6,378.0457063101227,0.4059529114676173,0.11019801262058504,0.21993907303982016,131069.41415416783,3110.045849913259,134179.46000408108,840,7,213.47058823529412,32,2,22,34.324650637073574,0.6399739583333333,44.002525252525245,1023.9898989898979,31.99968434343431,0
3024,4,0,0,34,0.0,0.0,1.0,34,850,500,350,0.5882352941176471,12,5,7,379.9981431392879,0.4059343434343434,0.1090153058635015,0.22163371209842136,131166.40082963463,3168.597751504936,134334.99858113957,841,8,214.47058823529412,32,2,22,34.17637331032498,0.6409505208333333,43.90782828282828,1024.3686868686862,32.01152146464644,0
3025,4,0,0,34,0.0,0.0,1.0,34,850,600,250,0.7058823529411765,11,6,5,379.9659996637759,0.40569295900178254,0.10662761530542753,0.22180173534330028,131198.73769258222,3170.2119043974894,134368.9495969797,842,9,215.47058823529412,32,2,22,34.144431435379175,0.6412760416666667,43.876262626262616,1024.494949494948,32.01546717171713,0
3026,4,0,0,34,0.0,0.0,1.0,34,1250,900,350,0.72,16,9,7,377.75133848899463,0.40474598930481287,0.10999521759923447,0.22125435540069668,131328.1249999999,3121.874999999986,134449.9999999999,843,10,216.47058823529412,32,2,22,34.0701219512195,0.642578125,43.74999999999999,1024.9999999999993,32.03124999999998,0
3027,4,0,0,34,0.0,0.0,1.0,34,850,500,350,0.5882352941176471,12,5,7,373.99499991892264,0.40357620320855614,0.11003626256704213,0.22073038230508954,131619.47959710742,3045.005452249761,134664.48504935717,844,11,217.47058823529412,32,2,18,33.87166236003445,0.6455078125,43.465909090909086,1026.1363636363633,32.06676136363635,0
3028,4,0,0,34,0.0,0.0,1.0,34,1450,1300,150,0.896551724137931,16,13,3,374.4275396218121,0.40378045157456927,0.106335921812029,0.22184964122712442,131768.13755526705,3067.523909073417,134835.66146434046,845,12,218.47058823529412,33,1,18,33.71031272380044,0.6445707070707071,43.32107843137254,1026.7156862745085,31.112596553772985,0
3029,4,0,0,34,0.0,0.0,1.0,34,1300,900,400,0.6923076923076923,17,9,8,376.35868575549216,0.4030377302436126,0.10545296362819956,0.22410449015440664,131956.93963860045,3132.628075740092,135089.56771434055,846,13,219.47058823529412,33,1,18,33.47000238549617,0.6464646464646464,43.13725490196078,1027.4509803921562,31.134878193701702,0
3030,4,0,0,34,0.0,0.0,1.0,34,1000,600,400,0.6,14,6,8,373.96262347458975,0.40311200237670824,0.10810033529271501,0.22304769277794484,132019.90370290252,3074.1019079200055,135094.00561082253,847,14,220.47058823529412,33,1,19,33.46798235153828,0.6470959595959596,43.07598039215685,1027.6960784313708,31.142305407011236,0
3031,4,0,0,34,0.0,0.0,1.0,34,850,500,350,0.5882352941176471,12,5,7,374.0652300058023,0.40268493761140817,0.11097356553209137,0.22329431203264494,132051.39136690204,3079.1668168492765,135130.55818375133,848,15,221.47058823529412,33,1,19,33.43356285521242,0.6474116161616161,43.045343137254896,1027.8186274509796,31.14601901366605,0
3032,4,1,0,35,0.02857142857142857,0.0,1.0,35,1150,800,350,0.6956521739130435,15,8,7,364.7002901211298,0.4058823529411764,0.11104684788895347,0.21970968697541216,132398.00347222216,2657.572357987302,135055.57583020948,849,0,216.11428571428573,33,2,21,33.324898785425106,0.6508838383838385,42.70833333333333,1029.166666666666,31.186868686868667,0
3033,4,0,0,35,0.0,0.0,1.0,35,800,400,400,0.5,12,4,8,362.988540667917,0.4056022408963585,0.10942234767969783,0.21922837743717985,132492.61289227704,2618.6600406093826,135111.27293288644,850,1,217.11428571428573,33,2,21,33.27369261595842,0.6518308080808081,42.61642156862745,1029.5343137254904,31.198009506833042,0
3034,4,0,0,35,0.0,0.0,1.0,35,1100,800,300,0.7272727272727273,14,8,6,360.6268167997598,0.40574229691876745,0.10913294797687922,0.21814139617607825,132551.19756235814,2560.3032879818466,135111.50085033997,851,2,218.11428571428573,34,1,22,33.27552986512524,0.6501225490196079,42.5595238095238,1029.7619047619037,30.287114845938344,0
3035,4,0,1,34,0.0,0.02857142857142857,0.9714285714285714,35,800,600,200,0.75,10,6,4,364.20236385022906,0.40556722689075625,0.11241044603651518,0.2210243518064431,132673.81660997716,2664.0235260770814,135337.84013605423,852,3,219.11428571428573,34,1,18,33.0600974501194,0.6513480392156863,42.44047619047618,1030.238095238094,30.301120448179237,0
3036,4,0,0,34,0.0,0.0,1.0,34,750,400,350,0.5333333333333333,11,4,7,366.82841558580986,0.4037061794414736,0.10905827776572719,0.22266617255089552,132681.93310565644,2934.300659602071,135616.2337652585,853,4,221.88235294117646,33,1,18,32.98429384243289,0.6537247474747474,42.432598039215684,1030.269607843137,31.220291146761728,0
3037,4,0,0,34,0.0,0.0,1.0,34,1100,800,300,0.7272727272727273,14,8,6,365.69819619983735,0.4031862745098039,0.1129088658409505,0.22272900276877872,132808.22167255398,2913.5454212322375,135721.7670937862,854,5,222.88235294117646,33,1,20,32.886373994372455,0.6549873737373737,42.31004901960785,1030.7598039215698,31.2351455733809,0
3038,4,0,0,34,0.0,0.0,1.0,34,1000,500,500,0.5,15,5,10,363.2784256196546,0.4028706179441473,0.11175352004362482,0.22181601401769055,132902.97752066524,2856.156886774333,135759.13440743956,855,6,223.88235294117646,33,1,21,32.85347832976785,0.6559343434343434,42.21813725490197,1031.1274509803932,31.246286393345247,0
3039,4,0,0,34,0.0,0.0,1.0,34,800,500,300,0.625,11,5,6,360.8977831560637,0.4029077540106952,0.11203583357790703,0.221108991165047,133029.37121539802,2802.0010332564516,135831.37224865446,856,7,224.88235294117646,33,1,21,32.787875188089004,0.6571969696969697,42.09558823529412,1031.6176470588243,31.261140819964375,0
3040,4,0,0,34,0.0,0.0,1.0,34,750,400,350,0.5333333333333333,11,4,7,355.1666582863146,0.40283348187759954,0.030605106680657634,0.2026789373334478,130323.35778061219,2457.302295918361,132780.66007653056,857,8,225.88235294117646,34,0,21,35.665879678209166,0.6277573529411764,44.732142857142854,1021.0714285714282,30.031512605042007,8
3041,4,1,0,35,0.02857142857142857,0.0,1.0,35,1050,700,350,0.6666666666666666,14,7,7,351.2245832250699,0.40427170868347334,0.03771156986048951,0.2027283894160641,130765.21675936627,2185.5917513288614,132950.80851069515,858,0,220.4,35,0,18,35.31894779525481,0.6300595238095238,44.29976851851851,1022.8009259259247,29.222883597883563,0
3042,4,0,1,34,0.0,0.02857142857142857,0.9714285714285714,35,950,600,350,0.631578947368421,13,6,7,349.8249421592514,0.4034663865546218,0.04025856496444691,0.2023856340764254,130854.016632373,2155.199759945114,133009.2163923181,859,1,221.4,35,0,18,35.26489441930617,0.6309523809523809,44.212962962962955,1023.1481481481472,29.232804232804206,0
3043,4,0,0,34,0.0,0.0,1.0,34,1350,1100,250,0.8148148148148148,16,11,5,356.43235339758434,0.3994912358882947,0.048528898231391615,0.20564878092939182,130749.15143140576,2520.645549886605,133269.79698129237,860,2,228.61764705882354,34,0,18,35.20205253559927,0.632046568627451,44.31547619047618,1022.738095238094,30.080532212885117,0
3044,4,0,0,34,0.0,0.0,1.0,34,750,600,150,0.8,9,6,3,354.9395257824155,0.4000482768865122,0.04588207912048814,0.20511064862463319,130810.03578514737,2485.930413832197,133295.96619897956,861,3,229.61764705882354,34,0,18,35.178585282594355,0.6326593137254901,44.25595238095238,1022.9761904761903,30.087535014005596,0
3045,4,0,0,34,0.0,0.0,1.0,34,800,500,300,0.625,11,5,6,355.282284162166,0.39924985145573383,0.044788273615634866,0.20579558724110386,130901.388888889,2501.388888888899,133402.7777777779,862,4,230.61764705882354,34,0,18,35.0773615635179,0.633578431372549,44.16666666666667,1023.3333333333343,30.098039215686303,0
3046,4,0,0,34,0.0,0.0,1.0,34,800,600,200,0.75,10,6,4,357.36884802596006,0.39932412358882946,0.04572503419972662,0.20766027655562538,131023.24263038553,2564.7250566893485,133587.96768707488,863,5,231.61764705882354,34,0,20,34.900678294573645,0.6348039215686274,44.04761904761905,1023.8095238095241,30.112044817927178,0
3047,4,0,0,34,0.0,0.0,1.0,34,500,200,300,0.4,8,2,6,356.31719410452257,0.3984699940582293,0.05025022561325798,0.20770685217312423,131145.15306122453,2545.85459183674,133691.00765306127,864,6,232.61764705882354,34,0,21,34.80430613668061,0.6360294117647058,43.92857142857143,1024.2857142857147,30.126050420168077,0
3048,4,0,0,34,0.0,0.0,1.0,34,750,500,250,0.6666666666666666,10,5,5,358.5455002263201,0.397653000594177,0.051195472379051754,0.209338030864838,131206.12953514743,2608.673469387758,133814.80300453518,865,7,233.61764705882354,34,0,21,34.685587574560394,0.6366421568627452,43.86904761904762,1024.5238095238096,30.13305322128852,0
3049,4,1,0,35,0.02857142857142857,0.0,1.0,35,950,800,150,0.8421052631578947,11,8,3,352.3171133640673,0.4000350140056022,0.05246155334171587,0.20731967188793904,131506.1366705246,2266.3724922839438,133772.50916280854,866,0,227.9142857142857,35,0,23,34.542146242383204,0.6375,43.576388888888886,1025.694444444444,29.30555555555554,0
3050,4,0,0,35,0.0,0.0,1.0,35,1050,500,550,0.47619047619047616,16,5,11,350.74651537745285,0.4002100840336134,0.052455634177398736,0.2065559047036786,131535.81700370798,2227.1458922753745,133762.96289598336,867,1,228.9142857142857,35,0,23,34.55247000639362,0.6377976190476191,43.5474537037037,1025.810185185185,29.30886243386243,0
3051,4,0,1,34,0.0,0.02857142857142857,0.9714285714285714,35,1100,800,300,0.7272727272727273,14,8,6,350.92862428897877,0.4002801120448179,0.05058167638812794,0.20714601750639727,131624.87809713656,2238.1874785665386,133863.0655757031,868,2,229.9142857142857,35,0,17,34.45794796601248,0.6386904761904761,43.46064814814815,1026.157407407408,29.318783068783087,0
3052,4,0,0,34,0.0,0.0,1.0,34,700,400,300,0.5714285714285714,10,4,6,356.5128376487043,0.39741161616161613,0.049349629579051646,0.20964901681526193,131480.6990504535,2574.911422902492,134055.61047335598,869,11,237.61764705882354,34,0,22,34.46024376088219,0.6393995098039216,43.601190476190474,1025.5952380952378,30.164565826330524,0
3053,4,0,0,34,0.0,0.0,1.0,34,650,400,250,0.6153846153846154,9,4,5,356.872049579585,0.39639037433155083,0.05518545315550227,0.2103641123992382,131572.28599773237,2590.8942743764114,134163.1802721088,870,12,238.61764705882354,34,0,17,34.35856153786647,0.6403186274509804,43.51190476190476,1025.9523809523805,30.17507002801119,0
3054,4,0,0,34,0.0,0.0,1.0,34,1200,900,300,0.75,15,9,6,385.77135348132083,0.39499777183600715,0.1372307628644145,0.21213693577319068,128868.76594387765,3142.7756519274503,132011.5415958051,871,13,239.61764705882354,34,0,17,36.368321804041116,0.6130514705882353,46.16071428571429,1015.3571428571436,29.863445378151283,8
3055,4,0,0,34,0.0,0.0,1.0,34,1250,900,350,0.72,16,9,7,384.7522641015371,0.3940693701723113,0.13713429132637245,0.21254760997453842,129050.14349489794,3130.4669784580447,132180.61047335598,872,14,240.61764705882354,34,0,18,36.20874829134934,0.6148897058823529,45.982142857142854,1016.0714285714284,29.8844537815126,0
3056,4,0,0,34,0.0,0.0,1.0,34,850,500,350,0.5882352941176471,12,5,7,385.64901908089246,0.393270944741533,0.14103182256509217,0.21385991058122208,129201.38888888879,3165.4549319727794,132366.84382086157,873,15,241.61764705882354,32,2,18,36.03142076502734,0.62109375,45.83333333333333,1016.6666666666658,31.770833333333307,0
3057,4,0,1,33,0.0,0.029411764705882353,0.9705882352941176,34,900,400,500,0.4444444444444444,14,4,10,383.0872858300038,0.39360516934046347,0.13030528667163144,0.2134797613567199,129394.01113406788,3113.840105601464,132507.85123966934,874,16,242.61764705882354,32,2,19,35.89988210474064,0.623046875,45.64393939393939,1017.4242424242418,31.794507575757557,0
3058,4,1,0,34,0.029411764705882353,0.0,1.0,34,1050,800,250,0.7619047619047619,13,8,5,380.56094267777763,0.39603758169934644,0.12916457025353933,0.2136384916201551,129683.2135273185,3070.4731978879563,132753.68672520644,875,0,241.0,32,2,18,35.66923887442668,0.6259765625,45.35984848484848,1018.5606060606049,31.830018939393902,0
3059,4,1,0,35,0.02857142857142857,0.0,1.0,35,1300,800,500,0.6153846153846154,18,8,10,371.28447103345337,0.4014005602240896,0.1318639063411955,0.21019247400955085,130012.50270328714,2654.324658785073,132666.82736207222,876,0,235.0857142857143,33,2,19,35.57037571096692,0.6268939393939394,45.03676470588235,1019.8529411764702,30.904634581105157,0
3060,4,1,1,35,0.027777777777777776,0.027777777777777776,0.9722222222222222,36,700,300,400,0.42857142857142855,11,3,8,360.1622452459653,0.4061342592592592,0.12350536965787096,0.20552971240682902,130323.35778061204,2187.5106292516807,132510.86840986373,877,0,229.52777777777777,34,2,20,35.538358400373106,0.6277573529411764,44.73214285714285,1021.0714285714268,30.031512605041968,0
3061,4,1,0,36,0.027777777777777776,0.0,1.0,36,1000,800,200,0.8,12,8,4,359.33474007301993,0.4080687830687831,0.12423324792297596,0.20650924218654243,130597.00255102017,2185.6079931972527,132782.61054421743,878,0,220.91666666666666,34,2,17,35.28199976706266,0.6305147058823529,44.4642857142857,1022.1428571428552,30.063025210083975,0
3062,4,1,1,36,0.02702702702702703,0.02702702702702703,0.972972972972973,37,1250,900,350,0.72,16,9,7,351.7188659889128,0.4112862862862863,0.1256778153407876,0.2037941161909542,130913.23329260944,1808.9307913236933,132722.16408393314,879,0,215.9189189189189,35,2,19,35.15654452235542,0.631547619047619,44.155092592592574,1023.3796296296273,29.239417989417923,0
3063,4,0,1,35,0.0,0.027777777777777776,0.9722222222222222,36,750,500,250,0.6666666666666666,10,5,5,359.0094202220077,0.40611772486772485,0.13361912890544225,0.20729898780561037,130779.59183673431,2190.221088435329,132969.81292516965,880,1,222.86111111111111,34,2,19,35.10533054003723,0.6323529411764706,44.28571428571426,1022.8571428571398,30.08403361344529,0
3064,4,0,0,35,0.0,0.0,1.0,35,650,400,250,0.6153846153846154,9,4,5,368.9483593493972,0.4014705882352941,0.13737436002808212,0.21243175721546018,130669.48596993927,2642.0584931276235,133311.54446306688,881,2,230.11428571428573,33,2,20,34.96281813096807,0.6335227272727273,44.39338235294117,1022.4264705882339,30.982620320855574,0
3065,4,0,0,35,0.0,0.0,1.0,35,950,700,250,0.7368421052631579,12,7,5,369.5346409187726,0.4009103641456582,0.13975557153127238,0.21328742137676865,130763.47588667815,2664.3268214148325,133427.802708093,882,3,231.11428571428573,33,2,20,34.85252416327181,0.634469696969697,44.30147058823529,1022.7941176470584,30.993761140819952,0
3066,4,0,0,35,0.0,0.0,1.0,35,650,300,350,0.46153846153846156,10,3,7,369.54299197188703,0.4005602240896358,0.13653227462523088,0.21363884328125415,130826.15460399841,2669.1777201076397,133495.33232410604,883,4,232.11428571428573,33,2,20,34.788771761699394,0.6351010101010102,44.24019607843137,1023.0392156862741,31.001188354129518,0
3067,4,0,0,35,0.0,0.0,1.0,35,1100,700,400,0.6363636363636364,15,7,8,386.5064590688193,0.40059523809523806,0.17749835253887158,0.20904708753816564,128208.45967567073,2998.3862056701546,131206.84588134088,884,5,233.11428571428573,32,3,20,37.025983875659726,0.6110026041666667,46.81186868686868,1012.7525252525243,31.648516414141383,8
3068,4,0,0,35,0.0,0.0,1.0,35,1000,600,400,0.6,14,6,8,383.7694121757363,0.40119047619047615,0.17999465954606197,0.20823188186005942,128336.3643537647,2850.3142217630607,131186.67857552777,885,6,234.11428571428573,32,3,22,36.96417445482867,0.6123046875,46.68560606060605,1013.257575757574,31.66429924242419,0
3069,4,0,1,34,0.0,0.02857142857142857,0.9714285714285714,35,1000,900,100,0.9,11,9,2,385.26101382922843,0.4015056022408963,0.17826094692454153,0.20971258847694038,128464.33280086191,2898.4598191510745,131362.792620013,886,7,235.11428571428573,32,3,18,36.79526300494042,0.6136067708333333,46.55934343434342,1013.7626262626243,31.68008207070701,0
3070,4,2,1,35,0.05555555555555555,0.027777777777777776,0.9722222222222222,36,800,500,300,0.625,11,5,6,383.8751267214959,0.4041170634920635,0.22014885378565618,0.21237334395606136,129107.96215698263,2712.2670667531374,131820.22922373578,887,0,229.33333333333334,33,3,20,36.171947224566885,0.617739898989899,45.9252450980392,1016.2990196078409,30.796939988116392,0
3071,4,1,0,36,0.027777777777777776,0.0,1.0,36,1000,900,100,0.9,11,9,2,377.3104842970937,0.40701058201058204,0.2268018856221321,0.21077614788072546,129490.3760617537,2571.6490918245663,132062.02515357826,888,0,225.75,32,4,17,35.9485485671753,0.6240234375,45.549242424242415,1017.8030303030287,31.806344696969646,0
3072,4,1,0,37,0.02702702702702703,0.0,1.0,37,1250,800,450,0.64,17,8,9,371.41850036982254,0.40868993993993996,0.21599532224532236,0.20993219586120399,129950.01922337555,2253.1682525951474,132203.1874759707,889,0,220.6216216216216,33,4,18,35.63050881410256,0.6262626262626263,45.09803921568627,1019.6078431372543,30.897207367795588,0
3073,4,1,0,38,0.02631578947368421,0.0,1.0,38,900,800,100,0.8888888888888888,10,8,2,361.5679834660206,0.4119695353247985,0.220994544903526,0.20700760372065558,130450.30757400986,1833.7063869665392,132284.0139609764,890,0,215.78947368421052,33,5,20,35.37368042226489,0.6313131313131313,44.607843137254896,1021.5686274509793,30.9566250742721,0
3074,4,0,0,38,0.0,0.0,1.0,38,950,800,150,0.8421052631578947,11,8,3,362.6198321918004,0.4118065433854907,0.2276789095039753,0.2082816391514887,130575.52984429066,1869.8553440984213,132445.38518838907,891,1,216.78947368421052,33,5,15,35.219824140687436,0.6325757575757576,44.48529411764706,1022.0588235294118,30.971479500891267,0
3075,4,0,0,38,0.0,0.0,1.0,38,1700,1200,500,0.7058823529411765,22,12,10,333.7315543792268,0.41130275011853956,0.09485019201813594,0.19334057088897094,130906.99932912034,1137.5592730455373,132044.55860216587,892,2,217.78947368421052,37,1,13,35.62303564413015,0.6275337837837838,44.16118421052631,1023.3552631578934,27.65825035561874,8
3076,4,0,1,37,0.0,0.02631578947368421,0.9736842105263158,38,950,400,550,0.42105263157894735,15,4,11,332.2489938607335,0.41108048838312,0.099377621431471,0.1929027740475003,130991.17036011067,1104.3369113573312,132095.507271468,893,3,218.78947368421052,37,1,13,35.575996143958875,0.6283783783783784,44.07894736842105,1023.6842105263147,27.66714082503553,0
3077,4,0,0,37,0.0,0.0,1.0,37,1100,900,200,0.8181818181818182,13,9,4,340.5805306641787,0.408252002002002,0.09830010468214678,0.19739769532372806,130924.43795146498,1518.0629108838546,132442.50086234882,894,4,225.59459459459458,36,1,14,35.43019182805164,0.6296296296296297,44.14414414414414,1023.4234234234234,28.42842842842843,0
3078,4,0,0,37,0.0,0.0,1.0,37,950,600,350,0.631578947368421,13,6,7,343.5062495536171,0.4079391891891892,0.09240080379543625,0.19969046169702598,131039.71370018662,1602.592119146165,132642.30581933277,895,5,226.59459459459458,36,1,15,35.23885467077283,0.630787037037037,44.03153153153153,1023.8738738738734,28.44094094094093,0
3079,4,1,1,37,0.02631578947368421,0.02631578947368421,0.9736842105263158,38,1300,900,400,0.6923076923076923,17,9,8,334.9906592813343,0.4107841394025604,0.09599206739247279,0.19635672707263288,131356.98356718215,1200.989545288542,132557.9731124707,896,0,221.60526315789474,36,2,16,35.13676809842908,0.6339699074074074,43.72184684684685,1025.1126126126135,28.475350350350375,0
3080,4,0,1,36,0.0,0.02702702702702703,0.972972972972973,37,1300,1000,300,0.7692307692307693,16,10,6,341.5357908679847,0.4065315315315315,0.10506882630626557,0.20019738581851354,131357.78523930468,1572.6770136745586,132930.46225297923,897,1,228.43243243243242,35,2,17,34.96822193368712,0.6360119047619048,43.72106481481482,1025.1157407407406,29.28902116402116,0
3081,4,0,1,35,0.0,0.027777777777777776,0.9722222222222222,36,950,600,350,0.631578947368421,13,6,7,349.3988839088627,0.4045800264550265,0.11058529787481142,0.20481101356972217,131358.63272392302,1979.31193310659,133337.9446570296,898,2,235.52777777777777,34,2,18,34.76585181744281,0.6381740196078431,43.7202380952381,1025.1190476190484,30.15056022408966,0
3082,4,0,0,35,0.0,0.0,1.0,35,1200,900,300,0.75,15,9,6,356.2539744988552,0.40143557422969184,0.11529660872237968,0.20900566273894963,131390.93888168014,2361.708837946942,133752.64771962707,899,3,242.6,33,2,19,34.5575344648976,0.6407828282828283,43.68872549019608,1025.2450980392157,31.068033273915628,0
3083,4,0,0,35,0.0,0.0,1.0,35,1250,1100,150,0.88,14,11,3,352.25376021658496,0.4018207282913165,0.10508238570433992,0.20764178560509794,131572.2859977325,2269.366496598649,133841.65249433115,900,4,243.6,34,1,15,34.47701516206389,0.6403186274509804,43.511904761904766,1025.9523809523816,30.175070028011223,0
3084,4,0,1,34,0.0,0.02857142857142857,0.9714285714285714,35,1150,700,450,0.6086956521739131,16,7,9,350.6725477840788,0.4014005602240896,0.09484057971014481,0.20787290203695402,131786.1128826531,2242.7543934240407,134028.86727607716,901,5,244.6,34,1,15,34.301932367149746,0.6424632352941176,43.30357142857143,1026.7857142857147,30.199579831932784,0
3085,4,0,0,34,0.0,0.0,1.0,34,1000,800,200,0.8,12,8,4,357.9581644818722,0.398767082590612,0.10729080364540189,0.21209147821988147,131768.1375552672,2633.496131295654,134401.63368656285,902,6,250.55882352941177,33,1,16,34.13304686878331,0.6445707070707071,43.32107843137255,1026.7156862745096,31.112596553773017,0
3086,4,0,2,32,0.0,0.058823529411764705,0.9411764705882353,34,950,600,350,0.631578947368421,13,6,7,356.81595118834355,0.3991198752228164,0.10329378083095397,0.21229156272618036,131925.46323829767,2614.621930267198,134540.08516856487,903,7,251.55882352941177,33,1,17,34.00371287128713,0.6461489898989898,43.16789215686274,1027.3284313725483,31.131164587046918,0
3087,4,0,0,32,0.0,0.0,1.0,32,650,500,150,0.7692307692307693,8,5,3,373.594104835761,0.390646001344086,0.12079288795838083,0.22054645245023455,131628.58963012687,3435.13302273219,135063.72265285905,904,17,267.5625,31,1,17,33.8727371737935,0.6481854838709677,43.45703124999999,1026.1718749999993,33.102318548387075,0
3088,4,0,0,32,0.0,0.0,1.0,32,800,600,200,0.75,10,6,4,371.14260274744834,0.39037298387096775,0.11930809233891404,0.21967629730186794,131728.82080078116,3378.0354817708176,135106.85628255198,905,18,268.5625,31,1,17,33.8343480466768,0.6491935483870968,43.35937499999999,1026.5624999999993,33.11491935483869,0
3089,4,0,0,32,0.0,0.0,1.0,32,700,400,300,0.5714285714285714,10,4,6,370.55494512244604,0.38991095430107525,0.1203477681968046,0.21971400731094798,131795.66277397994,3367.5069173176985,135163.16969129763,906,19,269.5625,31,1,19,33.781913094936186,0.6498655913978495,43.29427083333333,1026.8229166666658,33.12331989247309,0
3090,4,0,0,32,0.0,0.0,1.0,32,800,500,300,0.625,11,5,6,367.62134384424553,0.3901209677419355,0.11859787018255585,0.21835821989784684,131862.52170138876,3295.095486111092,135157.61718749985,907,20,270.5625,31,1,19,33.789722785665994,0.6505376344086021,43.22916666666666,1027.0833333333321,33.131720430107485,0
3091,4,0,0,32,0.0,0.0,1.0,32,1300,1000,300,0.7692307692307693,16,10,6,369.0359656366956,0.38925991263440857,0.1222332172260927,0.2205555600833997,132096.66146172408,3349.683803982196,135446.34526570627,908,21,271.5625,31,1,19,33.5171258180283,0.6528897849462365,43.00130208333333,1027.9947916666658,33.16112231182793,0
3092,4,0,0,32,0.0,0.0,1.0,32,550,400,150,0.7272727272727273,7,4,3,368.77827140303253,0.38894489247311825,0.12302956444669588,0.22098716142193853,132197.0706515841,3350.2814398871433,135547.35209147126,909,22,272.5625,31,1,19,33.422490925972824,0.6538978494623655,42.90364583333333,1028.3854166666658,33.17372311827954,0
3093,4,0,0,32,0.0,0.0,1.0,32,750,500,250,0.6666666666666666,10,5,5,367.8974523313574,0.3885248655913978,0.11723101265822833,0.22085029433265357,132264.03130425338,3331.9200303819403,135595.95133463532,910,23,273.5625,31,1,19,33.377637130801695,0.6545698924731183,42.838541666666664,1028.6458333333328,33.18212365591396,0
3094,4,0,0,32,0.0,0.0,1.0,32,950,600,350,0.631578947368421,13,6,7,369.1217802518831,0.38841985887096775,0.11575113880804722,0.22217588951489978,132364.50407240135,3371.724277072493,135736.22834947385,911,24,274.5625,31,1,20,33.24489118056433,0.6555779569892473,42.74088541666667,1029.0364583333342,33.19472446236562,0
3095,4,0,0,32,0.0,0.0,1.0,32,600,500,100,0.8333333333333334,7,5,2,366.9725651308004,0.3880418346774193,0.11933183657981283,0.2214721450323747,132465.01498752178,3322.205268012162,135787.22025553393,912,25,275.5625,31,1,20,33.198941732017865,0.6565860215053764,42.64322916666667,1029.427083333334,33.20732526881722,0
3096,4,0,0,32,0.0,0.0,1.0,32,650,500,150,0.7692307692307693,8,5,3,366.3685741531949,0.3873907930107527,0.11608215324314042,0.2216992389424346,132565.56404961488,3313.5713365342976,135879.1353861492,913,26,276.5625,31,1,21,33.11325178067181,0.6575940860215054,42.54557291666667,1029.8177083333342,33.219926075268845,0
3097,4,0,0,32,0.0,0.0,1.0,32,1050,700,350,0.6666666666666666,14,7,7,366.1339434299053,0.38547967069892475,0.11665245135203417,0.22254869649034342,132733.2305908203,3319.6282280815967,136052.8588189019,914,27,277.5625,31,1,19,32.950572824530376,0.6592741935483871,42.3828125,1030.46875,33.24092741935484,0
3098,4,0,0,32,0.0,0.0,1.0,32,1100,700,400,0.6363636363636364,15,7,8,365.9010821304341,0.3858996975806452,0.11996273370389043,0.22280561278034755,132800.3268771702,3318.356662326394,136118.68353949662,915,28,278.5625,31,1,19,32.889085396664974,0.6599462365591398,42.317708333333336,1030.7291666666672,33.24932795698926,0
3099,4,0,0,32,0.0,0.0,1.0,32,600,400,200,0.6666666666666666,8,4,4,365.9010821304341,0.3858996975806452,0.11996273370389043,0.22280561278034755,132800.3268771702,3318.356662326394,136118.68353949662,916,29,279.5625,31,1,19,32.889085396664974,0.6599462365591398,42.317708333333336,1030.7291666666672,33.24932795698926,0
3100,4,0,0,32,0.0,0.0,1.0,32,1150,900,250,0.782608695652174,14,9,5,367.5959779725139,0.38533266129032256,0.11191832933451162,0.2244404432971734,132901.00309583882,3370.7748413085988,136271.77793714742,917,30,280.5625,31,1,19,32.74416487772025,0.6609543010752688,42.220052083333336,1031.1197916666672,33.26192876344088,0
3101,4,0,0,32,0.0,0.0,1.0,32,950,700,250,0.7368421052631579,12,7,5,367.56189051278204,0.38434559811827956,0.11322109315829287,0.2250251388440696,133001.71746148015,3377.272542317714,136378.99000379787,918,31,281.5625,31,1,19,32.64379786249262,0.6619623655913979,42.122395833333336,1031.5104166666674,33.2745295698925,0
3102,4,0,2,30,0.0,0.0625,0.9375,32,950,900,50,0.9473684210526315,10,9,1,366.18190834125625,0.38421959005376344,0.10794737506309993,0.22458401251517907,133068.88156467007,3345.483398437495,136414.36496310757,919,32,282.5625,31,1,20,32.611896348645466,0.6626344086021505,42.057291666666664,1031.7708333333328,33.282930107526866,0
3103,4,0,0,30,0.0,0.0,1.0,30,850,600,250,0.7058823529411765,11,6,5,385.492774541061,0.38362068965517243,0.1066998967174102,0.2351284195084875,132862.96537422822,4243.5426311728215,137106.50800540103,920,33,284.7,29,1,20,32.32113588396426,0.6663074712643677,42.256944444444436,1030.972222222221,35.550766283524865,0
3104,4,1,1,30,0.03225806451612903,0.03225806451612903,0.967741935483871,31,550,400,150,0.7272727272727273,7,4,3,373.8869005554298,0.3865143369175627,0.10459827559415591,0.2302987396284085,133229.27731890953,3762.5363120013662,136991.8136309109,921,0,276.48387096774195,30,1,21,32.25193117215641,0.6670138888888889,41.9018817204301,1032.392473118278,34.41308243727594,0
3105,4,0,0,30,0.0,0.0,1.0,30,800,500,300,0.625,11,5,6,383.3050835999587,0.38414750957854404,0.09180232297412405,0.2360486069924185,133221.1829668209,4212.871334876526,137434.0543016974,922,1,275.23333333333335,29,1,21,32.01699067222745,0.6698994252873562,41.909722222222214,1032.3611111111104,35.59865900383139,0
3106,4,0,0,30,0.0,0.0,1.0,30,750,300,450,0.4,12,3,9,385.6874701414777,0.3827825670498084,0.08352160659852959,0.2382036568083079,133328.74228395053,4284.6450617283845,137613.38734567893,923,2,276.23333333333335,29,1,21,31.847319347319342,0.6709770114942528,41.80555555555555,1032.7777777777771,35.61302681992335,0
3107,4,1,0,31,0.03225806451612903,0.0,1.0,31,1000,800,200,0.8,12,8,4,377.6764252278243,0.38602150537634405,0.08770069612375164,0.23614747725252333,133784.9051371545,3905.480944328816,137690.38608148333,924,0,268.2903225806452,30,1,19,31.59618466069032,0.6725694444444444,41.36424731182795,1034.5430107526877,34.48476702508959,0
3108,4,0,0,31,0.0,0.0,1.0,31,900,700,200,0.7777777777777778,11,7,4,376.4852715522489,0.38525985663082435,0.07686475572925189,0.2362928342480737,133923.99274843888,3884.0821554514614,137808.07490389035,925,1,269.2903225806452,30,1,20,31.4875232653768,0.6739583333333333,41.2298387096774,1035.0806451612882,34.50268817204294,0
3109,4,0,0,31,0.0,0.0,1.0,31,700,500,200,0.7142857142857143,9,5,4,376.31170538717794,0.38584229390681,0.07949981783385662,0.23663094421203493,133993.56365258957,3884.6692898022493,137878.23294239183,926,2,270.2903225806452,30,1,20,31.42228136223982,0.6746527777777778,41.16263440860213,1035.3494623655888,34.51164874551963,0
3110,4,0,0,31,0.0,0.0,1.0,31,450,300,150,0.6666666666666666,6,3,3,375.88496326704933,0.3855286738351254,0.0793890061300373,0.23658641805631886,134028.35587929212,3875.848725286123,137904.20460457826,927,3,271.2903225806452,30,1,21,31.398461838006234,0.675,41.1290322580645,1035.4838709677397,34.516129032257986,0
3111,4,0,0,31,0.0,0.0,1.0,31,950,600,350,0.631578947368421,13,6,7,374.2396705725306,0.38485663082437277,0.07442494947254796,0.23667051849414553,134202.38475907597,3844.7712524569024,138047.15601153288,928,4,272.2903225806452,30,1,22,31.266755307649067,0.6767361111111111,40.96102150537633,1036.155913978493,34.53853046594976,0
3112,4,0,0,31,0.0,0.0,1.0,31,700,400,300,0.5714285714285714,10,4,6,374.8649438329651,0.38391577060931903,0.08146719600403274,0.23751713902185634,134272.02792591613,3866.7752413573617,138138.8031672735,929,5,273.2903225806452,30,1,22,31.18083473825271,0.6774305555555555,40.893817204301065,1036.4247311827944,34.54749103942648,0
3113,4,0,0,31,0.0,0.0,1.0,31,900,600,300,0.6666666666666666,12,6,6,375.1234086310678,0.3836469534050179,0.08772788296257295,0.2381338971828333,134341.68915842863,3878.9424716730146,138220.63163010165,930,6,274.2903225806452,30,1,22,31.104412463805694,0.678125,40.8266129032258,1036.6935483870961,34.5564516129032,0
3114,4,0,0,31,0.0,0.0,1.0,31,1000,700,300,0.7,13,7,6,381.12288511475634,0.38337813620071687,0.09120352377250951,0.2433323035732674,134550.78124999988,4056.0763888888755,138606.85763888876,931,7,275.2903225806452,30,1,22,30.73962516733601,0.6802083333333333,40.62499999999999,1037.499999999999,34.5833333333333,0
3115,4,0,0,31,0.0,0.0,1.0,31,650,400,250,0.6153846153846154,9,4,5,386.7893166076036,0.38297491039426523,0.06246920131913081,0.23344518328586572,132467.1769315817,4047.3777676609993,136514.5546992427,932,8,276.2903225806452,30,1,21,32.68676284980633,0.659375,42.641129032258064,1029.4354838709678,34.31451612903226,8
3116,4,0,0,31,0.0,0.0,1.0,31,650,500,150,0.7692307692307693,8,5,3,386.7893166076036,0.38297491039426523,0.06246920131913081,0.23344518328586572,132467.1769315817,4047.3777676609993,136514.5546992427,933,9,277.2903225806452,30,1,21,32.68676284980633,0.659375,42.641129032258064,1029.4354838709678,34.31451612903226,0
3117,4,0,0,31,0.0,0.0,1.0,31,950,700,250,0.7368421052631579,12,7,5,386.8947909527307,0.3826612903225806,0.056137957747071976,0.23415386163347715,132570.9709937565,4058.203621805986,136629.1746155625,934,10,278.2903225806452,30,1,21,32.579341773253276,0.6604166666666667,42.54032258064516,1029.8387096774193,34.32795698924731,0
3118,4,1,0,32,0.03125,0.0,1.0,32,600,400,200,0.6666666666666666,8,4,4,391.6701374427319,0.38827284946236557,0.032015306122448406,0.2231608922638823,130262.58680555565,3838.9681971904347,134101.55500274608,935,0,270.5625,31,1,21,34.795918367346935,0.6344086021505376,44.79166666666667,1020.8333333333342,32.93010752688175,8
3119,4,1,0,33,0.030303030303030304,0.0,1.0,33,1050,700,350,0.6666666666666666,14,7,7,383.6099952741022,0.3927556818181818,0.03326745718050095,0.2205757472826087,130617.28395061725,3421.2191358024656,134038.50308641972,936,0,263.3333333333333,32,1,21,34.641077898550726,0.6354166666666667,44.44444444444444,1022.222222222222,31.944444444444436,0
3120,4,0,0,33,0.0,0.0,1.0,33,900,700,200,0.7777777777777778,11,7,4,383.6099952741022,0.3927556818181818,0.03326745718050095,0.2205757472826087,130617.28395061725,3421.2191358024656,134038.50308641972,937,1,264.3333333333333,32,1,21,34.641077898550726,0.6354166666666667,44.44444444444444,1022.222222222222,31.944444444444436,0
3121,4,0,0,33,0.0,0.0,1.0,33,1100,1000,100,0.9090909090909091,12,10,2,382.01643475425396,0.3924794823232323,0.03895729738426423,0.2202100430658151,130714.10323245073,3386.98713779206,134101.09037024277,938,2,265.3333333333333,32,1,21,34.583487673375316,0.6363932291666667,44.349747474747474,1022.6010101010097,31.956281565656553,0
3122,4,0,0,33,0.0,0.0,1.0,33,1000,600,400,0.6,14,6,8,381.3272895977424,0.39129577020202017,0.031559734596021904,0.2203647432468551,130810.95838434852,3376.3576420773397,134187.31602642586,939,3,266.3333333333333,32,1,21,34.50279766312845,0.6373697916666667,44.255050505050505,1022.9797979797979,31.968118686868685,0
3123,4,1,0,34,0.029411764705882353,0.0,1.0,34,1100,800,300,0.7272727272727273,14,8,6,372.9543465913761,0.3956476530005942,0.03609785622791861,0.21737464636058004,131139.7734645328,2981.8297049211765,134121.60316945397,940,0,259.47058823529414,33,1,22,34.383724176437745,0.6382575757575757,43.93382352941176,1024.2647058823525,31.03832442067735,0
3124,4,0,0,34,0.0,0.0,1.0,34,750,500,250,0.6666666666666666,10,5,5,372.75384582175326,0.39551767676767674,0.03598288974721586,0.21779139796755279,131233.93233672148,2983.5905961649387,134217.5229328864,941,1,260.47058823529414,33,1,22,34.29352051190048,0.6392045454545454,43.841911764705884,1024.6323529411766,31.049465240641716,0
3125,4,0,0,34,0.0,0.0,1.0,34,750,500,250,0.6666666666666666,10,5,5,372.77724922845164,0.3954248366013072,0.033871716589051415,0.21798345161177002,131265.326136582,2986.54543925412,134251.87157583612,942,2,261.47058823529414,33,1,22,34.26114167264609,0.639520202020202,43.811274509803916,1024.7549019607836,31.053178847296472,0
3126,4,0,0,34,0.0,0.0,1.0,34,700,500,200,0.7142857142857143,9,5,4,370.14400865473914,0.39596330956625075,0.024672128265532667,0.21697649841604005,131359.53006355726,2924.388606545557,134283.9186701028,943,3,262.47058823529414,33,1,22,34.23328850368598,0.6404671717171717,43.71936274509804,1025.1225490196075,31.064319667260833,0
3127,4,0,0,34,0.0,0.0,1.0,34,1000,700,300,0.7,13,7,6,369.2379849364471,0.39585190136660725,0.02922906111435153,0.2175152126603095,131548.0392907775,2914.5065900134496,134462.54588079095,944,4,263.47058823529414,33,1,23,34.065897144905044,0.6423611111111112,43.53553921568627,1025.8578431372543,31.086601307189525,0
3128,4,0,0,34,0.0,0.0,1.0,34,1000,600,400,0.6,14,6,8,369.82191451540626,0.39609328579916814,0.02712121637952869,0.21803866678330866,131579.47063629376,2932.1943483275722,134511.66498462134,945,5,264.47058823529414,33,1,17,34.01915113871636,0.6426767676767677,43.504901960784316,1025.980392156863,31.090314913844335,0
3129,4,1,0,35,0.02857142857142857,0.0,1.0,35,500,100,400,0.2,9,1,8,360.9470647796556,0.40042016806722686,0.03345916948142258,0.21448011535253916,131877.806122449,2520.181405895694,134397.98752834467,946,0,257.8857142857143,34,1,18,33.945680729408124,0.6433823529411764,43.214285714285715,1027.1428571428573,30.21008403361345,0
3130,4,0,0,35,0.0,0.0,1.0,35,850,400,450,0.47058823529411764,13,4,9,360.0646643455892,0.39999999999999997,0.031219996689290097,0.21430055540016782,131938.95266439908,2501.310941043085,134440.26360544216,947,1,258.8857142857143,34,1,18,33.906672460409446,0.6439950980392157,43.154761904761905,1027.3809523809523,30.21708683473389,0
3131,4,1,1,35,0.027777777777777776,0.027777777777777776,0.9722222222222222,36,1000,600,400,0.6,14,6,8,354.10631447430904,0.40218253968253964,0.04049011887351428,0.21282292287776433,132308.68115837194,2170.2678915895144,134478.94904996146,948,0,252.66666666666666,35,1,19,33.68735234559568,0.6455357142857143,42.79513888888889,1028.8194444444448,29.39484126984128,0
3132,4,0,0,35,0.0,0.0,1.0,35,1000,700,300,0.7,13,7,6,362.91849425148365,0.3987394957983193,0.04457897087282303,0.21722294073805018,132153.0771683673,2592.1591553287935,134745.2363236961,949,1,260.65714285714284,34,1,19,33.61747906294624,0.6461397058823529,42.94642857142857,1028.2142857142853,30.24159663865545,0
3133,4,0,0,35,0.0,0.0,1.0,35,700,600,100,0.8571428571428571,8,6,2,362.73900338759313,0.3986694677871148,0.04033263345842908,0.21781985603003393,132275.5119756234,2596.297477324241,134871.80945294764,950,2,261.65714285714284,34,1,21,33.498726999189905,0.6473651960784313,42.82738095238094,1028.6904761904748,30.255602240896316,0
3134,4,0,1,34,0.0,0.02857142857142857,0.9714285714285714,35,1200,1000,200,0.8333333333333334,14,10,4,366.0672390773944,0.3991596638655462,0.04133372988334827,0.2207125069081694,132428.63520408154,2695.556972789106,135124.19217687065,951,3,262.65714285714284,34,1,22,33.25887693731205,0.6488970588235294,42.67857142857142,1029.2857142857135,30.27310924369746,0
3135,4,0,0,34,0.0,0.0,1.0,34,450,200,250,0.4444444444444444,7,2,5,371.9153452459612,0.39882278669043375,0.029579912002914766,0.22368203715509224,132334.9492983467,3043.479671280271,135378.42896962698,952,4,259.7647058823529,33,1,22,33.20281483245991,0.6502525252525253,42.76960784313725,1028.9215686274504,31.179441473559102,0
3136,4,0,0,34,0.0,0.0,1.0,34,450,200,250,0.4444444444444444,7,2,5,370.6010588601683,0.3982286096256684,0.027030245296499444,0.223264540337711,132398.00347222216,3013.3680555555457,135411.3715277777,953,5,260.7647058823529,33,1,22,33.173076923076934,0.6508838383838385,42.70833333333333,1029.166666666666,31.186868686868667,0
3137,4,0,0,34,0.0,0.0,1.0,34,750,400,350,0.5333333333333333,11,4,7,371.568196912414,0.3984699940582293,0.02301744605450251,0.2240345503135222,132429.5361910082,3041.3207960880327,135470.85698709622,954,6,261.7647058823529,33,1,22,33.116417629082804,0.651199494949495,42.67769607843137,1029.289215686274,31.190582293523455,0
3138,4,0,0,34,0.0,0.0,1.0,34,750,600,150,0.8,9,6,3,369.82217255829596,0.39837715389185974,0.023600823333380427,0.22354287006005763,132524.1568747596,3002.0743223759955,135526.23119713558,955,7,262.7647058823529,33,1,23,33.06603586447672,0.6521464646464646,42.58578431372548,1029.656862745097,31.201723113487787,0
3139,4,0,0,34,0.0,0.0,1.0,34,1000,600,400,0.6,14,6,8,369.54049057670363,0.39889705882352944,0.013750682285762261,0.22412390792119552,132650.37035034603,3003.9365868896552,135654.30693723567,956,8,263.7647058823529,33,1,17,32.946209057022756,0.6534090909090908,42.463235294117645,1030.1470588235293,31.216577540106947,0
3140,4,0,1,33,0.0,0.029411764705882353,0.9705882352941176,34,850,700,150,0.8235294117647058,10,7,3,372.3696805088784,0.398767082590612,0.015800517591102903,0.22660123104773278,132776.6438989812,3088.399293540952,135865.04319252213,957,9,264.7647058823529,33,1,17,32.74623464130004,0.6546717171717171,42.34068627450981,1030.6372549019611,31.231431966726095,0
3141,4,0,0,33,0.0,0.0,1.0,33,650,400,250,0.6153846153846154,9,4,5,378.2584348910442,0.39374210858585856,0.014627768243850925,0.22925945853203109,132625.50536935005,3433.3432175288226,136058.84858687888,958,10,273.45454545454544,32,1,17,32.74674143989541,0.6555989583333333,42.48737373737374,1030.0505050505049,32.18907828282828,0
3142,4,0,0,33,0.0,0.0,1.0,33,700,400,300,0.5714285714285714,10,4,6,380.6780588205556,0.3930318813131313,0.016092799085079657,0.23132640640614724,132723.06596584542,3504.951822518127,136228.01778836356,959,11,274.45454545454544,32,1,17,32.58613119307275,0.6565755208333333,42.392676767676775,1030.4292929292938,32.20091540404043,0
3143,4,0,0,33,0.0,0.0,1.0,33,1050,800,250,0.7619047619047619,13,8,5,366.05388818218626,0.39255839646464646,-0.02149445713802134,0.21552858976825587,131528.3966064453,3031.404559498672,134559.801165944,960,12,275.45454545454544,31,2,21,34.16740712532791,0.6471774193548387,43.5546875,1025.78125,33.08971774193548,8
3144,4,0,0,33,0.0,0.0,1.0,33,950,600,350,0.631578947368421,13,6,7,387.292517953849,0.39315025252525254,0.014635750698898331,0.22494038220414106,131004.77629833692,3547.4339353127275,134552.21023364965,961,13,276.45454545454544,32,1,18,34.15351093570137,0.6393229166666667,44.06565656565657,1023.7373737373739,31.991792929292934,8
3145,4,2,0,35,0.05714285714285714,0.0,1.0,35,350,200,150,0.5714285714285714,5,2,3,367.8580233849483,0.402766106442577,0.019181261869593014,0.21655641898400876,131522.32552800738,2677.105652484445,134199.4311804918,962,0,261.6,32,3,20,34.12727720334811,0.64453125,43.56060606060606,1025.757575757576,32.05492424242425,0
3146,4,0,1,34,0.0,0.02857142857142857,0.9714285714285714,35,900,500,400,0.5555555555555556,13,5,8,369.5343621155994,0.40178571428571425,0.014707536557930556,0.218283088319447,131651.87225793282,2729.9781272319115,134381.85038516473,963,1,262.6,32,3,16,33.95336081036746,0.6458333333333333,43.43434343434343,1026.2626262626259,32.07070707070706,0
3147,4,0,0,34,0.0,0.0,1.0,34,900,600,300,0.6666666666666666,12,6,6,380.13023938625776,0.39739304812834225,0.016111687787975892,0.22362105269944363,131495.0074089897,3197.0457288953894,134692.0531378851,964,2,271.29411764705884,31,3,21,33.84021518344547,0.6468413978494624,43.58723958333333,1025.6510416666658,33.08551747311825,0
3148,4,0,0,34,0.0,0.0,1.0,34,800,600,200,0.75,10,6,4,384.39537220747764,0.397448752228164,0.012869513287548928,0.2267242165415363,131595.18771701393,3316.916232638895,134912.10394965284,965,3,272.29411764705884,31,3,17,33.629441624365484,0.6478494623655914,43.489583333333336,1026.041666666667,33.0981182795699,0
3149,4,0,0,34,0.0,0.0,1.0,34,950,800,150,0.8421052631578947,11,8,3,381.90755923404856,0.39756016042780745,0.011664701404540345,0.22565182772734416,131661.9957817925,3256.542290581593,134918.5380723741,966,4,273.29411764705884,31,3,17,33.625666074600346,0.648521505376344,43.424479166666664,1026.3020833333333,33.1065188172043,0
3150,4,0,0,34,0.0,0.0,1.0,34,1000,700,300,0.7,13,7,6,386.3622432495937,0.3967060308972074,0.008063433336814585,0.22908666543355594,131795.66277397997,3384.173583984364,135179.83635796435,967,5,274.29411764705884,31,3,17,33.37613069574775,0.6498655913978495,43.29427083333333,1026.822916666666,33.1233198924731,0
3151,4,0,0,34,0.0,0.0,1.0,34,900,600,300,0.6666666666666666,12,6,6,386.3830748897449,0.39705882352941174,0.008128552625870089,0.22940437453672885,131846.31191970204,3388.636682481379,135234.94860218343,968,6,275.29411764705884,32,2,17,33.32436890418819,0.6477864583333333,43.244949494949495,1027.0202020202019,32.09438131313131,0
3152,4,0,0,34,0.0,0.0,1.0,34,1100,900,200,0.8181818181818182,13,9,4,384.0083818326543,0.397021687462864,0.010871293712864993,0.2287745396306105,131976.01807213548,3335.979428119573,135311.99750025506,969,7,276.29411764705884,32,2,18,33.25422913082657,0.6490885416666667,43.118686868686865,1027.5252525252522,32.11016414141413,0
3153,4,0,0,34,0.0,0.0,1.0,34,850,400,450,0.47058823529411764,13,4,9,382.4033822217338,0.39711452762923355,0.007859760196006427,0.22801326944342062,132008.4545741506,3296.095902203855,135304.55047635443,970,8,277.29411764705884,32,2,18,33.2626858336405,0.6494140625,43.08712121212121,1027.651515151515,32.114109848484844,0
3154,4,0,0,34,0.0,0.0,1.0,34,950,600,350,0.631578947368421,13,6,7,382.095241971314,0.3959261734997029,0.011017224569385808,0.22900410197618493,132203.1572830579,3302.8394742883397,135505.99675734623,971,9,278.29411764705884,32,2,19,33.073971761817056,0.6513671875,42.89772727272727,1028.4090909090912,32.1377840909091,0
3155,4,0,0,34,0.0,0.0,1.0,34,900,300,600,0.3333333333333333,15,3,12,382.02005860491926,0.39581476530005943,0.011195026678892939,0.22935279421181118,132268.09007052853,3305.812704060808,135573.90277458934,972,10,279.29411764705884,32,2,19,33.010361687328675,0.6520182291666667,42.83459595959596,1028.6616161616162,32.145675505050505,0
3156,4,0,0,34,0.0,0.0,1.0,34,750,300,450,0.4,12,3,9,381.75464575000115,0.3955362448009507,0.014096348401199776,0.2295997138765765,132334.9492983467,3303.8963379469365,135638.84563629364,973,11,280.29411764705884,33,1,19,32.949718119739565,0.6502525252525253,42.76960784313725,1028.9215686274504,31.179441473559102,0
3157,4,0,0,34,0.0,0.0,1.0,34,1050,800,250,0.7619047619047619,13,8,5,380.5661769558699,0.3949049316696376,0.011489816090793248,0.2296636595648561,132462.98408644518,3282.201306651135,135745.18539309633,974,12,281.29411764705884,32,2,19,32.85114886135981,0.6539713541666667,42.645202020202014,1029.4191919191912,32.169349747474726,0
3158,4,0,0,34,0.0,0.0,1.0,34,850,600,250,0.7058823529411765,11,6,5,381.50348488919224,0.3946264111705288,0.008899979805556235,0.2308265892252411,132560.4848995,3314.457389552076,135874.9422890521,975,13,282.29411764705884,32,2,19,32.72871709988555,0.6549479166666667,42.550505050505045,1029.7979797979795,32.18118686868686,0
3159,4,0,0,34,0.0,0.0,1.0,34,1150,1000,150,0.8695652173913043,13,10,3,381.79030957345606,0.3936237373737374,0.006579990486761167,0.23220361451106883,132755.59413580227,3336.959876543187,136092.55401234544,976,14,283.29411764705884,32,2,15,32.52470799640611,0.6569010416666667,42.3611111111111,1030.5555555555538,32.20486111111106,0
3160,4,0,1,33,0.0,0.029411764705882353,0.9705882352941176,34,800,500,300,0.625,11,5,6,390.9146239412407,0.3922868389780154,-0.052339785754557444,0.23288896117377866,131976.01807213554,3518.271094786254,135494.2891669218,977,15,284.29411764705884,32,2,17,33.07682067666094,0.6490885416666667,43.11868686868687,1027.5252525252529,32.11016414141415,8
3161,4,0,0,33,0.0,0.0,1.0,33,800,400,400,0.5,12,4,8,394.79626858337053,0.38592960858585856,-0.02874046431629096,0.23553491669905857,132029.7431945802,3824.9699910481904,135854.71318562838,978,30,293.45454545454544,31,2,17,32.92276384137843,0.6522177419354839,43.06640625000001,1027.734375000001,33.15272177419358,0
3162,4,0,0,33,0.0,0.0,1.0,33,1400,1000,400,0.7142857142857143,18,10,8,399.31191570723706,0.38533775252525254,-0.026381822785976006,0.23928418135476176,132197.07065158428,3957.5731065538234,136154.6437581381,979,31,294.45454545454544,31,2,17,32.63748206296952,0.6538978494623655,42.903645833333336,1028.3854166666672,33.17372311827959,0
3163,4,0,0,33,0.0,0.0,1.0,33,850,600,250,0.7058823529411765,11,6,5,398.9361706388036,0.3851010101010101,-0.025458994450261452,0.2396954132484554,132297.51798841692,3955.65304226346,136253.1710306804,980,32,295.45454545454544,31,2,18,32.54559022064716,0.6549059139784946,42.805989583333336,1028.776041666667,33.18632392473119,0
3164,4,0,0,33,0.0,0.0,1.0,33,750,500,250,0.6666666666666666,10,5,5,397.4823386713434,0.3849431818181818,-0.02527297264139383,0.2394588723215166,132398.0034722222,3925.2117580837576,136323.21523030594,981,33,296.45454545454544,30,3,19,32.48144399460188,0.6586805555555555,42.70833333333333,1029.1666666666663,34.30555555555554,0
3165,4,0,1,32,0.0,0.030303030303030304,0.9696969696969697,33,650,500,150,0.7692307692307693,8,5,3,396.6623264184771,0.3843118686868687,-0.02504945011472426,0.23962408677961625,132501.77043588847,3911.6921031332995,136413.46253902177,982,34,297.45454545454544,30,3,20,32.39773716275021,0.6597222222222222,42.607526881720425,1029.5698924731178,34.31899641577059,0
3166,4,0,0,32,0.0,0.0,1.0,32,700,600,100,0.8571428571428571,8,6,2,397.3815708613542,0.38260248655913975,0.004183520354905879,0.24094401575011215,132640.18961729674,4141.753381893853,136781.9429991906,983,35,305.84375,30,2,18,32.23947459986081,0.6611111111111111,42.47311827956989,1030.10752688172,34.336917562724004,0
3167,4,0,0,32,0.0,0.0,1.0,32,650,300,350,0.46153846153846156,10,3,7,397.31510984429525,0.38176243279569894,0.000216023216381922,0.2415713677380023,132744.05142574277,4148.243474679144,136892.29490042193,984,36,306.84375,30,2,18,32.13637450545628,0.6621527777777778,42.372311827956985,1030.5107526881714,34.350358422939046,0
3168,4,0,0,32,0.0,0.0,1.0,32,1400,1200,200,0.8571428571428571,16,12,4,399.1109811674196,0.3811953965053763,-0.005769230769230527,0.24333714034611345,132847.95388195157,4204.215443981952,137052.16932593353,985,37,307.84375,30,2,18,31.98527813993916,0.6631944444444444,42.27150537634408,1030.9139784946228,34.363799283154094,0
3169,4,0,0,32,0.0,0.0,1.0,32,650,500,150,0.7692307692307693,8,5,3,399.1109811674196,0.3811953965053763,-0.005769230769230527,0.24333714034611345,132847.95388195157,4204.215443981952,137052.16932593353,986,38,308.84375,30,2,18,31.98527813993916,0.6631944444444444,42.27150537634408,1030.9139784946228,34.363799283154094,0
3170,4,0,0,32,0.0,0.0,1.0,32,600,400,200,0.6666666666666666,8,4,4,401.1325431916872,0.38058635752688175,-0.007709663756027441,0.24525019951472615,132951.8969859231,4266.266512024499,137218.1634979476,987,39,309.84375,30,2,18,31.82832659976542,0.6642361111111111,42.17069892473118,1031.3172043010743,34.37724014336914,0
3171,4,0,0,32,0.0,0.0,1.0,32,600,300,300,0.5,9,3,6,400.4434685535419,0.38058635752688175,-0.006872068785825913,0.24551150675854527,133055.88073765746,4256.271678806786,137312.15241646423,988,40,310.84375,30,2,18,31.741249782873023,0.6652777777777779,42.06989247311827,1031.7204301075262,34.390681003584206,0
3172,4,0,0,32,0.0,0.0,1.0,32,600,500,100,0.8333333333333334,7,5,2,404.386073178164,0.380838373655914,-0.004631740036468157,0.24839010158895533,133125.22582090416,4366.797462134345,137492.0232830385,989,41,311.84375,30,2,18,31.569636189980024,0.6659722222222222,42.00268817204301,1031.989247311828,34.39964157706093,0
3173,4,0,0,32,0.0,0.0,1.0,32,700,400,300,0.5714285714285714,10,4,6,402.55510713364174,0.38062836021505375,-0.002534663455279418,0.24795715941407412,133229.2773189098,4326.425200890285,137555.70251980008,990,42,312.84375,30,2,18,31.51201015492774,0.6670138888888889,41.90188172043011,1032.3924731182801,34.413082437276,0
3174,4,0,1,31,0.0,0.03125,0.96875,32,750,300,450,0.4,12,3,9,401.60588427693466,0.379872311827957,6.50702758977495e-05,0.24806588543279462,133333.36946467796,4309.493149497046,137642.862614175,991,43,313.84375,30,2,19,31.431654520215158,0.6680555555555556,41.8010752688172,1032.795698924731,34.42652329749103,0
3175,4,0,0,31,0.0,0.0,1.0,31,1150,900,250,0.782608695652174,14,9,5,400.62434963579625,0.3761648745519713,0.026534859521332166,0.2483870967741935,133472.22222222216,4494.44444444444,137966.6666666666,992,44,323.16129032258067,29,2,19,31.31720430107527,0.6724137931034483,41.666666666666664,1033.333333333333,35.63218390804597,0
3176,4,0,0,31,0.0,0.0,1.0,31,900,700,200,0.7777777777777778,11,7,4,400.1007176811008,0.37598566308243725,0.02809316293447317,0.248761084857344,133576.40921277023,4488.803438258752,138065.212651029,993,45,324.16129032258067,30,1,19,31.225891734928272,0.6704861111111111,41.56586021505376,1033.7365591397847,34.45788530465949,0
3177,4,0,0,31,0.0,0.0,1.0,31,950,800,150,0.8421052631578947,11,8,3,400.41962290533013,0.3753136200716846,0.02765575749446758,0.25013225794475796,133750.14452537854,4511.236486877083,138261.38101225562,994,46,325.16129032258067,30,1,18,31.042911902286907,0.6722222222222223,41.397849462365585,1034.4086021505366,34.48028673835122,0
3178,4,0,0,31,0.0,0.0,1.0,31,850,700,150,0.8235294117647058,10,7,3,398.6650201154453,0.37473118279569895,0.02635449094771425,0.24974141496084742,133854.4399099607,4472.616595849232,138327.05650580992,995,47,326.16129032258067,30,1,18,30.98346105554833,0.6732638888888889,41.29704301075269,1034.8118279569894,34.493727598566316,0
3179,4,0,0,31,0.0,0.0,1.0,31,600,400,200,0.6666666666666666,8,4,4,398.52306200576913,0.3742383512544803,0.029036865761044917,0.250124376569391,133923.99274843908,4474.35993322927,138398.35268166836,996,48,327.16129032258067,30,1,18,30.91725100636281,0.6739583333333333,41.229838709677416,1035.08064516129,34.502688172043,0
3180,4,0,0,31,0.0,0.0,1.0,31,850,500,350,0.5882352941176471,12,5,7,399.40793789645863,0.3739695340501792,0.025833256548361883,0.2509167975267964,133958.77594230548,4500.839692449993,138459.61563475546,997,49,328.16129032258067,30,1,18,30.859408811564105,0.6743055555555555,41.196236559139784,1035.215053763441,34.507168458781365,0
3181,4,0,0,31,0.0,0.0,1.0,31,800,400,400,0.5,12,4,8,398.6619704673075,0.3738351254480287,0.023928674626140456,0.25068515579670775,133993.56365258986,4483.627623135611,138477.19127572546,998,50,329.16129032258067,30,1,18,30.843772988878783,0.6746527777777778,41.162634408602145,1035.349462365591,34.5116487455197,0
3182,4,0,0,31,0.0,0.0,1.0,31,800,500,300,0.625,11,5,6,399.72880567958384,0.3737455197132617,0.024793284628749523,0.25183241600663886,134063.15262241298,4517.780776679383,138580.93339909235,999,51,330.16129032258067,30,1,19,30.74626865671642,0.6753472222222222,41.09543010752688,1035.6182795698924,34.520609318996414,0
3183,4,0,0,31,0.0,0.0,1.0,31,700,400,300,0.5714285714285714,10,4,6,399.72880567958384,0.3737455197132617,0.024793284628749523,0.25183241600663886,134063.15262241298,4517.780776679383,138580.93339909235,1000,52,331.16129032258067,30,1,19,30.74626865671642,0.6753472222222222,41.09543010752688,1035.6182795698924,34.520609318996414,0
3184,4,0,0,31,0.0,0.0,1.0,31,1000,700,300,0.7,13,7,6,398.6457865456791,0.37275985663082434,0.02513702355549996,0.2523447466557624,134237.20408428722,4502.619161174707,138739.82324546194,1001,53,332.16129032258067,30,1,19,30.599600086467795,0.6770833333333333,40.92741935483871,1036.2903225806454,34.543010752688176,0
3185,4,1,0,32,0.03125,0.0,1.0,32,950,400,550,0.42105263157894735,15,4,11,390.61641592939816,0.37896925403225806,-0.007665094339622591,0.23002966715842327,131534.8595213319,3883.1613481327304,135418.02086946464,1002,0,322.75,30,2,22,33.53096610761706,0.65,43.54838709677419,1025.806451612903,34.19354838709676,8
3186,4,0,0,32,0.0,0.0,1.0,32,650,300,350,0.46153846153846156,10,3,7,389.97078071852775,0.37913726478494625,-0.009963649462928714,0.2300646785166338,131603.80715978728,3864.327884726564,135468.13504451385,1003,1,323.75,30,2,19,33.47769845428348,0.6506944444444445,43.48118279569893,1026.0752688172045,34.20250896057348,0
3187,4,0,0,32,0.0,0.0,1.0,32,950,600,350,0.631578947368421,13,6,7,390.9505778759024,0.37899025537634407,-0.013396365422396972,0.23085132730723232,131638.287753642,3892.812933576133,135531.10068721813,1004,2,324.75,30,2,19,33.41764898493778,0.6510416666666667,43.44758064516129,1026.2096774193546,34.206989247311824,0
3188,4,0,0,32,0.0,0.0,1.0,32,800,600,200,0.75,10,6,4,393.04295386639626,0.37863323252688175,-0.006961714659685869,0.23314038567851458,131810.75846918722,3961.45797201989,135772.2164412071,1005,3,325.75,30,2,20,33.1893542757417,0.6527777777777778,43.27956989247312,1026.8817204301076,34.229390681003586,0
3189,4,0,1,31,0.0,0.03125,0.96875,32,800,700,100,0.875,9,7,2,393.2091697550712,0.37850722446236557,-0.012046911803193172,0.23366286743921125,131879.77837033191,3971.267632096209,135851.04600242813,1006,4,326.75,30,2,21,33.11524033848033,0.6534722222222222,43.212365591397855,1027.1505376344094,34.238351254480314,0
3190,4,0,0,31,0.0,0.0,1.0,31,700,300,400,0.42857142857142855,11,3,8,396.21668365349234,0.3741935483870968,0.020921322750630855,0.2366747115189264,132076.58420138893,4266.189236111118,136342.77343750006,1007,5,336.03225806451616,29,2,22,32.838890014862855,0.6584051724137931,43.020833333333336,1027.916666666667,35.44540229885059,0
3191,4,1,0,32,0.03125,0.0,1.0,32,900,500,400,0.5555555555555556,13,5,8,386.07679936507407,0.38043934811827956,0.019473100026116574,0.23280127004234163,132432.58794369298,3825.8299369869433,136258.41788067992,1008,0,326.5,30,2,23,32.73999956472535,0.6590277777777778,42.6747311827957,1029.3010752688178,34.31003584229393,0
3192,4,0,0,32,0.0,0.0,1.0,32,950,500,450,0.5263157894736842,14,5,9,385.478719408112,0.37999831989247307,0.020853734168951643,0.2326541774583712,132467.17693158166,3812.655545438777,136279.83247702045,1009,1,327.5,30,2,24,32.720492231361796,0.659375,42.641129032258064,1029.4354838709676,34.31451612903225,0
3193,4,0,0,32,0.0,0.0,1.0,32,750,600,150,0.8,9,6,3,385.19759491168367,0.37995631720430106,0.022234007832898195,0.23269823162645883,132501.77043588858,3807.872658688869,136309.64309457745,1010,2,328.5,30,2,24,32.69283072236727,0.6597222222222222,42.60752688172043,1029.5698924731187,34.31899641577062,0
3194,4,0,0,32,0.0,0.0,1.0,32,850,600,250,0.7058823529411765,11,6,5,386.5430907107422,0.3795572916666667,0.02589006004438077,0.23372585776913957,132536.36845661353,3846.203498959425,136382.57195557296,1011,3,329.5,30,2,24,32.62329765478834,0.6600694444444444,42.5739247311828,1029.704301075269,34.32347670250897,0
3195,4,0,0,32,0.0,0.0,1.0,32,950,600,350,0.631578947368421,13,6,7,390.17330833002507,0.37800319220430106,0.025843933463796542,0.23679163961596514,132674.80570369403,3953.2335746907115,136628.03927838473,1012,4,330.5,30,2,16,32.3901935203305,0.6614583333333333,42.439516129032256,1030.2419354838707,34.34139784946236,0
3196,4,0,0,32,0.0,0.0,1.0,32,950,900,50,0.9473684210526315,10,9,1,389.09916734900025,0.37752016129032256,0.030989175795513857,0.2367946361295344,132778.68106139434,3932.8148485373986,136711.49590993175,1013,5,331.5,30,2,19,32.31313032516084,0.6625,42.33870967741935,1030.6451612903222,34.35483870967741,0
3197,4,1,1,32,0.030303030303030304,0.030303030303030304,0.9696969696969697,33,550,400,150,0.7272727272727273,7,4,3,380.5961244978381,0.38202335858585856,0.04957599478147445,0.2343188188173438,133211.4069992859,3539.949048566483,136751.35604785237,1014,0,322.42424242424244,32,1,20,32.09673638290934,0.6614583333333333,41.919191919191924,1032.323232323233,32.26010101010103,0
3198,4,0,0,32,0.0,0.0,1.0,32,1150,800,350,0.6956521739130435,15,8,7,389.6929072041923,0.3746849798387097,0.05893668012108999,0.2398668764219592,133203.26063368045,3981.673177083325,137184.93381076376,1015,1,333.3125,31,1,20,31.870164816683495,0.663978494623656,41.92708333333333,1032.2916666666658,33.299731182795675,0
3199,4,0,1,31,0.0,0.03125,0.96875,32,700,400,300,0.5714285714285714,10,4,6,391.22069636786705,0.3747059811827957,0.05846812334468399,0.24102477867139233,133236.86599731448,4025.0038994683155,137261.8698967828,1016,2,334.3125,31,1,20,31.796911127927007,0.6643145161290323,41.89453125,1032.4218750000002,33.30393145161291,0
3200,4,0,0,31,0.0,0.0,1.0,31,1200,900,300,0.75,15,9,6,395.5187356420612,0.3717293906810036,0.08196948391294301,0.24453431081329347,133368.0758794368,4349.914549369853,137717.99042880666,1017,3,341.0,30,1,20,31.55389286488832,0.6684027777777778,41.76747311827956,1032.9301075268806,34.43100358422935,0
3201,4,0,0,31,0.0,0.0,1.0,31,650,500,150,0.7692307692307693,8,5,3,391.77834058433854,0.3717741935483871,0.08021922223108113,0.24267527027170108,133437.50225820908,4255.584641288018,137693.08689949708,1018,4,342.0,30,1,20,31.580644811586666,0.6690972222222222,41.700268817204304,1033.198924731183,34.4399641577061,0
3202,4,0,0,31,0.0,0.0,1.0,31,1000,800,200,0.8,12,8,4,390.96896819370886,0.371236559139785,0.08305717521708122,0.2428555222463346,133541.67569950287,4242.130231818712,137783.80593132158,1019,5,343.0,30,1,20,31.496803207628965,0.6701388888888888,41.5994623655914,1033.6021505376348,34.453405017921156,0
3203,4,0,0,31,0.0,0.0,1.0,31,650,500,150,0.7692307692307693,8,5,3,394.578507721699,0.37002688172043013,0.08508818992689982,0.24648345742095745,133750.14452537868,4354.986486877096,138105.13101225576,1020,6,344.0,30,1,17,31.19396439708939,0.6722222222222223,41.39784946236559,1034.4086021505377,34.48028673835126,0
3204,4,0,0,31,0.0,0.0,1.0,31,700,600,100,0.8571428571428571,8,6,2,393.8547672695704,0.3698476702508961,0.0895750048190147,0.24649544702773607,133819.67026534857,4341.103017689903,138160.77328303846,1021,7,345.0,30,1,17,31.14282930631333,0.6729166666666666,41.33064516129032,1034.6774193548385,34.48924731182795,0
3205,4,0,0,31,0.0,0.0,1.0,31,800,500,300,0.625,11,5,6,392.0413589312043,0.36935483870967745,0.08799024843861925,0.24605627588665063,133923.99274843908,4300.748822118157,138224.74157055723,1022,8,346.0,30,1,18,31.084978141366925,0.6739583333333333,41.229838709677416,1035.08064516129,34.502688172043,0
3206,4,0,0,31,0.0,0.0,1.0,31,800,500,300,0.625,11,5,6,387.8667768709111,0.36944444444444446,0.07913777509798026,0.24412791250110294,134028.35587929236,4197.029280841709,138225.38516013406,1023,9,347.0,30,1,19,31.088287469712704,0.675,41.12903225806451,1035.4838709677415,34.51612903225805,0
3207,4,0,0,31,0.0,0.0,1.0,31,1100,900,200,0.8181818181818182,13,9,4,388.4553125821107,0.3699372759856631,0.08326741085816436,0.2451945203988799,134132.75965790826,4220.916616082761,138353.67627399103,1024,10,348.0,30,1,19,30.96832965702176,0.6760416666666667,41.0282258064516,1035.887096774192,34.52956989247307,0
3208,4,0,0,31,0.0,0.0,1.0,31,850,500,350,0.5882352941176471,12,5,7,388.64634661525486,0.37051971326164873,0.10388497507518646,0.21955994906186488,129930.49621582041,3899.402533637168,133829.89874945758,1025,11,349.0,31,0,19,35.21126011068541,0.6310483870967742,45.11718750000001,1019.5312500000008,32.8881048387097,8
3209,4,0,0,31,0.0,0.0,1.0,31,700,600,100,0.8571428571428571,8,6,2,401.3360651503937,0.37011648745519715,0.1421496452951414,0.20579147170477594,126043.83680555529,3925.088161892322,129968.9249674476,1026,12,350.0,29,2,20,38.88312586445367,0.5969827586206897,48.958333333333314,1004.1666666666645,34.62643678160912,8
3210,4,1,0,32,0.03125,0.0,1.0,32,700,600,100,0.8571428571428571,8,6,2,385.35675665524593,0.37558803763440857,0.087910205854832,0.19922970950503777,126381.48422144187,3340.391772170201,129721.87599361208,1027,0,340.03125,30,2,17,38.93530276700976,0.5975694444444444,48.62231182795699,1005.5107526881727,33.51702508960576,8
3211,4,1,0,33,0.030303030303030304,0.0,1.0,33,1100,700,400,0.6363636363636364,15,7,8,376.21700972795884,0.3797743055555556,0.08489705116304536,0.19680804626539683,126862.3542785645,2945.555114746096,129807.90939331059,1028,0,330.6969696969697,31,2,20,38.66930011632414,0.5997983870967742,48.14453125,1007.4218750000003,32.49747983870969,0
3212,4,2,1,34,0.05714285714285714,0.02857142857142857,0.9714285714285714,35,750,300,450,0.4,12,3,9,358.7744227146746,0.38848039215686275,0.07921904530716262,0.19033757042795932,127432.05925905916,2143.872699202243,129575.9319582614,1029,0,312.74285714285713,33,2,15,38.523460573694194,0.6006944444444444,47.579656862745104,1009.6813725490208,30.596405228758208,0
3213,4,2,1,35,0.05555555555555555,0.027777777777777776,0.9722222222222222,36,1250,1000,250,0.8,15,10,5,350.7208776213731,0.3909722222222222,0.08226747227453468,0.18811392526964563,127873.46938775515,1769.5790816326594,129643.04846938781,1030,0,305.0,34,2,17,38.27462923728813,0.6029411764705883,47.142857142857146,1011.4285714285718,29.747899159663877,0
3214,4,2,0,37,0.05405405405405406,0.0,1.0,37,400,200,200,0.5,6,2,4,342.2581246083761,0.39861736736736736,0.08697586475364272,0.18481938728852318,128144.53125000012,1371.7013888889032,129516.23263888902,1031,0,297.64864864864865,35,2,19,38.211591220850494,0.6035714285714286,46.87500000000001,1012.5000000000009,28.928571428571455,0
3215,4,1,1,37,0.02631578947368421,0.02631578947368421,0.9736842105263158,38,450,400,50,0.8888888888888888,5,4,1,332.32401701702923,0.40303461356092934,0.08119779655882309,0.18054080133158704,128385.71605725621,933.1313775510152,129318.84743480723,1032,0,290.7894736842105,34,4,15,38.217040604565554,0.6081495098039216,46.63690476190476,1013.4523809523807,29.80742296918767,0
3216,4,1,1,37,0.02631578947368421,0.02631578947368421,0.9736842105263158,38,800,600,200,0.75,10,6,4,331.9489686977567,0.4023530109056425,0.07476663583176157,0.18110441243647216,128555.01570001707,934.7409765089105,129489.75667652598,1033,0,291.7631578947368,35,3,16,38.05400213041163,0.6077380952380953,46.469907407407405,1014.1203703703698,28.974867724867707,0
3217,4,2,2,37,0.05128205128205128,0.05128205128205128,0.9487179487179487,39,650,400,250,0.6153846153846154,9,4,5,327.69895407556413,0.4074730094466936,0.09333208269024706,0.18080564310187552,129001.10995708554,654.7057615047588,129655.8157185903,1034,0,280.1025641025641,36,3,18,37.70784835384103,0.6102430555555556,46.03040540540541,1015.878378378379,28.21884384384386,0
3218,4,0,0,37,0.0,0.0,1.0,37,750,500,250,0.6666666666666666,10,5,5,344.8751872043295,0.4004316816816817,0.0963384783187693,0.18892776964843835,128717.71541950094,1478.3092403627854,130196.02465986372,1035,1,296.05405405405406,34,3,18,37.56036876270919,0.6115196078431373,46.309523809523796,1014.7619047619031,29.84593837535009,0
3219,4,3,1,39,0.075,0.025,0.975,40,800,500,300,0.625,11,5,6,321.87964838209905,0.411338141025641,0.09484504703929231,0.1794067009952044,129401.82317029864,331.269697890113,129733.09286818875,1036,0,274.775,36,4,21,37.448810182623134,0.6142939814814814,45.63626126126126,1017.4549549549547,28.26263763763763,0
3220,4,0,3,36,0.0,0.07692307692307693,0.9230769230769231,39,750,400,350,0.5333333333333333,11,4,7,333.42789924919595,0.41042510121457493,0.08379165588669735,0.17795048913606495,127673.1316967722,713.9568184441451,128387.08851521634,1037,1,282.64102564102564,37,2,17,38.91665310477016,0.5948761261261262,47.34100877192983,1010.6359649122817,27.314485538169777,8
3221,4,0,1,35,0.0,0.027777777777777776,0.9722222222222222,36,900,600,300,0.6666666666666666,12,6,6,352.2721679690327,0.39857804232804234,0.09268653977242947,0.18615080397166572,127272.13718820843,1766.8863378684575,129039.0235260769,1038,4,307.1111111111111,34,2,21,38.85161042944784,0.5968137254901961,47.73809523809523,1009.0476190476177,29.677871148459342,0
3222,4,0,0,35,0.0,0.0,1.0,35,950,800,150,0.8421052631578947,11,8,3,356.6257823412582,0.39457282913165265,0.0978758850478969,0.18818868206623304,127215.61418685112,2073.6735870818825,129289.287773933,1039,5,316.74285714285713,33,2,21,38.799805636540334,0.5984848484848485,47.79411764705882,1008.823529411764,30.570409982174667,0
3223,4,0,1,34,0.0,0.02857142857142857,0.9714285714285714,35,1300,1100,200,0.8461538461538461,15,11,4,357.2347652932046,0.3954131652661064,0.09917435648373019,0.18908647345468066,127339.27455786224,2098.003171856964,129437.27772971921,1040,6,317.74285714285713,33,2,19,38.65751983163347,0.5997474747474747,47.671568627450974,1009.3137254901951,30.58526440879379,0
3224,4,1,0,35,0.02857142857142857,0.0,1.0,35,1150,900,250,0.782608695652174,14,9,5,356.12711233924995,0.3957282913165266,0.10627393225331372,0.18980401042256692,127617.73003472191,2089.626736111072,129707.35677083298,1041,0,318.45714285714286,33,2,21,38.39991408934707,0.6025883838383839,47.395833333333314,1010.4166666666641,30.61868686868679,0
3225,4,1,0,36,0.027777777777777776,0.0,1.0,36,950,800,150,0.8421052631578947,11,8,3,346.8400792038578,0.40128968253968256,0.10689720554967153,0.18617183531239234,127903.57320011302,1672.4170918366963,129575.99029194973,1042,0,310.5833333333333,34,2,22,38.34196383037151,0.6032475490196079,47.11309523809522,1011.5476190476161,29.751400560224003,0
3226,4,0,0,36,0.0,0.0,1.0,36,1200,700,500,0.5833333333333334,17,7,10,346.4268389394125,0.39999999999999997,0.11300260038940557,0.18678930954355233,128084.27047902471,1674.3657879818315,129758.63626700654,1043,1,311.5833333333333,34,2,22,38.167656513387435,0.6050857843137255,46.934523809523796,1012.2619047619029,29.772408963585377,0
3227,4,0,0,36,0.0,0.0,1.0,36,1250,1100,150,0.88,14,11,3,347.9531640233955,0.4002314814814815,0.10753277960612251,0.18831968953632622,128234.94897959183,1723.9512471655303,129958.90022675737,1044,2,312.5833333333333,34,2,22,37.97504309669329,0.6066176470588236,46.785714285714285,1012.8571428571428,29.789915966386552,0
3228,4,0,0,36,0.0,0.0,1.0,36,650,300,350,0.46153846153846156,10,3,7,347.00995666192716,0.4003472222222222,0.10378879878821112,0.18795084158092537,128265.09530895691,1701.8530328798156,129966.94834183673,1045,3,313.5833333333333,34,2,22,37.9681317820347,0.6069240196078431,46.75595238095238,1012.9761904761904,29.793417366946777,0
3229,4,0,0,36,0.0,0.0,1.0,36,800,500,300,0.625,11,5,6,349.22729064850614,0.40067791005291004,0.09681598078755371,0.189723798678413,128385.71605725618,1767.1591553287915,130152.87521258497,1046,4,314.5833333333333,34,2,16,37.78877403187282,0.6081495098039216,46.63690476190476,1013.4523809523805,29.807422969187662,0
3230,4,1,0,37,0.02702702702702703,0.0,1.0,37,1000,600,400,0.6,14,6,8,345.90615734814264,0.40287162162162166,0.10697453779286525,0.1904002901237516,128907.38195516099,1517.971429183794,130425.35338434478,1047,0,307.05405405405406,35,2,18,37.340912544639465,0.6113095238095239,46.122685185185176,1015.5092592592576,29.01455026455022,0
3231,4,1,1,37,0.02631578947368421,0.02631578947368421,0.9736842105263158,38,1250,1000,250,0.8,15,10,5,340.13106435459076,0.40562766714082504,0.12023332245582896,0.18916648850065665,129315.90374157942,1196.8711955198437,130512.77493709925,1048,0,299.94736842105266,36,2,21,37.071892530262765,0.6134259259259259,45.72072072072072,1017.1171171171171,28.253253253253252,0
3232,4,0,1,36,0.0,0.02702702702702703,0.972972972972973,37,1150,900,250,0.782608695652174,14,9,5,349.0036945456083,0.4002127127127127,0.11590921675146548,0.19382720987849011,129260.23046339162,1622.4595979080918,130882.69006129971,1049,1,308.8918918918919,35,2,22,36.90293269595569,0.6148809523809524,45.77546296296296,1016.898148148148,29.0542328042328,0
3233,4,0,0,36,0.0,0.0,1.0,36,1050,900,150,0.8571428571428571,12,9,3,356.75893576995395,0.3956018518518518,0.12067395264116554,0.19783904619970194,129201.38888888896,2018.750000000005,131220.13888888896,1050,2,318.25,34,2,23,36.765710382513646,0.616421568627451,45.833333333333336,1016.6666666666673,29.901960784313744,0
3234,4,1,0,37,0.02702702702702703,0.0,1.0,37,650,400,250,0.6153846153846154,9,4,5,347.8976794725152,0.4007444944944945,0.1265215186761519,0.1945174883001127,129525.18332315247,1612.3021422753798,131137.48546542783,1051,0,310.6216216216216,35,2,18,36.66157381087738,0.6175595238095238,45.5150462962963,1017.9398148148151,29.08399470899472,0
3235,4,0,1,36,0.0,0.02702702702702703,0.972972972972973,37,1500,1100,400,0.7333333333333333,19,11,8,346.7325304846452,0.4008383383383383,0.12356089756385136,0.19474109768955725,129701.96926708249,1594.37840256344,131296.34766964594,1052,1,311.6216216216216,35,2,18,36.511594326402296,0.6193452380952381,45.34143518518518,1018.6342592592594,29.10383597883598,0
3236,4,0,0,36,0.0,0.0,1.0,36,850,600,250,0.7058823529411765,11,6,5,346.2293076454289,0.4002314814814815,0.11285530449263881,0.1953389822186606,129878.87577428416,1793.5746474194139,131672.45042170357,1053,2,307.72222222222223,35,1,20,36.34478729041293,0.6211309523809524,45.167824074074076,1019.3287037037039,29.123677248677254,0
3237,4,0,1,35,0.0,0.027777777777777776,0.9722222222222222,36,750,400,350,0.5333333333333333,11,4,7,349.1030964897368,0.399702380952381,0.11511900707609657,0.19725780480937075,129937.8714018561,1872.3426515346341,131810.21405339072,1054,3,308.72222222222223,35,1,20,36.211663261058774,0.6217261904761905,45.1099537037037,1019.5601851851849,29.130291005290996,0
3238,4,0,0,35,0.0,0.0,1.0,35,950,600,350,0.631578947368421,13,6,7,354.68954313516804,0.3995798319327731,0.11712117421399393,0.20052250408928812,129958.94451530614,2219.0157312925185,132177.96024659867,1055,4,314.8285714285714,34,1,21,36.047869235259775,0.6240808823529411,45.089285714285715,1019.6428571428573,29.989495798319332,0
3239,4,0,0,35,0.0,0.0,1.0,35,300,0,300,0.0,6,0,6,355.3681716916334,0.39929971988795515,0.11991528956627628,0.2012187129466108,130019.64462868468,2240.9686791383074,132260.613307823,1056,5,315.8285714285714,34,1,21,35.96893116999339,0.6246936274509804,45.0297619047619,1019.8809523809514,29.996498599439747,0
3240,4,0,0,35,0.0,0.0,1.0,35,850,600,250,0.7058823529411765,11,6,5,357.27281249917905,0.3991596638655462,0.12059936330149879,0.2029281163638478,130141.08737244896,2299.1744614512454,132440.2618339002,1057,6,316.8285714285714,34,1,23,35.797067631159344,0.6259191176470589,44.910714285714285,1020.3571428571427,30.010504201680668,0
3241,4,0,0,35,0.0,0.0,1.0,35,1450,1200,250,0.8275862068965517,17,12,5,358.6874427992973,0.39919467787114843,0.11844180783211056,0.20469751872628383,130325.14537677812,2349.2553148710404,132674.40069164915,1058,7,317.8285714285714,33,2,23,35.5741918706993,0.630050505050505,44.73039215686274,1021.0784313725486,30.941770647652987,0
3242,4,1,0,36,0.027777777777777776,0.0,1.0,36,700,400,300,0.5714285714285714,10,4,6,353.55384911431713,0.40302579365079366,0.12996076656103828,0.20391656728290503,130735.62349965706,2044.4165809327822,132780.04008058982,1059,0,309.97222222222223,35,1,19,35.289346612343444,0.6297619047619047,44.3287037037037,1022.6851851851851,29.219576719576718,0
3243,4,1,0,37,0.02702702702702703,0.0,1.0,37,950,600,350,0.631578947368421,13,6,7,346.8184345815149,0.4049674674674675,0.13343479863497465,0.20161593396516198,131039.71370018662,1689.3976747017205,132729.11137488834,1060,0,302.56756756756755,36,1,21,35.154073177885316,0.630787037037037,44.03153153153153,1023.8738738738734,28.44094094094093,0
3244,4,1,0,38,0.02631578947368421,0.0,1.0,38,900,600,300,0.6666666666666666,12,6,6,341.3973164121886,0.4069316026552869,0.13607188703466,0.19996128532713892,131328.12499999985,1367.6479689148453,132695.7729689147,1061,0,295.57894736842104,35,3,23,35.001693766937684,0.6357142857142857,43.74999999999999,1024.9999999999989,29.285714285714253,0
3245,4,0,0,38,0.0,0.0,1.0,38,1000,800,200,0.8,12,8,4,338.51638478675807,0.40676861071597914,0.12827863641092607,0.19887291612053018,131443.5782911289,1299.160985309628,132742.73927643854,1062,1,296.57894736842104,36,2,23,34.95909290577641,0.634837962962963,43.637387387387385,1025.45045045045,28.484734734734722,0
3246,4,0,0,38,0.0,0.0,1.0,38,750,600,150,0.8,9,6,3,336.23019933548596,0.40694642010431487,0.12641369298808303,0.19780486066566877,131496.7646295012,1242.6366766697272,132739.40130617094,1063,2,297.57894736842104,37,1,23,34.9640973558549,0.6334459459459459,43.585526315789465,1025.6578947368407,27.720483641536237,0
3247,4,0,0,38,0.0,0.0,1.0,38,700,400,300,0.5714285714285714,10,4,6,336.76906600819683,0.40710941204362255,0.12662240850656858,0.1982677540910434,131524.881754482,1258.7023170590794,132783.58407154106,1064,3,298.57894736842104,37,1,23,34.9219445929093,0.6337274774774775,43.55811403508771,1025.767543859648,27.723447131341835,0
3248,4,0,1,37,0.0,0.02631578947368421,0.9736842105263158,38,700,300,400,0.42857142857142855,11,3,8,333.64648304335753,0.4066204362256994,0.08831988891827569,0.18970185750179477,130180.80210387909,1086.873356344519,131267.6754602236,1065,4,299.57894736842104,38,0,20,36.35953203517588,0.618421052631579,44.871794871794876,1020.512820512821,26.85560053981108,8
3249,4,0,0,37,0.0,0.0,1.0,37,1200,800,400,0.6666666666666666,16,8,8,340.6913785922532,0.4048736236236236,0.106122448979592,0.19411485524442346,130262.58680555562,1475.8680555555648,131738.45486111118,1066,6,308.56756756756755,37,0,20,36.09693877551021,0.6210585585585586,44.79166666666667,1020.8333333333339,27.590090090090108,0
3250,4,0,0,37,0.0,0.0,1.0,37,750,700,50,0.9333333333333333,8,7,1,340.7746425155064,0.4048110610610611,0.1096879387383407,0.19444957103134677,130320.07250071033,1481.9552238048996,131802.02772451524,1067,7,309.56756756756755,36,1,20,36.03658872835556,0.6235532407407407,44.73536036036037,1021.0585585585599,28.362737737737774,0
3251,4,1,0,38,0.02631578947368421,0.0,1.0,38,1100,700,400,0.6363636363636364,15,7,8,362.8506417094339,0.40878378378378377,0.1770671572257927,0.20549099323544553,130026.38996056248,1923.9311508705996,131950.32111143306,1068,0,302.39473684210526,35,3,21,35.77129671659858,0.6226190476190476,45.02314814814815,1019.907407407408,29.140211640211657,8
3252,4,0,0,38,0.0,0.0,1.0,38,1500,1100,400,0.7333333333333333,19,11,8,367.52634172833274,0.40890232337600757,0.18537454558478506,0.20892841747380503,130173.98787133514,1968.473910108051,132142.46178144318,1069,1,303.39473684210526,35,3,21,35.50208404219122,0.6241071428571429,44.878472222222236,1020.4861111111131,29.15674603174609,0
3253,4,0,0,38,0.0,0.0,1.0,38,850,700,150,0.8235294117647058,10,7,3,366.99795124890306,0.40890232337600757,0.18429263486328895,0.20960890526093973,130356.43029423786,1968.168851656953,132324.5991458948,1070,2,304.39473684210526,33,5,22,35.330288211528455,0.6303661616161615,44.69975490196079,1021.2009803921574,30.9454842543078,0
3254,4,0,0,38,0.0,0.0,1.0,38,650,200,450,0.3076923076923077,11,2,9,366.99795124890306,0.4087393314366998,0.18429263486328895,0.20960890526093973,130356.43029423786,1968.1085700211506,132324.538864259,1071,3,305.39473684210526,33,5,22,35.330288211528455,0.6303661616161615,44.69975490196079,1021.2009803921574,30.9454842543078,0
3255,4,0,0,38,0.0,0.0,1.0,38,900,500,400,0.5555555555555556,13,5,8,365.4398727405864,0.40853188715030825,0.17527237378646876,0.20956242495949173,130512.91120001923,1938.9243319876973,132451.83553200692,1072,4,306.39473684210526,33,5,19,35.21128168225794,0.6319444444444444,44.54656862745098,1021.8137254901961,30.9640522875817,0
3256,4,0,0,38,0.0,0.0,1.0,38,1300,900,400,0.6923076923076923,17,9,8,366.6146983323836,0.40814663347558083,0.1750718650591776,0.2108587015793824,130627.42524092973,1977.9868197278918,132605.41206065763,1073,5,307.39473684210526,34,4,20,35.065117813749474,0.6308210784313726,44.43452380952381,1022.2619047619049,30.066526610644264,0
3257,4,0,0,38,0.0,0.0,1.0,38,850,500,350,0.5882352941176471,12,5,7,365.1649621105434,0.40798364153627314,0.17187006783678682,0.2107748380255305,130765.21675936642,1950.175084662209,132715.39184402864,1074,6,308.39473684210526,35,3,21,34.96249198445928,0.6300595238095238,44.29976851851852,1022.800925925926,29.222883597883598,0
3258,4,0,0,38,0.0,0.0,1.0,38,1400,900,500,0.6428571428571429,19,9,10,365.6434832397309,0.4080280938833571,0.16540077858069746,0.21186236427298163,130913.23329260966,1973.5141246570556,132886.7474172667,1075,7,309.39473684210526,35,3,21,34.80029028123351,0.631547619047619,44.15509259259259,1023.379629629629,29.239417989417973,0
3259,4,1,1,38,0.02564102564102564,0.02564102564102564,0.9743589743589743,39,850,600,250,0.7058823529411765,11,6,5,355.052076746592,0.41034075573549256,0.16673148790097603,0.2073340047651151,131212.72243527314,1517.469919243574,132730.1923545167,1076,0,302.43589743589746,36,3,22,34.768401480178795,0.6325231481481481,43.862612612612615,1024.5495495495497,28.459709709709713,0
3260,4,0,0,38,0.0,0.0,1.0,38,950,500,450,0.5263157894736842,14,5,9,359.7755776290047,0.4079984589853011,0.16673206228040494,0.21023717417488944,131239.1643759644,1843.3292341820875,133082.49361014648,1077,1,310.6578947368421,35,3,23,34.62067943070145,0.6348214285714286,43.83680555555555,1024.652777777777,29.275793650793627,0
3261,4,0,0,38,0.0,0.0,1.0,38,800,700,100,0.875,9,7,2,359.5743274505917,0.4076872925557136,0.1681643132220796,0.21060782036391798,131328.125,1844.474585262346,133172.59958526236,1078,2,311.6578947368421,34,4,23,34.53590785907859,0.6378676470588236,43.75,1025.0,30.147058823529413,0
3262,4,0,0,38,0.0,0.0,1.0,38,1300,1000,300,0.7692307692307693,16,10,6,362.81123771827305,0.4069019677572309,0.17292316901107374,0.21369408307712648,131541.75347222228,1944.9652777777885,133486.71875000006,1079,3,312.6578947368421,34,4,23,34.237070132683456,0.6400122549019608,43.54166666666667,1025.833333333334,30.171568627451,0
3263,4,0,0,38,0.0,0.0,1.0,38,1000,500,500,0.5,15,5,10,359.5428264276279,0.4069167852062589,0.16652056149341976,0.2134016547732041,131834.36850761765,1880.020294706057,133714.3888023237,1080,4,313.6578947368421,37,1,18,34.02555342017225,0.6368243243243243,43.25657894736842,1026.9736842105258,27.7560455192034,8
3264,4,0,0,38,0.0,0.0,1.0,38,1000,700,300,0.7,13,7,6,359.9835863947946,0.4069019677572309,0.16701509935804437,0.21436298144636157,131958.55391418294,1900.582698699689,133859.13661288263,1081,5,314.6578947368421,38,0,19,33.88898998301618,0.6362390350877193,43.13568376068376,1027.4572649572651,27.038349077822765,0
3265,4,0,0,38,0.0,0.0,1.0,38,1150,900,250,0.782608695652174,14,9,5,376.46480629387275,0.40702050734945466,0.12516953729820535,0.20660803198981612,128789.87295310343,2123.646073667201,130913.51902677063,1082,6,315.6578947368421,35,3,18,36.68519574306346,0.6101190476190477,46.23842592592592,1015.0462962962953,29.00132275132272,8
3266,4,0,0,38,0.0,0.0,1.0,38,900,500,400,0.5555555555555556,13,5,8,372.52656091455236,0.4066056187766714,0.12207270032271067,0.20524233676776718,128943.91593874284,2007.0067111030023,130950.92264984584,1083,7,316.6578947368421,36,2,19,36.627767306057585,0.6096643518518519,46.086711711711715,1015.6531531531534,28.212587587587596,0
3267,4,0,0,38,0.0,0.0,1.0,38,950,400,550,0.42105263157894735,15,4,11,369.36607728658157,0.4061759127548601,0.12071077716459166,0.2039425183157613,129029.71172185703,1931.839694424161,130961.55141628119,1084,8,317.6578947368421,36,2,19,36.62043707973102,0.6105324074074074,46.002252252252255,1015.9909909909913,28.221971971971982,0
3268,4,0,0,38,0.0,0.0,1.0,38,800,500,300,0.625,11,5,6,378.15288600613553,0.40555357989568513,0.08202637466148577,0.19700972033186803,126694.89590942311,1982.0081060790726,128676.90401550218,1085,9,318.6578947368421,36,2,17,38.79311148396719,0.5868055555555556,48.31081081081082,1006.7567567567583,27.965465465465506,8
3269,4,1,0,39,0.02564102564102564,0.0,1.0,39,950,700,250,0.7368421052631579,12,7,5,373.39488713717407,0.40800719748088166,0.08901638781049193,0.19671321230591413,127148.79575521505,1695.963446554706,128844.75920176975,1086,0,311.46153846153845,36,3,18,38.44559513175525,0.5914351851851851,47.86036036036038,1008.5585585585616,28.0155155155156,0
3270,4,2,0,41,0.04878048780487805,0.0,1.0,41,950,600,350,0.631578947368421,13,6,7,356.39881370446443,0.4138719512195122,0.09392116594565914,0.19032128174872992,127696.68104383699,902.1891276041855,128598.87017144117,1087,0,297.219512195122,39,2,18,38.31214143392078,0.5916132478632479,47.31770833333334,1010.7291666666681,25.916132478632516,0
3271,4,0,0,41,0.0,0.0,1.0,41,800,400,400,0.5,12,4,8,360.94034026692583,0.4138719512195122,0.0993901810863167,0.19325140005356065,127801.98703342034,1025.7785373264123,128827.76557074676,1088,1,298.219512195122,39,2,19,38.08945863809623,0.5926816239316239,47.21354166666668,1011.1458333333351,25.926816239316285,0
3272,4,2,0,43,0.046511627906976744,0.0,1.0,43,900,600,300,0.6666666666666666,12,6,6,357.38051037851375,0.41655131044665933,0.1318880891616243,0.19452053283018453,128461.13281250015,582.8179253472351,129043.95073784738,1089,0,285.30232558139534,39,4,13,37.50513769009453,0.5993589743589743,46.56250000000001,1013.7500000000011,25.993589743589773,0
3273,4,0,0,43,0.0,0.0,1.0,43,1200,900,300,0.75,15,9,6,353.8646170291559,0.4165051679586564,0.1275144489818738,0.19356879297545554,128659.5293496761,505.61101609491647,129165.14036577102,1090,1,286.30232558139534,40,3,13,37.39169087448663,0.5997395833333333,46.36686991869919,1014.5325203252031,25.363313008130078,0
3274,4,0,0,43,0.0,0.0,1.0,43,800,500,300,0.625,11,5,6,351.8541432117376,0.4163898117386489,0.1249647570281307,0.1926533285208592,128697.58204207603,456.5554925673878,129154.13753464342,1091,2,287.30232558139534,41,2,13,37.40385868856733,0.5985772357723578,46.329365079365076,1014.6825396825391,24.74835462640339,0
3275,4,0,0,43,0.0,0.0,1.0,43,1250,900,350,0.72,16,9,7,354.2858124737931,0.41652823920265786,0.11934424739550797,0.1948476781660006,128873.80248685121,531.6319641282429,129405.43445097946,1092,3,288.30232558139534,41,2,15,37.16241247353852,0.6003556910569106,46.15575396825397,1015.3769841269841,24.7652922957801,0
3276,4,0,2,41,0.0,0.046511627906976744,0.9534883720930233,43,1000,800,200,0.8,12,8,4,357.07802283767063,0.41608988556662974,0.11584748111231757,0.19675806231496623,128949.36244173598,608.9966773746581,129558.35911911064,1093,4,289.30232558139534,41,2,15,37.014472227648625,0.6011178861788617,46.08134920634921,1015.6746031746035,24.772551296941547,0
3277,4,0,0,41,0.0,0.0,1.0,41,1250,900,350,0.72,16,9,7,370.7163854935895,0.41097560975609754,0.1102298367797454,0.20344589331373472,128788.44024720739,1348.7970123603704,130137.23725956776,1094,5,304.1219512195122,40,1,16,36.83253237217995,0.6010416666666667,46.239837398373986,1015.0406504065044,25.376016260162608,0
3278,4,0,1,40,0.0,0.024390243902439025,0.975609756097561,41,600,400,200,0.6666666666666666,8,4,4,364.55846021893575,0.4111280487804878,0.10495713644086013,0.2005874523407272,128891.61544054467,1197.705772027236,130089.32121257191,1095,6,305.1219512195122,40,1,16,36.88346510541768,0.6020833333333333,46.13821138211382,1015.4471544715449,25.386178861788622,0
3279,4,0,0,40,0.0,0.0,1.0,40,850,400,450,0.47058823529411764,13,4,9,363.95721763656536,0.4095886752136752,0.10789473684210549,0.20051755419293474,128943.21852898417,1385.9630097825473,130329.18153876672,1096,7,312.125,40,0,16,36.84606597291709,0.6026041666666666,46.087398373983746,1015.6504065040658,25.391260162601647,0
3280,4,0,0,40,0.0,0.0,1.0,40,1150,600,550,0.5217391304347826,17,6,11,360.79585556315436,0.4086672008547008,0.10466296629663008,0.19942497290082795,129072.2714344139,1313.7481203317982,130386.0195547457,1097,8,313.125,40,0,16,36.794721138780545,0.60390625,45.96036585365853,1016.1585365853647,25.403963414634116,0
3281,4,0,1,39,0.0,0.025,0.975,40,1200,900,300,0.75,15,9,6,366.58208392318494,0.40892094017094016,0.1662576687116566,0.18425998139046437,125219.39442905512,1225.1864802953155,126444.58090935044,1098,9,314.125,37,3,16,40.60811057551854,0.5698198198198199,49.780701754385966,1000.8771929824563,27.050734945471792,8
3282,4,5,1,43,0.11363636363636363,0.022727272727272728,0.9772727272727273,44,450,200,250,0.4444444444444444,7,2,5,312.35928928043245,0.4226017441860465,0.12256397372860062,0.16114176776931458,126293.00910178878,-862.5701692008597,125430.43893258792,1099,0,277.8181818181818,41,3,14,40.86105079615739,0.5741869918699187,48.710317460317455,1005.1587301587294,24.516066589237305,8
3283,4,1,0,44,0.022727272727272728,0.0,1.0,44,1850,1400,450,0.7567567567567568,23,14,9,314.39375372010767,0.42237050739957716,0.123103819257665,0.16298326496533203,126492.52409297063,-846.3081065759537,125646.21598639469,1100,0,278.79545454545456,41,3,15,40.60527613412228,0.5762195121951219,48.511904761904766,1005.9523809523819,24.53542392566785,0
3284,4,2,0,46,0.043478260869565216,0.0,1.0,46,1600,1400,200,0.875,18,14,4,325.2661885971181,0.42555354267310785,0.18725863654275532,0.17198579620710247,127297.04231112434,-914.6635448746262,126382.37876624972,1101,0,267.6304347826087,40,6,19,39.507385028533044,0.5859375,47.71341463414634,1009.1463414634147,25.228658536585368,0
3285,4,2,1,47,0.041666666666666664,0.020833333333333332,0.9791666666666666,48,1700,1300,400,0.7647058823529411,21,13,8,314.2238641060837,0.4295766843971631,0.1940072977547831,0.16844142114407773,127850.36886492695,-1565.272613574909,126285.09625135204,1102,0,257.4375,42,6,15,39.22104052888761,0.5885416666666667,47.1656976744186,1011.3372093023252,24.079457364341074,0
3286,4,3,2,48,0.06,0.04,0.96,50,1000,800,200,0.8,12,8,4,309.56467128222585,0.43253401360544214,0.24037341299477188,0.16918656932526543,128624.38303489437,-2036.1490088331134,126588.23402606125,1103,0,247.22,43,7,12,38.55100199153596,0.5949612403100775,46.40151515151515,1014.3939393939393,23.59055673009161,0
3287,4,1,3,46,0.02040816326530612,0.061224489795918366,0.9387755102040817,49,1250,700,550,0.56,18,7,11,315.0445464118369,0.4312287414965987,0.24035977940703468,0.17222983584258583,128635.5530485697,-1694.8141074755185,126940.73894109417,1104,0,252.6122448979592,42,7,13,38.40067500875601,0.5964781746031746,46.39050387596899,1014.4379844961232,24.153285345145793,0
3288,4,1,1,46,0.02127659574468085,0.02127659574468085,0.9787234042553191,47,1300,1000,300,0.7692307692307693,16,10,6,325.25409137997354,0.42628353376503236,0.24519352727629218,0.17768807258147348,128607.98306439632,-1033.9454648357394,127574.03759956059,1105,0,263.8085106382979,40,7,14,38.169814313863,0.59921875,46.41768292682927,1014.329268292684,25.3582317073171,0
3289,4,1,0,47,0.02127659574468085,0.0,1.0,47,1250,700,550,0.56,18,7,11,327.74427956015325,0.4262449892075239,0.2542628352272498,0.1797274127807875,128758.45520852102,-960.0305720810154,127798.42463644,1106,0,264.72340425531917,42,5,16,37.95350391445485,0.597718253968254,46.269379844961236,1014.9224806201541,24.16482096714653,0
3290,4,2,0,49,0.04081632653061224,0.0,1.0,49,1350,800,550,0.5925925925925926,19,8,11,323.9070724557318,0.43145904195011336,0.2800375002239266,0.18019637622835696,129327.49438027528,-1419.7003427263485,127907.79403754893,1107,0,254.87755102040816,41,8,18,37.47267060047466,0.6049288617886179,45.7093253968254,1017.1626984126985,24.808846302748744,0
3291,4,1,2,48,0.02,0.04,0.96,50,1450,1000,450,0.6896551724137931,19,10,9,325.125253761001,0.4323384353741497,0.2928746746002229,0.18251812262282516,129683.21352731877,-1567.3424586776716,128115.8710686411,1108,0,250.76,43,7,16,37.080854096938154,0.6056201550387597,45.35984848484849,1018.5606060606071,23.68745595489784,0
3292,4,1,0,49,0.02040816326530612,0.0,1.0,49,1550,1000,550,0.6451612903225806,21,10,11,333.23525832290187,0.4295812074829932,0.30142483533697795,0.18764754656267654,129803.80980436473,-1148.9587817091347,128654.8510226556,1109,0,256.6734693877551,43,6,18,36.7520250596289,0.6068313953488372,45.24147727272727,1019.0340909090914,23.69846723044399,0
3293,4,0,1,48,0.0,0.02040816326530612,0.9795918367346939,49,1150,600,550,0.5217391304347826,17,6,11,333.0905212463454,0.4295634920634921,0.3031176241978444,0.18802933724262758,129900.32717982381,-1146.286461920334,128754.04071790348,1110,1,257.6734693877551,43,6,18,36.657861124012996,0.6078003875968992,45.146780303030305,1019.4128787878789,23.707276250880906,0
3294,4,1,1,48,0.02040816326530612,0.02040816326530612,0.9795918367346939,49,1500,1000,500,0.6666666666666666,20,10,10,336.638541806175,0.42945719954648526,0.3116828022968656,0.1913300066721171,130165.9349173553,-1036.225895316812,129129.7090220385,1111,0,258.51020408163265,43,6,19,36.29825538233111,0.6104651162790697,44.88636363636363,1020.4545454545449,23.73150105708244,0
3295,4,2,2,48,0.04,0.04,0.96,50,1950,1500,450,0.7692307692307693,24,15,9,331.0551998703835,0.4322278911564626,0.31787191726332487,0.19001661472012446,130548.03688280805,-1356.1352311580245,129191.90165165003,1112,0,254.16,40,10,17,36.05413849111641,0.61875,44.51219512195123,1021.9512195121968,25.54878048780492,0
3296,4,0,0,48,0.0,0.0,1.0,48,1400,1100,300,0.7857142857142857,17,11,6,340.2087768506526,0.4316544769503546,0.31081346093504814,0.19465805598259087,130426.23325525984,-725.5701429980156,129700.66311226183,1113,1,262.3333333333333,38,10,20,35.94354670013595,0.6208881578947368,44.63141025641026,1021.4743589743601,26.880904183535794,0
3297,4,0,0,48,0.0,0.0,1.0,48,1700,1300,400,0.7647058823529411,21,13,8,339.9655022173377,0.4314513150118204,0.3098507234562866,0.1955698381454253,130635.03146701407,-717.7191840277562,129917.31228298631,1114,2,263.3333333333333,39,9,17,35.738485836560024,0.6212606837606838,44.42708333333334,1022.2916666666681,26.212606837606874,0
3298,4,0,0,48,0.0,0.0,1.0,48,1850,1500,350,0.8108108108108109,22,15,7,334.22429234705174,0.4309711140661938,0.29909251166948025,0.19351951694321268,130885.78976014633,-850.9579078260034,130034.83185232033,1115,3,264.3333333333333,40,8,17,35.63184857814416,0.6221354166666666,44.1819105691057,1023.2723577235793,25.58180894308948,0
3299,4,0,1,47,0.0,0.020833333333333332,0.9791666666666666,48,1200,900,300,0.75,15,9,6,333.89196724961744,0.4306940750591017,0.3022662994938967,0.19437489046645856,131093.85456945281,-845.7630006940195,130248.0915687588,1116,4,265.3333333333333,40,8,18,35.430311600674806,0.62421875,43.97865853658537,1024.0853658536594,25.602134146341484,0
3300,4,0,0,47,0.0,0.0,1.0,47,1650,1300,350,0.7878787878787878,20,13,7,343.6136882623731,0.4286732963305581,0.3017408123791099,0.20042093774449463,131168.01757812515,-385.7747395833187,130782.24283854183,1117,5,271.8085106382979,39,8,18,35.10651820215578,0.6266025641025641,43.90625000000001,1024.3750000000011,26.26602564102567,0
3301,4,1,0,48,0.020833333333333332,0.0,1.0,48,1850,1500,350,0.8108108108108109,22,15,7,343.2882087624459,0.4294196956264775,0.3092482090389883,0.20258217673140966,131614.73954202206,-563.6423631766677,131051.09717884539,1118,0,267.125,40,8,17,34.66417417714833,0.6294270833333333,43.47052845528456,1026.1178861788628,25.65294715447157,0
3302,4,0,0,48,0.0,0.0,1.0,48,1250,1000,250,0.8,15,10,5,343.2698755024013,0.4293181146572104,0.3047029702970292,0.2029874556542305,131692.9613655894,-558.7547094983054,131134.2066560911,1119,1,268.125,40,8,17,34.585808580858085,0.6302083333333333,43.394308943089435,1026.4227642276433,25.66056910569108,0
3303,4,0,0,48,0.0,0.0,1.0,48,1750,1200,550,0.6857142857142857,23,12,11,346.36720177865243,0.4297059692671395,0.30530471713673113,0.20552205366842505,131823.38271077056,-468.14076029481475,131355.24195047576,1120,2,269.125,40,8,17,34.37489691571829,0.6315104166666667,43.26727642276422,1026.9308943089418,25.673272357723544,0
3304,4,0,0,48,0.0,0.0,1.0,48,1550,1000,550,0.6451612903225806,21,10,11,344.1785985034596,0.42912418735224583,0.3018258519543868,0.2054912836637539,132058.30379569042,-509.6716157710335,131548.63217991937,1121,3,270.125,40,8,19,34.194557049634184,0.6338541666666666,43.03861788617886,1027.8455284552847,25.696138211382117,0
3305,4,0,1,47,0.0,0.020833333333333332,0.9791666666666666,48,1400,1000,400,0.7142857142857143,18,10,8,348.17635787800805,0.42925347222222227,0.30551574751268373,0.20845256739702275,132162.7802977724,-396.8089017780553,131765.97139599436,1122,4,271.125,40,8,19,33.98666567832903,0.6348958333333333,42.93699186991869,1028.2520325203245,25.706300813008113,0
3306,4,0,0,47,0.0,0.0,1.0,47,1150,800,350,0.6956521739130435,15,8,7,347.27727523968804,0.4261293555349985,0.2671967038980261,0.2031418397641011,131278.46884201697,-281.99420858119265,130996.47463343578,1123,5,277.6808510638298,42,5,17,34.90115197932426,0.623015873015873,43.79844961240311,1024.8062015503897,24.40014765596166,8
3307,4,0,0,47,0.0,0.0,1.0,47,1200,800,400,0.6666666666666666,16,8,8,350.7423234042726,0.4257439099599136,0.26547621485470896,0.20588772543335526,131412.4312889541,-181.5727578027542,131230.85853115135,1124,6,278.6808510638298,37,10,18,34.677106726553305,0.6326013513513513,43.667763157894726,1025.3289473684197,27.71159317211945,0
3308,4,0,0,47,0.0,0.0,1.0,47,1450,700,750,0.4827586206896552,22,7,15,353.83975984346097,0.42505010792476106,0.2720710842578673,0.20801151941017518,131468.65051025298,-96.23285530164995,131372.41765495134,1125,7,279.6808510638298,37,10,18,34.54094497309241,0.6331644144144144,43.61293859649122,1025.5482456140337,27.71752015173064,0
3309,4,0,0,47,0.0,0.0,1.0,47,1850,1300,550,0.7027027027027027,24,13,11,354.98912266905955,0.4239323157570151,0.26782275793240307,0.2096115583002983,131637.3803117305,-54.03237053709475,131583.3479411934,1126,8,280.6808510638298,37,10,16,34.341164476261696,0.6348536036036037,43.4484649122807,1026.206140350877,27.735301090564242,0
3310,4,0,0,47,0.0,0.0,1.0,47,1100,700,400,0.6363636363636364,15,7,8,357.6760023801702,0.4230072463768116,0.277295572904833,0.21197962571442475,131778.07113727287,26.770737149883303,131804.84187442274,1127,9,281.6808510638298,37,10,17,34.13026840381604,0.6362612612612613,43.311403508771924,1026.7543859649113,27.750118539592197,0
3311,4,0,1,46,0.0,0.02127659574468085,0.9787234042553191,47,1150,800,350,0.6956521739130435,15,8,7,357.75516512080185,0.42273743447425227,0.2798818335712161,0.212728256811163,131903.67408366184,37.84414036815994,131941.51822403,1128,10,282.6808510638298,38,9,17,34.00156006240251,0.6356907894736843,43.189102564102555,1027.243589743588,27.032726045883894,0
3312,4,0,0,46,0.0,0.0,1.0,46,1600,1100,500,0.6875,21,11,10,358.7442071342029,0.4216686795491143,0.29112268000704966,0.21424444548964408,132068.34781804736,275.7509451019053,132344.09876314926,1129,11,289.19565217391306,38,8,17,33.810154869556165,0.6373355263157895,43.02884615384615,1027.8846153846155,27.049595141700408,0
3313,4,0,1,45,0.0,0.021739130434782608,0.9782608695652174,46,1350,1200,150,0.8888888888888888,15,12,3,361.308982965087,0.4212459742351047,0.2986177300959909,0.21640317119097444,132178.18737900854,351.4332904156428,132529.62066942418,1130,12,290.19565217391306,38,8,18,33.633549783549775,0.6384320175438596,42.92200854700854,1028.3119658119647,27.06084120557802,0
3314,4,0,0,45,0.0,0.0,1.0,45,1150,1000,150,0.8695652173913043,13,10,3,365.0414305983924,0.4197811447811448,0.29694405934141455,0.21844246935042266,132144.21895438974,647.6229464835203,132791.84190087326,1131,13,297.0444444444444,37,8,19,33.57183800789163,0.6399211711711712,42.955043859649116,1028.179824561403,27.788643907064944,0
3315,4,0,1,44,0.0,0.022222222222222223,0.9777777777777777,45,1200,900,300,0.75,15,9,6,367.5475254049122,0.4194023569023569,0.30281463475021675,0.2203276696006495,132210.46142578125,718.7255859375003,132929.18701171875,1132,14,298.0444444444444,39,6,19,33.44063354603464,0.6370192307692308,42.890625,1028.4375,26.370192307692307,0
3316,4,0,0,44,0.0,0.0,1.0,44,1200,700,500,0.5833333333333334,17,7,10,369.94841247717983,0.4169199260042283,0.3130547267439665,0.22206130394827206,132260.59701219946,985.919579589436,133246.5165917889,1133,15,305.1363636363636,38,6,19,33.328356529566534,0.6392543859649122,42.841880341880334,1028.6324786324776,27.069275753486252,0
3317,4,1,1,44,0.022222222222222223,0.022222222222222223,0.9777777777777777,45,1400,900,500,0.6428571428571429,19,9,10,361.3536465474684,0.4189604377104377,0.30439832061971517,0.21916833501055288,132652.03145438977,587.0017360225722,133239.03319041233,1134,0,299.3333333333333,37,8,15,33.15537963455739,0.6449887387387387,42.46162280701754,1030.1535087719294,27.84198672356566,0
3318,4,0,0,44,0.0,0.0,1.0,44,1050,600,450,0.5714285714285714,15,6,9,377.55785240268017,0.415444415081043,0.28626301755798145,0.21044017251438732,129401.82317029883,1020.4936462125316,130422.31681651136,1135,17,307.1363636363636,36,8,18,36.03255856852979,0.6142939814814814,45.63626126126127,1017.4549549549562,28.26263763763767,8
3319,4,0,0,44,0.0,0.0,1.0,44,1000,700,300,0.7,13,7,6,351.9136479359661,0.4148608174770965,0.1639179826358772,0.1982814109664016,129826.69850107745,340.4107739162663,130167.10927499372,1136,18,308.1363636363636,38,6,16,36.252926582101544,0.6148574561403508,45.21901709401709,1019.1239316239312,26.819050832208717,8
3320,4,0,0,44,0.0,0.0,1.0,44,1100,700,400,0.6363636363636364,15,7,8,350.2566289167017,0.41442036645525016,0.16440981093510532,0.1975366636282377,129864.1289605034,297.1544053819393,130161.28336588533,1137,19,309.1363636363636,39,5,16,36.257132515755416,0.6135149572649572,45.182291666666664,1019.2708333333327,26.135149572649556,0
3321,4,0,0,44,0.0,0.0,1.0,44,1200,1000,200,0.8333333333333334,14,10,4,349.0564364420973,0.41438733262861166,0.16294456309778083,0.19752962501549887,129996.88042534713,275.2495659722124,130272.12999131935,1138,20,310.1363636363636,39,5,17,36.152962206333,0.6148504273504274,45.05208333333333,1019.7916666666658,26.14850427350425,0
3322,4,1,0,45,0.022222222222222223,0.0,1.0,45,1450,1100,350,0.7586206896551724,18,11,7,342.32078589276944,0.4175294612794613,0.15685289809583614,0.19545412613877472,130344.39718934905,-75.53816876232986,130268.85902058672,1139,0,304.22222222222223,38,7,20,35.972483783218244,0.6200657894736843,44.71153846153846,1021.1538461538456,26.872469635627517,0
3323,4,0,0,45,0.0,0.0,1.0,45,1000,600,400,0.6,14,6,8,343.4803305509182,0.41717171717171714,0.1573125101675612,0.19666819884598086,130453.51765103362,-38.356527138584426,130415.16112389503,1140,1,305.22222222222223,38,7,20,35.83237467754306,0.6211622807017544,44.60470085470085,1021.5811965811962,26.883715699505164,0
3324,4,0,0,45,0.0,0.0,1.0,45,1350,1200,150,0.8888888888888888,15,12,3,344.16550986884766,0.41647727272727275,0.16157688108346724,0.1976162825573464,130562.68376981498,-12.965474103318371,130549.71829571166,1141,2,306.22222222222223,38,7,12,35.70436093107532,0.6222587719298245,44.497863247863236,1022.0085470085453,26.89496176338277,0
3325,4,0,1,44,0.0,0.022222222222222223,0.9777777777777777,45,1250,800,450,0.64,17,8,9,347.2312973616524,0.4156776094276094,0.16201256109311712,0.20008132131537473,130699.20562358461,76.57094656293162,130775.77657014754,1142,3,307.22222222222223,38,7,13,35.48784522690071,0.6236293859649122,44.36431623931624,1022.5427350427349,26.909019343229865,0
3326,4,0,0,44,0.0,0.0,1.0,44,1400,1100,300,0.7857142857142857,17,11,6,354.86917001838367,0.4124933932346723,0.15725297062147958,0.20448240976796808,130699.20562358464,476.2237243407101,131175.42934792535,1143,25,315.1363636363636,38,6,15,35.29259394699265,0.6236293859649122,44.36431623931624,1022.5427350427351,26.909019343229872,0
3327,4,0,0,44,0.0,0.0,1.0,44,1600,900,700,0.5625,23,9,14,366.97732213147344,0.4129008104298802,0.18333232725663007,0.2046917952333327,129430.46932067184,759.3374502060631,130189.8067708779,1144,26,316.1363636363636,36,8,15,36.27250258226355,0.6145833333333333,45.6081081081081,1017.567567567566,28.26576576576572,8
3328,4,0,0,44,0.0,0.0,1.0,44,1250,900,350,0.72,16,9,7,369.72470256208436,0.4129228329809725,0.18559726035663626,0.20667542278656012,129516.42679419267,777.0844746773587,130293.51126887003,1145,27,317.1363636363636,36,8,16,36.11502931740236,0.6154513888888888,45.52364864864864,1017.905405405404,28.27515015015011,0
3329,4,1,0,45,0.022222222222222223,0.0,1.0,45,950,400,550,0.42105263157894735,15,4,11,364.6498336596943,0.41599326599326597,0.1945305029642379,0.20569082850124482,129871.11418898105,471.49603724220935,130342.61022622326,1146,0,311.06666666666666,37,8,17,35.88326520367182,0.6171171171171171,45.17543859649122,1019.2982456140338,27.548601232811723,0
3330,4,0,0,45,0.0,0.0,1.0,45,1450,600,850,0.41379310344827586,23,6,17,362.2097854912774,0.4153409090909091,0.18817458611051374,0.20519338761509515,130038.81602993223,420.2663319482855,130459.08236188052,1147,1,312.06666666666666,37,8,17,35.775012542105635,0.6188063063063063,45.0109649122807,1019.9561403508768,27.56638217164532,0
3331,4,1,0,46,0.021739130434782608,0.0,1.0,46,1800,1400,400,0.7777777777777778,22,14,8,324.07032041433996,0.4173812399355878,0.040851363091052084,0.18174914981615298,129645.08311549762,-797.1752749234076,128847.9078405742,1148,0,306.2608695652174,42,4,18,37.14636853790041,0.6066468253968254,45.397286821705414,1018.4108527131763,24.247877445551815,8
3332,4,1,1,46,0.02127659574468085,0.02127659574468085,0.9787234042553191,47,1450,1200,250,0.8275862068965517,17,12,5,319.4446352951869,0.42123419673142154,0.04810996563573866,0.1805491017440038,129948.59931882723,-1097.7234166953883,128850.87590213184,1149,0,300.72340425531917,43,4,19,36.95676991424414,0.6082848837209303,45.099431818181806,1019.6022727272707,23.71168076109932,0
3333,4,0,0,46,0.0,0.0,1.0,46,550,300,250,0.5454545454545454,8,3,5,326.71044548060433,0.41882045088566827,0.05172884045573456,0.1845045945733458,129916.60399202254,-710.9776868878247,129205.62630513472,1150,1,308.19565217391306,42,4,20,36.80397142223489,0.609375,45.130813953488364,1019.4767441860452,24.273255813953455,0
3334,4,0,0,46,0.0,0.0,1.0,46,900,700,200,0.7777777777777778,11,7,4,327.9148278332893,0.41861916264090177,0.056728286688009666,0.18565376885128373,130015.40927716155,-673.2038902410022,129342.20538692056,1151,2,309.19565217391306,42,4,20,36.67319873317496,0.6103670634920635,45.033914728682156,1019.8643410852691,24.282484311554025,0
3335,4,0,0,46,0.0,0.0,1.0,46,1250,900,350,0.72,16,9,7,323.3781293232686,0.4177234299516908,0.05619313396852643,0.18389948477498158,130188.40889970532,-779.9831740881211,129408.4257256172,1152,3,310.19565217391306,42,4,20,36.61381187492087,0.6121031746031746,44.864341085271306,1020.5426356589128,24.298634182355066,0
3336,4,0,1,45,0.0,0.021739130434782608,0.9782608695652174,46,1400,800,600,0.5714285714285714,20,8,12,322.47426701918283,0.4169987922705314,0.06381077895910714,0.18409471050629211,130338.55273880382,-793.8130219581527,129544.73971684567,1153,4,311.19565217391306,41,5,20,36.48505051977074,0.6150914634146342,44.717261904761905,1021.1309523809521,24.90563298490127,0
3337,4,0,0,45,0.0,0.0,1.0,45,1150,700,450,0.6086956521739131,16,7,9,329.13818964877134,0.4165614478114478,0.07316307352128315,0.1881592039800995,130392.29811124326,-416.5830111045037,129975.71510013875,1154,5,315.75555555555553,40,5,20,36.26057213930349,0.6171875,44.66463414634146,1021.3414634146337,25.533536585365844,0
3338,4,0,1,44,0.0,0.022222222222222223,0.9777777777777777,45,1300,900,400,0.6923076923076923,17,9,8,346.5757737826521,0.41668771043771047,0.12273331933067277,0.19298798350633972,129364.36760355013,4.220508361794543,129368.58811191191,1155,6,316.75555555555553,38,7,18,36.858721907162355,0.6101973684210527,45.67307692307691,1017.3076923076909,26.77125506072871,8
3339,4,1,0,45,0.022222222222222223,0.0,1.0,45,1600,1200,400,0.75,20,12,8,344.81884024586964,0.41332070707070706,0.13350120658902553,0.19320801683617747,129609.02829141995,-61.67303583170647,129547.35525558825,1156,0,317.6,38,7,14,36.65473192739482,0.6126644736842105,45.4326923076923,1018.2692307692294,26.796558704453403,0
3340,4,0,1,44,0.0,0.022222222222222223,0.9777777777777777,45,1100,600,500,0.5454545454545454,16,6,10,341.54256631579824,0.41363636363636364,0.12633492388093615,0.19197047692922456,129731.4453125,-138.23784722222263,129593.20746527778,1157,1,318.6,39,6,14,36.613837764144506,0.6121794871794872,45.3125,1018.75,26.121794871794872,0
3341,4,1,0,45,0.022222222222222223,0.0,1.0,45,1000,700,300,0.7,13,7,6,337.19977090646154,0.41805555555555557,0.1257908431600514,0.19085164698512905,130003.35784131453,-232.5795037676122,129770.77833754692,1158,0,316.4,40,5,15,36.448679621325375,0.61328125,45.04573170731707,1019.8170731707304,25.49542682926826,0
3342,4,1,0,46,0.021739130434782608,0.0,1.0,46,1000,500,500,0.5,15,5,10,336.05806223601303,0.4214573268921095,0.1393887343322069,0.19198678040987435,130366.35068618198,-437.609165344722,129928.74152083725,1159,0,310.5,40,6,17,36.11014362954853,0.6169270833333333,44.690040650406495,1021.2398373983725,25.530995934959314,0
3343,4,0,0,46,0.0,0.0,1.0,46,1150,900,250,0.782608695652174,14,9,5,336.5765033366488,0.42115539452495976,0.13534836242841553,0.19266896421070573,130444.20070725087,-419.10940908190554,130025.09129816896,1160,1,311.5,40,6,17,36.0181224300305,0.6177083333333333,44.61382113821138,1021.5447154471537,25.538617886178844,0
3344,4,1,0,47,0.02127659574468085,0.0,1.0,47,1050,600,450,0.5714285714285714,15,6,9,334.5348658749549,0.4231421523280913,0.13502621657927794,0.19324308134659146,130794.81336805547,-648.9149305555671,130145.89843749991,1161,0,305.8510638297872,41,6,15,35.71580108621858,0.6196646341463414,44.27083333333333,1022.916666666666,24.9491869918699,0
3345,4,0,1,46,0.0,0.02127659574468085,0.9787234042553191,47,1150,800,350,0.6956521739130435,15,8,7,338.14401322682875,0.4226988899167437,0.14484332763565666,0.1963594863527092,130997.85175933782,-540.7721364008758,130457.07962293694,1162,1,306.8510638297872,41,6,17,35.41838275672705,0.6216971544715447,44.072420634920626,1023.7103174603161,24.968544328300393,0
3346,4,0,0,46,0.0,0.0,1.0,46,1300,800,500,0.6153846153846154,18,8,10,341.788581050984,0.42020933977455716,0.1486304284624811,0.19847587888942603,130997.85175933782,-245.286025289765,130752.56573404805,1163,2,314.4347826086956,41,5,17,35.32510821462025,0.6216971544715447,44.072420634920626,1023.7103174603161,24.968544328300393,0
3347,4,1,0,47,0.02127659574468085,0.0,1.0,47,1250,900,350,0.72,16,9,7,347.43953253798526,0.42125346901017574,0.17910474929294207,0.20394896853500943,131412.4312889543,-266.34615934066846,131146.08512961364,1164,0,308.72340425531917,37,10,19,34.76176790361102,0.6326013513513513,43.66776315789474,1025.3289473684213,27.711593172119493,0
3348,4,1,0,48,0.020833333333333332,0.0,1.0,48,800,400,400,0.5,12,4,8,339.9063577485575,0.42234596631205673,0.18372237257555257,0.2009526387009472,131684.26890432098,-647.9359567901224,131036.33294753086,1165,0,303.2708333333333,38,10,12,34.680875056382504,0.6334978070175439,43.40277777777778,1026.388888888889,27.010233918128655,0
3349,4,0,1,47,0.0,0.020833333333333332,0.9791666666666666,48,900,600,300,0.6666666666666666,12,6,6,341.3834542081295,0.4219765809692671,0.18888663419913443,0.2022040459540461,131755.55555555568,-604.1666666666474,131151.38888888902,1166,1,304.2708333333333,39,9,13,34.57115800865802,0.6324786324786325,43.33333333333334,1026.6666666666679,26.324786324786356,0
3350,4,0,1,46,0.0,0.02127659574468085,0.9787234042553191,47,1450,1100,350,0.7586206896551724,18,11,7,332.17038707757155,0.41867098365710764,0.09452048985494965,0.18637906415600308,129663.42872242327,-742.3533494046127,128921.07537301866,1167,2,311.63829787234044,38,9,15,36.92152697646773,0.6132127192982456,45.37927350427351,1018.4829059829071,26.802181736392292,8
3351,4,0,1,45,0.0,0.021739130434782608,0.9782608695652174,46,1000,700,300,0.7,13,7,6,364.1225867296291,0.4177234299516908,0.16452505683503027,0.1861459428976079,125919.34292524897,53.68485675693671,125973.02778200591,1168,4,319.3695652173913,41,5,19,39.945862574544506,0.5703760162601625,49.08234126984128,1003.6706349206363,24.479771583430153,8
3352,4,1,0,46,0.021739130434782608,0.0,1.0,46,1500,1200,300,0.8,18,12,6,366.2833364447888,0.41977657004830915,0.19884142056613574,0.1892594627069115,126357.8342013891,56.73835506426741,126414.57255645336,1169,0,318.17391304347825,39,7,18,39.439149053736706,0.5779914529914529,48.64583333333334,1005.4166666666683,25.779914529914574,0
3353,4,5,1,50,0.09803921568627451,0.0196078431372549,0.9803921568627451,51,900,700,200,0.7777777777777778,11,7,4,341.243478392897,0.43537581699346406,0.24289625109684998,0.18163442664403526,127565.10959201414,-1483.2139756944202,126081.89561631971,1170,0,287.88235294117646,39,12,18,38.82974152746271,0.5902777777777778,47.44791666666668,1010.2083333333354,25.902777777777832,0
3354,4,1,0,51,0.0196078431372549,0.0,1.0,51,1700,1500,200,0.8823529411764706,19,15,4,337.33638635416526,0.43491830065359477,0.24621494167287206,0.18046168573938562,127768.13394628672,-1579.831880668949,126188.30206561777,1171,0,288.8627450980392,41,10,19,38.72074624668825,0.5891768292682926,47.2470238095238,1011.0119047619037,24.658826945412287,0
3355,4,0,0,51,0.0,0.0,1.0,51,1100,700,400,0.6363636363636364,15,7,8,332.2163598856816,0.4347549019607843,0.24212877639318697,0.17808639692485131,127850.36886492679,-1705.2031691304812,126145.1656957963,1172,1,289.8627450980392,42,9,19,38.766128517134554,0.5885416666666667,47.165697674418595,1011.3372093023239,24.079457364341046,0
3356,4,1,0,52,0.019230769230769232,0.0,1.0,52,1750,1300,450,0.7428571428571429,22,13,9,334.1041839356404,0.43490761689291096,0.25793983440225854,0.18125105393987606,128329.16802300364,-1823.5855263003277,126505.58249670331,1173,0,285.2692307692308,39,13,23,38.22960573660944,0.5980235042735043,46.69270833333334,1013.2291666666681,25.980235042735078,0
3357,4,0,0,52,0.0,0.0,1.0,52,1600,1000,600,0.625,22,10,12,301.8696176763854,0.4350725867269985,0.12349164867628715,0.15793333165912893,126867.0391333616,-2723.1291409793125,124143.90999238228,1174,1,286.2692307692308,41,11,17,40.5369891678976,0.5800304878048781,48.13988095238095,1007.4404761904756,24.571718931475015,8
3358,4,1,1,52,0.018867924528301886,0.018867924528301886,0.9811320754716981,53,1550,1100,450,0.7096774193548387,20,11,9,300.4807343700762,0.4352775761973875,0.13986112085291436,0.158488857932452,127197.07031250001,-2955.3482851473914,124241.72202735262,1175,0,281.8490566037736,39,14,20,40.23475148010463,0.5865384615384616,47.8125,1008.7500000000001,25.865384615384617,0
3359,4,0,0,52,0.0,0.0,1.0,52,1250,600,650,0.48,19,6,13,309.69380034023516,0.43275515334338865,0.14224096844914724,0.16334829861083006,127197.0703125001,-2521.5711805555416,124675.49913194455,1176,1,288.1923076923077,39,13,21,40.00240947266971,0.5865384615384616,47.81250000000001,1008.7500000000008,25.865384615384635,0
3360,4,1,0,53,0.018867924528301886,0.0,1.0,53,1450,1300,150,0.896551724137931,16,13,3,307.4431221038382,0.4352322206095791,0.16556636199066532,0.16365359709270172,127567.61508133344,-2756.0428280108367,124811.5722533226,1177,0,283.7358490566038,41,12,14,39.68082015777929,0.5871443089430894,47.445436507936506,1010.2182539682537,24.6394696089818,0
3361,4,1,0,54,0.018518518518518517,0.0,1.0,54,1250,800,450,0.64,17,8,9,303.36931868143955,0.43848998369438624,0.1767857459759703,0.16242477375273592,127801.37466385742,-3045.7968083348333,124755.57785552258,1178,0,279.462962962963,42,12,16,39.54540009583129,0.5880456349206349,47.21414728682171,1011.1434108527138,24.074843115540805,0
3362,4,0,0,54,0.0,0.0,1.0,54,1800,1300,500,0.7222222222222222,23,13,10,303.81835340769896,0.43856277661309107,0.180172080535961,0.16346084825536325,127997.40780489454,-3022.4076640526364,124975.0001408419,1179,1,280.462962962963,42,12,18,39.33436273101599,0.5900297619047619,47.020348837209305,1011.9186046511628,24.09330011074197,0
3363,4,1,1,54,0.01818181818181818,0.01818181818181818,0.9818181818181818,55,1750,1000,750,0.5714285714285714,25,10,15,298.1889378365148,0.4394640852974186,0.19691896942998222,0.16193514088250913,128370.63536352031,-3344.0903080348453,125026.54505548546,1180,0,276.3454545454546,41,14,14,39.097222222222214,0.5952743902439024,46.65178571428571,1013.3928571428564,24.716898954703815,0
3364,4,1,0,55,0.01818181818181818,0.0,1.0,55,1450,900,550,0.6206896551724138,20,9,11,301.5343626705459,0.43975869809203144,0.2073623559539053,0.1646841519200675,128596.9387755104,-3244.720804988645,125352.21797052176,1181,0,277.1454545454545,41,14,16,38.782521517996884,0.5975609756097561,46.42857142857144,1014.2857142857158,24.73867595818819,0
3365,4,0,1,54,0.0,0.01818181818181818,0.9818181818181818,55,1150,900,250,0.782608695652174,14,9,5,302.62440830170164,0.43952020202020203,0.21098897282278384,0.16554219200202805,128660.12878583022,-3212.8609308334826,125447.26785499674,1182,1,278.1454545454545,42,13,16,38.69070359758039,0.5967261904761905,46.366279069767444,1014.5348837209306,24.155592469545965,0
3366,4,0,0,54,0.0,0.0,1.0,54,1650,1100,550,0.6666666666666666,22,11,11,311.0126792642319,0.4370850803633823,0.21010776057230784,0.1699681798758297,128622.09590143945,-2799.3794682224557,125822.71643321699,1183,2,284.0740740740741,41,13,17,38.51660554197228,0.5978150406504066,46.40376984126985,1014.384920634922,24.741095625242,0
3367,4,1,1,54,0.01818181818181818,0.01818181818181818,0.9818181818181818,55,2000,1500,500,0.75,25,15,10,303.2999255642823,0.43883277216610544,0.20898415657036318,0.1675802369363932,129057.01636392364,-3171.4033086546942,125885.61305526894,1184,0,279.8909090909091,43,12,20,38.27081391736564,0.5993217054263567,45.9753787878788,1016.0984848484875,23.63019732205785,0
3368,4,0,2,52,0.0,0.037037037037037035,0.962962962962963,54,1600,1100,500,0.6875,21,11,10,310.07824863045994,0.4352943745632425,0.1990299150734105,0.17109791361272336,129004.43558079454,-2799.7061099092434,126204.7294708853,1185,1,285.962962962963,42,12,20,38.15198556530589,0.6001984126984127,46.027131782945744,1015.891472868218,24.187892211148046,0
3369,4,0,0,52,0.0,0.0,1.0,52,1650,1100,550,0.6666666666666666,22,11,11,314.3313766084707,0.4335642911010558,0.19034291553338245,0.17320369395680957,128949.36244173588,-2293.4338781809115,126655.92856355497,1186,2,295.15384615384613,41,11,20,38.09988930129582,0.6011178861788617,46.0813492063492,1015.6746031746027,24.77255129694153,0
3370,4,0,0,52,0.0,0.0,1.0,52,1600,1000,600,0.625,22,10,12,314.2681724413309,0.43348573403720464,0.191507818484971,0.1736102816690459,129050.14349489794,-2288.729450113384,126761.41404478456,1187,3,296.15384615384613,41,11,20,37.999170083967954,0.6021341463414633,45.982142857142854,1016.0714285714284,24.78222996515679,0
3371,4,2,1,53,0.037037037037037035,0.018518518518518517,0.9814814814814815,54,1600,1200,400,0.75,20,12,8,304.58205345795477,0.43677935010482183,0.20847194499889166,0.1706886004277797,129614.99851278972,-2904.0537875124496,126710.94472527728,1188,0,286.14814814814815,40,14,16,37.6729873586161,0.609375,45.42682926829267,1018.292682926827,25.457317073170675,0
3372,4,0,1,52,0.0,0.018867924528301886,0.9811320754716981,53,1400,1000,400,0.7142857142857143,18,10,8,310.49247453902075,0.4354438800193517,0.2062249674274963,0.1739291655369012,129598.82948133671,-2552.107747395843,127046.72173394087,1189,1,292.54716981132077,39,14,16,37.53889599317987,0.610844017094017,45.44270833333333,1018.2291666666658,26.10844017094015,0
3373,4,0,0,52,0.0,0.0,1.0,52,950,600,350,0.631578947368421,13,6,7,316.2332010081906,0.4347583584715938,0.21197827560605598,0.17731381600059243,129636.22708013727,-2200.9441887647085,127435.28289137255,1190,2,296.6923076923077,38,14,17,37.35487480766542,0.6129385964912281,45.4059829059829,1018.3760683760678,26.799370220422837,0
3374,4,2,1,53,0.037037037037037035,0.018518518518518517,0.9814814814814815,54,1250,700,550,0.56,18,7,11,306.7947921517878,0.44004047286279996,0.2384063342442313,0.17456884405554707,130210.72035701304,-2810.405822427126,127400.31453458591,1191,0,286.6666666666667,40,14,19,37.014379833383124,0.6153645833333333,44.84247967479675,1020.6300813008131,25.51575203252033,0
3375,4,1,1,53,0.018518518518518517,0.018518518518518517,0.9814814814814815,54,1600,1000,600,0.625,22,10,12,310.54860496244464,0.441103249475891,0.24998866675733145,0.17742532185616658,130368.94531250048,-2702.8108527083295,127666.13445979216,1192,0,287.462962962963,39,15,20,36.75880592955256,0.6185897435897436,44.68750000000002,1021.2500000000039,26.185897435897534,0
3376,4,0,0,53,0.0,0.0,1.0,53,1250,600,650,0.48,19,6,13,318.80322405668534,0.4395107643928398,0.25593544636635523,0.18189227020975746,130315.76063368074,-2290.9830729166492,128024.7775607641,1193,1,293.7358490566038,39,14,20,36.60179895259471,0.6180555555555556,44.73958333333334,1021.0416666666681,26.180555555555593,0
3377,4,0,0,53,0.0,0.0,1.0,53,1650,1400,250,0.8484848484848485,19,14,5,321.41564945101135,0.4389362602805999,0.2550332731513263,0.18477163257544083,130608.41064453122,-2204.082573784725,128404.3280707465,1194,2,294.7358490566038,39,14,19,36.239448520669875,0.6209935897435898,44.453125,1022.1874999999998,26.20993589743589,0
3378,4,0,0,53,0.0,0.0,1.0,53,1250,900,350,0.72,16,9,7,319.74432159039094,0.43849782293178524,0.25571560649847247,0.18414124897085984,130677.89019639429,-2243.29733045807,128434.59286593623,1195,3,295.7358490566038,40,13,19,36.212023324387914,0.6200520833333334,44.385162601626014,1022.4593495934955,25.56148373983739,0
3379,4,0,0,53,0.0,0.0,1.0,53,1750,1400,350,0.8,21,14,7,321.2486942178376,0.4377418964683116,0.25856836224915436,0.18550591550789072,130781.81932257589,-2197.3022630378655,128584.51705953802,1196,4,296.7358490566038,40,13,19,36.06867858917041,0.62109375,44.28353658536586,1022.8658536585369,25.571646341463424,0
3380,4,0,0,53,0.0,0.0,1.0,53,1950,1500,450,0.7692307692307693,24,15,9,276.97738416412085,0.43807450411223997,0.15797691731988883,0.15520843122907568,129612.35860202923,-3420.0615918135927,126192.29701021564,1197,5,297.7358490566038,48,5,15,38.3783924843424,0.5987413194444444,45.429421768707485,1018.2823129251699,21.214214852607707,8
3381,4,1,1,53,0.018518518518518517,0.018518518518518517,0.9814814814814815,54,1600,1100,500,0.6875,21,11,10,273.95584756687737,0.4388248311204286,0.1712714317523938,0.15443286029809294,129845.91346410576,-3685.5905447690957,126160.32291933667,1198,0,293.2037037037037,50,4,17,38.21977287909153,0.5989583333333333,45.200163398692816,1019.1993464052293,20.383986928104587,0
3382,4,0,0,53,0.0,0.0,1.0,53,1700,900,800,0.5294117647058824,25,9,16,283.4755455486208,0.4384827044025157,0.17761783394314357,0.1603740291668279,129986.2578125006,-3230.4149305555097,126755.8428819451,1199,1,293.6981132075472,49,4,17,37.83564531066981,0.6014030612244898,45.06250000000002,1019.7500000000048,20.811224489796015,0
3383,4,0,0,53,0.0,0.0,1.0,53,1500,1000,500,0.6666666666666666,20,10,10,283.4726308440205,0.43840711175616837,0.17652597787877222,0.160897330524958,130113.75781250003,-3223.262152777776,126890.49565972225,1200,2,294.6981132075472,49,4,19,37.707176209534694,0.6026785714285714,44.9375,1020.2500000000002,20.821428571428577,0
3384,4,0,1,52,0.0,0.018867924528301886,0.9811320754716981,53,1150,800,350,0.6956521739130435,15,8,7,288.39377020351407,0.43837687469762937,0.18375583845803045,0.16413786698200034,130220.05555555582,-3089.0694444444252,127130.9861111114,1201,3,295.6981132075472,49,4,19,37.47448563030699,0.6037414965986394,44.83333333333334,1020.6666666666688,20.829931972789158,0
3385,4,0,1,51,0.0,0.019230769230769232,0.9807692307692307,52,1500,1100,400,0.7333333333333333,19,11,8,288.79537592899106,0.4359838486676722,0.17416639429886116,0.16436277369728214,130219.18764316959,-2878.660150284599,127340.52749288498,1202,4,302.13461538461536,48,4,19,37.465112888444544,0.6048177083333333,44.83418367346939,1020.6632653061231,21.2638180272109,0
3386,4,1,0,52,0.019230769230769232,0.0,1.0,52,1050,800,250,0.7619047619047619,13,8,5,289.0705968009191,0.43859979889391654,0.18178557366984482,0.16585947084739633,130534.22649923286,-2853.2569562336776,127680.96954299918,1203,0,301.1730769230769,46,6,12,37.14069864954743,0.6102807971014492,44.52570921985815,1021.8971631205668,22.215155720012323,0
3387,4,0,1,51,0.0,0.019230769230769232,0.9807692307692307,52,1200,1000,200,0.8333333333333334,14,10,4,304.1979379335243,0.4389768728004022,0.16545606096689713,0.16107530156152214,127354.73632812526,-2572.903016109887,124781.83331201537,1204,1,302.1730769230769,43,9,11,39.98000515995873,0.5821220930232558,47.656250000000014,1009.375000000002,23.473837209302374,7
3388,4,1,0,52,0.019230769230769232,0.0,1.0,52,1650,1300,350,0.7878787878787878,20,13,7,308.50319221690404,0.43981743338360985,0.2250260076730921,0.16168909970410966,126938.88440544186,-2532.5250319493007,124406.35937349255,1205,0,303.13461538461536,47,5,15,40.29641154851119,0.5729166666666667,48.06857638888887,1007.7256944444414,21.440972222222157,8
3389,4,1,1,52,0.018867924528301886,0.018867924528301886,0.9811320754716981,53,1750,1200,550,0.6857142857142857,23,12,11,307.5919131059151,0.44229257377842285,0.2414346478039351,0.1626610509918181,127302.17013888896,-2768.2071638695948,124533.96297501937,1206,0,298.39622641509436,44,9,16,39.94804569226535,0.5802556818181819,47.708333333333336,1009.1666666666673,22.935606060606077,0
3390,4,1,0,53,0.018867924528301886,0.0,1.0,53,1550,1000,550,0.6451612903225806,21,10,11,305.5652758181137,0.44344158200290273,0.2534591747001218,0.16245007873988657,127516.97698965088,-2807.047950933056,124709.92903871782,1207,0,299.22641509433964,46,7,15,39.779908715878165,0.5799365942028986,47.49556737588652,1010.0177304964536,21.956907184705514,0
3391,4,1,0,54,0.018518518518518517,0.0,1.0,54,1550,1100,450,0.7096774193548387,20,11,9,306.6384599305857,0.4444590030281854,0.2648218205595252,0.1645225295838663,127886.3705877759,-2957.0240553704484,124929.34653240546,1208,0,294.6666666666667,48,6,17,39.37613843351549,0.5813802083333333,47.130102040816325,1011.4795918367345,21.072491496598634,0
3392,4,1,1,54,0.01818181818181818,0.01818181818181818,0.9818181818181818,55,1300,1000,300,0.7692307692307693,16,10,6,303.6461244051548,0.445861391694725,0.27145529367751564,0.16396890717878382,128144.53125000017,-3217.621636239517,124926.90961376065,1209,0,290.2909090909091,48,7,18,39.188957475994535,0.583984375,46.87500000000001,1012.5000000000014,21.09375000000003,0
3393,4,0,0,54,0.0,0.0,1.0,54,1200,1000,200,0.8333333333333334,14,10,4,305.39417107578913,0.44398584905660377,0.278387387562663,0.16500530851597298,128166.97239198258,-2971.7107414113716,125195.2616505712,1210,1,296.35185185185185,46,8,18,39.12187007529331,0.5865036231884058,46.85283687943264,1012.5886524822718,22.012796793092864,0
3394,4,0,0,54,0.0,0.0,1.0,54,1600,1300,300,0.8125,19,13,6,305.22691662667205,0.4437456324248777,0.2820420595573687,0.1656573436392627,128346.57226120456,-2965.034297822009,125381.53796338255,1211,2,297.35185185185185,46,8,18,38.9433872849227,0.5883152173913043,46.67553191489363,1013.2978723404287,22.028214616096278,0
3395,4,2,0,56,0.03571428571428571,0.0,1.0,56,2100,1400,700,0.6666666666666666,28,14,14,301.01233754843395,0.44704410173160175,0.3086217826045352,0.16583447230989398,128942.16530149496,-3437.3634828080712,125504.80181868689,1212,0,287.69642857142856,48,8,19,38.44538401428891,0.5920138888888888,46.08843537414967,1015.646258503403,21.15929705215423,0
3396,4,1,0,57,0.017543859649122806,0.0,1.0,57,1800,1300,500,0.7222222222222222,23,13,10,308.05826485071407,0.44723788638262324,0.2309985914146797,0.168177883546243,128580.5332798387,-3333.332366233147,125247.20091360554,1213,0,283.63157894736844,45,12,13,38.63376722931736,0.5918981481481482,46.44474637681159,1014.2210144927528,22.538244766505617,8
3397,4,0,1,56,0.0,0.017543859649122806,0.9824561403508771,57,1450,1000,450,0.6896551724137931,19,10,9,312.74065662962664,0.44685933583959897,0.2400448541457194,0.17122780232478382,128695.39372637043,-3350.34361216132,125345.05011420911,1214,1,284.63157894736844,45,12,14,38.39827709337617,0.5930555555555556,46.33152173913043,1014.6739130434776,22.548309178743946,0
3398,4,0,2,54,0.0,0.03571428571428571,0.9642857142857143,56,1950,1400,550,0.717948717948718,25,14,11,319.1438106526193,0.44517721861471865,0.24057096955169133,0.1749357756630112,128741.35226318007,-2982.5988500314957,125758.75341314857,1215,2,290.5892857142857,45,11,15,38.189114006902315,0.5935185185185186,46.286231884057976,1014.8550724637687,22.552334943639305,0
3399,4,1,1,54,0.01818181818181818,0.01818181818181818,0.9818181818181818,55,1700,1400,300,0.8235294117647058,20,14,6,320.94051246670193,0.4449915824915825,0.2481535231022436,0.1768405880240359,128948.26721178598,-2723.055407871234,126225.21180391475,1216,0,293.1272727272727,45,10,16,37.93318395314964,0.5956018518518518,46.08242753623189,1015.6702898550733,22.570450885668297,0
3400,4,1,1,54,0.01818181818181818,0.01818181818181818,0.9818181818181818,55,1450,900,550,0.6206896551724138,20,9,11,337.677075566861,0.445496632996633,0.22621914509331686,0.17582496003653802,126672.22222222229,-2160.469176643556,124511.75304557873,1217,0,293.07272727272726,39,16,17,39.83512693156731,0.5811965811965811,48.333333333333336,1006.6666666666673,25.811965811965827,8
3401,4,1,1,54,0.01818181818181818,0.01818181818181818,0.9818181818181818,55,1100,800,300,0.7272727272727273,14,8,6,336.4550815123137,0.44628226711560043,0.23460410557184774,0.1760927244798212,126882.03124999988,-2461.9791666666815,124420.0520833332,1218,0,293.90909090909093,39,16,19,39.65053763440859,0.5833333333333333,48.12499999999999,1007.4999999999991,25.83333333333331,0
3402,4,2,0,56,0.03571428571428571,0.0,1.0,56,1500,1000,500,0.6666666666666666,20,10,10,328.48980017400254,0.4485592532467533,0.2613000073675684,0.17450458151709317,127486.19927300327,-2824.069552951407,124662.12972005186,1219,0,287.625,39,17,15,39.23252965446106,0.5894764957264957,47.52604166666666,1009.8958333333317,25.894764957264915,0
3403,4,0,0,56,0.0,0.0,1.0,56,1650,1200,450,0.7272727272727273,21,12,9,325.43309597194207,0.448626893939394,0.2600515463917532,0.17344511158944131,127617.73003472199,-2893.793402777803,124723.93663194418,1220,1,288.625,39,17,15,39.175257731958766,0.5908119658119658,47.39583333333332,1010.4166666666647,25.908119658119606,0
3404,4,3,1,58,0.05084745762711865,0.01694915254237288,0.9830508474576272,59,1500,1300,200,0.8666666666666667,17,13,4,313.16745455560107,0.4518921683226183,0.2897747634153143,0.17017652743297926,128395.77034517465,-3757.03961561481,124638.73072955984,1221,0,274.89830508474574,41,18,12,38.69216588358131,0.5955284552845528,46.626984126984105,1013.4920634920597,24.719318621757555,0
3405,4,1,3,56,0.01694915254237288,0.05084745762711865,0.9491525423728814,59,1450,900,550,0.6206896551724138,20,9,11,344.6886562952927,0.45125901032534577,0.2808450507387592,0.18397440994929717,127676.20991941041,-2957.871070238766,124718.33884917165,1222,0,275.8813559322034,44,15,13,38.62898915865019,0.5840435606060606,47.337962962962976,1010.6481481481503,22.969276094276143,8
3406,4,1,1,56,0.017543859649122806,0.017543859649122806,0.9824561403508771,57,1700,1000,700,0.5882352941176471,24,10,14,353.94314724217617,0.4518196532999164,0.2977732728871132,0.1897331601318233,127850.36886492727,-2349.647613574881,125500.72125135238,1223,0,276.29824561403507,42,15,14,38.216800804828964,0.5885416666666667,47.16569767441862,1011.3372093023279,24.079457364341142,0
3407,4,1,2,55,0.017543859649122806,0.03508771929824561,0.9649122807017544,57,1650,1400,250,0.8484848484848485,19,14,5,354.2681942070791,0.4514019423558897,0.30242496321232015,0.19072046496385253,128021.92251066657,-2329.1809386454956,125692.74157202107,1224,0,277.2105263157895,42,15,15,38.033001404315094,0.5902777777777778,46.99612403100776,1012.0155038759701,24.095607235142147,0
3408,4,1,0,56,0.017857142857142856,0.0,1.0,56,1650,1100,550,0.6666666666666666,22,11,11,353.9158245619818,0.4494182900432901,0.2975578271273245,0.1914746503949804,128219.87714356607,-2124.13260697619,126095.74453658989,1225,0,275.125,41,15,16,37.83946762660399,0.59375,46.800595238095255,1012.7976190476215,24.702380952381013,0
3409,4,0,0,56,0.0,0.0,1.0,56,1700,1200,500,0.7058823529411765,22,12,10,373.33850612483553,0.4490192099567099,0.27754837187352477,0.1904439803751872,125829.97163574686,-1804.565272755955,124025.4063629909,1226,1,276.125,43,13,15,39.80700408997955,0.5666182170542635,49.17140151515152,1003.3143939393955,23.332892882311523,8
3410,4,3,2,57,0.05084745762711865,0.03389830508474576,0.9661016949152542,59,1500,1000,500,0.6666666666666666,20,10,10,327.13517157470096,0.4546196181570232,0.16070434634831576,0.17023870034411553,126648.92082475996,-3241.987346148425,123406.93347861154,1227,0,263.03389830508473,44,15,20,40.124336920859776,0.5736268939393939,48.35648148148148,1006.5740740740741,22.8766835016835,8
3411,4,1,1,57,0.017241379310344827,0.017241379310344827,0.9827586206896551,58,1650,1200,450,0.7272727272727273,21,12,9,327.58887320259964,0.45147081064730793,0.18437137706450413,0.1712081314318277,126823.98159675053,-3290.7749547306594,123533.20664201987,1228,0,268.48275862068965,46,12,21,39.93336707152495,0.5729166666666667,48.18262411347517,1007.2695035460982,21.897163120567352,0
3412,4,2,1,58,0.03389830508474576,0.01694915254237288,0.9830508474576272,59,1350,700,650,0.5185185185185185,20,7,13,319.6077234097285,0.4537551139684395,0.2085905981815983,0.16891779678560678,127278.8108710559,-3663.010070024703,123615.8008010312,1229,0,261.6101694915254,44,15,23,39.668784792316636,0.5800189393939394,47.73148148148147,1009.0740740740713,22.93350168350162,0
3413,4,0,1,57,0.0,0.017241379310344827,0.9827586206896551,58,1800,1100,700,0.6111111111111112,25,11,14,324.67490475129154,0.45276895543456347,0.2100841287451205,0.17212129087784733,127402.53318877665,-3327.1189343721585,124075.41425440449,1230,1,266.98275862068965,43,15,18,39.41439592908731,0.5826065891472868,47.6089015151515,1009.5643939393914,23.478241719520728,0
3414,4,1,0,58,0.017241379310344827,0.0,1.0,58,1400,1000,400,0.7142857142857143,18,10,8,322.9453045049543,0.45297691066747325,0.22662038645451021,0.1726697764243432,127746.40346364869,-3348.9797668038536,124397.42369684484,1231,0,267.7413793103448,44,14,20,39.106673994016,0.5847537878787878,47.26851851851851,1010.9259259259247,22.9755892255892,0
3415,4,0,1,57,0.0,0.017241379310344827,0.9827586206896551,58,1950,1500,450,0.7692307692307693,24,15,9,337.6215718425014,0.4529643073200242,0.2500612845236152,0.1737515894116287,126193.31065759638,-3044.2467316144566,123149.06392598191,1232,1,268.7413793103448,41,17,19,40.32879146919433,0.5731707317073171,48.80952380952381,1004.7619047619047,24.506387921022068,8
3416,4,2,0,59,0.03389830508474576,0.0,1.0,59,1650,1100,550,0.6666666666666666,22,11,11,335.20601007638237,0.4542056302357296,0.2837571950188946,0.17449754589186822,126662.68957328987,-3308.3810405188087,123354.30853277106,1233,0,265.08474576271186,43,16,16,39.907102539981196,0.5750968992248062,48.34280303030304,1006.6287878787891,23.409971811134632,0
3417,4,3,3,59,0.04838709677419355,0.04838709677419355,0.9516129032258065,62,1550,900,650,0.5806451612903226,22,9,13,324.19954981008783,0.4574905252952582,0.3160299671846951,0.17200403813753123,127434.21744486499,-4134.271339588177,123299.94610527682,1234,0,253.20967741935485,42,20,16,39.393993921944976,0.5843253968253967,47.57751937984496,1009.6899224806193,24.040236249538555,0
3418,4,2,4,57,0.03278688524590164,0.06557377049180328,0.9344262295081968,61,1350,1000,350,0.7407407407407407,17,10,7,299.38963273411264,0.45635245901639343,0.21701637407974506,0.1570900981318032,126984.85819710526,-4594.435854398831,122390.42234270643,1235,0,258.0327868852459,48,13,17,40.47902781293063,0.572265625,48.022959183673464,1007.9081632653052,20.99808673469386,8
3419,4,3,4,56,0.05,0.06666666666666667,0.9333333333333333,60,1350,1000,350,0.7407407407407407,17,10,7,292.6929605171187,0.459245527306968,0.24378885546483353,0.1555725260674588,127508.11635712032,-4535.718809504592,122972.39754761574,1236,0,259.43333333333334,47,13,12,40.113970061595765,0.5786790780141844,47.50434027777777,1009.9826388888877,21.488992316784845,0
3420,4,0,3,53,0.0,0.05357142857142857,0.9464285714285714,56,1600,1100,500,0.6875,21,11,10,311.5031639229921,0.4542816558441558,0.2342514941199163,0.16370485423186987,127049.14618908754,-3284.7577976769207,123764.38839141061,1237,1,278.89285714285717,48,8,18,40.1080325011246,0.5729166666666667,47.959183673469376,1008.1632653061197,21.00340136054416,0
3421,4,2,1,54,0.03636363636363636,0.01818181818181818,0.9818181818181818,55,1500,1200,300,0.8,18,12,6,310.5286824331742,0.45416666666666666,0.24885766896269557,0.16491423652725934,127474.24529384756,-3083.0891898137766,124391.15610403378,1238,0,281.0,43,12,14,39.69820580145037,0.5833333333333333,47.53787878787879,1009.8484848484848,23.484848484848484,0
3422,4,0,2,52,0.0,0.037037037037037035,0.962962962962963,54,1850,1300,550,0.7027027027027027,24,13,11,316.8078521411027,0.4535945143256464,0.24393221163028955,0.1683485671691508,127498.15381262898,-2721.5167477330224,124776.63706489596,1239,1,287.2037037037037,43,11,15,39.51525629004533,0.5835755813953488,47.51420454545454,1009.9431818181806,23.487050739957688,0
3423,4,1,2,51,0.018867924528301886,0.03773584905660377,0.9622641509433962,53,1550,1100,450,0.7096774193548387,20,11,9,325.0719689211616,0.45301161103047893,0.24875403832966936,0.17387115932877384,127761.29548324173,-2293.6768250688483,125467.61865817288,1240,0,291.0943396226415,43,10,16,39.03771699762708,0.5862403100775193,47.25378787878789,1010.9848484848502,23.511275546159307,0
3424,4,2,4,49,0.03773584905660377,0.07547169811320754,0.9245283018867925,53,1550,1300,250,0.8387096774193549,18,13,5,329.0924422999468,0.4534349298500242,0.26575275786537556,0.17729470117204116,128050.79839677628,-2171.8900034293647,125878.90839334692,1241,0,291.75471698113205,44,9,18,38.640487299118725,0.5878314393939394,46.96759259259259,1012.1296296296287,23.002946127946107,0
3425,4,0,0,49,0.0,0.0,1.0,49,1150,700,450,0.6086956521739131,16,7,9,345.34788683342066,0.45115858843537415,0.25399196477303976,0.1844699292398069,127707.59489226001,-979.2903942758827,126728.30449798412,1242,1,312.83673469387753,40,9,18,38.580208123868886,0.5901041666666667,47.306910569105696,1010.7723577235781,25.269308943089452,0
3426,4,0,0,49,0.0,0.0,1.0,49,1650,1200,450,0.7272727272727273,21,12,9,344.31021016298956,0.45082199546485263,0.25383383535268833,0.18473959685995897,127887.4194944314,-993.4111433339724,126894.00835109742,1243,2,313.83673469387753,40,9,18,38.42246056465389,0.5919270833333333,47.12906504065042,1011.4837398373996,25.28709349593499,0
3427,4,0,0,49,0.0,0.0,1.0,49,700,500,200,0.7142857142857143,9,5,4,342.70845604261405,0.4505562641723356,0.25876165470707724,0.1843515989636042,127990.23321311738,-1027.332957399675,126962.9002557177,1244,3,314.83673469387753,40,9,18,38.35785544508054,0.59296875,47.027439024390254,1011.8902439024405,25.29725609756101,0
3428,4,3,1,51,0.057692307692307696,0.019230769230769232,0.9807692307692307,52,1400,1100,300,0.7857142857142857,17,11,6,327.2774251005692,0.4549082453494218,0.28214897646316195,0.18010815716824877,128898.98667800461,-1962.668407140754,126936.31827086386,1245,0,297.61538461538464,41,11,18,37.82239155920283,0.600609756097561,46.13095238095239,1015.476190476191,24.76771196283393,0
3429,4,2,0,53,0.03773584905660377,0.0,1.0,53,1800,1300,500,0.7222222222222222,23,13,10,324.90895689427884,0.45568759071117565,0.2866818857486375,0.1802976877910778,129227.86593967024,-2201.4788500035315,127026.3870896667,1246,0,292.9622641509434,39,14,20,37.54834289519518,0.6071047008547008,45.80729166666667,1016.7708333333342,26.07104700854703,0
3430,4,1,3,51,0.018518518518518517,0.05555555555555555,0.9444444444444444,54,1600,1000,600,0.625,22,10,12,319.20742124422304,0.4557491847193105,0.2840104160887147,0.17806261331021772,129433.96297053678,-2536.743691750934,126897.21927878585,1247,0,288.51851851851853,40,14,14,37.48418722327641,0.6075520833333333,45.60467479674797,1017.5813008130087,25.43953252032522,0
3431,4,2,4,49,0.03773584905660377,0.07547169811320754,0.9245283018867925,53,1150,800,350,0.6956521739130435,15,8,7,321.8861128685399,0.4557934204160619,0.29216249788682247,0.18080561307079662,129706.17992567371,-2249.876385739506,127456.3035399342,1248,0,292.9433962264151,41,12,17,37.14006297883392,0.608739837398374,45.337301587301575,1018.6507936507916,24.845141308555892,0
3432,4,0,1,48,0.0,0.02040816326530612,0.9795918367346939,49,1600,1300,300,0.8125,19,13,6,337.41522775592387,0.4527352607709751,0.29398126323187834,0.18814652395476655,129418.71667031899,-1066.4308477610068,128352.28582255798,1249,1,314.1224489795918,38,11,20,37.036478020439574,0.6107456140350878,45.619658119658105,1017.5213675213655,26.776878092667513,0
3433,4,0,0,48,0.0,0.0,1.0,48,1150,800,350,0.6956521739130435,15,8,7,341.5816982258062,0.45290336879432624,0.2902115499072231,0.19007594090051994,129337.1973505185,-764.1560970487433,128573.04125346975,1250,2,319.7291666666667,38,10,20,37.01335644014984,0.6099232456140351,45.69978632478632,1017.2008547008534,26.7684435447593,0
3434,4,0,0,48,0.0,0.0,1.0,48,1100,900,200,0.8181818181818182,13,9,4,342.50210963406033,0.4527556146572104,0.294066558157444,0.19085123405764493,129391.54071015025,-736.6248675944458,128654.9158425558,1251,3,320.7291666666667,38,10,20,36.934701949665715,0.6104714912280702,45.64636752136751,1017.414529914528,26.774066576698104,0
3435,4,1,1,48,0.02040816326530612,0.02040816326530612,0.9795918367346939,49,1400,1000,400,0.7142857142857143,18,10,8,335.93375373675616,0.45342616213151926,0.2938441569283794,0.18857473207300532,129680.91699932254,-1087.1605528785958,128593.75644644393,1252,0,315.16326530612247,41,8,18,36.807956722184315,0.6084857723577235,45.362103174603156,1018.5515873015846,24.842721641502063,0
3436,4,0,1,47,0.0,0.020833333333333332,0.9791666666666666,48,1450,1100,350,0.7586206896551724,18,11,7,333.7986041874381,0.45304188829787234,0.2831131605184454,0.18830146231721026,129873.84018276125,-929.6586853063964,128944.18149745486,1253,1,318.5416666666667,40,8,18,36.666666666666686,0.6119791666666667,45.17276422764226,1019.3089430894282,25.482723577235706,0
3437,4,1,1,47,0.020833333333333332,0.020833333333333332,0.9791666666666666,48,900,500,400,0.5555555555555556,13,5,8,331.8016880545574,0.45234929078014185,0.2844898174271171,0.18770443321479305,129984.23450688118,-974.2023140274935,129010.03219285369,1254,0,319.3541666666667,41,7,19,36.60568067581152,0.6115345528455285,45.06448412698411,1019.7420634920612,24.871757646147834,0
3438,4,2,2,47,0.04081632653061224,0.04081632653061224,0.9591836734693877,49,1050,500,550,0.47619047619047616,16,5,11,328.92369942910466,0.4528061224489796,0.2977618425006292,0.1882882133634031,130444.20070725092,-1218.1667519264502,129226.03395532447,1255,0,313.1224489795918,40,9,22,36.21356446478311,0.6177083333333333,44.61382113821138,1021.5447154471541,25.53861788617885,0
3439,4,1,1,47,0.020833333333333332,0.020833333333333332,0.9791666666666666,48,1450,1100,350,0.7586206896551724,18,11,7,328.5224130732144,0.4523954639479906,0.2937164434956987,0.1891481558174604,130667.99433893904,-1014.5270376669441,129653.46730127209,1256,0,312.6458333333333,41,7,19,35.99763891584189,0.6183943089430894,44.39484126984126,1022.420634920633,24.937088656600807,0
3440,4,1,1,47,0.020833333333333332,0.020833333333333332,0.9791666666666666,48,1400,1000,400,0.7142857142857143,18,10,8,334.3082161150163,0.4523769946808511,0.3075203547542893,0.1938762150454538,130947.0773986678,-844.6632298752834,130102.41416879251,1257,0,313.6041666666667,41,7,21,35.56781283318794,0.6211890243902439,44.12202380952381,1023.5119047619047,24.9637049941928,0
3441,4,0,1,46,0.0,0.02127659574468085,0.9787234042553191,47,1300,900,400,0.6923076923076923,17,9,8,344.17253299043597,0.45222402096823927,0.3168393404656802,0.19927965696841307,130885.78976014632,-390.54124115933814,130495.24851898698,1258,1,321.21276595744683,40,7,21,35.377354586685215,0.6221354166666666,44.1819105691057,1023.2723577235791,25.581808943089477,0
3442,4,1,2,45,0.02127659574468085,0.0425531914893617,0.9574468085106383,47,1250,700,550,0.56,18,7,11,340.73633419260995,0.4532261794634598,0.313094620307905,0.19957413859852882,131328.12500000015,-450.3472222222095,130877.77777777794,1259,0,311.36170212765956,40,7,22,35.018631436314365,0.6265625,43.75000000000001,1025.0000000000011,25.62500000000003,0
3443,4,1,0,46,0.021739130434782608,0.0,1.0,46,1100,900,200,0.8181818181818182,13,9,4,348.3983941858349,0.4540056360708535,0.32387579277145284,0.20436977968220618,131385.8453047642,-45.076495414330395,131340.76880934986,1260,0,304.8695652173913,36,10,23,34.76402314001174,0.6342592592592593,43.693693693693696,1025.2252252252251,28.478478478478475,0
3444,4,0,0,46,0.0,0.0,1.0,46,1800,1400,400,0.7777777777777778,22,14,8,347.2346918423643,0.4536634460547504,0.31473172734085275,0.20445771221668374,131530.20154867708,-65.63019945620545,131464.57134922087,1261,1,305.8695652173913,36,10,23,34.648195923445684,0.6357060185185186,43.55292792792793,1025.7882882882886,28.49411911911913,0
3445,4,0,0,46,0.0,0.0,1.0,46,1600,1200,400,0.75,20,12,8,317.15017350457424,0.45273752012882446,0.2357611768245902,0.177117236253861,129478.90216561154,-987.148742598903,128491.75342301263,1262,2,306.8695652173913,41,5,16,37.49096321928711,0.6064532520325203,45.560515873015866,1017.7579365079359,24.823364305071607,8
3446,4,1,0,47,0.02127659574468085,0.0,1.0,47,850,500,350,0.5882352941176471,12,5,7,340.7158296996955,0.4539777983348751,0.20112506224178062,0.1851105590224116,128388.03624260335,-343.14683364308104,128044.88940896027,1263,0,301.3191489361702,38,9,14,38.00205566097405,0.600328947368421,46.63461538461537,1013.4615384615367,26.670040485829915,8
3447,4,0,1,46,0.0,0.02127659574468085,0.9787234042553191,47,1900,1700,200,0.8947368421052632,21,17,4,341.65168714365603,0.45376580326857846,0.20461489832472912,0.18625021037796854,128523.41666894921,-617.9515715173092,127905.46509743191,1264,1,302.3191489361702,38,9,14,37.84023460822534,0.6016995614035088,46.50106837606836,1013.9957264957239,26.684098065676945,0
3448,4,0,1,45,0.0,0.021739130434782608,0.9782608695652174,46,1100,800,300,0.7272727272727273,14,8,6,304.2696183018045,0.4524959742351047,0.08680228438034066,0.16241208387348116,127678.93024006976,-1430.236126134242,126248.69411393552,1265,2,309.7826086956522,42,4,19,39.647451262384145,0.5868055555555556,47.33527131782946,1010.6589147286827,24.063307493540066,8
3449,4,0,1,44,0.0,0.022222222222222223,0.9777777777777777,45,1250,900,350,0.72,16,9,7,305.05999374143215,0.45288299663299664,0.09271399058633101,0.16323056280503095,127776.88108436998,-1204.0770912204757,126572.8039931495,1266,3,315.6222222222222,42,3,19,39.52762603028561,0.5877976190476191,47.23837209302326,1011.0465116279073,24.07253599114065,0
3450,4,2,2,44,0.043478260869565216,0.043478260869565216,0.9565217391304348,46,1650,1200,450,0.7272727272727273,21,12,9,307.3002841275425,0.45458937198067634,0.11523439202796837,0.16712175757296133,128427.6523977131,-1305.244714334038,127122.40768337906,1267,0,309.04347826086956,40,6,13,38.80840184479648,0.5973958333333333,46.59552845528456,1013.6178861788626,25.340447154471565,0
3451,4,2,0,46,0.043478260869565216,0.0,1.0,46,1300,700,600,0.5384615384615384,19,7,12,306.54604841664093,0.45383454106280197,0.13193485880995426,0.1679024845551379,128711.08596280344,-1308.8250421375942,127402.26092066584,1268,0,309.8478260869565,40,6,15,38.5394758804874,0.6002604166666667,46.31605691056912,1014.7357723577252,25.36839430894313,0
3452,4,0,1,45,0.0,0.021739130434782608,0.9782608695652174,46,850,600,250,0.7058823529411765,11,6,5,327.2061334565353,0.45344202898550723,0.13696410595843855,0.1745653026714814,127658.21468195257,-758.1935016158965,126900.02118033667,1269,1,310.8478260869565,38,8,17,39.089095041759165,0.5929276315789473,47.355769230769226,1010.5769230769223,26.59412955465585,8
3453,4,4,5,44,0.08163265306122448,0.10204081632653061,0.8979591836734694,49,1150,800,350,0.6956521739130435,15,8,7,309.7532149401764,0.4572526927437642,0.17379868363460793,0.16889167096574204,128530.68300118975,-1836.5169881719435,126694.1660130178,1270,0,292.3061224489796,40,9,16,38.64146956637934,0.5984375,46.49390243902439,1014.0243902439023,25.35060975609756,0
3454,4,1,2,43,0.022222222222222223,0.044444444444444446,0.9555555555555556,45,1800,1400,400,0.7777777777777778,22,14,8,322.06121542231534,0.45528198653198654,0.1813663141374755,0.1750942550551001,128415.1066207352,-728.4949366279945,127686.6116841072,1271,0,317.93333333333334,38,7,17,38.447129405150925,0.6006030701754386,46.60790598290596,1013.5683760683726,26.672852001799278,0
3455,4,2,0,45,0.044444444444444446,0.0,1.0,45,1350,1000,350,0.7407407407407407,17,10,7,317.0095684958116,0.45481902356902354,0.20637395705101969,0.17439104253370027,128883.87586805543,-828.51562500001,128055.36024305542,1272,0,318.0444444444444,39,6,19,38.098413349746956,0.6036324786324787,46.14583333333333,1015.4166666666656,26.03632478632476,0
3456,4,1,2,44,0.021739130434782608,0.043478260869565216,0.9565217391304348,46,950,600,350,0.631578947368421,13,6,7,311.4232945387295,0.4548309178743961,0.20370099673844555,0.17293622622051477,129255.70371283496,-1148.571332365421,128107.13238046954,1273,0,312.10869565217394,38,8,20,37.862908874413385,0.6091008771929824,45.77991452991452,1016.8803418803406,26.760008996851067,0
3457,4,0,2,42,0.0,0.045454545454545456,0.9545454545454546,44,1300,900,400,0.6923076923076923,17,9,8,320.12989019137075,0.45356545102184637,0.19302425515660815,0.17801615389146308,129310.02995105548,-520.7988622251581,128789.23108883032,1178,1,297.5681818181818,38,6,20,37.58644082633053,0.6096491228070176,45.72649572649572,1017.0940170940162,26.7656320287899,0
3458,4,0,1,41,0.0,0.023809523809523808,0.9761904761904762,42,1050,500,550,0.47619047619047616,16,5,11,327.1781502954654,0.4533246225319396,0.1857965420693799,0.18183051540420614,129287.27027280675,59.993988921372676,129347.26426172812,1179,2,308.23809523809524,36,6,21,37.43033255822538,0.6131365740740741,45.74887387387388,1017.0045045045058,28.250125125125162,0
3459,4,0,0,41,0.0,0.0,1.0,41,1150,800,350,0.6956521739130435,15,8,7,331.72197695954526,0.4525152439024391,0.17760759177557617,0.1847804928691004,129377.95380015444,383.50212191359367,129761.45592206804,1180,3,296.5121951219512,35,6,22,37.222696245733786,0.6160714285714286,45.65972222222223,1017.3611111111121,29.067460317460345,0
3460,4,2,1,42,0.046511627906976744,0.023255813953488372,0.9767441860465116,43,750,400,350,0.5333333333333333,11,4,7,316.32473135284306,0.45542635658914726,0.18498601849860163,0.1786869594239816,129927.00277970158,-380.1751500461535,129546.82762965542,1181,0,283.6744186046512,37,6,19,37.05814870581488,0.6176801801801801,45.120614035087726,1019.5175438596502,27.55452821242298,0
3461,4,0,0,42,0.0,0.0,1.0,42,900,500,400,0.5555555555555556,13,5,8,323.02363113766705,0.45515147115756877,0.18951076176797144,0.18216117666212023,129860.54202428806,-10.395234761752675,129850.1467895263,1182,1,291.3333333333333,36,6,19,36.9547103450816,0.6189236111111112,45.18581081081083,1019.2567567567589,28.31268768768775,0
3462,4,1,1,42,0.023255813953488372,0.023255813953488372,0.9767441860465116,43,1050,800,250,0.7619047619047619,13,8,5,316.2723486951295,0.45508028792912514,0.19381874051907322,0.1796976325036993,130153.5462437908,-367.20644769521687,129786.33979609558,1183,0,285.5348837209302,38,5,20,36.83034935259835,0.6181469298245614,44.89850427350428,1020.4059829059842,26.852789023841687,0
3463,4,1,1,42,0.023255813953488372,0.023255813953488372,0.9767441860465116,43,1300,900,400,0.6923076923076923,17,9,8,324.9562517950844,0.45362679955703217,0.12741829133132865,0.17357759830042502,127707.59489226011,-300.1237276092031,127407.47116465091,1184,0,286.30232558139534,40,3,15,39.09549064950736,0.5901041666666667,47.3069105691057,1010.7723577235789,25.269308943089474,8
3464,4,1,1,42,0.023255813953488372,0.023255813953488372,0.9767441860465116,43,950,800,150,0.8421052631578947,11,8,3,323.1456788662287,0.45521871539313397,0.09961423783279888,0.17075643669307,127271.40472147867,-289.97145383038634,126981.43326764829,1185,0,287.25581395348837,40,3,16,39.587110148722594,0.5856770833333333,47.738821138211385,1009.0447154471549,25.226117886178873,8
3465,4,2,1,43,0.045454545454545456,0.022727272727272728,0.9772727272727273,44,950,600,350,0.631578947368421,13,6,7,315.9353146194121,0.4580800739957717,0.12218668878957328,0.16901295492317214,127768.13394628686,-726.7068806689329,127041.42706561793,1186,0,281.59090909090907,41,3,14,39.26166470415071,0.5891768292682926,47.24702380952381,1011.0119047619048,24.65882694541231,0
3466,4,2,1,44,0.044444444444444446,0.022222222222222223,0.9777777777777777,45,1100,600,500,0.5454545454545454,16,6,10,311.321444106133,0.46138468013468015,0.12707283359914934,0.168216602425496,128169.06003996165,-1019.6446277266882,127149.41541223496,1187,0,274.02222222222224,42,3,17,38.969696969696976,0.591765873015873,46.850775193798455,1012.5968992248071,24.109449981543026,0
3467,4,2,3,43,0.043478260869565216,0.06521739130434782,0.9347826086956522,46,1150,800,350,0.6956521739130435,15,8,7,311.2546842241566,0.4619162640901771,0.13759588404172773,0.16959816305282677,128504.33601820772,-1200.4846942435652,127303.85132396415,1188,0,268.95652173913044,43,3,15,38.630199090937396,0.59375,46.51988636363637,1013.9204545454552,23.57954545454547,0
3468,4,0,2,41,0.0,0.046511627906976744,0.9534883720930233,43,850,600,250,0.7058823529411765,11,6,5,326.9352592768239,0.46052510151347364,0.074423417028598,0.17034120112725076,126698.43885633674,-301.7302149692992,126396.70864136744,1189,1,284.69767441860466,39,4,17,40.07856958096224,0.5814636752136753,48.307291666666664,1006.7708333333328,25.81463675213674,8
3469,4,3,1,43,0.06818181818181818,0.022727272727272728,0.9772727272727273,44,1050,800,250,0.7619047619047619,13,8,5,324.51484963988025,0.45973176532769555,0.1255946293359853,0.17172170279414536,127328.45187717023,-535.394965277768,126793.05691189246,1190,0,279.0681818181818,39,5,17,39.49420734853957,0.5878739316239316,47.68229166666667,1009.2708333333342,25.878739316239336,0
3470,4,0,0,43,0.0,0.0,1.0,43,1600,1100,500,0.6875,21,11,10,329.97110636118,0.458656330749354,0.11793505651954783,0.1747224054994447,127354.73632812526,-195.32335069441461,127159.41297743085,1191,1,286.4651162790698,39,4,17,39.3296353629171,0.5881410256410257,47.656250000000014,1009.375000000002,25.88141025641031,0
3471,4,1,2,42,0.022727272727272728,0.045454545454545456,0.9545454545454546,44,950,700,250,0.7368421052631579,12,7,5,348.88801251314305,0.45948951726568005,0.13447073066656112,0.1792576041858046,126126.4298269657,71.32939943056249,126197.75922639626,1192,0,280.9318181818182,37,7,21,40.114684532256305,0.5791103603603603,48.876096491228054,1004.4956140350854,27.148530109056363,8
3472,4,1,0,43,0.023255813953488372,0.0,1.0,43,1300,800,500,0.6153846153846154,18,8,10,324.4899658565305,0.4587486157253599,0.10582470803187127,0.16214610330433762,124974.59478691606,-473.3820522631396,124501.21273465292,1193,0,285.6511627906977,40,3,22,41.913981773215454,0.5622395833333333,50.02540650406505,999.8983739837415,24.997459349593537,8
3473,4,6,2,47,0.12244897959183673,0.04081632653061224,0.9591836734693877,49,1450,1000,450,0.6896551724137931,19,10,9,297.11633209136136,0.46740362811791386,0.157102983289231,0.15346467428205152,126342.87308673451,-2274.0728881281016,124068.80019860642,1194,0,251.55102040816325,41,8,14,41.19301361752518,0.5746951219512195,48.66071428571428,1005.3571428571414,24.520905923344912,0
3474,4,3,1,49,0.06,0.02,0.98,50,750,500,250,0.6666666666666666,10,5,5,300.12440305850635,0.4683163265306123,0.20132563732563802,0.15685234639482973,126823.46242901527,-2387.4368089358036,124436.02562007947,1195,0,247.46,42,8,17,40.625501042167706,0.578125,48.1831395348837,1007.2674418604618,23.982558139534802,0
3475,4,3,2,50,0.057692307692307696,0.038461538461538464,0.9615384615384616,52,800,500,300,0.625,11,5,6,289.47143626345627,0.4713031045751634,0.23202290667079484,0.1540335158703826,127553.5602154798,-3013.95738899167,124539.60282648813,1196,0,237.3653846153846,40,12,14,40.149019114688144,0.5885416666666667,47.459349593495915,1010.1626016260129,25.254065040650325,0
3476,4,0,2,48,0.0,0.04,0.96,50,1500,1000,500,0.6666666666666666,20,10,10,298.9317705046003,0.46976190476190477,0.22662333642835164,0.1585958211002233,127433.60595703074,-2381.2093098958794,125052.39664713485,1197,1,247.58,39,11,14,40.03243319921596,0.5889423076923077,47.57812499999998,1009.6874999999958,25.88942307692297,0
3477,4,0,1,47,0.0,0.020833333333333332,0.9791666666666666,48,1150,800,350,0.6956521739130435,15,8,7,303.3135362487206,0.4679927600472813,0.20893512150389748,0.16095543127943016,127442.37075617243,-1869.0007716049868,125573.36998456744,1198,2,243.16666666666666,38,10,14,39.91288399816598,0.590734649122807,47.56944444444442,1009.7222222222189,26.571637426900498,0
3478,4,1,2,46,0.020833333333333332,0.041666666666666664,0.9583333333333334,48,1400,1100,300,0.7857142857142857,17,11,6,303.23846179830656,0.4675033244680851,0.21731651376146788,0.16172162275455557,127644.0443250865,-1858.6832682292015,125785.3610568573,1199,0,243.9375,39,9,15,39.70907208878808,0.5910790598290598,47.36979166666665,1010.520833333331,25.91079059829054,0
3479,4,0,0,46,0.0,0.0,1.0,46,1050,600,450,0.5714285714285714,15,6,9,314.41901157259235,0.46560990338164254,0.21512259323344307,0.16651518056826486,127361.47636788628,-1191.0260975966441,126170.45027028964,1200,1,255.30434782608697,38,8,15,39.71519545582841,0.5899122807017544,47.64957264957263,1009.4017094017066,26.56320287899228,0
3480,4,1,0,47,0.02127659574468085,0.0,1.0,47,1350,1100,250,0.8148148148148148,16,11,5,312.15273884346624,0.46448119025593587,0.23197455961574276,0.1670579665816912,127784.64708713365,-1422.3344859211181,126362.31260121253,1201,0,250.85106382978722,40,7,17,39.34042784869502,0.5908854166666666,47.23069105691055,1011.077235772355,25.276930894308876,0
3481,4,1,4,44,0.020833333333333332,0.08333333333333333,0.9166666666666666,48,1500,1100,400,0.7333333333333333,19,11,8,306.05240933197706,0.4654440011820331,0.23368542743608645,0.1654917734202973,128198.62349559873,-1751.382287690205,126447.24120790852,1202,0,246.60416666666666,38,10,19,39.07299469001652,0.5984100877192983,46.8215811965812,1012.7136752136759,26.650359874044103,0
3482,4,2,1,45,0.043478260869565216,0.021739130434782608,0.9782608695652174,46,1350,900,450,0.6666666666666666,18,9,9,318.54900167657354,0.4621880032206119,0.23233136518160635,0.17201646090534997,128144.53125000026,-1035.9374999999714,127108.59375000029,1203,0,242.84782608695653,39,7,21,38.81172839506175,0.5961538461538461,46.875000000000014,1012.500000000002,25.961538461538513,0
3483,4,1,1,45,0.021739130434782608,0.021739130434782608,0.9782608695652174,46,1250,800,450,0.64,17,8,9,320.3690370846779,0.46138285024154585,0.2258569537191839,0.17386493339492948,128344.1443977761,-976.5020087655272,127367.64238901057,1204,0,243.54347826086956,36,10,23,38.56227309772543,0.603587962962963,46.677927927927925,1013.2882882882878,28.146896896896884,0
3484,4,0,0,45,0.0,0.0,1.0,45,1100,900,200,0.8181818181818182,13,9,4,317.96843396266695,0.46121632996632994,0.21616970134006364,0.17302049275955592,128450.017373134,-831.3898266774452,127618.62754645656,1205,1,248.0,37,8,16,38.515301063637985,0.602759009009009,46.5734649122807,1013.7061403508769,27.397463252726403,0
3485,4,0,1,44,0.0,0.022222222222222223,0.9777777777777777,45,1100,800,300,0.7272727272727273,14,8,6,318.2452399865105,0.46151094276094273,0.22166034555415104,0.17360826539953797,128550.50131492448,-817.8829717291186,127732.61834319535,1206,2,249.0,38,7,18,38.406026127265065,0.6019736842105263,46.47435897435898,1014.1025641025648,26.686909581646443,0
3486,4,1,1,44,0.022222222222222223,0.022222222222222223,0.9777777777777777,45,1000,300,700,0.3,17,3,14,321.28471212393276,0.4603956228956229,0.2348244044486547,0.17634465915017242,128794.39153928334,-724.0661982248539,128070.32534105849,1207,0,249.9111111111111,38,7,19,38.0808599094832,0.6044407894736843,46.23397435897436,1015.0641025641024,26.712213225371116,0
3487,4,2,1,45,0.043478260869565216,0.021739130434782608,0.9782608695652174,46,1400,1000,400,0.7142857142857143,18,10,8,309.0120311280125,0.4628824476650564,0.226419384937101,0.17148226000299566,129229.25954380176,-1212.0366995887425,128017.22284421301,1208,0,244.08695652173913,37,9,22,37.951018189007506,0.6106418918918919,45.80592105263157,1016.7763157894722,27.48044096728303,0
3488,4,0,0,45,0.0,0.0,1.0,45,1150,800,350,0.6956521739130435,15,8,7,306.58652767374787,0.46224747474747474,0.22065637944376215,0.1704732833830566,129307.31336805549,-1071.2239583333378,128236.08940972215,1209,1,249.2,39,6,22,37.93356547862899,0.607905982905983,45.729166666666664,1017.0833333333328,26.079059829059815,0
3489,4,0,0,45,0.0,0.0,1.0,45,1900,1500,400,0.7894736842105263,23,15,8,301.2721754961727,0.46212121212121215,0.204045986422406,0.16830934401218434,129492.7856445313,-1197.4853515624975,128295.3002929688,1210,2,250.2,39,6,12,37.88091034694503,0.609775641025641,45.546875,1017.8125000000003,26.09775641025642,0
3490,4,1,4,42,0.021739130434782608,0.08695652173913043,0.9130434782608696,46,850,500,350,0.5882352941176471,12,5,7,296.33923273655637,0.46282206119162644,0.19829747005611442,0.16672823498410308,129770.27253123146,-1508.795401216207,128261.47713001525,1211,0,245.7391304347826,40,6,14,37.72587106855506,0.6109375,45.27439024390244,1018.9024390243907,25.472560975609767,0
3491,4,1,1,42,0.023255813953488372,0.023255813953488372,0.9767441860465116,43,850,300,550,0.35294117647058826,14,3,11,314.9774354099134,0.4601328903654485,0.19767692299986472,0.17641016074888122,129591.85157933176,-436.2981879040088,129155.55339142776,1212,0,245.67441860465115,37,6,15,37.43179697034964,0.6143018018018018,45.44956140350875,1018.2017543859622,27.518966334755735,0
3492,4,0,1,41,0.0,0.023809523809523808,0.9761904761904762,42,950,500,450,0.5263157894736842,14,5,9,323.0482232204427,0.45951897018970195,0.19961424144691065,0.18018912006295784,129430.46932067187,-37.54337107379666,129392.92594959807,1213,2,252.52380952380952,36,6,15,37.39002324037183,0.6145833333333333,45.6081081081081,1017.5675675675662,28.265765765765728,0
3493,4,0,0,41,0.0,0.0,1.0,41,1050,700,350,0.6666666666666666,14,7,7,324.9439560654715,0.45904471544715447,0.18656378156702003,0.18177557938315944,129545.08562616643,218.9785224413348,129764.06414860777,1214,3,230.5609756097561,36,5,16,37.22552544247789,0.6157407407407407,45.49549549549548,1018.0180180180157,28.278278278278215,0
3494,4,1,1,41,0.023809523809523808,0.023809523809523808,0.9761904761904762,42,1000,700,300,0.7,13,7,6,320.76309399930665,0.4589261517615176,0.193947772657451,0.18145357507260018,129982.90339335155,-61.25634810713416,129921.6470452444,1215,0,226.04761904761904,37,5,17,36.88844086021506,0.6182432432432432,45.0657894736842,1019.7368421052611,27.560455192034084,0
3495,4,0,1,40,0.0,0.024390243902439025,0.975609756097561,41,1250,900,350,0.72,16,9,7,328.72009450733964,0.4588160569105691,0.20047794424702214,0.1856458524999968,129917.9389482389,341.3274338527827,130259.26638209168,1216,1,232.26829268292684,36,5,18,36.75139916786332,0.6195023148148149,45.12950450450451,1019.4819819819828,28.318943943943967,0
3496,4,1,0,41,0.024390243902439025,0.0,1.0,41,1700,1200,500,0.7058823529411765,22,12,10,351.2337973834703,0.4580792682926829,0.12443276255266467,0.1881396656612649,127820.21747616709,901.9961319467643,128722.21360811386,1217,0,232.9512195121951,38,3,20,38.316164817749616,0.5945723684210527,47.195512820512825,1011.2179487179494,26.610998650472354,8
3497,4,1,3,39,0.023809523809523808,0.07142857142857142,0.9285714285714286,42,1100,800,300,0.7272727272727273,14,8,6,356.56495411741594,0.45995451025938827,0.1268593307736834,0.18930242413089832,127461.32270361594,827.1758729983968,128288.49857661434,1218,0,228.38095238095238,36,6,18,38.54921750120813,0.5946180555555556,47.550675675675684,1009.7972972972985,28.04992492492496,8
3498,4,1,0,40,0.025,0.0,1.0,40,800,500,300,0.625,11,5,6,355.45203176006396,0.4578525641025641,0.16291642816256457,0.19013309843381224,127763.95486379013,1082.7914684070456,128846.74633219717,1219,0,238.85,35,5,19,38.26714844495325,0.5997023809523809,47.2511574074074,1010.995370370369,28.88558201058197,0
3499,4,1,1,40,0.024390243902439025,0.024390243902439025,0.975609756097561,41,1200,800,400,0.6666666666666666,16,8,8,351.1191970899174,0.4581554878048781,0.18349076554349342,0.1902812227121023,128287.0962178395,808.8124442009619,129095.90866204046,1220,0,234.0,36,5,20,37.84158700163035,0.6030092592592593,46.734234234234236,1013.0630630630634,28.14064064064065,0
3500,4,0,2,38,0.0,0.05,0.95,40,1150,600,550,0.5217391304347826,17,6,11,355.6521620665568,0.4576388888888889,0.18089444825222767,0.1928983287937199,128320.37278163584,1127.483603395071,129447.85638503091,1221,1,239.7,35,5,20,37.69276901987662,0.6053571428571429,46.70138888888889,1013.1944444444448,28.94841269841271,0
3501,4,2,0,40,0.05,0.0,1.0,40,1100,800,300,0.7272727272727273,14,8,6,353.29379833644884,0.4571981837606838,0.19664891256102934,0.19366689237275414,128743.83674214767,1096.8798190082096,129840.71656115589,1222,0,239.85,36,4,19,37.3201472111259,0.6076388888888888,46.28378378378379,1014.8648648648659,28.19069069069072,0
3502,4,2,1,41,0.047619047619047616,0.023809523809523808,0.9761904761904762,42,900,600,300,0.6666666666666666,12,6,6,338.69578807983487,0.45741385985288424,0.19885418591757587,0.18835384473792252,129312.88954293625,360.3578289583277,129673.24737189457,1223,0,229.38095238095238,37,5,21,37.11145249389106,0.6114864864864865,45.723684210526315,1017.1052631578943,27.489331436699846,0
3503,4,1,2,40,0.023809523809523808,0.047619047619047616,0.9523809523809523,42,750,400,350,0.5333333333333333,11,4,7,337.4097208467506,0.457196089818041,0.19383065591596416,0.1887055330326043,129536.03512619268,341.34349030470946,129877.3786164974,1224,0,227.64285714285714,37,5,17,36.91745655608214,0.6137387387387387,45.50438596491228,1017.9824561403509,27.51303935514462,0
3504,4,1,2,39,0.024390243902439025,0.04878048780487805,0.9512195121951219,41,1150,700,450,0.6086956521739131,16,7,9,341.3326836875763,0.45622459349593497,0.19084968025396298,0.19136214870345647,129631.0811444891,649.4649632740877,130280.54610776319,1225,0,232.6341463414634,36,5,18,36.7210826053301,0.6166087962962963,45.41103603603604,1018.3558558558559,28.287662662662665,0
3505,4,0,0,39,0.0,0.0,1.0,39,1050,900,150,0.8571428571428571,12,9,3,354.5115813828116,0.45557804768331084,0.19157577720984387,0.19780450376372524,129443.56575963706,1377.8486394557667,130821.41439909283,1226,1,243.84615384615384,34,5,18,36.57629464982062,0.6188725490196079,45.59523809523809,1017.6190476190466,29.929971988795486,0
3506,4,0,0,39,0.0,0.0,1.0,39,1500,1100,400,0.7333333333333333,19,11,8,357.44037972683054,0.4551282051282051,0.19795207520248503,0.20036336881935154,129625.34722222203,1466.6666666666465,131092.01388888867,1227,2,244.84615384615384,34,5,18,36.31683033278779,0.6207107843137255,45.41666666666666,1018.3333333333318,29.95098039215682,0
3507,4,0,0,39,0.0,0.0,1.0,39,1150,1000,150,0.8695652173913043,13,10,3,358.26692512544895,0.4551282051282051,0.1940052079119503,0.20129284821395055,129716.2857851474,1494.6109693877474,131210.89675453515,1228,3,245.84615384615384,34,5,19,36.20330333839739,0.6216299019607843,45.32738095238095,1018.6904761904763,29.961484593837536,0
3508,4,0,2,37,0.0,0.05128205128205128,0.9487179487179487,39,950,600,350,0.631578947368421,13,6,7,359.77950736076735,0.45493139901034635,0.19616792146574902,0.2029270185785831,129867.9209183674,1544.763321995469,131412.68424036287,1229,4,246.84615384615384,34,5,20,36.01061862493186,0.6231617647058824,45.17857142857143,1019.2857142857148,29.97899159663867,0
3509,4,0,1,36,0.0,0.02702702702702703,0.972972972972973,37,1500,1100,400,0.7333333333333333,19,11,8,373.87016040747767,0.4523898898898899,0.1404391258049793,0.19808428975863387,127378.63363751152,2124.614038108356,129503.24767561987,1230,5,260.81081081081084,32,5,17,38.19731081926202,0.6025390625,47.63257575757576,1009.4696969696972,31.54592803030304,8
3510,4,2,1,37,0.05263157894736842,0.02631578947368421,0.9736842105263158,38,1000,600,400,0.6,14,6,8,359.6424221410244,0.45442152678994785,0.16117840762084001,0.19391499781009053,128084.27047902484,1612.9074546485135,129697.17793367335,1231,0,252.52631578947367,34,4,19,37.83321572778235,0.6050857843137255,46.9345238095238,1012.2619047619039,29.77240896358541,0
3511,4,1,1,37,0.02631578947368421,0.02631578947368421,0.9736842105263158,38,900,600,300,0.6666666666666666,12,6,6,356.1380912099192,0.4548512328117591,0.16744503332108884,0.19308459755867557,128304.38220589771,1538.843899206496,129843.2261051042,1232,0,253.31578947368422,32,6,20,37.69680541708208,0.6119791666666667,46.71717171717174,1013.131313131316,31.660353535353625,0
3512,4,0,1,36,0.0,0.02702702702702703,0.972972972972973,37,1100,900,200,0.8181818181818182,13,9,4,356.7962506346306,0.4527027027027027,0.19492103568536723,0.18882138657180983,127332.20663265284,1721.5472143096345,129053.75384696249,1233,1,260.18918918918916,34,3,19,38.675837461665495,0.5974264705882353,47.678571428571416,1009.2857142857125,29.68487394957978,8
3513,4,2,0,38,0.05263157894736842,0.0,1.0,38,950,400,550,0.42105263157894735,15,4,11,340.03558789643733,0.4512061403508772,0.19435249037655966,0.18257858255072876,127916.59216226343,1099.2387235207989,129015.83088578423,1234,0,252.78947368421052,36,2,21,38.50073286578352,0.5992476851851851,47.100225225225216,1011.5990990990977,28.099974974974934,0
3514,4,0,0,38,0.0,0.0,1.0,38,950,500,450,0.5263157894736842,14,5,9,337.15515217764005,0.4508653390232338,0.1930712783962798,0.18154663586701317,128030.5363429307,1033.230992817131,129063.76733574783,1235,1,253.78947368421052,36,2,21,38.45716961537035,0.6004050925925926,46.98761261261261,1012.049549549549,28.112487487487474,0
3515,4,0,0,38,0.0,0.0,1.0,38,1000,800,200,0.8,12,8,4,338.365532191972,0.4504949027975344,0.18938404990645585,0.1828511452222085,128173.82979948954,1073.9719530395535,129247.80175252909,1236,2,254.78947368421052,35,3,21,38.28020821427209,0.6038690476190476,46.846064814814795,1012.6157407407379,28.931878306878225,0
3516,4,0,0,38,0.0,0.0,1.0,38,1250,700,550,0.56,18,7,11,337.72556808652865,0.4505097202465624,0.18774575231773727,0.18317531741198692,128320.37278163563,1067.4141589505957,129387.78694058621,1237,3,255.78947368421052,35,3,22,38.146847155586016,0.6053571428571429,46.70138888888888,1013.1944444444431,28.94841269841266,0
3517,4,0,0,38,0.0,0.0,1.0,38,850,700,150,0.8235294117647058,10,7,3,337.83928968059723,0.45055417259364633,0.18490787219333327,0.18337154253897225,128349.69142500403,1072.3137163494193,129422.00514135345,1238,4,256.7894736842105,35,3,22,38.11405387397677,0.6056547619047619,46.67245370370369,1013.3101851851831,28.951719576719515,0
3518,4,1,0,39,0.02564102564102564,0.0,1.0,39,1050,800,250,0.7619047619047619,13,8,5,329.88871242730164,0.4513326585695007,0.1878605509467841,0.18063847010664177,128700.23108071699,691.3507040627708,129391.58178477976,1239,0,251.17948717948718,37,2,19,37.95836034867805,0.6052927927927928,46.326754385964904,1014.692982456139,27.42413466097673,0
3519,4,1,1,39,0.025,0.025,0.975,40,650,400,250,0.6153846153846154,9,4,5,321.16924149579694,0.4516025641025641,0.1934561993900521,0.17724888667344912,129011.37689248644,286.89721217763804,129298.27410466407,1240,0,245.875,38,2,20,37.86325235741579,0.6066337719298245,46.020299145299134,1015.9188034188016,26.73470535312636,0
3520,4,0,1,38,0.0,0.02564102564102564,0.9743589743589743,39,1150,800,350,0.6956521739130435,15,8,7,327.80554456928286,0.45037674313990106,0.19323936330739055,0.18038069805443407,128895.01006319239,650.4997932055838,129545.50985639797,1241,1,252.94871794871796,37,2,20,37.81302865061369,0.6072635135135135,46.13486842105262,1015.4605263157883,27.444879089615903,0
3521,4,1,0,39,0.02564102564102564,0.0,1.0,39,650,300,350,0.46153846153846156,10,3,7,329.9942316530278,0.4526821862348178,0.20880820557091218,0.18235280529091258,129062.08070031148,717.9484312480558,129780.02913155952,1242,0,253.74358974358975,37,2,21,37.58756429624833,0.6089527027027026,45.970394736842096,1016.1184210526302,27.462660028449466,0
3522,4,4,1,42,0.09302325581395349,0.023255813953488372,0.9767441860465116,43,850,500,350,0.5882352941176471,12,5,7,310.0408230061006,0.4546419342930971,0.2349138980014993,0.17677506590968342,130289.85407991809,-515.2573962631639,129774.59668365493,1243,0,231.04651162790697,38,5,20,36.851628994000265,0.6195175438596492,44.76495726495726,1020.9401709401702,26.86684660368869,0
3523,4,1,0,43,0.023255813953488372,0.0,1.0,43,1500,1300,200,0.8666666666666667,17,13,4,314.2469306300291,0.45491878922111484,0.24441213794981276,0.18043734324170835,130562.68376981532,-394.2154741032754,130168.46829571205,1244,0,232.02325581395348,38,5,16,36.468787023485966,0.6222587719298245,44.49786324786326,1022.0085470085481,26.894961763382845,0
3524,4,0,3,40,0.0,0.06976744186046512,0.9302325581395349,43,1150,700,450,0.6086956521739131,16,7,9,316.80899362231133,0.4544112218530823,0.24850914923088152,0.18242250715797345,130671.89554569362,-320.39365548980777,130351.50189020381,1245,1,233.02325581395348,38,5,16,36.293103448275886,0.6233552631578947,44.39102564102564,1022.4358974358975,26.90620782726046,0
3525,4,0,1,39,0.0,0.025,0.975,40,1100,700,400,0.6363636363636364,15,7,8,338.35283495259745,0.45094818376068374,0.2517427255599749,0.19264737694500098,130235.32238476147,813.0981079699034,131048.42049273137,1246,2,250.975,38,2,21,36.184233479868844,0.6189692982456141,44.81837606837607,1020.7264957264956,26.861223571749886,0
3526,4,0,0,39,0.0,0.0,1.0,39,850,300,550,0.35294117647058826,14,3,11,339.69179508538093,0.4504610886189833,0.24238618524332822,0.193545325106787,130262.58680555565,1049.8263888888978,131312.41319444455,1247,3,254.92307692307693,37,2,22,36.12244897959184,0.6210585585585586,44.79166666666667,1020.8333333333342,27.59009009009011,0
3527,4,0,0,39,0.0,0.0,1.0,39,1200,800,400,0.6666666666666666,16,8,8,337.91187539619045,0.45015182186234814,0.2416677128731226,0.19298322684078012,130353.74858276626,1009.6159297051945,131363.36451247145,1248,4,255.92307692307693,34,5,22,36.07557122872465,0.6280637254901961,44.70238095238094,1021.1904761904747,30.035014005602196,0
3528,4,1,0,40,0.025,0.0,1.0,40,1300,1000,300,0.7692307692307693,16,10,6,327.64923426370837,0.4512152777777778,0.23620543293718188,0.18883111446313505,130706.03358892733,565.1463638117078,131271.17995273904,1249,0,250.5,35,5,18,35.98153650254667,0.6294642857142857,44.35763888888888,1022.5694444444433,29.21626984126981,0
3529,4,0,0,40,0.0,0.0,1.0,40,1550,1300,250,0.8387096774193549,18,13,5,326.853478041023,0.45074786324786326,0.23599298801176238,0.18938653033019145,130913.23329260954,557.8891246570422,131471.1224172666,1250,1,251.5,35,5,18,35.792712810073134,0.631547619047619,44.15509259259258,1023.3796296296281,29.239417989417944,0
3530,4,0,1,39,0.0,0.025,0.975,40,1200,800,400,0.6666666666666666,16,8,8,328.80235230045315,0.450267094017094,0.23877680043980187,0.1915731834831917,131126.2038009294,622.9208515948443,131749.12465252425,1251,2,252.5,36,4,19,35.52799157045995,0.6316550925925926,43.947072072072075,1024.2117117117123,28.45032532532534,0
3531,4,2,0,41,0.04878048780487805,0.0,1.0,41,800,400,400,0.5,12,4,8,312.22439512469646,0.45109247967479676,0.21601893658953664,0.18395286151049506,131553.00188519547,14.966637695008359,131567.96852289047,1252,0,240.9268292682927,37,4,21,35.52310460310673,0.634009009009009,43.530701754385966,1025.8771929824563,27.72641062114747,0
3532,4,0,2,39,0.0,0.04878048780487805,0.9512195121951219,41,1100,900,200,0.8181818181818182,13,9,4,312.27776899517966,0.45106707317073175,0.2174740277003111,0.18425569749412934,131609.25116381957,19.728666512765557,131628.97983033233,1253,1,241.9268292682927,37,4,15,35.46519911662037,0.634572072072072,43.47587719298245,1026.0964912280697,27.73233760075864,0
3533,4,1,1,39,0.025,0.025,0.975,40,1650,1200,450,0.7272727272727273,21,12,9,319.406272080734,0.45034722222222223,0.22293791817483832,0.18921552843145237,131761.33639974432,417.07945276357225,132178.4158525079,1254,0,248.9,36,4,16,35.129428540089926,0.6380208333333333,43.3277027027027,1026.6891891891892,28.519144144144143,0
3534,4,1,0,40,0.025,0.0,1.0,40,900,500,400,0.5555555555555556,13,5,8,323.60622439727945,0.4483840811965812,0.23955821091865825,0.19243389693298465,131905.89871966562,537.1139720801903,132443.01269174583,1255,0,249.875,36,4,17,34.8763063655631,0.6394675925925926,43.18693693693694,1027.2522522522524,28.53478478478479,0
3535,4,0,1,39,0.0,0.025,0.975,40,1050,700,350,0.6666666666666666,14,7,7,311.6516552152235,0.44752938034188033,0.12447057625738145,0.18027341328173885,130848.095703125,155.80512152777828,131003.90082465278,1256,1,250.875,39,1,14,36.24728500644811,0.6233974358974359,44.21875,1023.125,26.233974358974358,8
3536,4,0,0,39,0.0,0.0,1.0,39,950,700,250,0.7368421052631579,12,7,5,318.98092925440073,0.44520355375618537,0.14541424751258747,0.1848468433955173,130917.78897518065,552.0555966469202,131469.84457182756,1257,2,258.12820512820514,38,1,15,35.98953439816264,0.6258223684210527,44.150641025641015,1023.3974358974347,26.93151147098512,0
3537,4,0,0,39,0.0,0.0,1.0,39,1350,900,450,0.6666666666666666,18,9,9,322.07249765933386,0.4450629779577148,0.15100458343701662,0.18716923863368057,131027.14913662405,640.0482367228913,131667.19737334695,1258,3,259.12820512820514,38,1,15,35.80015826637449,0.6269188596491229,44.04380341880341,1023.8247863247843,26.942757534862746,0
3538,4,0,0,39,0.0,0.0,1.0,39,1200,800,400,0.6666666666666666,16,8,8,324.35758285861596,0.4445569050832208,0.16138841861174247,0.18903441622282946,131136.55495516444,707.0271979326188,131843.58215309706,1259,4,260.12820512820514,38,1,16,35.63136712909845,0.628015350877193,43.9369658119658,1024.2521367521344,26.954003598740382,0
3539,4,0,0,39,0.0,0.0,1.0,39,1450,1300,150,0.896551724137931,16,13,3,325.5337431423097,0.44348852901484476,0.15572232645403372,0.19066976384049536,131328.12499999974,750.3472222221932,132078.47222222193,1260,5,261.12820512820514,38,1,17,35.40819783197832,0.6299342105263157,43.749999999999986,1024.999999999998,26.97368421052626,0
3540,4,0,0,39,0.0,0.0,1.0,39,1100,700,400,0.6363636363636364,15,7,8,359.8058370527914,0.44298245614035087,0.24781998751630008,0.19984396491727352,129263.69214965409,1740.6814686659118,131004.37361832,1261,6,262.12820512820514,33,6,21,36.624789105808645,0.6193181818181819,45.77205882352942,1016.9117647058832,30.8155080213904,8
3541,4,0,0,39,0.0,0.0,1.0,39,1500,1100,400,0.7333333333333333,19,11,8,357.39127223344394,0.4423639226270805,0.24761716124075628,0.19879889517985327,129322.44897959189,1443.7429138322004,130766.1918934241,1262,7,263.12820512820514,34,5,22,36.62633622034956,0.6176470588235294,45.714285714285715,1017.1428571428576,29.915966386554633,0
3542,4,0,0,39,0.0,0.0,1.0,39,950,600,350,0.631578947368421,13,6,7,355.43179996416944,0.44233580746738643,0.24568006044852142,0.19783977770013186,129348.51794249383,1394.9153109996357,130743.43325349347,1263,8,264.12820512820514,35,4,22,36.64962358250843,0.6157738095238094,45.6886574074074,1017.245370370369,29.064153439153397,0
3543,4,0,0,39,0.0,0.0,1.0,39,1350,900,450,0.6666666666666666,18,9,9,355.6558946861003,0.44104251012145745,0.2454962045685105,0.19900440519458867,129554.63927469117,1415.3742283950382,130970.01350308621,1264,9,265.12820512820514,35,4,20,36.43417462482947,0.6178571428571429,45.4861111111111,1018.055555555554,29.087301587301543,0
3544,4,2,0,41,0.04878048780487805,0.0,1.0,41,1250,1000,250,0.8,15,10,5,341.1970110212491,0.4447662601626016,0.2492187991527377,0.19356688966717697,130094.74068944289,677.5873345644784,130772.32802400737,1265,0,253.14634146341464,37,4,22,36.254120091716814,0.6193693693693694,44.95614035087719,1020.1754385964912,27.57230915125652,0
3545,4,0,0,41,0.0,0.0,1.0,41,1050,500,550,0.47619047619047616,16,5,11,338.6712106750082,0.44469004065040646,0.24972872779078448,0.19269363166041384,130208.06081753578,619.5443193439722,130827.60513687975,1266,1,254.14634146341464,38,3,23,36.203723088733035,0.6186951754385965,44.84508547008546,1020.6196581196565,26.858412055780434,0
3546,4,0,0,41,0.0,0.0,1.0,41,800,400,400,0.5,12,4,8,340.64742309433205,0.44385162601626016,0.2573389143549103,0.19438496549406223,130321.66950660179,678.7824209777422,131000.45192757953,1267,2,255.14634146341464,35,6,23,36.038218846822346,0.6255952380952381,44.73379629629631,1021.064814814817,29.173280423280488,0
3547,4,0,0,41,0.0,0.0,1.0,41,1050,800,250,0.7619047619047619,13,8,5,344.00481506151203,0.4436229674796748,0.25957299799626776,0.19674935145287414,130410.31867551885,772.3555116169546,131182.6741871358,1268,3,256.1463414634146,35,6,23,35.862724268177516,0.6264880952380952,44.64699074074075,1021.4120370370384,29.1832010582011,0
3548,4,0,0,41,0.0,0.0,1.0,41,1700,1400,300,0.8235294117647058,20,14,6,336.0282223364268,0.44308943089430897,0.217388672969695,0.18594899061709455,129117.79495854465,528.0075189029842,129645.80247744764,1269,4,257.1463414634146,37,4,22,37.377616247707415,0.6095157657657657,45.91557017543858,1016.3377192982432,27.468587008060627,8
3549,4,2,1,42,0.046511627906976744,0.023255813953488372,0.9767441860465116,43,1200,900,300,0.75,15,9,6,320.4863638215439,0.446359357696567,0.2142170379950712,0.17944976775671587,129581.83235627103,-294.130894568396,129287.70146170263,1270,0,246.13953488372093,38,5,14,37.30172263029032,0.612390350877193,45.45940170940169,1018.1623931623897,26.793747188483938,0
3550,4,0,0,42,0.0,0.0,1.0,42,1600,1300,300,0.8125,19,13,6,339.37947912002886,0.4449404761904762,0.18272666832876272,0.1751931905727718,126319.25207756241,204.30590342217238,126523.55798098458,1271,1,253.0,37,5,15,40.15506835369403,0.5810810810810811,48.684210526315795,1005.2631578947376,27.16927453769561,8
3551,4,0,1,41,0.0,0.023809523809523808,0.9761904761904762,42,1000,600,400,0.6,14,6,8,352.9516236125009,0.4452187379016647,0.09248166493875565,0.18162258711204005,126189.15741008641,655.435294712574,126844.59270479898,1272,2,254.0,35,7,18,39.94799466267327,0.5836309523809524,48.8136574074074,1004.7453703703688,28.70701058201054,7
3552,4,2,0,43,0.046511627906976744,0.0,1.0,43,850,500,350,0.5882352941176471,12,5,7,344.987986647818,0.44730527870062753,0.11420367952645716,0.17998148054870378,126751.58900454482,145.55509901790415,126897.14410356272,1273,0,248.88372093023256,36,7,15,39.56958734063967,0.5873842592592593,48.25450450450449,1006.9819819819799,27.971721721721664,0
3553,4,2,0,45,0.044444444444444446,0.0,1.0,45,850,600,250,0.7058823529411765,11,6,5,330.6193526497839,0.4499368686868687,0.11539176579947541,0.1745130546155339,127226.7094587804,-587.2775357952055,126639.4319229852,1274,0,238.77777777777777,38,7,17,39.44434148752162,0.5885416666666667,47.78311965811964,1008.8675213675183,26.54914529914522,0
3554,4,0,0,45,0.0,0.0,1.0,45,1400,800,600,0.5714285714285714,20,8,12,328.7861954391608,0.4495159932659933,0.11965703397904104,0.17400802175427157,127334.51727892809,-626.8337031558485,126707.68357577224,1275,1,239.77777777777777,38,7,13,39.380226526939765,0.5896381578947368,47.67628205128204,1009.2948717948698,26.560391363022887,0
3555,4,2,2,45,0.0425531914893617,0.0425531914893617,0.9574468085106383,47,1400,1000,400,0.7142857142857143,18,10,8,318.5171249310623,0.45299491211840887,0.1361163425546874,0.17090032045492481,127887.41949443093,-1253.1333655562541,126634.28612887468,1276,0,230.53191489361703,40,7,16,39.074692722462224,0.5919270833333333,47.12906504065039,1011.483739837396,25.2870934959349,0
3556,4,1,0,46,0.021739130434782608,0.0,1.0,46,1300,1000,300,0.7692307692307693,16,10,6,326.4860078274065,0.45114734299516907,0.14679959155156652,0.1749186624717692,127828.32031249975,-853.1684027778077,126975.15190972194,1277,0,236.43478260869566,39,7,17,38.93352561461337,0.592948717948718,47.187499999999986,1011.2499999999981,25.92948717948713,0
3557,4,0,2,44,0.0,0.043478260869565216,0.9565217391304348,46,1100,600,500,0.5454545454545454,16,6,10,327.2835983162563,0.4502516103059581,0.15387490543825177,0.17592172608997192,127960.02739800327,-824.1563585069639,127135.8710394963,1278,1,237.43478260869566,39,7,18,38.77889169154742,0.594284188034188,47.05729166666666,1011.7708333333317,25.942841880341838,0
3558,4,1,1,44,0.022222222222222223,0.022222222222222223,0.9777777777777777,45,800,600,200,0.75,10,6,4,328.9479933131543,0.44888468013468014,0.17967576117042272,0.17775843484806997,128173.03790276764,-567.2814349928535,127605.75646777479,1279,0,241.84444444444443,36,9,19,38.51942467378411,0.6018518518518519,46.846846846846844,1012.6126126126127,28.12812812812813,0
3559,4,1,1,44,0.022222222222222223,0.022222222222222223,0.9777777777777777,45,1200,900,300,0.75,15,9,6,325.1805104902143,0.448989898989899,0.20732097150968487,0.1731451234484852,127579.2262067056,-647.4875149680702,126931.73869173753,1280,0,242.51111111111112,40,5,15,39.22098715756295,0.5888020833333334,47.43394308943089,1010.264227642276,25.256605691056897,8
3560,4,2,1,45,0.043478260869565216,0.021739130434782608,0.9782608695652174,46,800,500,300,0.625,11,5,6,315.60065743328715,0.4476650563607085,0.23000268463239704,0.17010425292085693,128069.20750070829,-1116.2547831633015,126952.95271754499,1281,0,238.1086956521739,41,5,18,38.963111339802,0.5922256097560976,46.949404761904745,1012.2023809523783,24.68786295005801,0
3561,4,1,0,46,0.021739130434782608,0.0,1.0,46,1150,800,350,0.6956521739130435,15,8,7,313.71657838616494,0.45054347826086955,0.23033105002414467,0.1698541207253378,128250.02170138877,-1153.1241142290364,127096.89758715974,1282,0,238.19565217391303,39,7,20,38.82661456190869,0.5972222222222222,46.77083333333333,1012.9166666666657,25.972222222222197,0
3562,4,0,2,44,0.0,0.043478260869565216,0.9565217391304348,46,1200,800,400,0.6666666666666666,16,8,8,315.5179570922617,0.4503421900161031,0.23743241431699302,0.17150780572668756,128408.33875868062,-1096.9726562499964,127311.36610243062,1283,1,239.19565217391303,39,7,13,38.6198184309695,0.5988247863247863,46.614583333333336,1013.5416666666672,25.988247863247878,0
3563,4,0,0,44,0.0,0.0,1.0,44,1100,700,400,0.6363636363636364,15,7,8,326.7265369332938,0.44840116279069764,0.23653927520687978,0.17704554103968925,128283.34349270926,-417.28548688058515,127866.05800582867,1284,2,249.86363636363637,37,7,22,38.46319497059565,0.6010698198198199,46.737938596491226,1013.0482456140348,27.379682313892832,0
3564,4,1,2,43,0.022222222222222223,0.044444444444444446,0.9555555555555556,45,1350,1000,350,0.7407407407407407,17,10,7,317.12162226176304,0.45105218855218854,0.23436127368769344,0.17341086351528986,128645.99745008697,-840.7145182291476,127805.28293185783,1285,0,245.2888888888889,39,6,16,38.33737635623096,0.6012286324786325,46.38020833333334,1014.479166666668,26.01228632478636,0
3565,4,1,1,43,0.022727272727272728,0.022727272727272728,0.9772727272727273,44,1400,1000,400,0.7142857142857143,18,10,8,324.22108996212626,0.447872621564482,0.24087739252850549,0.17871564998421124,128963.2175021703,-437.4810112847042,128525.7364908856,1286,0,239.02272727272728,39,5,17,37.834687895258604,0.6044337606837606,46.06770833333334,1015.729166666668,26.04433760683764,0
3566,4,1,2,42,0.022727272727272728,0.045454545454545456,0.9545454545454546,44,1100,700,400,0.6363636363636364,15,7,8,330.8922332706264,0.44563733262861166,0.26099105812220613,0.1834947839046199,129201.38888888879,-248.99359809028772,128952.39529079851,1287,0,239.88636363636363,36,8,20,37.42315573770492,0.6122685185185186,45.83333333333333,1016.6666666666658,28.24074074074072,0
3567,4,0,0,42,0.0,0.0,1.0,42,1400,1200,200,0.8571428571428571,16,12,4,349.491262811566,0.4412867789392179,0.2680806461557439,0.19326282957861507,129089.93632656176,623.1609726069233,129713.09729916869,1288,1,251.8095238095238,37,5,22,37.06391166738598,0.6092342342342343,45.942982456140335,1016.2280701754364,27.46562351825504,0
3568,4,1,1,42,0.023255813953488372,0.023255813953488372,0.9767441860465116,43,1500,1400,100,0.9333333333333333,16,14,2,341.39350402135506,0.44306016980435586,0.2651210397276904,0.19059511624506492,129466.28146701376,239.93377168934745,129706.21523870311,1289,0,246.93023255813952,35,8,14,36.88694131695665,0.6169642857142856,45.57291666666666,1017.7083333333322,29.07738095238092,0
3569,4,0,1,41,0.0,0.023809523809523808,0.9761904761904762,42,1350,1000,350,0.7407407407407407,17,10,7,345.2423608642778,0.44173441734417346,0.27349670388005043,0.1924556496105177,129407.39300679434,535.3827749914161,129942.77578178576,1290,3,253.8095238095238,35,7,22,36.848884275584865,0.6163690476190475,45.63078703703703,1017.4768518518513,29.07076719576718,0
3570,4,0,0,41,0.0,0.0,1.0,41,1400,900,500,0.6428571428571429,19,9,10,349.8289624216469,0.44131097560975613,0.2720272517966731,0.19534211624707118,129473.85381235827,858.7407879818586,130332.59460034013,1291,4,259.4146341463415,34,7,15,36.66461964362303,0.6191789215686274,45.56547619047619,1017.7380952380952,29.93347338935574,0
3571,4,0,0,41,0.0,0.0,1.0,41,1350,900,450,0.6666666666666666,18,9,9,350.6385125764946,0.44090447154471546,0.27523688981630356,0.1968545350134179,129685.96938775518,894.5790816326612,130580.54846938784,1292,5,260.4146341463415,34,7,16,36.42838359046284,0.6213235294117647,45.35714285714286,1018.5714285714291,29.95798319327733,0
3572,4,0,1,40,0.0,0.024390243902439025,0.975609756097561,41,1800,1400,400,0.7777777777777778,22,14,8,349.66697526475104,0.4401422764227642,0.2731042506336476,0.19698129988522925,129819.89354263117,878.7459008487632,130698.63944347993,1293,6,261.4146341463415,35,6,17,36.317078364565596,0.6205357142857143,45.22569444444444,1019.0972222222222,29.11706349206349,0
3573,4,1,0,41,0.024390243902439025,0.0,1.0,41,900,600,300,0.6666666666666666,12,6,6,344.99797637219046,0.4404725609756098,0.280049092700152,0.19613373035663695,130176.38204082474,782.1176751075496,130958.4997159323,1294,0,260.5853658536585,36,5,18,36.07440410505406,0.6221064814814814,44.87612612612613,1020.4954954954966,28.347097097097127,0
3574,4,0,0,41,0.0,0.0,1.0,41,1150,800,350,0.6956521739130435,15,8,7,345.64307477015507,0.4399644308943089,0.27310880227369494,0.19723565366250378,130321.66950660152,808.9850450895116,131130.65455169103,1295,1,261.5853658536585,35,6,18,35.91069674299101,0.6255952380952381,44.7337962962963,1021.064814814815,29.173280423280428,0
3575,4,0,0,41,0.0,0.0,1.0,41,1100,900,200,0.8181818181818182,13,9,4,345.64307477015507,0.43981199186991865,0.27310880227369494,0.19723565366250378,130321.66950660152,808.9565114883427,131130.62601808985,1296,2,262.5853658536585,35,6,18,35.91069674299101,0.6255952380952381,44.7337962962963,1021.064814814815,29.173280423280428,0
3576,4,0,1,40,0.0,0.024390243902439025,0.975609756097561,41,1150,800,350,0.6956521739130435,15,8,7,347.7929516596499,0.4396595528455285,0.21991478140105403,0.19272725442797198,129172.76810171679,852.6044864465566,130025.37258816334,1297,3,263.5853658536585,36,5,22,37.022728111960426,0.6119791666666667,45.8614864864865,1016.5540540540558,28.23761261261266,8
3577,4,0,1,39,0.0,0.025,0.975,40,1700,1400,300,0.8235294117647058,20,14,6,374.1338099206171,0.4395566239316239,0.16146523178807914,0.19480760447590764,126672.22222222232,1527.401007426351,128199.62322964867,1298,4,268.775,34,6,16,38.91763245033111,0.5906862745098039,48.333333333333336,1006.6666666666675,29.607843137254928,8
3578,4,1,0,40,0.025,0.0,1.0,40,1200,800,400,0.6666666666666666,16,8,8,372.53444585061357,0.4410523504273504,0.15966493322302355,0.19468894047819899,126822.06809807254,1449.1177721088452,128271.18587018139,1299,0,268.4,34,6,19,38.80352992160108,0.592218137254902,48.18452380952381,1007.2619047619046,29.625350140056018,0
3579,4,1,1,40,0.024390243902439025,0.024390243902439025,0.975609756097561,41,1100,800,300,0.7272727272727273,14,8,6,360.0193698995868,0.4437245934959349,0.13769176039842934,0.18398979858687448,125906.24188452227,865.7371739381447,126771.97905846042,1300,0,262.8292682926829,37,4,18,40.06234294766743,0.5768581081081081,49.09539473684211,1003.6184210526325,27.124822190611688,8
3580,4,2,2,40,0.047619047619047616,0.047619047619047616,0.9523809523809523,42,750,600,150,0.8,9,6,3,339.37290886735565,0.4458599496709253,0.13415354380820044,0.16892787741545348,124813.10410046359,77.19484012134018,124890.29894058494,1301,0,257.5,38,4,17,41.708988203428504,0.5638706140350878,50.1869658119658,999.2521367521344,26.296108861898276,8
3581,4,3,0,43,0.06976744186046512,0.0,1.0,43,1150,900,250,0.782608695652174,14,9,5,331.4770662025445,0.4495662606127722,0.18348610875346605,0.16819391877684647,125610.49970255786,-272.60001487211485,125337.89968768574,1302,0,251.62790697674419,40,3,14,41.08310523114356,0.56875,49.39024390243902,1002.4390243902427,25.060975609756067,0
3582,4,2,1,44,0.044444444444444446,0.022222222222222223,0.9777777777777777,45,1350,1000,350,0.7407407407407407,17,10,7,327.8038743265119,0.4538299663299663,0.20690226966525027,0.16905289061338946,126279.29823133699,-718.7927976304632,125560.50543370652,1303,0,241.4,39,6,13,40.48703233495698,0.577190170940171,48.72395833333334,1005.1041666666681,25.771901709401746,0
3583,4,1,0,45,0.022222222222222223,0.0,1.0,45,1100,800,300,0.7272727272727273,14,8,6,330.6792875462797,0.4527146464646465,0.20891373875428498,0.17151990113437007,126514.97938368063,-632.8233506944396,125882.1560329862,1304,0,242.3111111111111,39,6,15,40.172654793953186,0.579594017094017,48.489583333333336,1006.0416666666673,25.795940170940188,0
3584,4,1,3,43,0.021739130434782608,0.06521739130434782,0.9347826086956522,46,1200,900,300,0.75,15,9,6,325.3515928060392,0.452908615136876,0.21827297610274754,0.1700888706694865,126835.9607376563,-946.7436297838435,125889.21710787246,1305,0,238.02173913043478,40,6,16,39.97742635189668,0.58125,48.17073170731708,1007.317073170733,25.182926829268325,0
3585,4,2,1,44,0.044444444444444446,0.022222222222222223,0.9777777777777777,45,1200,800,400,0.6666666666666666,16,8,8,325.8585698147268,0.4516835016835017,0.22288543837243124,0.17099816377896634,126989.56164485439,-723.8726122017222,126265.68903265266,1306,0,241.84444444444443,40,5,18,39.80725280634537,0.5828125,48.018292682926834,1007.9268292682938,25.198170731707343,0
3586,4,3,3,44,0.06382978723404255,0.06382978723404255,0.9361702127659575,47,950,500,450,0.5263157894736842,14,5,9,312.99323632503706,0.45586648165279064,0.23182869206796042,0.16729412798093204,127733.27637525623,-1403.945754015453,126329.33062124078,1307,0,230.14893617021278,40,7,15,39.37158607285281,0.5903645833333333,47.28150406504066,1010.8739837398382,25.271849593495954,0
3587,4,0,0,44,0.0,0.0,1.0,44,1100,500,600,0.45454545454545453,17,5,12,333.77943615871845,0.45358747357293866,0.2274916056533156,0.17688625307143746,127388.43831041343,-296.07177752210623,127092.36653289132,1308,1,243.5,38,6,15,39.199033407415236,0.5901864035087719,47.62286324786324,1009.5085470085467,26.566014394961755,0
3588,4,0,0,44,0.0,0.0,1.0,44,1600,1200,400,0.75,20,12,8,337.0679686289204,0.4537306201550388,0.23258553378079538,0.17922612910111435,127523.29082657603,-203.1966816421965,127320.09414493384,1309,2,244.5,38,6,16,38.97798991608491,0.5915570175438596,47.48931623931624,1010.0427350427346,26.580071974808806,0
3589,4,0,1,43,0.0,0.022727272727272728,0.9772727272727273,44,1400,1000,400,0.7142857142857143,18,10,8,335.5412919905841,0.4535103946441155,0.23063929679227035,0.17894920690492908,127644.04432508691,-234.0304904513788,127410.01383463554,1310,3,245.5,39,5,16,38.89300501666495,0.5910790598290598,47.36979166666667,1010.5208333333343,25.91079059829062,0
3590,4,0,1,42,0.0,0.023255813953488372,0.9767441860465116,43,1900,1300,600,0.6842105263157895,25,13,12,338.6736761806803,0.45256552233296415,0.22435415159167893,0.1812109537491558,127775.65646701408,54.85026041668567,127830.50672743077,1311,4,252.04651162790697,39,4,17,38.67925338278728,0.5924145299145299,47.23958333333334,1011.0416666666682,25.92414529914534,0
3591,4,0,3,39,0.0,0.07142857142857142,0.9285714285714286,42,1250,900,350,0.72,16,9,7,343.76535151404926,0.45101384049554777,0.2322115007452734,0.1846597950168391,127933.68055555574,395.8333333333522,128329.5138888891,1312,5,258.23809523809524,39,3,18,38.3889346512905,0.594017094017094,47.08333333333334,1011.6666666666681,25.940170940170976,0
3592,4,0,0,39,0.0,0.0,1.0,39,950,600,350,0.631578947368421,13,6,7,370.1720501858306,0.44756522717049035,0.23913149060781413,0.19763796254716404,127688.85598013547,1653.369120809992,129342.22510094546,1313,6,275.0769230769231,36,3,18,37.97214484679666,0.5969328703703703,47.32545045045045,1010.6981981981976,28.074949949949932,0
3593,4,1,0,40,0.025,0.0,1.0,40,1400,1200,200,0.8571428571428571,16,12,4,361.994525246752,0.448838141025641,0.23207628955353266,0.1946669859543721,127978.05574792235,1265.4711064942942,129243.52685441665,1314,0,269.175,37,3,19,37.88244112122525,0.597972972972973,47.03947368421052,1011.8421052631571,27.347083926031274,0
3594,4,2,2,40,0.047619047619047616,0.047619047619047616,0.9523809523809523,42,1750,1500,250,0.8571428571428571,20,15,5,347.06733807049716,0.45396583430120013,0.23070802885878128,0.18911795375002255,128505.59937913569,520.2356734764373,129025.83505261212,1315,0,257.3095238095238,37,5,17,37.72113027648608,0.603322072072072,46.518640350877185,1013.9254385964896,27.403390232337557,0
3595,4,3,0,43,0.06976744186046512,0.0,1.0,43,900,300,600,0.3333333333333333,15,3,12,372.6153272060463,0.4536960132890366,0.28700127723611124,0.1958946788827673,127064.37467538107,883.0350444367728,127947.40971981785,1316,0,252.25581395348837,37,6,21,38.55208899764365,0.5886824324324325,47.94407894736843,1008.2236842105278,27.2492887624467,8
3596,4,0,0,43,0.0,0.0,1.0,43,1700,1300,400,0.7647058823529411,21,13,8,373.37819238049957,0.45288851974898486,0.28637273144868036,0.19739480719301852,127290.80590303168,905.5252086787551,128196.33111171043,1317,1,253.25581395348837,36,7,21,38.299994420265605,0.5928819444444444,47.71959459459461,1009.1216216216238,28.031156156156218,0
3597,4,1,0,44,0.022727272727272728,0.0,1.0,44,1000,700,300,0.7,13,7,6,377.5702165903601,0.45391781183932345,0.3097811082626696,0.20192560307210697,127756.25673284104,847.3915050785013,128603.64823791954,1318,0,248.47727272727272,37,7,22,37.71601590744758,0.5957207207207207,47.25877192982457,1010.9649122807031,27.323376007586567,0
3598,4,0,2,42,0.0,0.045454545454545456,0.9545454545454546,44,1450,1000,450,0.6896551724137931,19,10,9,341.32669359260564,0.4534223044397463,0.20117225147355722,0.18045005907276346,127290.80590303143,-101.73339493007575,127189.07250810135,1319,1,249.47727272727272,36,8,17,39.10859093107167,0.5928819444444444,47.7195945945946,1009.1216216216218,28.03115615615616,8
3599,4,1,1,42,0.023255813953488372,0.023255813953488372,0.9767441860465116,43,1450,1000,450,0.6896551724137931,19,10,9,341.734894935524,0.4515503875968992,0.22303969217795672,0.1816341671812529,127506.96277941288,114.7157057940876,127621.67848520697,1320,0,256.1162790697674,37,6,16,38.87686371367566,0.5931869369369369,47.50548245614035,1009.9780701754385,27.296704599336174,0
3600,4,2,0,44,0.045454545454545456,0.0,1.0,44,1300,1000,300,0.7692307692307693,16,10,6,335.1725003307982,0.4528607293868922,0.22043798073691345,0.17977779380349396,127874.24123612026,-228.01416739718198,127646.22706872308,1321,0,251.25,38,6,18,38.66699235942395,0.5951206140350878,47.14209401709402,1011.4316239316241,26.61662168241116,0
3601,4,0,1,43,0.0,0.022727272727272728,0.9772727272727273,44,1400,900,500,0.6428571428571429,19,9,10,327.89222801049476,0.4527396053558845,0.12597321999473476,0.1711696576892798,126777.10503472213,-464.05647897034606,126313.04855575178,1322,1,252.25,39,5,15,39.97379671769413,0.5822649572649572,48.229166666666664,1007.0833333333326,25.822649572649553,8
3602,4,1,1,43,0.022727272727272728,0.022727272727272728,0.9772727272727273,44,1500,1000,500,0.6666666666666666,20,10,10,335.57597923553067,0.45237623326286114,0.07827588196822233,0.17819461549068752,127469.34125940541,-28.420544095618254,127440.9207153098,1323,0,253.20454545454547,38,6,16,39.07087565241923,0.5910087719298245,47.542735042735046,1009.8290598290603,26.574448942870006,7
3603,4,3,2,44,0.06521739130434782,0.043478260869565216,0.9565217391304348,46,1250,1000,250,0.8,15,10,5,326.10658729237247,0.45482085346215784,0.1048348951075766,0.17576679926804406,128069.20750070855,-847.1575609410495,127222.0499397675,1324,0,242.93478260869566,41,5,20,38.697258159364885,0.5922256097560976,46.94940476190476,1012.2023809523804,24.687862950058058,0
3604,4,2,0,46,0.043478260869565216,0.0,1.0,46,1200,700,500,0.5833333333333334,17,7,10,316.99641195670046,0.4560789049919485,0.1259376631465179,0.1731624818824462,128604.67916757983,-1046.4891957837833,127558.18997179605,1325,0,241.15217391304347,38,8,16,38.38257495962361,0.6025219298245614,46.42094017094017,1014.3162393162395,26.69253261358525,0
3605,4,0,2,44,0.0,0.043478260869565216,0.9565217391304348,46,1100,900,200,0.8181818181818182,13,9,4,316.99641195670046,0.45594806763285023,0.1259376631465179,0.1731624818824462,128604.67916757983,-1046.5556286069125,127558.12353897291,1326,1,242.15217391304347,38,8,16,38.38257495962361,0.6025219298245614,46.42094017094017,1014.3162393162395,26.69253261358525,0
3606,4,1,0,45,0.022222222222222223,0.0,1.0,45,1700,1100,600,0.6470588235294118,23,11,12,333.6924880159186,0.4547348484848485,0.14838815251186466,0.18378220110540663,128929.9859832711,-395.40643947696265,128534.57954379413,1327,0,248.35555555555555,38,7,19,37.627989340065945,0.6058114035087719,46.100427350427346,1015.5982905982894,26.726270805218142,0
3607,4,1,0,46,0.021739130434782608,0.0,1.0,46,1450,1400,50,0.9655172413793104,15,14,1,329.0395455336148,0.4542874396135266,0.15610848531340427,0.1826034369875429,129230.80800165022,-694.4493058155682,128536.35869583466,1328,0,243.93478260869566,35,11,21,37.44035761715044,0.6145833333333333,45.80439814814814,1016.7824074074061,29.05092592592589,0
3608,4,2,1,47,0.041666666666666664,0.020833333333333332,0.9791666666666666,48,1450,900,550,0.6206896551724138,20,9,11,318.5320505473025,0.45379912825059104,0.16955102006062495,0.17988881585149719,129917.22140842002,-1323.4402126736222,128593.7811957464,1329,0,234.72916666666666,39,9,18,37.01178859711863,0.6140491452991452,45.13020833333333,1019.4791666666657,26.14049145299143,0
3609,4,0,1,46,0.0,0.02127659574468085,0.9787234042553191,47,1250,800,450,0.64,17,8,9,322.1597739884579,0.45260946654332407,0.16642986351662703,0.1815169571220259,129826.69850107742,-1035.0120306450522,128791.68647043237,1330,1,240.61702127659575,38,9,18,37.010998707062235,0.6148574561403508,45.21901709401709,1019.123931623931,26.81905083220871,0
3610,4,0,3,43,0.0,0.06521739130434782,0.9347826086956522,46,1850,1500,350,0.8108108108108109,22,15,7,323.2436780696985,0.45126811594202904,0.15185589959733226,0.17306819542319682,127801.98703341994,-912.5489975556526,126889.43803586428,1331,2,246.2173913043478,39,7,16,39.042379210878735,0.5926816239316239,47.21354166666666,1011.1458333333317,25.926816239316196,8
3611,4,1,1,43,0.022727272727272728,0.022727272727272728,0.9772727272727273,44,1750,1400,350,0.8,21,14,7,339.25027351921375,0.45146229739252997,0.16935722238095718,0.18230997517540992,127950.32035097352,-118.56376481223543,127831.75658616128,1332,0,255.70454545454547,37,7,18,38.48612315306529,0.5976914414414414,47.06688596491229,1011.7324561403519,27.34412043622573,0
3612,4,0,2,41,0.0,0.046511627906976744,0.9534883720930233,43,850,400,450,0.47058823529411764,13,4,9,344.7858621072922,0.45159653008490214,0.16862342046604817,0.18512919302509326,127916.59216226383,220.76650129861997,128137.35866356245,1333,1,260.86046511627904,36,7,18,38.380598537979154,0.5992476851851851,47.10022522522524,1011.5990990991008,28.099974974975023,0
3613,4,0,2,39,0.0,0.04878048780487805,0.9512195121951219,41,900,800,100,0.8888888888888888,10,8,2,353.25089724463237,0.4494410569105691,0.17947959291906979,0.18936848712414717,127851.72994898839,832.74766375172,128684.47761274011,1334,2,273.7317073170732,35,6,19,38.2329098954757,0.6005952380952381,47.164351851851855,1011.342592592593,28.895502645502656,0
3614,4,1,2,38,0.025,0.05,0.95,40,950,500,450,0.5263157894736842,14,5,9,357.61675135117605,0.4492254273504273,0.17381646655231564,0.19268998709587437,128056.65569540924,1159.041039737687,129215.69673514692,1335,0,266.175,35,5,21,37.91273584905659,0.6026785714285714,46.96180555555557,1012.1527777777801,28.91865079365086,0
3615,4,4,3,39,0.09523809523809523,0.07142857142857142,0.9285714285714286,42,1250,800,450,0.64,17,8,9,334.92339448425344,0.4520905923344947,0.17637287473128826,0.18408195591578128,128848.62075617285,230.94376929012782,129079.56452546298,1336,0,253.9047619047619,35,7,17,37.6795485636115,0.6107142857142858,46.18055555555556,1015.2777777777778,29.00793650793651,0
3616,4,2,0,41,0.04878048780487805,0.0,1.0,41,950,800,150,0.8421052631578947,11,8,3,343.8867065550316,0.4514481707317073,0.1979179060083287,0.18960012794171074,128972.5113627142,670.3864337310456,129642.89779644525,1337,0,260.1707317073171,36,5,20,37.325849963045094,0.6099537037037037,46.058558558558566,1015.7657657657668,28.215715715715746,0
3617,4,0,2,39,0.0,0.04878048780487805,0.9512195121951219,41,1000,400,600,0.4,16,4,12,343.16803196285304,0.4507876016260162,0.1602698759274397,0.1793452441987682,126822.836766747,504.51156584645344,127327.34833259345,1338,1,261.1707317073171,38,3,16,39.542232357516625,0.5844298245614035,48.18376068376068,1007.264957264957,26.506972559604133,8
3618,4,1,0,40,0.025,0.0,1.0,40,1400,1200,200,0.8571428571428571,16,12,4,351.45252919636135,0.45137553418803417,0.17211130453704704,0.18426698207893683,126953.84787867434,923.6501856340542,127877.49806430838,1339,0,262.55,37,3,18,39.19901262104233,0.5875563063063063,48.053728070175445,1007.7850877192993,27.237434803224307,0
3619,4,1,1,40,0.024390243902439025,0.024390243902439025,0.975609756097561,41,850,600,250,0.7058823529411765,11,6,5,345.015882289681,0.4527693089430895,0.18179022097454722,0.18295279885792615,127413.15593117707,592.1379117215245,128005.2938428986,1340,0,257.1219512195122,35,6,18,38.89012285528681,0.5961309523809524,47.598379629629626,1009.606481481481,28.845899470899457,0
3620,4,0,0,40,0.0,0.0,1.0,40,1650,1200,450,0.7272727272727273,21,12,9,352.02943362564696,0.45048076923076924,0.1816395361801766,0.18715779432059443,127518.18700034499,978.0310293401596,128496.21802968514,1341,1,264.475,36,4,18,38.60542795555061,0.5951967592592593,47.49436936936937,1010.0225225225229,28.05618118118119,0
3621,4,1,1,40,0.024390243902439025,0.024390243902439025,0.975609756097561,41,1000,700,300,0.7,13,7,6,346.305917259715,0.45271849593495933,0.1913464207812814,0.18584479852942803,127894.85857427277,658.1492622730029,128553.00783654577,1342,0,259.0,37,4,20,38.36438572719061,0.5971283783783784,47.12171052631579,1011.5131578947362,27.33819345661449,0
3622,4,0,0,40,0.0,0.0,1.0,40,1400,1100,300,0.7857142857142857,17,11,6,352.11237490406984,0.4528445512820513,0.1838228918274447,0.1890913137872494,127922.5879597567,1008.6252500769299,128931.21320983363,1343,1,264.9,37,3,20,38.1891755184623,0.5974099099099099,47.09429824561403,1011.6228070175426,27.34115694642007,0
3623,4,2,0,42,0.047619047619047616,0.0,1.0,42,1400,900,500,0.6428571428571429,19,9,10,337.76861701348736,0.4534456058846303,0.19367343058158792,0.18468758129277693,128643.06205257613,291.08729910423517,128934.14935168037,1344,0,253.23809523809524,35,7,20,37.81671895797678,0.6086309523809523,46.38310185185184,1014.4675925925912,28.984788359788322,0
3624,4,0,0,42,0.0,0.0,1.0,42,1500,1200,300,0.8,18,12,6,340.0683110375502,0.4533851142082849,0.19758375414019658,0.18663323453062056,128789.8729531035,359.4709147805156,129149.34386788402,1345,1,254.23809523809524,35,7,20,37.60879893576586,0.6101190476190477,46.238425925925924,1015.0462962962958,29.00132275132274,0
3625,4,1,1,42,0.023255813953488372,0.023255813953488372,0.9767441860465116,43,1150,800,350,0.6956521739130435,15,8,7,335.6967488534238,0.4546419342930971,0.2003704648328919,0.1860242204972289,129172.76810171662,72.57565842870798,129245.34376014532,1346,0,249.30232558139534,36,7,22,37.330139211993675,0.6119791666666667,45.86148648648649,1016.5540540540543,28.23761261261262,0
3626,4,0,0,42,0.0,0.0,1.0,42,1000,600,400,0.6,14,6,8,346.6809997312548,0.4543408826945412,0.20335675253708052,0.19225037257824154,129201.38888888905,558.3333333333521,129759.72222222241,1347,1,252.07142857142858,36,6,23,37.02185792349727,0.6122685185185186,45.83333333333334,1016.666666666668,28.240740740740776,0
3627,4,0,0,42,0.0,0.0,1.0,42,1200,900,300,0.75,15,9,6,345.98169003115237,0.4539174409601239,0.1962700399986992,0.19214887032956407,129260.2304633916,544.334597908091,129804.5650612997,1348,2,253.07142857142858,35,7,23,36.979759465816834,0.6148809523809524,45.77546296296296,1016.8981481481479,29.054232804232797,0
3628,4,0,1,41,0.0,0.023809523809523808,0.9761904761904762,42,1100,600,500,0.5454545454545454,16,6,10,355.561058094115,0.453215737514518,0.09575341060621656,0.19572923519816618,128910.32036675338,767.097981770828,129677.41834852421,1349,3,254.07142857142858,39,3,17,37.092800116251254,0.6038995726495726,46.119791666666664,1015.5208333333326,26.038995726495706,8
3629,4,1,2,40,0.023809523809523808,0.047619047619047616,0.9523809523809523,42,1350,1000,350,0.7407407407407407,17,10,7,379.7554811829796,0.4546917344173442,0.08835104289649753,0.19978440531800215,127092.01388888873,1282.2970920138705,128374.3109809026,1350,0,246.85714285714286,38,4,15,38.34366391184572,0.587171052631579,47.91666666666666,1008.333333333332,26.53508771929821,8
3630,4,3,3,40,0.06976744186046512,0.06976744186046512,0.9302325581395349,43,1250,900,350,0.72,16,9,7,372.9445690553278,0.4565568475452197,0.1250218749925085,0.19889693592115054,127644.04432508662,920.8306206597033,128564.87494574633,1351,0,241.8139534883721,39,4,14,37.9480852489434,0.5910790598290598,47.36979166666666,1010.5208333333319,25.91079059829056,0
3631,4,0,0,40,0.0,0.0,1.0,40,1800,1500,300,0.8333333333333334,21,15,6,397.2308884272379,0.45185630341880345,0.12761073301350012,0.21030008582240609,127347.6321549591,2117.2826120039044,129464.914766963,1352,2,260.95,36,4,15,37.63969467068319,0.5934606481481481,47.66328828828829,1009.3468468468475,28.03741241241243,0
3632,4,1,0,41,0.024390243902439025,0.0,1.0,41,1750,1400,350,0.8,21,14,7,388.01851982714044,0.4527947154471545,0.13201032707559257,0.20798319981221458,127847.22792935926,1721.4184290305993,129568.64635838986,1353,0,255.5609756097561,38,3,16,37.35848475244736,0.5948464912280702,47.168803418803414,1011.3247863247856,26.613810166441727,0
3633,4,0,1,40,0.0,0.024390243902439025,0.975609756097561,41,1100,600,500,0.5454545454545454,16,6,10,386.07058400471396,0.4528963414634146,0.13768860526742754,0.20763625787101922,127982.32299884956,1682.0420364891647,129664.36503533872,1354,1,256.5609756097561,38,3,16,37.26903178122691,0.596217105263158,47.035256410256416,1011.8589743589753,26.627867746288825,0
3634,4,1,2,39,0.024390243902439025,0.04878048780487805,0.9512195121951219,41,1300,1000,300,0.7692307692307693,16,10,6,378.84716049382723,0.45378556910569107,0.13307317073170744,0.2058951959205583,128401.20525931336,1529.0918602314127,129930.29711954478,1355,0,256.6585365853659,36,5,16,37.02245370370369,0.6041666666666667,46.62162162162162,1013.5135135135134,28.153153153153152,0
3635,4,1,2,38,0.025,0.05,0.95,40,1400,1100,300,0.7857142857142857,17,11,6,379.6123283431693,0.4524172008547009,0.14221479958890093,0.20634793043458294,128408.33875868045,1749.077690972213,130157.41644965266,1356,0,263.65,35,5,16,36.995760534429614,0.60625,46.61458333333333,1013.5416666666657,28.958333333333307,0
3636,4,1,0,39,0.02564102564102564,0.0,1.0,39,1300,800,500,0.6153846153846154,18,8,10,387.9214731691067,0.4514451192082771,0.030614399324372155,0.2088660936816913,128027.37054183801,2165.7365880058146,130193.10712984383,1357,0,270.7692307692308,35,4,18,37.17596828301312,0.6023809523809525,46.99074074074073,1012.037037037036,28.915343915343886,8
3637,4,1,2,38,0.025,0.05,0.95,40,950,600,350,0.631578947368421,13,6,7,386.50988911234344,0.45208333333333334,0.032723484416029125,0.21040647102144278,128466.99948827576,1930.806729038049,130397.8062173138,1358,0,264.975,35,5,16,36.76087928606765,0.606845238095238,46.556712962962955,1013.7731481481471,28.96494708994706,0
3638,4,0,3,35,0.0,0.07894736842105263,0.9210526315789473,38,1300,1000,300,0.7692307692307693,16,10,6,406.11402236671563,0.4484649122807018,0.09421644697890352,0.2097634812774872,126342.87308673482,2661.922477324274,129004.7955640591,1359,2,279.7894736842105,34,4,15,38.453473455693704,0.5873161764705883,48.66071428571429,1005.3571428571438,29.569327731092464,8
3639,4,2,0,37,0.05405405405405406,0.0,1.0,37,450,300,150,0.6666666666666666,6,3,3,411.71754290379107,0.4480730730730731,0.1484283017502781,0.21496154813108984,126783.27596357174,3039.7797722030055,129823.05573577475,1360,0,285.13513513513516,33,4,17,37.8569400502961,0.5940656565656566,48.22303921568628,1007.1078431372551,30.51841948900773,0
3640,4,2,1,38,0.05128205128205128,0.02564102564102564,0.9743589743589743,39,800,700,100,0.875,9,7,2,393.3369786709904,0.4538911381016644,0.15575071421013642,0.20872699525095648,127442.37075617303,2226.685783245786,129669.05653941882,1361,0,271.46153846153845,32,7,17,37.64041723979827,0.6031901041666667,47.56944444444446,1009.7222222222238,31.553819444444493,0
3641,4,0,0,38,0.0,0.0,1.0,38,1150,700,450,0.6086956521739131,16,7,9,405.03279688932747,0.44990220483641535,0.1490141763076418,0.2144681858938572,127354.73632812513,2716.5690104166815,130071.30533854182,1362,1,279.60526315789474,31,7,17,37.43550051599587,0.6048387096774194,47.65625000000001,1009.375000000001,32.56048387096777,0
3642,4,0,0,38,0.0,0.0,1.0,38,1400,1000,400,0.7142857142857143,18,10,8,403.2967639119964,0.4490576102418207,0.15181073152764424,0.2148589017858719,127601.78330017341,2692.277254871948,130294.06055504536,1363,2,280.60526315789474,32,6,18,37.22480838123802,0.6048177083333333,47.41161616161616,1010.353535353535,31.57354797979797,0
3643,4,1,0,39,0.02564102564102564,0.0,1.0,39,850,400,450,0.47058823529411764,13,4,9,394.08853697193695,0.45020805218173643,0.16187139733651357,0.21182258862241596,127958.47750865034,2285.393838908091,130243.87134755842,1364,0,274.38461538461536,33,6,19,37.090701711886304,0.6060606060606061,47.058823529411754,1011.7647058823516,30.65953654188944,0
3644,4,0,0,39,0.0,0.0,1.0,39,1400,1000,400,0.7142857142857143,18,10,8,395.3765834789585,0.4506860098965362,0.16520237866871268,0.21367386789091958,128176.493470054,2335.731978460456,130512.22544851447,1365,1,275.38461538461536,32,7,19,36.83421654197838,0.6106770833333333,46.84343434343434,1012.6262626262621,31.64457070707069,0
3645,4,0,0,39,0.0,0.0,1.0,39,1400,1100,300,0.7857142857142857,17,11,6,390.14234931104363,0.4498144399460189,0.16910045609597169,0.2121993753569822,128432.33471074376,2221.3785583103686,130653.71326905413,1366,2,276.38461538461536,32,7,19,36.70434728450422,0.61328125,46.590909090909086,1013.6363636363633,31.676136363636353,0
3646,4,1,1,39,0.025,0.025,0.975,40,850,500,350,0.5882352941176471,12,5,7,379.6061183472687,0.4510683760683761,0.1651748005631164,0.2079538915676167,128717.71541950102,1772.406462585022,130490.12188208604,1367,0,270.45,34,6,20,36.67927811669013,0.6115196078431373,46.3095238095238,1014.7619047619038,29.845938375350112,0
3647,4,1,0,40,0.025,0.0,1.0,40,1200,900,300,0.75,15,9,6,377.35311610176075,0.4514556623931624,0.15291446983011148,0.2084601194775748,129050.14349489805,1739.4947562358361,130789.63825113389,1368,0,267.15,34,6,21,36.396699863307944,0.6148897058823529,45.98214285714286,1016.0714285714292,29.884453781512626,0
3648,4,2,2,40,0.047619047619047616,0.047619047619047616,0.9523809523809523,42,1350,1100,250,0.8148148148148148,16,11,5,357.3911169211083,0.45421989934185053,0.15316857309843912,0.20049055772197252,129655.65653344669,867.7331349206298,130523.38966836732,1369,0,255.38095238095238,34,8,18,36.287258912916414,0.6210171568627452,45.38690476190476,1018.4523809523807,29.95448179271708,0
3649,4,1,1,40,0.024390243902439025,0.024390243902439025,0.975609756097561,41,750,600,150,0.8,9,6,3,361.1235371168514,0.45376016260162605,0.1503333200271446,0.20242796438384963,129625.34722222216,1162.1527777777737,130787.49999999994,1370,0,261.5853658536585,34,7,19,36.22306328423351,0.6207107843137255,45.416666666666664,1018.3333333333328,29.950980392156847,0
3650,4,0,0,40,0.0,0.0,1.0,40,1050,700,350,0.6666666666666666,14,7,7,366.3481712378667,0.4521501068376068,0.14541405873856528,0.20509572821052538,129575.4337274125,1493.9446366781917,131069.37836409069,1371,1,269.075,33,7,19,36.140868239447904,0.6224747474747474,45.4656862745098,1018.1372549019605,30.8526440879382,0
3651,4,0,0,40,0.0,0.0,1.0,40,900,600,300,0.6666666666666666,12,6,6,368.3908983318069,0.4513354700854701,0.15086912065439684,0.20706109113132593,129731.44531249999,1558.3767361111109,131289.8220486111,1372,2,270.075,33,7,19,35.930044308111796,0.6240530303030303,45.3125,1018.7499999999999,30.871212121212118,0
3652,4,0,1,39,0.0,0.025,0.975,40,1250,1000,250,0.8,15,10,5,365.54764067991573,0.45125534188034183,0.1439995189995189,0.2059548902367329,129825.09731833899,1491.4516051518465,131316.54892349083,1373,3,271.075,33,7,19,35.907186948853614,0.625,45.22058823529411,1019.1176470588226,30.882352941176443,0
3653,4,0,0,39,0.0,0.0,1.0,39,1250,700,550,0.56,18,7,11,377.8834780100075,0.44939271255060725,0.1514241305985451,0.21213542220645312,129683.21352731875,2001.0287534435406,131684.2422807623,1374,4,278.87179487179486,32,7,19,35.73741787529442,0.6259765625,45.35984848484849,1018.5606060606069,31.830018939393966,0
3654,4,0,0,39,0.0,0.0,1.0,39,1000,800,200,0.8,12,8,4,379.01944933654573,0.4492240215924426,0.1576071764377016,0.21364839350870105,129844.02101826356,2042.6818691970334,131886.7028874606,1375,5,279.87179487179486,32,7,20,35.54468120251073,0.6276041666666667,45.20202020202021,1019.1919191919202,31.849747474747506,0
3655,4,0,0,39,0.0,0.0,1.0,39,1400,1000,400,0.7142857142857143,18,10,8,378.53262753355085,0.4479026090868196,0.163942644823724,0.2149629067532416,130133.72559241418,2051.9722158453387,132185.69780825952,1376,6,280.87179487179486,32,7,22,35.26224064678465,0.6305338541666667,44.9179292929293,1020.3282828282839,31.885258838383873,0
3656,4,0,0,39,0.0,0.0,1.0,39,1250,900,350,0.72,16,9,7,379.52088213646675,0.4471434997750787,0.1667042730682573,0.21642350813323905,130295.81917656798,2090.060615520095,132385.87979208806,1377,7,281.87179487179486,31,8,22,35.07218998427071,0.634744623655914,44.759114583333336,1020.9635416666671,32.934307795698935,0
3657,4,0,1,38,0.0,0.02564102564102564,0.9743589743589743,39,1000,600,400,0.6,14,6,8,378.9224758606746,0.44728407557354927,0.1627613613338823,0.2170091785111573,130462.04460991762,2087.000189887162,132549.04479980477,1378,8,282.87179487179486,31,8,23,34.91853598436571,0.6364247311827957,44.59635416666667,1021.614583333334,32.95530913978497,0
3658,4,0,0,38,0.0,0.0,1.0,38,1200,700,500,0.5833333333333334,17,7,10,378.5722332886696,0.4465830962541489,0.14816523898038492,0.21804252810609168,130681.82615294363,2294.5021553923143,132976.32830833594,1379,9,287.5263157894737,32,6,19,34.704299415493544,0.6360677083333333,44.381313131313135,1022.4747474747479,31.952335858585872,0
3659,4,0,1,37,0.0,0.02631578947368421,0.9736842105263158,38,1150,700,450,0.6086956521739131,16,7,9,374.4427482464638,0.4454717875770507,0.15344219489857513,0.2165674224868734,130843.25140610656,2198.661329201108,133041.91273530768,1380,10,288.5263157894737,32,6,20,34.64611872146118,0.6376953125,44.22348484848485,1023.1060606060609,31.9720643939394,0
3660,4,0,1,36,0.0,0.02702702702702703,0.972972972972973,37,1050,700,350,0.6666666666666666,14,7,7,400.10282592626066,0.44494494494494496,0.08758889145937854,0.2235085848781419,129490.3760617539,2980.2585514233187,132470.63461317722,1381,11,276.43243243243245,32,5,17,35.36859570772856,0.6240234375,45.54924242424242,1017.8030303030303,31.806344696969695,7
3661,4,0,0,36,0.0,0.0,1.0,36,1300,1000,300,0.7692307692307693,16,10,6,406.06744837603725,0.44490740740740736,0.09066777536139203,0.22689272651575984,129499.41211276576,3317.099168565528,132816.51128133127,1382,12,282.5,31,5,17,35.20758709649908,0.6266801075268817,45.54036458333333,1017.838541666666,32.833501344085995,0
3662,4,1,0,37,0.02702702702702703,0.0,1.0,37,1650,1600,50,0.9696969696969697,17,16,1,395.5405687776168,0.4445382882882883,0.0999414274956072,0.2235122528257004,129940.5533395828,2879.352075043376,132819.90541462618,1383,0,275.8378378378378,32,5,19,35.025283797729614,0.6285807291666667,45.10732323232324,1019.5707070707078,31.86158459595962,0
3663,4,0,0,37,0.0,0.0,1.0,37,1250,1000,250,0.8,15,10,5,395.91718375913445,0.44394394394394393,0.09769070964763515,0.2244642054449158,130069.31889921962,2899.33568640957,132968.6545856292,1384,1,276.8378378378378,32,5,20,34.8844225770516,0.6298828125,44.981060606060616,1020.0757575757589,31.877367424242465,0
3664,4,1,0,38,0.02631578947368421,0.0,1.0,38,1150,700,450,0.6086956521739131,16,7,9,387.1767105988115,0.44421230440967285,0.098387275224044,0.22096669432692947,130327.04132550262,2492.0625127538196,132819.10383825644,1385,0,270.5263157894737,32,6,21,34.84501875437947,0.6324869791666667,44.728535353535364,1021.0858585858596,31.90893308080811,0
3665,4,0,0,38,0.0,0.0,1.0,38,1100,600,500,0.5454545454545454,16,6,10,388.1051990919412,0.4438122332859175,0.09784609181423831,0.22260349937994917,130520.50053884825,2531.136969441916,133051.63750829018,1386,1,271.5263157894737,32,6,18,34.62457267597513,0.6344401041666667,44.539141414141426,1021.8434343434358,31.932607323232368,0
3666,4,1,1,38,0.02564102564102564,0.02564102564102564,0.9743589743589743,39,1100,800,300,0.7272727272727273,14,8,6,374.74218669720045,0.44450067476383265,0.09933441398958665,0.21735046828437637,130951.5570934257,2014.6145713187361,132966.17166474444,1387,0,265.53846153846155,33,6,20,34.52865581098341,0.6363636363636364,44.117647058823536,1023.5294117647067,31.016042780748688,0
3667,4,1,1,38,0.02564102564102564,0.02564102564102564,0.9743589743589743,39,900,600,300,0.6666666666666666,12,6,6,373.9472439397044,0.4442757534862798,0.10501837637516043,0.21795335180251396,131139.77346453292,2007.8713715878573,133147.64483612077,1388,0,266.46153846153845,33,6,21,34.358299433676315,0.6382575757575757,43.93382352941177,1024.2647058823534,31.038324420677377,0
3668,4,0,0,38,0.0,0.0,1.0,38,1500,1100,400,0.7333333333333333,19,11,8,378.0340761878083,0.4443901137980086,0.10580815945188404,0.22030261681289545,131134.06795224987,2314.6292470156204,133448.6971992655,1389,1,272.86842105263156,32,6,21,34.25943047337279,0.640625,43.939393939393945,1024.242424242425,32.00757575757578,0
3669,4,0,0,38,0.0,0.0,1.0,38,1150,700,450,0.6086956521739131,16,7,9,379.3684121926541,0.4438122332859175,0.11050994907433642,0.22165613517419863,131233.93233672148,2357.20170727605,133591.13404399753,1390,2,273.86842105263156,33,5,22,34.124083044292945,0.6392045454545454,43.841911764705884,1024.6323529411766,31.049465240641716,0
3670,4,0,0,38,0.0,0.0,1.0,38,1050,800,250,0.7619047619047619,13,8,5,377.7369875373275,0.4437085111427217,0.11225594481300138,0.22088368460049884,131265.3261365821,2316.7537725874677,133582.07990916955,1391,3,274.86842105263156,33,5,22,34.134078769034524,0.639520202020202,43.81127450980392,1024.7549019607843,31.053178847296493,0
3671,4,1,1,38,0.02564102564102564,0.02564102564102564,0.9743589743589743,39,1050,700,350,0.6666666666666666,14,7,7,369.1621949167804,0.44466936572199733,0.10290712631849752,0.21764971097487934,131579.4706362938,1914.8482554786667,133494.31889177245,1392,0,268.79487179487177,33,6,17,34.036072623029135,0.6426767676767677,43.504901960784316,1025.9803921568632,31.090314913844338,0
3672,4,0,0,38,0.0,0.0,1.0,38,1100,800,300,0.7272727272727273,14,8,6,379.59271005917174,0.4425823850165955,0.10851174089068838,0.22365415295364535,131554.7062321446,2387.4414919395917,133942.1477240842,1393,5,276.86842105263156,32,6,17,33.79358974358974,0.6448567708333333,43.5290404040404,1025.8838383838379,32.058869949494934,0
3673,4,0,0,38,0.0,0.0,1.0,38,1200,800,400,0.6666666666666666,16,8,8,377.1169651714305,0.44222676623992413,0.10727698922503115,0.22276211431056583,131651.87225793282,2329.630905009689,133981.5031629425,1394,6,277.86842105263156,32,6,18,33.75881725721785,0.6458333333333333,43.43434343434343,1026.2626262626259,32.07070707070706,0
3674,4,0,0,38,0.0,0.0,1.0,38,1300,900,400,0.6923076923076923,17,9,8,376.52881247048526,0.4424786628733997,0.10711118590967628,0.22298294058248472,131749.0741537853,2321.4644870421357,134070.53864082744,1395,7,278.86842105263156,32,6,18,33.6756446521543,0.6468098958333333,43.339646464646464,1026.641414141414,32.08254419191919,0
3675,4,0,1,37,0.0,0.02631578947368421,0.9736842105263158,38,1150,900,250,0.782608695652174,14,9,5,378.8930573462797,0.4420045045045045,0.10774431468961287,0.22514938068020343,131878.73247946642,2393.5872296194307,134272.31970908586,1396,8,279.86842105263156,32,6,18,33.483917230075804,0.6481119791666667,43.21338383838384,1027.146464646465,32.09832702020203,0
3676,4,0,1,36,0.0,0.02702702702702703,0.972972972972973,37,1400,1000,400,0.7142857142857143,18,10,8,384.68998166165346,0.44069069069069067,0.11607476187377364,0.22910102983336644,131962.84188164596,2752.9566446940057,134715.79852633996,1397,9,287.4594594594595,31,6,19,33.25003696193976,0.6515456989247312,43.131510416666664,1027.4739583333328,33.14432123655912,0
3677,4,0,0,36,0.0,0.0,1.0,36,1000,800,200,0.8,12,8,4,386.75261595198833,0.4395833333333334,0.11467236467236486,0.2302443143564638,131948.81633714863,3006.309978032119,134955.12631518074,1398,10,294.19444444444446,30,6,19,33.211233211233214,0.6541666666666667,43.14516129032257,1027.4193548387082,34.24731182795694,0
3678,4,0,1,35,0.0,0.027777777777777776,0.9722222222222222,36,1300,1000,300,0.7692307692307693,16,10,6,389.79314116021635,0.4399636243386243,0.11459150754206981,0.23247725096029737,132017.872369638,3091.932232049934,135109.80460168794,1399,11,295.19444444444446,30,6,19,33.06331197140116,0.6548611111111111,43.077956989247305,1027.68817204301,34.25627240143366,0
3679,4,0,0,35,0.0,0.0,1.0,35,1150,800,350,0.6956521739130435,15,8,7,382.0707967448693,0.4388655462184874,0.04733301551989011,0.21877811864562877,130455.99819214862,2968.685433884282,133424.6836260329,1400,13,304.3142857142857,32,3,21,34.84427141268076,0.6337890625,44.60227272727272,1021.590909090908,31.924715909090875,7
3680,4,0,1,34,0.0,0.02857142857142857,0.9714285714285714,35,1100,900,200,0.8181818181818182,13,9,4,383.9422849716445,0.4377450980392157,0.04984472049689437,0.22076681385869562,130617.28395061727,3029.899691358022,133647.1836419753,1401,14,305.3142857142857,32,3,19,34.63258605072465,0.6354166666666667,44.44444444444444,1022.2222222222222,31.944444444444443,0
3681,4,1,0,35,0.02857142857142857,0.0,1.0,35,950,300,650,0.3157894736842105,16,3,13,375.4050696554658,0.43781512605042017,0.03295019157088119,0.21773494040017033,130951.55709342571,2831.975682429848,133783.53277585556,1402,0,283.0571428571429,33,2,21,34.51169380587485,0.6363636363636364,44.117647058823536,1023.5294117647068,31.01604278074869,0
3682,4,1,2,34,0.027777777777777776,0.05555555555555555,0.9444444444444444,36,1000,700,300,0.7,13,7,6,372.05902556288083,0.43925264550264553,-0.010281701101124696,0.21066950905467252,130019.64462868459,2482.941117623493,132502.5857463081,1403,0,276.1666666666667,34,2,16,35.54336407143691,0.6246936274509804,45.02976190476189,1019.8809523809506,29.99649859943972,8
3683,4,1,0,35,0.02857142857142857,0.0,1.0,35,750,600,150,0.8,9,6,3,375.56470304004466,0.43960084033613445,0.008057376205346856,0.21329820719723136,130137.51471789692,2775.011413879278,132912.5261317762,1404,0,283.0857142857143,33,2,17,35.33409400272241,0.6281565656565656,44.91421568627451,1020.3431372549016,30.91948900772429,0
3684,4,0,0,35,0.0,0.0,1.0,35,700,400,300,0.5714285714285714,10,4,6,375.99722344273135,0.4387955182072829,0.008719962952163485,0.21405884306592665,130231.31315179246,2793.3224300749553,133024.63558186742,1405,1,284.0857142857143,33,2,18,35.22769340056828,0.6291035353535354,44.82230392156862,1020.7107843137245,30.93062982768862,0
3685,4,0,1,34,0.0,0.02857142857142857,0.9714285714285714,35,850,500,350,0.5882352941176471,12,5,7,370.30126142824366,0.4385504201680672,0.00943467379752505,0.2116660296805885,130387.71896626288,2656.5473615916876,133044.26632785457,1406,2,285.0857142857143,33,2,20,35.21418286537078,0.6306818181818181,44.66911764705882,1021.323529411764,30.949197860962546,0
3686,4,0,0,34,0.0,0.0,1.0,34,1300,1000,300,0.7692307692307693,16,10,6,372.66015772332275,0.43755570409982175,0.017769229091067817,0.21303519546459074,130391.51178770026,2918.344269717379,133309.85605741764,1407,3,293.02941176470586,32,2,21,35.15010096015165,0.6331380208333333,44.66540404040404,1021.3383838383841,31.916824494949502,0
3687,4,0,1,33,0.0,0.029411764705882353,0.9705882352941176,34,900,300,600,0.3333333333333333,15,3,12,371.09167975128304,0.4372586155674391,0.018310104909594616,0.2124913503798749,130455.99819214884,2882.227100550978,133338.22529269982,1408,4,294.02941176470586,32,2,21,35.12467556544309,0.6337890625,44.602272727272734,1021.5909090909098,31.92471590909093,0
3688,4,0,0,33,0.0,0.0,1.0,33,850,500,350,0.5882352941176471,12,5,7,379.2551609562329,0.43568497474747475,0.03681474443646238,0.21719970750821935,130462.04460991762,3295.680745442718,133757.72535536034,1409,5,302.75757575757575,31,2,22,34.91003908573372,0.6364247311827957,44.59635416666667,1021.614583333334,32.95530913978497,0
3689,4,0,0,33,0.0,0.0,1.0,33,1050,500,550,0.47619047619047616,16,5,11,379.2551609562329,0.43568497474747475,0.03681474443646238,0.21719970750821935,130462.04460991762,3295.680745442718,133757.72535536034,1410,6,303.75757575757575,31,2,22,34.91003908573372,0.6364247311827957,44.59635416666667,1021.614583333334,32.95530913978497,0
3690,4,0,1,32,0.0,0.030303030303030304,0.9696969696969697,33,450,300,150,0.6666666666666666,6,3,3,378.7042648795072,0.4354482323232323,0.0337592826442068,0.21707029704232972,130495.30241224506,3283.8255140516544,133779.1279262967,1411,7,304.75757575757575,31,2,17,34.89032432776857,0.636760752688172,44.563802083333336,1021.7447916666671,32.959509408602166,0
3691,4,2,0,34,0.058823529411764705,0.0,1.0,34,850,700,150,0.8235294117647058,10,7,3,364.1404680323121,0.43666443850267384,0.04644020103418023,0.21202751875162143,131101.7390604276,2747.889724262836,133849.62878469043,1412,0,295.3529411764706,32,2,21,34.647906135700495,0.6402994791666667,43.9709595959596,1024.1161616161621,32.003630050505066,0
3692,4,0,1,33,0.0,0.029411764705882353,0.9705882352941176,34,1000,700,300,0.7,13,7,6,362.36344154253874,0.43607026143790845,0.045219092662190485,0.21120178831328723,131139.77346453292,2704.051927143414,133843.82539167634,1413,1,296.3529411764706,33,1,21,34.65492143255962,0.6382575757575757,43.93382352941177,1024.2647058823534,31.038324420677377,0
3693,4,0,0,33,0.0,0.0,1.0,33,900,500,400,0.5555555555555556,13,5,8,369.75536834492425,0.43386994949494945,0.04991087344028533,0.21493521734114635,131037.09323347113,3090.3337350780635,134127.42696854917,1414,2,306.06060606060606,32,1,21,34.56961400912569,0.6396484375,44.034090909090914,1023.8636363636367,31.995738636363647,0
3694,4,0,1,32,0.0,0.030303030303030304,0.9696969696969697,33,1100,900,200,0.8181818181818182,13,9,4,369.1063950393261,0.43371212121212116,0.05179647541871679,0.21491902154802417,131101.73906042756,3078.0980575961685,134179.83711802372,1415,3,307.06060606060606,32,1,21,34.520763983068264,0.6402994791666667,43.9709595959596,1024.116161616162,32.00363005050506,0
3695,4,0,0,32,0.0,0.0,1.0,32,950,500,450,0.5263157894736842,14,5,9,379.6216628772304,0.43159862231182794,0.05428634977122493,0.22157739195237733,131194.69536675332,3560.8696831596985,134755.565049913,1416,4,314.125,31,1,22,34.157346212506354,0.6438172043010753,43.88020833333332,1024.4791666666654,33.0477150537634,0
3696,4,0,0,32,0.0,0.0,1.0,32,950,500,450,0.5263157894736842,14,5,9,377.5029018260934,0.43105258736559143,0.05999655827979544,0.22130781185454354,131362.56946250994,3518.0180495261147,134880.58751203606,1417,5,315.125,30,2,23,34.04161749923517,0.6482638888888889,43.71639784946235,1025.134408602149,34.17114695340497,0
3697,4,0,0,32,0.0,0.0,1.0,32,850,700,150,0.8235294117647058,10,7,3,378.34305845896984,0.4301915322580645,0.06086992136304059,0.2224004265055423,131465.92994854887,3547.844403977329,135013.7743525262,1418,6,316.125,30,2,23,33.915465268676286,0.6493055555555556,43.61559139784946,1025.5376344086014,34.18458781362005,0
3698,4,0,0,32,0.0,0.0,1.0,32,800,600,200,0.75,10,6,4,376.44383354843114,0.42996051747311825,0.055904460893489105,0.22188384412935702,131569.33108235046,3505.6926740085432,135075.023756359,1419,7,317.125,30,2,20,33.859557185903306,0.6503472222222222,43.51478494623655,1025.940860215053,34.1980286738351,0
3699,4,0,0,32,0.0,0.0,1.0,32,1050,700,350,0.6666666666666666,14,7,7,375.75540414652755,0.4293514784946237,0.05157597666159308,0.22240657704889064,131728.82080078125,3499.563259548612,135228.38406032987,1420,8,318.125,31,1,20,33.71596482327075,0.6491935483870968,43.359375,1026.5625,33.11491935483871,0
3700,4,0,0,32,0.0,0.0,1.0,32,1150,900,250,0.782608695652174,14,9,5,375.5209854802942,0.42842741935483875,0.05115365111561876,0.22305041667684927,131862.52170138876,3503.4288194444257,135365.9505208332,1421,9,319.125,31,1,20,33.58688302907369,0.6505376344086021,43.22916666666666,1027.0833333333321,33.131720430107485,0
3701,4,0,1,31,0.0,0.03125,0.96875,32,900,700,200,0.7777777777777778,11,7,4,376.79634545456935,0.42798639112903225,0.05292817767076441,0.22439999713071734,131962.84188164596,3544.6233113606727,135507.46519300665,1422,10,320.125,31,1,20,33.45279960292316,0.6515456989247312,43.131510416666664,1027.4739583333328,33.14432123655912,0
3702,4,0,0,31,0.0,0.0,1.0,31,750,500,250,0.6666666666666666,10,5,5,387.943431117762,0.4253584229390681,0.06436416746165086,0.23053372477464532,131879.7783703319,4032.3787432073186,135912.1571135392,1423,11,331.1290322580645,30,1,21,33.250457995289196,0.6534722222222222,43.212365591397855,1027.1505376344091,34.23835125448031,0
3703,4,0,0,31,0.0,0.0,1.0,31,800,600,200,0.75,10,6,4,390.04198064525497,0.42491039426523297,0.06637295116557795,0.23220256230937136,131948.81633714875,4093.115533587689,136041.93187073644,1424,12,332.1290322580645,30,1,21,33.12674428745858,0.6541666666666667,43.14516129032258,1027.419354838709,34.24731182795697,0
3704,4,0,0,31,0.0,0.0,1.0,31,550,300,250,0.5454545454545454,8,3,5,390.04198064525497,0.42491039426523297,0.06637295116557795,0.23220256230937136,131948.81633714875,4093.115533587689,136041.93187073644,1425,13,333.1290322580645,30,1,21,33.12674428745858,0.6541666666666667,43.14516129032258,1027.419354838709,34.24731182795697,0
3705,4,0,0,31,0.0,0.0,1.0,31,900,700,200,0.7777777777777778,11,7,4,390.98076149635,0.4241935483870967,0.06746823324997187,0.2338242255422659,132121.49029150762,4131.392176841254,136252.88246834886,1426,14,334.1290322580645,30,1,21,32.928051597158685,0.6559027777777777,42.97715053763441,1028.091397849462,34.26971326164873,0
3706,4,0,0,31,0.0,0.0,1.0,31,850,600,250,0.7058823529411765,11,6,5,388.5796180667977,0.4237903225806452,0.06938877016392486,0.23323920133844714,132259.71075052023,4078.6855778124523,136338.3963283327,1427,15,335.1290322580645,30,1,21,32.85013502330241,0.6572916666666666,42.842741935483865,1028.629032258064,34.28763440860213,0
3707,4,0,0,31,0.0,0.0,1.0,31,1050,800,250,0.7619047619047619,13,8,5,390.5981084757988,0.4225358422939068,0.07209089721823214,0.2353115433988347,132398.00347222216,4142.881944444435,136540.8854166666,1428,16,336.1290322580645,30,1,22,32.65856950067477,0.6586805555555555,42.70833333333333,1029.166666666666,34.305555555555536,0
3708,4,0,0,31,0.0,0.0,1.0,31,1050,600,450,0.5714285714285714,15,6,9,388.1456687277166,0.4215949820788531,0.07091720710856597,0.23447916580869935,132501.77043588844,4085.9976586888542,136587.7680945773,1429,17,337.1290322580645,30,1,22,32.61694952132288,0.6597222222222222,42.607526881720425,1029.5698924731175,34.318996415770584,0
3709,4,0,0,31,0.0,0.0,1.0,31,750,500,250,0.6666666666666666,10,5,5,392.4604680892208,0.4212365591397849,0.0718754473269847,0.23752228329380792,132570.97099375646,4205.773066250431,136776.7440600069,1430,18,338.1290322580645,30,1,22,32.436048029235195,0.6604166666666667,42.54032258064516,1029.838709677419,34.327956989247305,0
3710,4,0,0,31,0.0,0.0,1.0,31,700,300,400,0.42857142857142855,11,3,8,392.4604680892208,0.4212365591397849,0.0718754473269847,0.23752228329380792,132570.97099375646,4205.773066250431,136776.7440600069,1431,19,339.1290322580645,30,1,22,32.436048029235195,0.6604166666666667,42.54032258064516,1029.838709677419,34.327956989247305,0
3711,4,0,0,31,0.0,0.0,1.0,31,1000,800,200,0.8,12,8,4,391.7142123204265,0.4206989247311828,0.07161727834149478,0.2383860777835738,132778.68106139437,4202.259292981842,136980.94035437622,1432,20,340.1290322580645,30,1,21,32.24575073900191,0.6625,42.33870967741935,1030.6451612903224,34.354838709677416,0
3712,4,0,1,30,0.0,0.03225806451612903,0.967741935483871,31,500,300,200,0.6,7,3,4,390.86832643486724,0.419668458781362,0.06783823449018289,0.23853229372170778,132882.5970668574,4187.919665568266,137070.51673242566,1433,21,341.1290322580645,30,1,22,32.16279928735933,0.6635416666666667,42.23790322580645,1031.048387096774,34.368279569892465,0
3713,4,0,0,30,0.0,0.0,1.0,30,900,800,100,0.8888888888888888,10,8,2,401.2975784831554,0.418558429118774,0.06334231805929913,0.24406787150368958,132755.59413580244,4654.899691358017,137410.49382716045,1434,22,328.6,29,1,22,32.02212488769093,0.6652298850574713,42.36111111111111,1030.5555555555552,35.53639846743294,0
3714,4,0,1,29,0.0,0.03333333333333333,0.9666666666666667,30,1250,1100,150,0.88,14,11,3,405.64269484383016,0.4186302681992337,0.09499455930359102,0.23154387364067072,130333.48765432097,4573.765432098764,134907.25308641972,1435,23,329.6,29,1,21,34.36706565107001,0.6408045977011494,44.72222222222222,1021.111111111111,35.21072796934865,7
3715,4,1,0,30,0.03333333333333333,0.0,1.0,30,700,400,300,0.5714285714285714,10,4,6,396.7370355674774,0.42162356321839084,0.079057449409208,0.2287529203510833,130723.78713348757,4372.593557098755,135096.38069058632,1436,0,322.96666666666664,29,1,19,34.19730974693286,0.6447557471264368,44.34027777777777,1022.6388888888882,35.2634099616858,0
3716,4,0,0,30,0.0,0.0,1.0,30,1100,800,300,0.7272727272727273,14,8,6,398.23910801210485,0.42092911877394634,0.07958186261200129,0.23025347485221032,130830.3337191356,4420.351080246891,135250.6847993825,1437,1,323.96666666666664,29,1,20,34.05059281382931,0.6458333333333333,44.2361111111111,1023.0555555555538,35.27777777777772,0
3717,4,0,0,30,0.0,0.0,1.0,30,900,700,200,0.7777777777777778,11,7,4,401.7415073988919,0.42061781609195403,0.08994229183841718,0.21467508743385721,127723.00347222218,4262.326388888884,131985.32986111107,1438,2,324.96666666666664,29,1,14,37.13932399010718,0.6142241379310345,47.291666666666664,1010.8333333333329,34.856321839080444,7
3718,4,0,0,30,0.0,0.0,1.0,30,900,600,300,0.6666666666666666,12,6,6,402.5259030522745,0.4207375478927203,0.08552396648811977,0.21565791759555616,127828.3203124999,4290.842013888875,132119.16232638876,1439,3,325.96666666666664,29,1,14,37.01114201345969,0.615301724137931,47.18749999999999,1011.2499999999992,34.870689655172384,0
3719,4,0,0,30,0.0,0.0,1.0,30,850,600,250,0.7058823529411765,11,6,5,405.2392597075847,0.42109674329501917,0.08440417353102614,0.21768162003761418,127933.68055555565,4368.750000000006,132302.43055555565,1440,4,326.96666666666664,29,1,14,36.83415705656232,0.6163793103448276,47.083333333333336,1011.6666666666674,34.885057471264396,0
3720,4,0,0,30,0.0,0.0,1.0,30,650,400,250,0.6153846153846154,9,4,5,406.0830132414328,0.4205699233716475,0.08292615975844098,0.21851704833656435,128003.94483024694,4396.045524691366,132399.99035493832,1441,5,327.96666666666664,29,1,15,36.7405526580657,0.6170977011494253,47.01388888888889,1011.9444444444447,34.89463601532568,0
3721,4,1,1,30,0.03225806451612903,0.03225806451612903,0.967741935483871,31,900,700,200,0.7777777777777778,11,7,4,396.620510956327,0.426747311827957,0.07349310467290526,0.21527156458601504,128348.74561004159,3981.149012891662,132329.89462293324,1442,0,318.35483870967744,30,1,16,36.6259340319229,0.6177083333333333,46.67338709677419,1013.306451612903,33.7768817204301,0
3722,4,1,1,30,0.03225806451612903,0.03225806451612903,0.967741935483871,31,750,600,150,0.8,9,6,3,395.0450745516721,0.42665770609319,0.08303971539014121,0.2153338180937728,128519.04844490699,3954.1634148456524,132473.21185975266,1443,0,319.1290322580645,30,1,15,36.49119609402615,0.6194444444444445,46.505376344086024,1013.9784946236564,33.79928315412188,0
3723,4,1,0,31,0.03225806451612903,0.0,1.0,31,850,700,150,0.8235294117647058,10,7,3,395.9927973956836,0.4212813620071685,0.10194265992345564,0.21733558182646823,128791.76783443171,4000.1224852584082,132791.8903196901,1444,0,320.06451612903226,30,1,17,36.18770965748587,0.6222222222222222,46.236559139784944,1015.0537634408602,33.83512544802867,0
3724,4,1,0,32,0.03125,0.0,1.0,32,1000,800,200,0.8,12,8,4,384.77635712951957,0.42454217069892475,0.10597460612271048,0.2131972335067536,129168.29639010955,3540.181308322479,132708.47769843202,1445,0,311.03125,31,1,19,36.087405533495584,0.6233198924731183,45.865885416666664,1016.5364583333329,32.79149865591396,0
3725,4,0,0,32,0.0,0.0,1.0,32,1150,700,450,0.6086956521739131,16,7,9,387.0247442049575,0.4244581653225807,0.1051616517285534,0.21498316161029285,129267.58660210499,3605.9509277343705,132873.53752983935,1446,1,312.03125,31,1,19,35.928830559112264,0.6243279569892473,45.768229166666664,1016.9270833333329,32.80409946236558,0
3726,4,1,1,32,0.030303030303030304,0.030303030303030304,0.9696969696969697,33,900,500,400,0.5555555555555556,13,5,8,380.10906089888584,0.425228851010101,0.12490001013981655,0.21373519250126205,129747.52456700854,3263.6419434241507,133011.1665104327,1447,0,303.54545454545456,32,1,16,35.615214607345,0.6266276041666667,45.29671717171718,1018.8131313131319,31.83791035353537,0
3727,4,0,0,32,0.0,0.0,1.0,32,850,600,250,0.7058823529411765,11,6,5,391.1556583771259,0.4223370295698925,0.13265363217802784,0.2189295699964745,129565.68611992737,3736.0702514648538,133301.75637139223,1448,1,313.90625,31,1,16,35.51938120816814,0.6273521505376345,45.47526041666667,1018.0989583333339,32.84190188172045,0
3728,4,0,0,32,0.0,0.0,1.0,32,700,300,400,0.42857142857142855,11,3,8,391.1556583771259,0.4223370295698925,0.13265363217802784,0.2189295699964745,129565.68611992737,3736.0702514648538,133301.75637139223,1449,2,314.90625,31,1,16,35.51938120816814,0.6273521505376345,45.47526041666667,1018.0989583333339,32.84190188172045,0
3729,4,1,0,33,0.030303030303030304,0.0,1.0,33,1000,500,500,0.5,15,5,10,400.80808885854697,0.424636994949495,0.1621427892246139,0.2205242911209774,128890.09785899658,3732.0387591311037,132622.1366181277,1450,0,306.3333333333333,33,0,16,35.96477995011665,0.615530303030303,46.13970588235294,1015.4411764705885,30.770944741532986,8
3730,4,2,2,33,0.05714285714285714,0.05714285714285714,0.9428571428571428,35,750,600,150,0.8,9,6,3,381.2875250516225,0.4308823529411765,0.1539406345957015,0.21286737827167715,129466.28146701383,2872.7756076388832,132339.05707465272,1451,0,289.77142857142854,35,0,15,35.87192937563971,0.6169642857142856,45.572916666666664,1017.7083333333328,29.07738095238094,0
3731,4,1,0,34,0.029411764705882353,0.0,1.0,34,1100,900,200,0.8181818181818182,13,9,4,391.62417895818436,0.42829025549613786,0.15952026878167014,0.21784094954548988,129322.44897959175,3329.1595804988533,132651.6085600906,1452,0,299.2647058823529,34,0,17,35.75584230649188,0.6176470588235294,45.71428571428571,1017.1428571428564,29.9159663865546,0
3732,4,0,0,34,0.0,0.0,1.0,34,900,700,200,0.7777777777777778,11,7,4,393.73078685117997,0.42760323826500296,0.16343883990942798,0.2195183976005893,129413.2812499999,3390.7986111110963,132804.079861111,1453,1,300.2647058823529,34,0,17,35.60947310947311,0.6185661764705883,45.62499999999999,1017.4999999999992,29.926470588235272,0
3733,4,1,1,34,0.02857142857142857,0.02857142857142857,0.9714285714285714,35,1350,1100,250,0.8148148148148148,16,11,5,388.4493381586857,0.4292366946778712,0.1598053054271118,0.21882894577653358,129819.89354263089,3085.6903452931765,132905.58388792406,1454,0,292.65714285714284,35,0,17,35.32900340715502,0.6205357142857143,45.22569444444443,1019.0972222222199,29.117063492063426,0
3734,4,1,0,35,0.02857142857142857,0.0,1.0,35,1050,800,250,0.7619047619047619,13,8,5,383.0849527353221,0.4262955182072829,0.15971461002108045,0.2166224925287664,129967.37423911154,2957.7090835047725,132925.08332261632,1455,0,293.57142857142856,35,0,18,35.31545592130154,0.6220238095238095,45.081018518518505,1019.6759259259238,29.133597883597822,0
3735,4,1,0,36,0.027777777777777776,0.0,1.0,36,900,700,200,0.7777777777777778,11,7,4,380.4144941106039,0.42810846560846566,0.16603182006633554,0.2169172008971101,130292.97052154178,2713.7366893773774,133006.70721091915,1456,0,286.3888888888889,34,2,19,35.052277674129364,0.6274509803921569,44.76190476190475,1020.9523809523796,30.028011204481754,0
3736,4,0,0,36,0.0,0.0,1.0,36,1050,800,250,0.7619047619047619,13,8,5,381.9059764488604,0.4279596560846561,0.16809457201694045,0.21827923863789286,130384.1429280045,2758.896683673462,133143.03961167796,1457,1,287.3888888888889,34,2,19,34.92151377394412,0.6283700980392157,44.672619047619044,1021.3095238095235,30.038515406162457,0
3737,4,0,0,36,0.0,0.0,1.0,36,800,600,200,0.75,10,6,4,378.9875124560719,0.42746362433862434,0.17008751148911982,0.2172912371015673,130505.75573979582,2692.010345804979,133197.7660856008,1458,2,288.3888888888889,34,2,16,34.872470775564096,0.6295955882352942,44.55357142857142,1021.7857142857134,30.052521008403335,0
3738,4,0,0,36,0.0,0.0,1.0,36,850,700,150,0.8235294117647058,10,7,3,382.2917150737309,0.42713293650793654,0.16655342004788687,0.2195300584553832,130566.58340419494,2782.9046201813953,133349.48802437633,1459,3,289.3888888888889,34,2,16,34.72626674432149,0.6302083333333333,44.49404761904761,1022.023809523809,30.059523809523792,0
3739,4,0,0,36,0.0,0.0,1.0,36,1150,800,350,0.6956521739130435,15,8,7,388.2999917038458,0.42703373015873014,0.16591976099018368,0.2240352739239584,130749.15143140587,2953.9788832199542,133703.13031462583,1460,4,290.3888888888889,34,2,16,34.387246343072206,0.632046568627451,44.31547619047619,1022.7380952380951,30.08053221288515,0
3740,4,1,1,36,0.02702702702702703,0.02702702702702703,0.972972972972973,37,800,500,300,0.625,11,5,6,379.9966830288996,0.42936686686686687,0.1667517149710478,0.22068750238940343,131002.08340031284,2556.071432398823,133558.15483271168,1461,0,283.5135135135135,35,2,17,34.342966836254,0.6324404761904762,44.06828703703703,1023.7268518518512,29.249338624338606,0
3741,4,0,0,36,0.0,0.0,1.0,36,800,400,400,0.5,12,4,8,386.2419842427701,0.4275958994708995,0.16972076788830748,0.2235521787586942,130870.93431122445,2909.56986961451,133780.50418083897,1462,1,292.22222222222223,34,2,17,34.316220670932715,0.6332720588235294,44.19642857142857,1023.2142857142853,30.09453781512604,0
3742,4,0,1,35,0.0,0.027777777777777776,0.9722222222222222,36,850,600,250,0.7058823529411765,11,6,5,385.26466154868797,0.42724867724867727,0.16799570184368284,0.22305991308133274,130883.62328800159,2884.9669656635842,133768.59025366517,1463,2,293.22222222222223,35,1,17,34.32834238208347,0.63125,44.18402777777778,1023.2638888888893,29.23611111111112,0
3743,4,1,0,36,0.027777777777777776,0.0,1.0,36,850,700,150,0.8235294117647058,10,7,3,383.85526322964535,0.426058201058201,0.18261008776886278,0.2236165387965196,131120.5970963006,2866.266262645752,133986.86335894634,1464,0,293.94444444444446,35,1,18,34.124030022224744,0.6336309523809525,43.9525462962963,1024.189814814815,29.262566137566143,0
3744,4,0,0,36,0.0,0.0,1.0,36,1200,900,300,0.75,15,9,6,384.41252844129184,0.42604166666666665,0.18477933423708448,0.2244604024909177,131209.51753257873,2887.716478052112,134097.23401063084,1465,1,294.94444444444446,35,1,18,34.019618918511824,0.6345238095238095,43.86574074074073,1024.537037037036,29.272486772486744,0
3745,4,0,0,36,0.0,0.0,1.0,36,700,400,300,0.5714285714285714,10,4,6,384.42280543607393,0.42516534391534394,0.18127653260042065,0.22534137356092812,131358.63272392293,2899.5044056717343,134258.13712959466,1466,2,295.94444444444446,34,2,19,33.86825959044632,0.6381740196078431,43.720238095238095,1025.1190476190477,30.150560224089638,0
3746,4,0,0,36,0.0,0.0,1.0,36,1250,1000,250,0.8,15,10,5,385.5623062933668,0.42448743386243387,0.18641581221383952,0.22673169069743024,131480.69905045338,2938.8003117913663,134419.49936224474,1467,3,296.94444444444446,34,2,19,33.71541884310312,0.6393995098039216,43.60119047619047,1025.595238095237,30.1645658263305,0
3747,4,0,0,36,0.0,0.0,1.0,36,1000,700,300,0.7,13,7,6,383.22091289344905,0.4238095238095238,0.18087780355761796,0.22625782665352945,131633.3616780045,2888.931405895686,134522.29308390018,1468,4,297.94444444444446,34,2,18,33.620939675174014,0.6409313725490196,43.45238095238095,1026.190476190476,30.182072829131645,0
3748,4,0,0,36,0.0,0.0,1.0,36,1050,700,350,0.6666666666666666,14,7,7,383.1856995730222,0.42379298941798943,0.18080849089432793,0.22641836298965196,131663.9048327664,2890.3450963718756,134554.24992913826,1469,5,298.94444444444446,34,2,19,33.59094072613386,0.6412377450980392,43.422619047619044,1026.3095238095234,30.185574229691866,0
3749,4,0,0,36,0.0,0.0,1.0,36,900,500,400,0.5555555555555556,13,5,8,382.00089624652855,0.4237599206349207,0.1829249195073981,0.22601507330289944,131713.96933138295,2862.9708665552184,134576.94019793818,1470,6,299.94444444444446,35,1,19,33.57070037959934,0.6395833333333334,43.373842592592595,1026.5046296296302,29.32870370370372,0
3750,4,0,0,36,0.0,0.0,1.0,36,950,500,450,0.5263157894736842,14,5,9,383.2560512489249,0.42268518518518516,0.18621816542709024,0.22764485935628934,131862.521701389,2907.4218750000105,134769.943576389,1471,7,300.94444444444446,35,1,19,33.38826910074375,0.6410714285714285,43.22916666666667,1027.0833333333342,29.34523809523812,0
3751,4,0,0,36,0.0,0.0,1.0,36,1300,1000,300,0.7692307692307693,16,10,6,383.49410159828625,0.42278439153439157,0.187985078363627,0.22814300574975818,131921.9660922498,2918.2591735253945,134840.22526577517,1472,8,301.94444444444446,35,1,19,33.32206699714586,0.6416666666666666,43.171296296296305,1027.314814814816,29.351851851851883,0
3752,4,1,1,36,0.02702702702702703,0.02702702702702703,0.972972972972973,37,1050,600,450,0.5714285714285714,15,6,9,378.14093002671746,0.4226413913913914,0.19717693401903946,0.2278068529673151,132398.00347222216,2614.7355109739283,135012.7389831961,1473,0,294.7567567567568,34,3,20,32.97908232118759,0.6485906862745099,42.70833333333333,1029.166666666666,30.269607843137237,0
3753,4,0,0,36,0.0,0.0,1.0,36,750,700,50,0.9333333333333333,8,7,1,381.79187845562893,0.4218419312169312,0.16022310198358736,0.21717267794207246,130198.14822785948,2824.184394449558,133022.33262230904,1474,1,296.3333333333333,32,4,18,35.11356138397461,0.6311848958333333,44.854797979797986,1020.5808080808087,31.89315025252527,8
3754,4,0,0,36,0.0,0.0,1.0,36,900,700,200,0.7777777777777778,11,7,4,380.9337159544294,0.42220568783068785,0.1606480336383873,0.21722355622055864,130294.81207274791,2726.737386491204,133021.54945923912,1475,2,297.3333333333333,32,4,19,35.03715269189545,0.6321614583333333,44.760101010101025,1020.9595959595979,31.904987373737434,0
3755,4,0,0,36,0.0,0.0,1.0,36,1450,900,550,0.6206896551724138,20,9,11,382.45907061794367,0.4209986772486773,0.17120650607370824,0.2197307435523246,130585.01882779812,2788.6849875012667,133373.70381529938,1476,3,298.3333333333333,32,4,15,34.70326333127444,0.6350911458333333,44.4760101010101,1022.0959595959591,31.940498737373723,0
3756,4,1,0,37,0.02702702702702703,0.0,1.0,37,1000,700,300,0.7,13,7,6,371.73997516689985,0.42336086086086083,0.17096737671243956,0.2161369166680201,131045.64838343425,2342.9812151576275,133388.62959859188,1477,0,291.2432432432432,33,4,16,34.51014861360462,0.6373106060606061,44.025735294117645,1023.8970588235294,31.027183600713013,0
3757,4,0,0,37,0.0,0.0,1.0,37,1300,1100,200,0.8461538461538461,15,11,4,376.64387263757493,0.42357982982982983,0.16231163139690952,0.2108506038709792,129573.74762854072,2406.8916219581,131980.63925049882,1478,1,292.2432432432432,36,1,15,35.880525753050904,0.6160300925925926,45.46734234234234,1018.1306306306307,28.281406406406408,8
3758,4,0,2,35,0.0,0.05405405405405406,0.9459459459459459,37,1300,1000,300,0.7692307692307693,16,10,6,375.80555269100785,0.4239239239239239,0.15808919791697007,0.21107820946187805,129703.52055440133,2348.6606455832557,132052.1811999846,1479,2,293.2432432432432,37,0,17,35.76964477933262,0.615427927927928,45.33991228070175,1018.6403508771928,27.530820293978184,0
3759,4,1,0,36,0.027777777777777776,0.0,1.0,36,650,400,250,0.6153846153846154,9,4,5,377.44320300571957,0.4250330687830688,0.1494866882797916,0.21238222019874106,129774.47041636254,2596.4983564645963,132370.96877282715,1480,0,292.05555555555554,36,0,18,35.65566976127321,0.6180555555555556,45.27027027027028,1018.9189189189208,28.303303303303355,0
3760,4,0,0,36,0.0,0.0,1.0,36,1150,800,350,0.6956521739130435,15,8,7,380.50224722634033,0.4243551587301588,0.1542858720866005,0.2148900089918944,129917.93894823916,2686.813544963924,132604.7524932031,1481,1,293.05555555555554,36,0,19,35.4316248757318,0.6195023148148149,45.129504504504524,1019.481981981985,28.318943943944028,0
3761,4,1,0,37,0.02702702702702703,0.0,1.0,37,1100,700,400,0.6363636363636364,15,7,8,374.5204909712159,0.42520645645645644,0.16017740315111118,0.21403943085038907,130380.7656035665,2366.966744647547,132747.73234821405,1482,0,286.1081081081081,35,2,20,35.113516168026585,0.6261904761904762,44.675925925925924,1021.2962962962961,29.179894179894173,0
3762,4,0,0,37,0.0,0.0,1.0,37,1500,1200,300,0.8,18,12,6,369.43230151228755,0.4237675175175175,0.15246768507638087,0.21242357336956516,130617.28395061713,2250.8487654320816,132868.1327160492,1483,1,287.1081081081081,35,2,15,35.003396739130444,0.6285714285714286,44.444444444444436,1022.2222222222209,29.20634920634917,0
3763,4,0,0,37,0.0,0.0,1.0,37,1450,1300,150,0.896551724137931,16,13,3,369.1479275063932,0.42357982982982983,0.15599644002948287,0.21307382334252095,130765.21675936632,2254.3417513288628,133019.55851069518,1484,2,288.1081081081081,35,2,16,34.86064746708914,0.6300595238095238,44.29976851851851,1022.8009259259251,29.222883597883573,0
3764,4,0,0,37,0.0,0.0,1.0,37,1150,800,350,0.6956521739130435,15,8,7,371.4681802532914,0.42214089089089085,0.15930177124207012,0.21556854239895726,130972.4633487654,2330.4205246913566,133302.88387345677,1485,3,289.1081081081081,35,2,18,34.59124830393487,0.6321428571428571,44.09722222222222,1023.611111111111,29.246031746031743,0
3765,4,0,1,36,0.0,0.02702702702702703,0.972972972972973,37,900,500,400,0.5555555555555556,13,5,8,372.83876769786264,0.4223285785785786,0.15644332022765406,0.21686420629999933,131061.3335503472,2372.9492187499955,133434.2827690972,1486,4,290.1081081081081,35,2,18,34.46613258731772,0.6330357142857144,44.010416666666664,1023.9583333333331,29.255952380952376,0
3766,4,0,0,36,0.0,0.0,1.0,36,600,300,300,0.5,9,3,6,398.01657663966813,0.4209986772486773,0.17596517474961582,0.21527248558508308,128208.45967567104,3073.635283548898,131282.09495921995,1487,5,298.47222222222223,32,4,17,36.73456135976397,0.6110026041666667,46.8118686868687,1012.7525252525268,31.64851641414146,8
3767,4,2,1,37,0.05263157894736842,0.02631578947368421,0.9736842105263158,38,1300,1000,300,0.7692307692307693,16,10,6,378.0648649939504,0.4264758179231864,0.1892571365114224,0.2082163565696188,128929.21095521563,2148.720946712044,131077.9319019277,1488,0,283.7105263157895,34,4,16,36.5021685617161,0.6136642156862745,46.10119047619049,1015.5952380952398,29.870448179271758,0
3768,4,1,0,38,0.02631578947368421,0.0,1.0,38,600,300,300,0.5,9,3,6,376.9384043596154,0.4289651493598862,0.19725590772057222,0.20854978341011285,129110.63102324282,2133.351048752856,131243.98207199568,1489,0,284.2894736842105,34,4,17,36.34546679161297,0.6155024509803921,45.92261904761906,1016.3095238095254,29.8914565826331,0
3769,4,0,0,38,0.0,0.0,1.0,38,1450,1200,250,0.8275862068965517,17,12,5,376.1858092587915,0.4280464675201517,0.19931500098560995,0.20925335640020298,129322.44897959198,2129.8540249433263,131452.3030045353,1490,1,285.2894736842105,34,4,17,36.14841799313358,0.6176470588235294,45.71428571428572,1017.1428571428582,29.915966386554654,0
3770,4,0,0,38,0.0,0.0,1.0,38,1150,800,350,0.6956521739130435,15,8,7,374.9666564070991,0.4270981507823613,0.1932902431517387,0.20954019034514398,129504.14540816352,2111.947278911592,131616.0926870751,1491,2,286.2894736842105,34,4,13,35.99415204678362,0.6194852941176471,45.5357142857143,1017.8571428571449,29.93697478991603,0
3771,4,0,1,37,0.0,0.02631578947368421,0.9736842105263158,38,1000,500,500,0.5,15,5,10,373.2413623908587,0.4256164058795638,0.18340487816878048,0.20986856631675227,129746.60572562362,2085.3599773242713,131831.9657029479,1492,3,287.2894736842105,34,4,14,35.79107268053284,0.6219362745098039,45.29761904761905,1018.8095238095241,29.964985994397768,0
3772,4,0,1,36,0.0,0.02702702702702703,0.972972972972973,37,1600,1400,200,0.875,18,14,4,372.1451690763132,0.42583208208208206,0.1965188734635126,0.20990164279521706,129867.92091836737,2265.943877551025,132133.8647959184,1493,4,293.8918918918919,34,3,16,35.69551506657322,0.6231617647058824,45.17857142857143,1019.2857142857144,29.97899159663866,0
3773,4,1,0,37,0.02702702702702703,0.0,1.0,37,950,700,250,0.7368421052631579,12,7,5,371.0542198339744,0.4256131131131131,0.1962102207286096,0.20977421735168264,129958.94451530614,2244.362953514741,132203.3074688209,1494,0,294.7567567567568,34,3,18,35.63071609262503,0.6240808823529411,45.089285714285715,1019.6428571428573,29.989495798319332,0
3774,4,0,0,37,0.0,0.0,1.0,37,1300,1100,200,0.8461538461538461,15,11,4,371.61355209284227,0.4238613613613614,0.20331917496775764,0.2110735424113816,130141.08737244886,2272.43835034012,132413.525722789,1495,1,295.7567567567568,34,3,19,35.43125072920312,0.6259191176470589,44.91071428571428,1020.3571428571419,30.010504201680643,0
3775,4,0,1,36,0.0,0.02702702702702703,0.972972972972973,37,1100,800,300,0.7272727272727273,14,8,6,368.6983073087939,0.4234234234234234,0.20236248950243052,0.20975365637735116,130203.5175004286,2201.1633016117853,132404.68080204038,1496,2,296.7567567567568,35,2,19,35.44218265668707,0.6244047619047619,44.84953703703703,1020.6018518518513,29.160052910052894,0
3776,4,0,0,36,0.0,0.0,1.0,36,700,500,200,0.7142857142857143,9,5,4,367.0898219954332,0.4225694444444445,0.19387437810945274,0.2093193027548427,130292.97052154192,2365.858067120876,132658.8285886628,1497,3,301.55555555555554,34,2,19,35.39237406716417,0.6274509803921569,44.76190476190476,1020.9523809523807,30.028011204481786,0
3777,4,0,0,36,0.0,0.0,1.0,36,1400,900,500,0.6428571428571429,19,9,10,364.3542710990398,0.4211309523809524,0.18966108716196062,0.20890131655598268,130505.75573979599,2310.065901360548,132815.82164115654,1498,4,302.55555555555554,34,2,14,35.246271699871826,0.6295955882352942,44.55357142857143,1021.7857142857149,30.052521008403378,0
3778,4,0,0,36,0.0,0.0,1.0,36,850,600,250,0.7058823529411765,11,6,5,363.2920593308325,0.4215608465608465,0.1925941021958264,0.20894768342088785,130627.42524092957,2291.1812641723227,132918.6065051019,1499,5,303.55555555555554,34,2,15,35.150032995613536,0.6308210784313726,44.4345238095238,1022.2619047619037,30.066526610644225,0
3779,4,0,0,36,0.0,0.0,1.0,36,1000,800,200,0.8,12,8,4,359.5480392606187,0.4211309523809524,0.18806030969845167,0.2071199268416804,130688.28125,2197.7430555555557,132886.02430555556,1500,6,304.55555555555554,34,2,15,35.18405324640044,0.6314338235294117,44.375,1022.5,30.073529411764707,0
3780,4,0,1,35,0.0,0.027777777777777776,0.9722222222222222,36,1500,1100,400,0.7333333333333333,19,11,8,359.00942022200735,0.42037037037037034,0.18680814194082362,0.20729898780561068,130779.59183673466,2190.2210884353726,132969.81292517003,1501,7,305.55555555555554,34,2,15,35.10533054003725,0.6323529411764706,44.285714285714285,1022.8571428571425,30.08403361344537,0
3781,4,0,1,34,0.0,0.02857142857142857,0.9714285714285714,35,950,600,350,0.631578947368421,13,6,7,365.5618818115382,0.42034313725490197,0.1760832363611471,0.21133729843232157,130826.1546039986,2565.0110534410014,133391.1656574396,1502,8,307.25714285714287,33,2,18,34.890592557099495,0.6351010101010102,44.24019607843138,1023.0392156862756,31.001188354129564,0
3782,4,0,0,34,0.0,0.0,1.0,34,950,400,550,0.42105263157894735,15,4,11,372.0551275874376,0.42103015448603687,0.17323489464930297,0.2144679344007588,130714.10323245097,2926.5704711254225,133640.6737035764,1503,9,313.4117647058824,32,2,18,34.83814874264312,0.6363932291666667,44.34974747474749,1022.6010101010118,31.956281565656617,0
3783,4,0,1,33,0.0,0.029411764705882353,0.9705882352941176,34,1050,700,350,0.6666666666666666,14,7,7,371.27899571696975,0.421215834818776,0.17275644982100968,0.21437855625824478,130778.66934815342,2911.0746033568225,133689.74395151023,1504,10,314.4117647058824,32,2,18,34.792515327325845,0.6370442708333333,44.28661616161617,1022.8535353535367,31.964172979798022,0
3784,4,0,0,33,0.0,0.0,1.0,33,1300,900,400,0.6923076923076923,17,9,8,387.16417646303125,0.4192708333333333,0.15781525959231946,0.2138304823608793,129040.9799542138,3392.0089467911353,132432.98890100495,1505,17,324.6363636363636,32,1,20,36.15684934344061,0.6194661458333333,45.99116161616161,1016.0353535353531,31.751104797979785,8
3785,4,0,0,33,0.0,0.0,1.0,33,1000,700,300,0.7,13,7,6,387.1270762516968,0.4194286616161616,0.15882266571793235,0.2141571021821241,129105.13157139569,3396.018422865002,132501.1499942607,1506,18,325.6363636363636,32,1,20,36.09221642440055,0.6201171875,45.9280303030303,1016.2878787878781,31.75899621212119,0
3786,4,1,1,33,0.029411764705882353,0.029411764705882353,0.9705882352941176,34,750,500,250,0.6666666666666666,10,5,5,375.49077620492017,0.4221813725490196,0.16086008256679363,0.21004726450735822,129544.24267409154,2928.533646914626,132472.77632100615,1507,0,317.02941176470586,33,1,18,35.93994522691704,0.6221590909090908,45.496323529411754,1018.0147058823517,30.848930481283386,0
3787,4,1,0,34,0.029411764705882353,0.0,1.0,34,1200,800,400,0.6666666666666666,16,8,8,373.75035661739054,0.4241495840760547,0.16667609918290838,0.21040854538074472,129793.87622849374,2902.101505430587,132695.97773392432,1508,0,316.7352941176471,33,1,19,35.72998095810782,0.6246843434343434,45.25122549019607,1018.9950980392148,30.87863933452166,0
3788,4,1,0,35,0.02857142857142857,0.0,1.0,35,800,500,300,0.625,11,5,6,364.9434406539293,0.4273809523809524,0.16814840742037163,0.20728497215671463,130141.08737244883,2498.827239229008,132639.91461167784,1509,0,308.65714285714284,34,1,21,35.60139812546182,0.6259191176470589,44.91071428571428,1020.3571428571416,30.010504201680636,0
3789,4,0,0,35,0.0,0.0,1.0,35,1300,900,400,0.6923076923076923,17,9,8,366.680549770929,0.426890756302521,0.1681632653061227,0.20892263882297094,130262.58680555539,2553.0080782312725,132815.59488378666,1510,1,309.65714285714284,33,2,21,35.43367346938775,0.6294191919191919,44.79166666666666,1020.833333333332,30.934343434343393,0
3790,4,0,1,34,0.0,0.02857142857142857,0.9714285714285714,35,600,400,200,0.6666666666666666,8,4,4,366.68027230012143,0.4262254901960784,0.17201838008367076,0.20925890608250736,130325.14537677797,2557.531958861954,132882.67733563992,1511,2,310.65714285714284,33,2,21,35.37015922547607,0.630050505050505,44.730392156862735,1021.0784313725475,30.941770647652955,0
3791,4,0,0,34,0.0,0.0,1.0,34,700,400,300,0.5714285714285714,10,4,6,367.30538878703993,0.425839275103981,0.15356653820635557,0.20995357408444357,130387.71896626285,2778.422361591686,133166.14132785454,1512,3,311.5,33,1,21,35.290676745860345,0.6306818181818181,44.66911764705882,1021.3235294117637,30.94919786096254,0
3792,4,1,0,35,0.02857142857142857,0.0,1.0,35,700,400,300,0.5714285714285714,10,4,6,361.14901996392376,0.42766106442577034,0.15389988358556428,0.20820604573759066,130718.7145691608,2441.787131519244,133160.50170068003,1513,0,303.57142857142856,34,1,19,35.11229142413658,0.6317401960784313,44.34523809523808,1022.619047619046,30.07703081232488,0
3793,4,1,0,36,0.027777777777777776,0.0,1.0,36,800,600,200,0.75,10,6,4,349.879336448568,0.4299603174603175,0.15488748241912886,0.20366660321690278,131090.96364883374,1973.2038751714376,133064.16752400517,1514,0,296.1111111111111,35,1,20,35.023922543701026,0.6333333333333333,43.98148148148147,1024.0740740740719,29.259259259259196,0
3794,4,0,1,35,0.0,0.027777777777777776,0.9722222222222222,36,600,400,200,0.6666666666666666,8,4,4,351.0027527025227,0.42929894179894185,0.15445348195009312,0.2049522669474094,131209.51753257864,2010.980366940985,133220.49789951963,1515,1,297.1111111111111,35,1,20,34.87535773459857,0.6345238095238095,43.865740740740726,1024.5370370370351,29.27248677248672,0
3795,4,0,0,35,0.0,0.0,1.0,35,1200,1000,200,0.8333333333333334,14,10,4,358.021128192343,0.4258053221288515,0.16675191815856816,0.20836926554198446,131084.190759637,2386.1819727890916,133470.37273242607,1516,2,306.42857142857144,34,1,20,34.82232814074246,0.6354166666666667,43.98809523809523,1024.0476190476174,30.11904761904757,0
3796,4,0,0,35,0.0,0.0,1.0,35,1100,800,300,0.7272727272727273,14,8,6,354.98461398910666,0.42598039215686273,0.1366940211019929,0.19535604885981184,128898.98667800476,2151.431405895719,131050.41808390048,1517,3,307.42857142857144,34,1,19,37.1189917936694,0.6133578431372548,46.130952380952394,1015.4761904761923,29.866946778711537,8
3797,4,0,0,35,0.0,0.0,1.0,35,1000,600,400,0.6,14,6,8,351.7258536383095,0.4244047619047619,0.13616024364530865,0.19460036374013295,129110.63102324282,2082.3093820861886,131192.94040532902,1518,4,308.42857142857144,34,1,19,36.986060677052826,0.6155024509803921,45.92261904761906,1016.3095238095254,29.8914565826331,0
3798,4,0,1,34,0.0,0.02857142857142857,0.9714285714285714,35,700,600,100,0.8571428571428571,8,6,2,352.4104640646865,0.4243347338935574,0.13036037121851263,0.1955819144043279,129232.53864198856,2108.6116707712395,131341.1503127598,1519,5,309.42857142857144,33,2,20,36.84451709453216,0.6190025252525253,45.80269607843137,1016.7892156862738,30.81179441473557,0
3799,4,0,0,34,0.0,0.0,1.0,34,1300,800,500,0.6153846153846154,18,8,10,361.2524231106672,0.419674688057041,0.13776974476941595,0.20082044638760696,129297.68207644633,2541.8201905417886,131839.50226698813,1520,7,319.38235294117646,32,2,20,36.55338299193046,0.6220703125,45.73863636363637,1017.045454545455,31.782670454545467,0
3800,4,2,0,36,0.05555555555555555,0.0,1.0,36,1200,900,300,0.75,15,9,6,339.8416241874974,0.42382605820105823,0.14160635068876992,0.192277632284683,129989.29280045339,1635.1544784580371,131624.44727891142,1521,0,302.5833333333333,34,2,22,36.395585259553286,0.6243872549019608,45.0595238095238,1019.7619047619037,29.99299719887952,0
3801,4,0,0,36,0.0,0.0,1.0,36,900,700,200,0.7777777777777778,11,7,4,340.1736511598102,0.4234623015873016,0.13734567901234573,0.1927650689905593,130050.00000000012,1647.9166666666822,131697.9166666668,1522,1,303.5833333333333,34,2,22,36.32557189542485,0.625,45.00000000000001,1020.0000000000009,30.00000000000003,0
3802,4,1,0,37,0.02702702702702703,0.0,1.0,37,750,500,250,0.6666666666666666,10,5,5,331.5208800106361,0.4248936436436436,0.13417404812997602,0.18918526865277635,130323.35778061228,1241.156462585029,131564.5142431973,1523,0,296.35135135135135,34,3,23,36.26948039329989,0.6277573529411764,44.732142857142854,1021.0714285714289,30.031512605042025,0
3803,4,0,0,37,0.0,0.0,1.0,37,950,600,350,0.631578947368421,13,6,7,331.91856865592456,0.4248936436436436,0.13727763669475057,0.1895604182377177,130353.74858276638,1253.3659297052095,131607.1145124716,1524,1,297.35135135135135,34,3,23,36.22857892282584,0.6280637254901961,44.70238095238095,1021.1904761904757,30.035014005602225,0
3804,4,0,0,37,0.0,0.0,1.0,37,1150,700,450,0.6086956521739131,16,7,9,347.53809045385253,0.4247372372372373,0.1175324114621239,0.18988926588139415,128613.70991941006,1539.6326303154888,130153.34254972555,1525,2,298.35135135135135,35,2,17,37.598889396014,0.6083333333333334,46.41203703703703,1014.3518518518512,28.981481481481463,8
3805,4,1,0,38,0.02631578947368421,0.0,1.0,38,900,600,300,0.6666666666666666,12,6,6,345.4637465325668,0.42641654812707447,0.1327148398675544,0.19090116512327351,129062.08070031164,1317.253986803627,130379.33468711526,1526,0,291.4736842105263,37,1,18,37.194592820402136,0.6089527027027026,45.9703947368421,1016.1184210526316,27.462660028449502,0
3806,4,0,1,37,0.0,0.02631578947368421,0.9736842105263158,38,800,500,300,0.625,11,5,6,345.0447096052759,0.42680180180180183,0.13137457493372073,0.19120797984163243,129173.52123970828,1314.1280249692095,130487.64926467749,1527,1,292.4736842105263,37,1,18,37.091805091144444,0.6100788288288288,45.86074561403508,1016.5570175438588,27.47451398767186,0
3807,4,1,0,38,0.02631578947368421,0.0,1.0,38,1200,900,300,0.75,15,9,6,347.9920495799351,0.42997273589378854,0.1337527463881718,0.19339791998500902,129287.27027280675,1398.1914390983507,130685.4617119051,1528,0,293.2894736842105,36,2,19,36.901136825010155,0.6131365740740741,45.74887387387388,1017.0045045045058,28.250125125125162,0
3808,4,1,1,38,0.02564102564102564,0.02564102564102564,0.9743589743589743,39,1300,800,500,0.6153846153846154,18,8,10,339.66583244025804,0.43049932523616735,0.14346613249012896,0.19118804245107934,129787.30384589496,1016.8625201985278,130804.16636609349,1529,0,286.7435897435897,37,2,16,36.60494906560492,0.6162725225225225,45.25767543859649,1018.9692982456146,27.53971076339499,0
3809,4,0,0,38,0.0,0.0,1.0,38,1050,800,250,0.7619047619047619,13,8,5,350.6431032595959,0.4260016595542911,0.1424519904824506,0.19715774737038944,129745.78622118755,1498.8930230906722,131244.67924427823,1530,1,295.2631578947368,36,2,16,36.36748830183118,0.6177662037037037,45.29842342342343,1018.8063063063074,28.300175175175205,0
3810,4,1,0,39,0.02564102564102564,0.0,1.0,39,750,400,350,0.5333333333333333,11,4,7,344.5311834799533,0.4277721547458389,0.14159204226924316,0.19531831809347988,130066.7768568213,1162.4121123807295,131229.18896920205,1531,0,288.6666666666667,37,2,17,36.197440789709404,0.6190878378378378,44.983552631578945,1020.065789473684,27.56934566145092,0
3811,4,0,0,39,0.0,0.0,1.0,39,1300,1000,300,0.7692307692307693,16,10,6,343.78474768551933,0.42743477282950965,0.14086586669311263,0.1955958698934482,130206.62607725442,1152.6104185903268,131359.23649584476,1532,1,289.6666666666667,37,2,18,36.07470276464692,0.6204954954954955,44.84649122807017,1020.6140350877183,27.584163110478872,0
3812,4,0,0,39,0.0,0.0,1.0,39,650,300,350,0.46153846153846156,10,3,7,342.69054560599767,0.4272941970310391,0.13375196232339137,0.19525391551969618,130262.58680555539,1127.963411819002,131390.5502173744,1533,2,290.6666666666667,36,3,19,36.04591836734692,0.622974537037037,44.79166666666666,1020.833333333332,28.356481481481445,0
3813,4,0,0,39,0.0,0.0,1.0,39,800,500,300,0.625,11,5,6,342.4398801471674,0.4274628879892038,0.13440682327855624,0.19539977302041286,130320.07250070991,1125.3580015826344,131445.43050229255,1534,3,291.6666666666667,36,3,19,35.99408109995956,0.6235532407407407,44.735360360360346,1021.0585585585565,28.362737737737678,0
3814,4,0,0,39,0.0,0.0,1.0,39,1250,800,450,0.64,17,8,9,341.49016185515086,0.42647885739991004,0.13638527298791314,0.19583672728173196,130514.55886667022,1113.887566366544,131628.44643303676,1535,4,292.6666666666667,37,2,14,35.82141771291625,0.6235923423423424,44.54495614035086,1021.8201754385941,27.61676149834038,0
3815,4,0,0,39,0.0,0.0,1.0,39,1200,700,500,0.5833333333333334,17,7,10,343.5505782770259,0.42619770580296895,0.131910542287901,0.1983069179559463,130766.77439212044,1185.000192366856,131951.77458448728,1536,5,293.6666666666667,37,2,15,35.51359705546025,0.6261261261261262,44.298245614035075,1022.8070175438579,27.643432906590753,0
3816,4,1,0,40,0.025,0.0,1.0,40,1100,800,300,0.7272727272727273,14,8,6,336.4774282978343,0.42684294871794876,0.13171361502347434,0.19581883122250998,131081.84633875726,821.2165105193758,131903.06284927664,1537,0,287.3,38,2,18,35.37623891497129,0.627467105263158,43.990384615384606,1024.0384615384603,26.948380566801585,0
3817,4,1,1,40,0.024390243902439025,0.024390243902439025,0.975609756097561,41,1150,1000,150,0.8695652173913043,13,10,3,329.75638240480185,0.4273373983739837,0.13965877636976876,0.19456874063960464,131609.25116381928,480.26038906368876,132089.51155288296,1538,0,281.2682926829268,37,4,16,35.01683051934173,0.634572072072072,43.47587719298244,1026.0964912280674,27.73233760075858,0
3818,4,0,0,40,0.0,0.0,1.0,40,1050,900,150,0.8571428571428571,12,9,3,335.36273010222794,0.425,0.14210835648642917,0.19787669787494588,131609.25116381925,827.3675554016235,132436.6187192209,1539,1,289.125,37,3,16,34.8730141768184,0.634572072072072,43.47587719298244,1026.0964912280672,27.732337600758573,0
3819,4,0,1,39,0.0,0.025,0.975,40,850,700,150,0.8235294117647058,10,7,3,337.67806267806304,0.42502670940170945,0.1392735042735047,0.19953703703703696,131665.51246537376,892.1110341643395,132557.6234995381,1540,2,290.125,37,3,16,34.75694444444445,0.6351351351351351,43.42105263157894,1026.3157894736826,27.738264580369798,0
3820,4,0,0,39,0.0,0.0,1.0,39,1300,1200,100,0.9230769230769231,14,12,2,344.926499703719,0.42240215924426455,0.1435875515807128,0.20351968374699858,131609.2511638194,1279.1036665127504,132888.35483033216,1541,3,298.12820512820514,37,2,16,34.62768041604331,0.634572072072072,43.475877192982445,1026.0964912280683,27.732337600758605,0
3821,4,0,2,37,0.0,0.05128205128205128,0.9487179487179487,39,1000,600,400,0.6,14,6,8,349.7712982235769,0.4214462438146649,0.1441855880130123,0.20729483775731442,131778.07113727275,1418.4374038165347,133196.50854108928,1542,4,299.12820512820514,37,2,16,34.33317314537947,0.6362612612612613,43.31140350877192,1026.7543859649104,27.750118539592172,0
3822,4,0,0,37,0.0,0.0,1.0,37,1050,700,350,0.6666666666666666,14,7,7,364.605224801178,0.42004504504504503,0.15641095230399094,0.21471734932975678,131535.81700370798,2191.7292256087085,133727.54622931668,1543,5,314.7027027027027,35,2,18,34.19705987438414,0.6377976190476191,43.5474537037037,1025.810185185185,29.30886243386243,0
3823,4,0,0,37,0.0,0.0,1.0,37,1500,1300,200,0.8666666666666667,17,13,4,368.1609316936398,0.4194194194194194,0.1592306027980852,0.21782650454909205,131713.96933138277,2298.3875332218713,134012.35686460463,1544,6,315.7027027027027,35,2,17,33.92587007178563,0.6395833333333334,43.37384259259259,1026.5046296296289,29.32870370370368,0
3824,4,0,0,37,0.0,0.0,1.0,37,950,800,150,0.8421052631578947,11,8,3,367.1737346946578,0.41882507507507505,0.15285258206809216,0.21775169613709888,131803.09070644696,2278.926611796956,134082.01731824392,1545,7,316.7027027027027,35,2,17,33.86121130147279,0.6404761904761904,43.287037037037024,1026.85185185185,29.33862433862428,0
3825,4,0,0,37,0.0,0.0,1.0,37,1150,900,250,0.782608695652174,14,9,5,366.988016123475,0.41898148148148145,0.14866234940584455,0.21849447479061584,131951.6933111495,2284.9380304783735,134236.63134162786,1546,8,317.7027027027027,35,2,17,33.7159935789118,0.6419642857142858,43.1423611111111,1027.4305555555538,29.35515873015868,0
3826,4,0,0,37,0.0,0.0,1.0,37,1000,600,400,0.6,14,6,8,366.0246186505028,0.4186061061061061,0.14371378061528195,0.2184896464632532,132050.54029959018,2266.7497311500765,134317.29003074026,1547,9,318.7027027027027,36,1,17,33.641028450385306,0.6409143518518519,43.046171171171174,1027.8153153153157,28.550425425425438,0
3827,4,0,0,37,0.0,0.0,1.0,37,900,600,300,0.6666666666666666,12,6,6,366.6488142925505,0.41816816816816815,0.14600161072553752,0.21902947492554986,132079.47812677544,2285.3568095122173,134364.83493628766,1548,10,319.7027027027027,36,1,17,33.595804119193694,0.6412037037037037,43.01801801801802,1027.927927927928,28.553553553553556,0
3828,4,0,0,37,0.0,0.0,1.0,37,1350,1000,350,0.7407407407407407,17,10,7,366.3838961204264,0.41735485485485485,0.1439272021583753,0.22021600493133026,132311.0948786626,2295.3308883207737,134606.4257669834,1549,11,320.7027027027027,36,1,17,33.36913492410975,0.6435185185185186,42.7927927927928,1028.8288288288302,28.578578578578615,0
3829,4,1,1,37,0.02631578947368421,0.02631578947368421,0.9736842105263158,38,800,600,200,0.75,10,6,4,358.01658531935436,0.4193338074917022,0.13871532953294086,0.21673908184728716,132581.84700963707,1893.3856291481643,134475.23263878524,1550,0,313.2368421052632,34,4,18,33.31190035834006,0.6504289215686274,42.5297619047619,1029.8809523809516,30.290616246498576,0
3830,4,0,1,36,0.0,0.02702702702702703,0.972972972972973,37,1000,700,300,0.7,13,7,6,358.57271867664804,0.41538413413413416,0.11574536643852684,0.21796386607198476,132735.14739229012,2119.040532879801,134854.1879251699,1049,1,280.81081081081084,34,3,14,33.1434361521873,0.6519607843137255,42.38095238095237,1030.4761904761895,30.30812324929969,0
3831,4,0,0,36,0.0,0.0,1.0,36,550,300,250,0.5454545454545454,8,3,5,369.0464027351722,0.41357473544973544,0.12754508435136724,0.2234485568145812,132587.25610342177,2586.16998269896,135173.42608612071,1050,14,289.5833333333333,33,3,17,33.02246945898778,0.6527777777777778,42.52450980392157,1029.9019607843136,31.20915032679738,0
3832,4,0,0,36,0.0,0.0,1.0,36,750,400,350,0.5333333333333333,11,4,7,371.30262420548235,0.4125165343915344,0.13549265250026443,0.2255717098496889,132713.49961553246,2655.374134948091,135368.87375048056,1051,15,290.5833333333333,33,3,15,32.837277989216616,0.654040404040404,42.40196078431372,1030.3921568627447,31.22400475341651,0
3833,4,0,0,36,0.0,0.0,1.0,36,1300,1200,100,0.9230769230769231,14,12,2,372.08918988768846,0.41162367724867727,0.13242986210175967,0.22681262792284315,132839.80320069205,2685.6509515570965,135525.45415224915,1052,16,291.5833333333333,33,3,15,32.68990727532097,0.6553030303030303,42.279411764705884,1030.8823529411766,31.238859180035654,0
3834,4,0,0,36,0.0,0.0,1.0,36,800,600,200,0.75,10,6,4,373.55371900826447,0.41130952380952385,0.127665544332211,0.22828282828282828,132934.5703125,2731.640624999998,135666.2109375,1053,17,292.5833333333333,33,3,16,32.55681818181817,0.65625,42.1875,1031.25,31.25,0
3835,4,0,0,36,0.0,0.0,1.0,36,750,600,150,0.8,9,6,3,376.99570402248986,0.4107473544973545,0.13672447242348706,0.23116728566389957,133060.97902549495,2832.683493127639,135893.6625186226,1054,18,293.5833333333333,33,3,16,32.34091044066992,0.6575126262626263,42.064950980392155,1031.740196078431,31.26485442661912,0
3836,4,0,0,36,0.0,0.0,1.0,36,450,300,150,0.6666666666666666,6,3,3,379.47003437623187,0.4103505291005291,0.1351944213540226,0.23307929682583844,133124.20590938564,2903.3293985486134,136027.53530793425,1055,19,294.5833333333333,33,3,16,32.213489094723506,0.6581439393939394,42.003676470588225,1031.9852941176457,31.272281639928657,0
3837,4,0,1,35,0.0,0.027777777777777776,0.9722222222222222,36,1200,1000,200,0.8333333333333334,14,10,4,380.1307479790451,0.40925925925925927,0.13688474875730172,0.23467852111497534,133313.9766706315,2935.348333573627,136249.32500420514,1056,20,295.5833333333333,33,3,16,32.00563169969543,0.6600378787878788,41.81985294117647,1032.7205882352941,31.2945632798574,0
3838,4,0,0,35,0.0,0.0,1.0,35,850,400,450,0.47058823529411764,13,4,9,414.68307496609236,0.4052521008403361,0.11283002025611988,0.23476139795019182,130012.50270328723,3788.507575211461,133801.0102784987,1057,21,303.9714285714286,33,2,15,34.46387086437555,0.6268939393939394,45.036764705882355,1019.8529411764708,30.904634581105178,8
3839,4,0,0,35,0.0,0.0,1.0,35,1050,900,150,0.8571428571428571,12,9,3,415.5427499571646,0.40497198879551816,0.11518489918489938,0.23581413724563005,130106.25608239608,3812.9422878219775,133919.19837021804,1058,22,304.9714285714286,33,2,15,34.34622122122122,0.6278409090909092,44.944852941176464,1020.2205882352932,30.915775401069492,0
3840,4,0,0,35,0.0,0.0,1.0,35,400,200,200,0.5,6,2,4,415.91998508531384,0.40504201680672264,0.11192477952026358,0.23621758498092235,130137.51471789685,3825.358636101486,133962.87335399832,1059,23,305.9714285714286,33,2,15,34.30468812555048,0.6281565656565656,44.9142156862745,1020.3431372549011,30.919489007724277,0
3841,4,1,0,36,0.027777777777777776,0.0,1.0,36,900,700,200,0.7777777777777778,11,7,4,407.6284342244674,0.40681216931216935,0.1296503220717764,0.2347334972858081,130674.53833174358,3453.5717828300703,134128.11011457365,1060,0,298.44444444444446,30,6,15,33.96898689803252,0.6413194444444444,44.388440860215056,1022.44623655914,34.081541218638,0
3842,4,0,0,36,0.0,0.0,1.0,36,1100,800,300,0.7272727272727273,14,8,6,405.71442963847767,0.40625,0.12808581147170073,0.234464124827521,130812.00003251816,3414.463196612319,134226.4632291305,1061,1,299.44444444444446,30,6,15,33.87804931458854,0.6427083333333333,44.25403225806451,1022.9838709677415,34.099462365591386,0
3843,4,0,1,35,0.0,0.027777777777777776,0.9722222222222222,36,800,600,200,0.75,10,6,4,374.48395176470143,0.4063657407407408,0.13187281941579498,0.1990101682764181,127500.81045310358,2349.40147033608,129850.21192343965,1062,2,300.44444444444446,35,1,21,38.056287722515094,0.5970238095238095,47.511574074074076,1009.9537037037038,28.855820105820108,8
3844,4,1,0,36,0.027777777777777776,0.0,1.0,36,800,600,200,0.75,10,6,4,371.11768746268183,0.4104662698412698,0.13934686919573602,0.19836853624841255,127734.70320001706,2280.921532064462,130015.62473208152,1063,0,298.0833333333333,35,1,22,37.90120983131059,0.5994047619047619,47.28009259259259,1010.8796296296289,28.88227513227511,0
3845,4,0,0,36,0.0,0.0,1.0,36,1050,700,350,0.6666666666666666,14,7,7,365.4720850269442,0.4108300264550264,0.13339564100607837,0.1959199434948122,127851.72994898837,2145.2476637517198,129996.9776127401,1064,1,299.0833333333333,35,1,23,37.9239147020676,0.6005952380952381,47.164351851851855,1011.3425925925928,28.895502645502653,0
3846,4,1,1,36,0.02702702702702703,0.02702702702702703,0.972972972972973,37,850,600,250,0.7058823529411765,11,6,5,357.6920165331802,0.41266266266266266,0.14057058726319438,0.19370497824900382,128258.57688347124,1775.4138006249432,130033.99068409618,1065,0,291.97297297297297,36,1,24,37.70428015564202,0.6027199074074074,46.762387387387385,1012.9504504504498,28.137512512512494,0
3847,4,2,1,37,0.05263157894736842,0.02631578947368421,0.9736842105263158,38,800,700,100,0.875,9,7,2,351.5618501714686,0.4166518492176387,0.14012333037522495,0.19223701168950505,128644.60699445971,1445.3072099107337,130089.91420437045,1066,0,283.6578947368421,37,1,18,37.465322813085464,0.6047297297297297,46.38157894736842,1014.4736842105253,27.41820768136555,0
3848,4,0,0,37,0.0,0.0,1.0,37,1050,700,350,0.6666666666666666,14,7,7,359.88024999014056,0.4148210710710711,0.14962214962215015,0.19685253018586335,128658.13607103696,1860.304434502037,130518.440505539,1067,1,292.3243243243243,36,1,21,37.240537240537236,0.6067708333333333,46.36824324324323,1014.5270270270247,28.18130630630624,0
3849,4,1,1,37,0.02631578947368421,0.02631578947368421,0.9736842105263158,38,950,500,450,0.5263157894736842,14,5,9,348.79571711097424,0.4156146277856804,0.14393009726388573,0.19233592400690824,128978.53185595533,1397.4319021236895,130375.96375807901,1068,0,285.60526315789474,37,1,23,37.195056131260785,0.6081081081081081,46.05263157894735,1015.7894736842077,27.45376955903264,0
3850,4,0,0,37,0.0,0.0,1.0,37,1150,1000,150,0.8695652173913043,13,10,3,347.09546634641697,0.4141328828828829,0.15067494679145188,0.19220877975097259,129145.65659626015,1565.174380578611,130710.83097683876,1069,1,290.94594594594594,37,0,23,37.068051060769506,0.6097972972972974,45.88815789473683,1016.4473684210507,27.471550497866236,0
3851,4,0,0,37,0.0,0.0,1.0,37,1200,900,300,0.75,15,9,6,348.36065573770514,0.41410160160160164,0.1482055826318125,0.19318181818181812,129201.38888888879,1601.7361111111018,130803.12499999988,1070,2,291.94594594594594,37,0,23,36.97916666666667,0.6103603603603603,45.83333333333333,1016.6666666666658,27.477477477477454,0
3852,4,0,0,37,0.0,0.0,1.0,37,850,600,250,0.7058823529411765,11,6,5,346.8311912874803,0.4139139139139139,0.14062795949588436,0.1927417195441205,129285.00987082534,1568.014797822374,130853.0246686477,1071,3,292.94594594594594,37,0,24,36.93295148247978,0.611204954954955,45.751096491228054,1016.9956140350853,27.486367946894198,0
3853,4,0,0,37,0.0,0.0,1.0,37,900,400,500,0.4444444444444444,14,4,10,348.1340923730628,0.41435185185185186,0.14078870334932447,0.19401418877655524,129396.5465936632,1609.4698609187194,131006.01645458191,1072,4,293.94594594594594,37,0,24,36.786358982649,0.6123310810810811,45.64144736842104,1017.4342105263139,27.49822190611659,0
3854,4,0,0,37,0.0,0.0,1.0,37,1250,800,450,0.64,17,8,9,349.29414143472115,0.4149774774774775,0.13779214769846893,0.1957691425168529,129619.76431450051,1655.0848578408647,131274.84917234138,1073,5,294.94594594594594,37,0,21,36.529893937762466,0.6145833333333333,45.422149122807014,1018.3114035087711,27.521929824561383,0
3855,4,0,1,36,0.0,0.02702702702702703,0.972972972972973,37,850,500,350,0.5882352941176471,12,5,7,351.7121434555254,0.4145708208208208,0.14415966019841164,0.19754569605210584,129703.52055440132,1723.6606455832532,131427.18119998457,1074,6,295.94594594594594,37,0,22,36.3832077502691,0.615427927927928,45.33991228070175,1018.6403508771926,27.53082029397818,0
3856,4,0,0,36,0.0,0.0,1.0,36,1600,1200,400,0.75,20,12,8,358.55865931689135,0.41258267195767195,0.14919538111909558,0.2013136606779195,129688.42734203805,2100.1817273354495,131788.6090693735,1075,7,304.9166666666667,36,0,22,36.22420305878018,0.6171875,45.35472972972973,1018.5810810810816,28.293918918918934,0
3857,4,0,0,36,0.0,0.0,1.0,36,1450,1100,350,0.7586206896551724,18,11,7,359.78849813369897,0.4117559523809524,0.14932358609852847,0.2028938128727795,129860.54202428782,2144.4658763493267,132005.00790063714,1076,8,305.9166666666667,36,0,22,36.01788936765737,0.6189236111111112,45.185810810810814,1019.2567567567569,28.312687687687692,0
3858,4,1,0,37,0.02702702702702703,0.0,1.0,37,950,600,350,0.631578947368421,13,6,7,355.45156732433577,0.4129441941941942,0.15513536742586997,0.20223369123807583,130206.62607725461,1856.4298630347857,132063.0559402894,1077,0,298.6216216216216,37,0,24,35.77701976794154,0.6204954954954955,44.84649122807018,1020.6140350877199,27.584163110478915,0
3859,4,0,0,37,0.0,0.0,1.0,37,950,600,350,0.631578947368421,13,6,7,355.7612300668674,0.4128190690690691,0.14914948950991103,0.20316384031585571,130351.21588059409,1874.805826338651,132226.02170693275,1078,1,299.6216216216216,35,2,24,35.62244984699082,0.6258928571428571,44.70486111111111,1021.1805555555552,29.17658730158729,0
3860,4,0,0,37,0.0,0.0,1.0,37,1550,1200,350,0.7741935483870968,19,12,7,353.81038556679994,0.4120995995995996,0.18220191381677342,0.1909252653382972,128116.77781865573,1665.8093115189272,129782.58713017465,1079,2,300.6216216216216,37,0,21,37.94755677100257,0.5993806306306306,46.90241228070175,1012.3903508771929,27.36190137505927,8
3861,4,1,0,38,0.02631578947368421,0.0,1.0,38,1000,600,400,0.6,14,6,8,349.19068043434584,0.4143106922712186,0.19058735111252778,0.18987756764324068,128422.23087873185,1368.772242420736,129791.00312115258,1080,0,293.6842105263158,37,1,17,37.75241598153757,0.6024774774774775,46.60087719298245,1013.5964912280697,27.394499762920802,0
3862,4,2,0,40,0.05,0.0,1.0,40,1050,900,150,0.8571428571428571,12,9,3,336.7276250635425,0.41969818376068374,0.1929003485749432,0.18598195101187975,129042.58355034732,690.44053819445,129733.02408854177,1081,0,279.95,39,1,20,37.43635089877657,0.6052350427350428,45.989583333333336,1016.0416666666674,26.052350427350447,0
3863,4,0,0,40,0.0,0.0,1.0,40,700,500,200,0.7142857142857143,9,5,4,337.3763744215557,0.4198985042735042,0.18978938198216722,0.1867147637680724,129121.9740125867,712.5406901041579,129834.51470269085,1082,1,280.95,39,1,22,37.33911123637732,0.6060363247863247,45.91145833333333,1016.3541666666657,26.060363247863222,0
3864,4,0,1,39,0.0,0.025,0.975,40,1300,900,400,0.6923076923076923,17,9,8,338.1187534251066,0.42001869658119656,0.12795388270871588,0.18579475002748136,128839.3438966796,829.4019704379987,129668.7458671176,1083,2,281.95,37,3,23,37.60789052093458,0.6067004504504505,46.18969298245613,1015.2412280701742,27.43895211000471,8
3865,4,1,0,40,0.025,0.0,1.0,40,1550,1200,350,0.7741935483870968,19,12,7,335.70440545731407,0.4219684829059829,0.13518927444795015,0.1853977291462862,129038.51290269522,663.7594510190254,129702.27235371424,1084,0,282.875,38,2,24,37.46648264984226,0.606907894736842,45.99358974358972,1016.025641025638,26.73751686909574,0
3866,4,2,1,41,0.047619047619047616,0.023809523809523808,0.9761904761904762,42,850,700,150,0.8235294117647058,10,7,3,320.99161673356497,0.4290432636469222,0.13455817484253485,0.17952326323821746,129536.03512619234,-83.69554651321664,129452.33957967912,1085,0,270.35714285714283,37,5,15,37.33529010483984,0.6137387387387387,45.50438596491226,1017.9824561403482,27.513039355144546,0
3867,4,1,1,41,0.023809523809523808,0.023809523809523808,0.9761904761904762,42,1200,900,300,0.75,15,9,6,323.9725485542505,0.4273978900503291,0.15619946091644255,0.1826653731210134,129853.92011834306,13.821088099923372,129867.74120644298,1086,0,271.3333333333333,38,4,17,36.93723794549267,0.6151315789473684,45.192307692307686,1019.230769230768,26.821862348178104,0
3868,4,0,0,41,0.0,0.0,1.0,41,900,600,300,0.6666666666666666,12,6,6,331.75672567444946,0.42378048780487804,0.1591101800588557,0.1864701596032248,129731.44531249977,407.8559027777486,130139.30121527752,1087,1,278.9024390243902,37,4,17,36.86307089297884,0.6157094594594594,45.312499999999986,1018.7499999999982,27.533783783783736,0
3869,4,0,0,41,0.0,0.0,1.0,41,1450,1100,350,0.7586206896551724,18,11,7,332.9687438916694,0.4240853658536585,0.15899700139305373,0.1879544876721823,129899.05698147466,450.46516716677456,130349.52214864144,1088,2,279.9024390243902,37,4,18,36.66225216019505,0.6173986486486487,45.14802631578945,1019.4078947368388,27.551564722617265,0
3870,4,0,1,40,0.0,0.024390243902439025,0.975609756097561,41,900,700,200,0.7777777777777778,11,7,4,333.11781708868114,0.42378048780487804,0.15754523996852932,0.18844256076184465,129982.90339335143,459.92420744840643,130442.82760079984,1089,3,280.9024390243902,37,4,19,36.57347670250897,0.6182432432432432,45.06578947368419,1019.7368421052602,27.56045519203406,0
3871,4,0,0,40,0.0,0.0,1.0,40,750,500,250,0.6666666666666666,10,5,5,341.4152120345965,0.42220886752136755,0.1633395934600097,0.19267397128037153,129889.23890106282,869.2324080837174,130758.47130914654,1090,4,288.4,36,4,19,36.45695242303725,0.619212962962963,45.15765765765764,1019.3693693693662,28.315815815815725,0
3872,4,0,0,40,0.0,0.0,1.0,40,1600,1200,400,0.75,20,12,8,339.1798029207096,0.421474358974359,0.15157493012255507,0.19214680430989245,130038.81602993193,821.307998614922,130860.12402854685,1091,5,289.4,37,3,22,36.36225184548128,0.6188063063063063,45.010964912280684,1019.9561403508743,27.56638217164525,0
3873,4,0,0,40,0.0,0.0,1.0,40,1150,1000,150,0.8695652173913043,13,10,3,338.8174282435972,0.4210603632478633,0.15629364994090467,0.19263126479310638,130178.65022170248,821.3590960679791,131000.00931777045,1092,6,290.4,37,3,22,36.229786719673356,0.6202139639639639,44.87390350877191,1020.5043859649095,27.581199620673228,0
3874,4,0,0,40,0.0,0.0,1.0,40,1650,1100,550,0.6666666666666666,22,11,11,339.89967195705447,0.42119391025641023,0.1637126019945605,0.19425354309255474,130380.76560356635,863.3299948179481,131244.0955983843,1093,7,291.4,35,5,23,35.997469023874274,0.6261904761904762,44.67592592592592,1021.2962962962949,29.17989417989414,0
3875,4,0,0,40,0.0,0.0,1.0,40,1050,500,550,0.47619047619047616,16,5,11,340.2050176415145,0.42043269230769226,0.16177920018126146,0.19487278979374734,130469.43486636228,877.2712780778377,131346.7061444401,1094,8,292.4,35,5,23,35.899914089347064,0.6270833333333333,44.58912037037037,1021.6435185185184,29.18981481481481,0
3876,4,0,0,40,0.0,0.0,1.0,40,1550,1100,450,0.7096774193548387,20,11,9,339.1490746719809,0.41923076923076924,0.16253255576944836,0.1948617747838818,130587.70743580672,857.7400280778387,131445.44746388457,1095,9,293.4,35,5,17,35.80721794436265,0.6282738095238095,44.473379629629626,1022.1064814814812,29.20304232804232,0
3877,4,0,0,40,0.0,0.0,1.0,40,850,600,250,0.7058823529411765,11,6,5,344.2543937823328,0.4182425213675214,0.16967013692429544,0.19870516511133085,130765.21675936643,1003.3000846622102,131768.51684402864,1096,10,294.4,35,5,17,35.49717570065255,0.6300595238095238,44.29976851851852,1022.8009259259261,29.2228835978836,0
3878,4,0,0,40,0.0,0.0,1.0,40,1150,800,350,0.6956521739130435,15,8,7,341.9750611268259,0.41760149572649574,0.16712421711899839,0.19831241438226327,130945.1247351887,955.9934071151905,131901.1181423039,1097,11,295.4,38,2,17,35.37360821155185,0.6260964912280702,44.12393162393162,1023.5042735042724,26.934322986954538,0
3879,4,0,0,40,0.0,0.0,1.0,40,1250,800,450,0.64,17,8,9,344.5975156295517,0.4171741452991453,0.17222946885109058,0.20025942948926573,131027.14913662423,1030.326014500685,132057.4751511249,1098,12,296.4,38,2,17,35.22361647361647,0.6269188596491229,44.043803418803414,1023.8247863247857,26.942757534862782,0
3880,4,0,0,40,0.0,0.0,1.0,40,1200,900,300,0.75,15,9,6,348.13139632790023,0.4170806623931624,0.17468704360525833,0.20274529557711118,131109.19922017664,1128.6457191905827,132237.84493936723,1099,13,297.4,38,2,17,35.050246887822524,0.6277412280701755,43.96367521367521,1024.1452991452982,26.951192082771005,0
3881,4,0,1,39,0.0,0.025,0.975,40,1250,800,450,0.64,17,8,9,352.3090611401175,0.41676014957264956,0.1756723652663399,0.20620505329573813,131300.7492900322,1251.6887418730425,132552.43803190524,1100,14,298.4,38,2,18,34.74973070641786,0.6296600877192983,43.776709401709404,1024.8931623931628,26.970872694556917,0
3882,4,0,0,39,0.0,0.0,1.0,39,750,400,350,0.5333333333333333,11,4,7,352.3035230352301,0.4148110661268556,0.17594329789451724,0.2063492063492064,131328.12500000015,1453.4722222222372,132781.5972222224,1101,15,303.9230769230769,37,2,19,34.722222222222214,0.6317567567567568,43.75000000000001,1025.0000000000011,27.702702702702734,0
3883,4,0,0,39,0.0,0.0,1.0,39,1450,1000,450,0.6896551724137931,19,10,9,353.87898677796204,0.4137426900584795,0.17347118893219804,0.20807708704973607,131476.45968632118,1505.3512677897852,132981.81095411096,1102,16,304.9230769230769,35,4,19,34.53205526088101,0.637202380952381,43.605324074074076,1025.578703703704,29.302248677248684,0
3884,4,0,0,39,0.0,0.0,1.0,39,1100,800,300,0.7272727272727273,14,8,6,351.02015829176923,0.41351776878092666,0.17259086061895235,0.20731346095352515,131645.7436110097,1442.0619521548624,133087.80556316455,1103,17,305.9230769230769,36,3,18,34.43455320238487,0.6368634259259259,43.44031531531532,1026.2387387387391,28.50663163163164,0
3885,4,0,0,39,0.0,0.0,1.0,39,1100,700,400,0.6363636363636364,15,7,8,350.87817065358234,0.4135739991003149,0.17434772212610938,0.2075440963989231,131703.53366457685,1442.3789921678524,133145.9126567447,1104,18,306.9230769230769,36,3,18,34.37991406107149,0.6374421296296297,43.38400900900901,1026.4639639639647,28.51288788788791,0
3886,4,0,0,39,0.0,0.0,1.0,39,1000,600,400,0.6,14,6,8,353.8393257488535,0.413602114260009,0.1770640820293783,0.20986100605687238,131806.21831957914,1527.644683941219,133333.86300352035,1105,19,307.9230769230769,37,2,18,34.20036928279054,0.6365427927927928,43.28399122807018,1026.8640350877197,27.75308202939783,0
3887,4,0,0,39,0.0,0.0,1.0,39,1150,900,250,0.782608695652174,14,9,5,359.00200541054636,0.41334907782276203,0.18109589940575832,0.21403096658445542,132003.33275623262,1677.8922360726297,133681.22499230524,1106,20,308.9230769230769,37,2,19,33.8690603215251,0.6385135135135135,43.09210526315789,1027.6315789473679,27.773826458036968,0
3888,4,2,1,40,0.04878048780487805,0.024390243902439025,0.975609756097561,41,750,600,150,0.8,9,6,3,342.20779850939414,0.4178607723577236,0.1771363397087209,0.20681253909915545,132517.14677640592,872.0367069259592,133389.18348333187,1107,0,294.8048780487805,35,6,21,33.78391037170264,0.6476190476190475,42.59259259259259,1029.6296296296289,29.417989417989396,0
3889,4,0,0,40,0.0,0.0,1.0,40,1200,1000,200,0.8333333333333334,14,10,4,350.60400924453734,0.416292735042735,0.18572874493927127,0.21121753727658743,132398.00347222242,1283.854166666687,133681.8576388891,1108,1,302.425,36,4,21,33.68758434547908,0.6443865740740741,42.70833333333334,1029.1666666666683,28.587962962963008,0
3890,4,0,0,40,0.0,0.0,1.0,40,1050,700,350,0.6666666666666666,14,7,7,349.5811600931031,0.41509081196581193,0.1752697235333791,0.2116036164971719,132576.73852237637,1269.2660108024538,133846.0045331788,1109,2,303.425,35,5,21,33.534221173297375,0.6482142857142856,42.534722222222214,1029.8611111111097,29.424603174603135,0
3891,4,0,0,40,0.0,0.0,1.0,40,950,600,350,0.631578947368421,13,6,7,349.1499667287539,0.414823717948718,0.16702426421029015,0.212014529592044,132695.96220207462,1266.15815757886,133962.1203596535,1110,3,304.425,35,5,17,33.425541076911564,0.6494047619047619,42.418981481481474,1030.324074074073,29.437830687830658,0
3892,4,0,0,40,0.0,0.0,1.0,40,1000,800,200,0.8,12,8,4,347.83963633994097,0.41467681623931624,0.16880385065418602,0.21192744142785372,132821.51870046547,1240.1177525777093,134061.63645304317,1111,4,305.425,37,3,17,33.333222529518125,0.646677927927928,42.297149122807014,1030.8114035087715,27.85976766239923,0
3893,4,0,2,38,0.0,0.05,0.95,40,900,500,400,0.5555555555555556,13,5,8,350.53565962656876,0.41410256410256413,0.1755050505050506,0.21421623643845866,132934.57031249988,1319.6614583333203,134254.2317708332,1112,5,306.425,37,3,18,33.15025252525252,0.6478040540540541,42.18749999999999,1031.249999999999,27.871621621621596,0
3894,4,0,0,38,0.0,0.0,1.0,38,600,400,200,0.6666666666666666,8,4,4,367.70912763539974,0.40862079184447603,0.18898876404494347,0.22292992070538512,132636.34366426594,2154.318844307248,134790.66250857318,1113,27,323.2894736842105,35,3,19,33.00749063670412,0.6488095238095238,42.47685185185184,1030.0925925925912,29.43121693121689,0
3895,4,0,0,38,0.0,0.0,1.0,38,850,500,350,0.5882352941176471,12,5,7,365.8312705901015,0.40860597439544805,0.18890491787770958,0.22214392706637642,132695.9622020745,2108.8664909121794,134804.8286929867,1114,28,324.2894736842105,35,3,20,32.99586235302928,0.6494047619047619,42.41898148148147,1030.324074074072,29.43783068783063,0
3896,4,0,0,38,0.0,0.0,1.0,38,850,600,250,0.7058823529411765,11,6,5,364.88343953629476,0.4077465623518255,0.18950440762886123,0.22262888214995288,132874.89819101503,2096.7699759945067,134971.66816700954,1115,29,325.2894736842105,35,3,20,32.84033078880407,0.6511904761904762,42.24537037037037,1031.018518518518,29.457671957671945,0
3897,4,0,0,38,0.0,0.0,1.0,38,1000,700,300,0.7,13,7,6,364.06644340513594,0.40756875296348977,0.19082490787111417,0.22284066920512138,132994.25582990385,2083.749142661159,135078.00497256502,1116,30,326.2894736842105,35,3,22,32.74143476959904,0.6523809523809524,42.12962962962962,1031.4814814814804,29.47089947089944,0
3898,4,0,0,38,0.0,0.0,1.0,38,1200,800,400,0.6666666666666666,16,8,8,367.89041836978174,0.40663525367472736,0.19008340071891072,0.2260840014199407,133143.5282305597,2196.445660793879,135339.97389135358,1117,31,327.2894736842105,35,3,22,32.49282737093941,0.6538690476190476,41.984953703703695,1032.060185185184,29.487433862433832,0
3899,4,0,0,38,0.0,0.0,1.0,38,900,600,300,0.6666666666666666,12,6,6,370.01226162861803,0.40622036510194404,0.191955148433675,0.22848577235378265,133322.7656276792,2266.211607295959,135588.97723497517,1118,32,328.2894736842105,35,3,22,32.25804568717546,0.6556547619047619,41.811342592592595,1032.75462962963,29.507275132275144,0
3900,4,0,0,38,0.0,0.0,1.0,38,1200,900,300,0.75,15,9,6,368.4059600574494,0.4060425557136083,0.19411522402591253,0.22860687720121226,133503.88259623724,2236.8926568411116,135740.77525307835,1119,33,329.2894736842105,33,5,22,32.117746748883356,0.6619318181818181,41.63602941176472,1033.4558823529428,31.316844919786146,0
3901,4,0,0,38,0.0,0.0,1.0,38,1050,900,150,0.8571428571428571,12,9,3,367.57933659662194,0.40582029397818875,0.19295013212441514,0.22865751855337166,133595.2664399095,2221.3718820861895,135816.63832199568,1120,34,330.2894736842105,34,4,22,32.04744357438969,0.6605392156862745,41.54761904761906,1033.8095238095252,30.406162464986036,0
3902,4,0,0,38,0.0,0.0,1.0,38,1200,700,500,0.5833333333333334,17,7,10,365.9269766049739,0.40513869132290187,0.1898080837452747,0.22838890608793233,133718.3673469389,2186.231575963737,135904.59892290263,1121,35,331.2894736842105,34,4,20,31.966745319214258,0.6617647058823529,41.42857142857144,1034.2857142857154,30.42016806722692,0
3903,4,0,0,38,0.0,0.0,1.0,38,1500,1100,400,0.7333333333333333,19,11,8,365.9232291172359,0.40553876244665715,0.1891261971353504,0.22953366190081176,133903.12500000012,2199.6527777777924,136102.7777777779,1122,36,332.2894736842105,34,4,20,31.781736446591527,0.6636029411764706,41.25000000000001,1035.000000000001,30.44117647058826,0
3904,4,0,0,38,0.0,0.0,1.0,38,1400,900,500,0.6428571428571429,19,9,10,362.3398071079403,0.4049608819345662,0.18421052631578916,0.22843161752457108,134088.01020408174,2117.084750566904,136205.09495464864,1123,37,333.2894736842105,34,4,21,31.68941570881226,0.6654411764705883,41.07142857142858,1035.7142857142865,30.462184873949603,0
3905,4,1,0,39,0.02564102564102564,0.0,1.0,39,1200,800,400,0.6666666666666666,16,8,8,354.88200371859534,0.40629217273954116,0.18291470718444347,0.22585406857253224,134433.9710276154,1741.639401225541,136175.61042884094,1124,0,325.71794871794873,36,3,22,31.536857060122344,0.6646412037037037,40.73761261261261,1037.049549549549,28.806931931931917,0
3906,4,0,1,38,0.0,0.02564102564102564,0.9743589743589743,39,1350,1000,350,0.7407407407407407,17,10,7,356.5749513855396,0.4050832208726946,0.18105283559399532,0.22785812176463116,134582.56927924356,1797.9067988236882,136380.47607806724,1125,1,326.71794871794873,33,6,23,31.34460749576788,0.6726641414141414,40.59436274509804,1037.6225490196077,31.44310754604872,0
3907,4,0,0,38,0.0,0.0,1.0,38,1450,1000,450,0.6896551724137931,19,10,9,359.94035038328826,0.40479788999525845,0.18223544464181485,0.23142143620242642,134805.19061178374,2104.3655084582615,136909.556120242,1126,2,330.0,33,5,19,31.03512705530644,0.6748737373737373,40.3799019607843,1038.4803921568612,31.469102792632157,0
3908,4,0,0,38,0.0,0.0,1.0,38,1100,900,200,0.8181818181818182,13,9,4,358.2037145765717,0.40464971550497864,0.17349006035537928,0.2314404311279712,134983.4201388887,2070.312499999976,137053.73263888867,1127,3,331.0,34,4,19,30.90249933172948,0.6743259803921569,40.20833333333332,1039.1666666666652,30.563725490196035,0
3909,4,0,0,38,0.0,0.0,1.0,38,1250,900,350,0.72,16,9,7,359.6945656365378,0.40438300142247513,0.17522464698331208,0.23320064155188422,135107.15880102027,2119.462159863935,137226.6209608842,1128,4,332.0,34,4,21,30.7404385663575,0.6755514705882353,40.08928571428571,1039.6428571428562,30.57773109243695,0
3910,4,0,0,38,0.0,0.0,1.0,38,1150,900,250,0.782608695652174,14,9,5,358.4556926273811,0.40426446183025133,0.17598590064170172,0.23279631785131377,135169.04939058935,2090.42304421766,137259.47243480702,1129,5,333.0,34,4,21,30.710980728868524,0.6761642156862745,40.02976190476189,1039.8809523809505,30.584733893557367,0
3911,4,0,0,38,0.0,0.0,1.0,38,1150,900,250,0.782608695652174,14,9,5,358.293551694163,0.4041311047889995,0.17122429557528518,0.23329128574542407,135261.91184807234,2092.694160997703,137354.60600907003,1130,6,334.0,34,4,21,30.622711146715492,0.6770833333333333,39.940476190476176,1040.2380952380934,30.59523809523804,0
3912,4,0,0,38,0.0,0.0,1.0,38,1150,700,450,0.6086956521739131,16,7,9,357.48760396551967,0.40288643907064964,0.17533227598073386,0.2338098925426845,135422.7768802509,2082.3928058555894,137505.16968610647,1131,7,335.0,35,3,22,30.483547388709734,0.6764880952380952,39.78587962962961,1040.856481481479,29.738756613756543,0
3913,4,0,0,38,0.0,0.0,1.0,38,800,500,300,0.625,11,5,6,358.28644491034976,0.4028419867235657,0.1739229661879853,0.2345289873015779,135452.89592978367,2106.1873070987335,137559.0832368824,1132,8,336.0,35,3,22,30.432788525683783,0.6767857142857143,39.75694444444443,1040.9722222222201,29.742063492063433,0
3914,4,0,0,38,0.0,0.0,1.0,38,1100,700,400,0.6363636363636364,15,7,8,358.7046521342398,0.402041844476055,0.1694863200014045,0.23539502226489784,135543.27317226047,2124.0005304783595,137667.27370273884,1133,9,337.0,35,3,22,30.331985661887302,0.6776785714285714,39.67013888888887,1041.3194444444418,29.751984126984052,0
3915,4,0,0,38,0.0,0.0,1.0,38,1450,900,550,0.6206896551724138,20,9,11,356.5358600518872,0.4012565196775723,0.16017940670730968,0.23537819901163035,135757.7168367346,2080.529007031042,137838.24584376562,1134,10,338.0,34,4,23,30.175253217576724,0.6819852941176471,39.46428571428571,1042.1428571428564,30.65126050420166,0
3916,4,0,0,38,0.0,0.0,1.0,38,800,500,300,0.625,11,5,6,356.52630250283687,0.40097498814604077,0.15980342060176156,0.2355764361065913,135788.7347647391,2082.4511054421646,137871.18587018127,1135,11,339.0,34,4,23,30.144679230915674,0.6822916666666667,39.4345238095238,1042.261904761904,30.65476190476188,0
3917,4,0,1,37,0.0,0.02631578947368421,0.9736842105263158,38,750,500,250,0.6666666666666666,10,5,5,345.01397588291445,0.4006638217164533,0.07854494236684029,0.21043324111979242,132861.9978720275,1567.849225915117,134429.84709794263,1136,12,340.0,36,2,20,33.36541962497725,0.6490162037037037,42.25788288288289,1030.9684684684692,28.638013013013033,8
3918,4,0,0,37,0.0,0.0,1.0,37,650,300,350,0.46153846153846156,10,3,7,351.17909200052065,0.3991491491491492,0.09407116783337743,0.21409665793625154,132845.0671537422,1930.482011959865,134775.54916570205,1137,51,349.86486486486484,35,2,20,33.22351801953519,0.6508928571428572,42.27430555555555,1030.902777777777,29.454365079365054,0
3919,4,0,1,36,0.0,0.02702702702702703,0.972972972972973,37,1150,800,350,0.6956521739130435,15,8,7,350.4872308565976,0.3993681181181181,0.09199928405226476,0.21401581492127653,132904.73257726748,1916.2823377486097,134821.0149150161,1138,52,350.86486486486484,35,2,21,33.181450405956525,0.6514880952380953,42.216435185185176,1031.1342592592578,29.460978835978793,0
3920,4,0,0,36,0.0,0.0,1.0,36,850,500,350,0.5882352941176471,12,5,7,360.60782232557654,0.39882605820105815,0.09289196818065193,0.2199199817844713,132857.85147392284,2381.916099773236,135239.76757369607,1139,53,357.22222222222223,34,2,21,32.96766743648961,0.6531862745098039,42.26190476190476,1030.9523809523805,30.322128851540604,0
3921,4,0,0,36,0.0,0.0,1.0,36,750,600,150,0.8,9,6,3,360.3169344499352,0.3979993386243386,0.09744827940025913,0.22028409337613195,132949.9167375284,2380.821286848079,135330.73802437648,1140,54,358.22222222222223,34,2,21,32.8826618954173,0.6541053921568627,42.17261904761905,1031.3095238095243,30.332633053221304,0
3922,4,0,0,36,0.0,0.0,1.0,36,1000,800,200,0.8,12,8,4,356.8121482814343,0.3975363756613757,0.09330319933320519,0.21850016006068032,133011.3112953515,2292.010345804994,135303.3216411565,1141,55,359.22222222222223,34,2,21,32.91137718792075,0.654718137254902,42.11309523809524,1031.5476190476193,30.339635854341743,0
3923,4,0,1,35,0.0,0.027777777777777776,0.9722222222222222,36,950,700,250,0.7368421052631579,12,7,5,353.6092883020753,0.39770171957671957,0.09331782468822492,0.2172529355273346,133134.14292800456,2215.493905895694,135349.63683390024,1142,56,360.22222222222223,34,2,21,32.87071749913484,0.6559436274509804,41.99404761904762,1032.0238095238096,30.353641456582636,0
3924,4,0,1,34,0.0,0.02857142857142857,0.9714285714285714,35,950,700,250,0.7368421052631579,12,7,5,356.5503616943946,0.3964985994397759,0.08127798127798136,0.21955995956970636,133219.0743944638,2499.861831987717,135718.9362264515,1143,57,363.42857142857144,33,2,21,32.70961934156379,0.6590909090909092,41.91176470588236,1032.3529411764716,31.283422459893078,0
3925,4,0,0,34,0.0,0.0,1.0,34,1500,1100,400,0.7333333333333333,19,11,8,371.84251877202337,0.3941250742721331,0.15350683209571891,0.20927528840465573,129782.79867976083,2951.2935927799126,132734.09227254076,1144,58,371.0882352941176,30,4,22,35.789858417974756,0.6322916666666667,45.26209677419356,1018.9516129032272,33.965053763440906,8
3926,4,0,0,34,0.0,0.0,1.0,34,1250,1000,250,0.8,15,10,5,371.9440407510165,0.3939022578728461,0.14675832018631185,0.21012423081388615,129930.49621582055,2865.374755859404,132795.87097167995,1145,59,372.0882352941176,31,3,22,35.63697318007662,0.6310483870967742,45.117187500000014,1019.5312500000018,32.88810483870974,0
3927,4,0,0,34,0.0,0.0,1.0,34,1100,700,400,0.6363636363636364,15,7,8,375.03693078924016,0.39423648247177656,0.14808001321539566,0.21259329347343786,130063.2815890843,2955.7067871093845,133018.98837619368,1146,60,373.0882352941176,31,3,22,35.42304910220406,0.6323924731182795,44.98697916666667,1020.0520833333342,32.904905913978524,0
3928,4,0,0,34,0.0,0.0,1.0,34,1100,800,300,0.7272727272727273,14,8,6,377.40622058452675,0.39447786690433745,0.14961082046701502,0.21448386879774756,130162.91512383366,3024.85877143013,133187.7738952638,1147,61,374.0882352941176,31,3,22,35.2612872697886,0.6334005376344086,44.88932291666667,1020.4427083333343,32.91750672043014,0
3929,4,1,0,35,0.02857142857142857,0.0,1.0,35,1050,800,250,0.7619047619047619,13,8,5,366.3538480262894,0.39670868347338933,0.14870245677889016,0.21053277503706952,130595.10125054244,2568.841722276466,133163.9429728189,1148,0,364.37142857142857,31,4,20,35.104564755838645,0.637768817204301,44.46614583333333,1022.1354166666658,32.97211021505374,0
3930,4,0,0,35,0.0,0.0,1.0,35,1250,1000,250,0.8,15,10,5,365.3987525061259,0.3969187675070028,0.1371215351812367,0.20066980670418386,128816.57483930212,2413.8831496786024,131230.45798898072,1149,1,365.37142857142857,32,3,18,36.93874378109451,0.6171875,46.21212121212121,1015.1515151515152,31.72348484848485,8
3931,4,1,0,36,0.027777777777777776,0.0,1.0,36,800,500,300,0.625,11,5,6,384.2926340609022,0.40188492063492065,0.055944638986159756,0.20376683699940162,127410.50020406088,2717.4470398428803,130127.94724390376,1150,0,356.19444444444446,32,4,17,37.90150283475071,0.6028645833333333,47.601010101010104,1009.5959595959602,31.549873737373755,8
3932,4,1,0,37,0.02702702702702703,0.0,1.0,37,1100,800,300,0.7272727272727273,14,8,6,373.8672313748461,0.4051864364364364,0.06046269326666964,0.19987237793979928,127741.58564314194,2151.6785911668453,129893.26423430878,1151,0,347.5405405405405,33,4,18,37.824660564916975,0.6038510101010102,47.27328431372548,1010.906862745097,30.63354129530597,0
3933,4,1,0,38,0.02631578947368421,0.0,1.0,38,1600,1200,400,0.75,20,12,8,365.5208129603556,0.40993954480796585,0.06911298707728863,0.1972328041506894,128114.39909297052,1765.6958616780062,129880.09495464852,1152,0,339.36842105263156,34,4,19,37.653604186265284,0.6053921568627452,46.904761904761905,1012.3809523809523,29.775910364145656,0
3934,4,2,1,39,0.05,0.025,0.975,40,1100,700,400,0.6363636363636364,15,7,8,346.5418923938732,0.41701388888888885,0.07253051214782724,0.1897646952290498,128701.7763658479,920.1149703387006,129621.8913361866,1153,0,323.35,35,5,19,37.534338047982956,0.6092261904761904,46.32523148148148,1014.6990740740739,28.99140211640211,0
3935,4,0,0,39,0.0,0.0,1.0,39,550,500,50,0.9090909090909091,6,5,1,353.62679068470993,0.4119995501574449,0.07264254881066345,0.19284206165508067,128536.5717120182,1290.7950680272165,129827.36678004541,1154,1,332.64102564102564,34,5,19,37.52323510996322,0.6096813725490196,46.48809523809524,1014.0476190476195,29.82492997198881,0
3936,4,0,0,39,0.0,0.0,1.0,39,1100,800,300,0.7272727272727273,14,8,6,351.02248467264496,0.4118870895186684,0.07097536981380692,0.1921493023034653,128687.5159438777,1234.4423185941214,129921.95826247183,1155,2,333.64102564102564,34,5,19,37.435224295044776,0.6112132352941176,46.33928571428572,1014.6428571428584,29.84243697478995,0
3937,4,2,0,41,0.04878048780487805,0.0,1.0,41,900,600,300,0.6666666666666666,12,6,6,331.7263833518677,0.41897865853658534,0.06132959451393005,0.18409452165168402,129230.80800165047,374.8776624525934,129605.68566410306,1156,0,318.3170731707317,35,6,22,37.37205938152153,0.6145833333333333,45.80439814814815,1016.7824074074082,29.05092592592595,0
3938,4,0,0,41,0.0,0.0,1.0,41,600,400,200,0.6666666666666666,8,4,4,332.02195909775935,0.41857215447154467,0.060638359883086634,0.1845336467167623,129289.65627411265,385.40099344136013,129675.05726755402,1157,1,319.3170731707317,35,6,22,37.304754182314774,0.6151785714285714,45.74652777777778,1017.0138888888889,29.057539682539684,0
3939,4,2,2,41,0.046511627906976744,0.046511627906976744,0.9534883720930233,43,1150,700,450,0.6086956521739131,16,7,9,318.11616198590184,0.42227297895902544,0.0704204561091859,0.17931411313880866,129843.17440221987,-338.9575398199504,129504.21686239992,1158,0,305.4186046511628,37,6,21,37.09734176080329,0.6168355855855856,45.20285087719298,1019.1885964912277,27.545637743006154,0
3940,4,0,0,41,0.0,0.0,1.0,41,900,700,200,0.7777777777777778,11,7,4,330.8080169846877,0.41661585365853654,0.06586336471664911,0.18496227014496697,129525.18332315258,369.5938089420616,129894.77713209465,1159,1,321.219512195122,35,6,21,37.096480007580055,0.6175595238095238,45.515046296296305,1017.939814814816,29.083994708994744,0
3941,4,0,1,40,0.0,0.024390243902439025,0.975609756097561,41,750,400,350,0.5333333333333333,11,4,7,329.9731042957452,0.4169715447154472,0.061087873067616094,0.18504992636700202,129643.02722318674,355.74242862654637,129998.76965181329,1160,2,322.219512195122,35,6,22,36.998167405386965,0.61875,45.39930555555556,1018.4027777777778,29.097222222222225,0
3942,4,1,0,41,0.024390243902439025,0.0,1.0,41,1150,700,450,0.6086956521739131,16,7,9,324.65965230036215,0.41984247967479676,0.03993626561734609,0.18457125276950367,130176.38204082493,252.60378621868978,130428.98582704362,1161,0,298.8536585365854,36,5,23,36.59328330758479,0.6221064814814814,44.876126126126145,1020.4954954954981,28.34709709709717,0
3943,4,0,1,40,0.0,0.024390243902439025,0.975609756097561,41,950,800,150,0.8421052631578947,11,8,3,327.31497962897043,0.4192327235772358,-0.007823285780027112,0.18454993532271735,129853.9201183432,300.6551772566609,130154.57529559986,1162,1,299.8536585365854,38,3,20,36.852070230607964,0.6151315789473684,45.19230769230769,1019.2307692307693,26.82186234817814,8
3944,4,0,1,39,0.0,0.025,0.975,40,1200,1000,200,0.8333333333333334,14,10,4,329.23995278010847,0.41642628205128207,6.81198910088554e-05,0.1858939425696919,129908.37191358028,554.2052469135879,130462.57716049386,1163,2,308.125,38,2,20,36.74784287011807,0.6156798245614035,45.13888888888889,1019.4444444444447,26.827485380116965,0
3945,4,0,1,38,0.0,0.02564102564102564,0.9743589743589743,39,1050,800,250,0.7619047619047619,13,8,5,336.0339821944929,0.41250562303193883,0.022557925332715723,0.18982041108410677,129927.00277970156,931.9776277316233,130858.98040743319,1164,3,316.8974358974359,37,2,20,36.55580053058006,0.6176801801801801,45.120614035087726,1019.5175438596501,27.554528212422976,0
3946,4,0,0,38,0.0,0.0,1.0,38,1150,800,350,0.6956521739130435,15,8,7,359.38167433981323,0.41364390706495974,-0.05800486286835038,0.19435854441251066,128204.80619331067,1808.532894344256,130013.33908765492,1165,4,323.5,34,4,20,37.716488382116665,0.6063112745098039,46.81547619047619,1012.7380952380954,29.786414565826334,8
3947,4,1,2,37,0.02564102564102564,0.05128205128205128,0.9487179487179487,39,1200,600,600,0.5,18,6,12,352.1843407436058,0.4171727395411606,-0.032015709041236406,0.1927813432624478,128686.69979100731,1264.2881056732485,129950.98789668056,1166,0,316.1794871794872,36,3,18,37.406585275619676,0.6070601851851851,46.340090090090094,1014.6396396396403,28.184434434434454,0
3948,4,1,0,38,0.02631578947368421,0.0,1.0,38,1100,800,300,0.7272727272727273,14,8,6,354.4607484453395,0.41835585585585583,-0.008603931168551071,0.1948201557244684,128848.62075617275,1534.3557098765318,130382.97646604928,1167,0,324.89473684210526,35,3,20,37.183652530779746,0.6107142857142858,46.18055555555555,1015.277777777777,29.00793650793649,0
3949,4,1,1,38,0.02564102564102564,0.02564102564102564,0.9743589743589743,39,1450,1200,250,0.8275862068965517,17,12,5,341.4735992330391,0.4225708502024292,0.00016465671913046265,0.18991314952418784,129315.90374157947,1031.593417742081,130347.49715932156,1168,0,317.53846153846155,36,3,22,37.03775465013288,0.6134259259259259,45.72072072072073,1017.1171171171176,28.253253253253266,0
3950,4,0,0,38,0.0,0.0,1.0,38,1100,800,300,0.7272727272727273,14,8,6,342.33101945632995,0.4215564248458985,0.011457987379608126,0.19052841027412412,129344.54038075259,1255.7296739307112,130600.2700546833,1169,1,324.57894736842104,36,2,22,36.986835307575916,0.6137152777777778,45.69256756756758,1017.2297297297315,28.25638138138143,0
3951,4,2,0,40,0.05,0.0,1.0,40,1200,900,300,0.75,15,9,6,328.7904119377562,0.4270699786324786,0.0221448030176028,0.18589903385864623,129962.83512309169,546.1068193440137,130508.9419424357,1170,0,309.3,38,2,21,36.704124755518286,0.6162280701754386,45.08547008547009,1019.6581196581209,26.83310841205581,0
3952,4,0,1,39,0.0,0.025,0.975,40,750,400,350,0.5333333333333333,11,4,7,331.29618949976515,0.4263488247863248,0.022508169934640776,0.1877345073832003,130050.0,617.0138888888894,130667.01388888889,1171,1,310.3,39,1,21,36.55194716775599,0.6153846153846154,45.0,1020.0,26.153846153846153,0
3953,4,0,1,38,0.0,0.02564102564102564,0.9743589743589743,39,1150,800,350,0.6956521739130435,15,8,7,341.48100578324636,0.423048807917229,0.02305650482515542,0.19307433170588303,129962.83512309167,1075.9679304551244,131038.8030535468,1172,2,319.15384615384613,38,1,21,36.38062307907236,0.6162280701754386,45.08547008547009,1019.6581196581208,26.83310841205581,0
3954,4,0,0,38,0.0,0.0,1.0,38,1350,1100,250,0.8148148148148148,16,11,5,349.1083716800193,0.4205192034139402,0.023621668430674703,0.19734703636793322,129954.9515836605,1473.6723078255009,131428.623891486,1173,3,327.9736842105263,37,1,21,36.19419202781661,0.6179617117117118,45.09320175438597,1019.6271929824572,27.557491702228575,0
3955,4,2,1,39,0.05,0.025,0.975,40,900,600,300,0.6666666666666666,12,6,6,332.3669847247125,0.4223290598290598,0.036951066499373075,0.19057301210474545,130508.09500328744,675.6800973183065,131183.77510060574,1174,0,312.525,38,2,18,36.06101003764117,0.6217105263157895,44.55128205128206,1021.7948717948727,26.88933873144402,0
3956,4,0,0,39,0.0,0.0,1.0,39,850,300,550,0.35294117647058826,14,3,11,339.0911035617346,0.42175551057130006,0.03648141742881883,0.19429168504259267,130480.8049003764,1048.976025458416,131529.7809258348,1175,1,321.53846153846155,38,1,23,35.916858377775455,0.6214364035087719,44.57799145299146,1021.6880341880357,26.886527215474622,0
3957,4,0,0,39,0.0,0.0,1.0,39,1000,800,200,0.8,12,8,4,340.18490819947414,0.4213618983355825,0.03417552942059143,0.19574440087557257,130644.58832137137,1088.663456972773,131733.25177834413,1176,2,322.53846153846155,38,1,19,35.723212108544956,0.6230811403508771,44.41773504273505,1022.3290598290614,26.90339631129109,0
3958,4,0,0,39,0.0,0.0,1.0,39,1100,800,300,0.7272727272727273,14,8,6,337.1481820781498,0.42130566801619435,0.034136255778202784,0.19468375725067652,130781.1529786694,1018.5255953685875,131799.678574038,1177,3,323.53846153846155,38,1,20,35.66277592089688,0.6244517543859649,44.284188034188055,1022.863247863251,26.917453891138184,0
3959,4,0,0,39,0.0,0.0,1.0,39,1200,500,700,0.4166666666666667,19,5,14,336.2203316466325,0.42085582546108863,0.0397343547985578,0.19483693628814866,130917.788975181,1003.4444855358538,131921.23346071685,1178,4,324.53846153846155,38,1,20,35.54846539304729,0.6258223684210527,44.150641025641036,1023.3974358974375,26.931511470985196,0
3960,4,1,1,39,0.025,0.025,0.975,40,1150,900,250,0.782608695652174,14,9,5,327.73211036064146,0.42041933760683764,0.04282882699735735,0.19169016062592134,131274.74500868082,604.589843750034,131879.33485243085,1179,0,317.4,39,1,22,35.405654943416714,0.6276709401709402,43.80208333333335,1024.791666666669,26.27670940170946,0
3961,4,1,0,40,0.025,0.0,1.0,40,1100,800,300,0.7272727272727273,14,8,6,328.9660846548703,0.4221554487179487,0.05580048760666401,0.19321850461471035,131434.9175347224,647.5260416666861,132082.44357638908,1180,0,317.675,39,1,23,35.2126506840038,0.6292735042735043,43.64583333333334,1025.416666666668,26.292735042735078,0
3962,4,0,0,40,0.0,0.0,1.0,40,1350,900,450,0.6666666666666666,18,9,9,329.6391072939684,0.4221821581196581,0.05605829778590299,0.1938845071933342,131488.33007812512,668.7391493055698,132157.06922743068,1181,1,318.675,39,1,23,35.1415972645406,0.6298076923076923,43.59375000000001,1025.625000000001,26.298076923076945,0
3963,4,0,0,40,0.0,0.0,1.0,40,1350,1000,350,0.7407407407407407,17,10,7,328.2980095172036,0.42220886752136755,0.05326969943135618,0.19336595680176,131541.75347222248,636.9791666666913,132178.73263888917,1182,2,319.675,39,1,23,35.12219063092336,0.6303418803418803,43.54166666666668,1025.8333333333355,26.30341880341886,0
3964,4,0,1,39,0.0,0.025,0.975,40,1100,800,300,0.7272727272727273,14,8,6,329.4738582502977,0.4214610042735043,0.06007917174177857,0.1946029047651039,131648.63281250012,674.9565972222365,132323.58940972236,1183,3,320.675,39,1,16,34.9844363242658,0.6314102564102564,43.43750000000001,1026.250000000001,26.314102564102587,0
3965,4,0,1,38,0.0,0.02564102564102564,0.9743589743589743,39,1000,700,300,0.7,13,7,6,329.10626930399786,0.42018106162843005,0.07299246699808681,0.19484794465447425,131739.10307774495,871.2329470743002,132610.33602481926,1184,4,326.8974358974359,38,1,16,34.90282547611614,0.634046052631579,43.34935897435898,1026.6025641025647,27.01585695006749,0
3966,4,0,0,38,0.0,0.0,1.0,38,1650,1400,250,0.8484848484848485,19,14,5,336.4685023181622,0.41607396870554764,0.07122941927070126,0.19926341475047163,131749.9269606995,1265.9401209987702,133015.86708169826,1185,5,335.89473684210526,37,1,19,34.70297536402148,0.6359797297297297,43.338815789473685,1026.6447368421057,27.747155049786638,0
3967,4,0,1,37,0.0,0.02631578947368421,0.9736842105263158,38,950,800,150,0.8421052631578947,11,8,3,336.3622805910854,0.4157924371740161,0.07705964313002878,0.1999392033361221,131890.6779008925,1272.609841489686,133163.2877423822,1186,6,336.89473684210526,37,1,19,34.56403003131228,0.6373873873873874,43.20175438596491,1027.1929824561398,27.76197249881459,0
3968,4,0,0,37,0.0,0.0,1.0,37,1050,700,350,0.6666666666666666,14,7,7,343.45280093624984,0.41463338338338335,0.07902670686481161,0.20346063587626959,131761.33639974432,1650.7600083191273,133412.09640806346,1187,7,346.81081081081084,36,1,19,34.51222075975284,0.6380208333333333,43.3277027027027,1026.6891891891892,28.519144144144143,0
3969,4,0,0,37,0.0,0.0,1.0,37,900,700,200,0.7777777777777778,11,7,4,342.58255380500293,0.4149461961961962,0.07603370450173808,0.2032537611026561,131819.1518165125,1631.7883339420532,133450.94015045455,1188,8,347.81081081081084,36,1,20,34.4763223306649,0.638599537037037,43.2713963963964,1026.9144144144148,28.52540040040041,0
3970,4,0,1,36,0.0,0.02702702702702703,0.972972972972973,37,850,700,150,0.8235294117647058,10,7,3,340.3874425850347,0.41447697697697694,0.07066966111035344,0.20241292381099663,131905.89871966565,1579.8223054135242,133485.72102507917,1189,9,348.81081081081084,36,1,20,34.44534276109041,0.6394675925925926,43.18693693693694,1027.2522522522527,28.534784784784797,0
3971,4,0,0,36,0.0,0.0,1.0,36,750,400,350,0.5333333333333333,11,4,7,350.0552216764036,0.4123346560846561,0.07846729042197409,0.20743753316575675,131773.3802324461,2025.5919656635929,133798.9721981097,1190,10,359.0833333333333,35,1,20,34.330613797768,0.6401785714285715,43.31597222222223,1026.736111111112,29.335317460317487,0
3972,4,0,0,36,0.0,0.0,1.0,36,850,500,350,0.5882352941176471,12,5,7,353.17298563070085,0.4122519841269841,0.08932259396943443,0.2102693892316386,131951.69331114975,2120.354697145068,134072.0480082948,1191,11,360.0833333333333,35,1,20,34.070843190266984,0.6419642857142858,43.142361111111114,1027.4305555555559,29.355158730158738,0
3973,4,0,0,36,0.0,0.0,1.0,36,1500,1200,300,0.8,18,12,6,353.0970571095998,0.41188822751322757,0.08739898421276449,0.21105034059538808,132100.3796403464,2128.8510588134395,134229.23069915985,1192,12,361.0833333333333,35,1,21,33.92300908203857,0.6434523809523809,42.99768518518518,1028.0092592592594,29.371693121693124,0
3974,4,0,0,36,0.0,0.0,1.0,36,850,400,450,0.47058823529411764,13,4,9,353.19808605223625,0.41159060846560847,0.08771074090749909,0.21144284342911518,132159.8776148836,2135.723165294943,134295.60078017853,1193,13,362.0833333333333,35,1,21,33.86049827405073,0.644047619047619,42.939814814814824,1028.2407407407422,29.378306878306923,0
3975,4,0,0,36,0.0,0.0,1.0,36,1150,700,450,0.6086956521739131,16,7,9,358.3708578600582,0.4106812169312169,0.08376457794277625,0.2153859740039253,132308.68115837182,2283.1151138117216,134591.79627218354,1194,14,363.0833333333333,35,1,21,33.5776662166723,0.6455357142857143,42.795138888888886,1028.819444444444,29.394841269841255,0
3976,4,0,0,36,0.0,0.0,1.0,36,850,500,350,0.5882352941176471,12,5,7,355.2516653575608,0.4099537037037037,0.08091089007119501,0.2141914852637009,132428.6352040817,2209.1287802736874,134637.76398435538,1195,15,364.0833333333333,34,2,22,33.53718482535277,0.6488970588235294,42.67857142857143,1029.2857142857147,30.27310924369749,0
3977,4,0,0,36,0.0,0.0,1.0,36,900,600,300,0.6666666666666666,12,6,6,374.2692883573594,0.4097883597883598,0.0922731537327437,0.20657073238898194,129014.56921616684,2461.3340066418687,131475.9032228087,1196,16,365.0833333333333,33,3,21,36.51135906714918,0.6167929292929293,46.0171568627451,1015.9313725490194,30.785799168152103,8
3978,4,0,0,36,0.0,0.0,1.0,36,1000,700,300,0.7,13,7,6,359.3185006343299,0.40884589947089944,-0.0019043866561594402,0.18764410588681676,126792.0918367348,1911.748866213167,128703.84070294797,1197,17,366.0833333333333,34,2,18,39.167159180457055,0.5919117647058824,48.21428571428572,1007.142857142858,29.621848739495825,8
3979,4,1,1,36,0.02702702702702703,0.02702702702702703,0.972972972972973,37,1200,700,500,0.5833333333333334,17,7,10,387.4468803405759,0.4139139139139139,0.02453283361486469,0.19837280273437502,125982.31449442531,2416.3229752685465,128398.63746969386,1198,0,357.1621621621622,33,4,18,39.29545084635416,0.5858585858585859,49.01960784313726,1003.9215686274517,30.421865715983387,8
3980,4,2,1,37,0.05263157894736842,0.02631578947368421,0.9736842105263158,38,1250,1000,250,0.8,15,10,5,368.92390177408964,0.42103781412991936,0.05173487433681223,0.19153223696527055,126552.40929705209,1737.6567416182102,128290.0660386703,1199,0,347.39473684210526,34,4,16,39.172188042277966,0.5894607843137255,48.45238095238095,1006.1904761904757,29.59383753501399,0
3981,4,0,0,37,0.0,0.0,1.0,37,1100,700,400,0.6363636363636364,15,7,8,375.09723347389297,0.41591591591591587,0.04331615098297559,0.194737212366176,126552.4092970522,2093.891723356017,128646.30102040822,1200,1,357.7837837837838,34,3,16,39.0168993532103,0.5894607843137255,48.452380952380956,1006.1904761904766,29.593837535014018,0
3982,4,4,0,41,0.0975609756097561,0.0,1.0,41,900,700,200,0.7777777777777778,11,7,4,343.6346051148832,0.42873475609756095,0.0649102860287567,0.18327878663763283,127646.96830257648,576.2269869046106,128223.1952894811,1201,0,323.780487804878,35,6,16,38.685550528767244,0.5985119047619047,47.36689814814816,1010.5324074074089,28.87235449735454,0
3983,4,0,2,39,0.0,0.04878048780487805,0.9512195121951219,41,1050,600,450,0.5714285714285714,15,6,9,345.7514177693761,0.42840447154471545,0.054135737009544105,0.18239180295173524,127202.60080024638,648.423722983752,127851.02452323012,1202,1,324.780487804878,37,4,19,39.08740942028985,0.5900900900900901,47.80701754385966,1008.7719298245627,27.264106211474665,8
3984,4,1,0,40,0.025,0.0,1.0,40,1200,800,400,0.6666666666666666,16,8,8,353.80096987910616,0.42586805555555557,0.05351239669421459,0.1861300754581388,127092.01388888912,993.0555555555802,128085.0694444447,1203,0,333.825,39,1,20,38.997933884297524,0.5854700854700854,47.91666666666668,1008.3333333333353,25.854700854700905,0
3985,4,4,2,42,0.09090909090909091,0.045454545454545456,0.9545454545454546,44,1250,900,350,0.72,16,9,7,325.67973963627696,0.4349563953488372,0.08228145561971334,0.1759858935161137,128171.5759460151,-442.74234787054144,127728.83359814456,1204,0,304.3863636363636,38,6,20,38.603652317647885,0.5981359649122807,46.8482905982906,1012.606837606838,26.647548358074683,0
3986,4,0,0,42,0.0,0.0,1.0,42,1050,700,350,0.6666666666666666,14,7,7,333.0807362186121,0.4329994192799071,0.0722127467701772,0.1793909330986721,128039.08420138928,129.47048611115045,128168.55468750044,1205,1,309.6190476190476,39,3,20,38.551530122135304,0.5950854700854701,46.979166666666686,1012.0833333333366,25.950854700854784,0
3987,4,1,0,43,0.023255813953488372,0.0,1.0,43,1550,1200,350,0.7741935483870968,19,12,7,332.8714021849315,0.4361618678479144,0.08284960292860077,0.18146366904866063,128523.41666894934,-43.559210406182274,128479.85745854316,1206,0,303.3953488372093,38,5,19,38.062813893864345,0.6016995614035088,46.50106837606837,1013.9957264957251,26.684098065676977,0
3988,4,0,1,42,0.0,0.023255813953488372,0.9767441860465116,43,1100,700,400,0.6363636363636364,15,7,8,337.9780711995794,0.4356312292358804,0.08932035030661623,0.18487556244880193,128658.86843450925,96.77523924316375,128755.6436737524,1207,1,304.3953488372093,38,5,19,37.795299775344,0.6030701754385965,46.367521367521356,1014.5299145299128,26.69815564552402,0
3989,4,1,2,41,0.023255813953488372,0.046511627906976744,0.9534883720930233,43,1200,800,400,0.6666666666666666,16,8,8,333.1152282769306,0.4368078626799557,0.10018566490786451,0.18358994059297257,128957.11343277436,-8.48434418147366,128948.62908859289,1208,0,302.5348837209302,38,5,20,37.61504680761543,0.6060855263157895,46.07371794871794,1015.7051282051273,26.72908232118756,0
3990,4,0,0,41,0.0,0.0,1.0,41,1200,800,400,0.6666666666666666,16,8,8,341.89085175561803,0.4334857723577236,0.10377706368856376,0.18799936385136684,128867.17547706956,611.7016774391775,129478.87715450874,1209,1,313.780487804878,37,4,21,37.483801295896335,0.6069819819819819,46.16228070175437,1015.3508771929799,27.441915599810265,0
3991,4,0,0,41,0.0,0.0,1.0,41,900,500,400,0.5555555555555556,13,5,8,342.70867081844074,0.43361280487804876,0.10732444580194489,0.1888465447823443,128950.68825263505,638.5037944367068,129589.19204707176,1210,2,314.780487804878,37,4,21,37.377986793335474,0.6078265765765766,46.0800438596491,1015.6798245614004,27.45080606922704,0
3992,4,0,0,41,0.0,0.0,1.0,41,1250,900,350,0.72,16,9,7,341.7427500857516,0.43358739837398375,0.10701288585871138,0.18911125674894466,129117.79495854453,625.0140668282102,129742.80902537274,1211,3,315.780487804878,37,4,21,37.23241899521702,0.6095157657657657,45.915570175438575,1016.3377192982423,27.468587008060602,0
3993,4,0,0,41,0.0,0.0,1.0,41,1150,1000,150,0.8695652173913043,13,10,3,337.50013777936164,0.43328252032520326,0.1107844117043717,0.18742372920753245,129257.13320444709,524.8600530932102,129781.9932575403,1212,4,316.780487804878,37,4,21,37.19852994033496,0.6109234234234234,45.7785087719298,1016.8859649122772,27.483404457088575,0
3994,4,0,0,41,0.0,0.0,1.0,41,1100,900,200,0.8181818181818182,13,9,4,339.5101203999991,0.4328760162601626,0.11557837806586257,0.18947645384440093,129452.33298947733,590.0754318636305,130042.40842134097,1213,5,317.780487804878,37,4,17,36.949031174801576,0.6128941441441442,45.586622807017534,1017.6535087719283,27.50414888572779,0
3995,4,0,0,41,0.0,0.0,1.0,41,900,700,200,0.7777777777777778,11,7,4,359.89981154078976,0.43300304878048784,0.113044332501951,0.18724007657459696,126638.21549590121,1012.5442249740521,127650.75972087527,1214,6,318.780487804878,36,5,13,39.31085440441559,0.5862268518518519,48.36711711711711,1006.5315315315307,27.959209209209188,8
3996,4,1,0,42,0.023809523809523808,0.0,1.0,42,1300,1000,300,0.7692307692307693,16,10,6,352.13827254621117,0.4331566976384049,0.11581569760817123,0.18500338730227772,127036.7384676052,546.8995267774459,127583.63799438265,1215,0,312.1666666666667,37,5,15,39.09660285693568,0.5884009009009009,47.971491228070164,1008.1140350877175,27.246325272641013,0
3997,4,1,3,40,0.023255813953488372,0.06976744186046512,0.9302325581395349,43,1000,700,300,0.7,13,7,6,362.29045010084934,0.43549280177187155,0.006959345821492713,0.18389679808916515,125625.78124999988,502.60416666665145,126128.38541666654,1216,0,305.8837209302326,39,4,12,40.29509559434743,0.5705128205128205,49.37499999999999,1002.4999999999991,25.705128205128183,8
3998,4,3,1,42,0.06976744186046512,0.023255813953488372,0.9767441860465116,43,800,600,200,0.75,10,6,4,353.4178427678609,0.43920727205610927,0.05172031290692769,0.18168239209239095,126148.45920138904,317.31770833334264,126465.77690972238,1217,0,304.6046511627907,39,4,15,39.978224802986304,0.5758547008547008,48.85416666666667,1004.5833333333346,25.75854700854704,0
3999,4,1,1,42,0.023255813953488372,0.023255813953488372,0.9767441860465116,43,850,500,350,0.5882352941176471,12,5,7,351.16973281037946,0.4389304171280915,0.06752185352595919,0.1814502281095175,126357.83420138905,274.60937500001836,126632.44357638907,1218,0,305.27906976744185,39,4,13,39.81903577842243,0.5779914529914529,48.64583333333334,1005.416666666668,25.779914529914564,0
4000,4,1,3,40,0.023255813953488372,0.06976744186046512,0.9302325581395349,43,1050,600,450,0.5714285714285714,15,6,9,356.39607128510227,0.43851513473606496,0.07971703220683635,0.18569099886633486,126698.43885633674,430.9651692708285,127129.40402560757,1219,0,305.93023255813955,39,4,14,39.33706242455595,0.5814636752136753,48.307291666666664,1006.7708333333328,25.81463675213674,0
4001,4,3,0,43,0.06976744186046512,0.0,1.0,43,1000,700,300,0.7,13,7,6,370.49840310976344,0.43881506090808414,0.12968129498821157,0.1956732569531715,127249.61480034702,829.1558159722031,128078.77061631922,1220,0,306.51162790697674,39,4,17,38.41498038405947,0.5870726495726496,47.76041666666666,1008.9583333333317,25.87072649572645,0
4002,4,1,3,41,0.022727272727272728,0.06818181818181818,0.9318181818181819,44,1000,800,200,0.8,12,8,4,399.7372865453179,0.44130990133897113,0.11033623910336221,0.21776732774483745,128496.33487654325,1753.3914448302476,130249.7263213735,1221,0,300.52272727272725,35,9,14,36.39554794520548,0.6071428571428572,46.52777777777778,1013.8888888888891,28.968253968253975,8
4003,4,1,1,41,0.023809523809523808,0.023809523809523808,0.9761904761904762,42,1150,600,550,0.5217391304347826,17,6,11,371.8961381277904,0.4377419667053813,0.0826784424162903,0.1967941934636897,127328.45187717005,1070.5919053819393,128399.04378255199,1222,0,312.0238095238095,39,3,15,38.29869353562461,0.5878739316239316,47.682291666666664,1009.2708333333326,25.878739316239297,8
4004,4,0,0,41,0.0,0.0,1.0,41,1200,700,500,0.5833333333333334,17,7,10,372.00903189225767,0.43521341463414637,0.09605916414644478,0.1975409758115517,127469.34125940542,1283.9492475710492,128753.29050697647,1223,1,320.4878048780488,38,3,15,38.15109676964312,0.5910087719298245,47.542735042735046,1009.8290598290604,26.57444894287001,0
4005,4,1,0,42,0.023809523809523808,0.0,1.0,42,1100,700,400,0.6363636363636364,15,7,8,369.2098499385255,0.4372096399535424,0.11904761904761907,0.19832776894927917,127933.68055555588,1046.8750000000346,128980.55555555591,1224,0,313.8333333333333,39,3,16,37.74540087863813,0.594017094017094,47.08333333333335,1011.6666666666692,25.940170940171008,0
4006,4,1,0,43,0.023255813953488372,0.0,1.0,43,1500,1000,500,0.6666666666666666,20,10,10,357.7791947788478,0.43890734588409,0.12925900334958285,0.19409471431198347,128329.1680230039,582.8748914931043,128912.04291449701,1225,0,307.51162790697674,39,4,18,37.62990044892227,0.5980235042735043,46.69270833333336,1013.2291666666703,25.980235042735135,0
4007,4,1,2,42,0.022727272727272728,0.045454545454545456,0.9545454545454546,44,1250,800,450,0.64,17,8,9,331.0338866871809,0.44071529245947855,-0.00555402642340308,0.18050715708036816,128533.39489073542,-21.590214356834963,128511.80467637858,1226,0,301.5,37,7,16,38.09922866205307,0.6036036036036037,46.49122807017543,1014.0350877192967,27.406353722143155,8
4008,4,0,1,41,0.0,0.023809523809523808,0.9761904761904762,42,1400,1000,400,0.7142857142857143,18,10,8,329.76485122423276,0.43426974448315914,0.04160555392588283,0.18044436241146192,128672.41753472203,86.32812499997908,128758.74565972202,1227,1,316.73809523809524,37,5,16,37.98981861738536,0.6050112612612613,46.35416666666666,1014.5833333333318,27.421171171171128,0
4009,4,0,1,40,0.0,0.024390243902439025,0.975609756097561,41,750,400,350,0.5333333333333333,11,4,7,337.68152539846614,0.4332317073170732,0.04944641455293586,0.18484268188579456,128686.69979100712,491.0242167843435,129177.72400779146,1228,2,324.780487804878,36,5,16,37.77446355900851,0.6070601851851851,46.34009009009009,1014.6396396396389,28.18443443443441,0
4010,4,0,0,40,0.0,0.0,1.0,40,1450,1000,450,0.6896551724137931,19,10,9,347.3136390083213,0.4321981837606838,0.05158052351375342,0.19093779081091614,128858.1486892298,950.8385074263517,129808.98719665615,1229,3,332.45,36,4,17,37.35534974859509,0.6087962962962963,46.171171171171174,1015.3153153153156,28.203203203203213,0
4011,4,2,1,41,0.047619047619047616,0.023809523809523808,0.9761904761904762,42,1300,900,400,0.6923076923076923,17,9,8,358.0880945504605,0.43766937669376693,0.10293399571152584,0.19078185179968707,127603.50722343962,786.0124482590626,128389.51967169868,1230,0,317.57142857142856,36,6,15,38.36495950364094,0.5960648148148149,47.409909909909906,1010.3603603603601,28.06556556556556,8
4012,4,0,0,41,0.0,0.0,1.0,41,1500,1100,400,0.7333333333333333,19,11,8,357.3580348209912,0.43704268292682924,0.1067433129221027,0.19120145629456817,127774.23327043239,932.2297804561097,128706.4630508885,1231,1,325.0975609756098,36,5,15,38.20844471671492,0.5978009259259259,47.24099099099098,1011.0360360360344,28.084334334334287,0
4013,4,0,1,40,0.0,0.024390243902439025,0.975609756097561,41,1050,700,350,0.6666666666666666,14,7,7,358.0413505206309,0.43661077235772355,0.10612553019317716,0.19211035904279003,127888.11404309708,957.8466135053836,128845.96065660247,1232,2,326.0975609756098,36,5,16,38.07452868700363,0.5989583333333333,47.12837837837837,1011.486486486486,28.096846846846834,0
4014,4,0,0,40,0.0,0.0,1.0,40,1150,800,350,0.6956521739130435,15,8,7,362.1326283103757,0.43490918803418804,0.1044153674832966,0.19403048939302936,127831.16731596457,1258.3673200227215,129089.5346359873,1233,3,334.875,36,4,17,38.02941722345954,0.5983796296296297,47.18468468468468,1011.2612612612609,28.09059059059058,0
4015,4,1,0,41,0.024390243902439025,0.0,1.0,41,800,400,400,0.5,12,4,8,353.4716104390084,0.43661077235772355,0.10051432692383866,0.1907424534882152,128116.77781865561,857.1287559633558,128973.90657461896,1234,0,327.6829268292683,37,4,18,37.95613108776489,0.5993806306306306,46.902412280701746,1012.390350877192,27.361901375059244,0
4016,4,2,3,40,0.046511627906976744,0.06976744186046512,0.9302325581395349,43,900,500,400,0.5555555555555556,13,5,8,344.69720755539436,0.43844592100406055,0.12301438760359873,0.1891441642169699,128783.68975309697,278.28165877961226,129061.97141187658,1235,0,313.3953488372093,37,6,15,37.49763692340932,0.6061373873873874,46.244517543859644,1015.0219298245603,27.43302513039352,0
4017,4,1,0,41,0.024390243902439025,0.0,1.0,41,1000,700,300,0.7,13,7,6,356.338218592829,0.4333079268292683,0.14726623762911673,0.19646520364959144,128972.51136271395,991.5669892865707,129964.07835200052,1236,0,328.5853658536585,36,5,19,37.00965447154472,0.6099537037037037,46.05855855855855,1015.7657657657649,28.21571571571569,0
4018,4,1,0,42,0.023809523809523808,0.0,1.0,42,1250,1000,250,0.8,15,10,5,354.1682762883411,0.43429394115369724,0.15104150187206633,0.19668754827083157,129258.639974434,756.0648486324254,130014.70482306642,1237,0,321.73809523809524,36,6,20,36.773255813953476,0.6128472222222222,45.77702702702703,1016.8918918918928,28.246996996997023,0
4019,4,1,2,41,0.023255813953488372,0.046511627906976744,0.9534883720930233,43,1250,900,350,0.72,16,9,7,350.5808349931617,0.4356312292358804,0.14898341874735554,0.1967701133686695,129675.59880203522,492.3559412511519,130167.95474328638,1238,0,315.2325581395349,37,6,18,36.44039096422293,0.6151463963963963,45.36732456140351,1018.5307017543859,27.52785680417259,0
4020,4,0,0,41,0.0,0.0,1.0,41,1150,900,250,0.782608695652174,14,9,5,365.6575248030026,0.4323678861788618,0.15758399312247784,0.20444742089271517,129525.18332315248,1272.371586719824,130797.5549098723,1239,1,331.1463414634146,35,6,18,36.209612469205986,0.6175595238095238,45.5150462962963,1017.9398148148152,29.08399470899472,0
4021,4,1,1,41,0.023809523809523808,0.023809523809523808,0.9761904761904762,42,900,500,400,0.5555555555555556,13,5,8,362.6839250960347,0.43191056910569103,0.1795690783766304,0.20543016320167543,130032.77084094247,1032.1591439412587,131064.92998488373,1240,0,324.23809523809524,36,6,20,35.769064443708366,0.6206597222222222,45.0168918918919,1019.9324324324339,28.331456456456497,0
4022,4,1,0,42,0.023809523809523808,0.0,1.0,42,1100,700,400,0.6363636363636364,15,7,8,364.3536574828638,0.433882597754549,0.1928282776320227,0.2077638823059368,130293.86421388392,1095.2179116057664,131389.0821254897,1241,0,324.7142857142857,33,9,21,35.46130416516625,0.6297348484848485,44.761029411764696,1020.9558823529399,30.938057040998178,0
4023,4,0,0,42,0.0,0.0,1.0,42,1450,1200,250,0.8275862068965517,17,12,5,358.1689951999417,0.4339309910956253,0.1788802753456662,0.2051627333309466,130469.43486636232,946.0212780778527,131415.45614444016,1242,1,325.7142857142857,35,7,22,35.4410945583626,0.6270833333333333,44.589120370370374,1021.6435185185187,29.18981481481482,0
4024,4,0,0,42,0.0,0.0,1.0,42,1150,900,250,0.782608695652174,14,9,5,342.99793855214466,0.4336527293844367,0.14063316293399342,0.18931855657606494,129016.12548828125,450.45301649305486,129466.57850477431,1243,2,326.7142857142857,39,3,17,37.30401329505451,0.6049679487179487,46.015625,1015.9375,26.049679487179485,7
4025,4,1,0,43,0.023255813953488372,0.0,1.0,43,1300,900,400,0.6923076923076923,17,9,8,337.886740328322,0.434546880767811,0.1391028008725288,0.1882350671912538,129382.26176754908,143.31013698856535,129525.57190453765,1244,0,320.09302325581393,40,3,18,37.061523990277365,0.60703125,45.65548780487805,1017.3780487804878,25.434451219512194,0
4026,4,2,1,44,0.044444444444444446,0.022222222222222223,0.9777777777777777,45,1300,900,400,0.6923076923076923,17,9,8,325.0525885873733,0.43703703703703706,0.14618926911702657,0.18345242660617836,129891.90853915023,-555.6597785589804,129336.24876059125,1245,0,306.8222222222222,42,3,16,36.87123732572878,0.6091269841269842,45.15503875968992,1019.3798449612398,24.27094868955333,0
4027,4,1,0,45,0.022222222222222223,0.0,1.0,45,1700,1300,400,0.7647058823529411,21,13,8,324.8087258370626,0.43682659932659934,0.15258199977301135,0.18380794369623354,129996.88042534712,-555.1757812500116,129441.7046440971,1246,0,307.77777777777777,43,2,17,36.771152536601974,0.6087693798449613,45.05208333333333,1019.7916666666657,23.71608527131781,0
4028,4,1,1,45,0.021739130434782608,0.021739130434782608,0.9782608695652174,46,950,600,350,0.631578947368421,13,6,7,318.2859699864861,0.4382850241545894,0.15707130302755234,0.18169542533681443,130336.7858376902,-902.5834042237402,129434.20243346646,1247,0,302.0652173913044,42,4,18,36.593755930916686,0.6135912698412698,44.71899224806202,1021.1240310077532,24.312476928756027,0
4029,4,0,2,43,0.0,0.044444444444444446,0.9555555555555556,45,1350,1100,250,0.8148148148148148,16,11,5,323.7265127500277,0.43600589225589226,0.15606281366359065,0.18505077450091806,130389.2089966773,-557.9112142542267,129831.29778242308,1248,1,309.5777777777778,41,4,18,36.401873887000164,0.615599593495935,44.66765873015873,1021.3293650793646,24.910472319008893,0
4030,4,0,0,43,0.0,0.0,1.0,43,1700,1200,500,0.7058823529411765,22,12,10,339.11979537215956,0.4339470284237726,0.15533612029818245,0.19348383202781783,130315.76063368065,238.530815972227,130554.29144965288,1249,2,324.25581395348837,39,4,18,36.08319730667208,0.6180555555555556,44.739583333333336,1021.0416666666674,26.180555555555575,0
4031,4,0,0,43,0.0,0.0,1.0,43,1450,1100,350,0.7586206896551724,18,11,7,339.8629210450285,0.4337393872277593,0.15122801608102154,0.19430646885402364,130395.54172092021,263.3219401041721,130658.86366102438,1250,3,325.25581395348837,39,4,18,35.983448070712214,0.6188568376068376,44.661458333333336,1021.3541666666673,26.188568376068392,0
4032,4,0,0,43,0.0,0.0,1.0,43,1300,1000,300,0.7692307692307693,16,10,6,338.3790482559104,0.43369324473975635,0.14933751332255918,0.19461148349949708,130625.9411250744,240.21632708705593,130866.15745216145,1251,4,326.25581395348837,40,3,13,35.788224475594,0.61953125,44.4359756097561,1022.256097560976,25.5564024390244,0
4033,4,0,1,42,0.0,0.023255813953488372,0.9767441860465116,43,1350,900,450,0.6666666666666666,18,9,9,336.56932673812855,0.43341638981173863,0.14755333308684881,0.19422211607181933,130755.83316808786,201.68054729328557,130957.51371538115,1252,5,327.25581395348837,40,3,13,35.703166401695796,0.6208333333333333,44.3089430894309,1022.7642276422771,25.569105691056926,0
4034,4,0,0,42,0.0,0.0,1.0,42,1100,700,400,0.6363636363636364,15,7,8,338.21238663624604,0.4323582075106465,0.15810697433062249,0.19523265281489147,130768.17626953138,445.48339843751535,131213.6596679689,1253,6,335.6666666666667,39,3,13,35.64867858234037,0.6225961538461539,44.29687500000001,1022.812500000001,26.225961538461565,0
4035,4,0,1,41,0.0,0.023809523809523808,0.9761904761904762,42,1300,1000,300,0.7692307692307693,16,10,6,340.3231555016084,0.43169279907084784,0.15790979285170548,0.1973168968944559,130937.79047070196,512.2324054795473,131450.02287618152,1254,7,336.6666666666667,40,2,14,35.42328633369743,0.62265625,44.13109756097561,1023.4756097560976,25.586890243902438,0
4036,4,0,0,41,0.0,0.0,1.0,41,1150,700,450,0.6086956521739131,16,7,9,346.6094615872356,0.4301067073170732,0.1559574927792855,0.2003561814154352,130821.45317925359,868.790690104177,131690.24386935777,1255,8,345.6829268292683,39,2,15,35.380074160811866,0.6231303418803419,44.24479166666667,1023.0208333333343,26.231303418803442,0
4037,4,0,2,39,0.0,0.04878048780487805,0.9512195121951219,41,1300,700,600,0.5384615384615384,19,7,12,346.0430303854347,0.4301321138211382,0.15666852851734636,0.20058246451545103,130928.03955078126,861.3471137152787,131789.38666449653,1256,9,346.6829268292683,39,2,15,35.28678965224768,0.624198717948718,44.140625,1023.4375000000001,26.241987179487182,0
4038,4,0,0,39,0.0,0.0,1.0,39,1050,600,450,0.5714285714285714,15,6,9,358.24615544945715,0.42611336032388664,0.15629863024244317,0.20648971852420517,130710.70545744855,1565.3215412434738,132276.02699869202,1257,10,364.8974358974359,37,2,16,35.19461719922797,0.6255630630630631,44.3530701754386,1022.5877192982465,27.637505926979635,0
4039,4,1,0,40,0.025,0.0,1.0,40,1450,1200,250,0.8275862068965517,17,12,5,353.86066124583147,0.4282852564102564,0.16271902377972491,0.20637567031782442,131163.9135437213,1282.7498356344638,132446.66337935577,1258,0,356.75,38,2,17,34.84824780976221,0.6282894736842105,43.910256410256416,1024.358974358975,26.95681511470987,0
4040,4,0,0,40,0.0,0.0,1.0,40,1150,900,250,0.782608695652174,14,9,5,357.59802139510043,0.4277911324786325,0.1630277285520696,0.2093006601124588,131300.74929003217,1390.5776307619333,132691.3269207941,1259,1,357.75,38,2,17,34.614215226380345,0.6296600877192983,43.776709401709404,1024.8931623931626,26.97087269455691,0
4041,4,0,0,40,0.0,0.0,1.0,40,1450,900,550,0.6206896551724138,20,9,11,356.48086265294893,0.42743055555555554,0.1559312520047047,0.20956414257655742,131468.65051025298,1373.2144427113549,132841.86495296433,1260,2,358.75,37,3,17,34.4732305142735,0.6331644144144144,43.61293859649122,1025.5482456140337,27.71752015173064,0
4042,4,0,0,40,0.0,0.0,1.0,40,1200,1000,200,0.8333333333333334,14,10,4,358.87884533146945,0.4271901709401709,0.15635221806520594,0.21128455620364342,131524.88175448202,1440.2995392813039,132965.18129376334,1261,3,359.75,37,3,17,34.354957242116505,0.6337274774774775,43.55811403508771,1025.7675438596482,27.723447131341842,0
4043,4,1,0,41,0.024390243902439025,0.0,1.0,41,1450,900,550,0.6206896551724138,20,9,11,354.673309424393,0.4295223577235772,0.1622210042325145,0.21043949692513983,131821.37573964495,1150.704717291252,132972.0804569362,1262,0,351.9512195121951,38,3,17,34.163675613816054,0.6348684210526316,43.26923076923077,1026.9230769230767,27.024291497975703,0
4044,4,1,1,41,0.023809523809523808,0.023809523809523808,0.9761904761904762,42,1650,1300,350,0.7878787878787878,20,13,7,345.4525872825327,0.43129355400696867,0.1601450953152741,0.20693616150808014,132183.68055555547,732.6388888888852,132916.31944444435,1263,0,344.54761904761904,39,3,18,34.03565640194489,0.6367521367521367,42.916666666666664,1028.3333333333328,26.367521367521356,0
4045,4,0,0,41,0.0,0.0,1.0,41,900,600,300,0.6666666666666666,12,6,6,352.25236664695,0.4294461382113821,0.16875453102899418,0.21052001688676686,132095.80342793453,1106.211876324021,133202.01530425856,1264,1,353.1463414634146,38,3,18,33.94932619690986,0.637609649122807,43.002136752136735,1027.9914529914504,27.052406657669746,0
4046,4,0,0,41,0.0,0.0,1.0,41,1100,700,400,0.6363636363636364,15,7,8,351.73133251658885,0.42906504065040646,0.16954564807493466,0.2105138273718688,132150.72320841538,1096.309993425364,133247.03320184074,1265,2,354.1463414634146,38,3,18,33.90741895261844,0.638157894736842,42.94871794871794,1028.2051282051273,27.058029689608613,0
4047,4,0,0,41,0.0,0.0,1.0,41,950,700,250,0.7368421052631579,12,7,5,348.3109541149782,0.42906504065040646,0.164310555765232,0.20922558809564085,132288.07259706687,1015.4769568631677,133303.54955393003,1266,3,355.1463414634146,38,3,18,33.85714162079829,0.6395285087719298,42.81517094017094,1028.7393162393155,27.072087269455672,0
4048,4,0,0,41,0.0,0.0,1.0,41,850,500,350,0.5882352941176471,12,5,7,346.0274134667387,0.4285823170731707,0.16065857710072096,0.20830850290697667,132370.51647308056,960.7654868872755,133331.28195996783,1267,4,356.1463414634146,38,3,18,33.8329699612403,0.6403508771929824,42.73504273504273,1029.0598290598289,27.080521817363916,0
4049,4,0,1,40,0.0,0.024390243902439025,0.975609756097561,41,1000,600,400,0.6,14,6,8,347.2346074574023,0.4284298780487805,0.16480879628223466,0.20964615773555934,132480.48159105843,1000.3616042077498,133480.84319526618,1268,5,357.1463414634146,38,3,20,33.69136571191366,0.6414473684210527,42.628205128205124,1029.4871794871788,27.091767881241548,0
4050,4,0,0,40,0.0,0.0,1.0,40,700,600,100,0.8571428571428571,8,6,2,352.96106428026644,0.4282184829059829,0.16287410799872148,0.21311584775095985,132482.65241468546,1352.2435989920073,133834.89601367747,1269,6,364.525,37,3,20,33.541799801185775,0.6432995495495495,42.626096491228076,1029.495614035089,27.824205784732133,0
4051,4,0,0,40,0.0,0.0,1.0,40,1300,1100,200,0.8461538461538461,15,11,4,352.84684683725663,0.4276575854700855,0.1691949558369692,0.21433108078407898,132708.51518015168,1365.1562259541527,134073.67140610583,1270,7,365.525,37,3,16,33.31770334503921,0.6455518018018018,42.40679824561404,1030.3728070175446,27.84791370317688,0
4052,4,0,0,40,0.0,0.0,1.0,40,1300,1000,300,0.7692307692307693,16,10,6,354.04836505985173,0.4272435897435898,0.17022923093287967,0.21571021904910348,132821.5187004656,1405.0483081332775,134226.56700859885,1271,8,366.525,37,3,16,33.17322182037372,0.646677927927928,42.29714912280702,1030.8114035087724,27.859767662399253,0
4053,4,0,0,40,0.0,0.0,1.0,40,1300,1000,300,0.7692307692307693,16,10,6,356.4899275014954,0.4264957264957265,0.167697327532629,0.218095929030383,132975.88962853415,1480.9130506246186,134456.80267915878,1272,9,367.525,38,2,16,32.955251709136114,0.6463815789473684,42.14743589743591,1031.4102564102586,27.142375168691018,0
4054,4,0,0,40,0.0,0.0,1.0,40,1100,600,500,0.5454545454545454,16,6,10,355.7906716561857,0.42622863247863246,0.15566770186335388,0.2186347257123893,133141.23109796218,1474.0816074951022,134615.3127054573,1273,10,368.525,38,2,17,32.80732401656315,0.6480263157894737,41.9871794871795,1032.0512820512845,27.159244264507485,0
4055,4,0,1,39,0.0,0.025,0.975,40,1250,1000,250,0.8,15,10,5,354.0227749032486,0.4262419871794872,0.1600512263272269,0.21803199961058614,133223.94035585166,1432.8618096647142,134656.8021655164,1274,11,369.525,38,2,17,32.76997309324226,0.6488486842105263,41.90705128205129,1032.3717948717967,27.167678812415705,0
4056,4,0,0,39,0.0,0.0,1.0,39,750,600,150,0.8,9,6,3,360.0542315148553,0.4238079172289699,0.1655157760543926,0.22137103078049228,133160.8178117307,1789.0231850184834,134949.84099674918,1275,13,379.71794871794873,37,2,17,32.67765767201388,0.6500563063063063,41.96820175438597,1032.1271929824575,27.895329540066417,0
4057,4,0,0,39,0.0,0.0,1.0,39,1150,800,350,0.6956521739130435,15,8,7,357.9322324072239,0.42400472334682865,0.15790604924414287,0.22043971712880883,133223.94035585164,1737.0284763313807,134960.96883218302,1276,14,380.71794871794873,38,1,18,32.66907275173342,0.6488486842105263,41.90705128205129,1032.3717948717965,27.167678812415698,0
4058,4,0,0,39,0.0,0.0,1.0,39,850,700,150,0.8235294117647058,10,7,3,358.39520401705676,0.42411718398560505,0.15958011096612723,0.22154506601259005,133361.84619037193,1759.249214697946,135121.09540506988,1277,15,381.71794871794873,38,1,18,32.518790511653584,0.6502192982456141,41.77350427350428,1032.9059829059836,27.181736392262724,0
4059,4,0,0,39,0.0,0.0,1.0,39,1600,1200,400,0.75,20,12,8,357.51386986232717,0.4234424201529465,0.1666313034868092,0.22199774290660745,133528.88028047106,1747.7310025878744,135276.61128305894,1278,16,382.71794871794873,37,2,19,32.37410707970861,0.6537162162162162,41.611842105263165,1033.5526315789486,27.933854907539153,0
4060,4,0,0,39,0.0,0.0,1.0,39,1400,1100,300,0.7857142857142857,17,11,6,357.71677138010546,0.42240215924426455,0.16731625381190796,0.22349006762913348,133755.63274276705,1769.3266197291496,135524.95936249619,1279,17,383.71794871794873,37,2,16,32.141721433114256,0.6559684684684685,41.39254385964912,1034.4298245614036,27.95756282598388,0
4061,4,0,0,39,0.0,0.0,1.0,39,750,400,350,0.5333333333333333,11,4,7,361.4982306538683,0.4215024741340531,0.1713748566895421,0.22654849275638847,133869.08111149597,1878.6871922129983,135747.76830370896,1280,18,384.71794871794873,37,2,17,31.930317157589887,0.6570945945945945,41.28289473684211,1034.8684210526324,27.96941678520628,0
4062,4,0,0,39,0.0,0.0,1.0,39,1200,800,400,0.6666666666666666,16,8,8,364.05433599966705,0.4211932073774179,0.08796008533942534,0.22256405935146542,132949.08717839466,2019.52015992278,134968.60733831744,1281,19,385.71794871794873,36,3,19,32.7871351095581,0.6498842592592593,42.17342342342342,1031.3063063063066,28.647397397397405,7
4063,4,0,0,39,0.0,0.0,1.0,39,500,100,400,0.2,9,1,8,365.030031839511,0.4211088618983356,0.0842610783671689,0.22385576651362787,133065.2506391527,1914.562535508488,134979.8131746612,1282,20,386.71794871794873,36,3,19,32.64525576657208,0.6510416666666667,42.060810810810814,1031.756756756757,28.65990990990992,0
4064,4,0,0,39,0.0,0.0,1.0,39,1300,1000,300,0.7692307692307693,16,10,6,366.05598919071997,0.42094017094017094,0.08720409898420334,0.22553772237234695,133239.59094229375,1954.630052349653,135194.2209946434,1283,21,387.71794871794873,36,3,19,32.443690008725994,0.6527777777777778,41.891891891891895,1032.4324324324332,28.6786786786787,0
4065,4,0,0,39,0.0,0.0,1.0,39,1250,1000,250,0.8,15,10,5,370.27909146232867,0.42006860098965365,0.09123643578584706,0.2290478871087719,133387.25767784304,2078.102517120642,135465.3601949637,1284,22,388.71794871794873,37,2,20,32.18640537097973,0.6523085585585586,41.748903508771924,1033.0043859649113,27.919037458511117,0
4066,4,0,0,39,0.0,0.0,1.0,39,1250,900,350,0.72,16,9,7,369.8146954922508,0.4198717948717949,0.09451505726577425,0.22911005099431123,133443.89770169646,2069.902878770369,135513.80058046684,1285,23,389.71794871794873,37,2,20,32.14154639357599,0.6528716216216216,41.69407894736841,1033.2236842105247,27.924964438122288,0
4067,4,0,0,39,0.0,0.0,1.0,39,1300,1100,200,0.8461538461538461,15,11,4,366.91289200196024,0.4196749887539361,0.09373458895513465,0.22805330288139022,133564.50007086166,2001.3164151567762,135565.81648601842,1286,24,390.71794871794873,34,5,21,32.09552190103264,0.6602328431372548,41.57738095238095,1033.6904761904761,30.402661064425768,0
4068,4,0,0,39,0.0,0.0,1.0,39,1150,1000,150,0.8695652173913043,13,10,3,365.9549235865515,0.4195906432748538,0.09175731377481733,0.22764703126257957,133595.2664399092,1977.9691043083826,135573.23554421758,1287,25,391.71794871794873,34,5,21,32.089426915399976,0.6605392156862745,41.547619047619044,1033.809523809523,30.406162464985968,0
4069,4,0,0,39,0.0,0.0,1.0,39,850,700,150,0.8235294117647058,10,7,3,390.19365679479085,0.41970310391363025,0.1745076179858791,0.2313003635639225,131786.1128826531,2499.8547335600947,134285.9676162132,1288,26,392.71794871794873,34,5,16,33.28743961352656,0.6424632352941176,43.30357142857143,1026.7857142857147,30.199579831932784,8
4070,4,0,0,39,0.0,0.0,1.0,39,1100,600,500,0.5454545454545454,16,6,10,391.3159650844758,0.41897210976158344,0.1824880411207177,0.2329004674951053,131938.9526643991,2525.963718820863,134464.91638321997,1289,27,393.71794871794873,34,5,17,33.103997682502886,0.6439950980392157,43.154761904761905,1027.3809523809525,30.217086834733898,0
4071,4,0,0,39,0.0,0.0,1.0,39,1300,1000,300,0.7692307692307693,16,10,6,392.8266270426216,0.41919703103913625,0.1799654792355525,0.23398803436886584,131969.53125,2568.229166666667,134537.76041666666,1290,28,394.71794871794873,34,5,17,33.03426601784267,0.6443014705882353,43.125,1027.5,30.220588235294116,0
4072,4,0,0,39,0.0,0.0,1.0,39,1650,1400,250,0.8484848484848485,19,14,5,390.5527910002805,0.4187471884840306,0.17851142327611624,0.23343808140407063,132100.37964034633,2518.4343921467735,134618.8140324931,1291,29,395.71794871794873,35,4,17,32.96038805073931,0.6434523809523809,42.99768518518518,1028.009259259259,29.371693121693113,0
4073,4,0,0,39,0.0,0.0,1.0,39,1500,1100,400,0.7333333333333333,19,11,8,392.8259504779066,0.41810053981106615,0.181025006275372,0.2357220946588219,132249.14969403707,2590.179585691001,134839.32927972806,1292,30,396.71794871794873,35,4,19,32.75160815423277,0.6449404761904762,42.85300925925925,1028.587962962962,29.388227513227484,0
4074,4,0,0,39,0.0,0.0,1.0,39,1200,900,300,0.75,15,9,6,396.80436389610406,0.41722896986054886,0.18229276379056158,0.2392505278078518,132429.53619100817,2709.8910228541513,135139.42721386233,1293,31,397.71794871794873,33,6,19,32.46703476604357,0.651199494949495,42.67769607843137,1029.2892156862738,31.19058229352345,0
4075,4,0,0,39,0.0,0.0,1.0,39,1050,700,350,0.6666666666666666,14,7,7,382.35651909307813,0.4161043634727845,0.16785275646106812,0.2196870800332448,130587.70743580672,2203.066495061693,132790.77393086842,1294,32,398.71794871794873,35,4,17,34.7031527195863,0.6282738095238095,44.473379629629626,1022.1064814814812,29.20304232804232,8
4076,4,0,0,39,0.0,0.0,1.0,39,1000,500,500,0.5,15,5,10,378.44151343004205,0.415710751237067,0.16136697974425718,0.21843812241549873,130765.21675936654,2097.397306884447,132862.61406625097,1295,33,399.71794871794873,35,4,17,34.62301025989212,0.6300595238095238,44.299768518518526,1022.8009259259269,29.222883597883627,0
4077,4,0,0,39,0.0,0.0,1.0,39,1100,1000,100,0.9090909090909091,12,10,2,374.59502290097123,0.41599190283400805,0.15656047187374988,0.2170490951828564,130913.23329260976,2007.8891246570706,132921.12241726683,1296,34,400.71794871794873,35,4,17,34.571269697655126,0.631547619047619,44.155092592592595,1023.3796296296299,29.239417989417998,0
4078,4,0,0,39,0.0,0.0,1.0,39,1250,500,750,0.4,20,5,15,373.5010954279722,0.4155420602789024,0.16094112737042532,0.2172494537311817,131061.33355034741,1990.3103298611354,133051.64388020855,1297,35,401.71794871794873,35,4,17,34.44917768735166,0.6330357142857144,44.01041666666668,1023.9583333333348,29.255952380952426,0
4079,4,0,0,39,0.0,0.0,1.0,39,750,500,250,0.6666666666666666,10,5,5,377.28815630687495,0.4144174538911381,0.15780920017729438,0.22013035408517811,131179.87403817306,2098.5225640860863,133278.39660225913,1298,36,402.71794871794873,35,4,18,34.232125371897716,0.6342261904761906,43.89467592592593,1024.4212962962968,29.269179894179906,0
4080,4,0,0,39,0.0,0.0,1.0,39,1450,1100,350,0.7586206896551724,18,11,7,373.8495461071044,0.41427687809266756,0.15021930804069927,0.21914352903528103,131358.63272392304,2021.7567687118708,133380.38949263492,1299,37,403.71794871794873,34,5,19,34.13923082878489,0.6381740196078431,43.7202380952381,1025.1190476190486,30.150560224089666,0
4081,4,0,0,39,0.0,0.0,1.0,39,1150,800,350,0.6956521739130435,15,8,7,372.62746787642965,0.4139676113360324,0.1535960846305673,0.21877575874708197,131419.65880102065,1994.1149376417507,133413.7737386624,1300,38,404.71794871794873,34,5,19,34.10880839041759,0.6387867647058824,43.6607142857143,1025.3571428571447,30.157563025210138,0
4082,4,0,0,39,0.0,0.0,1.0,39,1050,700,350,0.6666666666666666,14,7,7,373.3659401617269,0.41334907782276203,0.14776466667856814,0.22008670809259662,131572.28599773248,2024.9220521542047,133597.20804988669,1301,39,405.71794871794873,34,5,16,33.935512880018564,0.6403186274509804,43.511904761904766,1025.9523809523814,30.17507002801122,0
4083,4,0,0,39,0.0,0.0,1.0,39,1050,600,450,0.5714285714285714,15,6,9,374.73380441330767,0.41228070175438597,0.1463516186114293,0.22154262516914758,131684.26890432098,2069.3094135802485,133753.57831790124,1302,40,406.71794871794873,35,4,16,33.787212449255755,0.6392857142857142,43.40277777777778,1026.388888888889,29.325396825396826,0
4084,4,0,0,39,0.0,0.0,1.0,39,1500,1300,200,0.8666666666666667,17,13,4,376.5269657494372,0.41118421052631576,0.14427951230925196,0.22417370053371927,131951.6933111497,2136.6741415894994,134088.36745273918,1303,41,407.71794871794873,35,4,17,33.47097837107129,0.6419642857142858,43.14236111111111,1027.4305555555554,29.355158730158728,0
4085,4,1,0,40,0.025,0.0,1.0,40,950,600,350,0.631578947368421,13,6,7,371.84423424588965,0.41302083333333334,0.15902101346174868,0.22366957000030915,132340.06123944905,1841.9777463274238,134182.03898577648,1304,0,398.5,36,4,18,33.19949108022328,0.6438078703703703,42.76463963963965,1028.9414414414425,28.581706706706736,0
4086,4,0,0,40,0.0,0.0,1.0,40,1200,700,500,0.5833333333333334,17,7,10,372.6889127227434,0.41312767094017094,0.16164117845496428,0.22469983056565151,132427.78427479864,1870.8860687318725,134298.6703435305,1305,1,399.5,35,5,18,33.089344615615275,0.6467261904761905,42.67939814814815,1029.2824074074083,29.40806878306881,0
4087,4,0,0,40,0.0,0.0,1.0,40,1350,1000,350,0.7407407407407407,17,10,7,372.42360900022936,0.4124198717948718,0.1685259076093073,0.22525172326818751,132546.9409749013,1872.7220239626156,134419.66299886393,1306,2,400.5,35,5,19,32.97612022779216,0.6479166666666667,42.563657407407405,1029.7453703703695,29.421296296296273,0
4088,4,0,0,40,0.0,0.0,1.0,40,1150,700,450,0.6086956521739131,16,7,9,371.8429001372714,0.41179220085470086,0.1646830748482806,0.2250787840422751,132576.7385223767,1859.5437885802603,134436.28231095694,1307,3,401.5,35,5,19,32.9610586648685,0.6482142857142856,42.53472222222223,1029.8611111111122,29.424603174603206,0
4089,4,0,0,40,0.0,0.0,1.0,40,1450,1000,450,0.6896551724137931,19,10,9,371.9631359676809,0.41160523504273505,0.16852808988764068,0.22550898570247688,132636.34366426614,1867.166066529499,134503.50973079563,1308,4,402.5,35,5,16,32.897940074906366,0.6488095238095238,42.476851851851855,1030.0925925925928,29.431216931216937,0
4090,4,0,0,40,0.0,0.0,1.0,40,1350,1100,250,0.8148148148148148,16,11,5,371.63148259083584,0.41121794871794876,0.17277097902097927,0.22614171068293415,132774.93709926138,1868.6693450206953,134643.60644428208,1309,5,403.5,36,4,16,32.76697261072261,0.6481481481481481,42.34234234234234,1030.6306306306303,28.62862862862862,0
4091,4,0,0,40,0.0,0.0,1.0,40,1800,1400,400,0.7777777777777778,22,14,8,368.63669475709924,0.411071047008547,0.1623130254394589,0.22554064711291064,132978.12328798397,1804.1231687768932,134782.24645676085,1310,6,404.5,36,4,17,32.639798740765016,0.6501736111111112,42.145270270270274,1031.4189189189192,28.650525525525534,0
4092,4,0,0,40,0.0,0.0,1.0,40,1250,1000,250,0.8,15,10,5,369.57193560705855,0.410536858974359,0.16268962130306663,0.2268176588055913,133094.29943034257,1837.5835717474258,134931.88300209,1311,7,405.5,36,4,17,32.49890865437084,0.6513310185185186,42.03265765765766,1031.8693693693697,28.663038038038046,0
4093,4,0,0,40,0.0,0.0,1.0,40,1250,800,450,0.64,17,8,9,374.59637266103437,0.40970886752136754,0.17012926802661732,0.2306195398377235,133210.5262991031,1980.0359903822712,135190.5622894854,1312,8,406.5,36,4,17,32.25246354678012,0.6524884259259259,41.92004504504504,1032.3198198198195,28.67555055055054,0
4094,4,0,2,38,0.0,0.05,0.95,40,1250,800,450,0.64,17,8,9,378.4907175828062,0.4096287393162393,0.16888834369207317,0.23374669164659354,133326.8038942658,2092.591535792541,135419.39543005833,1313,9,407.5,36,4,17,32.03508341511286,0.6536458333333333,41.80743243243243,1032.7702702702695,28.68806306306304,0
4095,4,0,0,38,0.0,0.0,1.0,38,850,700,150,0.8235294117647058,10,7,3,388.7744567520007,0.40862079184447603,0.16772484203242466,0.23925218697633774,133195.58000283447,2756.6078514739247,135952.1878543084,1314,10,407.7368421052632,34,4,17,31.901597278283937,0.6565563725490196,41.93452380952381,1032.2619047619048,30.360644257703083,0
4096,4,0,0,38,0.0,0.0,1.0,38,1450,1000,450,0.6896551724137931,19,10,9,386.1360467690344,0.4087393314366998,0.16442440086617371,0.2388098701222319,133379.97626133796,2700.5633503401486,136080.5396116781,1315,11,408.7368421052632,34,4,18,31.78421881602704,0.6583946078431373,41.75595238095239,1032.9761904761913,30.38165266106445,0
4097,4,0,0,38,0.0,0.0,1.0,38,1600,1400,200,0.875,18,14,4,387.2416080065593,0.4088282361308677,0.1605660365916517,0.23989078628757513,133441.47002551018,2734.8178854875255,136176.2879109977,1316,12,409.7368421052632,34,4,19,31.693839536044855,0.6590073529411764,41.69642857142857,1033.2142857142856,30.388655462184868,0
4098,4,0,0,38,0.0,0.0,1.0,38,1000,600,400,0.6,14,6,8,388.3435938166613,0.40851706970128027,0.1584655309008567,0.24180478974399808,133630.5616379518,2778.918053128119,136409.4796910799,1317,13,410.7368421052632,33,5,21,31.475321994389795,0.6631944444444444,41.513480392156865,1033.9460784313728,31.331699346405237,0
4099,4,0,0,38,0.0,0.0,1.0,38,1050,800,250,0.7619047619047619,13,8,5,386.55205706536253,0.4082207207207207,0.16051727256285053,0.24110220322059092,133693.92368620244,2735.9322436082302,136429.85592981067,1318,14,411.7368421052632,33,5,22,31.457987715764112,0.6638257575757576,41.45220588235294,1034.1911764705883,31.339126559714796,0
4100,4,0,0,38,0.0,0.0,1.0,38,700,400,300,0.5714285714285714,10,4,6,386.1763910469641,0.40770211000474155,0.1538619904570444,0.2418332270158654,133841.52494331068,2737.287414965989,136578.81235827666,1319,15,412.7368421052632,34,4,15,31.31950836017794,0.6629901960784313,41.30952380952381,1034.7619047619048,30.43417366946779,0
4101,4,0,0,38,0.0,0.0,1.0,38,1200,900,300,0.75,15,9,6,382.9090281650922,0.4067389758179232,0.14828354234251662,0.24059081711876024,133964.73922902497,2659.2616213151914,136624.00085034015,1320,16,413.7368421052632,34,4,17,31.28042586629868,0.6642156862745099,41.19047619047619,1035.2380952380954,30.44817927170869,0
4102,4,0,0,38,0.0,0.0,1.0,38,1000,700,300,0.7,13,7,6,386.5637583899715,0.4063240872451399,0.1499437257203715,0.24329461436150313,134026.36763038556,2761.9472789115766,136788.31490929713,1321,17,414.7368421052632,34,4,17,31.124013183107238,0.664828431372549,41.13095238095239,1035.476190476191,30.45518207282915,0
4103,4,0,0,38,0.0,0.0,1.0,38,1000,500,500,0.5,15,5,10,383.37957458052546,0.4063537221431958,0.14948578342407726,0.24169581875728804,134088.01020408186,2681.3208616780294,136769.33106575988,1322,18,415.7368421052632,34,4,17,31.144636015325673,0.6654411764705883,41.071428571428584,1035.7142857142874,30.462184873949628,0
4104,4,0,0,38,0.0,0.0,1.0,38,1150,700,450,0.6086956521739131,16,7,9,381.61249254877976,0.40610182550972024,0.1489393233687597,0.24078392296351958,134118.83680555565,2636.284722222232,136755.12152777787,1323,19,416.7368421052632,34,4,17,31.159493161705544,0.6657475490196079,41.04166666666667,1035.8333333333342,30.465686274509828,0
4105,4,0,0,38,0.0,0.0,1.0,38,1650,1400,250,0.8484848484848485,19,14,5,378.6923212125597,0.4058795637743006,0.1432137417498729,0.24035369774919624,134334.72222222236,2574.305555555575,136909.02777777793,1324,20,417.7368421052632,34,4,18,31.01889067524115,0.6678921568627452,40.83333333333334,1036.6666666666679,30.49019607843141,0
4106,4,0,1,37,0.0,0.02631578947368421,0.9736842105263158,38,700,500,200,0.7142857142857143,9,5,4,378.2355554208119,0.40601292081555235,0.14000845972566323,0.24046946625658908,134396.4356575964,2566.702097505672,136963.13775510207,1325,21,418.7368421052632,34,4,18,30.968953310371223,0.6685049019607843,40.773809523809526,1036.904761904762,30.49719887955182,0
4107,4,0,0,37,0.0,0.0,1.0,37,800,700,100,0.875,9,7,2,389.42952145324773,0.4046859359359359,0.14184954731247745,0.24669703842173163,134264.85794225786,3057.3398752883613,137322.19781754623,1326,22,428.94594594594594,33,4,18,30.810645027787633,0.6695075757575757,40.90073529411765,1036.3970588235302,31.405971479500916,0
4108,4,0,1,36,0.0,0.02702702702702703,0.972972972972973,37,950,600,350,0.631578947368421,13,6,7,389.83906587466987,0.40452952952952953,0.14639133754868494,0.247385495741473,134328.37017313062,3073.2892697520274,137401.65944288264,1327,23,429.94594594594594,33,4,19,30.736370532371833,0.6701388888888888,40.83946078431373,1036.6421568627457,31.413398692810475,0
4109,4,0,1,35,0.0,0.027777777777777776,0.9722222222222222,36,1300,1100,200,0.8461538461538461,15,11,4,431.5985415347266,0.403207671957672,0.08821045174649877,0.26113632824608557,132560.4848995002,4242.766363264138,136803.25126276436,1266,24,406.02777777777777,32,4,16,31.439022396599636,0.6549479166666667,42.55050505050506,1029.797979797981,32.18118686868691,8
4110,4,0,0,35,0.0,0.0,1.0,35,1050,1000,50,0.9523809523809523,11,10,1,412.49944239256337,0.402766106442577,0.06429209753606568,0.23363037832689426,130030.07888793932,3745.421967060257,133775.50085499958,1267,25,408.85714285714283,31,4,16,34.50160113196307,0.6320564516129032,45.01953124999999,1019.921874999999,32.90070564516126,8
4111,4,1,0,36,0.027777777777777776,0.0,1.0,36,1150,1000,150,0.8695652173913043,13,10,3,398.29076697901024,0.4059358465608465,0.06709729261960717,0.22768720947655233,130391.51178770023,3186.747047495157,133578.2588351954,1268,0,398.47222222222223,32,4,18,34.49566283430173,0.6331380208333333,44.66540404040404,1021.3383838383838,31.916824494949495,0
4112,4,0,0,36,0.0,0.0,1.0,36,750,500,250,0.6666666666666666,10,5,5,395.571418064478,0.4054563492063492,0.06557917284560921,0.22669716111740493,130488.24737271709,3123.4842107948216,133611.73158351192,1269,1,399.47222222222223,32,4,15,34.46665430878234,0.6341145833333333,44.57070707070707,1021.7171717171718,31.92866161616162,0
4113,4,0,0,36,0.0,0.0,1.0,36,1050,800,250,0.7619047619047619,13,8,5,400.4071478249523,0.40534060846560843,0.06428865554869234,0.23004228968367557,130585.01882779812,3257.434987501266,133842.45381529938,1270,2,400.47222222222223,32,4,15,34.24464690137945,0.6350911458333333,44.4760101010101,1022.0959595959591,31.940498737373723,0
4114,4,0,0,36,0.0,0.0,1.0,36,700,600,100,0.8571428571428571,8,6,2,372.1723958231046,0.4058531746031746,0.047164681184713286,0.20669447975359034,129260.23046339175,2421.417931241439,131681.6483946332,1271,3,401.47222222222223,35,1,17,36.3139274603536,0.6148809523809524,45.77546296296297,1016.8981481481491,29.05423280423283,8
4115,4,0,2,34,0.0,0.05555555555555555,0.9444444444444444,36,1250,1000,250,0.8,15,10,5,375.5019821904275,0.40560515873015873,-0.00042481422303342065,0.20486602540177593,128555.01570001696,2458.4040637859885,131013.41976380294,1272,4,402.47222222222223,35,1,15,36.94980217606331,0.6077380952380953,46.4699074074074,1014.1203703703688,28.974867724867682,8
4116,4,3,0,37,0.08108108108108109,0.0,1.0,37,900,600,300,0.6666666666666666,12,6,6,363.77265367822514,0.413475975975976,0.03810436475256407,0.20129050885628336,129115.53603857229,1993.7402351675898,131109.27627373987,1273,0,382.7027027027027,36,1,18,36.67497691597414,0.611400462962963,45.91779279279279,1016.3288288288284,28.231356356356343,0
4117,4,0,0,37,0.0,0.0,1.0,37,600,400,200,0.6666666666666666,8,4,4,383.383836723265,0.41344469469469475,0.017257216021376864,0.20567166047419366,127880.99500868062,2424.3271380544493,130305.32214673507,1274,1,383.7027027027027,35,2,15,37.44099725369037,0.6008928571428571,47.13541666666667,1011.4583333333339,28.89880952380954,8
4118,4,1,1,37,0.02631578947368421,0.02631578947368421,0.9736842105263158,38,1050,900,150,0.8571428571428571,12,9,3,370.6895673469388,0.41660739687055476,0.013383458646616608,0.20046561892989578,128203.1316979596,1904.983951688965,130108.11564964856,1275,0,374.57894736842104,35,3,18,37.43190476190476,0.6041666666666667,46.81712962962963,1012.731481481482,28.9351851851852,0
4119,4,0,1,36,0.0,0.02702702702702703,0.972972972972973,37,1200,1000,200,0.8333333333333334,14,10,4,379.6097735245485,0.41300675675675674,0.006272202133946525,0.20514362983480378,128174.66695011342,2331.2712585034014,130505.93820861682,1276,1,385.64864864864865,34,3,18,37.235235911905306,0.6060049019607843,46.845238095238095,1012.6190476190479,29.782913165266116,0
4120,4,0,0,36,0.0,0.0,1.0,36,800,600,200,0.75,10,6,4,379.3556828417077,0.41210317460317464,0.0211035356503797,0.2051607624878836,128204.80619331072,2527.044359410444,130731.85055272117,1277,2,394.5,34,2,19,37.210777399004755,0.6063112745098039,46.8154761904762,1012.7380952380959,29.786414565826348,0
4121,4,0,0,36,0.0,0.0,1.0,36,950,700,250,0.7368421052631579,12,7,5,378.57923701854446,0.4118716931216931,0.015989112129400906,0.20535932990852995,128325.39859693886,2516.266298185952,130841.6648951248,1278,3,395.5,34,2,20,37.10688129087846,0.6075367647058824,46.69642857142858,1013.2142857142865,29.800420168067248,0
4122,4,0,0,36,0.0,0.0,1.0,36,900,700,200,0.7777777777777778,11,7,4,382.03224124743133,0.41129298941798936,0.018279317363393943,0.20801704389150444,128476.21882086186,2616.411564625872,131092.63038548772,1279,4,396.5,34,2,13,36.86492093314545,0.6090686274509804,46.54761904761906,1013.8095238095253,29.81792717086839,0
4123,4,1,1,36,0.02702702702702703,0.02702702702702703,0.972972972972973,37,1100,700,400,0.6363636363636364,15,7,8,377.63438227001575,0.4138513513513513,0.020899504314527695,0.20771074831691858,128877.9996811773,2333.752759559349,131211.75244073666,1280,0,386.7567567567568,35,2,15,36.5654327672024,0.6110119047619047,46.15162037037038,1015.39351851852,29.01124338624343,0
4124,4,1,1,36,0.02702702702702703,0.02702702702702703,0.972972972972973,37,1100,600,500,0.5454545454545454,16,6,10,374.11773390476105,0.41288163163163166,0.025863183757920627,0.20654122441610032,129024.94454089516,2254.103973765444,131279.0485146606,1281,0,387.5945945945946,35,2,17,36.504613807245384,0.6125,46.00694444444445,1015.9722222222231,29.027777777777803,0
4125,4,1,0,37,0.02702702702702703,0.0,1.0,37,1200,1000,200,0.8333333333333334,14,10,4,346.040785234654,0.41619744744744747,0.06951188192104896,0.18090793827726342,126836.65242522917,1378.1309603522268,128214.7833855814,1282,0,380.27027027027026,36,1,15,39.45570150922302,0.5882523148148149,48.170045045045036,1007.3198198198189,27.981106106106083,8
4126,4,0,0,37,0.0,0.0,1.0,37,800,600,200,0.75,10,6,4,348.74660033980024,0.4156969469469469,0.07176193741522896,0.182576701769467,126893.37722435263,1450.726782525757,128344.10400687839,1283,1,381.27027027027026,36,1,15,39.329291010021976,0.5888310185185186,48.11373873873873,1007.5450450450443,27.98736236236234,0
4127,4,0,1,36,0.0,0.02702702702702703,0.972972972972973,37,900,600,300,0.6666666666666666,12,6,6,411.2620536736964,0.4157282282282282,0.12294206888801518,0.208228471386366,125521.3758680554,2930.573658540278,128451.94952659568,1284,2,382.27027027027026,35,2,14,39.17619542619542,0.5767857142857142,49.47916666666666,1002.0833333333321,28.630952380952348,8
4128,4,1,0,37,0.02702702702702703,0.0,1.0,37,1200,1000,200,0.8333333333333334,14,10,4,410.3795234155584,0.4166666666666667,0.1374991423456693,0.20895117214566528,125753.44676997574,2921.3279106652635,128674.774680641,1285,0,383.1621621621622,35,2,16,38.95732364028001,0.5791666666666666,49.24768518518517,1003.0092592592571,28.657407407407344,0
4129,4,3,2,38,0.075,0.05,0.95,40,950,700,250,0.7368421052631579,12,7,5,397.2326170543831,0.42674946581196577,0.15833333333333344,0.2063046817605023,126567.38281250012,2164.3679269547474,128731.75073945486,1286,0,355.35,35,5,13,38.44461697722568,0.5875,48.43750000000001,1006.2500000000009,28.750000000000025,8
4130,4,0,1,37,0.0,0.02631578947368421,0.9736842105263158,38,750,500,250,0.6666666666666666,10,5,5,413.1017251635931,0.42263809862494073,0.16595635430038524,0.21277852678024267,126228.49384851979,2829.0417147251046,129057.53556324489,1287,1,375.05263157894734,33,5,16,38.396341463414636,0.5883838383838385,48.77450980392157,1004.9019607843137,30.451574569221627,0
4131,4,2,0,39,0.05128205128205128,0.0,1.0,39,1000,600,400,0.6,14,6,8,399.15753380271525,0.4262539361223572,0.1774774856699437,0.20829571736194744,126762.11911848074,2319.6109693877584,129081.73008786849,1288,0,366.02564102564105,34,5,15,38.195019111794146,0.5916053921568627,48.24404761904762,1007.0238095238096,29.61834733893558,0
4132,4,3,3,39,0.07142857142857142,0.07142857142857142,0.9285714285714286,42,1100,800,300,0.7272727272727273,14,8,6,379.0485263137829,0.43368902439024387,0.18990853917324557,0.2025202126305069,127717.31190650119,1282.6404857353393,128999.95239223652,1289,0,340.8095238095238,36,6,17,37.71863859180037,0.5972222222222222,47.297297297297305,1010.8108108108115,28.078078078078097,0
4133,4,2,1,40,0.04878048780487805,0.024390243902439025,0.975609756097561,41,800,600,200,0.75,10,6,4,374.64472857552505,0.4355691056910569,0.16667797981553245,0.20116160172109654,127916.59216226373,1384.6553901874966,129301.24755245123,1290,0,319.4634146341463,36,5,19,37.625468477494536,0.5992476851851851,47.10022522522523,1011.5990990991,28.099974974975,0
4134,4,0,0,40,0.0,0.0,1.0,40,850,400,450,0.47058823529411764,13,4,9,378.4443340882001,0.4355101495726496,0.1646808145521108,0.20331788102427525,127939.53517500432,1683.5984385716774,129623.13361357599,1291,1,321.675,35,5,19,37.50583933951112,0.6014880952380952,47.0775462962963,1011.6898148148151,28.90542328042329,0
4135,4,3,1,42,0.06976744186046512,0.023255813953488372,0.9767441860465116,43,1450,1100,350,0.7586206896551724,18,11,7,356.1559136017393,0.4407991878922111,0.1699681699078761,0.19543184897518073,128783.68975309702,573.5786362120099,129357.26838930903,1292,0,300.16279069767444,37,6,17,37.20686597529796,0.6061373873873874,46.244517543859644,1015.0219298245606,27.43302513039353,0
4136,4,0,0,42,0.0,0.0,1.0,42,1350,1000,350,0.7407407407407407,17,10,7,373.23545076861683,0.43857675183894695,0.16807188817395158,0.20489307875933682,128800.9863748883,1214.6188418147744,130015.60521670309,1293,1,308.3095238095238,36,6,17,36.75578729383921,0.6082175925925926,46.22747747747747,1015.0900900900892,28.196946946946923,0
4137,4,0,2,40,0.0,0.047619047619047616,0.9523809523809523,42,800,600,200,0.75,10,6,4,373.57885070858435,0.43781455671699576,0.17206916036903852,0.20552535063083002,128886.73460200062,1229.871636839543,130116.60623884016,1294,2,309.3095238095238,36,6,17,36.65945806070017,0.6090856481481481,46.14301801801802,1015.4279279279277,28.206331331331327,0
4138,4,0,0,40,0.0,0.0,1.0,40,1100,800,300,0.7272727272727273,14,8,6,395.4104123961293,0.4334001068376068,0.18036971830985937,0.21595491753942453,128596.93877551025,2169.713718820866,130766.65249433112,1295,3,325.575,34,6,17,36.402093114241,0.6102941176470589,46.42857142857143,1014.2857142857147,29.831932773109255,0
4139,4,0,1,39,0.0,0.025,0.975,40,950,600,350,0.631578947368421,13,6,7,395.87974531758533,0.43346688034188036,0.18419277249794686,0.2167041149224009,128687.51594387768,2188.956207483009,130876.47215136068,1296,4,326.575,34,6,17,36.297371817435184,0.6112132352941176,46.33928571428572,1014.6428571428581,29.842436974789944,0
4140,4,1,0,40,0.025,0.0,1.0,40,1000,600,400,0.6,14,6,8,398.5882203229655,0.4321314102564102,0.18416552667578667,0.21907367598202068,128848.62075617272,2271.5084876543096,131120.12924382702,1297,0,327.35,35,5,18,36.06361149110807,0.6107142857142858,46.18055555555555,1015.2777777777768,29.00793650793648,0
4141,4,1,0,41,0.024390243902439025,0.0,1.0,41,800,600,200,0.75,10,6,4,388.0005374899218,0.4330538617886179,0.18632546981207487,0.21516393442622944,129201.38888888896,1827.0061728395108,131028.39506172847,1298,0,320.3414634146341,34,7,20,35.97165300546446,0.616421568627451,45.833333333333336,1016.6666666666673,29.901960784313744,0
4142,4,0,0,41,0.0,0.0,1.0,41,1500,900,600,0.6,21,9,12,385.24746103886986,0.4325965447154472,0.18454827806705,0.21429390020287142,129322.44897959188,1764.2290249433129,131086.67800453518,1299,1,321.3414634146341,34,7,21,35.91799313358301,0.6176470588235294,45.714285714285715,1017.1428571428575,29.91596638655463,0
4143,4,0,0,41,0.0,0.0,1.0,41,1400,1200,200,0.8571428571428571,16,12,4,388.0373448240485,0.431859756097561,0.1788903152189416,0.21684439857814475,129504.14540816324,1850.4889455782297,131354.63435374148,1300,2,322.3414634146341,34,7,17,35.66154970760235,0.6194852941176471,45.535714285714285,1017.8571428571427,29.93697478991596,0
4144,4,0,1,40,0.0,0.024390243902439025,0.975609756097561,41,1400,1200,200,0.8571428571428571,16,12,4,390.1961369352395,0.431885162601626,0.17537020658372993,0.21849493422147054,129584.09857521002,1912.6429344564438,131496.74150966646,1301,3,323.3414634146341,35,6,17,35.525013262096934,0.6181547619047619,45.457175925925924,1018.1712962962961,29.090608465608458,0
4145,4,0,0,40,0.0,0.0,1.0,40,1100,800,300,0.7272727272727273,14,8,6,401.91342777729017,0.43124999999999997,0.179441846873174,0.225466844238342,129655.65653344666,2422.0698696145073,132077.72640306115,1302,4,328.8,34,6,18,35.153662575491914,0.6210171568627452,45.38690476190476,1018.4523809523805,29.954481792717075,0
4146,4,0,1,39,0.0,0.025,0.975,40,950,600,350,0.631578947368421,13,6,7,368.55817765900946,0.43083600427350427,0.035020449897751105,0.2071551136497191,129731.4453125,1866.8907667233564,131598.33607922334,1303,5,329.8,37,3,17,35.92578391274709,0.6157094594594594,45.3125,1018.75,27.533783783783782,8
4147,4,0,1,38,0.0,0.02564102564102564,0.9743589743589743,39,2000,1400,600,0.7,26,14,12,378.7429239899432,0.4275472334682861,0.04900335286098545,0.21295756577607328,129745.7862211875,2028.0596897573366,131773.84591094483,1304,6,339.1025641025641,36,3,17,35.651781437677315,0.6177662037037037,45.29842342342343,1018.8063063063071,28.300175175175198,0
4148,4,3,1,40,0.07317073170731707,0.024390243902439025,0.975609756097561,41,1450,1100,350,0.7586206896551724,18,11,7,362.0360141387387,0.4324695121951219,0.07936649261274709,0.20687137642258963,130374.54433094799,1241.083284588215,131615.6276155362,1305,0,323.0975609756098,37,4,20,35.43858707322311,0.6221846846846847,44.68201754385965,1021.2719298245614,27.601944049312472,0
4149,4,1,2,39,0.024390243902439025,0.04878048780487805,0.9512195121951219,41,950,800,150,0.8421052631578947,11,8,3,353.395271659627,0.43084349593495935,0.10156656100618666,0.2037770807425271,130726.51855504418,1039.6267075754195,131766.1452626196,1306,0,323.6829268292683,38,3,16,35.3026187491294,0.6239035087719298,44.337606837606835,1022.6495726495725,26.911830859199277,0
4150,4,0,0,39,0.0,0.0,1.0,39,750,400,350,0.5333333333333333,11,4,7,369.1140924166865,0.4259165542060279,0.09724424695210687,0.21124504304806074,130435.08193582093,1829.085377607331,132264.16731342825,1307,1,341.2307692307692,36,3,19,35.19641347885201,0.6247106481481481,44.622747747747745,1021.5090090090088,28.375250250250243,0
4151,4,0,1,38,0.0,0.02564102564102564,0.9743589743589743,39,1500,1100,400,0.7333333333333333,19,11,8,372.43755571969183,0.42546671165092215,0.08910414552375312,0.2142032900662977,130626.62459843408,1930.052155470907,132556.676753905,1308,2,342.2307692307692,37,2,18,34.917118059279915,0.6247184684684685,44.435307017543856,1022.2587719298241,27.628615457562812,0
4152,4,1,1,38,0.02564102564102564,0.02564102564102564,0.9743589743589743,39,950,400,550,0.42105263157894735,15,4,11,363.5198155517108,0.4268162393162393,0.09363524436593362,0.2108062852896722,130945.12473518871,1720.2295182263015,132665.35425341502,1309,0,339.0,38,1,19,34.8223295059151,0.6260964912280702,44.12393162393162,1023.5042735042725,26.93432298695454,0
4153,4,0,0,38,0.0,0.0,1.0,38,1450,1300,150,0.896551724137931,16,13,3,363.42884420545863,0.42657954006638216,0.09390201969527023,0.2111596215523561,131019.23338190575,1923.2337113342342,132942.46709323997,1310,1,337.7894736842105,37,1,19,34.74962960979615,0.6286599099099099,44.05153508771929,1023.793859649121,27.670104314841108,0
4154,4,0,1,37,0.0,0.02631578947368421,0.9736842105263158,38,1150,800,350,0.6956521739130435,15,8,7,360.1067346711396,0.42567567567567566,0.09089987382840681,0.21030233304794502,131215.75869498274,1850.3356802092585,133066.09437519198,1311,2,338.7894736842105,37,1,19,34.63586258561643,0.6306306306306306,43.859649122807,1024.5614035087692,27.69084874348025,0
4155,4,1,2,36,0.02631578947368421,0.05263157894736842,0.9473684210526316,38,1150,900,250,0.782608695652174,14,9,5,349.0279545206417,0.42712778568041726,0.08938365066986198,0.1943179778991178,129357.17520004325,1581.4992702871818,130938.67447033043,1312,0,339.42105263157896,33,5,22,36.803673252218616,0.6202651515151515,45.68014705882353,1017.2794117647059,30.82664884135472,8
4156,4,1,0,37,0.02702702702702703,0.0,1.0,37,700,300,400,0.42857142857142855,11,3,8,354.0312515981787,0.4248310810810811,0.11893635138487513,0.19793342235676287,129522.50567544144,1771.0029588817624,131293.5086343232,1313,0,345.86486486486484,32,5,19,36.50820722732158,0.6243489583333333,45.517676767676775,1017.9292929292942,31.810290404040444,0
4157,4,0,0,37,0.0,0.0,1.0,37,1250,900,350,0.72,16,9,7,354.18348054727386,0.424049049049049,0.12096312059114323,0.19850519601207542,129618.91842987972,1781.7759348536038,131400.69436473332,1314,1,346.86486486486484,32,5,19,36.406282289729305,0.6253255208333333,45.42297979797981,1018.3080808080817,31.822127525252554,0
4158,4,0,0,37,0.0,0.0,1.0,37,1200,1100,100,0.9166666666666666,13,11,2,355.1886274641652,0.4239239239239239,0.12306171940523658,0.19979961087530923,129762.65889321415,1818.0441416762778,131580.70303489044,1315,2,347.86486486486484,33,4,19,36.234564188918284,0.6243686868686869,45.28186274509804,1018.8725490196078,30.874925727866906,0
4159,4,1,0,38,0.02631578947368421,0.0,1.0,38,1050,700,350,0.6666666666666666,14,7,7,348.38791895130475,0.42502370791844474,0.1374241717218856,0.1980358913296144,130171.45691609984,1470.0325963718938,131641.48951247174,1316,0,339.6842105263158,34,4,21,35.99291297246853,0.6262254901960784,44.88095238095239,1020.4761904761909,30.01400560224091,0
4160,4,1,1,38,0.02564102564102564,0.02564102564102564,0.9743589743589743,39,1050,700,350,0.6666666666666666,14,7,7,341.72590075285575,0.4282782276203329,0.13728196762454448,0.1957738104313092,130475.34722222232,1117.3929988662187,131592.74022108855,1317,0,331.94871794871796,34,5,22,35.85508428493746,0.6292892156862745,44.583333333333336,1021.6666666666674,30.04901960784316,0
4161,4,1,2,37,0.02564102564102564,0.05128205128205128,0.9487179487179487,39,950,500,450,0.5263157894736842,14,5,9,340.7236271984647,0.42934660368870897,0.13875898152627686,0.19581345804056363,130597.00255102055,1099.496882086185,131696.49943310674,1318,0,332.20512820512823,34,5,16,35.7575801692678,0.6305147058823529,44.46428571428572,1022.1428571428582,30.063025210084067,0
4162,4,0,1,36,0.0,0.02702702702702703,0.972972972972973,37,1250,900,350,0.72,16,9,7,359.3399946246259,0.4259884884884885,0.14183918708099674,0.20523510453783475,130356.43029423786,1968.4557922433733,132324.88608648122,1319,1,347.8378378378378,33,4,22,35.52579603184127,0.6303661616161615,44.69975490196079,1021.2009803921574,30.9454842543078,0
4163,4,0,0,36,0.0,0.0,1.0,36,1250,800,450,0.64,17,8,9,361.61228462165957,0.4238095238095238,0.1533260014663731,0.2068660530076552,130419.01139285388,2232.2233335736432,132651.23472642753,1320,2,357.47222222222223,33,3,22,35.40429414117177,0.6309974747474747,44.63848039215687,1021.446078431374,30.952911467617394,0
4164,4,0,0,36,0.0,0.0,1.0,36,1050,500,550,0.47619047619047616,16,5,11,365.03197971679776,0.4237599206349207,0.1550778803746784,0.2094977067349194,130544.21864487237,2330.562914504065,132874.78155937642,1321,3,358.47222222222223,33,3,18,35.189945836830965,0.632260101010101,44.51593137254903,1021.9362745098056,30.967765894236532,0
4165,4,0,0,36,0.0,0.0,1.0,36,950,800,150,0.8421052631578947,11,8,3,364.63031901333176,0.4232638888888889,0.15320561482014194,0.20994553150643408,130669.4859699396,2329.2112709054445,132998.69724084504,1322,4,359.47222222222223,33,3,19,35.073190099484606,0.6335227272727273,44.39338235294119,1022.4264705882366,30.982620320855656,0
4166,4,0,0,36,0.0,0.0,1.0,36,900,600,300,0.6666666666666666,12,6,6,363.0714447113885,0.4227678571428572,0.15876757330022384,0.20947930030325998,130749.15143140599,2294.2566609977453,133043.40809240373,1323,5,360.47222222222223,34,2,19,35.032301245489464,0.632046568627451,44.3154761904762,1022.738095238096,30.080532212885174,0
4167,4,0,0,36,0.0,0.0,1.0,36,750,200,550,0.26666666666666666,13,2,11,376.09674467116184,0.42240410052910055,0.11308844988902345,0.2136559625997118,130147.65346004815,2589.6217585829368,132737.27521863108,1324,6,361.47222222222223,36,0,19,35.31021226501858,0.6218171296296297,44.904279279279294,1020.382882882885,28.34396896896903,8
4168,4,0,1,35,0.0,0.027777777777777776,0.9722222222222222,36,1250,900,350,0.72,16,9,7,377.64174865923275,0.4224206349206349,0.07844231198393281,0.19978898178772406,127319.21744379523,2416.210382679991,129735.42782647522,1325,7,362.47222222222223,36,0,16,38.163216915867004,0.5931712962962963,47.69144144144145,1009.2342342342349,28.034284284284304,8
4169,4,1,0,36,0.027777777777777776,0.0,1.0,36,750,600,150,0.8,9,6,3,379.9814127621932,0.4251322751322751,0.10215932446821663,0.20273205696361038,127660.40322417034,2501.716074182317,130162.11929835266,1326,0,362.3333333333333,36,0,17,37.75351014040562,0.5966435185185186,47.35360360360362,1010.5855855855874,28.07182182182187,0
4170,4,0,1,35,0.0,0.027777777777777776,0.9722222222222222,36,1200,900,300,0.75,15,9,6,381.08753467356803,0.4248346560846561,0.10259457318280862,0.2036096256684492,127717.3119065011,2534.29510591673,130251.60701241782,1327,1,363.3333333333333,36,0,17,37.66711229946525,0.5972222222222222,47.2972972972973,1010.8108108108108,28.07807807807808,0
4171,4,0,0,35,0.0,0.0,1.0,35,700,500,200,0.7142857142857143,9,5,4,389.2018280369862,0.4221988795518207,0.10933726067746741,0.20743174351421767,127617.73003472202,2933.810763888865,130551.54079861088,1328,2,374.45714285714286,35,0,17,37.564432989690715,0.5982142857142857,47.39583333333332,1010.4166666666649,28.86904761904757,0
4172,4,2,0,37,0.05405405405405406,0.0,1.0,37,1050,900,150,0.8571428571428571,12,9,3,374.84625100246615,0.4336211211211211,0.10813152840882467,0.20213671666207741,128089.02739304397,2202.73834256694,130291.76573561091,1329,0,355.1621621621622,37,0,19,37.44358391103408,0.5990990990990991,46.92982456140351,1012.2807017543856,27.358937885253667,0
4173,4,0,0,37,0.0,0.0,1.0,37,1250,700,550,0.56,18,7,11,365.6844836873435,0.43218218218218213,0.11282387077008149,0.19845771919292615,128344.14439777608,1986.7044586090478,130330.84885638513,1330,1,356.1621621621622,36,1,21,37.41433281469957,0.603587962962963,46.677927927927925,1013.2882882882877,28.14689689689688,0
4174,4,0,1,36,0.0,0.02702702702702703,0.972972972972973,37,1750,1500,250,0.8571428571428571,20,15,5,367.69898041515097,0.43152527527527523,0.11004589495155548,0.2012738647351466,128686.69979100738,2063.5936612288187,130750.2934522362,1331,2,357.1621621621622,36,1,17,37.0130410654828,0.6070601851851851,46.3400900900901,1014.6396396396409,28.18443443443447,0
4175,4,1,0,37,0.02702702702702703,0.0,1.0,37,950,300,650,0.3157894736842105,16,3,13,370.88872339162344,0.42889764764764765,0.11721005531321693,0.20375148332574572,128829.56594685912,2156.286649825513,130985.85259668464,1332,0,358.0810810810811,36,1,19,36.78614346459605,0.6085069444444444,46.19932432432433,1015.2027027027035,28.200075075075098,0
4176,4,0,0,37,0.0,0.0,1.0,37,1600,1400,200,0.875,18,14,4,369.08264192478214,0.4286161161161161,0.1113857455726428,0.2036388081225356,129001.10995708543,2122.414094838078,131123.5240519235,1333,1,359.0810810810811,36,1,21,36.65682851125153,0.6102430555555556,46.0304054054054,1015.8783783783781,28.218843843843835,0
4177,4,0,1,36,0.0,0.02702702702702703,0.972972972972973,37,1550,1000,550,0.6451612903225806,21,10,11,374.4438935831492,0.4280530530530531,0.0368841540621363,0.2077967987192536,129230.01284646144,2277.8778356058915,131507.89068206734,1334,2,360.0810810810811,36,1,18,36.287010373980145,0.6125578703703703,45.80518018018019,1016.7792792792801,28.24386886886889,8
4178,4,0,0,36,0.0,0.0,1.0,36,1050,800,250,0.7619047619047619,13,8,5,426.8441394264513,0.4212797619047619,0.11658640064212844,0.22601747054876015,127354.73632812488,3769.85214997513,131124.58847810002,1335,3,370.94444444444446,31,5,15,36.885104919160646,0.6048387096774194,47.65624999999999,1009.3749999999991,32.560483870967715,8
4179,4,1,0,37,0.02702702702702703,0.0,1.0,37,1100,800,300,0.7272727272727273,14,8,6,414.5034275501609,0.42673923923923923,0.11263906004693003,0.2213542319905962,127697.47865332618,3186.20851826344,130883.68717158961,1336,0,361.8918918918919,32,5,16,36.843118884030794,0.6057942708333333,47.31691919191919,1010.7323232323232,31.5853851010101,0
4180,4,1,0,38,0.02631578947368421,0.0,1.0,38,900,600,300,0.6666666666666666,12,6,6,407.9662653050855,0.4289206970128023,0.11923326835607528,0.2203017832647462,128144.53125000001,2856.5103369554135,131001.04158695543,1337,0,353.3421052631579,32,6,18,36.548353909465014,0.6103515625,46.875,1012.5000000000001,31.640625000000004,0
4181,4,2,2,38,0.05,0.05,0.95,40,1150,900,250,0.782608695652174,14,9,5,390.97358983840894,0.4337339743589744,0.12678885630498593,0.21434404201751994,128747.91843820858,2067.4071712018153,130815.3256094104,1338,0,336.625,34,6,18,36.35997067448682,0.6118259803921569,46.279761904761905,1014.8809523809521,29.849439775910355,0
4182,4,1,1,38,0.02564102564102564,0.02564102564102564,0.9743589743589743,39,1050,600,450,0.5714285714285714,15,6,9,398.58923195407135,0.4318488529014845,0.13607085346215797,0.21827505559389623,128703.50346020768,2459.9661188004698,131163.46957900815,1339,0,345.4102564102564,33,6,19,36.21225845410629,0.6136363636363636,46.32352941176471,1014.7058823529417,30.748663101604294,0
4183,4,0,0,38,0.0,0.0,1.0,38,1250,800,450,0.64,17,8,9,405.5022681655793,0.42985419630156474,0.14110188362893283,0.22197658221925062,128688.43102744634,2836.6901336598503,131525.1211611062,1340,1,354.7894736842105,32,6,19,36.05234776837565,0.6158854166666667,46.33838383838385,1014.6464646464658,31.707702020202056,0
4184,4,1,1,38,0.02564102564102564,0.02564102564102564,0.9743589743589743,39,1350,900,450,0.6666666666666666,18,9,9,387.40964574135506,0.43238304093567254,0.18118977929970215,0.213101803765525,128880.67065860622,2214.7625242322165,131095.43318283843,1341,0,346.6666666666667,32,7,19,36.31455690955815,0.6178385416666667,46.148989898989896,1015.4040404040401,31.731376262626252,7
4185,4,0,0,38,0.0,0.0,1.0,38,1150,900,250,0.782608695652174,14,9,5,395.61047771964087,0.4317360123281176,0.1910678851527381,0.2175578635583751,128870.65463595917,2596.5162489149266,131467.1708848741,1342,1,356.13157894736844,31,7,20,36.11663246986406,0.6202956989247312,46.158854166666664,1015.364583333333,32.75369623655913,0
4186,4,0,0,38,0.0,0.0,1.0,38,1500,1200,300,0.8,18,12,6,396.03697866045854,0.430921052631579,0.16787986609537664,0.20953464993837623,127321.88118828661,2588.7639363606677,129910.64512464729,1343,2,357.13157894736844,31,7,16,37.696345632821576,0.604502688172043,47.68880208333333,1009.2447916666661,32.556283602150515,8
4187,4,3,0,41,0.07317073170731707,0.0,1.0,41,1000,600,400,0.6,14,6,8,369.2270067254783,0.4380081300813008,0.17181673125142471,0.2003412257587534,128336.36435376493,1282.348523520901,129618.71287728584,1344,0,331.9268292682927,32,9,19,37.332554517133964,0.6123046875,46.68560606060606,1013.2575757575759,31.664299242424246,0
4188,4,1,0,42,0.023809523809523808,0.0,1.0,42,1250,900,350,0.72,16,9,7,355.1408672862726,0.43935104529616725,0.1722574087106108,0.1948475569165224,128778.12499999999,746.8749999999997,129524.99999999999,1345,0,325.0,34,8,18,37.23830049261084,0.6121323529411764,46.25,1014.9999999999999,29.852941176470583,0
4189,4,0,2,40,0.0,0.047619047619047616,0.9523809523809523,42,1050,700,350,0.6666666666666666,14,7,7,353.4501956542485,0.4386372435152923,0.17520031268321246,0.19426473159643282,128848.6207561728,708.3140432098653,129556.93479938265,1346,1,326.0,35,7,18,37.20930232558137,0.6107142857142858,46.18055555555555,1015.2777777777774,29.007936507936495,0
4190,4,0,0,40,0.0,0.0,1.0,40,750,400,350,0.5333333333333333,11,4,7,363.19511363754987,0.4355235042735042,0.1735661637682835,0.18715864520562892,126247.30909475748,1170.4811546210726,127417.79024937855,1347,2,342.875,35,5,21,39.63071998925105,0.5842261904761905,48.755787037037045,1004.9768518518528,28.713624338624363,8
4191,4,1,1,40,0.024390243902439025,0.024390243902439025,0.975609756097561,41,1200,1000,200,0.8333333333333334,14,10,4,355.78704564864677,0.43765243902439027,0.17495592946531358,0.18510038498298081,126638.21549590159,811.2473115007213,127449.4628074023,1348,0,335.4878048780488,36,5,18,39.41434511822182,0.5862268518518519,48.36711711711713,1006.5315315315338,27.959209209209273,0
4192,4,2,1,41,0.047619047619047616,0.023809523809523808,0.9761904761904762,42,1200,900,300,0.75,15,9,6,351.982685553088,0.4410932055749129,0.19969721992843437,0.18613582192348865,127302.17013888869,564.0668117441538,127866.23695063284,1349,0,328.3809523809524,34,8,20,38.82810349573356,0.5971200980392157,47.70833333333332,1009.166666666665,29.68137254901956,0
4193,4,1,2,40,0.023809523809523808,0.047619047619047616,0.9523809523809523,42,900,700,200,0.7777777777777778,11,7,4,342.84361383657483,0.43904858691444054,0.2492715857989467,0.17407452421174746,125637.38452717764,231.63526663236917,125869.01979381,1350,0,329.04761904761904,35,7,19,40.7705110444085,0.5779761904761904,49.363425925925924,1002.5462962962963,28.644179894179896,8
4194,4,3,0,43,0.06976744186046512,0.0,1.0,43,1550,1100,450,0.7096774193548387,20,11,9,329.5913484850789,0.44109911406423036,0.2524203118819093,0.17123420291062025,126581.54776398034,-255.306995793954,126326.24076818638,1351,0,303.95348837209303,36,7,16,40.13167711131006,0.5856481481481481,48.42342342342343,1006.3063063063075,27.952952952952987,0
4195,4,0,1,42,0.0,0.023255813953488372,0.9767441860465116,43,1050,700,350,0.6666666666666666,14,7,7,329.5476850122402,0.44086840162421553,0.2505520687296303,0.1718067552008421,126723.2408717841,-247.72986669099873,126475.51100509311,1352,1,304.95348837209303,36,7,18,39.987370913022396,0.5870949074074074,48.282657657657666,1006.8693693693707,27.96859359359363,0
4196,4,1,1,42,0.023255813953488372,0.023255813953488372,0.9767441860465116,43,1450,1200,250,0.8275862068965517,17,12,5,320.3643276069473,0.4449750830564784,0.24447693389520975,0.16831026445818706,127036.73846760545,-460.39213988919147,126576.34632771625,1353,0,296.86046511627904,37,6,19,39.89739685302009,0.5884009009009009,47.97149122807018,1008.1140350877196,27.24632527264107,0
4197,4,2,0,44,0.045454545454545456,0.0,1.0,44,800,500,300,0.625,11,5,6,312.7645422716433,0.4465622797744891,0.24784795506372204,0.16600856886337545,127451.5971861535,-827.5198859264314,126624.07730022707,1354,0,290.79545454545456,37,7,14,39.66488851485866,0.5926238738738738,47.56030701754386,1009.7587719298252,27.290777619725006,0
4198,4,1,1,44,0.022222222222222223,0.022222222222222223,0.9777777777777777,45,1450,1000,450,0.6896551724137931,19,10,9,310.4864615067774,0.4471380471380471,0.26160943828138783,0.1663132064607613,127820.21747616718,-1062.7105933596076,126757.50688280757,1355,0,285.31111111111113,38,7,16,39.3462757527734,0.5945723684210527,47.19551282051283,1011.2179487179501,26.61099865047237,0
4199,4,2,0,46,0.043478260869565216,0.0,1.0,46,1550,1100,450,0.7096774193548387,20,11,9,304.31588613406785,0.44658816425120773,0.2745812158855636,0.1650163607910088,128311.11495844889,-1389.7560423689638,126921.35891607993,1356,0,279.82608695652175,37,9,18,39.00252525252525,0.6013513513513513,46.71052631578948,1013.1578947368432,27.382645803698466,0
4200,4,0,1,45,0.0,0.021739130434782608,0.9782608695652174,46,850,500,350,0.5882352941176471,12,5,7,303.30389639703196,0.44591384863123995,0.2660280826491359,0.1651559379320941,128477.80687326877,-1406.4361149584374,127071.37075831032,1357,1,280.82608695652175,37,9,16,38.85869565217391,0.6030405405405406,46.54605263157895,1013.8157894736848,27.400426742532023,0
4201,4,2,0,47,0.0425531914893617,0.0,1.0,47,1550,1100,450,0.7096774193548387,20,11,9,295.7546583256809,0.4484659266111625,0.261054695895121,0.1626650620791247,128875.73964497056,-1776.8799309664553,127098.8597140041,1358,0,275.6808510638298,38,9,18,38.646227904040394,0.6052631578947368,46.15384615384616,1015.3846153846165,26.72064777327938,0
4202,4,2,0,49,0.04081632653061224,0.0,1.0,49,950,800,150,0.8421052631578947,11,8,3,283.8483339395713,0.45140660430839,0.2601680377280424,0.15814869809399862,129386.78521050361,-2454.344402967814,126932.44080753581,1359,0,265.38775510204084,39,10,20,38.43138886044845,0.6087072649572649,45.65104166666667,1017.3958333333345,26.08707264957268,0
4203,4,0,1,48,0.0,0.02040816326530612,0.9795918367346939,49,1150,600,550,0.5217391304347826,17,6,11,283.8202628610164,0.4516191893424036,0.2558580534137518,0.15866656800216575,129519.29253472244,-2447.9600694444234,127071.33246527801,1360,1,266.38775510204084,39,10,15,38.298198935734746,0.6100427350427351,45.52083333333334,1017.9166666666684,26.100427350427395,0
4204,4,0,0,48,0.0,0.0,1.0,48,1300,1000,300,0.7692307692307693,16,10,6,319.5350794651121,0.45093639184397166,0.26886753994999446,0.1684471745558489,127174.94956380798,-1413.21007425363,125761.73948955435,1361,2,272.8125,37,11,16,39.77685527412399,0.5898085585585586,47.8344298245614,1008.6622807017535,27.261142721669014,8
4205,4,0,1,47,0.0,0.020833333333333332,0.9791666666666666,48,1800,1300,500,0.7222222222222222,23,13,10,319.1590829979444,0.4507147606382979,0.26622482978415185,0.168824149420292,127313.2358033241,-1473.3648815020028,125839.8709218221,1362,3,273.8125,37,11,16,39.64490076778211,0.5912162162162162,47.69736842105263,1009.2105263157895,27.27596017069701,0
4206,4,3,0,50,0.06,0.0,1.0,50,1600,1200,400,0.75,20,12,8,306.60305720257253,0.4511819727891156,0.2807832898172322,0.16503531046611986,128015.94309769316,-2149.9840951153437,125865.95900257782,1363,0,263.72,40,10,17,39.245037490794665,0.5932291666666667,47.0020325203252,1011.9918699186991,25.299796747967477,0
4207,4,2,1,51,0.038461538461538464,0.019230769230769232,0.9807692307692307,52,1500,1100,400,0.7333333333333333,19,11,8,300.821084322207,0.4539105706385118,0.2919491493540207,0.16419081393624763,128571.78411005587,-2664.5147491095872,125907.26936094629,1364,0,254.53846153846155,41,11,16,38.82615589031267,0.5973069105691057,46.453373015873005,1014.1865079365065,24.736256291134303,0
4208,4,0,2,49,0.0,0.0392156862745098,0.9607843137254902,51,2450,1900,550,0.7755102040816326,30,19,11,311.7795993693183,0.45160130718954244,0.3034214988731241,0.17010654030106184,128556.44710696315,-2183.744484929633,126372.70262203352,1365,1,260.52941176470586,40,11,16,38.56390085846945,0.5986979166666666,46.468495934959336,1014.1260162601602,25.353150406504007,0
4209,4,0,0,49,0.0,0.0,1.0,49,1300,900,400,0.6923076923076923,17,9,8,325.3701667003182,0.4486784297052154,0.30563203358915314,0.1770133108745765,128442.17985243603,-1441.749306012145,127000.43054642389,1366,2,271.83673469387753,38,11,17,38.33570474985948,0.6008771929824561,46.58119658119657,1013.6752136752118,26.675663517768733,0
4210,4,2,0,51,0.0392156862745098,0.0,1.0,51,1500,1200,300,0.8,18,12,6,317.58642186528954,0.4506045751633987,0.3191501045307106,0.17542701910547837,129046.45568940416,-2003.3195766409215,127043.13611276324,1367,0,262.1372549019608,40,11,19,37.91862539174501,0.6036458333333333,45.98577235772356,1016.0569105691033,25.401422764227583,0
4211,4,1,0,52,0.019230769230769232,0.0,1.0,52,1550,900,650,0.5806451612903226,22,9,13,315.8541454283807,0.4510903720462544,0.32717275234502896,0.17619206452224923,129433.96297053662,-2223.456296681875,127210.50667385475,1368,0,258.0769230769231,40,12,18,37.56949299244316,0.6075520833333333,45.604674796747965,1017.5813008130074,25.439532520325184,0
4212,4,0,0,52,0.0,0.0,1.0,52,1450,1100,350,0.7586206896551724,18,11,7,319.98980987587123,0.4511375062845651,0.3243274894218291,0.17896917507127885,129537.39636005365,-2109.870633386203,127427.52572666745,1369,1,259.0769230769231,40,12,18,37.35940567701574,0.60859375,45.50304878048781,1017.9878048780497,25.449695121951244,0
4213,4,0,2,50,0.0,0.038461538461538464,0.9615384615384616,52,1600,1000,600,0.625,22,10,12,327.21588823707077,0.45079971091000504,0.32812886169424016,0.18415530893605214,129781.98346757678,-1906.654600497609,127875.32886707917,1370,2,260.0769230769231,41,11,19,36.92749407717524,0.6095020325203252,45.26289682539682,1018.9484126984121,24.852400309717368,0
4214,4,0,0,50,0.0,0.0,1.0,50,1300,700,600,0.5384615384615384,19,7,12,346.76088568972,0.44742346938775507,0.34690529760687205,0.19463995064719214,129678.39084201408,-1006.5212673610922,128671.86957465298,1371,3,271.0,39,11,19,36.534823072202904,0.6116452991452992,45.36458333333334,1018.5416666666682,26.11645299145303,0
4215,4,1,0,51,0.0196078431372549,0.0,1.0,51,1300,1000,300,0.7692307692307693,16,10,6,366.6417289492548,0.44849673202614376,0.35265607665466336,0.1998734433921528,128523.41666894965,-586.7558249894857,127936.66084396017,1372,0,266.6666666666667,38,13,16,37.20673971832964,0.6016995614035088,46.50106837606838,1013.9957264957276,26.68409806567704,8
4216,4,1,1,51,0.019230769230769232,0.019230769230769232,0.9807692307692307,52,1650,1100,550,0.6666666666666666,22,11,11,362.9245244849229,0.4492992709904475,0.36253283686880233,0.20004957819403546,128963.21750217034,-1039.2171223958148,127924.00037977453,1373,0,262.5192307692308,39,13,18,36.85188271288416,0.6044337606837606,46.06770833333334,1015.7291666666683,26.04433760683765,0
4217,4,0,0,51,0.0,0.0,1.0,51,1350,800,550,0.5925925925925926,19,8,11,364.3079999999999,0.4479901960784314,0.36249411764705863,0.2014977876106195,129098.08976138548,-793.7066230418363,128304.38313834363,1374,1,268.2156862745098,40,11,18,36.67916666666665,0.6041666666666667,45.9349593495935,1016.2601626016265,25.40650406504066,0
4218,4,0,0,51,0.0,0.0,1.0,51,1750,1200,550,0.6857142857142857,23,12,11,361.5637225652613,0.44771241830065356,0.36670482464067966,0.20095258887925044,129289.65627411264,-850.5035607261339,128439.1527133865,1375,2,269.2156862745098,35,16,19,36.55364458859679,0.6151785714285714,45.74652777777778,1017.0138888888888,29.05753968253968,0
4219,4,0,1,50,0.0,0.0196078431372549,0.9803921568627451,51,1000,500,500,0.5,15,5,10,356.58188651130524,0.4475,0.3598243192806114,0.19889345225408392,129430.46932067223,-969.4878155181974,128460.98150515404,1376,3,270.2156862745098,36,15,17,36.536954035709016,0.6145833333333333,45.60810810810812,1017.5675675675693,28.265765765765813,0
4220,4,0,0,50,0.0,0.0,1.0,50,1350,900,450,0.6666666666666666,18,9,9,355.1876390608829,0.4466156462585034,0.3594777605664967,0.19840456624426855,129487.77113261937,-801.5088568297724,128686.2622757896,1377,4,275.98,36,14,18,36.514116323670414,0.615162037037037,45.551801801801815,1017.7927927927949,28.27202202202208,0
4221,4,0,1,49,0.0,0.02,0.98,50,800,400,400,0.5,12,4,8,357.17723372556725,0.44650510204081634,0.3615119534783542,0.20004510207331852,129591.85157933229,-742.5481879039528,128849.30339142833,1378,5,276.98,37,13,18,36.357599253356305,0.6143018018018018,45.44956140350878,1018.2017543859663,27.518966334755845,0
4222,4,2,0,51,0.0392156862745098,0.0,1.0,51,1150,800,350,0.6956521739130435,15,8,7,345.09829838318956,0.448921568627451,0.35039433929397323,0.19568891928584706,130076.563856337,-1222.1598307291488,128854.40402560786,1373,0,245.49019607843138,39,12,20,36.17305303107663,0.6156517094017093,44.97395833333334,1020.1041666666682,26.156517094017133,0
4223,4,3,1,53,0.05555555555555555,0.018518518518518517,0.9814814814814815,54,2000,1700,300,0.85,23,17,6,325.27087576800574,0.45028243652457484,0.3575164696924551,0.18833539092053247,130885.78976014645,-2285.0670658121003,128600.72269433436,1374,0,232.7962962962963,40,14,19,35.860893170457196,0.6221354166666666,44.18191056910571,1023.2723577235802,25.581808943089506,0
4224,4,2,0,55,0.03636363636363636,0.0,1.0,55,1950,1500,450,0.7692307692307693,24,15,9,315.7062780032901,0.4506593714927048,0.35328143554558644,0.18528247490993796,131404.40095308976,-2702.2149454107725,128702.18600767899,1375,0,228.65454545454546,41,14,21,35.583272859216265,0.6257621951219512,43.67559523809525,1025.2976190476206,25.00725900116148,0
4225,4,0,1,54,0.0,0.01818181818181818,0.9818181818181818,55,2050,1400,650,0.6829268292682927,27,14,13,319.54027288814746,0.4499298540965208,0.358733954633375,0.1881575410970071,131531.57675107082,-2594.072814310903,128937.50393675992,1376,1,229.65454545454546,41,14,21,35.357027724049004,0.6270325203252032,43.551587301587304,1025.7936507936508,25.01935733643051,0
4226,4,1,1,54,0.01818181818181818,0.01818181818181818,0.9818181818181818,55,1250,900,350,0.72,16,9,7,317.3340461637376,0.4495510662177329,0.3612186808166702,0.18785885066947122,131735.18597253718,-2639.188082640465,129095.99788989671,1377,0,230.3090909090909,41,14,19,35.20889704934928,0.6290650406504066,43.3531746031746,1026.5873015873017,25.038714672861015,0
4227,4,0,0,54,0.0,0.0,1.0,54,1650,1100,550,0.6666666666666666,22,11,11,323.8316957776576,0.4486009201024925,0.363417443391693,0.19110044607054405,131614.7395420219,-2275.795140954462,129338.94440106745,1378,1,235.53703703703704,40,14,19,35.1632910765574,0.6294270833333333,43.47052845528455,1026.1178861788617,25.65294715447154,0
4228,4,0,1,53,0.0,0.018518518518518517,0.9814814814814815,54,2250,1800,450,0.8,27,18,9,319.28846985134857,0.44846261355695316,0.21711384830834812,0.17498211118540952,128733.87008180108,-2481.8751170526493,126251.99496474843,1379,2,236.53703703703704,42,12,14,38.19305197491965,0.5974702380952381,46.293604651162795,1014.8255813953498,24.162513842746424,8
4229,4,1,2,52,0.018518518518518517,0.037037037037037035,0.962962962962963,54,1100,600,500,0.5454545454545454,16,6,10,308.94725361801295,0.4486737130211973,0.2085945789524455,0.15879306783628808,126141.1585560509,-2738.871800072147,123402.28675597876,1380,0,237.42592592592592,42,12,16,41.10257708755345,0.5711805555555556,48.86143410852711,1004.554263565888,23.91795865633067,8
4230,4,2,6,48,0.037037037037037035,0.1111111111111111,0.8888888888888888,54,1400,900,500,0.6428571428571429,19,9,10,313.6561690559895,0.4481641625902632,0.24373738022360625,0.16265626109586792,126506.44961991436,-2864.094330268642,123642.35528964573,1381,0,237.4814814814815,42,12,16,40.60954857766646,0.5749007936507937,48.49806201550386,1006.0077519379821,23.952565522332907,0
4231,4,2,0,50,0.04,0.0,1.0,50,1600,1000,600,0.625,22,10,12,336.706831440831,0.4479336734693877,0.2807867494824017,0.1748703221353992,126567.38281249985,-1476.7795138889041,125090.60329861095,1382,0,255.08,39,11,18,39.96721877156659,0.5801282051282051,48.43749999999999,1006.2499999999989,25.801282051282023,0
4232,4,4,2,52,0.07407407407407407,0.037037037037037035,0.962962962962963,54,1450,1200,250,0.8275862068965517,17,12,5,316.954685557623,0.45218233170277194,0.301755189766856,0.1689801843699436,127630.5659350421,-2706.1236129701115,124924.44232207199,1383,0,237.11111111111111,40,14,19,39.376320024137584,0.5893229166666667,47.38313008130082,1010.4674796747978,25.261686991869944,0
4233,4,0,1,51,0.0,0.019230769230769232,0.9807692307692307,52,1200,700,500,0.5833333333333334,17,7,10,327.4684477917374,0.45018696581196577,0.29292458444082925,0.17396200555292585,127486.1992730036,-2050.4584418402683,125435.74083116333,1384,1,246.8653846153846,39,13,20,39.25831614234141,0.5894764957264957,47.52604166666667,1009.8958333333344,25.894764957264986,0
4234,4,1,3,49,0.019230769230769232,0.057692307692307696,0.9423076923076923,52,1750,1300,450,0.7428571428571429,22,13,9,342.7772645639395,0.4515617144293615,0.2370914169245868,0.17730458507139782,126401.93527094852,-1661.4871583083514,124740.44811264018,1385,0,236.42307692307693,37,15,17,39.98462090648057,0.5819256756756757,48.60197368421051,1005.5921052631561,27.178165007112327,8
4235,4,1,1,49,0.02,0.02,0.98,50,1300,1000,300,0.7692307692307693,16,10,6,355.24451077319975,0.4490986394557823,0.2704948216340628,0.18397346833248532,126450.94548396772,-1015.7991469478741,125435.14633701985,1386,0,246.72,35,15,19,39.62073264288456,0.5863095238095238,48.55324074074074,1005.7870370370366,28.736772486772473,0
4236,4,1,1,49,0.02,0.02,0.98,50,1400,600,800,0.42857142857142855,22,6,16,333.5833996266829,0.45164115646258507,0.22715440238196538,0.17160931565040077,126177.97592957856,-1578.5825538652152,124599.39337571335,1387,0,240.34,38,12,19,40.44599815681273,0.5778508771929824,48.82478632478633,1004.7008547008552,26.439496176338295,7
4237,4,0,1,48,0.0,0.02040816326530612,0.9795918367346939,49,1800,1400,400,0.7777777777777778,22,14,8,334.4715970301396,0.4510522959183674,0.2358965905418391,0.1726299098440254,126312.18639281533,-1350.4322585652803,124961.75413425005,1388,1,246.16326530612244,38,11,14,40.28567506288305,0.5792214912280702,48.69123931623931,1005.2350427350423,26.453553756185322,0
4238,4,2,0,50,0.04,0.0,1.0,50,1400,1000,400,0.7142857142857143,18,10,8,318.315642441283,0.4543792517006802,0.24793868495361027,0.1668296992837084,126938.35101460773,-1918.707449269611,125019.64356533812,1389,0,241.34,40,10,16,40.0497512437811,0.5822916666666667,48.06910569105691,1007.7235772357725,25.19308943089431,0
4239,4,0,3,47,0.0,0.06,0.94,50,1350,800,550,0.5925925925925926,19,8,11,332.44708219016417,0.4543962585034014,0.25181920395772384,0.1678084193529698,125394.4548433572,-1476.1601575518876,123918.29468580532,1390,1,242.34,36,14,16,41.28157559403341,0.5734953703703703,49.60585585585587,1001.5765765765793,27.82157157157165,8
4240,4,3,0,50,0.06,0.0,1.0,50,1500,1100,400,0.7333333333333333,19,11,8,327.8909019449022,0.4545408163265306,0.27895072895604955,0.16791230548099442,125990.2011309263,-1737.7918629921833,124252.40926793413,1391,0,241.98,38,12,19,40.782075839807035,0.5759320175438596,49.011752136752136,1003.9529914529916,26.419815564552408,0
4241,4,1,1,50,0.0196078431372549,0.0196078431372549,0.9803921568627451,51,1750,1400,350,0.8,21,14,7,319.6815827124077,0.45573529411764707,0.27051937581663754,0.16513579897972194,126346.8101362919,-2121.8275244447595,124224.98261184714,1392,0,238.2156862745098,37,14,13,40.62181899152945,0.5813626126126126,48.656798245614034,1005.3728070175436,27.172238027501177,0
4242,4,0,0,50,0.0,0.0,1.0,50,1700,1100,600,0.6470588235294118,23,11,12,328.6192760059822,0.4542687074829932,0.2690073941295097,0.1695523501519885,126298.39932838257,-1699.182290398488,124599.21703798408,1393,2,243.98,36,14,15,40.44691537829562,0.5827546296296297,48.704954954954964,1005.1801801801812,27.9216716716717,0
4243,4,2,2,50,0.038461538461538464,0.038461538461538464,0.9615384615384616,52,1400,1000,400,0.7142857142857143,18,10,8,347.74619747704696,0.4568878833584716,0.29081557588092566,0.179716609799917,126365.89055309002,-1480.1572564988664,124885.73329659116,1394,0,235.55769230769232,38,14,17,39.89679630219956,0.5797697368421053,48.63782051282051,1005.4487179487174,26.459176788124143,8
4244,4,2,1,51,0.038461538461538464,0.019230769230769232,0.9807692307692307,52,1550,1100,450,0.7096774193548387,20,11,9,344.73929520012285,0.45765774258421316,0.32218163435038605,0.18088267580188852,126984.30879720926,-1644.7037767550755,125339.60502045418,1395,0,236.1346153846154,38,14,20,39.336884319129396,0.5860745614035088,48.023504273504265,1007.9059829059815,26.52384165542057,0
4245,4,1,0,52,0.019230769230769232,0.0,1.0,52,950,600,350,0.631578947368421,13,6,7,336.7801414665094,0.45808980643539465,0.33371637537826326,0.1780707127620677,127296.33012099199,-1825.6878154461456,125470.64230554584,1396,0,236.8846153846154,35,17,21,39.21763294720342,0.5949404761904762,47.714120370370374,1009.1435185185189,28.83267195767197,0
4246,4,1,1,52,0.018867924528301886,0.018867924528301886,0.9811320754716981,53,1700,1200,500,0.7058823529411765,22,12,10,328.84628238929133,0.4587868892114175,0.3387694978009481,0.1760710059375941,127802.6987079988,-2194.511530111164,125608.18717788764,1397,0,233.39622641509433,36,17,18,38.90002598656122,0.5980902777777778,47.21283783783785,1011.1486486486508,28.087462462462522,0
4247,4,1,0,53,0.018867924528301886,0.0,1.0,53,1150,800,350,0.6956521739130435,15,8,7,326.62286557824905,0.45733551040154813,0.33842409367489856,0.17528190430246365,127894.85857427298,-2245.322959949205,125649.53561432377,1398,0,234.33962264150944,37,16,19,38.86212737127371,0.5971283783783784,47.121710526315795,1011.5131578947378,27.338193456614533,0
4248,4,1,0,54,0.018518518518518517,0.0,1.0,54,1450,900,550,0.6206896551724138,20,9,11,323.2301422050344,0.45832605404146287,0.34914313001453157,0.1752924405918444,128315.61872260796,-2504.417933962518,125811.20078864545,1399,0,230.9814814814815,36,18,20,38.51885813789784,0.6032986111111112,46.706081081081095,1013.1756756756774,28.14376876876882,0
4249,4,1,0,55,0.01818181818181818,0.0,1.0,55,1950,1600,350,0.8205128205128205,23,16,7,317.06150473773806,0.45840347923681257,0.3570722892749465,0.17397974803540278,128783.68975309728,-2833.52990824098,125950.1598448563,1400,0,227.76363636363635,37,18,12,38.1989080335602,0.6061373873873874,46.24451754385966,1015.0219298245628,27.433025130393588,0
4250,4,0,1,54,0.0,0.01818181818181818,0.9818181818181818,55,1000,800,200,0.8,12,8,4,307.74520355216106,0.4585016835016835,0.3010789400492955,0.1664071183383305,128198.6234955986,-3101.05460076259,125097.568894836,1401,1,228.76363636363635,38,17,19,39.03013679361394,0.5984100877192983,46.82158119658119,1012.7136752136747,26.65035987404407,8
4251,4,3,4,53,0.05263157894736842,0.07017543859649122,0.9298245614035088,57,1600,1100,500,0.6875,21,11,10,290.7850642151446,0.45959951963241436,0.3043827925791407,0.15951860546837213,128773.09032698712,-3910.9417320168986,124862.14859497022,1402,0,221.57894736842104,41,16,10,38.876433551624146,0.599339430894309,46.25496031746031,1014.9801587301574,24.755613627564816,0
4252,4,1,3,51,0.018518518518518517,0.05555555555555555,0.9444444444444444,54,1350,1100,250,0.8148148148148148,16,11,5,310.2316319550923,0.45679012345679015,0.31407696301761834,0.16866289354486902,128415.10662073578,-2832.31438107238,125582.7922396634,1403,0,234.7962962962963,38,16,12,38.74688169776186,0.6006030701754386,46.60790598290599,1013.5683760683773,26.672852001799402,0
4253,4,1,1,51,0.019230769230769232,0.019230769230769232,0.9807692307692307,52,1700,1300,400,0.7647058823529411,21,13,8,315.2065509420937,0.4553088863750629,0.3331226295828067,0.17195060813461796,128550.50131492442,-2296.007971729122,126254.4933431953,1404,0,243.94230769230768,38,14,13,38.48306468605142,0.6019736842105263,46.47435897435898,1014.1025641025643,26.68690958164643,0
4254,4,1,0,52,0.019230769230769232,0.0,1.0,52,1400,900,500,0.6428571428571429,19,9,10,314.05820449349517,0.4563458396178985,0.3321225521162354,0.17202565318795954,128713.0691157134,-2315.320923734376,126397.74819197903,1405,0,243.84615384615384,38,14,14,38.346888818698694,0.6036184210526316,46.31410256410257,1014.7435897435902,26.7037786774629,0
4255,4,0,1,51,0.0,0.019230769230769232,0.9807692307692307,52,1800,1300,500,0.7222222222222222,23,13,10,314.81103076397517,0.4558195072900955,0.33685907300865714,0.17306616564334298,128857.43408203151,-2286.851671006918,126570.58241102459,1406,1,244.84615384615384,39,13,15,38.18108563318628,0.6033653846153846,46.171875000000014,1015.312500000002,26.0336538461539,0
4256,4,1,2,50,0.019230769230769232,0.038461538461538464,0.9615384615384616,52,1400,800,600,0.5714285714285714,20,8,12,313.87799999999993,0.4551989064856712,0.3439269230769233,0.17360508849557527,129098.08976138543,-2295.7899563751666,126802.29980501026,1407,0,245.42307692307693,40,12,17,37.96041666666668,0.6041666666666667,45.9349593495935,1016.2601626016261,25.406504065040654,0
4257,4,2,1,51,0.038461538461538464,0.019230769230769232,0.9807692307692307,52,1400,800,600,0.5714285714285714,20,8,12,318.2593376136859,0.4558037958773253,0.35743705766330214,0.17774266977919523,129480.23069598296,-2158.2175747596984,127322.01312122327,1408,0,245.21153846153845,37,15,13,37.46139481433599,0.6131756756756757,45.559210526315766,1017.7631578947335,27.507112375533335,0
4258,4,0,2,49,0.0,0.0392156862745098,0.9607843137254902,51,1300,700,600,0.5384615384615384,19,7,12,330.5769529565718,0.45395424836601306,0.36321267469032525,0.18452278714444337,129459.11864144546,-1640.7598054135321,127818.35883603193,1409,1,251.01960784313727,36,15,13,37.16941462874846,0.6148726851851851,45.57995495495495,1017.6801801801798,28.268893893893885,0
4259,4,0,0,49,0.0,0.0,1.0,49,1500,900,600,0.6,21,9,12,351.87178868609294,0.4536210317460318,0.3724586608837077,0.19117158003873336,128388.03624260383,-759.8032208803677,127628.23302172347,1410,2,239.73469387755102,38,11,14,37.71940227703987,0.600328947368421,46.6346153846154,1013.4615384615408,26.67004048583002,8
4260,4,1,2,48,0.02,0.04,0.96,50,1200,700,500,0.5833333333333334,17,7,10,341.5246399788603,0.4543962585034014,0.36266009852216663,0.1873770322046187,128778.12500000058,-1203.8194444443852,127574.3055555562,1411,0,235.92,39,11,15,37.58381226053639,0.6025641025641026,46.25000000000003,1015.0000000000047,26.025641025641146,0
4261,4,0,1,47,0.0,0.020833333333333332,0.9791666666666666,48,1100,800,300,0.7272727272727273,14,8,6,355.5107271636733,0.45221077127659576,0.3714252892204566,0.19398930475143467,128561.193408068,-459.02332929361086,128102.17007877438,1412,1,246.20833333333334,37,11,16,37.45033246837496,0.6038851351351351,46.46381578947369,1014.1447368421063,27.40931721194882,0
4262,4,3,0,50,0.06,0.0,1.0,50,1300,800,500,0.6153846153846154,18,8,10,348.3810796180755,0.4534608843537415,0.38554710356933897,0.19393591696002951,129352.7228599772,-979.2415891506727,128373.48127082654,1413,0,236.54,34,16,20,36.82465379364151,0.617953431372549,45.6845238095238,1017.2619047619038,29.91946778711482,0
4263,4,0,0,50,0.0,0.0,1.0,50,1750,1300,450,0.7428571428571429,22,13,9,351.5050837581096,0.45303571428571426,0.3871961632939527,0.1962780510155503,129473.85381235812,-897.8564342403783,128575.99737811774,1414,1,237.54,34,16,15,36.62197333021407,0.6191789215686274,45.56547619047618,1017.7380952380939,29.933473389355704,0
4264,4,0,0,50,0.0,0.0,1.0,50,1900,1500,400,0.7894736842105263,23,15,8,351.7109868271226,0.45291666666666663,0.38599227097067557,0.1970925644652882,129613.56122470848,-882.6972950960214,128730.86392961246,1415,2,238.54,35,15,15,36.474672274001676,0.618452380952381,45.42824074074074,1018.2870370370368,29.093915343915338,0
4265,4,1,0,51,0.0196078431372549,0.0,1.0,51,1200,800,400,0.6666666666666666,16,8,8,344.8206357425864,0.4534640522875817,0.3806723863057382,0.19496256798147166,129962.83512309138,-1237.2265139893511,128725.60860910203,1416,0,234.84313725490196,38,13,17,36.29549105895502,0.6162280701754386,45.08547008547008,1019.6581196581185,26.83310841205575,0
4266,4,1,2,50,0.019230769230769232,0.038461538461538464,0.9615384615384616,52,900,700,200,0.7777777777777778,11,7,4,336.4020692146024,0.4534627953745601,0.37794635040716207,0.19222385721869958,130374.54433094789,-1627.656139240449,128746.88819170743,1417,0,231.30769230769232,37,15,19,36.09306778326533,0.6221846846846847,44.682017543859644,1021.2719298245606,27.60194404931245,0
4267,4,0,2,48,0.0,0.04,0.96,50,1250,800,450,0.64,17,8,9,348.4347356211448,0.4523469387755102,0.38734972978934645,0.1988205001810518,130320.07250070991,-918.3919984173649,129401.68050229254,1418,1,239.72,36,14,19,35.8410536377339,0.6235532407407407,44.735360360360346,1021.0585585585565,28.362737737737678,0
4268,4,1,0,49,0.02040816326530612,0.0,1.0,49,1300,900,400,0.6923076923076923,17,9,8,348.4030171004083,0.45103458049886624,0.3862435574456289,0.2000259194406111,130558.13426997565,-702.6304226680763,129855.50384730757,1419,0,243.18367346938774,35,14,17,35.600698376745946,0.6279761904761905,44.502314814814795,1021.9907407407379,29.199735449735368,0
4269,4,0,1,48,0.0,0.02040816326530612,0.9795918367346939,49,2000,1600,400,0.8,24,16,8,347.8907542733843,0.45108772675736963,0.3832779659294103,0.20034334571389004,130676.44702717743,-707.7744555898721,129968.67257158757,1420,1,244.18367346938774,35,14,17,35.49401931929666,0.6291666666666667,44.38657407407406,1022.4537037037021,29.212962962962916,0
4270,4,0,0,48,0.0,0.0,1.0,48,1300,700,600,0.5384615384615384,19,7,12,353.6181159833731,0.4510010342789598,0.38588728458313937,0.20354372520544287,130657.8514739229,-359.40334467120124,130298.4481292517,1421,2,249.4375,34,14,17,35.366451249805934,0.6311274509803921,44.404761904761905,1022.3809523809523,30.070028011204478,0
4271,4,0,1,47,0.0,0.020833333333333332,0.9791666666666666,48,1600,1100,500,0.6875,21,11,10,348.1995892351979,0.4508625147754137,0.3787310970320925,0.20129078935578248,130824.41332572442,-489.39860360940173,130335.01472211503,1422,3,250.4375,35,13,18,35.33641154730926,0.6306547619047619,44.241898148148145,1023.0324074074072,29.229497354497347,0
4272,4,0,1,46,0.0,0.02127659574468085,0.9787234042553191,47,1750,1300,450,0.7428571428571429,22,13,9,354.27592566156454,0.45012334258402714,0.38035907505119204,0.20472717076057995,130810.03578514747,-131.4306972788985,130678.60508786856,1423,4,255.29787234042553,34,13,18,35.19555646068507,0.6326593137254901,44.25595238095239,1022.976190476191,30.08753501400562,0
4273,4,0,0,46,0.0,0.0,1.0,46,1450,900,550,0.6206896551724138,20,9,11,336.04241342396335,0.4475744766505636,0.28895123003884327,0.1858258405497191,129089.936326562,-524.0612496152708,128565.87507694673,1424,5,261.69565217391306,37,9,17,37.405589123867074,0.6092342342342343,45.94298245614035,1016.2280701754385,27.465623518255093,8
4274,4,1,0,47,0.02127659574468085,0.0,1.0,47,1400,1000,400,0.7142857142857143,18,10,8,331.3786202226398,0.44736740672217085,0.28245328710447093,0.1847804437353875,129418.71667031907,-822.6808477609932,128596.03582255809,1425,0,257.1063829787234,38,9,18,37.19003744925102,0.6107456140350878,45.61965811965811,1017.5213675213662,26.77687809266753,0
4275,4,1,1,47,0.020833333333333332,0.020833333333333332,0.9791666666666666,48,1850,1500,350,0.8108108108108109,22,15,7,325.46711351757875,0.4487662529550827,0.27494761320658334,0.18330712559254295,129811.0473632811,-1150.1546223958503,128660.89274088526,1426,0,252.72916666666666,39,9,17,36.94259174077482,0.6129807692307692,45.23437499999999,1019.0624999999989,26.12980769230766,0
4276,4,0,0,47,0.0,0.0,1.0,47,1450,1000,450,0.6896551724137931,19,10,9,336.5352411765797,0.447540857230959,0.28360169784512856,0.18961663706930862,129826.69850107757,-661.7481417561479,129164.95035932142,1427,1,259.0851063829787,38,9,17,36.644739141070005,0.6148574561403508,45.2190170940171,1019.1239316239321,26.819050832208738,0
4277,4,0,0,47,0.0,0.0,1.0,47,1700,1200,500,0.7058823529411765,22,12,10,335.70141511058046,0.4471554116558742,0.27939930019777015,0.18997207248165243,129996.88042534741,-671.9726562499795,129324.90776909742,1428,2,260.0851063829787,39,8,20,36.49344569288389,0.6148504273504274,45.05208333333334,1019.7916666666681,26.14850427350431,0
4278,4,0,1,46,0.0,0.02127659574468085,0.9787234042553191,47,1300,1200,100,0.9230769230769231,14,12,2,336.0891812504964,0.4465194264569843,0.275542017637435,0.19058027515843162,130076.56385633699,-656.5348307291489,129420.02902560784,1429,3,261.0851063829787,39,8,21,36.40280897920284,0.6156517094017093,44.97395833333334,1020.1041666666681,26.15651709401713,0
4279,4,1,1,46,0.02127659574468085,0.02127659574468085,0.9787234042553191,47,1100,700,400,0.6363636363636364,15,7,8,335.3083999540157,0.44657724329324694,0.28287936410045567,0.19173712373061155,130402.5412266276,-654.7206682584825,129747.82055836912,1430,0,255.70212765957447,37,10,22,36.09265968867418,0.6224662162162162,44.654605263157904,1021.3815789473699,27.604907539118106,0
4280,4,1,0,47,0.02127659574468085,0.0,1.0,47,1150,800,350,0.6956521739130435,15,8,7,335.05806534348216,0.44777212457600984,0.2801791232819175,0.1925654306493186,130598.60365689477,-648.3769044320993,129950.22675246268,1431,0,254.82978723404256,37,10,20,35.90073660873918,0.6244369369369369,44.46271929824563,1022.1491228070204,27.625651967757307,0
4281,4,0,0,47,0.0,0.0,1.0,47,1250,800,450,0.64,17,8,9,337.32686662433383,0.44769503546099293,0.2753318336747872,0.19443203696777134,130710.70545744867,-581.5534587565123,130129.15199869216,1432,1,255.82978723404256,37,10,20,35.729412395453586,0.6255630630630631,44.35307017543861,1022.5877192982474,27.63750592697966,0
4282,4,0,2,45,0.0,0.0425531914893617,0.9574468085106383,47,1250,700,550,0.56,18,7,11,335.7961426956896,0.44775285229725564,0.27230027670752244,0.19369020549923927,130738.73842191842,-619.6871874038014,130119.05123451461,1433,2,256.82978723404256,37,10,20,35.74021210821629,0.6258445945945945,44.32565789473685,1022.6973684210537,27.640469416785237,0
4283,4,0,3,42,0.0,0.06666666666666667,0.9333333333333333,45,1450,1000,450,0.6896551724137931,19,10,9,363.1042108312219,0.44633838383838387,0.26582781293561863,0.19833108714110428,128601.01814229749,393.8937163456097,128994.9118586431,1434,3,268.22222222222223,36,9,19,37.21711816735131,0.6061921296296297,46.42454954954954,1014.3018018018,28.17505005005,8
4284,4,0,0,42,0.0,0.0,1.0,42,1100,900,200,0.8181818181818182,13,9,4,355.431579801038,0.44194008904374754,0.17800245098039236,0.18591805712669665,126858.71056241411,628.583607381134,127487.29416979525,1435,4,285.04761904761904,35,7,15,39.19653799019607,0.5904761904761905,48.14814814814814,1007.4074074074061,28.783068783068746,8
4285,4,0,0,42,0.0,0.0,1.0,42,1300,1200,100,0.9230769230769231,14,12,2,353.96781044929554,0.4421094657375145,0.18316736882420548,0.1859577370388549,127035.2447041633,593.2774835646073,127628.52218772791,1436,5,286.04761904761904,36,6,15,39.05202747989275,0.5902777777777778,47.972972972972954,1008.1081081081055,28.00300300300293,0
4286,4,3,5,40,0.06666666666666667,0.1111111111111111,0.8888888888888888,45,1150,900,250,0.782608695652174,14,9,5,334.395846986356,0.4477483164983165,0.19046310607361727,0.17880505206625744,127749.32861328077,-456.23101128476657,127293.097601996,1437,0,267.9111111111111,39,6,14,38.8142924609308,0.5921474358974359,47.26562499999998,1010.9374999999961,25.921474358974258,0
4287,4,1,0,41,0.024390243902439025,0.0,1.0,41,1250,900,350,0.72,16,9,7,358.9485747954388,0.44509654471544713,0.22159299545487943,0.19056790232034915,127461.32270361567,950.4120252008646,128411.73472881653,1438,0,293.609756097561,36,5,16,38.48904315824692,0.5946180555555556,47.55067567567567,1009.7972972972965,28.049924924924902,0
4288,4,1,0,42,0.023809523809523808,0.0,1.0,42,900,700,200,0.7777777777777778,11,7,4,351.97293078933836,0.4473359465737514,0.22701785907901062,0.18862558632597687,127839.40882050224,599.2022785856958,128438.61109908794,1439,0,287.5952380952381,37,5,17,38.27783349597022,0.5965653153153153,47.17653508771929,1011.293859649121,27.33226647700327,0
4289,4,3,0,45,0.06666666666666667,0.0,1.0,45,1000,500,500,0.5,15,5,10,339.17384882901524,0.4506734006734007,0.24408175681209254,0.185656140768251,128685.967348327,-269.88964556359167,128416.0777027634,1440,0,269.35555555555555,38,7,17,37.73735565617211,0.6033442982456141,46.34081196581196,1014.6367521367512,26.700967161493452,0
4290,4,0,0,45,0.0,0.0,1.0,45,1550,1100,450,0.7096774193548387,20,11,9,343.5468519552094,0.4502104377104377,0.2490056559022078,0.188486516072723,128778.125,-151.73611111111188,128626.38888888889,1441,1,270.35555555555555,39,6,17,37.53249863163656,0.6025641025641026,46.25,1015.0,26.025641025641026,0
4291,4,1,0,46,0.021739130434782608,0.0,1.0,46,1000,500,500,0.5,15,5,10,333.5582083060794,0.4515297906602254,0.2441787657026575,0.1843697360338577,129072.27143441388,-589.3768796681999,128482.89455474568,1442,0,265.45652173913044,40,6,18,37.48666533319999,0.60390625,45.96036585365853,1016.1585365853646,25.403963414634113,0
4292,4,0,1,45,0.0,0.021739130434782608,0.9782608695652174,46,1350,1100,250,0.8148148148148148,16,11,5,335.08868471921085,0.45062399355877614,0.24222359884759515,0.18570328568511363,129176.17517203632,-542.9050729088,128633.27009912752,1443,1,266.45652173913044,41,5,18,37.342128590481764,0.6034044715447154,45.85813492063492,1016.5674603174597,24.794328300425846,0
4293,4,1,0,46,0.021739130434782608,0.0,1.0,46,1550,1300,250,0.8387096774193549,18,13,5,338.283868025492,0.4497685185185185,0.2584642488749329,0.18889168386933364,129473.07715136217,-440.26194979007573,129032.8152015721,1444,0,267.32608695652175,38,8,13,36.959155644201836,0.6112938596491229,45.566239316239304,1017.7350427350409,26.78250112460634,0
4294,4,0,0,46,0.0,0.0,1.0,46,1150,800,350,0.6956521739130435,15,8,7,338.283868025492,0.44957729468599034,0.2584642488749329,0.18889168386933364,129473.07715136217,-440.2693312148674,129032.80782014731,1445,1,268.32608695652175,38,8,13,36.959155644201836,0.6112938596491229,45.566239316239304,1017.7350427350409,26.78250112460634,0
4295,4,1,2,45,0.02127659574468085,0.0425531914893617,0.9574468085106383,47,1350,900,450,0.6666666666666666,18,9,9,332.46183682253366,0.45004625346901017,0.2577374260198133,0.1875473691411705,129873.84018276155,-764.3809075285872,129109.45927523296,1446,0,263.59574468085106,40,7,14,36.7007311399136,0.6119791666666667,45.172764227642276,1019.3089430894306,25.482723577235767,0
4296,4,0,1,44,0.0,0.022222222222222223,0.9777777777777777,45,750,400,350,0.5333333333333333,11,4,7,345.74943136834736,0.4460227272727273,0.2633661981679598,0.19413280793084972,129690.63321827764,-31.90746219590892,129658.72575608172,1447,1,276.0444444444444,38,7,14,36.54814348646948,0.6134868421052632,45.35256410256411,1018.5897435897451,26.804993252361715,0
4297,4,0,0,44,0.0,0.0,1.0,44,1250,900,350,0.72,16,9,7,360.0779105511789,0.4434350775193798,0.27758586945885133,0.20224448543049905,129703.52055440146,540.6745344721587,130244.19508887362,1448,2,283.20454545454544,37,7,15,36.17016505202728,0.615427927927928,45.33991228070176,1018.6403508771938,27.53082029397821,0
4298,4,0,0,44,0.0,0.0,1.0,44,1400,1000,400,0.7142857142857143,18,10,8,383.8935880790196,0.44335799859055675,0.30400740540749016,0.200629088049279,126822.83676674686,939.6993573757065,127762.53612412256,1449,3,284.20454545454544,38,6,18,38.51669671899305,0.5844298245614035,48.183760683760674,1007.2649572649559,26.506972559604105,8
4299,4,0,1,43,0.0,0.022727272727272728,0.9772727272727273,44,1350,900,450,0.6666666666666666,18,9,9,379.813886784635,0.44335799859055675,0.3081771917649785,0.19902247667514839,126930.47337278083,841.9912886258805,127772.46466140672,1450,4,285.20454545454544,38,6,19,38.50853477523325,0.5855263157894737,48.076923076923066,1007.6923076923058,26.518218623481733,0
4300,4,0,0,43,0.0,0.0,1.0,43,1350,1000,350,0.7407407407407407,17,10,7,389.72035795824326,0.44264488741232927,0.3236286556955752,0.2047479412038907,127036.73846760545,1301.760637888585,128338.49910549403,1451,5,292.06976744186045,37,6,19,38.149427162642304,0.5884009009009009,47.97149122807018,1008.1140350877196,27.24632527264107,0
4301,4,1,1,43,0.022727272727272728,0.022727272727272728,0.9772727272727273,44,1500,800,700,0.5333333333333333,22,8,14,403.4862431978842,0.4444591261451727,0.3233786653597974,0.20505944688550015,125676.58875091316,1364.8750252507984,127041.46377616396,1452,0,286.40909090909093,36,8,19,39.20990566037738,0.5763888888888888,49.32432432432433,1002.7027027027034,27.852852852852873,8
4302,4,4,1,46,0.0851063829787234,0.02127659574468085,0.9787234042553191,47,1650,1300,350,0.7878787878787878,20,13,7,382.6368799777323,0.4527443724946038,0.34443065009441987,0.20017950457782427,126865.01323959102,310.2539617320075,127175.26720132303,1453,0,267.70212765957444,36,11,20,38.50487182353378,0.5885416666666667,48.141891891891895,1007.4324324324331,27.98423423423425,0
4303,4,3,2,47,0.061224489795918366,0.04081632653061224,0.9591836734693877,49,750,500,250,0.6666666666666666,10,5,5,362.99050794231545,0.45431193310657597,0.3322960002620632,0.1923452740141479,127383.94445516117,-551.5587428801398,126832.38571228103,1454,0,257.7142857142857,35,14,18,38.46642589620119,0.5958333333333333,47.62731481481482,1009.4907407407406,28.84259259259259,0
4304,4,0,0,47,0.0,0.0,1.0,47,1000,500,500,0.5,15,5,10,377.7064408168837,0.45189639222941724,0.3407772111834002,0.19870643190801288,127092.013888889,200.69444444445372,127292.70833333346,1455,1,269.6808510638298,36,11,22,38.3953168044077,0.5908564814814814,47.91666666666667,1008.3333333333344,28.009259259259288,0
4305,4,2,1,48,0.04081632653061224,0.02040816326530612,0.9795918367346939,49,1250,900,350,0.72,16,9,7,363.7887170943917,0.4546839569160998,0.340298222441477,0.1945045451671444,127745.77100326677,-505.50597049752884,127240.26503276924,1456,0,259.6326530612245,36,13,19,38.07508076194719,0.5975115740740741,47.26914414414414,1010.9234234234234,28.081206206206204,0
4306,4,2,1,49,0.04,0.02,0.98,50,1450,1200,250,0.8275862068965517,17,12,5,358.3111731743125,0.45475340136054426,0.34268769283510503,0.1939134864841314,128232.43694540879,-809.3342189670143,127423.10272644178,1457,0,255.4,35,15,22,37.71533253342476,0.6044642857142857,46.788194444444436,1012.8472222222208,28.938492063492024,0
4307,4,1,0,50,0.02,0.0,1.0,50,1450,1100,350,0.7586206896551724,18,11,7,358.22828582882863,0.45451530612244895,0.3446413887619917,0.1945810713844431,128379.01341735254,-802.2012174211227,127576.81219993142,1458,0,256.28,35,15,17,37.56757271204508,0.605952380952381,46.64351851851852,1013.425925925926,28.955026455026456,0
4308,4,1,1,50,0.0196078431372549,0.0196078431372549,0.9803921568627451,51,1450,1100,350,0.7586206896551724,18,11,7,356.0650902590709,0.4573039215686274,0.3446021336987375,0.19560797006005645,128829.5659468591,-1025.6577946189327,127803.90815224017,1459,0,252.23529411764707,36,15,19,37.16236827509706,0.6085069444444444,46.19932432432433,1015.2027027027034,28.200075075075095,0
4309,4,0,0,50,0.0,0.0,1.0,50,1400,1000,400,0.7142857142857143,18,10,8,362.4288936838881,0.4568197278911565,0.3520803284145122,0.19881750570741843,128772.40997331796,-665.8315832724567,128106.5783900455,1460,1,258.24,36,14,20,37.05920152372499,0.6079282407407407,46.255630630630634,1014.9774774774779,28.19381881881883,0
4310,4,1,2,49,0.0196078431372549,0.0392156862745098,0.9607843137254902,51,1350,1000,350,0.7407407407407407,17,10,7,357.47684555980834,0.4572385620915033,0.35943411988892127,0.19809730036969425,129173.52123970844,-964.6914194752216,128208.82982023322,1461,0,254.15686274509804,37,14,21,36.775855714953444,0.6100788288288288,45.86074561403509,1016.5570175438602,27.474513987671898,0
4311,4,0,2,47,0.0,0.04081632653061224,0.9591836734693877,49,1300,1000,300,0.7692307692307693,16,10,6,359.98670212831234,0.45677437641723356,0.34459181412427564,0.19933987566933434,129144.15048494452,-501.96463355245567,128642.18585139206,1462,1,258.265306122449,36,13,21,36.74200457936333,0.6116898148148149,45.88963963963965,1016.4414414414424,28.23448448448451,0
4312,4,1,0,48,0.020833333333333332,0.0,1.0,48,1150,700,450,0.6086956521739131,16,7,9,340.0450644193446,0.4564864066193854,0.2665175139543434,0.18481032302202322,128401.90120174838,-867.5134468570205,127534.38775489136,1463,0,260.3958333333333,40,8,18,38.00490490992347,0.5971354166666667,46.6209349593496,1013.5162601626023,25.337906504065057,7
4313,4,0,1,47,0.0,0.020833333333333332,0.9791666666666666,48,1600,1000,600,0.625,22,10,12,341.4757370452329,0.45575687056737585,0.2763568804275218,0.18642931376977143,128582.21379469882,-818.4587547095089,127763.75503998931,1464,1,261.3958333333333,40,8,18,37.784736138944545,0.5989583333333333,46.443089430894304,1014.227642276422,25.35569105691055,0
4314,4,1,0,48,0.020833333333333332,0.0,1.0,48,1200,600,600,0.5,18,6,12,342.7665133333974,0.4541223404255319,0.2801143024618993,0.18863215217637944,128898.98667800461,-763.5487528344553,128135.43792517016,1465,0,262.2291666666667,41,7,19,37.42917155138728,0.600609756097561,46.13095238095239,1015.476190476191,24.76771196283393,0
4315,4,1,3,46,0.02040816326530612,0.061224489795918366,0.9387755102040817,49,1400,1200,200,0.8571428571428571,16,12,4,370.37402412188106,0.45730583900226757,0.2916372824304623,0.19433306693914493,126984.30879720942,-340.4272744874857,126643.88152272193,1466,0,257.85714285714283,38,11,17,38.690949402869066,0.5860745614035088,48.02350427350427,1007.9059829059828,26.5238416554206,8
4316,4,1,0,47,0.02127659574468085,0.0,1.0,47,1650,1400,250,0.8484848484848485,19,14,5,370.5347995355507,0.4548065063213074,0.3049059257956741,0.19493352497305072,127092.01388888896,18.40277777778786,127110.41666666674,1467,0,267.8510638297872,37,10,18,38.57610192837465,0.5889639639639639,47.91666666666667,1008.333333333334,27.252252252252273,0
4317,4,2,3,46,0.04081632653061224,0.061224489795918366,0.9387755102040817,49,1150,600,550,0.5217391304347826,17,6,11,360.0533279831485,0.45659722222222227,0.32137654367453194,0.19229267539679407,127700.83703639593,-604.1777277623778,127096.65930863355,1468,0,257.8775510204082,37,12,18,38.21553843928544,0.5951576576576576,47.313596491228076,1010.7456140350887,27.31744902797537,0
4318,4,3,0,49,0.061224489795918366,0.0,1.0,49,1550,1100,450,0.7096774193548387,20,11,9,356.75731679194155,0.45815617913832196,0.33020557400290995,0.1932141111734572,128261.74554183792,-646.0283601032331,127615.7171817347,1469,0,256.18367346938777,35,14,21,37.724710542352206,0.6047619047619048,46.759259259259245,1012.9629629629612,28.941798941798893,0
4319,4,0,2,47,0.0,0.04081632653061224,0.9591836734693877,49,1200,900,300,0.75,15,9,6,355.18553772225073,0.4579258786848073,0.3298496191532805,0.19292832309528682,128379.01341735231,-680.3262174211516,127698.68719993116,1470,1,257.18367346938777,35,14,17,37.644662707476776,0.605952380952381,46.643518518518505,1013.425925925924,28.955026455026402,0
4320,4,2,1,48,0.04081632653061224,0.02040816326530612,0.9795918367346939,49,1450,1000,450,0.6896551724137931,19,10,9,324.41895848849305,0.45964427437641725,0.3178077324509785,0.169977778136217,126926.2236938286,-1550.8279197493164,125375.39577407928,1471,0,257.2244897959184,37,12,16,39.908414943779476,0.5872747747747749,48.08114035087718,1007.675438596489,27.234471313418624,8
4321,4,0,0,48,0.0,0.0,1.0,48,1350,900,450,0.6666666666666666,18,9,9,329.9343279423434,0.4581855791962175,0.32225187213591155,0.1727280533704005,126893.37722435262,-1226.7037730298011,125666.67345132281,1472,1,263.5416666666667,36,12,17,39.80314630602437,0.5888310185185186,48.11373873873873,1007.5450450450442,27.987362362362337,0
4322,4,4,3,49,0.07692307692307693,0.057692307692307696,0.9423076923076923,52,1150,600,550,0.5217391304347826,17,6,11,300.6295663281436,0.46230046505781797,0.310105565153989,0.16085504800336037,127775.65646701367,-2717.216612199217,125058.43985481445,1473,0,244.19230769230768,39,13,15,39.64085788859124,0.5924145299145299,47.23958333333332,1011.0416666666649,25.924145299145255,0
4323,4,1,2,48,0.02,0.04,0.96,50,1150,800,350,0.6956521739130435,15,8,7,311.7543788319736,0.45817176870748294,0.3299620431623469,0.1668419690777499,127783.97108966224,-2032.5574936518901,125751.41359601034,1474,0,254.86,37,13,16,39.35118660304379,0.5960022522522522,47.23135964912281,1011.074561403509,27.326339497392137,0
4324,4,0,0,48,0.0,0.0,1.0,48,1850,1300,550,0.7027027027027027,24,13,11,316.5228109920833,0.4570866578014185,0.31773373433040764,0.1700964459536372,127950.32035097323,-1500.1609870344869,126450.15936393874,1475,1,250.45833333333334,37,11,17,39.060975940175574,0.5976914414414414,47.066885964912274,1011.7324561403497,27.344120436225666,0
4325,4,0,0,48,0.0,0.0,1.0,48,1000,500,500,0.5,15,5,10,315.87116649371364,0.45699431146572106,0.31764737754659755,0.1698635853382277,127978.0557479223,-1515.0844490612642,126462.97129886104,1476,2,251.45833333333334,37,11,17,39.04918003178733,0.597972972972973,47.03947368421052,1011.8421052631568,27.347083926031264,0
4326,4,0,1,47,0.0,0.020833333333333332,0.9791666666666666,48,1400,900,500,0.6428571428571429,19,9,10,319.594097659837,0.4568650265957446,0.3160154698725586,0.17246126848002763,128116.7778186556,-1410.9267995922005,126705.8510190634,1477,3,252.45833333333334,37,11,17,38.81356276399868,0.5993806306306306,46.902412280701746,1012.3903508771918,27.36190137505924,0
4327,4,4,3,48,0.0784313725490196,0.058823529411764705,0.9411764705882353,51,1200,600,600,0.5,18,6,12,302.14615656757786,0.4597549019607843,0.3131682373740048,0.1663551814093557,128917.41569378354,-2409.619666699707,126507.79602708382,1478,0,237.92156862745097,40,11,11,38.44170085726674,0.60234375,46.112804878048784,1015.5487804878055,25.388719512195138,0
4328,4,1,2,47,0.02040816326530612,0.04081632653061224,0.9591836734693877,49,1450,1000,450,0.6896551724137931,19,10,9,330.83133349152564,0.4580498866213152,0.30839722360840205,0.1750903981789605,127334.51727892844,-1367.7687451281756,125966.74853380026,1479,0,248.6122448979592,38,11,12,39.32862284323067,0.5896381578947368,47.67628205128206,1009.2948717948726,26.560391363022962,8
4329,4,3,1,49,0.06,0.02,0.98,50,1300,900,400,0.6923076923076923,17,9,8,330.25371306634304,0.4570918367346939,0.32993309315491404,0.17775151370856093,128012.72922092026,-1544.664171006939,126468.06504991332,1480,0,244.34,39,11,15,38.64996139989705,0.5948183760683761,47.005208333333336,1011.9791666666677,25.948183760683786,0
4330,4,1,0,50,0.02,0.0,1.0,50,1500,1100,400,0.7333333333333333,19,11,8,334.9926566636339,0.45826530612244903,0.3417895711200245,0.18125395663553207,128223.64501953125,-1409.204101562498,126814.44091796875,1481,0,245.32,39,11,17,38.314756248071575,0.5969551282051282,46.796875,1012.8125,25.96955128205128,0
4331,4,1,0,51,0.0196078431372549,0.0,1.0,51,1800,1400,400,0.7777777777777778,22,14,8,329.978828324061,0.45877450980392154,0.3482302649543936,0.18026922197605125,128607.98306439628,-1712.4176870579588,126895.56537733832,1482,0,241.49019607843138,40,11,15,38.05000333967872,0.59921875,46.41768292682927,1014.3292682926837,25.358231707317092,0
4332,4,1,1,51,0.019230769230769232,0.019230769230769232,0.9807692307692307,52,1400,800,600,0.5714285714285714,20,8,12,324.1737777647197,0.4602265585721468,0.352557840713551,0.178513553683563,128924.17332963271,-2041.232737307892,126882.94059232483,1483,0,237.82692307692307,41,11,16,37.87557796880596,0.6008638211382114,46.10615079365079,1015.5753968253963,24.770131629887715,0
4333,4,0,1,50,0.0,0.0196078431372549,0.9803921568627451,51,1850,1400,450,0.7567567567567568,23,14,9,333.1199046377399,0.45955882352941174,0.3648357772009039,0.18340866154517527,128917.41569378323,-1611.0085555886255,127306.4071381946,1484,1,243.4313725490196,40,11,16,37.655317055272036,0.60234375,46.11280487804877,1015.548780487803,25.388719512195074,0
4334,4,0,0,50,0.0,0.0,1.0,50,1650,1200,450,0.7272727272727273,21,12,9,333.0278343245479,0.4581887755102041,0.3621857699405364,0.18393847655728415,129042.58355034718,-1405.045572916677,127637.5379774305,1485,2,248.88,39,11,16,37.530329437495716,0.6052350427350428,45.98958333333333,1016.0416666666662,26.052350427350415,0
4335,4,0,0,50,0.0,0.0,1.0,50,1550,1100,450,0.7096774193548387,20,11,9,332.80518789271053,0.4582908163265306,0.36277806253203515,0.18393850469650921,129069.0443250866,-1409.0304904514096,127660.01383463519,1486,3,249.88,39,11,16,37.5090765419443,0.6055021367521367,45.96354166666666,1016.1458333333317,26.055021367521324,0
4336,4,0,1,49,0.0,0.02,0.98,50,1800,1100,700,0.6111111111111112,25,11,14,332.57806698942835,0.4577891156462585,0.35913847446942637,0.18468366637137576,129255.70371283521,-1402.4097655251164,127853.2939473101,1487,4,250.88,38,12,16,37.32511206836171,0.6091008771929824,45.779914529914535,1016.8803418803426,26.76000899685112,0
4337,4,1,1,49,0.02,0.02,0.98,50,1400,900,500,0.6428571428571429,19,9,10,334.99662192972494,0.4596428571428572,0.36684856753069583,0.18744467471335008,129554.63927469152,-1319.9266975308428,128234.71257716068,1488,0,246.0,38,12,15,36.9599818099136,0.6121162280701755,45.48611111111112,1018.0555555555569,26.790935672514657,0
4338,4,0,2,47,0.0,0.04081632653061224,0.9591836734693877,49,1250,800,450,0.64,17,8,9,342.58708554493694,0.45858134920634924,0.3691804417555027,0.1914651363704787,129508.13140822185,-926.4373412973091,128581.69406692454,1489,1,251.30612244897958,37,12,15,36.814046285324444,0.6134572072072072,45.53179824561404,1017.8728070175445,27.51007586533904,0
4339,4,0,0,47,0.0,0.0,1.0,47,1350,900,450,0.6666666666666666,18,9,9,360.57263334459344,0.45881514030218934,0.37133105802047806,0.20085129576039135,129377.9538001543,-69.97010030864243,129307.98369984566,1490,2,260.93617021276594,35,12,17,36.48890784982936,0.6160714285714286,45.65972222222222,1017.361111111111,29.067460317460313,0
4340,4,0,1,46,0.0,0.02127659574468085,0.9787234042553191,47,1400,900,500,0.6428571428571429,19,9,10,360.2364152497345,0.45879586802343514,0.3681039780507993,0.20126550417447042,129495.73072059323,-70.18443501371956,129425.5462855795,1491,3,261.93617021276594,35,12,15,36.37754908649838,0.6172619047619048,45.54398148148148,1017.8240740740737,29.08068783068782,0
4341,4,0,0,46,0.0,0.0,1.0,46,1350,700,650,0.5185185185185185,20,7,13,369.2565280819845,0.4582830112721417,0.37408541080880453,0.20650834346821784,129534.44054705223,366.28755668935565,129900.72810374158,1492,4,267.5,34,12,15,36.10859353681831,0.6197916666666667,45.50595238095239,1017.976190476191,29.940476190476208,0
4342,4,0,0,46,0.0,0.0,1.0,46,1750,1400,350,0.8,21,14,7,369.1075145148403,0.4583132045088567,0.3756130409371581,0.20706326469996447,129655.6565334467,371.37542517006614,130027.03195861676,1493,5,268.5,34,12,15,35.98894408727839,0.6210171568627452,45.38690476190476,1018.4523809523808,29.954481792717083,0
4343,4,0,1,45,0.0,0.021739130434782608,0.9782608695652174,46,1450,800,650,0.5517241379310345,21,8,13,370.13912803155245,0.4579307568438003,0.381050711938107,0.20828539098106885,129776.92920918365,407.1038832199466,130184.0330924036,1494,6,269.5,34,12,15,35.83922381898195,0.6222426470588236,45.26785714285714,1018.9285714285712,29.968487394957975,0
4344,4,1,2,44,0.021739130434782608,0.043478260869565216,0.9565217391304348,46,700,500,200,0.7142857142857143,9,5,4,364.7258793728573,0.45945048309178743,0.3756111911379816,0.20732296007852347,130171.45691609979,295.379818594104,130466.83673469389,1495,0,265.95652173913044,34,12,16,35.57610048219007,0.6262254901960784,44.88095238095238,1020.4761904761906,30.0140056022409,0
4345,4,1,1,44,0.022222222222222223,0.022222222222222223,0.9777777777777777,45,1500,1200,300,0.8,18,12,6,369.34610578925447,0.4576388888888889,0.3820408163265312,0.21044138585666824,130262.58680555552,622.3958333333298,130884.98263888885,1496,0,272.0,33,12,17,35.365646258503396,0.6294191919191919,44.791666666666664,1020.833333333333,30.934343434343425,0
4346,4,1,2,43,0.022222222222222223,0.044444444444444446,0.9555555555555556,45,1100,700,400,0.6363636363636364,15,7,8,359.35482273432024,0.4587752525252525,0.36070665890118425,0.20635860556348762,130566.58340419496,383.9462868480609,130950.52969104302,1497,0,268.31111111111113,34,11,17,35.31231799650553,0.6302083333333333,44.49404761904761,1022.0238095238091,30.059523809523796,0
4347,4,1,1,43,0.022727272727272728,0.022727272727272728,0.9772727272727273,44,1000,600,400,0.6,14,6,8,368.356736510191,0.45943446088794926,0.3639061801611265,0.211405837973743,130544.2186448723,817.3684700596076,131361.5871149319,1498,0,274.65909090909093,33,11,17,35.10500359755366,0.632260101010101,44.515931372549026,1021.936274509805,30.967765894236514,0
4348,4,0,0,43,0.0,0.0,1.0,43,1200,900,300,0.75,15,9,6,380.73999468504064,0.45831026208933184,0.37248967414267375,0.21801608612856782,130455.99819214873,1333.9632116620744,131789.9614038108,1499,3,282.04651162790697,32,11,20,34.87825979483377,0.6337890625,44.60227272727273,1021.5909090909089,31.924715909090903,0
4349,4,0,0,43,0.0,0.0,1.0,43,1750,1200,550,0.6857142857142857,23,12,11,380.13246801703497,0.4578949796973053,0.37035206917850494,0.21839406164640887,130585.01882779827,1327.921098612394,131912.93992641065,1500,4,283.04651162790697,32,11,18,34.762713609223795,0.6350911458333333,44.476010101010104,1022.0959595959603,31.94049873737376,0
4350,4,0,0,43,0.0,0.0,1.0,43,1550,1000,550,0.6451612903225806,21,10,11,377.11365837093274,0.45704134366925064,0.30908229913202123,0.20946713134617193,129265.58036169781,1149.5631823283352,130415.14354402614,1501,5,284.04651162790697,32,11,20,36.182849101895535,0.6217447916666667,45.77020202020202,1016.9191919191921,31.778724747474755,8
4351,4,0,0,43,0.0,0.0,1.0,43,1200,700,500,0.5833333333333334,17,7,10,377.5094378955451,0.45632613510520487,0.3101186040909161,0.21034116465830985,129388.3437259708,1169.0641820453648,130557.40790801616,1502,6,285.04651162790697,33,10,20,36.047538745683774,0.6205808080808081,45.64950980392157,1017.4019607843139,30.830362448009513,0
4352,4,1,0,44,0.022727272727272728,0.0,1.0,44,1500,1200,300,0.8,18,12,6,372.8135832230999,0.4573973749119098,0.3079728610562533,0.21027864950962966,129867.92091836725,883.3049886621209,130751.22590702937,1503,0,279.54545454545456,34,10,18,35.67848244179709,0.6231617647058824,45.17857142857142,1019.2857142857134,29.97899159663863,0
4353,4,1,2,43,0.022222222222222223,0.044444444444444446,0.9555555555555556,45,1400,1000,400,0.7142857142857143,18,10,8,368.1304428097461,0.45896464646464646,0.30426596057664046,0.20959386517760914,130233.84871357842,588.6088791494196,130822.45759272785,1504,0,274.31111111111113,36,9,19,35.42586054721978,0.6226851851851851,44.81981981981982,1020.7207207207206,28.35335335335335,0
4354,4,0,1,42,0.0,0.023255813953488372,0.9767441860465116,43,1750,1200,550,0.6857142857142857,23,12,11,401.2116158884683,0.45953303802141016,0.33737831260140605,0.2156512435400516,127958.47750865044,1667.6918463750321,129626.16935502547,1505,1,284.74418604651163,33,10,15,36.910529715762294,0.6060606060606061,47.05882352941176,1011.7647058823524,30.659536541889466,8
4355,4,0,1,41,0.0,0.023809523809523808,0.9761904761904762,42,1200,900,300,0.75,15,9,6,406.75244920938314,0.4592044134727062,0.33401971795831775,0.21859875087289007,127952.84162649239,2009.0263429752326,129961.86796946762,1506,2,283.6666666666667,32,10,16,36.77617621365282,0.6083984375,47.06439393939395,1011.7424242424257,31.616950757575804,0
4356,4,2,2,41,0.046511627906976744,0.046511627906976744,0.9534883720930233,43,1100,600,500,0.5454545454545454,16,6,10,393.0958909289039,0.4597176079734219,0.3118610383902465,0.2145281162603036,128566.7534722225,1507.8125000000346,130074.56597222252,1507,0,260.90697674418607,34,9,14,36.49171459874008,0.6099877450980392,46.45833333333335,1014.1666666666689,29.828431372549087,0
4357,4,0,1,40,0.0,0.024390243902439025,0.975609756097561,41,950,700,250,0.7368421052631579,12,7,5,381.4717438346669,0.45810467479674793,0.23389618511569688,0.19965339320178035,126882.03125000013,1616.4930555555704,128498.52430555571,1508,4,274.6341463414634,34,7,20,38.51668045216432,0.5928308823529411,48.12500000000001,1007.500000000001,29.6323529411765,8
4358,4,3,1,42,0.06976744186046512,0.023255813953488372,0.9767441860465116,43,1650,1000,650,0.6060606060606061,23,10,13,365.5388514303282,0.4608480989294943,0.2507699146372948,0.1958131787214455,127822.46823827582,744.9892564728959,128567.45749474871,1509,0,262.6744186046512,35,8,20,37.95221948800122,0.600297619047619,47.19328703703703,1011.2268518518513,28.89219576719575,0
4359,4,3,1,44,0.06666666666666667,0.022222222222222223,0.9777777777777777,45,1150,900,250,0.782608695652174,14,9,5,351.2814965693971,0.46193181818181817,0.2664474971625377,0.19141807461814153,128506.3934948978,29.599324780045492,128535.99281967785,1510,0,251.93333333333334,34,11,21,37.61349849320964,0.609375,46.51785714285713,1013.9285714285702,29.821428571428534,0
4360,4,1,0,45,0.022222222222222223,0.0,1.0,45,850,600,250,0.7058823529411765,11,6,5,344.271413802345,0.4616372053872054,0.2820038934476723,0.18953843770876375,128915.32368517168,-123.62785082379798,128791.69583434788,1511,0,252.6,36,9,22,37.3743254232276,0.609375,46.11486486486486,1015.5405405405407,28.209459459459467,0
4361,4,0,0,45,0.0,0.0,1.0,45,1800,1200,600,0.6666666666666666,24,12,12,342.8466175146878,0.46069023569023565,0.28481670236600487,0.18984868525690612,129144.15048494427,-144.67296688581627,128999.47751805845,1512,1,253.6,36,9,23,37.17755188714086,0.6116898148148149,45.88963963963963,1016.4414414414404,28.234484484484454,0
4362,4,3,3,45,0.0625,0.0625,0.9375,48,1100,700,400,0.6363636363636364,15,7,8,322.91733246227585,0.4616855053191489,0.27385759558372547,0.18174783349516574,129784.5106336804,-1218.0664062500196,128566.44422743039,1513,0,238.6875,39,9,14,37.034433994411486,0.6127136752136753,45.26041666666666,1018.9583333333321,26.12713675213672,0
4363,4,0,1,44,0.0,0.022222222222222223,0.9777777777777777,45,1100,600,500,0.5454545454545454,16,6,10,343.8230352703232,0.4598905723905724,0.2891988977462847,0.19121980631536678,129315.90374157933,-107.64269336905983,129208.26104821028,1514,3,255.6,36,9,24,36.97801335990549,0.6134259259259259,45.72072072072071,1017.1171171171164,28.253253253253234,0
4364,4,0,1,43,0.0,0.022727272727272728,0.9772727272727273,44,1050,800,250,0.7619047619047619,13,8,5,348.26092874454935,0.45902704369274133,0.2991515082574121,0.19413835285943773,129407.39300679436,213.50777499141412,129620.90078178578,1515,4,261.59090909090907,35,9,24,36.77210120198687,0.6163690476190475,45.63078703703703,1017.4768518518514,29.070767195767182,0
4365,4,0,0,43,0.0,0.0,1.0,43,1050,800,250,0.7619047619047619,13,8,5,356.5477620710062,0.4595099667774087,0.22814769155558623,0.19324226386424256,128291.05748724712,562.5273276749015,128853.58481492203,1516,5,265.7906976744186,35,8,21,37.70005045889029,0.6050595238095238,46.730324074074076,1013.0787037037039,28.945105820105827,8
4366,4,0,2,41,0.0,0.046511627906976744,0.9534883720930233,43,1250,900,350,0.72,16,9,7,359.81961489326426,0.4587716869693614,0.23318473755897617,0.19587694262586042,128466.9994882756,644.9892564728757,129111.98874474848,1517,6,266.7906976744186,35,8,16,37.437326369067996,0.606845238095238,46.55671296296295,1013.7731481481458,28.96494708994702,0
4367,4,0,1,40,0.0,0.024390243902439025,0.975609756097561,41,1350,900,450,0.6666666666666666,18,9,9,365.78286408225415,0.45846036585365857,0.24388525876336464,0.19947109066918303,128536.57171201808,1203.2950680272004,129739.86678004528,1518,7,278.0731707317073,34,7,16,37.215064177819514,0.6096813725490196,46.488095238095234,1014.0476190476186,29.82492997198878,0
4368,4,0,0,40,0.0,0.0,1.0,40,1300,1000,300,0.7692307692307693,16,10,6,374.282235467,0.4575587606837607,0.2541057401812692,0.20416516140339008,128548.11137843627,1622.6548983564155,130170.76627679268,1519,9,285.85,33,7,19,36.987789526686804,0.6120580808080809,46.47671568627452,1014.0931372549028,30.73009506833039,0
4369,4,0,0,40,0.0,0.0,1.0,40,1650,1500,150,0.9090909090909091,18,15,3,373.26992211079363,0.457545405982906,0.2478874939642688,0.2050509306873882,128827.8847078047,1617.5148981161135,130445.39960592081,1520,10,286.85,33,7,19,36.727426364075335,0.6148989898989898,46.200980392156865,1015.1960784313726,30.763517528223414,0
4370,4,0,0,40,0.0,0.0,1.0,40,1400,1300,100,0.9285714285714286,15,13,2,369.15105625901043,0.45674412393162395,0.24714603844350758,0.20346232635671035,128959.43877551013,1521.1026077097463,130480.54138321988,1521,11,287.85,34,6,20,36.6976285357087,0.6139705882352942,46.07142857142857,1015.7142857142851,29.873949579831915,0
4371,4,2,0,42,0.047619047619047616,0.0,1.0,42,1000,600,400,0.6,14,6,8,350.02652414790543,0.4583696283391405,0.24111491469761503,0.19635914190723472,129655.65653344666,677.0372732426245,130332.69380668928,1522,0,275.0952380952381,34,8,19,36.47477108903174,0.6210171568627452,45.38690476190476,1018.4523809523805,29.954481792717075,0
4372,4,0,0,42,0.0,0.0,1.0,42,1150,700,450,0.6086956521739131,16,7,9,354.5863498401967,0.4581397599690282,0.24263343294545803,0.1992249110691111,129716.28578514737,799.1248582766374,130515.41064342401,1523,1,276.0952380952381,34,8,19,36.297037513147124,0.6216299019607843,45.32738095238095,1018.690476190476,29.96148459383753,0
4373,4,0,0,42,0.0,0.0,1.0,42,1500,1100,400,0.7333333333333333,19,11,8,356.43743662683596,0.45764372822299654,0.23941891636355517,0.2010419850065199,129867.92091836741,857.9577664399126,130725.87868480732,1524,2,277.0952380952381,34,8,21,36.09578174881256,0.6231617647058824,45.17857142857143,1019.2857142857149,29.978991596638675,0
4374,4,1,0,43,0.023255813953488372,0.0,1.0,43,1300,1000,300,0.7692307692307693,16,10,6,347.0220741357765,0.4583564045773348,0.2412909349786423,0.19772187944945424,130262.58680555565,440.7986111111192,130703.38541666677,1525,0,271.6279069767442,35,8,22,35.93537414965986,0.625,44.79166666666667,1020.8333333333342,29.16666666666669,0
4375,4,0,1,42,0.0,0.023255813953488372,0.9767441860465116,43,1000,600,400,0.6,14,6,8,347.22330674851173,0.457687338501292,0.24955196187986295,0.19843901934901997,130380.76560356659,454.24811385460464,130835.01371742118,1526,1,272.6279069767442,35,8,22,35.810478996675734,0.6261904761904762,44.67592592592593,1021.2962962962968,29.179894179894195,0
4376,4,0,0,42,0.0,0.0,1.0,42,1400,1200,200,0.8571428571428571,16,12,4,355.8327365476013,0.4570509097948123,0.24981262179583297,0.20305904067656544,130323.3577806123,874.663407029487,131198.0211876418,1527,2,275.92857142857144,34,8,22,35.64887684116436,0.6277573529411764,44.73214285714286,1021.0714285714291,30.031512605042032,0
4377,4,0,0,42,0.0,0.0,1.0,42,1350,1100,250,0.8148148148148148,16,11,5,357.6931572322356,0.4565064847077042,0.25650586498873595,0.2049214069003372,130475.3472222225,934.0277777778122,131409.37500000032,1528,3,276.92857142857144,34,8,23,35.447253942359986,0.6292892156862745,44.58333333333335,1021.6666666666688,30.0490196078432,0
4378,4,0,0,42,0.0,0.0,1.0,42,950,400,550,0.42105263157894735,15,4,11,358.005374867694,0.4560346496322106,0.25855490111255297,0.20574525760468707,130597.00255102056,950.8857709750739,131547.88832199565,1529,4,277.92857142857144,34,8,17,35.31596979579159,0.6305147058823529,44.46428571428572,1022.1428571428584,30.06302521008407,0
4379,4,1,1,42,0.023255813953488372,0.023255813953488372,0.9767441860465116,43,1400,1100,300,0.7857142857142857,17,11,6,348.7350194351658,0.45604928017718716,0.2618264835378714,0.20206520588766297,130913.23329260989,530.8057913237516,131444.03908393363,1530,0,272.4418604651163,35,8,18,35.23288471688156,0.631547619047619,44.1550925925926,1023.3796296296309,29.239417989418026,0
4380,4,0,0,42,0.0,0.0,1.0,42,1100,800,300,0.7272727272727273,14,8,6,358.5979692092223,0.45426829268292684,0.2684194198852181,0.20771618216458734,130901.38888888896,988.1944444444543,131889.58333333343,1531,1,279.3095238095238,34,8,20,34.992535287730725,0.633578431372549,44.16666666666667,1023.3333333333339,30.098039215686292,0
4381,4,0,0,42,0.0,0.0,1.0,42,1500,800,700,0.5333333333333333,22,8,14,360.0077649115195,0.4536391792489354,0.2649882087222246,0.2095254934890997,131084.19075963733,1038.265306122468,132122.4560657598,1532,2,280.3095238095238,34,8,23,34.77146787568785,0.6354166666666667,43.98809523809525,1024.0476190476202,30.119047619047652,0
4382,4,0,0,42,0.0,0.0,1.0,42,1550,1200,350,0.7741935483870968,19,12,7,360.5302906289428,0.452852787456446,0.2623806203866623,0.21049685760873027,131206.12953514748,1060.7568027210925,132266.88633786858,1533,3,281.3095238095238,34,8,23,34.634750948950334,0.6366421568627452,43.86904761904762,1024.52380952381,30.13305322128853,0
4383,4,0,0,42,0.0,0.0,1.0,42,1000,700,300,0.7,13,7,6,364.84263542043095,0.45228416569879987,0.2602996254681649,0.21404442411832564,131390.93888168002,1187.459971733776,132578.3988534138,1534,4,282.3095238095238,33,9,23,34.33739740218344,0.6407828282828283,43.68872549019607,1025.2450980392148,31.0680332739156,0
4384,4,0,0,42,0.0,0.0,1.0,42,1050,700,350,0.6666666666666666,14,7,7,364.8740175257137,0.4514614789005033,0.2576160899142266,0.2151214982200897,131579.47063629367,1201.9860149942251,132781.4566512879,1535,5,283.3095238095238,33,9,21,34.14606227106227,0.6426767676767677,43.50490196078431,1025.9803921568623,31.090314913844313,0
4385,4,1,0,43,0.023255813953488372,0.0,1.0,43,1400,1100,300,0.7857142857142857,17,11,6,354.4887028204891,0.4514811738648948,0.2554288453830258,0.2110527307134458,131951.6933111495,755.0769193672622,132706.77023051676,1536,0,277.69767441860466,35,8,22,34.03704798918555,0.6419642857142858,43.1423611111111,1027.4305555555538,29.35515873015868,0
4386,4,0,0,43,0.0,0.0,1.0,43,1250,800,450,0.64,17,8,9,352.62965668371095,0.4510889627168697,0.2510370835952229,0.21044027898866596,132040.8950617282,712.3070987654061,132753.2021604936,1537,1,278.69767441860466,35,8,22,33.99493243243243,0.6428571428571428,43.05555555555554,1027.7777777777762,29.36507936507932,0
4387,4,0,1,42,0.0,0.023255813953488372,0.9767441860465116,43,1350,600,750,0.4444444444444444,21,6,15,351.81871604966483,0.44984311554079,0.24711657441402224,0.21113746073571832,132253.17166828967,705.8282099666959,132958.99987825635,1538,2,279.69767441860466,36,7,23,33.80204912050215,0.6429398148148149,42.849099099099085,1028.6036036036016,28.572322322322268,0
4388,4,0,0,42,0.0,0.0,1.0,42,1350,900,450,0.6666666666666666,18,9,9,357.79584219317076,0.44836430507162217,0.25002680045453607,0.21419530067682763,132159.87761488307,1057.2509430726636,133217.12855795573,1539,3,286.6904761904762,35,7,23,33.74230826954825,0.644047619047619,42.939814814814795,1028.240740740738,29.378306878306798,0
4389,4,0,1,41,0.0,0.023809523809523808,0.9761904761904762,42,1200,700,500,0.5833333333333334,17,7,10,362.60079885509253,0.44795296167247384,0.24677978265876144,0.2182724240095212,132368.2260186257,1199.3648994770256,133567.5909181027,1540,4,287.6904761904762,35,7,24,33.40890132343568,0.6461309523809524,42.73726851851852,1029.050925925926,29.401455026455032,0
4390,4,1,0,42,0.023809523809523808,0.0,1.0,42,1600,1200,400,0.75,20,12,8,363.17592608685413,0.4469487998451413,0.25420097260339936,0.2203564361349073,132666.15125868065,1236.23046875001,133902.38172743065,1541,0,286.5952380952381,35,7,18,33.09424502864847,0.6491071428571429,42.44791666666667,1030.2083333333342,29.434523809523835,0
4391,4,0,0,42,0.0,0.0,1.0,42,1150,800,350,0.6956521739130435,15,8,7,366.8699583632962,0.44651325977545486,0.2520440629929681,0.22330669714457654,132785.41512613607,1342.9959437157172,134128.41106985178,1542,1,287.5952380952381,35,7,18,32.87911753696426,0.6502976190476191,42.33217592592593,1030.671296296297,29.447751322751344,0
4392,4,0,0,42,0.0,0.0,1.0,42,1700,1200,500,0.7058823529411765,22,12,10,368.69127177556464,0.44569057297715836,0.25621890547263715,0.22549127816005862,132964.41139671204,1404.563587748618,134368.97498446066,1543,2,288.5952380952381,35,7,19,32.652176149328554,0.6520833333333333,42.15856481481481,1031.36574074074,29.46759259259257,0
4393,4,0,1,41,0.0,0.023809523809523808,0.9761904761904762,42,1050,700,350,0.6666666666666666,14,7,7,371.9992740058551,0.4453881145954317,0.24560264936036136,0.22824318842134886,133083.80922335823,1501.4160826046,134585.22530596284,1544,3,289.5952380952381,35,7,20,32.44683585716957,0.6532738095238095,42.042824074074076,1031.828703703704,29.48082010582011,0
4394,4,0,1,40,0.0,0.024390243902439025,0.975609756097561,41,1100,700,400,0.6363636363636364,15,7,8,371.30889932054276,0.444994918699187,0.24788497884978833,0.22869252662697084,133226.30385487544,1693.6224489796077,134919.92630385506,1545,4,296.0975609756098,34,7,20,32.32145602706027,0.6568627450980392,41.90476190476191,1032.3809523809537,30.364145658263343,0
4395,4,0,0,40,0.0,0.0,1.0,40,1250,800,450,0.64,17,8,9,373.4919629981357,0.4452457264957265,0.24497863247863272,0.2299924193199049,133219.0743944639,1951.2507208766206,135170.32511534053,1546,5,302.275,33,7,21,32.27237654320989,0.6590909090909092,41.91176470588237,1032.3529411764725,31.283422459893107,0
4396,4,0,0,40,0.0,0.0,1.0,40,1500,1300,200,0.8666666666666667,17,13,4,373.9449541232726,0.4441907051282051,0.2458793164827342,0.23085964310599422,133313.97667063161,1970.4177780180864,135284.3944486497,1547,6,303.275,33,7,22,32.16533661643131,0.6600378787878788,41.81985294117648,1032.720588235295,31.294563279857424,0
4397,4,0,0,40,0.0,0.0,1.0,40,1350,1000,350,0.7407407407407407,17,10,7,375.58532778355874,0.44314903846153847,0.24495967741935498,0.23286290322580655,133472.22222222228,2026.041666666677,135498.26388888896,1548,7,304.275,33,7,23,31.964045698924735,0.6616161616161615,41.66666666666667,1033.333333333334,31.313131313131333,0
4398,4,0,0,40,0.0,0.0,1.0,40,750,400,350,0.5333333333333333,11,4,7,378.04693894384206,0.44261485042735044,0.2487531486146095,0.23524237423308036,133606.8047417534,2101.928710937491,135708.7334526909,1549,8,305.275,31,9,23,31.765323257766585,0.668010752688172,41.53645833333333,1033.854166666666,33.35013440860213,0
4399,4,0,0,40,0.0,0.0,1.0,40,900,500,400,0.5555555555555556,13,5,8,376.94019490715885,0.4424278846153846,0.250950642155628,0.23498108539659776,133674.1214328342,2077.429877387148,135751.55131022134,1550,9,306.275,31,9,23,31.726370351716604,0.6686827956989247,41.471354166666664,1034.1145833333333,33.35853494623656,0
4400,4,0,0,40,0.0,0.0,1.0,40,1400,1100,300,0.7857142857142857,17,11,6,368.617651916232,0.44256143162393163,0.19600231749710328,0.21939105765772973,131938.95266439905,1727.0053854875289,133665.95804988657,1551,10,307.275,34,6,16,33.6869930475087,0.6439950980392157,43.154761904761905,1027.380952380952,30.217086834733884,8
4401,4,0,0,40,0.0,0.0,1.0,40,1200,900,300,0.75,15,9,6,367.71733130634203,0.4416800213675214,0.19901552003706247,0.21956234014515608,132061.28826530612,1712.2448979591813,133773.5331632653,1552,11,308.275,34,6,16,33.58669214732453,0.6452205882352942,43.035714285714285,1027.857142857143,30.23109243697479,0
4402,4,0,0,40,0.0,0.0,1.0,40,1050,600,450,0.5714285714285714,15,6,9,366.2426037559537,0.4405982905982906,0.19906323843816853,0.21977029166638484,132249.1496940371,1687.0545856910016,133936.2042797281,1553,12,309.275,35,5,18,33.43519091556954,0.6449404761904762,42.85300925925925,1028.5879629629621,29.38822751322749,0
4403,4,0,0,40,0.0,0.0,1.0,40,1050,800,250,0.7619047619047619,13,8,5,361.72265623079494,0.44023771367521364,0.17880820399113073,0.1994338850367833,128972.51136271424,1330.5396026696599,130303.0509653839,1554,13,310.275,36,4,18,36.87292128603104,0.6099537037037037,46.058558558558566,1015.7657657657671,28.215715715715753,8
4404,4,1,0,41,0.024390243902439025,0.0,1.0,41,1100,700,400,0.6363636363636364,15,7,8,354.0755988390424,0.44115853658536586,0.18809082145952605,0.19706499595274657,129344.5403807526,959.7520239834673,130304.29240473607,1555,0,303.6829268292683,36,5,19,36.688161924794265,0.6137152777777778,45.69256756756758,1017.2297297297316,28.256381381381434,0
4405,4,0,0,41,0.0,0.0,1.0,41,1600,1000,600,0.625,22,10,12,353.4223510063433,0.4401930894308943,0.19830563349881247,0.19770656269166753,129545.08562616687,956.8257446636007,130501.91137083046,1556,1,304.6829268292683,36,5,15,36.50073746312684,0.6157407407407407,45.495495495495504,1018.0180180180193,28.278278278278314,0
4406,4,0,0,41,0.0,0.0,1.0,41,1500,1200,300,0.8,18,12,6,353.8375968651854,0.4396341463414634,0.19711706319517175,0.1988811320311214,129731.44531250001,980.7725694444443,130712.21788194445,1557,2,305.6829268292683,37,4,16,36.300698704839796,0.6157094594594594,45.3125,1018.7500000000001,27.533783783783786,0
4407,4,0,0,41,0.0,0.0,1.0,41,1450,1000,450,0.6896551724137931,19,10,9,358.3000553973946,0.43877032520325204,0.19843835271399168,0.20210906037464707,129871.11418898133,1106.5654816866836,130977.67967066802,1558,3,306.6829268292683,37,4,17,36.045073149741825,0.6171171171171171,45.17543859649123,1019.298245614036,27.548601232811784,0
4408,4,1,0,42,0.023809523809523808,0.0,1.0,42,700,500,200,0.7142857142857143,9,5,4,351.65028976540987,0.4389880952380953,0.20689758315386486,0.19993830760947606,130180.8021038791,755.6233563445192,130936.42546022362,1559,0,300.35714285714283,38,4,18,35.900204145728644,0.618421052631579,44.871794871794876,1020.5128205128211,26.855600539811082,0
4409,4,0,0,42,0.0,0.0,1.0,42,1050,600,450,0.5714285714285714,15,6,9,352.34993369114943,0.4387824235385211,0.20437214031520123,0.20061688119697524,130235.32238476159,777.6814413032511,131013.00382606484,1560,1,301.35714285714283,38,4,18,35.82705324122532,0.6189692982456141,44.818376068376075,1020.7264957264965,26.861223571749907,0
4410,4,0,0,42,0.0,0.0,1.0,42,1250,1000,250,0.8,15,10,5,351.47236193842207,0.43861304684475416,0.1952237783334101,0.20069050317182857,130346.55044100099,762.6448443734095,131109.1952853744,1561,2,302.35714285714283,37,5,18,35.7366718565446,0.6219031531531531,44.7094298245614,1021.1622807017536,27.598980559506856,0
4411,4,0,0,42,0.0,0.0,1.0,42,1300,1000,300,0.7692307692307693,16,10,6,346.1458791495684,0.4383831784746419,0.1950009964281878,0.19850667371045072,130514.55886667041,635.4153441443376,131149.97421081475,1562,3,303.35714285714283,37,5,13,35.70248506635189,0.6235923423423424,44.54495614035087,1021.8201754385957,27.616761498340423,0
4412,4,0,0,42,0.0,0.0,1.0,42,1000,600,400,0.6,14,6,8,349.0162288737435,0.4379839334107627,0.19518088290883795,0.20058750219241903,130598.60365689438,716.2064289011913,131314.8100857956,1563,4,304.35714285714283,37,5,14,35.54405349352785,0.6244369369369369,44.46271929824561,1022.1491228070172,27.62565196775722,0
4413,4,0,0,42,0.0,0.0,1.0,42,1300,1100,200,0.8461538461538461,15,11,4,350.9410069708431,0.4374637049941928,0.19878373824331397,0.2022790995679899,130710.70545744817,774.3493190212083,131485.0547764694,1564,5,305.35714285714283,37,5,16,35.381371077275006,0.6255630630630631,44.35307017543858,1022.5877192982434,27.637505926979554,0
4414,4,1,2,41,0.023255813953488372,0.046511627906976744,0.9534883720930233,43,1200,900,300,0.75,15,9,6,340.7065737693041,0.4388381321520856,0.1937531544822768,0.19813906571632334,131054.49631090641,330.22568303015606,131384.72199393658,1565,0,299.2325581395349,38,5,17,35.29558813299945,0.6271929824561404,44.01709401709401,1023.9316239316227,26.945569050832177,0
4415,4,0,0,41,0.0,0.0,1.0,41,950,600,350,0.631578947368421,13,6,7,348.4847149804428,0.4369156504065041,0.19047171191506274,0.20232918526476423,130991.1703601106,929.6841335795391,131920.85449369013,1566,1,308.9268292682927,37,4,18,35.16048986003998,0.6283783783783784,44.07894736842104,1023.6842105263141,27.667140825035517,0
4416,4,1,0,42,0.023809523809523808,0.0,1.0,42,1000,600,400,0.6,14,6,8,339.4143697534536,0.4385283584978707,0.18776616337591956,0.19879984514130838,131328.12499999988,515.363381040306,131843.4883810402,1567,0,302.54761904761904,37,5,19,35.052506775067755,0.6317567567567568,43.74999999999999,1024.999999999999,27.702702702702677,0
4417,4,0,0,42,0.0,0.0,1.0,42,1400,900,500,0.6428571428571429,19,9,10,342.0593738589058,0.4382621951219512,0.19109739704264972,0.2009383960005329,131440.53939673727,592.093721144947,132032.63311788221,1568,1,303.54761904761904,37,5,20,34.87132877102937,0.6328828828828829,43.64035087719297,1025.4385964912267,27.714556661925045,0
4418,4,0,1,41,0.0,0.023809523809523808,0.9761904761904762,42,1050,600,450,0.5714285714285714,15,6,9,339.09204235406503,0.43806862175764616,0.18252736696540728,0.18722695263882372,129029.71172185717,357.5389480406714,129387.25066989784,1569,2,304.54761904761904,36,6,18,37.3893907485406,0.6105324074074074,46.00225225225226,1015.9909909909925,28.221971971972014,7
4419,4,1,0,42,0.023809523809523808,0.0,1.0,42,800,400,400,0.5,12,4,8,335.02473758641133,0.4375241966705381,0.18885934788227976,0.18565182972329872,129172.76810171663,255.21454731759763,129427.98264903422,1570,0,305.4761904761905,36,6,19,37.347217606439955,0.6119791666666667,45.86148648648649,1016.5540540540544,28.237612612612622,0
4420,4,0,1,41,0.0,0.023809523809523808,0.9761904761904762,42,1250,1000,250,0.8,15,10,5,335.4321922800222,0.43768147502903604,0.18679615335948374,0.1865531749182981,129315.90374157943,275.3434177420662,129591.2471593215,1571,1,306.4761904761905,36,6,20,37.19137511071744,0.6134259259259259,45.72072072072072,1017.1171171171172,28.253253253253256,0
4421,4,0,0,41,0.0,0.0,1.0,41,650,400,250,0.6153846153846154,9,4,5,343.8244176200316,0.4375508130081301,0.19276151545530085,0.19052428138528296,129171.97312510702,682.4956865140464,129854.46881162106,1572,2,313.9512195121951,35,6,20,37.1243927663289,0.6139880952380952,45.86226851851851,1016.5509259259247,29.044312169312136,0
4422,4,0,0,41,0.0,0.0,1.0,41,750,400,350,0.5333333333333333,11,4,7,346.37197447377605,0.4369918699186992,0.19492769509558783,0.19279691473400984,129348.51794249385,760.5403109996364,130109.0582534935,1573,3,314.9512195121951,35,6,20,36.88002522092009,0.6157738095238094,45.6886574074074,1017.2453703703692,29.064153439153404,0
4423,4,0,0,41,0.0,0.0,1.0,41,950,400,550,0.42105263157894735,15,4,11,346.34016696459105,0.4370172764227642,0.19900574801926396,0.19321210329649,129436.83556241418,765.8350480109643,130202.67061042515,1574,4,315.9512195121951,35,6,15,36.79102214134062,0.6166666666666667,45.60185185185185,1017.5925925925919,29.074074074074055,0
4424,4,0,0,41,0.0,0.0,1.0,41,1550,1100,450,0.7096774193548387,20,11,9,347.0472324928285,0.43683943089430893,0.19633605814407962,0.1946251496943529,129643.02722318664,798.4507619598643,130441.4779851465,1575,5,316.9512195121951,35,6,15,36.56345891578587,0.61875,45.39930555555555,1018.402777777777,29.0972222222222,0
4425,4,0,0,41,0.0,0.0,1.0,41,650,400,250,0.6153846153846154,9,4,5,347.71781211337947,0.4364329268292683,0.19099364684434073,0.19558849201495707,129760.9247068972,824.0369673782465,130584.96167427544,1576,6,317.9512195121951,35,6,15,36.42662065962361,0.6199404761904762,45.28356481481481,1018.8657407407401,29.110449735449716,0
4426,4,0,1,40,0.0,0.024390243902439025,0.975609756097561,41,1400,900,500,0.6428571428571429,19,9,10,348.5685598343104,0.43572154471544716,0.18585548635093496,0.19665876402695504,129878.87577428392,854.338536308275,130733.2143105922,1577,7,318.9512195121951,35,6,15,36.285175617879716,0.6211309523809524,45.16782407407406,1019.3287037037021,29.123677248677204,0
4427,4,0,1,39,0.0,0.025,0.975,40,1550,1300,250,0.8387096774193549,18,13,5,359.33815180365144,0.4337606837606838,0.18764602803738373,0.20236411706837165,129807.25623582734,1328.9399092970148,131136.19614512436,1578,13,327.75,34,6,15,36.08352803738317,0.6225490196078431,45.23809523809522,1019.0476190476164,29.97198879551813,0
4428,4,1,0,40,0.025,0.0,1.0,40,1300,800,500,0.6153846153846154,18,8,10,350.8085950281341,0.4329727564102564,0.17326999432785017,0.19912284386175133,130114.93866008641,1129.0877647033378,131244.02642478974,1579,0,311.425,35,5,17,35.9884902628096,0.6235119047619048,44.93634259259258,1020.2546296296282,29.150132275132233,0
4429,4,0,0,40,0.0,0.0,1.0,40,700,500,200,0.7142857142857143,9,5,4,351.1970933604027,0.43301282051282053,0.1724090032883545,0.1999488164199734,130233.05047850206,1147.4937575016925,131380.54423600374,1580,1,312.425,35,5,17,35.85877556034318,0.624702380952381,44.82060185185184,1020.7175925925912,29.16335978835975,0
4430,4,1,0,41,0.024390243902439025,0.0,1.0,41,1100,900,200,0.8181818181818182,13,9,4,345.31345283298435,0.43366361788617885,0.17888829563656583,0.1987635343786639,130657.8514739227,823.5894643994147,131481.4409383221,1581,0,305.780487804878,34,7,16,35.57871448532836,0.6311274509803921,44.40476190476189,1022.3809523809507,30.070028011204432,0
4431,4,0,1,40,0.0,0.024390243902439025,0.975609756097561,41,950,600,350,0.631578947368421,13,6,7,344.54742702414046,0.43356199186991873,0.17800051108776493,0.19863506027767572,130718.71456916103,807.7593537414963,131526.47392290254,1582,1,306.780487804878,34,7,17,35.536719053162585,0.6317401960784313,44.345238095238095,1022.6190476190479,30.07703081232494,0
4432,4,1,1,40,0.024390243902439025,0.024390243902439025,0.975609756097561,41,550,400,150,0.7272727272727273,7,4,3,342.6826809833526,0.43671239837398373,0.18153650591880544,0.19849732653186647,130901.38888888883,771.5277777777733,131672.9166666666,1583,0,300.8536585365854,34,7,18,35.39970141150925,0.633578431372549,44.166666666666664,1023.3333333333328,30.09803921568626,0
4433,4,0,1,39,0.0,0.025,0.975,40,1050,700,350,0.6666666666666666,14,7,7,350.957925057309,0.4359775641025641,0.18300069824275567,0.20280978144031314,130810.03578514738,1181.7637471655312,131991.7995323129,1584,1,309.275,34,6,18,35.28041235113852,0.6326593137254901,44.25595238095238,1022.9761904761904,30.0875350140056,0
4434,4,0,0,39,0.0,0.0,1.0,39,1100,700,400,0.6363636363636364,15,7,8,357.43173456224235,0.4350258659469186,0.19437046320956708,0.2064693902000719,130794.81336805562,1550.043402777783,132344.8567708334,1585,2,315.7435897435897,33,6,18,35.130261371350976,0.6347853535353536,44.270833333333336,1022.9166666666672,30.997474747474765,0
4435,4,0,0,39,0.0,0.0,1.0,39,1500,1200,300,0.8,18,12,6,359.2815341045939,0.43474471434997747,0.19302753194768085,0.20855306840692686,130982.91710219646,1611.9486795944154,132594.86578179087,1586,3,316.7435897435897,33,6,19,34.892528632427464,0.6366792929292929,44.08700980392158,1023.6519607843152,31.01975638740349,0
4436,4,1,0,40,0.025,0.0,1.0,40,1150,600,550,0.5217391304347826,17,6,11,350.2553659758195,0.4351095085470085,0.20299952198852744,0.2058242206801728,131453.76778162256,1208.9318110822865,132662.69959270486,1587,0,309.8,33,7,20,34.647864882090495,0.6414141414141414,43.62745098039216,1025.4901960784323,31.07546048722522,0
4437,4,0,0,40,0.0,0.0,1.0,40,1400,1200,200,0.8571428571428571,16,12,4,350.03032655663566,0.434642094017094,0.20457477305303384,0.20636999253043342,131579.4706362938,1211.3610149942388,132790.83165128803,1588,1,310.8,33,7,19,34.526795668100014,0.6426767676767677,43.504901960784316,1025.9803921568632,31.090314913844338,0
4438,4,0,0,40,0.0,0.0,1.0,40,1200,900,300,0.75,15,9,6,352.61181946143506,0.43385416666666665,0.20493075453677223,0.20857885591871306,131705.23356401373,1288.1644079200178,132993.39797193374,1589,2,311.8,33,7,19,34.333711397644066,0.6439393939393939,43.382352941176464,1026.4705882352932,31.10516934046343,0
4439,4,0,0,40,0.0,0.0,1.0,40,850,500,350,0.5882352941176471,12,5,7,351.0779728983089,0.43352029914529916,0.20285202863961804,0.20835930686174406,131831.05656478263,1256.5960207612281,133087.65258554387,1590,3,312.8,33,7,19,34.24622116149561,0.6452020202020202,43.25980392156862,1026.9607843137244,31.120023767082557,0
4440,4,0,0,40,0.0,0.0,1.0,40,1150,600,550,0.5217391304347826,17,6,11,348.7714780755549,0.43305288461538466,0.20150918635170645,0.20733351271129788,131893.9905925605,1200.1724096501284,133094.16300221064,1591,4,313.8,33,7,19,34.24202656486121,0.6458333333333333,43.1985294117647,1027.2058823529408,31.127450980392144,0
4441,4,0,0,40,0.0,0.0,1.0,40,1250,800,450,0.64,17,8,9,349.9631908973022,0.4328926282051282,0.20389339375149085,0.20873337972011194,132019.90370290264,1240.421352364465,133260.3250552671,1592,5,314.8,33,7,19,34.0845854201447,0.6470959595959596,43.07598039215686,1027.6960784313717,31.142305407011264,0
4442,4,0,0,40,0.0,0.0,1.0,40,1350,900,450,0.6666666666666666,18,9,9,359.5288450966762,0.43243856837606837,0.17634935933779383,0.20469237475194232,130233.05047850226,1488.8738757254812,131721.92435422775,1593,6,315.8,35,5,24,35.646166420985,0.624702380952381,44.820601851851855,1020.7175925925928,29.163359788359795,8
4443,4,2,2,40,0.047619047619047616,0.047619047619047616,0.9523809523809523,42,1200,700,500,0.5833333333333334,17,7,10,343.660429482207,0.4341366627951994,0.16957618077781,0.19851443632442806,130794.81336805574,589.8003472222423,131384.61371527798,1594,0,301.7142857142857,37,5,19,35.482433808553964,0.6264076576576576,44.27083333333334,1022.9166666666681,27.646396396396437,0
4444,4,0,0,40,0.0,0.0,1.0,40,1250,900,350,0.72,16,9,7,348.73915116235884,0.4298744658119658,0.14803203787294916,0.20137302670106225,130780.41459956596,1121.6501552228126,131902.06475478876,1595,1,278.925,36,4,21,35.36712356416751,0.6281828703703703,44.28490990990992,1022.8603603603618,28.412787787787828,0
4445,4,0,0,40,0.0,0.0,1.0,40,850,600,250,0.7058823529411765,11,6,5,346.7926244817922,0.4297542735042735,0.14514531043593148,0.20039848605550906,130809.21292914552,1072.7340516192037,131881.9469807647,1596,2,279.925,36,4,21,35.38776970497578,0.6284722222222222,44.256756756756765,1022.9729729729743,28.415915915915953,0
4446,4,0,0,40,0.0,0.0,1.0,40,950,400,550,0.42105263157894735,15,4,11,357.61199698260026,0.42954059829059826,0.15508171603677257,0.20237118210749422,129996.880425347,1308.3064721182097,131305.1868974652,1597,3,280.925,35,5,18,35.934839972761324,0.6223214285714286,45.05208333333332,1019.7916666666648,29.13690476190471,8
4447,4,0,0,40,0.0,0.0,1.0,40,1450,1100,350,0.7586206896551724,18,11,7,359.147909910948,0.42913995726495724,0.1533664208735115,0.20385633134996803,130114.93866008647,1346.1016535922404,131461.0403136787,1598,4,281.925,35,5,18,35.775784647381364,0.6235119047619048,44.93634259259259,1020.2546296296287,29.150132275132247,0
4448,4,1,0,41,0.024390243902439025,0.0,1.0,41,950,700,250,0.7368421052631579,12,7,5,350.9812812025538,0.43033536585365856,0.16093258396751509,0.20071880331066627,130406.32482144322,954.0357925493199,131360.36061399255,1599,0,276.0243902439024,36,5,21,35.688625505328915,0.6244212962962963,44.65090090090091,1021.3963963963977,28.372122122122157,0
4449,4,0,0,41,0.0,0.0,1.0,41,1550,1300,250,0.8387096774193549,18,13,5,350.60533659795726,0.4288617886178862,0.16471005516489012,0.20154810894868017,130607.69120049108,958.3507071260524,131566.04190761712,1600,1,277.0243902439024,36,5,17,35.49424369285008,0.6264467592592593,44.45382882882883,1022.1846846846851,28.39401901901903,0
4450,4,0,1,40,0.0,0.024390243902439025,0.975609756097561,41,1100,600,500,0.5454545454545454,16,6,10,352.72717395226454,0.4291920731707317,0.15915503638793194,0.20345617510530434,130738.7384219183,1023.0211459295168,131761.75956784782,1601,2,278.0243902439024,37,4,17,35.30732908044744,0.6258445945945945,44.32565789473684,1022.6973684210528,27.640469416785212,0
4451,4,0,0,40,0.0,0.0,1.0,40,1450,1000,450,0.6896551724137931,19,10,9,354.2879206240653,0.42813835470085465,0.16729079609986086,0.2052494825067907,130906.99932912034,1275.7537174899803,132182.75304661033,1602,3,283.325,37,3,19,35.09712400442873,0.6275337837837838,44.16118421052631,1023.3552631578934,27.65825035561874,0
4452,4,1,0,41,0.024390243902439025,0.0,1.0,41,1400,900,500,0.6428571428571429,19,9,10,353.2949963645979,0.4279979674796748,0.19036287923854855,0.20692992644212152,131328.12499999985,1080.1901787088175,132408.31517870867,1603,0,277.390243902439,37,4,20,34.69681571815718,0.6317567567567568,43.74999999999999,1024.9999999999989,27.702702702702673,0
4453,4,1,1,41,0.023809523809523808,0.023809523809523808,0.9761904761904762,42,1350,800,550,0.5925925925925926,19,8,11,343.59041165047046,0.4291037553232675,0.19008230512340973,0.20308316292693956,131675.35942925338,648.4781901041563,132323.83761935754,1604,0,271.76190476190476,39,3,15,34.59532206772896,0.6316773504273504,43.41145833333333,1026.3541666666658,26.31677350427348,0
4454,4,0,0,41,0.0,0.0,1.0,41,750,400,350,0.5333333333333333,11,4,7,351.2867749858231,0.4278201219512195,0.19354199582404097,0.206935927203305,131547.23340821092,1042.1606764555422,132589.39408466645,1605,2,279.390243902439,38,3,20,34.52709504964244,0.6321271929824561,43.53632478632478,1025.8547008547002,26.996176338281586,0
4455,4,0,0,41,0.0,0.0,1.0,41,1550,1000,550,0.6451612903225806,21,10,11,356.3201394955793,0.427489837398374,0.1907182696121681,0.19918229690170342,129516.42679419303,1046.5870177777035,130563.01381197074,1606,3,280.390243902439,36,5,16,36.4561437474647,0.6154513888888888,45.52364864864866,1017.9054054054069,28.275150150150193,8
4456,4,1,2,40,0.023809523809523808,0.047619047619047616,0.9523809523809523,42,1000,800,200,0.8,12,8,4,348.94248743190104,0.429369918699187,0.19345750348332102,0.1968306652407133,129871.11418898132,663.5099261311284,130534.62411511244,1607,0,274.6904761904762,37,5,18,36.28352696500287,0.6171171171171171,45.17543859649123,1019.2982456140359,27.54860123281178,0
4457,4,1,0,41,0.024390243902439025,0.0,1.0,41,1350,1100,250,0.8148148148148148,16,11,5,350.5090782822853,0.4297764227642276,0.1871763067700558,0.19842269854555922,130010.85820877584,913.9972154893878,130924.85542426523,1608,0,278.0975609756098,37,4,20,36.10174085223811,0.6185247747747749,45.03837719298246,1019.8464912280707,27.56341868183975,0
4458,4,0,0,41,0.0,0.0,1.0,41,1050,800,250,0.7619047619047619,13,8,5,348.8590709576145,0.4299288617886179,0.1865321383809404,0.19763015091642705,130038.81602993238,873.0441097260782,130911.86013965846,1609,1,279.0975609756098,37,4,20,36.115441123772655,0.6188063063063063,45.010964912280706,1019.956140350878,27.56638217164535,0
4459,4,0,0,41,0.0,0.0,1.0,41,1000,900,100,0.9,11,9,2,350.84648978224834,0.42947154471544713,0.18873739994653338,0.1993270716674972,130150.67737188368,932.5816597414615,131083.25903162514,1610,2,280.0975609756098,37,4,20,35.95126799914034,0.6199324324324325,44.901315789473685,1020.3947368421055,27.57823613086772,0
4460,4,1,1,41,0.023809523809523808,0.023809523809523808,0.9761904761904762,42,1300,1000,300,0.7692307692307693,16,10,6,358.4445405899069,0.430809620596206,0.2292004760359192,0.19477383237345727,128394.44739006223,809.8079457140559,129204.25533577628,1611,0,274.4047619047619,37,5,20,37.546318835875795,0.6021959459459459,46.628289473684205,1013.4868421052624,27.3915362731152,8
4461,4,2,0,43,0.046511627906976744,0.0,1.0,43,1150,800,350,0.6956521739130435,15,8,7,349.74975102392204,0.43443152454780365,0.2281540927051855,0.19249400020164306,128902.8613873364,416.74873529839465,129319.61012263478,901,0,231.51162790697674,38,5,22,37.247939680869706,0.6055372807017544,46.12713675213674,1015.4914529914518,26.72345928924873,0
4462,4,0,0,43,0.0,0.0,1.0,43,1300,900,400,0.6923076923076923,17,9,8,347.9896570112158,0.43390088593576964,0.2316194983158235,0.19271091948805058,129147.0854792169,388.3699959821756,129535.45547519908,902,1,232.51162790697674,38,5,22,37.04387394015834,0.6080043859649122,45.886752136752136,1016.4529914529916,26.748762932973463,0
4463,4,1,1,43,0.022727272727272728,0.022727272727272728,0.9772727272727273,44,1150,900,250,0.782608695652174,14,9,5,342.9222210866658,0.43561707188160675,0.2337826721377303,0.1916524369866055,129508.13140822173,82.2660428067021,129590.39745102843,903,0,228.20454545454547,37,7,17,36.80551815145967,0.6134572072072072,45.531798245614034,1017.8728070175436,27.510075865339015,0
4464,4,0,0,43,0.0,0.0,1.0,43,650,600,50,0.9230769230769231,7,6,1,353.74368080351593,0.4337393872277593,0.2421230099998708,0.19716682023811033,129401.8231702988,555.0154461894462,129956.83861648824,904,3,234.51162790697674,36,7,22,36.638304740822726,0.6142939814814814,45.63626126126127,1017.454954954956,28.262637637637667,0
4465,4,1,0,44,0.022727272727272728,0.0,1.0,44,1000,700,300,0.7,13,7,6,347.93989086416974,0.4343727977448908,0.2482299327178843,0.19626512290493447,129871.11418898118,237.46825946444673,130108.58244844562,905,0,230.1590909090909,37,7,20,36.30907558806655,0.6171171171171171,45.175438596491226,1019.2982456140348,27.54860123281175,0
4466,4,0,2,42,0.0,0.045454545454545456,0.9545454545454546,44,1450,1000,450,0.6896551724137931,19,10,9,348.81165452653477,0.4344829105003523,0.25149560117302006,0.19732046150223675,129982.90339335173,267.91031855954463,130250.81371191128,906,1,231.1590909090909,37,7,20,36.173387096774185,0.6182432432432432,45.065789473684205,1019.7368421052627,27.560455192034127,0
4467,4,0,0,42,0.0,0.0,1.0,42,1200,700,500,0.5833333333333334,17,7,10,362.87298888550714,0.4319831591173055,0.2689113792656035,0.20488367218612435,129908.37191357993,1028.047839506136,130936.41975308607,907,2,242.5,35,7,20,35.89066757493188,0.6214285714285714,45.13888888888887,1019.4444444444418,29.126984126984052,0
4468,4,0,1,41,0.0,0.023809523809523808,0.9761904761904762,42,1000,600,400,0.6,14,6,8,365.7194834576851,0.43230981416957026,0.2706610453489007,0.2068028658063028,129967.37423911145,1106.3201946158688,131073.69443372733,908,3,243.5,35,7,20,35.75813469542186,0.6220238095238095,45.0810185185185,1019.6759259259231,29.133597883597805,0
4469,4,0,0,41,0.0,0.0,1.0,41,1200,900,300,0.75,15,9,6,367.28652649422327,0.43175813008130076,0.26223247937040295,0.2083181109729779,130085.41907793177,1355.7243441357596,131441.14342206754,909,4,246.17073170731706,35,6,21,35.598196051735854,0.6232142857142857,44.96527777777776,1020.1388888888863,29.146825396825324,0
4470,4,0,0,41,0.0,0.0,1.0,41,1050,700,350,0.6666666666666666,14,7,7,367.85976300924796,0.4315548780487805,0.2628237578735102,0.2091179581207307,130173.98787133458,1377.1544656635488,131551.14233699813,910,5,247.17073170731706,35,6,22,35.49357774753318,0.6241071428571429,44.87847222222221,1020.4861111111087,29.156746031745964,0
4471,4,0,0,41,0.0,0.0,1.0,41,850,600,250,0.7058823529411765,11,6,5,369.34610578925486,0.43124999999999997,0.266202090592335,0.21044138585666802,130262.58680555526,1422.395833333299,131684.98263888856,911,6,248.17073170731706,35,6,22,35.365646258503396,0.625,44.79166666666665,1020.833333333331,29.1666666666666,0
4472,4,0,0,41,0.0,0.0,1.0,41,1250,800,450,0.64,17,8,9,369.2989109935886,0.43109756097560975,0.26526083051198857,0.21121600061687693,130410.31867551831,1432.0777338391176,131842.39640935743,912,7,249.17073170731706,35,6,22,35.21683191690273,0.6264880952380952,44.64699074074072,1021.4120370370339,29.183201058200968,0
4473,4,0,2,39,0.0,0.04878048780487805,0.9512195121951219,41,1350,900,450,0.6666666666666666,18,9,9,335.21790525545566,0.43081808943089434,0.14934550857291629,0.1816638720288001,128287.09621783959,415.85990326304716,128702.95612110263,913,8,250.17073170731706,36,5,20,38.244312286942346,0.6030092592592593,46.73423423423424,1013.0630630630641,28.14064064064067,8
4474,4,1,1,39,0.025,0.025,0.975,40,1500,1300,200,0.8666666666666667,17,13,4,335.9050635389495,0.43434829059829055,0.14450027762354267,0.18321169577033566,128543.9128951588,635.7102457187091,129179.62314087752,914,0,250.0,36,4,15,37.965019433647974,0.6056134259259259,46.480855855855864,1014.0765765765776,28.168793793793824,0
4475,4,2,1,40,0.04878048780487805,0.024390243902439025,0.975609756097561,41,1100,700,400,0.6363636363636364,15,7,8,327.5201561715406,0.4377286585365854,0.15691706474395795,0.18035027862430472,128922.84765504758,244.96623961217242,129167.81389465975,915,0,244.4390243902439,37,4,17,37.79196357878066,0.607545045045045,46.10745614035087,1015.5701754385955,27.4478425794215,0
4476,4,0,0,40,0.0,0.0,1.0,40,1050,700,350,0.6666666666666666,14,7,7,326.25687731977195,0.43737980769230766,0.14089271860800245,0.18027041053620943,129058.31665702851,421.2326769336766,129479.54933396219,916,1,232.825,36,4,18,37.68632938047214,0.6108217592592593,45.97409909909909,1016.1036036036024,28.225100100100068,0
4477,4,0,0,40,0.0,0.0,1.0,40,1150,700,450,0.6086956521739131,16,7,9,326.2587437407559,0.43684561965811963,0.14325242718446596,0.1806701645446119,129145.65659626016,426.97993613416725,129572.63653239433,917,2,233.825,37,3,20,37.59753685724559,0.6097972972972974,45.88815789473683,1016.4473684210508,27.471550497866236,0
4478,4,0,0,40,0.0,0.0,1.0,40,1150,800,350,0.6956521739130435,15,8,7,325.4427511011934,0.4356837606837607,0.14281975421028714,0.1810120820681825,129319.08543381325,417.21583255434206,129736.30126636759,918,3,234.825,35,5,20,37.44215597026246,0.6154761904761905,45.71759259259258,1017.1296296296281,29.060846560846517,0
4479,4,1,0,41,0.024390243902439025,0.0,1.0,41,950,700,250,0.7368421052631579,12,7,5,320.3274140029159,0.43622967479674796,0.1571881640974746,0.17971719182644966,129659.75265806333,106.71465384301487,129766.46731190634,919,0,230.0731707317073,36,5,14,37.22679861418253,0.6168981481481481,45.382882882882875,1018.4684684684673,28.29079079079076,0
4480,4,0,0,41,0.0,0.0,1.0,41,850,400,450,0.47058823529411764,13,4,9,320.29433786784375,0.43544207317073175,0.15604473206849412,0.18035740282303142,129803.15778193726,115.04329498416138,129918.20107692142,920,1,231.0731707317073,36,5,15,37.08236637565844,0.6183449074074074,45.24211711711711,1019.0315315315308,28.306431431431413,0
4481,4,0,0,41,0.0,0.0,1.0,41,1250,1000,250,0.8,15,10,5,318.6631170459206,0.4353658536585366,0.15054902968905015,0.18000787741755553,129927.00277970113,80.5887388426915,130007.59151854382,921,2,232.0731707317073,37,4,15,36.99854807485484,0.6176801801801801,45.120614035087705,1019.5175438596466,27.55452821242288,0
4482,4,0,2,39,0.0,0.04878048780487805,0.9512195121951219,41,1100,900,200,0.8181818181818182,13,9,4,353.52528491159086,0.4345274390243902,0.02831005752043514,0.19508110570017145,129006.37846500798,1094.5335343566715,130100.91199936465,922,3,233.0731707317073,37,4,20,37.046568627450974,0.6083896396396397,46.02521929824559,1015.8991228070136,27.456733048838203,8
4483,4,1,0,40,0.025,0.0,1.0,40,850,500,350,0.5882352941176471,12,5,7,346.2319229036686,0.4312900641025641,0.07410289068556875,0.1921406288812056,129230.01284646094,948.8584498332865,130178.87129629424,923,0,239.525,36,4,21,37.0041440543434,0.6125578703703703,45.80518018018016,1016.7792792792762,28.243868868868784,0
4484,4,1,3,38,0.024390243902439025,0.07317073170731707,0.926829268292683,41,1050,600,450,0.5714285714285714,15,6,9,338.3718030662785,0.43442581300813005,0.07774817243970755,0.1889751549976648,129480.23069598296,562.4918244074628,130042.72252039042,924,0,234.65853658536585,37,4,13,36.949651655534005,0.6131756756756757,45.559210526315766,1017.7631578947335,27.507112375533335,0
4485,4,0,0,38,0.0,0.0,1.0,38,1500,1300,200,0.8666666666666667,17,13,4,358.0697080889768,0.42806128496917967,0.08844812920076217,0.19886222852526833,129260.23046339137,1656.8345979080634,130917.06506129944,925,2,252.6578947368421,35,3,22,36.67245238637225,0.6148809523809524,45.77546296296295,1016.898148148146,29.054232804232743,0
4486,4,0,0,38,0.0,0.0,1.0,38,1100,900,200,0.8181818181818182,13,9,4,354.6334609362341,0.4274834044570887,0.08750276898023657,0.19769072638493548,129407.39300679434,1578.4383305469712,130985.83133734131,926,3,253.6578947368421,35,3,22,36.610003602168874,0.6163690476190475,45.63078703703703,1017.4768518518513,29.07076719576718,0
4487,4,1,1,38,0.02564102564102564,0.02564102564102564,0.9743589743589743,39,1000,400,600,0.4,16,4,12,344.39632489850743,0.42881241565452094,0.09899985833687497,0.19407140350756488,129831.84831791246,1142.7222830939031,130974.57060100636,927,0,248.12820512820514,36,3,17,36.43922651933701,0.6186342592592593,45.21396396396396,1019.1441441441439,28.309559559559553,0
4488,4,0,1,37,0.0,0.02631578947368421,0.9736842105263158,38,1050,800,250,0.7619047619047619,13,8,5,350.74380165289267,0.4260016595542911,0.10143540669856455,0.19684601113172548,129672.49657064475,1496.3648834019286,131168.86145404668,928,1,255.55263157894737,35,3,17,36.439393939393945,0.6190476190476191,45.370370370370374,1018.5185185185188,29.10052910052911,0
4489,4,1,0,38,0.02631578947368421,0.0,1.0,38,1000,600,400,0.6,14,6,8,350.6006107835534,0.4257053105737316,0.12200956937798968,0.19840346702722486,129996.88042534732,1515.3971354166724,131512.277560764,929,0,255.92105263157896,35,3,20,36.11359380320052,0.6223214285714286,45.052083333333336,1019.7916666666674,29.136904761904784,0
4490,4,0,0,38,0.0,0.0,1.0,38,1450,1100,350,0.7586206896551724,18,11,7,352.67093981903895,0.4255423186344239,0.1277103830356292,0.20033163694875303,130144.4615912208,1579.633916323727,131724.09550754452,930,1,256.92105263157896,35,3,20,35.91103297035693,0.6238095238095238,44.907407407407405,1020.3703703703699,29.153439153439137,0
4491,4,2,0,40,0.05,0.0,1.0,40,900,600,300,0.6666666666666666,12,6,6,340.1565815294833,0.42855235042735046,0.1409456186701894,0.1965637650517702,130809.21292914549,899.1765241843618,131708.38945332984,931,0,245.025,36,4,15,35.55748201966828,0.6284722222222222,44.256756756756765,1022.972972972974,28.415915915915946,0
4492,4,0,0,40,0.0,0.0,1.0,40,1300,800,500,0.6153846153846154,18,8,10,339.25477304354285,0.42885950854700855,0.14113488832654864,0.19677642834669828,130953.25213304524,885.3031663420251,131838.55529938726,932,1,246.025,36,4,16,35.43500385080868,0.6299189814814814,44.115990990990994,1023.5360360360364,28.43155655655657,0
4493,4,0,1,39,0.0,0.025,0.975,40,750,600,150,0.8,9,6,3,338.9448989362674,0.42844551282051285,0.14275540801028064,0.19707767535908266,131047.29940943375,883.5627308402676,131930.86214027402,933,2,247.025,37,3,17,35.34795102448776,0.6289414414414414,44.02412280701755,1023.9035087719304,27.67306780464677,0
4494,4,1,0,40,0.025,0.0,1.0,40,1450,900,550,0.6206896551724138,20,9,11,340.55813631264033,0.42995459401709407,0.14931246655965724,0.19903163125963902,131243.84576263875,939.2319030855895,132183.07766572436,934,0,247.9,37,3,18,35.10823524166222,0.6309121621621622,43.832236842105274,1024.6710526315808,27.693812233285968,0
4495,4,0,0,40,0.0,0.0,1.0,40,950,600,350,0.631578947368421,13,6,7,378.9325292794802,0.4299946581196581,0.19417470021161543,0.2047776425699654,128174.66695011327,1760.1353080186213,129934.8022581319,935,1,248.9,34,6,18,37.252380672466494,0.6060049019607843,46.84523809523809,1012.6190476190467,29.78291316526608,8
4496,4,1,0,41,0.024390243902439025,0.0,1.0,41,1300,800,500,0.6153846153846154,18,8,10,367.2849070788505,0.4323932926829268,0.19661420914284822,0.20069419228508237,128616.7994599299,1247.8018476838936,129864.60130761379,936,0,243.8048780487805,37,4,14,37.09497621878716,0.6044481981981982,46.40899122807017,1014.3640350877187,27.415244191559964,0
4497,4,0,0,41,0.0,0.0,1.0,41,1500,1200,300,0.8,18,12,6,367.6937652632879,0.4324441056910569,0.18303484395829095,0.20190444121041026,128811.51532202207,1272.6382156047919,130084.15353762686,937,1,244.8048780487805,37,4,15,36.885666450637295,0.6064189189189189,46.21710526315789,1015.1315789473676,27.435988620199126,0
4498,4,1,0,42,0.023809523809523808,0.0,1.0,42,1050,800,250,0.7619047619047619,13,8,5,362.33084776492586,0.43568524970963995,0.18471594294325877,0.20023990081883836,129065.65176647305,952.893404375774,130018.54517084883,938,0,239.95238095238096,38,4,16,36.762476781270806,0.6071820175438596,45.96688034188034,1016.1324786324784,26.740328385065222,0
4499,4,1,0,43,0.023255813953488372,0.0,1.0,43,1000,700,300,0.7,13,7,6,354.9514898035212,0.4385612772240679,0.18458268371792252,0.19767346472971606,129368.65790435519,584.0622498345238,129952.72015418971,939,0,235.34883720930233,37,6,18,36.6413379320256,0.6120495495495495,45.66885964912281,1017.3245614035087,27.495258416311046,0
4500,4,1,1,43,0.022727272727272728,0.022727272727272728,0.9772727272727273,44,1350,900,450,0.6666666666666666,18,9,9,350.54362587498605,0.4392507928118394,0.1920701959800395,0.19743052918451293,129811.04736328126,300.8870442708331,130111.9344075521,940,0,230.97727272727272,39,5,15,36.303728406419296,0.6129807692307692,45.234375,1019.0625000000001,26.129807692307697,0
4501,4,1,1,43,0.022727272727272728,0.022727272727272728,0.9772727272727273,44,1150,600,550,0.5217391304347826,17,6,11,355.6591481908667,0.4362006694855532,0.20491681521093286,0.20154018397482454,130050.00000000001,450.6944444444454,130500.69444444447,941,0,231.9318181818182,39,5,16,35.930691721132895,0.6153846153846154,45.0,1020.0000000000001,26.153846153846157,0
4502,4,0,1,42,0.0,0.023255813953488372,0.9767441860465116,43,1350,1000,350,0.7407407407407407,17,10,7,358.4859266846375,0.4327473237356958,0.20795783361424736,0.20325555985658658,130071.79578493678,725.7816494995957,130797.57743443637,942,1,238.25581395348837,38,5,16,35.836475352604374,0.6173245614035088,44.97863247863248,1020.0854700854699,26.844354475933418,0
4503,4,0,1,41,0.0,0.023809523809523808,0.9761904761904762,42,950,700,250,0.7368421052631579,12,7,5,363.885557993917,0.43155971738288806,0.21559097679703898,0.20629051468722825,130066.77685682157,1065.8843346029805,131132.66119142456,943,2,244.66666666666666,37,5,16,35.70387240675051,0.6190878378378378,44.98355263157896,1020.0657894736861,27.569345661450974,0
4504,4,0,0,41,0.0,0.0,1.0,41,1350,900,450,0.6666666666666666,18,9,9,370.3456892961265,0.43150406504065036,0.2098556495769035,0.2110109159943048,130262.58680555563,1448.4375000000114,131711.02430555565,944,3,249.85365853658536,36,5,16,35.34013605442177,0.622974537037037,44.79166666666667,1020.833333333334,28.356481481481502,0
4505,4,2,0,43,0.046511627906976744,0.0,1.0,43,1350,1200,150,0.8888888888888888,15,12,3,357.4309286586501,0.43466223698781836,0.22076084573842736,0.20752333022121613,130991.1703601107,764.0591335795535,131755.22949369025,945,0,239.1860465116279,37,6,16,34.93153741788061,0.6283783783783784,44.07894736842105,1023.6842105263149,27.66714082503554,0
4506,4,0,0,43,0.0,0.0,1.0,43,1050,700,350,0.6666666666666666,14,7,7,354.5290253940518,0.4343623108157992,0.2195494263864719,0.20628950580405295,131075.36844269387,694.0045254308992,131769.37296812478,946,1,240.1860465116279,37,6,16,34.920650854838144,0.629222972972973,43.99671052631579,1024.0131578947364,27.676031294452336,0
4507,4,0,0,43,0.0,0.0,1.0,43,850,500,350,0.5882352941176471,12,5,7,355.8339240446702,0.43438538205980065,0.22373671123014627,0.20765498765455034,131187.6746330601,736.2050101954347,131923.87964325552,947,2,241.1860465116279,37,6,16,34.77369420956866,0.6303490990990991,43.88706140350877,1024.4517543859643,27.68788525367471,0
4508,4,0,0,43,0.0,0.0,1.0,43,1350,900,450,0.6666666666666666,18,9,9,354.73348839481963,0.434108527131783,0.22725304694459503,0.2074680339510628,131271.93583602645,713.3103454909162,131985.24618151737,948,3,242.1860465116279,37,6,17,34.71672373207789,0.6311936936936937,43.80482456140351,1024.7807017543857,27.696775723091505,0
4509,4,0,0,43,0.0,0.0,1.0,43,1200,900,300,0.75,15,9,6,348.7322465190986,0.43362403100775193,0.12817665535074085,0.195130333357633,129554.63927469129,494.708093943428,130049.34736863471,949,4,243.1860465116279,38,5,15,36.61039108685765,0.6121162280701755,45.48611111111111,1018.0555555555551,26.790935672514607,8
4510,4,0,1,42,0.0,0.023255813953488372,0.9767441860465116,43,1600,1400,200,0.875,18,14,4,351.1040543446709,0.43332410483573275,0.11572292066093981,0.19713934358787338,129690.6332182774,506.981426692965,130197.61464497037,950,5,244.1860465116279,38,5,15,36.411789385357686,0.6134868421052632,45.3525641025641,1018.5897435897432,26.804993252361662,0
4511,4,1,0,43,0.023255813953488372,0.0,1.0,43,1250,900,350,0.72,16,9,7,348.61792722494044,0.4351467331118494,0.1293961092452951,0.19683504506392785,129908.37191358021,457.6774691357966,130366.04938271601,951,0,245.04651162790697,38,5,16,36.2539736603088,0.6156798245614035,45.138888888888886,1019.4444444444441,26.82748538011695,0
4512,4,0,3,40,0.0,0.06976744186046512,0.9302325581395349,43,1650,1000,650,0.6060606060606061,23,10,13,354.8708388273434,0.4350083056478405,0.12991985036787046,0.20134650267155665,130099.04308431942,633.6713099934184,130732.71439431283,952,1,246.04651162790697,38,5,18,35.9010105770238,0.6175986842105263,44.95192307692307,1020.1923076923068,26.847165991902813,0
4513,4,1,2,39,0.024390243902439025,0.04878048780487805,0.9512195121951219,41,900,400,500,0.4444444444444444,14,4,10,359.8341203358525,0.4326981707317073,0.17549130458191975,0.20426673748388635,130118.92804967135,1164.2460027595218,131283.17405243087,953,0,258.0243902439024,36,5,20,35.754231052244286,0.6215277777777778,44.932432432432435,1020.2702702702708,28.340840840840855,0
4514,4,0,1,38,0.0,0.02564102564102564,0.9743589743589743,39,1200,800,400,0.6666666666666666,16,8,8,366.62663638137394,0.42780026990553305,0.16385113014326547,0.20747253006784072,129996.88042534699,1732.063802083308,131728.9442274303,954,1,249.17948717948718,35,4,20,35.70501361933946,0.6223214285714286,45.05208333333332,1019.7916666666647,29.136904761904706,0
4515,4,0,0,38,0.0,0.0,1.0,38,1100,900,200,0.8181818181818182,13,9,4,371.35532431664353,0.4271129682313893,0.17184649685831999,0.21059852905819457,130080.3589143991,2061.2067743764164,132141.5656887755,955,2,255.31578947368422,34,4,21,35.49957210098416,0.6253063725490196,44.970238095238095,1020.1190476190477,30.003501400560225,0
4516,4,1,0,39,0.02564102564102564,0.0,1.0,39,600,400,200,0.6666666666666666,8,4,4,363.2021462935094,0.42979644624381463,0.17002580375200504,0.20757096754494336,130380.76560356647,1670.9147805212574,132051.68038408773,956,0,249.74358974358975,35,4,23,35.40250075551526,0.6261904761904762,44.675925925925924,1021.2962962962958,29.179894179894166,0
4517,4,0,1,38,0.0,0.02564102564102564,0.9743589743589743,39,1150,1000,150,0.8695652173913043,13,10,3,371.09375,0.42979644624381463,0.18164715719063573,0.21337890625,130617.28395061725,1894.2515432098724,132511.5354938271,957,1,250.74358974358975,35,4,15,34.96093750000001,0.6285714285714286,44.44444444444444,1022.222222222222,29.2063492063492,0
4518,4,0,0,38,0.0,0.0,1.0,38,1500,1100,400,0.7333333333333333,19,11,8,378.6351090486074,0.42629800853485067,0.18847132391257704,0.21743026161754492,130566.58340419513,2287.4185090703113,132854.00191326544,958,5,258.3157894736842,34,4,16,34.819695204814614,0.6302083333333333,44.49404761904763,1022.0238095238104,30.059523809523835,0
4519,4,0,0,38,0.0,0.0,1.0,38,1150,800,350,0.6956521739130435,15,8,7,378.6733092988291,0.4261794689426268,0.18750650925999635,0.2184810208318497,130749.15143140589,2302.2427721088416,133051.39420351473,959,6,259.3157894736842,34,4,17,34.633385713731414,0.632046568627451,44.31547619047619,1022.7380952380952,30.080532212885153,0
4520,4,1,0,39,0.02564102564102564,0.0,1.0,39,1000,700,300,0.7,13,7,6,370.7379442724054,0.42794084570400365,0.18062317429406072,0.21580850861330525,131090.9636488339,1920.0788751714508,133011.04252400534,960,0,253.64102564102564,35,4,18,34.489903556359245,0.6333333333333333,43.981481481481474,1024.074074074073,29.259259259259228,0
4521,4,0,1,38,0.0,0.02564102564102564,0.9743589743589743,39,1250,900,350,0.72,16,9,7,370.5193543717049,0.4281376518218623,0.17108693385241103,0.21634810850252828,131209.51753257867,1923.1331447187758,133132.65067729744,961,1,254.64102564102564,35,4,18,34.3754707034192,0.6345238095238095,43.86574074074073,1024.5370370370356,29.27248677248673,0
4522,4,0,1,37,0.0,0.02631578947368421,0.9736842105263158,38,600,300,300,0.5,9,3,6,378.02866844848626,0.4259868421052631,0.18129844546272111,0.22018826233326533,131114.670138889,2313.0208333333517,133427.69097222234,962,2,262.13157894736844,34,4,18,34.279224301600216,0.6357230392156863,43.95833333333334,1024.1666666666677,30.122549019607874,0
4523,4,0,0,37,0.0,0.0,1.0,37,1100,800,300,0.7272727272727273,14,8,6,375.0854202481782,0.42627002002002,0.16067357154970452,0.21899492039727433,131206.12953514748,2442.701247165549,133648.83078231305,963,3,259.5945945945946,34,3,18,34.261949027810076,0.6366421568627452,43.86904761904763,1024.5238095238103,30.133053221288538,0
4524,4,0,0,37,0.0,0.0,1.0,37,700,500,200,0.7142857142857143,9,5,4,377.595709360014,0.42627002002002,0.16570380789711625,0.2208114039518345,131267.12018140606,2513.180272108858,133780.3004535149,964,4,260.5945945945946,34,3,18,34.13588135068153,0.6372549019607843,43.80952380952382,1024.761904761906,30.140056022409,0
4525,4,0,0,37,0.0,0.0,1.0,37,1600,1400,200,0.875,18,14,4,378.38629302753066,0.425269019019019,0.17034198913233078,0.22199016321657247,131390.93888168025,2543.3202325047782,133934.25911418503,965,5,261.5945945945946,33,4,21,33.990258187903414,0.6407828282828283,43.688725490196084,1025.2450980392166,31.068033273915656,0
4526,4,1,0,38,0.02631578947368421,0.0,1.0,38,750,300,450,0.4,12,3,9,369.1864142351154,0.4268166192508298,0.17165071770334883,0.21867195304695308,131755.55555555562,2128.4722222222267,133884.02777777784,966,0,255.68421052631578,34,4,17,33.857548701298704,0.642156862745098,43.333333333333336,1026.6666666666672,30.196078431372566,0
4527,4,0,0,38,0.0,0.0,1.0,38,1150,800,350,0.6956521739130435,15,8,7,367.1736097544612,0.4260016595542911,0.16688009561616912,0.21870775885374405,131969.5312499999,2091.145833333319,134060.67708333323,967,1,256.6842105263158,34,4,19,33.69322789943227,0.6443014705882353,43.12499999999999,1027.4999999999993,30.220588235294098,0
4528,4,0,0,38,0.0,0.0,1.0,38,850,400,450,0.47058823529411764,13,4,9,366.2309154532428,0.42604611190137504,0.1656404128588589,0.21849837547393516,132030.69905045332,2070.7447562358116,134101.44380668912,968,2,257.6842105263158,34,4,19,33.65573960384572,0.6449142156862745,43.06547619047618,1027.7380952380938,30.227591036414523,0
4529,4,1,0,39,0.02564102564102564,0.0,1.0,39,900,600,300,0.6666666666666666,12,6,6,357.68238537892324,0.42622582096266304,0.15829317460180192,0.21531171891699416,132368.22601862552,1669.1565661436766,134037.3825847692,969,0,252.05128205128204,35,4,20,33.535433771979164,0.6461309523809524,42.73726851851851,1029.0509259259247,29.401455026454993,0
4530,4,0,2,37,0.0,0.05128205128205128,0.9487179487179487,39,800,400,400,0.5,12,4,8,355.5213165270698,0.42597278452541615,0.15737568774006006,0.21417991507850284,132398.00347222204,1614.062499999976,134012.06597222202,970,1,253.05128205128204,35,4,20,33.56106612685559,0.6464285714285714,42.70833333333332,1029.1666666666652,29.404761904761862,0
4531,4,0,0,37,0.0,0.0,1.0,37,1200,900,300,0.75,15,9,6,371.8452491621922,0.4234234234234234,0.16455154069833,0.22308057013711768,132240.39619677508,2434.5926146193583,134674.98881139443,971,2,263.6756756756757,33,4,20,33.29994737678225,0.6493055555555556,42.86151960784313,1028.553921568626,31.168300653594727,0
4532,4,0,0,37,0.0,0.0,1.0,37,900,700,200,0.7777777777777778,11,7,4,368.6375388879652,0.4223285785785786,0.07423113821485972,0.21425543160334684,131031.70680084013,2260.6411822702257,133292.34798311035,972,3,264.6756756756757,35,2,19,34.60368151330168,0.6327380952380952,44.03935185185185,1023.842592592592,29.252645502645485,8
4533,4,0,0,37,0.0,0.0,1.0,37,1350,1000,350,0.7407407407407407,17,10,7,371.93875251659216,0.4214214214214214,0.07413267035823279,0.21667452409607135,131120.5970963006,2353.766262645751,133474.36335894634,973,4,265.6756756756757,35,2,19,34.429149244735754,0.6336309523809525,43.9525462962963,1024.189814814815,29.262566137566143,0
4534,4,0,1,36,0.0,0.02702702702702703,0.972972972972973,37,1100,700,400,0.6363636363636364,15,7,8,369.0165410732097,0.4211086086086086,0.07040279461474785,0.21530424555299787,131179.87403817297,2281.508675197184,133461.38271337017,974,5,266.6756756756757,35,2,19,34.4439658419011,0.6342261904761906,43.894675925925924,1024.421296296296,29.26917989417989,0
4535,4,0,0,36,0.0,0.0,1.0,36,900,700,200,0.7777777777777778,11,7,4,370.2273726769665,0.41860119047619043,0.08195848340498069,0.21633041389210114,131236.62308673467,2517.4780328798206,133754.1011196145,975,6,274.8611111111111,34,2,19,34.355514890980224,0.6369485294117647,43.839285714285715,1024.642857142857,30.136554621848738,0
4536,4,0,0,36,0.0,0.0,1.0,36,1350,1000,350,0.7407407407407407,17,10,7,371.2062312748619,0.41800595238095234,0.08424302249061255,0.21759406790386918,131358.63272392296,2552.228599773243,133910.8613236962,976,7,275.8611111111111,34,2,19,34.20697363836952,0.6381740196078431,43.720238095238095,1025.119047619048,30.150560224089645,0
4537,4,0,0,36,0.0,0.0,1.0,36,1050,600,450,0.5714285714285714,15,6,9,369.0306259500883,0.41727843915343915,0.08764801485953089,0.2168369585221051,131450.17715419497,2501.8282312925153,133952.0053854875,977,8,276.8611111111111,34,2,19,34.170149369243845,0.639093137254902,43.63095238095238,1025.4761904761904,30.161064425770306,0
4538,4,0,0,36,0.0,0.0,1.0,36,500,200,300,0.4,8,2,6,371.3837226244024,0.4169808201058201,0.08743423088827029,0.21856845315108256,131511.22448979586,2568.225623582763,134079.4501133786,978,9,277.8611111111111,34,2,19,34.04808882698856,0.6397058823529411,43.57142857142857,1025.714285714285,30.168067226890738,0
4539,4,0,2,34,0.0,0.05555555555555555,0.9444444444444444,36,1350,1000,350,0.7407407407407407,17,10,7,366.8533159710328,0.41622023809523806,0.1084526359298088,0.21739183473473828,131773.38023244598,2468.300298996912,134241.6805314429,979,10,278.8611111111111,35,1,16,33.89943354751438,0.6401785714285715,43.31597222222222,1026.736111111111,29.33531746031746,8
4540,4,0,0,34,0.0,0.0,1.0,34,800,600,200,0.75,10,6,4,378.728129096853,0.41325014854426617,0.11648070599477278,0.2232895701971024,131579.47063629376,3166.5693483275722,134746.03998462134,980,11,285.47058823529414,33,1,16,33.7907111004937,0.6426767676767677,43.504901960784316,1025.980392156863,31.090314913844335,0
4541,4,1,1,34,0.02857142857142857,0.02857142857142857,0.9714285714285714,35,1500,1400,100,0.9333333333333333,16,14,2,371.1619024990499,0.41638655462184876,0.11123430027634829,0.2214402698185414,132030.69905045338,2800.953089569145,134831.65214002252,981,0,278.2857142857143,34,1,17,33.52904552299316,0.6449142156862745,43.06547619047618,1027.7380952380943,30.227591036414537,0
4542,4,0,1,33,0.0,0.029411764705882353,0.9705882352941176,34,750,500,250,0.6666666666666666,10,5,5,377.2502169783274,0.416369578134284,0.10436862558044946,0.22500855758038774,132019.90370290267,3160.907463475577,135180.81116637823,982,1,281.29411764705884,33,1,18,33.383516177756576,0.6470959595959596,43.07598039215686,1027.696078431372,31.14230540701127,0
4543,4,1,0,34,0.029411764705882353,0.0,1.0,34,900,600,300,0.6666666666666666,12,6,6,378.2769934221933,0.41869058229352346,0.09687600008170905,0.22678243901279146,132214.2874858276,3202.724631519269,135417.01211734687,983,0,275.5882352941176,34,0,19,33.160907898290695,0.6467524509803921,42.88690476190476,1028.4523809523805,30.248599439775898,0
4544,4,0,0,34,0.0,0.0,1.0,34,1050,600,450,0.5714285714285714,15,6,9,382.2698271890281,0.4178735888294712,0.09730757974831761,0.22992053697945525,132336.75063775515,3317.669359410437,135654.4199971656,984,1,276.5882352941176,34,0,20,32.934648463110804,0.6479779411764706,42.767857142857146,1028.9285714285718,30.262605042016816,0
4545,4,0,0,34,0.0,0.0,1.0,34,750,600,150,0.8,9,6,3,382.8843544926489,0.4171865715983363,0.09746995572422534,0.23086962793778718,132431.5071105957,3341.2329399126183,135772.74005050832,985,2,277.5882352941176,31,3,20,32.8232395108581,0.65625,42.67578125,1029.296875,33.203125,0
4546,4,0,0,34,0.0,0.0,1.0,34,1100,700,400,0.6363636363636364,15,7,8,372.93400079078566,0.4169637551990493,0.06768571227774278,0.219511785275589,131516.61169982696,3047.6561708021272,134564.2678706291,986,3,278.5882352941176,33,1,20,34.002887295898034,0.6420454545454546,43.56617647058823,1025.7352941176468,31.08288770053475,8
4547,4,1,0,35,0.02857142857142857,0.0,1.0,35,1450,1100,350,0.7586206896551724,18,11,7,363.35427494968235,0.421218487394958,0.06462506207581531,0.21625844088384538,131938.95266439902,2588.116496598628,134527.06916099766,987,0,271.6,34,1,20,33.822180378524514,0.6439950980392157,43.1547619047619,1027.3809523809518,30.217086834733877,0
4548,4,0,0,35,0.0,0.0,1.0,35,1650,1300,350,0.7878787878787878,20,13,7,367.8854273834023,0.4201330532212885,0.07205687830687868,0.22073125643004113,132244.8979591835,2730.1941609977134,134975.09212018122,988,1,272.6,34,1,20,33.39723186728395,0.6470588235294117,42.85714285714285,1028.571428571427,30.25210084033609,0
4549,4,0,0,35,0.0,0.0,1.0,35,1100,800,300,0.7272727272727273,14,8,6,368.3063154616536,0.41911764705882354,0.06778484673221574,0.22188209736348366,132398.00347222202,2752.692743764148,135150.69621598616,989,2,273.6,33,2,20,33.23211875843457,0.6508838383838385,42.70833333333332,1029.166666666665,31.186868686868635,0
4550,4,0,0,35,0.0,0.0,1.0,35,1050,700,350,0.6666666666666666,14,7,7,368.5929705215422,0.41922268907563026,0.06706122448979634,0.22242679255610273,132461.07266435964,2764.8440503652196,135225.91671472485,990,3,274.6,33,2,20,33.16121031746032,0.6515151515151515,42.6470588235294,1029.4117647058806,31.1942959001782,0
4551,4,0,0,35,0.0,0.0,1.0,35,650,500,150,0.7692307692307693,8,5,3,370.47718940656443,0.41876750700280113,0.07096269595674531,0.22393880182690315,132524.15687475962,2819.435433487107,135343.59230824673,991,4,275.6,33,2,20,33.04917479965087,0.6521464646464646,42.58578431372548,1029.6568627450972,31.201723113487795,0
4552,4,0,0,35,0.0,0.0,1.0,35,600,500,100,0.8333333333333334,7,5,2,368.1649287121969,0.4189775910364146,0.06641015902372982,0.2228827710489303,132581.84700963707,2762.3972505668808,135344.24426020397,992,5,276.6,34,1,21,33.050610719377325,0.6504289215686274,42.5297619047619,1029.8809523809516,30.290616246498576,0
4553,4,0,0,35,0.0,0.0,1.0,35,650,500,150,0.7692307692307693,8,5,3,367.83496192959865,0.41876750700280113,0.06953305594082315,0.2228647122279332,132612.49999999988,2755.902777777764,135368.40277777764,993,6,277.6,34,1,22,33.02824973031284,0.6507352941176471,42.49999999999999,1029.999999999999,30.294117647058798,0
4554,4,0,1,34,0.0,0.02857142857142857,0.9714285714285714,35,500,400,100,0.8,6,4,2,369.1315947482136,0.418312324929972,0.07311749847286664,0.22383291446084727,132643.15653344663,2792.5559807256095,135435.71251417225,994,7,278.6,34,1,17,32.964000924534844,0.6510416666666667,42.47023809523809,1030.1190476190468,30.297619047619023,0
4555,4,0,0,34,0.0,0.0,1.0,34,1000,600,400,0.6,14,6,8,373.214778202947,0.41675950683303625,0.05732339303573086,0.22730698765133872,132808.22167255386,3113.1981990100016,135921.41987156385,995,8,282.05882352941177,33,1,17,32.692679229580314,0.6549873737373737,42.310049019607845,1030.7598039215688,31.235145573380873,0
4556,4,0,0,34,0.0,0.0,1.0,34,700,300,400,0.42857142857142855,11,3,8,373.06938053985755,0.41640671420083186,0.05827809012335328,0.2274101180508178,132839.8032006922,3111.692618223779,135951.49581891598,996,9,283.05882352941177,33,1,18,32.66464574417499,0.6553030303030303,42.27941176470589,1030.8823529411777,31.23885918003569,0
4557,4,0,0,34,0.0,0.0,1.0,34,1100,800,300,0.7272727272727273,14,8,6,370.43102762798367,0.4150141117052882,0.0651839633191682,0.22656595410734817,132966.16685890043,3050.9587658592836,136017.1256247597,997,10,284.05882352941177,33,1,18,32.605552915082384,0.6565656565656566,42.15686274509804,1031.3725490196077,31.25371360665478,0
4558,4,0,0,34,0.0,0.0,1.0,34,1450,1100,350,0.7586206896551724,18,11,7,368.79414946132016,0.41382575757575757,0.06567533211337229,0.22671418443527291,133155.8249831796,3021.4178440984306,136177.24282727804,998,11,285.05882352941177,33,1,20,32.45715586163223,0.658459595959596,41.97303921568628,1032.1078431372555,31.2759952465835,0
4559,4,0,2,32,0.0,0.058823529411764705,0.9411764705882353,34,1250,800,450,0.64,17,8,9,372.84036294799176,0.4134172608437314,0.06069493324395281,0.22959117086797415,133219.07439446382,3133.8896097654947,136352.96400422932,999,12,286.05882352941177,33,1,20,32.2891935739158,0.6590909090909092,41.91176470588236,1032.3529411764719,31.283422459893085,0
4560,4,0,0,32,0.0,0.0,1.0,32,650,500,150,0.7692307692307693,8,5,3,395.58344684315466,0.40570396505376344,-0.001279149094517651,0.2211646150103688,129522.50567544151,3847.3918477706666,133369.8975232122,1000,17,304.0,32,0,18,35.45077730918714,0.6243489583333333,45.51767676767678,1017.9292929292949,31.810290404040465,8
4561,4,0,0,32,0.0,0.0,1.0,32,1150,700,450,0.6086956521739131,16,7,9,393.94826601662544,0.4057669690860215,-0.007286630717738607,0.2211538386886654,129683.21352731883,3817.695420110221,133500.90894742907,1001,18,305.0,32,0,18,35.32834387008803,0.6259765625,45.3598484848485,1018.5606060606076,31.830018939393987,0
4562,4,0,0,32,0.0,0.0,1.0,32,1200,800,400,0.6666666666666666,16,8,8,392.5761114412458,0.40498991935483875,-0.0030669144981410046,0.22092672380270978,129779.68606519763,3789.6808999082014,133569.36696510584,1002,19,306.0,32,0,20,35.26486988847584,0.626953125,45.26515151515153,1018.9393939393956,31.841856060606112,0
4563,4,1,0,33,0.030303030303030304,0.0,1.0,33,1000,600,400,0.6,14,6,8,385.67263640149906,0.4077099116161616,-0.0029684601113171283,0.21974371143806376,130262.58680555574,3447.743055555579,133710.32986111133,1003,0,297.6969696969697,33,0,21,34.94897959183674,0.6294191919191919,44.79166666666668,1020.8333333333348,30.93434343434348,0
4564,4,1,1,33,0.029411764705882353,0.029411764705882353,0.9705882352941176,34,950,400,550,0.42105263157894735,15,4,11,373.45490851180455,0.41200609031491386,-0.002517272192315012,0.2149157351968787,130649.5530589992,2958.343376951349,133607.89643595053,1004,0,289.9117647058824,32,2,18,34.86785229097197,0.6357421875,44.412878787878796,1022.3484848484859,31.948390151515184,0
4565,4,1,0,34,0.029411764705882353,0.0,1.0,34,450,400,50,0.8888888888888888,5,4,1,374.11103241617565,0.4103721033868093,0.012337478493804399,0.21637556714263173,130843.25140610657,2989.980773645553,133833.2321797521,1005,0,290.88235294117646,32,2,19,34.65460323337035,0.6376953125,44.22348484848485,1023.106060606061,31.972064393939405,0
4566,4,0,0,34,0.0,0.0,1.0,34,1150,800,350,0.6956521739130435,15,8,7,374.67160312904434,0.41003787878787884,0.016242317822651398,0.21742753661898104,130972.46334876557,3014.3325617284104,133986.79591049397,1006,1,291.88235294117646,32,2,20,34.50927182270464,0.6389973958333333,44.09722222222223,1023.6111111111122,31.987847222222257,0
4567,4,0,0,34,0.0,0.0,1.0,34,900,600,300,0.6666666666666666,12,6,6,373.0791366449374,0.4096293820558527,0.010330923147215065,0.21723222378514628,131101.73906042744,2982.264724262822,134084.00378469026,1007,2,292.88235294117646,32,2,21,34.41905026096248,0.6402994791666667,43.97095959595959,1024.116161616161,32.00363005050503,0
4568,4,0,1,33,0.0,0.029411764705882353,0.9705882352941176,34,900,600,300,0.6666666666666666,12,6,6,370.55163830797915,0.40914661319073087,0.017019472566653704,0.21685419236812287,131295.77219480145,2930.3726979389667,134226.1448927404,1008,3,293.88235294117646,32,2,22,34.287349595499144,0.6422526041666667,43.78156565656565,1024.8737373737365,32.027304292929266,0
4569,4,0,0,33,0.0,0.0,1.0,33,700,600,100,0.8571428571428571,8,6,2,381.13905912062205,0.4071969696969697,-0.014634490720553561,0.207086501444764,128390.74315200625,3249.299537355893,131640.04268936213,1009,4,302.6060606060606,29,4,20,36.97509821387786,0.6210488505747127,46.63194444444445,1013.4722222222229,34.94731800766286,8
4570,4,2,0,35,0.05714285714285714,0.0,1.0,35,1050,900,150,0.8571428571428571,12,9,3,357.59706548799187,0.41516106442577033,-0.01099007170435784,0.19705880842848936,128952.32602845074,2222.5946751249653,131174.9207035757,1010,0,286.25714285714287,33,2,22,36.998270592020575,0.6161616161616161,46.078431372549026,1015.6862745098051,30.77837195484258,0
4571,4,0,0,35,0.0,0.0,1.0,35,800,600,200,0.75,10,6,4,354.1636429234675,0.41456582633053224,-0.010586350087013363,0.1956276324769135,129045.6964418734,2140.6587910899752,131186.35523296337,1011,1,287.25714285714287,33,2,22,36.990285651107655,0.6171085858585859,45.98651960784314,1016.0539215686281,30.789512774806912,0
4572,4,0,0,35,0.0,0.0,1.0,35,1750,1400,350,0.8,21,14,7,355.28897350384295,0.41484593837535017,-0.015041328177657798,0.19734464776551386,129265.58036169775,2185.4209353560154,131451.00129705376,1012,2,288.25714285714287,32,3,22,36.73769762436886,0.6217447916666667,45.77020202020202,1016.9191919191917,31.77872474747474,0
4573,4,0,0,35,0.0,0.0,1.0,35,1350,1100,250,0.8148148148148148,16,11,5,353.78446779175283,0.41414565826330535,-0.013067909878928585,0.19731135127569144,129426.12879106747,2157.7908185389515,131583.9196096064,1013,3,289.25714285714287,32,3,19,36.612534640360664,0.6233723958333333,45.61237373737375,1017.550505050507,31.798453282828344,0
4574,4,0,0,35,0.0,0.0,1.0,35,1100,800,300,0.7272727272727273,14,8,6,349.05012011972883,0.4129201680672269,-0.010919718067732287,0.19572243577563747,129637.82709775097,2050.0198241061303,131687.8469218571,1014,4,290.25714285714287,33,2,20,36.517749699157655,0.6231060606060606,45.40441176470589,1018.3823529411773,30.860071301247796,0
4575,4,0,0,35,0.0,0.0,1.0,35,950,500,450,0.5263157894736842,14,5,9,350.50336156637263,0.4121498599439776,-0.010815639387067977,0.1974787232239807,129825.09731833906,2100.826605151861,131925.92392349092,1015,5,291.25714285714287,33,2,20,36.290484207150875,0.625,45.220588235294116,1019.1176470588232,30.88235294117646,0
4576,4,0,1,34,0.0,0.02857142857142857,0.9714285714285714,35,1000,800,200,0.8,12,8,4,351.46275301881263,0.41190476190476194,-0.003462370762202127,0.19833562955294998,129887.55076172619,2130.127234717411,132017.6779964436,1016,6,292.25714285714287,33,2,20,36.20261280756593,0.6256313131313131,45.15931372549019,1019.3627450980387,30.88978015448602,0
4577,4,0,0,34,0.0,0.0,1.0,34,1300,1100,200,0.8461538461538461,15,11,4,365.3144371616796,0.4085153000594177,0.00010931032472472069,0.20592305424365082,129844.02101826352,2686.7790914192547,132530.80010968278,1017,7,301.6764705882353,32,2,20,35.893882144036986,0.6276041666666667,45.20202020202021,1019.1919191919199,31.849747474747495,0
4578,4,0,0,34,0.0,0.0,1.0,34,1250,1000,250,0.8,15,10,5,365.88269325794215,0.4083296197266786,0.0005024540145346368,0.20726510491848932,130037.12153096625,2715.6664498520545,132752.7879808183,1018,8,302.6764705882353,32,2,20,35.683079557646266,0.6295572916666667,45.01262626262626,1019.9494949494951,31.873421717171723,0
4579,4,0,0,34,0.0,0.0,1.0,34,850,600,250,0.7058823529411765,11,6,5,379.5939424132967,0.40819964349376114,-0.032797818853432026,0.20613132488559693,128368.35048719536,2966.8087121212357,131335.1591993166,1019,9,303.6764705882353,32,2,18,37.03718124428939,0.6126302083333333,46.654040404040416,1013.3838383838398,31.668244949494994,8
4580,4,0,0,34,0.0,0.0,1.0,34,1400,1300,100,0.9285714285714286,15,13,2,374.59866638422073,0.4088123885918003,-0.03349061296419997,0.204816893020382,128641.33536380259,2837.774533833165,131479.10989763576,1020,10,304.6764705882353,33,1,19,36.88441249899332,0.6130050505050505,46.38480392156864,1014.4607843137272,30.741235888294764,0
4581,4,0,0,34,0.0,0.0,1.0,34,950,600,350,0.631578947368421,13,6,7,372.0948254772271,0.40834818775995246,-0.03476437479306882,0.20446035255604345,128838.54875283457,2788.031462585049,131626.5802154196,1021,11,305.6764705882353,34,0,21,36.74635514383991,0.6127450980392157,46.1904761904762,1015.2380952380961,29.859943977591062,0
4582,4,1,0,35,0.02857142857142857,0.0,1.0,35,1400,1000,400,0.7142857142857143,18,10,8,363.03885588242787,0.40966386554621853,-0.030661694620491065,0.20178535756692148,129292.1786422903,2388.1271258503434,131680.30576814065,1022,0,297.9142857142857,34,1,22,36.51356861367981,0.6173406862745099,45.74404761904762,1017.0238095238099,29.912464985994408,0
4583,4,1,0,36,0.027777777777777776,0.0,1.0,36,800,500,300,0.625,11,5,6,353.7209378284775,0.4127149470899471,-0.021708012336122184,0.1983074048842485,129631.08114448938,1970.645518829673,131601.72666331904,1023,0,290.6111111111111,36,0,20,36.405691326624634,0.6166087962962963,45.41103603603605,1018.3558558558582,28.287662662662726,0
4584,4,0,0,36,0.0,0.0,1.0,36,1000,700,300,0.7,13,7,6,356.88531117522126,0.41327711640211645,-0.022157729869172416,0.20037415515703788,129688.4273420382,2056.778949557688,131745.20629159588,1024,1,291.6111111111111,36,0,20,36.26681407775934,0.6171875,45.35472972972974,1018.5810810810827,28.293918918918965,0
4585,4,0,0,36,0.0,0.0,1.0,36,950,800,150,0.8421052631578947,11,8,3,355.36965245188,0.4130291005291005,-0.021355241182827278,0.1999617298124761,129774.47041636256,2023.5816897979284,131798.0521061605,1025,2,292.6111111111111,36,0,20,36.21794871794871,0.6180555555555556,45.27027027027028,1018.9189189189209,28.30330330330336,0
4586,4,1,0,37,0.02702702702702703,0.0,1.0,37,950,600,350,0.631578947368421,13,6,7,350.1042210153774,0.4153215715715716,0.03296359943758809,0.189731179051466,128287.09621783947,1583.6870231718237,129870.78324101129,1026,0,285.6756756756757,36,1,19,37.86729287090558,0.6030092592592593,46.734234234234236,1013.0630630630632,28.140640640640644,8
4587,4,1,0,38,0.02631578947368421,0.0,1.0,38,800,600,200,0.75,10,6,4,344.2692763388131,0.41874110953058324,0.04166216362260888,0.18838105345730577,128672.41753472232,1259.5920138888978,129932.00954861121,1027,0,279.13157894736844,37,1,13,37.62191991786447,0.6050112612612613,46.35416666666667,1014.5833333333342,27.421171171171192,0
4588,4,2,1,39,0.05,0.025,0.975,40,900,500,400,0.5555555555555556,13,5,8,332.3512630728106,0.4264823717948718,0.05675578774841217,0.18455136690084079,129254.34570312516,591.5690104166805,129845.91471354185,1028,0,266.125,39,1,16,37.332257734070886,0.6073717948717949,45.78125000000001,1016.8750000000013,26.07371794871798,0
4589,4,0,0,39,0.0,0.0,1.0,39,1050,700,350,0.6666666666666666,14,7,7,340.5636921084238,0.4250730994152047,0.06011207335710678,0.18846901704638952,129119.93805473375,994.7125657462223,130114.65062047997,1029,1,273.8205128205128,38,1,16,37.26019657311049,0.6077302631578947,45.91346153846154,1016.346153846154,26.745951417004054,0
4590,4,0,0,39,0.0,0.0,1.0,39,1300,1000,300,0.7692307692307693,16,10,6,342.651768156428,0.42437022042285205,0.06409987015156227,0.19027768549083335,129255.7037128352,1057.9390843012754,130313.64279713648,1030,2,274.8205128205128,38,1,16,37.069018351194245,0.6091008771929824,45.779914529914535,1016.8803418803425,26.760008996851116,0
4591,4,0,1,38,0.0,0.02564102564102564,0.9743589743589743,39,700,300,400,0.42857142857142855,11,3,8,342.92401207416094,0.4240890688259109,0.059054344108434575,0.19082288246394477,129337.19735051897,1070.5661251735246,130407.7634756925,1031,3,275.8205128205128,38,1,17,36.97922137030423,0.6099232456140351,45.69978632478634,1017.2008547008571,26.768443544759396,0
4592,4,1,0,39,0.02564102564102564,0.0,1.0,39,1000,800,200,0.8,12,8,4,340.00431261511227,0.4258603238866397,0.07981751078687704,0.19064241810866198,129636.22708013756,1015.3752556797674,130651.60233581733,1032,0,274.2307692307692,38,1,14,36.74967652818577,0.6129385964912281,45.40598290598292,1018.3760683760701,26.799370220422897,0
4593,4,0,0,39,0.0,0.0,1.0,39,1250,800,450,0.64,17,8,9,340.3948083920245,0.4255791722896986,0.08065062690613334,0.19112627227382611,129690.63321827764,1029.2036489152024,130719.83686719285,1033,1,275.2307692307692,38,1,14,36.68449758758128,0.6134868421052632,45.35256410256411,1018.5897435897451,26.804993252361715,0
4594,4,0,2,37,0.0,0.05128205128205128,0.9487179487179487,39,1250,1100,150,0.88,14,11,3,341.5828216014561,0.4256635177687809,0.08336761277937788,0.19219323714531494,129772.26382725191,1065.5952087442638,130837.85903599617,1034,2,276.2307692307692,38,1,14,36.57137988885395,0.6143092105263157,45.272435897435905,1018.9102564102573,26.813427800269928,0
4595,4,0,0,37,0.0,0.0,1.0,37,850,700,150,0.8235294117647058,10,7,3,359.78810987547945,0.4202327327327327,0.09129394881607267,0.2012676060194518,129545.08562616697,1921.7563002191716,131466.84192638614,1035,3,291.6756756756757,36,1,15,36.33872603244838,0.6157407407407407,45.49549549549551,1018.0180180180201,28.278278278278336,0
4596,4,0,0,37,0.0,0.0,1.0,37,1250,800,450,0.64,17,8,9,358.55865931689107,0.41888763763763764,0.08864984387372443,0.2013136606779196,129688.4273420382,1900.1817273354661,131588.60906937366,1036,4,292.6756756756757,36,1,16,36.22420305878016,0.6171875,45.35472972972974,1018.5810810810827,28.293918918918965,0
4597,4,0,0,37,0.0,0.0,1.0,37,1200,700,500,0.5833333333333334,17,7,10,358.4369219498793,0.4185122622622623,0.08998656114678227,0.20198344605519358,129831.84831791259,1907.3056164272498,131739.15393433985,1037,5,293.6756756756757,36,1,16,36.08149171270719,0.6186342592592593,45.21396396396397,1019.1441441441449,28.30955955955958,0
4598,4,1,0,38,0.02631578947368421,0.0,1.0,38,1200,1000,200,0.8333333333333334,14,10,4,352.8206204994865,0.4234234234234234,0.09130365938484353,0.20059263988935364,130178.65022170272,1585.9424294013431,131764.59265110406,1038,0,286.92105263157896,37,1,17,35.872528741807244,0.6202139639639639,44.873903508771924,1020.5043859649113,27.581199620673278,0
4599,4,0,0,38,0.0,0.0,1.0,38,1100,800,300,0.7272727272727273,14,8,6,351.0991158318011,0.4232307965860598,0.08480435123321683,0.20034082336355805,130320.07250071004,1551.0794976198906,131871.15199832994,1039,1,287.92105263157896,36,2,18,35.77304143230029,0.6235532407407407,44.73536036036035,1021.0585585585575,28.362737737737707,0
4600,4,1,1,38,0.02564102564102564,0.02564102564102564,0.9743589743589743,39,1350,1000,350,0.7407407407407407,17,10,7,346.3306175615471,0.42338618983355825,0.09753645047762705,0.20063958123537662,130906.99932912036,1267.420384156647,132174.419713277,1040,0,281.5128205128205,37,2,15,35.30070270366798,0.6275337837837838,44.16118421052631,1023.3552631578935,27.658250355618744,0
4601,4,1,1,38,0.02564102564102564,0.02564102564102564,0.9743589743589743,39,1000,500,500,0.5,15,5,10,341.9882436684602,0.4242015294646873,0.1057033834174308,0.19959374732421575,131191.27498584625,1173.174743407108,132364.44972925336,1041,0,277.56410256410254,38,1,16,35.124665415232734,0.6285635964912281,43.883547008547005,1024.4658119658116,26.959626630679253,0
4602,4,0,0,38,0.0,0.0,1.0,38,1150,700,450,0.6086956521739131,16,7,9,351.8897829207946,0.41930417259364633,0.113047177412539,0.20505317918048285,131131.51552641182,1628.768106532766,132760.2836329446,1042,1,285.7894736842105,37,1,17,34.931462548620786,0.6297860360360361,43.941885964912274,1024.2324561403498,27.681958274063508,0
4603,4,0,0,38,0.0,0.0,1.0,38,1300,1000,300,0.7692307692307693,16,10,6,353.95597858417614,0.4189337363679469,0.11168164313222095,0.2073170731707317,131328.125,1696.8750000000007,133025.0,1043,2,286.7894736842105,37,1,18,34.67987804878049,0.6317567567567568,43.75,1025.0,27.7027027027027,0
4604,4,1,1,38,0.02564102564102564,0.02564102564102564,0.9743589743589743,39,1250,900,350,0.72,16,9,7,348.26375301819843,0.41942195231668916,0.10528675987764036,0.20574548656167396,131656.85609796207,1370.2621630506458,133027.1182610127,1044,0,280.4102564102564,38,1,15,34.49406620861961,0.6332236842105263,43.42948717948719,1026.2820512820529,27.007422402159285,0
4605,4,0,0,38,0.0,0.0,1.0,38,1550,1000,550,0.6451612903225806,21,10,11,353.98228572354674,0.41725936462778573,0.1047991090261724,0.20870902630845814,131581.12502164143,1715.4774786472954,133296.60250028872,1045,4,288.7894736842105,37,1,15,34.423760286416574,0.6342905405405406,43.50328947368422,1025.9868421052645,27.729374110953096,0
4606,4,0,0,38,0.0,0.0,1.0,38,1100,800,300,0.7272727272727273,14,8,6,354.81956315289614,0.41703710289236606,0.10784975258659446,0.20966610549943895,131665.5124653742,1743.499923053273,133409.01238842748,1046,5,289.7894736842105,37,1,15,34.31712962962964,0.6351351351351351,43.42105263157896,1026.315789473686,27.73826458036989,0
4607,4,0,0,38,0.0,0.0,1.0,38,800,500,300,0.625,11,5,6,351.29298871489954,0.4171111901375059,0.10149974423402308,0.20804277377214478,131749.92696069958,1656.5651209987857,133406.49208169838,1047,6,290.7894736842105,37,1,15,34.322488340631566,0.6359797297297297,43.33881578947369,1026.6447368421063,27.74715504978666,0
4608,4,0,0,38,0.0,0.0,1.0,38,1350,1100,250,0.8148148148148148,16,11,5,358.23087147723885,0.4173630867709815,0.10783014098747401,0.21325433708651395,131946.99931709756,1853.497710834104,133800.49702793168,1048,7,291.7894736842105,37,1,15,33.94565990750621,0.6379504504504505,43.146929824561404,1027.4122807017545,27.767899478425797,0
4609,4,0,1,37,0.0,0.02631578947368421,0.9736842105263158,38,1150,600,550,0.5217391304347826,17,6,11,359.0796217893425,0.4174223565670934,0.10662751395236514,0.21439569265307623,132059.6782182979,1883.9878616497342,133943.66607994764,1049,8,292.7894736842105,37,1,17,33.81027309579689,0.6390765765765766,43.03728070175438,1027.8508771929821,27.779753437648164,0
4610,4,0,0,37,0.0,0.0,1.0,37,750,500,250,0.6666666666666666,10,5,5,365.8982039879124,0.4165102602602602,0.11876498623486609,0.21891550474506144,132137.36329234633,2269.7647816735575,134407.12807401989,1050,9,299.9189189189189,36,1,18,33.55672690763052,0.6417824074074074,42.96171171171171,1028.1531531531525,28.559809809809792,0
4611,4,0,0,37,0.0,0.0,1.0,37,950,800,150,0.8421052631578947,11,8,3,365.18106393821563,0.4162912912912913,0.11779888529423088,0.21865365867671102,132166.31063073195,2252.9267865838688,134419.23741731583,1051,10,300.9189189189189,36,1,18,33.54597889971891,0.6420717592592593,42.93355855855855,1028.2657657657649,28.562937937937914,0
4612,4,0,0,37,0.0,0.0,1.0,37,1050,700,350,0.6666666666666666,14,7,7,365.8336651258911,0.41554054054054057,0.11897217414458816,0.21971666869986944,132282.13168827607,2278.651413237558,134560.78310151363,1052,11,301.9189189189189,36,1,18,33.41247035212551,0.6432291666666667,42.820945945945944,1028.7162162162158,28.57545045045044,0
4613,4,0,1,36,0.0,0.02702702702702703,0.972972972972973,37,950,500,450,0.5263157894736842,14,5,9,369.72625458119234,0.41529029029029024,0.018124006359300227,0.2138992205823125,130854.01663237285,2276.0838196805103,133130.10045205336,1053,12,302.9189189189189,35,2,18,34.755844645550525,0.6309523809523809,44.21296296296295,1023.148148148146,29.23280423280417,8
4614,4,0,0,36,0.0,0.0,1.0,36,900,800,100,0.8888888888888888,10,8,2,373.98980219369264,0.41474867724867726,0.02231082456735667,0.21653201317579795,130883.62328800143,2589.828076774679,133473.45136477612,1054,13,307.30555555555554,35,1,18,34.61677129284017,0.63125,44.18402777777777,1023.263888888888,29.236111111111086,0
4615,4,0,0,36,0.0,0.0,1.0,36,1200,800,400,0.6666666666666666,16,8,8,370.95621008490104,0.4143022486772487,0.03008892908282501,0.2156030640217499,131031.70680084011,2521.405071159114,133553.11187199922,1055,14,308.30555555555554,35,1,18,34.54433265506067,0.6327380952380952,44.03935185185185,1023.8425925925919,29.252645502645482,0
4616,4,0,0,36,0.0,0.0,1.0,36,1250,900,350,0.72,16,9,7,368.62861065185547,0.4140873015873016,0.03231061890232412,0.21474618667928008,131120.59709630036,2466.9607070901666,133587.55780339052,1056,15,309.30555555555554,35,1,18,34.513904584322134,0.6336309523809525,43.95254629629628,1024.1898148148132,29.26256613756609,0
4617,4,1,0,37,0.02702702702702703,0.0,1.0,37,750,400,350,0.5333333333333333,11,4,7,366.37893272179156,0.41504004004004,0.047798051858965795,0.2160977537311163,131595.1877170137,2242.9049854252166,133838.0927024389,1057,0,301.9189189189189,35,2,17,34.091582064297796,0.6383928571428572,43.48958333333332,1026.0416666666652,29.315476190476147,0
4618,4,0,0,37,0.0,0.0,1.0,37,700,300,400,0.42857142857142855,11,3,8,367.83140872809463,0.4146646646646646,0.05121391546016629,0.21763153862638238,131713.96933138292,2289.7069776663293,134003.67630904925,1058,1,302.9189189189189,35,2,17,33.93432649302815,0.6395833333333334,43.373842592592595,1026.50462962963,29.328703703703713,0
4619,4,0,0,37,0.0,0.0,1.0,37,1250,1100,150,0.88,14,11,3,368.47227825576135,0.4145708208208208,0.05791636333730299,0.21869261036544294,131832.80452942822,2315.3467667609807,134148.1512961892,1059,2,303.9189189189189,35,2,18,33.797874638416175,0.6407738095238096,43.258101851851855,1026.967592592593,29.34193121693123,0
4620,4,0,1,36,0.0,0.02702702702702703,0.972972972972973,37,900,400,500,0.4444444444444444,14,4,10,367.043930689134,0.41410160160160164,0.058828544632961055,0.21835669764053312,131921.9660922497,2284.2313957476017,134206.1974879973,1060,3,304.9189189189189,35,2,18,33.744554604176045,0.6416666666666666,43.1712962962963,1027.3148148148152,29.351851851851865,0
4621,4,0,0,36,0.0,0.0,1.0,36,900,600,300,0.6666666666666666,12,6,6,375.92702298007623,0.4142361111111111,0.06057533423464001,0.22364130401951454,131921.9660922497,2718.6063957476013,134640.5724879973,1061,4,307.8611111111111,35,1,19,33.516411296379744,0.6416666666666666,43.1712962962963,1027.3148148148152,29.351851851851865,0
4622,4,0,0,36,0.0,0.0,1.0,36,1100,900,200,0.8181818181818182,13,9,4,378.72466450848634,0.41321097883597885,0.051696314643848496,0.2263682685171181,132100.3796403464,2805.934392146773,134906.31403249316,1062,5,308.8611111111111,35,1,19,33.26437363957066,0.6434523809523809,42.99768518518518,1028.0092592592594,29.371693121693124,0
4623,4,0,0,36,0.0,0.0,1.0,36,750,400,350,0.5333333333333333,11,4,7,377.88125164986513,0.41202050264550266,0.0433828494260633,0.22657576262892726,132219.3889853395,2792.645640432096,135012.0346257716,1063,6,309.8611111111111,35,1,19,33.16593517893314,0.6446428571428571,42.88194444444444,1028.4722222222222,29.384920634920633,0
4624,4,1,1,36,0.02702702702702703,0.02702702702702703,0.972972972972973,37,1050,800,250,0.7619047619047619,13,8,5,367.5662585266417,0.41266266266266266,0.0389789592806975,0.2228050740055132,132629.89921932077,2350.055164962269,134979.95438428305,1064,0,302.4594594594595,36,1,18,33.01765606209687,0.6467013888888888,42.48310810810811,1030.0675675675684,28.61298798798801,0
4625,4,0,0,36,0.0,0.0,1.0,36,950,600,350,0.631578947368421,13,6,7,373.479792787578,0.40963955026455023,0.041413800854124716,0.2260696051852974,132576.73852237666,2702.946566358037,135279.6850887347,1065,8,311.8611111111111,35,1,19,32.918914362778146,0.6482142857142856,42.53472222222223,1029.861111111112,29.4246031746032,0
4626,4,0,0,36,0.0,0.0,1.0,36,1150,800,350,0.6956521739130435,15,8,7,370.13859880370524,0.40925925925925927,0.047005427662362376,0.22529625579952134,132785.41512613604,2629.801499271272,135415.2166254073,1066,9,312.8611111111111,35,1,19,32.79489518996819,0.6502976190476191,42.33217592592593,1030.6712962962968,29.447751322751337,0
4627,4,0,0,36,0.0,0.0,1.0,36,1100,800,300,0.7272727272727273,14,8,6,372.0408902168307,0.4090939153439153,0.05308302465671444,0.2271769904689337,132904.73257726766,2689.199004415291,135593.93158168293,1067,10,313.8611111111111,35,1,19,32.625832491488,0.6514880952380953,42.21643518518518,1031.1342592592591,29.460978835978832,0
4628,4,0,1,35,0.0,0.027777777777777776,0.9722222222222222,36,1200,900,300,0.75,15,9,6,376.89124148458876,0.4086309523809524,0.054561600299121826,0.23124469496456368,133083.80922335834,2831.6244159379476,135915.4336392963,1068,11,314.8611111111111,35,1,19,32.32064404561601,0.6532738095238095,42.04282407407408,1031.8287037037048,29.48082010582014,0
4629,4,0,0,35,0.0,0.0,1.0,35,700,500,200,0.7142857142857143,9,5,4,374.11086956721243,0.40693277310924375,0.03899368996820285,0.23022820085289578,133195.5800028346,2965.982851473938,136161.56285430855,1069,12,307.0571428571429,34,1,19,32.28001383923424,0.6565563725490196,41.93452380952382,1032.2619047619057,30.36064425770311,0
4630,4,0,0,35,0.0,0.0,1.0,35,1400,1100,300,0.7857142857142857,17,11,6,377.1777857136925,0.40668767507002807,0.03876492383696983,0.23288379295845427,133318.49666950112,3056.9550736961437,136375.45174319728,1070,13,308.0571428571429,34,1,19,32.077329490874156,0.657781862745098,41.81547619047619,1032.7380952380952,30.374649859943975,0
4631,4,0,1,34,0.0,0.02857142857142857,0.9714285714285714,35,950,600,350,0.631578947368421,13,6,7,378.2451752671504,0.4070728291316527,0.04170453797009821,0.23373612112662376,133349.23469387766,3087.7409297052286,136436.9756235829,1071,14,309.0571428571429,34,1,19,32.01888351006609,0.6580882352941176,41.78571428571429,1032.8571428571436,30.37815126050422,0
4632,4,0,0,34,0.0,0.0,1.0,34,1050,800,250,0.7619047619047619,13,8,5,385.5960693499106,0.4077168746286393,0.04131611101413846,0.23764790667688343,133250.7047319541,3476.1895965494077,136726.8943285035,1072,15,310.0882352941176,33,1,19,31.928165182987133,0.6594065656565656,41.881127450980394,1032.4754901960787,31.287136066547838,0
4633,4,1,0,35,0.02857142857142857,0.0,1.0,35,1350,1200,150,0.8888888888888888,15,12,3,376.98657258622694,0.411764705882353,0.034161991411790105,0.2343145604700223,133564.50007086172,3070.4046201814126,136634.90469104314,1073,0,302.2,34,1,20,31.835195209029134,0.6602328431372548,41.577380952380956,1033.6904761904766,30.402661064425782,0
4634,4,0,0,35,0.0,0.0,1.0,35,1000,900,100,0.9,11,9,2,375.7064983764582,0.41137955182072833,0.035200263179537616,0.23390759415050474,133626.03635204086,3040.8340419501187,136666.87039399098,1074,1,303.2,34,1,20,31.80651506428709,0.6608455882352942,41.517857142857146,1033.9285714285718,30.40966386554623,0
4635,4,1,1,35,0.027777777777777776,0.027777777777777776,0.9722222222222222,36,950,600,350,0.631578947368421,13,6,7,368.08944543716444,0.41326058201058197,0.038118750388174805,0.2313815944789487,133981.00090288508,2663.3984642918545,136644.39936717693,1075,0,295.75,35,1,18,31.647684926402093,0.6622023809523809,41.174768518518526,1035.300925925927,29.580026455026484,0
4636,4,0,0,35,0.0,0.0,1.0,35,950,900,50,0.9473684210526315,10,9,1,376.50972288699364,0.40882352941176475,0.044295412331311734,0.2355828654867433,133810.73022959195,3076.2081916099937,136886.93842120195,1076,1,305.14285714285717,34,1,19,31.600458328539105,0.6626838235294117,41.33928571428572,1034.642857142858,30.43067226890759,0
4637,4,0,0,35,0.0,0.0,1.0,35,750,400,350,0.5333333333333333,11,4,7,379.61856175865597,0.4085084033613446,0.04878144977075127,0.23792531776265294,133872.32320011337,3164.083758503401,137036.40695861678,1077,2,306.14285714285717,34,1,19,31.458261436404765,0.663296568627451,41.279761904761905,1034.8809523809525,30.437675070028014,0
4638,4,0,0,35,0.0,0.0,1.0,35,950,400,550,0.42105263157894735,15,4,11,380.53072108421355,0.40875350140056027,0.04946861807848357,0.23929686777074494,133995.55165816314,3197.8847789115475,137193.43643707468,1078,3,307.14285714285717,34,1,19,31.311084281936296,0.6645220588235294,41.16071428571428,1035.3571428571418,30.451680672268875,0
4639,4,0,0,35,0.0,0.0,1.0,35,650,400,250,0.6153846153846154,9,4,5,381.1308643334358,0.40717787114845944,0.05423383786978375,0.2406822047481534,134149.6669501132,3225.715702947826,137375.382653061,1079,4,308.14285714285717,34,1,19,31.141069102888217,0.6660539215686274,41.01190476190475,1035.9523809523796,30.46918767506999,0
4640,4,0,0,35,0.0,0.0,1.0,35,1200,600,600,0.5,18,6,12,379.4265020692287,0.40682773109243703,0.05330695217883874,0.24007105816436744,134220.76106234972,3185.3827749914,137406.1438373411,1080,5,309.14285714285717,35,0,19,31.113988793328115,0.6645833333333333,40.943287037037024,1036.22685185185,29.606481481481428,0
4641,4,0,0,35,0.0,0.0,1.0,35,1050,900,150,0.8571428571428571,12,9,3,384.8480816640973,0.40640756302521014,0.052600012760799064,0.24410052545210006,134310.72638031538,3337.8450788751566,137648.57145919054,1081,6,310.14285714285717,35,0,19,30.883392883727847,0.6654761904761906,40.856481481481474,1036.574074074073,29.616402116402085,0
4642,4,0,0,35,0.0,0.0,1.0,35,850,500,350,0.5882352941176471,12,5,7,419.6055456347972,0.40651260504201686,0.04318507111151382,0.24857924322542255,131762.2396681043,4160.728287140851,135922.96795524514,1082,7,311.14285714285717,31,4,18,32.55667406467978,0.6495295698924731,43.326822916666664,1026.6927083333328,33.1191196236559,8
4643,4,0,0,35,0.0,0.0,1.0,35,1150,900,250,0.782608695652174,14,9,5,417.3271419000978,0.4058473389355742,0.041139485053918845,0.2477765673149922,131846.311919702,4004.6089047036016,135850.92082440562,1083,8,312.14285714285717,32,3,18,32.52986435538072,0.6477864583333333,43.244949494949495,1027.0202020202016,32.0943813131313,0
4644,4,0,0,35,0.0,0.0,1.0,35,650,300,350,0.46153846153846156,10,3,7,411.76994876757647,0.4050070028011204,0.036755136111205955,0.245597638006038,132019.90370290272,3872.3657968089237,135892.26949971163,1084,9,313.14285714285717,33,2,18,32.496621353048745,0.6470959595959596,43.075980392156865,1027.6960784313724,31.142305407011285,0
4645,4,0,0,35,0.0,0.0,1.0,35,850,600,250,0.7058823529411765,11,6,5,411.196691024454,0.4043417366946778,0.0427890507966775,0.24648304507694407,132208.8860053825,3872.771289888503,136081.657295271,1085,10,314.14285714285717,33,2,19,32.31996742929775,0.648989898989899,42.8921568627451,1028.4313725490192,31.164587046939975,0
4646,4,0,0,35,0.0,0.0,1.0,35,700,400,300,0.5714285714285714,10,4,6,410.2701312287862,0.4041666666666666,0.036080193335376265,0.24633816033865738,132271.91014273348,3853.4427864282934,136125.35292916177,1086,11,315.14285714285717,33,2,19,32.280001588436186,0.6496212121212122,42.830882352941174,1028.6764705882347,31.172014260249536,0
4647,4,0,0,35,0.0,0.0,1.0,35,900,500,400,0.5555555555555556,13,5,8,412.9693215436712,0.40378151260504197,0.04074509024553308,0.24945366122580653,132498.52710300015,3943.6855147499887,136442.21261775013,1087,12,316.14285714285717,31,4,19,31.981287677585264,0.6569220430107527,42.61067708333333,1029.557291666666,33.21152553763439,0
4648,4,0,1,34,0.0,0.02857142857142857,0.9714285714285714,35,1350,900,450,0.6666666666666666,18,9,9,410.32973377414123,0.4035364145658263,0.040086856022134576,0.24869762021764075,132625.50536935005,3884.037661973267,136509.54303132332,1088,13,317.14285714285717,32,3,18,31.92086499959141,0.6555989583333333,42.48737373737374,1030.0505050505049,32.18907828282828,0
4649,4,0,0,34,0.0,0.0,1.0,34,850,600,250,0.7058823529411765,11,6,5,406.2978472555292,0.4028520499108734,0.03849645185692152,0.24775369102624306,132853.20255905006,3995.594040148958,136848.796599199,1089,14,321.70588235294116,32,2,18,31.79475403143498,0.6578776041666667,42.26641414141414,1030.9343434343432,32.216698232323225,0
4650,4,0,0,34,0.0,0.0,1.0,34,800,600,200,0.75,10,6,4,409.51058359651466,0.4027035056446821,0.03399148862629886,0.25058366722096825,132983.40292125792,4091.6221877869475,137075.02510904486,1090,15,322.70588235294116,32,2,18,31.580517811237613,0.6591796875,42.14015151515151,1031.439393939393,32.232481060606034,0
4651,4,0,0,34,0.0,0.0,1.0,34,1250,1000,250,0.8,15,10,5,408.6349633869204,0.40201648841354726,0.03923367512142484,0.2513612359434215,133178.8230314508,4084.3046946740033,137263.1277261248,1091,16,323.70588235294116,32,2,19,31.405963302752298,0.6611328125,41.95075757575757,1032.196969696969,32.25615530303028,0
4652,4,0,0,34,0.0,0.0,1.0,34,1200,800,400,0.6666666666666666,16,8,8,407.52351846950125,0.4018679441473559,0.03378451270470295,0.251557347740532,133309.1828161667,4065.3254451076396,137374.50826127434,1092,17,324.70588235294116,32,2,19,31.303235929412725,0.6624348958333333,41.82449494949495,1032.7020202020199,32.27193813131312,0
4653,4,0,0,34,0.0,0.0,1.0,34,1150,800,350,0.6956521739130435,15,8,7,406.3405723171115,0.40118092691622104,0.038420061253540805,0.25148854483348004,133406.99450311193,4041.7348995000493,137448.72940261196,1093,18,325.70588235294116,32,2,19,31.23523180966349,0.6634114583333333,41.72979797979798,1033.080808080808,32.28377525252525,0
4654,4,0,1,33,0.0,0.029411764705882353,0.9705882352941176,34,850,500,350,0.5882352941176471,12,5,7,405.39300215802166,0.40086527035056446,0.0378346329368644,0.25156495243846916,133504.84206012142,4024.3857450770347,137529.22780519846,1094,19,326.70588235294116,32,2,19,31.161168804724092,0.6643880208333333,41.63510101010101,1033.459595959596,32.29561237373738,0
4655,4,1,0,34,0.029411764705882353,0.0,1.0,34,650,600,50,0.9230769230769231,7,6,1,401.4491003501993,0.4029077540106952,0.048157724628312915,0.2502182748758091,133668.00103305784,3932.179752066115,137600.18078512396,1095,0,325.70588235294116,32,2,20,31.098901098901106,0.666015625,41.47727272727273,1034.090909090909,32.31534090909091,0
4656,4,0,0,34,0.0,0.0,1.0,34,1050,700,350,0.6666666666666666,14,7,7,399.0915562438783,0.4021278966131907,0.05242717052649715,0.24963024518033103,133798.5999515355,3879.5782955820746,137678.17824711755,1096,1,326.70588235294116,32,2,18,31.02854731104059,0.6673177083333333,41.3510101010101,1034.5959595959591,32.33112373737372,0
4657,4,0,0,34,0.0,0.0,1.0,34,1100,800,300,0.7272727272727273,14,8,6,396.81483817228644,0.4018865121806298,0.048522056132444424,0.2488669646899947,133896.59098880214,3826.430817008461,137723.0218058106,1097,2,327.70588235294116,32,2,19,30.98897970802325,0.6682942708333333,41.25631313131313,1034.9747474747471,32.34296085858585,0
4658,4,0,0,34,0.0,0.0,1.0,34,950,800,150,0.8421052631578947,11,8,3,402.54818560380727,0.4010323826500297,0.05172166427546632,0.2531361289839893,133994.6178961331,3987.858062952769,137982.47595908586,1098,3,328.70588235294116,32,2,19,30.742123983739837,0.6692708333333333,41.161616161616166,1035.3535353535358,32.35479797979799,0
4659,4,0,0,34,0.0,0.0,1.0,34,700,300,400,0.42857142857142855,11,3,8,402.03221886588096,0.4013480392156863,0.057995281496726836,0.2534873398429532,134092.68067352817,3981.9155889705103,138074.59626249867,1099,4,329.70588235294116,32,2,19,30.65697509041408,0.6702473958333333,41.06691919191919,1035.7323232323229,32.36663510101009,0
4660,4,0,0,34,0.0,0.0,1.0,34,1300,800,500,0.6153846153846154,18,8,10,402.34579373639514,0.4008467023172906,0.05444884739131339,0.25504684330363464,134288.9138385114,4006.11592567085,138295.02976418225,1100,5,330.70588235294116,32,2,19,30.451841474804073,0.6722005208333333,40.87752525252525,1036.489898989899,32.390309343434346,0
4661,4,0,0,34,0.0,0.0,1.0,34,650,300,350,0.46153846153846156,10,3,7,401.5585285122053,0.40123663101604273,0.056696083206784875,0.2552320925806681,134387.0842260994,3992.8559585756575,138379.94018467504,1101,6,331.70588235294116,32,2,19,30.37374167884397,0.6731770833333333,40.782828282828284,1036.868686868687,32.40214646464647,0
4662,4,0,0,34,0.0,0.0,1.0,34,1000,700,300,0.7,13,7,6,400.68162058257064,0.4003453654188948,0.05256166982922217,0.2553607069888145,134485.2904837517,3977.156827109482,138462.4473108612,1102,7,332.70588235294116,32,2,19,30.29798133495638,0.6741536458333333,40.688131313131315,1037.247474747475,32.413983585858595,0
4663,4,0,0,34,0.0,0.0,1.0,34,1000,700,300,0.7,13,7,6,404.69229497890814,0.3995098039215686,0.057653848140686303,0.2591005850021588,134652.11868286136,4098.550928958691,138750.66961182005,1103,8,333.70588235294116,31,3,19,30.02668527579141,0.6784274193548387,40.52734375,1037.8906250000002,33.480342741935495,0
4664,4,0,1,33,0.0,0.029411764705882353,0.9705882352941176,34,1250,800,450,0.64,17,8,9,408.73540196155267,0.3990641711229947,0.05293970090231026,0.2621759742429169,134719.69816419805,4212.941996256501,138932.64016045455,1104,9,334.70588235294116,31,3,19,29.854012500522597,0.6790994623655914,40.46223958333333,1038.151041666666,33.488743279569874,0
4665,4,0,0,33,0.0,0.0,1.0,33,650,400,250,0.6153846153846154,9,4,5,415.2545242670103,0.39764835858585856,0.10463070948273545,0.24343252937856827,131361.49300469286,4312.780761718745,135674.2737664116,1105,10,343.93939393939394,31,2,17,33.07519899233669,0.645497311827957,43.717447916666664,1025.130208333333,33.06871639784945,8
4666,4,0,0,33,0.0,0.0,1.0,33,950,700,250,0.7368421052631579,12,7,5,417.51913328294285,0.39678030303030304,0.1020182780182779,0.24518741048494963,131428.24172973633,4374.761115180122,135803.00284491645,1106,11,344.93939393939394,31,2,17,32.94933862433863,0.6461693548387097,43.65234375,1025.390625,33.07711693548387,0
4667,4,0,0,33,0.0,0.0,1.0,33,1050,900,150,0.8571428571428571,12,9,3,416.8720228985818,0.39595170454545453,0.1008100810081014,0.24544976056763998,131528.39660644517,4366.101752387138,135894.4983588323,1107,12,345.93939393939394,31,2,17,32.86419988152661,0.6471774193548387,43.55468749999999,1025.7812499999989,33.089717741935445,0
4668,4,0,0,33,0.0,0.0,1.0,33,1050,700,350,0.6666666666666666,14,7,7,417.7072328583578,0.39634627525252525,0.10263036455929875,0.24637223015897136,131595.18771701382,4393.65234374999,135988.84006076382,1108,13,346.93939393939394,31,2,15,32.77495769881558,0.6478494623655914,43.48958333333333,1026.041666666666,33.098118279569874,0
4669,4,0,0,33,0.0,0.0,1.0,33,1050,700,350,0.6666666666666666,14,7,7,414.59429916686054,0.3958333333333333,0.10142270094065098,0.24517980947729628,131695.40617201055,4320.032925075945,136015.4390970865,1109,14,347.93939393939394,31,2,15,32.75310266818892,0.6488575268817205,43.39192708333333,1026.432291666666,33.11071908602148,0
4670,4,0,0,33,0.0,0.0,1.0,33,750,400,350,0.5333333333333333,11,4,7,415.6527186743168,0.3954782196969697,0.10127399550354554,0.24623754220488264,131762.23966810433,4353.466627332895,136115.70629543724,1110,15,348.93939393939394,31,2,15,32.658132530120476,0.6495295698924731,43.326822916666664,1026.692708333333,33.119119623655905,0
4671,4,0,0,33,0.0,0.0,1.0,33,850,600,250,0.7058823529411765,11,6,5,417.3182020819246,0.39516256313131315,0.10390488706491774,0.24744145425699673,131795.66277397997,4400.1458062065885,136195.80858018657,1111,16,349.93939393939394,31,2,15,32.58147349733706,0.6498655913978495,43.29427083333333,1026.822916666666,33.1233198924731,0
4672,4,0,0,33,0.0,0.0,1.0,33,700,500,200,0.7142857142857143,9,5,4,415.67749713020834,0.39500473484848486,0.10695187165775377,0.24690241697011167,131862.52170138885,4362.456597222216,136224.97829861107,1112,17,350.93939393939394,31,2,15,32.555780933062884,0.6505376344086021,43.229166666666664,1027.083333333333,33.131720430107514,0
4673,4,0,0,33,0.0,0.0,1.0,33,1000,800,200,0.8,12,8,4,415.86724358993627,0.394570707070707,0.10810327683868337,0.24754292326929858,131943.58555568306,4374.203046882972,136317.78860256603,1113,18,351.93939393939394,32,1,15,32.46871287534309,0.6487630208333333,43.150252525252526,1027.3989898989898,32.10621843434343,0
4674,4,0,0,33,0.0,0.0,1.0,33,600,400,200,0.6666666666666666,8,4,4,418.2615047479915,0.3948469065656566,0.10540540540540588,0.24960767218831736,132040.89506172828,4445.524691358013,136486.4197530863,1114,19,352.93939393939394,32,1,16,32.30855855855856,0.6497395833333333,43.05555555555555,1027.777777777777,32.11805555555553,0
4675,4,0,0,33,0.0,0.0,1.0,33,1050,900,150,0.8571428571428571,12,9,3,417.934150524159,0.3941761363636364,0.1073411429830553,0.24989662072324803,132114.37795859764,4443.022064830834,136557.4000234285,1115,20,353.93939393939394,33,0,16,32.2424951325148,0.6480429292929293,42.98406862745098,1028.063725490196,31.153446226975635,0
4676,4,0,0,33,0.0,0.0,1.0,33,1050,800,250,0.7619047619047619,13,8,5,415.13616399839725,0.394570707070707,0.10803940260565659,0.24884447773389629,132208.8860053825,4376.93795655517,136585.82396193765,1116,21,354.93939393939394,33,0,17,32.21868048935495,0.648989898989899,42.8921568627451,1028.4313725490192,31.164587046939975,0
4677,4,0,0,33,0.0,0.0,1.0,33,850,700,150,0.8235294117647058,10,7,3,412.252677417604,0.39520202020202017,0.10750988142292495,0.24773523456841703,132303.42784325735,4308.488471981924,136611.91631523927,1117,22,355.93939393939394,33,0,17,32.19711633909072,0.6499368686868687,42.80024509803921,1028.7990196078429,31.175727866904328,0
4678,4,0,0,33,0.0,0.0,1.0,33,750,400,350,0.5333333333333333,11,4,7,409.93951712042514,0.39555713383838387,0.10452705189547329,0.24696356275303644,132398.00347222213,4255.068513312179,136653.0719855343,1118,23,356.93939393939394,32,1,18,32.16093117408908,0.6533203125,42.70833333333333,1029.1666666666658,32.16145833333331,0
4679,4,0,0,33,0.0,0.0,1.0,33,950,600,350,0.631578947368421,13,6,7,406.9861566608785,0.3949258207070707,0.09592614890628104,0.24581963862317058,132495.48037190078,4184.76526629935,136680.24563820014,1119,24,357.93939393939394,32,1,18,32.138367672308064,0.654296875,42.61363636363636,1029.5454545454543,32.173295454545446,0
4680,4,0,0,33,0.0,0.0,1.0,33,1150,900,250,0.782608695652174,14,9,5,404.9270650825836,0.39429450757575757,0.09444202971234983,0.2452108440889853,132592.99314164364,4138.09831267217,136731.0914543158,1120,25,358.93939393939394,32,1,19,32.09283437538311,0.6552734375,42.51893939393939,1029.9242424242418,32.18513257575756,0
4681,4,1,0,34,0.029411764705882353,0.0,1.0,34,850,600,250,0.7058823529411765,11,6,5,393.8505101779605,0.39681743909685085,0.09641105194750788,0.2412979326548813,133029.3712153978,3678.737144367533,136708.10835976535,1121,0,349.3529411764706,33,1,15,31.938009820226483,0.6571969696969697,42.09558823529411,1031.6176470588225,31.261140819964318,0
4682,4,0,1,33,0.0,0.029411764705882353,0.9705882352941176,34,1000,900,100,0.9,11,9,2,395.7716443957202,0.39653891859774215,0.0898558924816808,0.24309212381155054,133124.20590938567,3737.3571763263935,136861.56308571206,1122,1,350.3529411764706,33,1,15,31.792913549459676,0.6581439393939394,42.003676470588225,1031.985294117646,31.272281639928664,0
4683,4,0,0,33,0.0,0.0,1.0,33,700,600,100,0.8571428571428571,8,6,2,435.59455768229293,0.3963068181818182,0.10065713662835973,0.23677849420383895,128408.33875868081,4587.249007292902,132995.5877659737,1123,2,356.7878787878788,31,2,18,35.57725248372731,0.6155913978494624,46.61458333333335,1013.5416666666687,32.694892473118344,8
4684,4,0,0,33,0.0,0.0,1.0,33,750,400,350,0.5333333333333333,11,4,7,423.2291254451921,0.3961489898989899,0.08350421508316264,0.22161210111893903,126901.11340679515,4144.090855285804,131045.20426208095,1124,3,357.7878787878788,32,1,18,37.445175438596486,0.59765625,48.1060606060606,1007.5757575757569,31.486742424242404,8
4685,4,2,0,35,0.05714285714285714,0.0,1.0,35,850,400,450,0.47058823529411764,13,4,9,404.65733354214547,0.4060224089635854,0.09396222372978236,0.21558375386180093,127601.7833001735,3327.286437608416,130929.06973778192,1125,0,338.2857142857143,32,3,17,37.19044197284013,0.6048177083333333,47.411616161616166,1010.3535353535358,31.573547979797993,0
4686,4,0,0,35,0.0,0.0,1.0,35,350,100,250,0.2857142857142857,6,1,5,397.6308466356278,0.40682773109243703,0.08968163883033342,0.20017872907770753,125284.2523243802,2964.5284919906185,128248.78081637081,1126,1,339.2857142857143,32,3,16,39.76384159414806,0.5810546875,49.71590909090909,1001.136363636364,31.285511363636374,8
4687,4,3,0,38,0.07894736842105263,0.0,1.0,38,1000,900,100,0.9,11,9,2,374.2756227398308,0.420059862494073,0.11181092541781013,0.19261501560513228,126193.31065759626,1848.5116705084115,128041.82232810467,1127,0,313.42105263157896,34,4,19,39.40807661927332,0.5857843137254901,48.8095238095238,1004.7619047619038,29.55182072829129,0
4688,4,1,1,38,0.02564102564102564,0.02564102564102564,0.9743589743589743,39,1000,600,400,0.6,14,6,8,367.74129941831796,0.4239484930274404,0.1263470828688218,0.1909882232462879,126567.38281250013,1508.8107638889037,128076.19357638904,1128,0,306.35897435897436,35,4,17,39.18650793650795,0.5875,48.43750000000001,1006.250000000001,28.75000000000003,0
4689,4,1,0,39,0.02564102564102564,0.0,1.0,39,1100,800,300,0.7272727272727273,14,8,6,370.14226575494797,0.4228238866396761,0.12432226850991923,0.19264675555181218,126654.74597318671,1576.05492862654,128230.80090181326,1129,0,307.3076923076923,35,4,18,39.036090031045184,0.5883928571428572,48.35069444444444,1006.5972222222222,28.759920634920633,0
4690,4,1,1,39,0.025,0.025,0.975,40,1000,800,200,0.8,12,8,4,365.5842279866567,0.4291933760683761,0.11813002680965168,0.19206044653383514,127035.24470416365,1288.4163724535395,128323.6610766172,1130,0,300.6,36,4,20,38.759262362228185,0.5902777777777778,47.972972972972975,1008.1081081081082,28.003003003003005,0
4691,4,3,2,40,0.07142857142857142,0.047619047619047616,0.9523809523809523,42,650,200,450,0.3076923076923077,11,2,9,348.72814000340514,0.43622967479674796,0.12370865849126678,0.1855332986850857,127546.62390430976,495.8447467738026,128042.46865108356,1131,0,286.3809523809524,36,6,15,38.6596525455221,0.5954861111111112,47.46621621621622,1010.1351351351356,28.05930930930932,0
4692,4,2,0,42,0.047619047619047616,0.0,1.0,42,1300,1100,200,0.8461538461538461,15,11,4,348.59987757848205,0.4360240030971738,0.13994132201096066,0.18630389979107426,127728.54538175224,505.23105667129687,128233.77643842353,1132,0,287.3333333333333,37,5,17,38.47658368586613,0.5954391891891893,47.28618421052632,1010.855263157896,27.320412517780973,0
4693,4,1,2,41,0.023255813953488372,0.046511627906976744,0.9534883720930233,43,1000,700,300,0.7,13,7,6,344.0860277375133,0.4387689184200812,0.14078704431175293,0.1851808440187346,128009.35057345337,209.24579041568336,128218.59636386904,1133,0,281.6279069767442,38,5,19,38.3034645974099,0.5964912280701755,47.00854700854702,1011.9658119658138,26.63067926225826,0
4694,4,1,0,42,0.023809523809523808,0.0,1.0,42,1050,600,450,0.5714285714285714,15,6,9,352.8376819648987,0.436955574912892,0.14818255000309621,0.18974278142028464,127978.05574792244,631.0961064943083,128609.15185441675,1134,0,289.07142857142856,37,5,21,38.11407311082214,0.597972972972973,47.03947368421053,1011.8421052631579,27.347083926031296,0
4695,4,0,1,41,0.0,0.023809523809523808,0.9761904761904762,42,850,600,250,0.7058823529411765,11,6,5,354.4879358223835,0.43645954316686025,0.15565028134073944,0.191290889038461,128116.77781865571,683.1704226300385,128799.94824128575,1135,1,290.07142857142856,37,5,22,37.93040813747788,0.5993806306306306,46.90241228070175,1012.3903508771928,27.361901375059265,0
4696,4,0,0,41,0.0,0.0,1.0,41,1250,700,550,0.56,18,7,11,354.10076734693877,0.43610264227642276,0.1478132404181185,0.19149454352816525,128203.13169795948,879.368467838151,129082.50016579764,1136,2,291.2926829268293,35,6,22,37.851904761904756,0.6041666666666667,46.817129629629626,1012.7314814814811,28.935185185185173,0
4697,4,1,0,42,0.023809523809523808,0.0,1.0,42,750,600,150,0.8,9,6,3,348.0604426993331,0.43805652342237705,0.15150577721371694,0.1898415679289822,128543.9128951587,548.2102457186941,129092.1231408774,1137,0,285.3333333333333,36,6,17,37.65685730149916,0.6056134259259259,46.48085585585586,1014.0765765765768,28.1687937937938,0
4698,4,0,0,42,0.0,0.0,1.0,42,1000,600,400,0.6,14,6,8,350.7718093132682,0.4382742934572203,0.14729450443736236,0.1918702629085144,128658.13607103718,625.9294345020679,129284.06550553924,1138,1,286.3333333333333,36,6,19,37.47155622155625,0.6067708333333333,46.36824324324324,1014.5270270270264,28.18130630630629,0
4699,4,1,0,43,0.023255813953488372,0.0,1.0,43,1500,1300,200,0.8666666666666667,17,13,4,344.11632984759285,0.43996862310815804,0.15737454760841052,0.19002275997424292,129034.22807979374,280.55699830716486,129314.7850781009,1139,0,280.6511627906977,37,6,20,37.25717677530757,0.6086711711711712,45.997807017543856,1016.0087719298242,27.459696538643897,0
4700,4,2,2,43,0.044444444444444446,0.044444444444444446,0.9555555555555556,45,1250,800,450,0.64,17,8,9,329.35350068735505,0.44223484848484845,0.17134654033878904,0.1847243547333422,129647.68005540135,-459.80013080951426,129187.87992459183,1140,0,269.1333333333333,37,8,15,37.00922337065747,0.6148648648648649,45.394736842105246,1018.4210526315765,27.52489331436693,0
4701,4,3,1,45,0.06521739130434782,0.021739130434782608,0.9782608695652174,46,1250,800,450,0.64,17,8,9,324.8576067681312,0.44379025764895325,0.18505215572673728,0.1846007487016869,130158.86423631782,-743.3805729063276,129415.48366341149,1141,0,263.80434782608694,40,6,19,36.605957241974544,0.61484375,44.893292682926834,1020.4268292682939,25.510670731707346,0
4702,4,0,1,44,0.0,0.022222222222222223,0.9777777777777777,45,1000,700,300,0.7,13,7,6,330.1963682406897,0.4415614478114478,0.19014816327456696,0.18736635171201138,130103.13042534732,-408.0837673611003,129695.04665798623,1142,1,270.6222222222222,39,6,19,36.526189503777836,0.6159188034188035,44.94791666666667,1020.2083333333342,26.159188034188055,0
4703,4,0,0,44,0.0,0.0,1.0,44,1000,700,300,0.7,13,7,6,341.7348025390996,0.43974630021141653,0.19303303274707861,0.1936226801092455,130044.55133912274,88.14981463218868,130132.70115375493,1143,2,277.3863636363636,38,6,20,36.2912869662372,0.6170504385964912,45.00534188034188,1019.9786324786332,26.841542959964034,0
4704,4,0,0,44,0.0,0.0,1.0,44,1050,700,350,0.6666666666666666,14,7,7,342.8607581768087,0.43984540169133196,0.18913689201153838,0.19453222696555852,130099.0430843196,121.17130999343323,130220.21439431302,1144,3,278.3863636363636,38,6,21,36.207325374384745,0.6175986842105263,44.95192307692308,1020.1923076923083,26.847165991902852,0
4705,4,0,0,44,0.0,0.0,1.0,44,1100,700,400,0.6363636363636364,15,7,8,343.9820017171284,0.43922877026074697,0.19118318867062611,0.1955783381191674,130180.80210387909,155.9705785667408,130336.77268244584,1145,4,279.3863636363636,38,6,21,36.095843802345065,0.618421052631579,44.871794871794876,1020.512820512821,26.85560053981108,0
4706,4,0,0,44,0.0,0.0,1.0,44,1350,800,550,0.5925925925925926,19,8,11,343.5595794806389,0.4390636011275546,0.19193220868478544,0.19603105417424707,130318.55955678683,154.46358608749517,130473.02314287433,1146,5,280.3863636363636,37,7,21,35.96703178694159,0.6216216216216216,44.736842105263165,1021.0526315789484,27.596017069701308,0
4707,4,0,1,43,0.0,0.022727272727272728,0.9772727272727273,44,1350,1000,350,0.7407407407407407,17,10,7,342.8581067839723,0.43814966525722343,0.1915668058862563,0.19619570778866607,130430.54112803933,143.8336795937144,130574.37480763305,1147,6,281.3863636363636,37,7,21,35.87152926864176,0.6227477477477478,44.62719298245614,1021.4912280701749,27.607871028923647,0
4708,4,0,0,43,0.0,0.0,1.0,43,1150,800,350,0.6956521739130435,15,8,7,348.71655700506204,0.4374307862679956,0.19827022871420352,0.2001646271233989,130550.14209733382,504.99921374077184,131055.14131107459,1148,7,279.93023255813955,36,7,14,35.60078053259872,0.6258680555555556,44.51013513513514,1021.9594594594595,28.387762762762762,0
4709,4,0,0,43,0.0,0.0,1.0,43,1350,1000,350,0.7407407407407407,17,10,7,351.03689495086536,0.4368078626799557,0.20619745154398328,0.20194632017515568,130636.47050766986,571.6441948705497,131208.11470254042,1149,8,280.93023255813955,36,7,14,35.45407395167806,0.6267361111111112,44.42567567567568,1022.2972972972975,28.39714714714715,0
4710,4,0,0,43,0.0,0.0,1.0,43,1300,900,400,0.6923076923076923,17,9,8,351.7260280674065,0.43708471760797346,0.2021563411330647,0.20309774398831867,130780.41459956575,599.775155222782,131380.18975478853,1150,9,281.93023255813955,36,7,14,35.290744614481255,0.6281828703703703,44.284909909909906,1022.8603603603601,28.41278778778778,0
4711,4,0,0,43,0.0,0.0,1.0,43,1550,1200,350,0.7741935483870968,19,12,7,353.1714851758434,0.4363695090439277,0.20267645320045746,0.20454233816398293,130895.62694028504,645.720593904732,131541.3475341898,1151,10,282.93023255813955,36,7,15,35.13719232603353,0.6293402777777778,44.172297297297305,1023.3108108108121,28.425300300300336,0
4712,4,1,3,41,0.022727272727272728,0.06818181818181818,0.9318181818181819,44,1300,900,400,0.6923076923076923,17,9,8,345.6937008394474,0.4365420190274842,0.20787139689578704,0.20247773906310487,131328.125,280.5744511403293,131608.69945114033,1152,0,277.47727272727275,36,8,16,34.89159891598916,0.6336805555555556,43.75,1025.0,28.47222222222222,0
4713,4,0,0,41,0.0,0.0,1.0,41,1500,1200,300,0.8,18,12,6,374.2419202959774,0.43015752032520327,0.22761958254613956,0.21712091975066244,130962.30867346955,1602.317176870771,132564.62585034032,1153,1,297.4878048780488,34,7,17,34.53055943242616,0.6341911764705883,44.10714285714287,1023.5714285714299,30.105042016806763,0
4714,4,1,1,41,0.023809523809523808,0.023809523809523808,0.9761904761904762,42,1100,800,300,0.7272727272727273,14,8,6,367.5061140855309,0.43201945412311266,0.22880371660859433,0.21525358110723966,131328.12500000015,1252.7777777777928,132580.90277777793,1154,0,291.3809523809524,35,7,18,34.33265582655826,0.6357142857142857,43.75000000000001,1025.0000000000011,29.285714285714317,0
4715,4,0,1,40,0.0,0.024390243902439025,0.975609756097561,41,700,300,400,0.42857142857142855,11,3,8,373.7785417207797,0.43198678861788614,0.22959194086860157,0.2191070428517394,131359.5300635573,1619.8747176566692,132979.40478121396,1155,1,295.9756097560976,33,8,18,34.140142458657095,0.6404671717171717,43.71936274509804,1025.1225490196077,31.06431966726084,0
4716,4,0,0,40,0.0,0.0,1.0,40,1200,1000,200,0.8333333333333334,14,10,4,380.0515320814697,0.4301148504273504,0.22660248744319578,0.22223712666190543,131265.32613658198,1977.5176614763427,133242.8437980583,1156,2,303.8,33,7,19,34.074782747349126,0.639520202020202,43.811274509803916,1024.7549019607834,31.053178847296465,0
4717,4,1,0,41,0.024390243902439025,0.0,1.0,41,1450,1200,250,0.8275862068965517,17,12,5,368.52757631978375,0.43109756097560975,0.22450110864744977,0.21828171828171827,131755.55555555565,1511.1111111111163,133266.66666666677,1157,0,297.3658536585366,34,7,18,33.87445887445885,0.642156862745098,43.333333333333336,1026.6666666666674,30.19607843137257,0
4718,4,0,1,40,0.0,0.024390243902439025,0.975609756097561,41,1500,1100,400,0.7333333333333333,19,11,8,369.7236466665211,0.43030995934959354,0.22352306035518366,0.21987218105343964,131908.37762188198,1553.9292800453395,133462.3069019273,1158,1,298.3658536585366,34,7,18,33.68944837176961,0.6436887254901961,43.1845238095238,1027.261904761904,30.213585434173645,0
4719,4,0,0,40,0.0,0.0,1.0,40,1300,1000,300,0.7692307692307693,16,10,6,339.80439757957714,0.42956730769230766,0.10065303648186963,0.19475965251039185,130492.6056757772,868.3922520493608,131360.99792782657,1159,2,298.15,36,4,16,35.886696792681605,0.6252893518518519,44.56644144144145,1021.7342342342348,28.381506506506522,8
4720,4,1,0,41,0.024390243902439025,0.0,1.0,41,1250,800,450,0.64,17,8,9,331.2221646301934,0.4303607723577236,0.10772233562286737,0.1915938810952746,130848.0957031251,467.95789930556975,131316.05360243068,1160,0,291.8536585365854,39,2,17,35.74670807031832,0.6233974358974359,44.21875000000001,1023.1250000000008,26.23397435897438,0
4721,4,0,0,41,0.0,0.0,1.0,41,1300,1000,300,0.7692307692307693,16,10,6,333.271546132759,0.43030995934959354,0.10969157310620714,0.19358113211541103,131008.00781249999,532.2482638888887,131540.25607638888,1161,1,292.8536585365854,39,2,18,35.532831366164686,0.625,44.0625,1023.7499999999999,26.249999999999996,0
4722,4,0,1,40,0.0,0.024390243902439025,0.975609756097561,41,1200,700,500,0.5833333333333334,17,7,10,333.2528027372697,0.4301067073170732,0.10762663306486653,0.19424272728604447,131141.34250217004,540.6439887152735,131681.98649088532,1162,2,293.8536585365854,39,2,18,35.39876351740738,0.6263354700854701,43.932291666666664,1024.2708333333326,26.26335470085468,0
4723,4,0,1,39,0.0,0.025,0.975,40,1100,900,200,0.8181818181818182,13,9,4,331.4202672523184,0.4299278846153846,0.1262260068789529,0.18180711313117146,128772.40997331796,535.8231476303224,129308.23312094828,1163,3,302.075,36,4,18,37.846027959613885,0.6079282407407407,46.255630630630634,1014.9774774774779,28.19381881881883,8
4724,4,1,1,39,0.025,0.025,0.975,40,1450,1100,350,0.7586206896551724,18,11,7,331.6377350779735,0.4321848290598291,0.14351933946580964,0.18324355686519012,129058.31665702867,560.1215658225785,129618.43822285125,1164,0,302.825,36,4,19,37.549641656507426,0.6108217592592593,45.9740990990991,1016.1036036036038,28.225100100100107,0
4725,4,1,0,40,0.025,0.0,1.0,40,1250,1000,250,0.8,15,10,5,325.90457879322537,0.43402777777777773,0.14116491422246824,0.18165008447851883,129401.82317029865,434.52933507832046,129836.35250537697,1165,0,297.225,36,4,22,37.346430547869396,0.6142939814814814,45.63626126126126,1017.4549549549548,28.262637637637635,0
4726,4,0,1,39,0.0,0.025,0.975,40,900,500,400,0.5555555555555556,13,5,8,328.50567113258177,0.4344951923076923,0.1357423387542871,0.1836340606906251,129516.42679419293,509.3761413440551,130025.80293553698,1166,1,298.225,36,4,16,37.16395618984401,0.6154513888888888,45.52364864864865,1017.9054054054061,28.275150150150168,0
4727,4,0,0,39,0.0,0.0,1.0,39,1200,900,300,0.75,15,9,6,335.9411517224217,0.4319331983805668,0.14030070110627824,0.18751699741294162,129459.11864144553,898.1290834753709,130357.2477249209,1167,3,306.84615384615387,36,3,17,37.032938659584666,0.6148726851851851,45.57995495495496,1017.6801801801804,28.2688938938939,0
4728,4,0,0,39,0.0,0.0,1.0,39,750,300,450,0.4,12,3,9,336.670353982301,0.4315395861448493,0.13509189925119158,0.18833539603960384,129545.08562616662,922.7979668857931,130467.88359305241,1168,4,307.84615384615387,36,3,17,36.92708333333333,0.6157407407407407,45.49549549549549,1018.0180180180174,28.27827827827826,0
4729,4,0,0,39,0.0,0.0,1.0,39,1200,900,300,0.75,15,9,6,339.40780157590166,0.4311178587494377,0.13913176606675082,0.19042209413476774,129659.75265806357,1001.5063205097113,130661.25897857329,1169,5,308.84615384615387,36,3,17,36.740979286451434,0.6168981481481481,45.38288288288289,1018.4684684684693,28.290790790790812,0
4730,4,1,0,40,0.025,0.0,1.0,40,750,500,250,0.6666666666666666,10,5,5,335.4862945939905,0.43246527777777777,0.14890603160950433,0.18991832172968404,130010.85820877599,723.3722154894028,130734.23042426539,1170,0,302.1,37,3,19,36.48476418306276,0.6185247747747749,45.038377192982466,1019.8464912280718,27.563418681839778,0
4731,4,1,0,41,0.024390243902439025,0.0,1.0,41,1300,1000,300,0.7692307692307693,16,10,6,327.55089606084994,0.43467987804878044,0.142267695755532,0.18743637270902194,130430.54112803945,344.77158837335344,130775.3127164128,1171,0,295.7073170731707,37,4,20,36.26243380563905,0.6227477477477478,44.627192982456144,1021.4912280701758,27.60787102892367,0
4732,4,0,1,40,0.0,0.024390243902439025,0.975609756097561,41,1100,900,200,0.8181818181818182,13,9,4,327.7466463514411,0.4350863821138211,0.13561415167895507,0.18836339317436088,130598.60365689438,360.6508733456366,130959.25453024002,1172,1,296.7073170731707,37,4,17,36.08757062146892,0.6244369369369369,44.46271929824561,1022.1491228070172,27.62565196775722,0
4733,4,0,1,39,0.0,0.025,0.975,40,800,300,500,0.375,13,3,10,336.81093294625873,0.43273237179487184,0.13574065909842403,0.19304394154272916,130492.60567577698,790.267252049332,131282.8729278263,1173,3,305.1,36,4,17,35.96315992505236,0.6252893518518519,44.566441441441434,1021.7342342342331,28.381506506506476,0
4734,4,0,0,39,0.0,0.0,1.0,39,1050,800,250,0.7619047619047619,13,8,5,346.12873877077357,0.4325798470535313,0.13364923680856222,0.1988720164010866,130587.70743580672,1240.0316947445071,131827.73913055123,1174,4,304.71794871794873,35,4,17,35.628868946514174,0.6282738095238095,44.473379629629626,1022.1064814814812,29.20304232804232,0
4735,4,0,0,39,0.0,0.0,1.0,39,1100,700,400,0.6363636363636364,15,7,8,344.84286389414024,0.4324392712550607,0.13092251950947653,0.1982846467391304,130617.28395061711,1208.4876543209705,131825.77160493808,1175,5,305.71794871794873,35,4,17,35.631793478260875,0.6285714285714286,44.444444444444436,1022.2222222222208,29.206349206349167,0
4736,4,0,0,39,0.0,0.0,1.0,39,750,400,350,0.5333333333333333,11,4,7,341.65039695051564,0.43241115609536657,0.13459491358401188,0.19698585744175431,130722.8274516069,1132.3011778670448,131855.12862947394,1176,6,306.71794871794873,36,3,17,35.60662371985464,0.6276041666666667,44.34121621621621,1022.6351351351342,28.406531531531506,0
4737,4,0,1,38,0.0,0.02564102564102564,0.9743589743589743,39,950,800,150,0.8421052631578947,11,8,3,341.4378965055757,0.4319613135402609,0.13274163907214676,0.19715705110999018,130780.41459956585,1130.6779330005756,131911.09253256643,1177,7,307.71794871794873,36,3,18,35.55382766340049,0.6281828703703703,44.28490990990991,1022.8603603603609,28.412787787787803,0
4738,4,0,2,36,0.0,0.05263157894736842,0.9473684210526316,38,750,400,350,0.5333333333333333,11,4,7,372.5126725546916,0.4318397344713134,0.08953783350342581,0.20612672408375823,129115.5360385725,2019.4346796120644,131134.97071818457,1178,8,304.1842105263158,36,2,18,36.45290858725762,0.611400462962963,45.9177927927928,1016.3288288288301,28.23135635635639,7
4739,4,1,0,37,0.02702702702702703,0.0,1.0,37,1500,1100,400,0.7333333333333333,19,11,8,375.9303391855939,0.4318380880880881,0.09579952055964247,0.20943289952282168,129383.0002834467,2327.827569882348,131710.82785332904,1179,0,310.8378378378378,34,3,21,36.09315274202357,0.6182598039215687,45.654761904761905,1017.3809523809523,29.92296918767507,0
4740,4,0,1,36,0.0,0.02702702702702703,0.972972972972973,37,1300,800,500,0.6153846153846154,18,8,10,378.6384173513199,0.4314627127127127,0.1013379184353338,0.21175520645985188,129534.44054705206,2409.3431122448806,131943.78365929693,1180,1,311.8378378378378,34,3,17,35.8698300393716,0.6197916666666667,45.50595238095237,1017.9761904761897,29.94047619047617,0
4741,4,0,0,36,0.0,0.0,1.0,36,1100,900,200,0.8181818181818182,13,9,4,389.8695164647178,0.42752976190476194,0.10780909176067555,0.2174000399735762,129419.51600646375,2891.3448253075567,132310.8608317713,1181,11,321.47222222222223,33,3,21,35.70132783331324,0.6208964646464646,45.6188725490196,1017.5245098039206,30.834076054664262,0
4742,4,0,0,36,0.0,0.0,1.0,36,1100,900,200,0.8181818181818182,13,9,4,392.81012738039993,0.42761243386243386,0.09954260953298011,0.2199101440887035,129575.43372741235,2979.708525567067,132555.14225297942,1182,12,322.47222222222223,33,3,17,35.467320654790555,0.6224747474747474,45.46568627450979,1018.1372549019593,30.85264408793816,0
4743,4,1,0,37,0.02702702702702703,0.0,1.0,37,800,600,200,0.75,10,6,4,381.9123969579523,0.43018018018018017,0.10179149497384365,0.2160806864162361,129989.2928004533,2528.904478458023,132518.19727891134,1183,0,314.72972972972974,34,3,18,35.32303097517316,0.6243872549019608,45.059523809523796,1019.761904761903,29.9929971988795,0
4744,4,0,1,36,0.0,0.02702702702702703,0.972972972972973,37,750,400,350,0.5333333333333333,11,4,7,383.4983776953883,0.42955455455455455,0.10391371534895466,0.2176543772747995,130110.72137188185,2579.4501133786557,132690.1714852605,1184,1,315.72972972972974,34,3,18,35.15898483080513,0.6256127450980392,44.940476190476176,1020.2380952380934,30.007002801120393,0
4745,4,2,0,38,0.05263157894736842,0.0,1.0,38,1200,1000,200,0.8333333333333334,14,10,4,370.8274080886958,0.4320323613086771,0.10415522433287228,0.21248028187185256,130481.60750973175,2077.408417411071,132559.0159271428,1185,0,307.7368421052632,33,5,21,35.10542861141098,0.6316287878787878,44.577205882352935,1021.6911764705875,30.960338680926895,0
4746,4,0,2,36,0.0,0.05263157894736842,0.9473684210526316,38,1000,600,400,0.6,14,6,8,367.50972704200996,0.43132112375533427,0.09959994699613262,0.21126110497983486,130606.84479827466,1999.8571763264117,132606.70197460108,1186,1,308.7368421052632,33,5,17,35.06311693242218,0.6328914141414141,44.4546568627451,1022.1813725490192,30.975193107546037,0
4747,4,0,1,35,0.0,0.027777777777777776,0.9722222222222222,36,1150,600,550,0.5217391304347826,17,6,11,382.91115622106554,0.4271990740740741,0.1079684063187365,0.21905041091987493,130419.01139285353,2787.7788891291584,133206.79028198268,1187,4,326.8333333333333,33,3,19,34.86040291941612,0.6309974747474747,44.63848039215685,1021.4460784313711,30.952911467617305,0
4748,4,0,1,34,0.0,0.02857142857142857,0.9714285714285714,35,1150,900,250,0.782608695652174,14,9,5,382.56358941623716,0.42584033613445377,0.09891058581706136,0.2197369377225492,130575.52984429052,2990.6886774317422,133566.21852172227,1188,5,331.9142857142857,33,2,17,34.710231814548365,0.6325757575757576,44.48529411764705,1022.0588235294106,30.97147950089123,0
4749,4,0,0,34,0.0,0.0,1.0,34,1100,900,200,0.8181818181818182,13,9,4,394.4244554226163,0.4235554070112894,0.09598154270973391,0.22660510763989186,130585.01882779802,3501.184987501253,134086.20381529926,1189,6,340.8235294117647,32,2,18,34.39751904467777,0.6350911458333333,44.47601010101009,1022.0959595959583,31.940498737373698,0
4750,4,0,0,34,0.0,0.0,1.0,34,1300,900,400,0.6923076923076923,17,9,8,394.3020469266602,0.4222556446821153,0.08761793394972539,0.2272919770860512,130714.10323245064,3508.167693347603,134222.27092579825,1190,7,341.8235294117647,32,2,18,34.269405687945024,0.6363932291666667,44.34974747474747,1022.601010101009,31.956281565656532,0
4751,4,0,0,34,0.0,0.0,1.0,34,1050,800,250,0.7619047619047619,13,8,5,393.1830519947362,0.4222185086155674,0.09002882723265837,0.22702608012896336,130778.66934815311,3483.99127002345,134262.66061817657,1191,8,342.8235294117647,32,2,18,34.232399292268425,0.6370442708333333,44.28661616161615,1022.8535353535343,31.964172979797947,0
4752,4,0,0,34,0.0,0.0,1.0,34,1050,800,250,0.7619047619047619,13,8,5,393.1448778581247,0.4216800356506239,0.08550640490619466,0.22776549214010716,130907.84940631047,3493.150093102733,134400.9994994132,1192,9,343.8235294117647,32,2,18,34.10214887929262,0.6383463541666667,44.16035353535353,1023.358585858585,31.97995580808078,0
4753,4,0,1,33,0.0,0.029411764705882353,0.9705882352941176,34,700,500,200,0.7142857142857143,9,5,4,393.6094483831288,0.4218100118835413,0.08578370929136137,0.2289937321655077,131069.41415416809,3518.0319610244005,134587.4461151925,1193,10,344.8235294117647,32,2,18,33.92622277024249,0.6399739583333333,44.00252525252526,1023.9898989899001,31.999684343434378,0
4754,4,0,0,33,0.0,0.0,1.0,33,1100,700,400,0.6363636363636364,15,7,8,384.15770338404127,0.4195864898989899,0.09076096701514746,0.20710415992423992,128078.62175835512,3240.477837456607,131319.0995958117,1194,11,354.57575757575756,31,2,19,37.21861332647286,0.612231182795699,46.94010416666667,1012.239583333334,32.65288978494626,8
4755,4,2,1,34,0.05714285714285714,0.02857142857142857,0.9714285714285714,35,1100,1000,100,0.9090909090909091,12,10,2,366.86872426726643,0.4262254901960784,0.09904118093398662,0.2015345166996044,128827.8847078047,2452.584342560557,131280.46905036527,1195,0,335.25714285714287,33,2,16,36.889888137775635,0.6148989898989898,46.200980392156865,1015.1960784313726,30.763517528223414,0
4756,4,0,0,34,0.0,0.0,1.0,34,1150,1000,150,0.8695652173913043,13,10,3,377.03404474429476,0.4230540701128936,0.10479633505554475,0.20672576068585544,128752.49496224876,2908.8147893072164,131661.30975155596,1196,1,346.11764705882354,32,2,17,36.708965746039645,0.6165364583333333,46.275252525252526,1014.8989898989901,31.71559343434344,0
4757,4,2,0,36,0.05555555555555555,0.0,1.0,36,1050,700,350,0.6666666666666666,14,7,7,355.0674339603546,0.4288194444444444,0.09750833232943834,0.19768040035579482,129357.17520004313,1986.8852228166052,131344.06042285974,1197,0,327.8333333333333,33,3,19,36.65007729992372,0.6202651515151515,45.68014705882352,1017.279411764705,30.826648841354697,0
4758,4,0,0,36,0.0,0.0,1.0,36,850,700,150,0.8235294117647058,10,7,3,356.21592644370764,0.42848875661375657,0.10051173991571338,0.19894911022965625,129481.87183114652,2024.700986399442,131506.57281754597,1198,1,328.8333333333333,33,3,16,36.493954445113374,0.6215277777777778,45.55759803921568,1017.7696078431361,30.84150326797382,0
4759,4,0,1,35,0.0,0.027777777777777776,0.9722222222222222,36,750,300,450,0.4,12,3,9,357.30421154358373,0.428422619047619,0.10372866848552964,0.20003257341671757,129575.43372741224,2059.569636678163,131635.0033640904,1199,2,329.8333333333333,33,3,16,36.371068046862476,0.6224747474747474,45.465686274509785,1018.1372549019584,30.85264408793813,0
4760,4,0,0,35,0.0,0.0,1.0,35,1350,1000,350,0.7407407407407407,17,10,7,366.42989050192205,0.4252801120448179,0.1095509799057306,0.20486531048727405,129522.50567544109,2492.1835144372744,132014.68918987835,1200,3,340.2,32,3,16,36.192683784007265,0.6243489583333333,45.517676767676754,1017.9292929292914,31.810290404040355,0
4761,4,2,0,37,0.05405405405405406,0.0,1.0,37,550,300,250,0.5454545454545454,8,3,5,348.1644641054117,0.42924174174174173,0.1175910542526668,0.19806330131225539,130201.83000283418,1666.3300736961123,131868.1600765303,1201,0,322.7567567567568,34,3,20,35.967815622691404,0.626531862745098,44.85119047619046,1020.5952380952357,30.01750700280105,0
4762,4,0,1,36,0.0,0.02702702702702703,0.972972972972973,37,1000,700,300,0.7,13,7,6,367.9360186475002,0.42977352352352355,0.054750708529267555,0.2032578588450753,129050.14349489793,2141.8544501133715,131191.9979450113,1202,1,323.7567567567568,34,3,21,36.635910954891614,0.6148897058823529,45.982142857142854,1016.0714285714283,29.884453781512597,8
4763,4,0,0,36,0.0,0.0,1.0,36,750,300,450,0.4,12,3,9,370.036829854079,0.4273974867724868,0.07729002519161687,0.20455635954333495,129076.82742214543,2352.636005382554,131429.46342752798,1203,2,333.72222222222223,33,3,21,36.55531435922172,0.6174242424242424,45.95588235294118,1016.1764705882362,30.7932263814617,0
4764,4,1,0,37,0.02702702702702703,0.0,1.0,37,1300,1100,200,0.8461538461538461,15,11,4,364.1851364457119,0.4296171171171171,0.08263645297115096,0.20356135553957508,129513.05537533658,2033.4060217224383,131546.46139705903,1204,0,325.6756756756757,33,4,17,36.259430933461765,0.6218434343434344,45.52696078431374,1017.8921568627464,30.84521687462868,0
4765,4,0,2,35,0.0,0.05405405405405406,0.9459459459459459,37,1100,800,300,0.7272727272727273,14,8,6,364.18814455670616,0.4295858358358358,0.07635980542621534,0.20453593632130684,129700.23548635143,2047.057622068437,131747.29310841986,1205,1,326.6756756756757,33,4,18,36.06883622072505,0.6237373737373737,45.34313725490196,1018.6274509803924,30.867498514557344,0
4766,4,0,0,35,0.0,0.0,1.0,35,1050,800,250,0.7619047619047619,13,8,5,364.6218123372708,0.42783613445378155,0.0676935758075321,0.2059259237497456,129918.783115268,2474.244431228353,132393.02754649636,1206,2,325.8857142857143,33,2,19,35.83551208077893,0.6259469696969697,45.128676470588225,1019.4852941176457,30.89349376114078,0
4767,4,0,0,35,0.0,0.0,1.0,35,1050,700,350,0.6666666666666666,14,7,7,361.9370794171929,0.4278011204481793,0.06712672091186911,0.2049007057761822,130012.5027032872,2411.269103229532,132423.77180651674,1207,3,326.8857142857143,33,2,19,35.80869983177122,0.6268939393939394,45.036764705882355,1019.8529411764706,30.90463458110517,0
4768,4,1,0,36,0.027777777777777776,0.0,1.0,36,1050,700,350,0.6666666666666666,14,7,7,354.34567508705413,0.4283564814814815,0.0707261623798292,0.20238262580537505,130356.43029423781,2038.4877511053514,132394.91804534316,1208,0,318.77777777777777,33,3,21,35.65330113204529,0.6303661616161615,44.69975490196079,1021.200980392157,30.94548425430779,0
4769,4,0,0,36,0.0,0.0,1.0,36,950,800,150,0.8421052631578947,11,8,3,356.63670502446945,0.42781084656084656,0.07652544630961877,0.20484504958017064,130575.5298442908,2113.6053440984365,132689.13518838922,1209,1,319.77777777777777,33,3,17,35.37270183852917,0.6325757575757576,44.485294117647065,1022.0588235294128,30.9714795008913,0
4770,4,1,1,36,0.02702702702702703,0.02702702702702703,0.972972972972973,37,1050,800,250,0.7619047619047619,13,8,5,360.5423653924597,0.43002377377377377,0.15601059436675846,0.20009047061838872,129231.64859693893,1918.6968537415146,131150.34545068044,1210,0,312.1081081081081,34,3,17,36.638713265425594,0.6167279411764706,45.80357142857144,1016.7857142857156,29.905462184873986,8
4771,4,2,2,36,0.05263157894736842,0.05263157894736842,0.9473684210526316,38,950,700,250,0.7368421052631579,12,7,5,353.01789989609273,0.4333214793741109,0.1622472972245319,0.19767654139948626,129584.09857521013,1549.101267789791,131133.19984299992,1211,0,304.6842105263158,35,3,14,36.47135860710091,0.6181547619047619,45.45717592592593,1018.1712962962969,29.090608465608483,0
4772,4,1,1,36,0.02702702702702703,0.02702702702702703,0.972972972972973,37,1500,1100,400,0.7333333333333333,19,11,8,360.63115348305337,0.42752127127127126,0.16678395279873381,0.20163706261179004,129525.1833231526,1942.1632533865059,131467.3465765391,1212,0,313.8918918918919,35,2,14,36.33752605647148,0.6175595238095238,45.515046296296305,1017.9398148148161,29.083994708994748,0
4773,4,0,0,36,0.0,0.0,1.0,36,800,200,600,0.25,14,2,12,370.2776427264864,0.42569444444444443,0.17567681730156837,0.20676052042251694,129473.85381235839,2388.2546768707616,131862.10848922914,1213,3,323.6111111111111,34,2,15,36.144334620033526,0.6191789215686274,45.5654761904762,1017.7380952380961,29.93347338935577,0
4774,4,1,0,37,0.02702702702702703,0.0,1.0,37,1400,1000,400,0.7142857142857143,18,10,8,360.2001648241505,0.4261136136136136,0.1749024228588265,0.2033745546007127,129908.3719135803,1958.6033950617364,131866.97530864202,1214,0,315.8378378378378,35,2,16,35.95878746594005,0.6214285714285714,45.13888888888889,1019.4444444444448,29.126984126984137,0
4775,4,0,0,37,0.0,0.0,1.0,37,1200,800,400,0.6666666666666666,16,8,8,362.1830421891989,0.42627002002002,0.17992663566880518,0.20511291566653084,130026.38996056237,2018.6706961591158,132045.0606567215,1215,1,316.8378378378378,35,2,17,35.788318958995305,0.6226190476190476,45.023148148148145,1019.9074074074072,29.140211640211632,0
4776,4,1,0,38,0.02631578947368421,0.0,1.0,38,1000,600,400,0.6,14,6,8,349.9955219927936,0.4272018729255571,0.17636797375875957,0.20017566309697998,130410.31867551855,1528.8198463220015,131939.13852184053,1216,0,309.4736842105263,35,3,19,35.70974976392823,0.6264880952380952,44.64699074074073,1021.4120370370359,29.183201058201025,0
4777,4,0,0,38,0.0,0.0,1.0,38,700,500,200,0.7142857142857143,9,5,4,348.25648529716864,0.42678698435277385,0.17418187302066013,0.1997521711495897,130521.3723013554,1490.9828747666525,132012.35517612204,1217,1,310.4736842105263,36,2,16,35.64166850341634,0.6255787037037037,44.538288288288285,1021.8468468468468,28.384634634634633,0
4778,4,0,0,38,0.0,0.0,1.0,38,1250,700,550,0.56,18,7,11,351.9430607288388,0.42680180180180183,0.18286010699030375,0.20292031330022728,130722.82745160676,1601.3984000892515,132324.225851696,1218,2,311.4736842105263,36,2,16,35.343482729508494,0.6276041666666667,44.3412162162162,1022.635135135133,28.406531531531474,0
4779,4,0,0,38,0.0,0.0,1.0,38,1100,800,300,0.7272727272727273,14,8,6,351.06227764406253,0.427290777619725,0.18111046083777071,0.2027144734800395,130780.41459956575,1582.414044111672,132362.8286436774,1219,3,312.4736842105263,36,2,17,35.30771771441153,0.6281828703703703,44.284909909909906,1022.8603603603601,28.41278778778778,0
4780,4,0,0,38,0.0,0.0,1.0,38,950,700,250,0.7368421052631579,12,7,5,370.7072063182184,0.427898293029872,0.20246970242008455,0.19735391171997504,127572.62613378686,1895.7815328773315,129468.40766666419,1220,4,313.4736842105263,34,4,16,38.07791264042736,0.5998774509803921,47.44047619047619,1010.2380952380954,29.71288515406163,8
4781,4,0,0,38,0.0,0.0,1.0,38,1150,700,450,0.6086956521739131,16,7,9,348.6197023696308,0.427275960170697,0.1381203260081676,0.18049406155728542,126439.93391617975,1215.8904258988794,127655.82434207863,1221,5,314.4736842105263,36,2,17,39.79864143619602,0.5842013888888888,48.56418918918919,1005.7432432432438,27.93731231231233,7
4782,4,1,0,39,0.02564102564102564,0.0,1.0,39,1000,700,300,0.7,13,7,6,348.3264310271944,0.4294309491677913,0.1546274670662524,0.18238014670705932,126898.60251471617,1040.427463257935,127939.0299779741,1222,0,307.38461538461536,37,2,19,39.3345077447673,0.5869932432432432,48.10855263157895,1007.5657894736851,27.23150782361311,0
4783,4,1,0,40,0.025,0.0,1.0,40,1400,900,500,0.6428571428571429,19,9,10,342.1588372412097,0.43134348290598296,0.1551036904894636,0.1819100540140139,127518.18700034512,726.5894800173041,128244.77648036242,1223,0,300.675,36,4,17,38.85466607202588,0.5951967592592593,47.49436936936938,1010.022522522524,28.056181181181223,0
4784,4,2,0,42,0.047619047619047616,0.0,1.0,42,1400,1100,300,0.7857142857142857,17,11,6,330.9583701154461,0.4361449864498645,0.1678154530294611,0.1792276062124285,128258.57688347127,92.71885906175802,128351.29574253302,1224,0,287.3095238095238,36,6,21,38.38127663516769,0.6027199074074074,46.762387387387385,1012.95045045045,28.1375125125125,0
4785,4,1,1,42,0.023255813953488372,0.023255813953488372,0.9767441860465116,43,750,400,350,0.5333333333333333,11,4,7,333.71223696449823,0.43747692875599853,0.19269533752968226,0.1828600801128731,128728.04763244443,-8.375052900909509,128719.67257954352,1225,0,281.6046511627907,37,6,16,37.83304069872141,0.6055743243243243,46.29934210526315,1014.802631578946,27.427098150782324,0
4786,4,1,1,42,0.023255813953488372,0.023255813953488372,0.9767441860465116,43,1300,700,600,0.5384615384615384,19,7,12,336.2732379002472,0.43874584717607973,0.20444627460039255,0.1851701979448327,128922.84765504758,70.66068405661579,128993.50833910418,1226,0,282.5581395348837,37,6,17,37.56972936010939,0.607545045045045,46.10745614035087,1015.5701754385955,27.4478425794215,0
4787,4,2,0,44,0.045454545454545456,0.0,1.0,44,1100,900,200,0.8181818181818182,13,9,4,326.3526420180036,0.44042899929527835,0.2114898309237938,0.1813613394078476,129285.00987082534,-361.1985178132084,128923.81135301213,1227,0,276.4318181818182,37,7,19,37.453616352201244,0.611204954954955,45.751096491228054,1016.9956140350853,27.486367946894198,0
4788,4,0,0,44,0.0,0.0,1.0,44,950,700,250,0.7368421052631579,12,7,5,330.35659148313664,0.4401537174066244,0.21466116058744622,0.18410683557789911,129396.5465936632,-250.5995835257256,129145.94701013748,1228,1,277.4318181818182,37,7,19,37.23854492222581,0.6123310810810811,45.64144736842104,1017.4342105263139,27.49822190611659,0
4789,4,0,2,42,0.0,0.045454545454545456,0.9545454545454546,44,1400,1000,400,0.7142857142857143,18,10,8,338.4576511553363,0.4397683227625088,0.23079053058394106,0.17817633961267243,127118.94729573005,-195.12393618965004,126923.8233595404,1229,2,278.4318181818182,38,6,17,39.35709997527986,0.5874451754385965,47.88995726495726,1008.4401709401702,26.537899235267638,8
4790,4,2,0,44,0.045454545454545456,0.0,1.0,44,1250,900,350,0.72,16,9,7,348.048696822902,0.43977933403805497,0.2758565989847712,0.18531241425435568,127577.25180802084,80.6192472057615,127657.8710552266,1230,0,279.27272727272725,38,6,14,38.64543675972926,0.5921052631578947,47.435897435897424,1010.2564102564087,26.585695006747596,0
4791,4,1,1,44,0.022222222222222223,0.022222222222222223,0.9777777777777777,45,1000,700,300,0.7,13,7,6,343.6946028454144,0.44109848484848485,0.2889849701461811,0.18486430631452663,127986.37695312474,-202.35460069447583,127784.02235243026,1231,0,274.0444444444444,39,6,16,38.336850593644904,0.594551282051282,47.031249999999986,1011.874999999998,25.945512820512768,0
4792,4,0,0,44,0.0,0.0,1.0,44,1100,700,400,0.6363636363636364,15,7,8,352.9015729860985,0.43854607117688515,0.2847003608722358,0.18992521018888198,128009.35057345309,234.94023486009849,128244.29080831319,1232,1,281.1818181818182,38,6,17,38.080438837274755,0.5964912280701755,47.008547008547005,1011.9658119658116,26.630679262258198,0
4793,4,4,2,46,0.08333333333333333,0.041666666666666664,0.9583333333333334,48,1450,1100,350,0.7586206896551724,18,11,7,327.1663703772526,0.44333628841607564,0.2806362742155972,0.18060089479080063,129020.64252635691,-1157.6142577542105,127863.0282686027,1233,0,258.6666666666667,40,8,16,37.70151878897003,0.6033854166666667,46.01117886178863,1015.9552845528475,25.398882113821188,0
4794,4,0,1,45,0.0,0.021739130434782608,0.9782608695652174,46,1550,1000,550,0.6451612903225806,21,10,11,341.7726967349788,0.4422000805152979,0.2862963183251055,0.1878464972280221,128848.62075617276,-392.6118827160616,128456.0088734567,1234,1,270.9130434782609,38,8,17,37.50569995440035,0.6049890350877193,46.18055555555555,1015.2777777777771,26.717836257309926,0
4795,4,0,2,43,0.0,0.044444444444444446,0.9555555555555556,45,1150,600,550,0.5217391304347826,17,6,11,340.68194783028565,0.4407407407407407,0.2748460522779592,0.1880176809006489,129011.37689248644,-209.63056560014033,128801.7463268863,1235,2,273.6222222222222,38,7,17,37.367669225645884,0.6066337719298245,46.020299145299134,1015.9188034188016,26.73470535312636,0
4796,4,0,3,40,0.0,0.06976744186046512,0.9302325581395349,43,1150,900,250,0.782608695652174,14,9,5,370.21630773271585,0.4396917681801403,0.2632499731377582,0.1906647866730843,126223.2160572562,772.6337836800284,126995.84984093622,1236,3,286.06976744186045,34,9,18,39.47917900722664,0.5860906862745099,48.779761904761905,1004.8809523809521,29.555322128851532,7
4797,4,3,1,42,0.06976744186046512,0.023255813953488372,0.9767441860465116,43,1350,900,450,0.6666666666666666,18,9,9,361.39017276294305,0.4396917681801403,0.26768505502610984,0.18876454282011584,126800.41822059329,564.8850094307288,127365.30323002402,1237,0,284.2325581395349,35,8,17,39.10643147169231,0.5898809523809524,48.20601851851852,1007.1759259259261,28.776455026455032,0
4798,4,1,0,43,0.023255813953488372,0.0,1.0,43,950,700,250,0.7368421052631579,12,7,5,359.69869872770073,0.4406376891842008,0.27012645649351685,0.188419787672886,126917.01630015446,530.3771219135969,127447.39342206805,1238,0,285.2093023255814,35,8,18,39.0291178497588,0.5910714285714286,48.090277777777786,1007.6388888888899,28.78968253968257,0
4799,4,1,0,44,0.022727272727272728,0.0,1.0,44,800,300,500,0.375,13,3,10,348.6595840263384,0.4429175475687104,0.267501773123618,0.18395380958677773,127208.74592764069,70.63025120028627,127279.37617884098,1239,0,279.70454545454544,35,9,19,39.00776350007648,0.594047619047619,47.80092592592593,1008.796296296297,28.822751322751344,0
4800,4,0,0,44,0.0,0.0,1.0,44,1500,1300,200,0.8666666666666667,17,13,4,346.88341688312914,0.44344608879492603,0.2604606435875785,0.18367761254631285,127354.73632812512,35.4492187500141,127390.18554687513,1240,1,280.70454545454544,35,9,17,38.90286377708978,0.5955357142857143,47.65625000000001,1009.3750000000009,28.83928571428574,0
4801,4,3,1,46,0.06382978723404255,0.02127659574468085,0.9787234042553191,47,1200,800,400,0.6666666666666666,16,8,8,328.73537894568165,0.4483502929386371,0.26968758416374916,0.17787736258019782,128225.67389875095,-969.5369000657304,127256.13699868521,1241,0,263.72340425531917,38,9,21,38.47112341772154,0.5986842105263157,46.7948717948718,1012.8205128205138,26.653171390013522,0
4802,4,2,2,46,0.041666666666666664,0.041666666666666664,0.9583333333333334,48,750,400,350,0.5333333333333333,11,4,7,321.83426589229504,0.44789819739952713,0.2672548113142932,0.17540508086201612,128513.93771701427,-1327.9622395832944,127185.97547743097,1242,0,259.125,39,9,16,38.35225327032394,0.5998931623931624,46.510416666666686,1013.9583333333364,25.998931623931703,0
4803,4,2,0,48,0.041666666666666664,0.0,1.0,48,1450,1000,450,0.6896551724137931,19,10,9,325.88576689154746,0.448119828605201,0.2884064477509831,0.17891587596383857,128804.55864800366,-1204.8855251735908,127599.67312283006,1243,0,260.0833333333333,39,9,18,37.95375833760903,0.6028311965811965,46.22395833333334,1015.1041666666682,26.028311965812005,0
4804,4,0,0,48,0.0,0.0,1.0,48,1250,900,350,0.72,16,9,7,325.83352510671483,0.4480921247044917,0.29173755671203705,0.17928020830761535,128891.61544054466,-1200.558116861652,127691.05732368301,1244,1,261.0833333333333,40,8,18,37.86654323458769,0.6020833333333333,46.13821138211382,1015.4471544715448,25.38617886178862,0
4805,4,1,0,49,0.02040816326530612,0.0,1.0,49,900,500,400,0.5555555555555556,13,5,8,363.104761368046,0.4494579081632653,0.2989992982591059,0.19417415828321455,127753.08956916108,-213.3804068176844,127539.7091623434,1245,0,256.734693877551,34,15,18,38.08486418590046,0.6017156862745099,47.261904761904766,1010.9523809523815,29.733893557422988,8
4806,4,1,2,48,0.02,0.04,0.96,50,1800,1600,200,0.8888888888888888,20,16,4,353.77398431810866,0.45163265306122446,0.2993415637860084,0.19103795153177885,128144.5312500001,-933.1597222222078,127211.3715277779,1246,0,252.58,36,14,19,37.92009602194789,0.6015625,46.87500000000001,1012.5000000000008,28.12500000000002,0
4807,4,0,0,48,0.0,0.0,1.0,48,1300,1100,200,0.8461538461538461,15,11,4,372.544638235658,0.44960660460992913,0.36880019763676986,0.18726451155954704,125221.05724224549,-226.51052826244165,124994.54671398304,1247,1,263.8541666666667,32,16,18,40.45719271687483,0.5804036458333333,49.779040404040394,1000.8838383838367,31.2776199494949,8
4808,4,3,1,50,0.058823529411764705,0.0196078431372549,0.9803921568627451,51,1400,1000,400,0.7142857142857143,18,10,8,349.22254134681407,0.45248366013071895,0.38522050920782913,0.1800860183524783,126276.38996056248,-1380.2876371742022,124896.10232338827,1248,0,249.27450980392157,35,16,18,39.95182711500077,0.5845238095238094,48.726851851851855,1005.0925925925931,28.71693121693123,0
4809,4,3,0,53,0.05660377358490566,0.0,1.0,53,1900,1500,400,0.7894736842105263,23,15,8,336.06615884877255,0.4551735607160135,0.38218473945027576,0.1766797215903068,127064.37467538094,-2059.59273526469,125004.78194011626,1249,0,240.33962264150944,37,16,23,39.47333242704369,0.5886824324324325,47.944078947368425,1008.2236842105268,27.24928876244667,0
4810,4,0,1,52,0.0,0.018867924528301886,0.9811320754716981,53,1400,900,500,0.6428571428571429,19,9,10,337.4238725372314,0.4554910498306725,0.3044277267773259,0.1688259950424311,125028.15473835317,-2140.1104630286386,122888.04427532453,1250,1,241.33962264150944,36,17,18,41.53530007881993,0.5697337962962963,49.971846846846844,1000.1126126126123,27.780905905905897,8
4811,4,2,1,53,0.037037037037037035,0.018518518518518517,0.9814814814814815,54,1350,800,550,0.5925925925925926,19,8,11,329.8361480194283,0.45625873515024457,0.31646774755503704,0.16733418785758108,125603.79756271145,-2514.265447060648,123089.5321156508,1251,0,237.66666666666666,37,17,12,41.131134689710485,0.5737612612612613,49.3969298245614,1002.4122807017532,27.092223802750084,0
4812,4,3,2,54,0.05357142857142857,0.03571428571428571,0.9642857142857143,56,1400,1000,400,0.7142857142857143,18,10,8,318.1801450628963,0.459084145021645,0.33911175103267577,0.16408980329833722,126279.29823133696,-3164.086914062481,123115.21131727447,1252,0,230.08928571428572,39,17,12,40.72885359450029,0.577190170940171,48.72395833333334,1005.1041666666679,25.77190170940174,0
4813,4,3,2,55,0.05263157894736842,0.03508771929824561,0.9649122807017544,57,1900,1500,400,0.7894736842105263,23,15,8,317.01193689726193,0.4606829573934837,0.35853559226016607,0.16552098496585174,126784.78109095112,-3361.5421954524486,123423.23889549867,1253,0,226.89473684210526,40,17,16,40.23986713757149,0.5807291666666667,48.22154471544715,1007.113821138211,25.177845528455276,0
4814,4,3,3,55,0.05172413793103448,0.05172413793103448,0.9482758620689655,58,1750,1300,450,0.7428571428571429,22,13,9,311.1819681294234,0.46005999193385766,0.37924766122392306,0.1650286029001114,127417.32927256534,-3670.0049406336725,123747.32433193167,1254,0,223.75862068965517,41,17,16,39.73983410304282,0.5856199186991871,47.594246031746025,1009.6230158730145,24.62495160665889,0
4815,4,2,3,54,0.03508771929824561,0.05263157894736842,0.9473684210526316,57,2000,1600,400,0.8,24,16,8,320.0958264678614,0.46017387218045114,0.395072187511031,0.17032936376287702,127553.56021548023,-3234.127544781541,124319.43267069869,1255,0,228.33333333333334,40,17,18,39.37562877263582,0.5885416666666667,47.459349593495936,1010.1626016260166,25.254065040650413,0
4816,4,1,0,55,0.01818181818181818,0.0,1.0,55,1200,600,600,0.5,18,6,12,326.93881885506556,0.45815095398428735,0.39501508592417633,0.17447527065631743,127670.36132812515,-2651.9205729166542,125018.44075520849,1256,0,235.16363636363636,39,16,20,39.08343640486497,0.5913461538461539,47.34375000000001,1010.6250000000011,25.91346153846157,0
4817,4,2,1,56,0.03508771929824561,0.017543859649122806,0.9824561403508771,57,1350,1000,350,0.7407407407407407,17,10,7,316.8702547118961,0.4598344820384294,0.3956504747721197,0.17144022575780465,128221.71512492587,-3273.191587503693,124948.52353742218,1257,0,227.87719298245614,40,17,22,38.77558699578569,0.5953125,46.79878048780489,1012.8048780487824,25.32012195121956,0
4818,4,1,1,56,0.017543859649122806,0.017543859649122806,0.9824561403508771,57,1750,1400,350,0.8,21,14,7,317.8237529822231,0.45918180868838765,0.39941362082103593,0.17228847164109803,128298.92223750793,-3244.7110061801327,125054.21123132779,1258,0,228.66666666666666,40,17,23,38.67280235396396,0.59609375,46.72256097560978,1013.109756097565,25.327743902439124,0
4819,4,0,0,56,0.0,0.0,1.0,56,1400,1200,200,0.8571428571428571,16,12,4,323.53226256775736,0.4588541666666666,0.4036753637732058,0.17493212135039124,128195.98458465566,-2904.8926110449784,125291.09197361067,1259,1,233.64285714285714,40,16,23,38.63313263087472,0.5950520833333333,46.82418699186994,1012.7032520325232,25.31758130081308,0
4820,4,0,0,56,0.0,0.0,1.0,56,1600,1000,600,0.625,22,10,12,325.51008147145154,0.45871888528138527,0.39933355774877866,0.17691073801170537,128401.90120174864,-2840.7773357458827,125561.12386600276,1260,2,234.64285714285714,40,16,15,38.37319094889536,0.5971354166666667,46.62093495934961,1013.5162601626043,25.33790650406511,0
4821,4,2,1,57,0.034482758620689655,0.017241379310344827,0.9827586206896551,58,1700,1200,500,0.7058823529411765,22,12,10,316.26308207505946,0.4600851986287558,0.395739087807494,0.1741856733173254,128930.61682178079,-3444.8011500210064,125485.81567175977,1261,0,227.51724137931035,42,16,17,38.06988041853515,0.5994543650793651,46.0998062015504,1015.6007751938004,24.180970837947626,0
4822,4,0,1,56,0.0,0.017543859649122806,0.9824561403508771,57,1450,900,550,0.6206896551724138,20,9,11,324.5104312925784,0.4592209690893902,0.3931970200973758,0.17869893949123902,128924.17332963305,-3032.5521817523068,125891.62114788074,1262,1,232.43859649122808,41,16,17,37.86703054280225,0.6008638211382114,46.106150793650805,1015.575396825399,24.770131629887782,0
4823,4,1,4,53,0.017543859649122806,0.07017543859649122,0.9298245614035088,57,1000,600,400,0.6,14,6,8,323.3298442066146,0.458516081871345,0.39435388941148686,0.17827540521440655,128974.5540143142,-3059.735508786831,125914.81850552736,1263,0,233.2982456140351,41,16,18,37.84579792948532,0.6013719512195121,46.05654761904763,1015.7738095238107,24.774970963995383,0
4824,4,1,0,54,0.018518518518518517,0.0,1.0,54,1850,1600,250,0.8648648648648649,21,16,5,338.33701333139715,0.45791113440484504,0.39591960880653354,0.18532439173134976,128713.06911571311,-2090.320923734403,126622.74819197871,1264,0,244.72222222222223,38,16,19,37.730969677826934,0.6036184210526316,46.314102564102555,1014.7435897435878,26.703778677462836,0
4825,4,0,1,53,0.0,0.018518518518518517,0.9814814814814815,54,1350,1000,350,0.7407407407407407,17,10,7,338.72581103393225,0.45786017936175166,0.39186036349266007,0.18621322505063367,128857.43408203115,-2070.532226562516,126786.90185546863,1265,1,245.72222222222223,39,15,19,37.57406124961525,0.6033653846153846,46.17187499999999,1015.3124999999992,26.033653846153825,0
4826,4,0,0,53,0.0,0.0,1.0,53,1550,1000,550,0.6451612903225806,21,10,11,344.7273130193909,0.4566854136429608,0.3921866931479645,0.18908253312264467,128767.2812111911,-1722.080228650782,127045.20098254032,1266,2,251.1320754716981,38,15,19,37.51359649122804,0.6041666666666667,46.26068376068374,1014.957264957262,26.709401709401632,0
4827,4,0,1,52,0.0,0.018867924528301886,0.9811320754716981,53,1700,1300,400,0.7647058823529411,21,13,8,344.46750417788746,0.4566400580551524,0.39243218129726687,0.18932762823611682,128848.62075617262,-1723.1674382716299,127125.45331790099,1267,3,252.1320754716981,38,15,19,37.43730050159599,0.6049890350877193,46.18055555555554,1015.277777777776,26.717836257309894,0
4828,4,0,0,52,0.0,0.0,1.0,52,1100,600,500,0.5454545454545454,16,6,10,349.69297492188093,0.4556938159879336,0.3927823876803469,0.19242463700246795,128895.0100631924,-1385.2640956833036,127509.7459675091,1268,4,256.88461538461536,37,15,20,37.25738311197494,0.6072635135135135,46.13486842105262,1015.4605263157886,27.444879089615906,0
4829,4,0,1,51,0.0,0.019230769230769232,0.9807692307692307,52,1450,1000,450,0.6896551724137931,19,10,9,350.4782753302847,0.45557598039215685,0.38919058057659073,0.19326373468212835,128978.5318559556,-1359.1653200985022,127619.3665358571,1269,5,257.88461538461536,37,15,20,37.15232800805986,0.6081081081081081,46.05263157894736,1015.78947368421,27.4537695590327,0
4830,4,0,1,50,0.0,0.0196078431372549,0.9803921568627451,51,1300,900,400,0.6923076923076923,17,9,8,353.71851874546,0.45503267973856204,0.33772900332126743,0.18634037430817546,127147.30133310263,-1127.9898622652984,126019.31147083733,1270,6,262.4901960784314,37,14,18,38.94324853228961,0.589527027027027,47.861842105263165,1008.5526315789485,27.258179231863473,8
4831,4,2,2,50,0.038461538461538464,0.038461538461538464,0.9615384615384616,52,1400,1100,300,0.7857142857142857,17,11,6,344.87587561260233,0.4577677224736048,0.33024789322499215,0.18309018281427009,127459.90125868075,-1608.4309895833148,125851.47026909744,1271,0,257.65384615384613,39,13,17,38.84576370263393,0.5892094017094017,47.55208333333334,1009.7916666666682,25.892094017094056,0
4832,4,2,2,50,0.038461538461538464,0.038461538461538464,0.9615384615384616,52,1750,1200,550,0.6857142857142857,23,12,11,345.9273104888527,0.4550889265962796,0.3343901433137437,0.18424761034768733,127591.4184570314,-1572.5287543402642,126018.88970269113,1272,0,258.61538461538464,39,13,19,38.68450785304328,0.5905448717948718,47.42187500000001,1010.3125000000011,25.905448717948747,0
4833,4,2,0,52,0.038461538461538464,0.0,1.0,52,1450,1100,350,0.7586206896551724,18,11,7,342.7713168058742,0.4548611111111111,0.35560102585210585,0.1848530331142892,128091.80230034742,-1618.7608506944239,126473.041449653,1273,0,258.61538461538464,39,13,21,38.25246964395967,0.5956196581196581,46.92708333333334,1012.2916666666683,25.956196581196625,0
4834,4,3,1,54,0.05454545454545454,0.01818181818181818,0.9818181818181818,55,1200,700,500,0.5833333333333334,17,7,10,332.48652202498346,0.4575757575757576,0.37202797202797244,0.18314935535274535,128936.76757812513,-2426.0199652777605,126510.74761284736,1274,0,245.45454545454547,39,16,20,37.65170940170942,0.6041666666666667,46.09375000000001,1015.625000000001,26.041666666666693,0
4835,4,0,0,54,0.0,0.0,1.0,54,1850,1300,550,0.7027027027027027,24,13,11,335.3756797671145,0.45657174470067546,0.37291846864748157,0.18470922432596704,128929.98598327128,-2152.0036616991683,126777.98232157211,1275,1,251.0,38,16,20,37.58525317343434,0.6058114035087719,46.10042735042735,1015.598290598291,26.726270805218185,0
4836,4,0,3,51,0.0,0.05555555555555555,0.9444444444444444,54,1250,600,650,0.48,19,6,13,342.539740868248,0.4564261588632658,0.37922468305142876,0.18943244274062626,129092.79348381904,-1956.1175944188817,127136.67588940015,1276,2,252.0,38,16,20,37.237612139052445,0.6074561403508771,45.94017094017094,1016.2393162393155,26.743139901034617,0
4837,4,1,0,52,0.019230769230769232,0.0,1.0,52,2050,1400,650,0.6829268292682927,27,14,13,356.88812997474747,0.4570057189542484,0.38450748647123323,0.19735317354450796,129089.93632656174,-1185.8668051708523,127904.06952139089,1277,0,262.0769230769231,37,15,22,36.87598906632139,0.6092342342342343,45.942982456140335,1016.2280701754363,27.465623518255036,0
4838,4,0,1,51,0.0,0.019230769230769232,0.9807692307692307,52,1750,1100,650,0.6285714285714286,24,11,13,354.7433485622141,0.4568957390648567,0.3847730138713741,0.19672131147540978,129201.38888888896,-1233.2852416127985,127968.10364727616,1278,1,263.0769230769231,36,16,22,36.81693989071037,0.6122685185185186,45.833333333333336,1016.6666666666673,28.24074074074076,0
4839,4,1,0,52,0.019230769230769232,0.0,1.0,52,2250,1700,550,0.7555555555555555,28,17,11,352.152508213693,0.45808195072900953,0.38635535081032746,0.19695083652144119,129536.03512619255,-1276.7120652508595,128259.3230609417,1279,0,263.5576923076923,37,15,19,36.54225908372827,0.6137387387387387,45.504385964912274,1017.9824561403499,27.513039355144592,0
4840,4,0,1,51,0.0,0.019230769230769232,0.9807692307692307,52,1200,500,700,0.4166666666666667,19,5,14,348.5726185740943,0.457846279537456,0.3816114179716297,0.19564296398397354,129675.5988020352,-1359.7273920821838,128315.871409953,1280,1,264.5576923076923,37,15,19,36.49152671618763,0.6151463963963963,45.36732456140351,1018.5307017543856,27.527856804172586,0
4841,4,0,0,51,0.0,0.0,1.0,51,1500,1400,100,0.9333333333333333,16,14,2,353.98832001320875,0.45859477124183007,0.3814502478342945,0.19903867813297102,129745.78622118762,-1014.3014213537588,128731.48479983387,1281,2,261.54901960784315,36,15,19,36.28228510371763,0.6177662037037037,45.298423423423436,1018.806306306308,28.300175175175223,0
4842,4,0,0,51,0.0,0.0,1.0,51,1250,800,450,0.64,17,8,9,353.7317199157382,0.4586111111111111,0.38096723936563204,0.1991859572817373,129803.15778193748,-1016.9011494602573,128786.25663247722,1282,3,262.54901960784315,36,15,19,36.23052270969167,0.6183449074074074,45.242117117117125,1019.0315315315327,28.306431431431463,0
4843,4,0,0,51,0.0,0.0,1.0,51,1350,1000,350,0.7407407407407407,17,10,7,353.756722932755,0.45879084967320266,0.37703824071064873,0.1993460985393175,129831.84831791274,-1014.2221613505128,128817.62615656223,1283,4,263.54901960784315,36,15,20,36.200736648250476,0.6186342592592593,45.21396396396398,1019.144144144146,28.309559559559613,0
4844,4,0,0,51,0.0,0.0,1.0,51,2150,1500,650,0.6976744186046512,28,15,13,351.16149876467387,0.4578104575163399,0.37911526641561655,0.1993435575694203,130118.92804967135,-1061.4484416849227,129057.47960798643,1284,5,264.54901960784315,36,15,21,35.97544150110375,0.6215277777777778,44.932432432432435,1020.2702702702708,28.340840840840855,0
4845,4,0,1,50,0.0,0.0196078431372549,0.9803921568627451,51,1350,1000,350,0.7407407407407407,17,10,7,353.4666496324266,0.45725490196078433,0.3842349826073417,0.2012450824289142,130233.84871357842,-993.3355652950245,129240.5131482834,1285,6,265.54901960784315,36,15,22,35.8000514857311,0.6226851851851851,44.81981981981982,1020.7207207207206,28.35335335335335,0
4846,4,0,0,50,0.0,0.0,1.0,50,1600,900,700,0.5625,23,9,14,359.4281355292105,0.45693877551020406,0.38675839552238833,0.204950511323039,130292.97052154175,-633.8049361758565,129659.16558536589,1286,7,270.98,34,16,22,35.58792949315922,0.6274509803921569,44.76190476190475,1020.9523809523794,30.028011204481746,0
4847,4,1,1,50,0.0196078431372549,0.0196078431372549,0.9803921568627451,51,1550,900,650,0.5806451612903226,22,9,13,350.5478683143715,0.4571568627450981,0.39114473047539144,0.20187352468638547,130676.44702717742,-1038.3300111454296,129638.11701603199,1287,0,266.6470588235294,35,16,21,35.426099916987404,0.6291666666666667,44.38657407407406,1022.453703703702,29.212962962962916,0
4848,4,0,0,50,0.0,0.0,1.0,50,1250,800,450,0.64,17,8,9,356.9790452278845,0.45714285714285713,0.3895865843717252,0.20531674891974802,130627.42524092947,-673.7492913832498,129953.67594954622,1288,1,270.9,34,16,21,35.31137184115525,0.6308210784313726,44.434523809523796,1022.2619047619029,30.066526610644203,0
4849,4,0,0,50,0.0,0.0,1.0,50,1550,1100,450,0.7096774193548387,20,11,9,359.48886066994567,0.45740646258503403,0.3959720605355068,0.20724894719159934,130718.71456916085,-601.6156462585193,130117.09892290233,1289,2,271.9,34,16,21,35.154734187039196,0.6317401960784313,44.34523809523809,1022.6190476190463,30.077030812324892,0
4850,4,0,0,50,0.0,0.0,1.0,50,1300,900,400,0.6923076923076923,17,9,8,358.40396720296343,0.45751700680272106,0.3942246352222605,0.20750815154167632,130883.62328800141,-618.1580343364337,130265.46525366498,1290,3,272.9,35,15,21,35.01548184594502,0.63125,44.18402777777777,1023.2638888888879,29.236111111111082,0
4851,4,0,2,48,0.0,0.04,0.96,50,1650,1000,650,0.6060606060606061,23,10,13,355.8389386839499,0.45710034013605444,0.3845207956600363,0.20713571904444647,131090.9636488339,-670.5461248285496,130420.41752400534,1291,4,273.9,35,15,22,34.87134569017479,0.6333333333333333,43.981481481481474,1024.074074074073,29.259259259259228,0
4852,4,0,0,48,0.0,0.0,1.0,48,1350,1000,350,0.7407407407407407,17,10,7,375.7083987560871,0.4559230939716312,0.38811746345624387,0.21779940014201507,130931.84700963729,238.43891723356793,131170.28592687086,1292,5,284.3541666666667,34,14,22,34.52391338063664,0.6338848039215687,44.136904761904766,1023.4523809523818,30.101540616246524,0
4853,4,0,0,48,0.0,0.0,1.0,48,1750,1400,350,0.8,21,14,7,377.8290875272136,0.4550273345153664,0.3850389353788932,0.22024671199757095,131145.15306122453,310.09070294784965,131455.24376417237,1293,6,285.3541666666667,34,14,22,34.25344800867815,0.6360294117647058,43.92857142857143,1024.2857142857147,30.126050420168077,0
4854,4,1,0,49,0.02040816326530612,0.0,1.0,49,1750,1400,350,0.8,21,14,7,368.0392739245705,0.455109126984127,0.3767987300069988,0.21645261303406393,131485.18786344194,-121.40228333979758,131363.78558010215,1294,0,280.51020408163265,33,16,23,34.160169474648505,0.641729797979798,43.5968137254902,1025.6127450980393,31.07917409387998,0
4855,4,0,1,48,0.0,0.02040816326530612,0.9795918367346939,49,1350,700,650,0.5185185185185185,20,7,13,372.6074696726689,0.45434736394557823,0.3812675774871688,0.22004336749216719,131642.34459102273,10.184183967707213,131652.52877499044,1295,1,281.51020408163265,33,16,19,33.88414537059152,0.6433080808080809,43.443627450980394,1026.2254901960787,31.0977421271539,0
4856,4,0,0,48,0.0,0.0,1.0,48,1300,700,600,0.5384615384615384,19,7,12,380.39814194606913,0.4530972960992908,0.3853858936484489,0.22393873225868605,131522.3255280075,406.16965105603197,131928.49517906352,1296,9,288.3541666666667,32,16,23,33.805699162973895,0.64453125,43.56060606060607,1025.757575757577,32.05492424242428,0
4857,4,1,0,49,0.02040816326530612,0.0,1.0,49,1400,900,500,0.6428571428571429,19,9,10,373.12289500612076,0.4528061224489796,0.3820821098661369,0.2218096529036385,131893.9905925605,42.533520761240794,131936.52411332174,1297,0,283.44897959183675,33,16,21,33.61667859699355,0.6458333333333333,43.1985294117647,1027.2058823529408,31.127450980392144,0
4858,4,0,0,49,0.0,0.0,1.0,49,1950,1600,350,0.8205128205128205,23,16,7,369.0838037342594,0.45220379818594103,0.37160639331720513,0.22077922077922077,132130.12695312515,-46.58203124998482,132083.54492187517,1298,1,284.44897959183675,35,14,21,33.48214285714286,0.64375,42.96875000000001,1028.1250000000011,29.375000000000032,0
4859,4,0,0,49,0.0,0.0,1.0,49,1600,1100,500,0.6875,21,11,10,368.8681954249788,0.45170776643990934,0.3683800891264368,0.22169502292986043,132308.68115837185,-39.107108410500615,132269.57404996135,1299,2,285.44897959183675,35,14,21,33.30766959163009,0.6455357142857143,42.795138888888886,1028.8194444444441,29.394841269841262,0
4860,4,0,0,49,0.0,0.0,1.0,49,1600,1100,500,0.6875,21,11,10,368.03370702645503,0.45108772675736963,0.3665443970787483,0.22189814720716367,132428.63520408142,-52.329553059673515,132376.30565102174,1300,3,286.44897959183675,34,15,21,33.20827550312283,0.6488970588235294,42.678571428571416,1029.2857142857126,30.27310924369743,0
4861,4,0,0,49,0.0,0.0,1.0,49,1300,700,600,0.5384615384615384,19,7,12,368.1649287121968,0.45066255668934235,0.37227735852172295,0.22288277104893017,132581.84700963701,-37.60274943313266,132544.24426020388,1301,4,287.44897959183675,34,15,21,33.05061071937731,0.6504289215686274,42.52976190476189,1029.880952380951,30.29061624649856,0
4862,4,0,1,48,0.0,0.02040816326530612,0.9795918367346939,49,1700,1200,500,0.7058823529411765,22,12,10,366.0431586404341,0.4499362244897959,0.3674648096503246,0.22268697289882183,132765.8180980724,-80.39611678006369,132685.42198129234,1302,5,288.44897959183675,34,15,20,32.920132070386195,0.6522671568627452,42.35119047619047,1030.595238095237,30.31162464985991,0
4863,4,1,1,48,0.02040816326530612,0.02040816326530612,0.9795918367346939,49,1350,700,650,0.5185185185185185,20,7,13,366.4524028160395,0.44800524376417233,0.37534528963100433,0.22394313505424615,132934.57031249985,-57.16145833334798,132877.4088541665,1303,0,288.9591836734694,35,14,21,32.739898989899,0.6517857142857143,42.18749999999999,1031.2499999999989,29.464285714285683,0
4864,4,0,0,48,0.0,0.0,1.0,48,1950,1600,350,0.8205128205128205,23,16,7,365.5597885491106,0.44799977836879434,0.3627673696806526,0.22411278921091934,133053.95474322687,127.83511231137149,133181.78985553826,1304,1,292.8333333333333,35,13,21,32.64293994465636,0.6529761904761905,42.07175925925925,1031.7129629629617,29.477513227513192,0
4865,4,0,0,48,0.0,0.0,1.0,48,1600,1100,500,0.6875,21,11,10,360.6869231233285,0.44782432033096925,0.35883781763826583,0.22219111562569674,133233.13185871052,11.089677640597245,133244.2215363511,1305,2,293.8333333333333,35,13,21,32.58875186846038,0.6547619047619048,41.898148148148145,1032.4074074074072,29.49735449735449,0
4866,4,0,1,47,0.0,0.020833333333333332,0.9791666666666666,48,1000,700,300,0.7,13,7,6,359.7508829040205,0.447371823286052,0.35842580138982316,0.22197077297853884,133292.8843557099,-9.553433641972447,133283.33092206792,1306,3,294.8333333333333,35,13,21,32.55295897780767,0.6553571428571429,41.84027777777778,1032.638888888889,29.503968253968253,0
4867,4,0,0,47,0.0,0.0,1.0,47,1400,800,600,0.5714285714285714,20,8,12,371.4731890687686,0.44675069380203514,0.37084519738442423,0.22920358180301212,133292.8843557099,502.94656635802744,133795.83092206792,1307,4,301.9148936170213,35,12,21,32.25033624747815,0.6553571428571429,41.84027777777778,1032.638888888889,29.503968253968253,0
4868,4,0,1,46,0.0,0.02127659574468085,0.9787234042553191,47,1350,1100,250,0.8148148148148148,16,11,5,375.98811428787167,0.4460568917668825,0.37292919084100484,0.232737164225627,133412.4295374657,632.2975608710576,134044.72709833676,1308,5,302.9148936170213,35,12,21,32.013686608409884,0.656547619047619,41.72453703703704,1033.101851851852,29.51719576719577,0
4869,4,0,0,46,0.0,0.0,1.0,46,1600,1400,200,0.875,18,14,4,382.88197678084225,0.4450382447665056,0.3687785299467352,0.23679735655932804,133379.976261338,1013.7577947845921,134393.73405612257,1309,6,308.6304347826087,34,12,21,31.868253236525675,0.6583946078431373,41.75595238095239,1032.9761904761915,30.381652661064457,0
4870,4,0,0,46,0.0,0.0,1.0,46,1500,900,600,0.6,21,9,12,383.9226975371435,0.4444243156199678,0.37027629906341764,0.23784024433824297,133442.32420535415,1046.3074149091274,134488.63162026327,1310,7,309.6304347826087,35,11,21,31.77870971957731,0.6568452380952381,41.695601851851855,1033.217592592593,29.52050264550266,0
4871,4,0,0,46,0.0,0.0,1.0,46,1000,600,400,0.6,14,6,8,385.5972379151901,0.4440720611916264,0.36986421420544136,0.2394791682309803,133535.5467248173,1098.1942940764045,134633.74101889372,1311,8,310.6304347826087,33,13,21,31.641767449213503,0.6622474747474747,41.60539215686274,1033.5784313725485,31.320558526440863,0
4872,4,0,0,46,0.0,0.0,1.0,46,1500,1200,300,0.8,18,12,6,382.5274620016311,0.4439915458937198,0.3684138069134688,0.23815419408488658,133626.0363520409,1023.1257086167874,134649.16206065766,1312,9,311.6304347826087,34,12,21,31.630205334868545,0.6608455882352942,41.517857142857146,1033.928571428572,30.409663865546236,0
4873,4,0,1,45,0.0,0.021739130434782608,0.9782608695652174,46,1300,1100,200,0.8461538461538461,15,11,4,382.32762953482677,0.44373993558776165,0.36757013211357403,0.23838781367017972,133681.60211173262,1022.0340095593202,134703.63612129193,1313,10,312.6304347826087,35,11,21,31.579579369520612,0.6592261904761905,41.46412037037037,1034.143518518518,29.546957671957657,0
4874,4,0,1,44,0.0,0.022222222222222223,0.9777777777777777,45,1350,1000,350,0.7407407407407407,17,10,7,386.987451483417,0.4423400673400673,0.3559979619480793,0.24247055386918226,133861.20119866685,1360.521020876201,135221.72221954307,1314,11,312.0,35,10,20,31.278776609626064,0.6610119047619047,41.29050925925926,1034.837962962963,29.566798941798943,0
4875,4,0,0,44,0.0,0.0,1.0,44,1800,1300,500,0.7222222222222222,23,13,10,395.64885135217816,0.44158518322762513,0.34971770610068464,0.24838749187777537,133933.9303429705,1798.1611394557808,135732.09148242627,1315,12,316.1363636363636,34,10,20,30.98164654015718,0.6639093137254901,41.220238095238095,1035.1190476190475,30.444677871148457,0
4876,4,0,0,44,0.0,0.0,1.0,44,1150,700,450,0.6086956521739131,16,7,9,396.46965484905184,0.4405941684284707,0.35142754130568843,0.2497385610088269,134057.18714569145,1829.9213435373972,135887.10848922885,1316,13,317.1363636363636,34,10,20,30.836638310916957,0.6651348039215687,41.10119047619047,1035.595238095237,30.45868347338932,0
4877,4,0,1,43,0.0,0.022727272727272728,0.9772727272727273,44,1550,1300,250,0.8387096774193549,18,13,5,395.8428252336818,0.43984540169133196,0.35313580479040674,0.2501830143797191,134180.50063775506,1822.8776927437589,136003.37833049882,1317,14,318.1363636363636,34,10,20,30.72910682140257,0.6663602941176471,40.982142857142854,1036.0714285714282,30.472689075630242,0
4878,4,0,0,43,0.0,0.0,1.0,43,1100,600,500,0.5454545454545454,16,6,10,392.0156205080843,0.4383305647840532,0.3403648003167872,0.24833528858703136,134264.85794225777,1926.7843197327918,136191.64226199058,1318,15,324.0,33,10,20,30.74363939143116,0.6695075757575757,40.900735294117645,1036.3970588235293,31.405971479500888,0
4879,4,0,0,43,0.0,0.0,1.0,43,1500,1100,400,0.7333333333333333,19,11,8,390.51355565615415,0.4375922849760059,0.3386112485568198,0.24802887994377348,134360.13192041515,1893.8905709342487,136254.0224913494,1319,16,325.0,33,10,20,30.687056737588648,0.6704545454545454,40.80882352941176,1036.7647058823525,31.417112299465227,0
4880,4,0,0,43,0.0,0.0,1.0,43,1050,600,450,0.5714285714285714,15,6,9,388.59231670841666,0.43708471760797346,0.336461951026509,0.24766907896235218,134487.21645520945,1852.1398019992203,136339.35625720868,1320,17,326.0,33,10,20,30.60954237555135,0.6717171717171717,40.686274509803916,1037.2549019607836,31.43196672608435,0
4881,4,0,0,43,0.0,0.0,1.0,43,1750,1400,350,0.8,21,14,7,408.64351117321195,0.43724621631598376,0.3983254995627068,0.23791319402107527,131097.37059694852,2114.4179652625858,133211.7885622111,1321,18,327.0,36,7,20,33.512938934095736,0.6313657407407407,43.97522522522524,1024.0990990991008,28.447197197197244,8
4882,4,0,0,43,0.0,0.0,1.0,43,1600,1300,300,0.8125,19,13,6,410.3906972413125,0.43736157253599117,0.400566504163141,0.2394691579733306,131183.87972009188,2167.3287730298125,133351.2084931217,1322,19,328.0,36,7,20,33.38028104503318,0.6322337962962963,43.89076576576578,1024.4369369369383,28.45658158158162,0
4883,4,0,2,41,0.0,0.046511627906976744,0.9534883720930233,43,1250,900,350,0.72,16,9,7,405.1821006014935,0.4366694352159468,0.3944034789185098,0.23732094463801795,131328.12500000023,2042.3611111111413,133370.4861111114,1323,20,329.0,36,7,20,33.36720867208673,0.6336805555555556,43.750000000000014,1025.0000000000018,28.47222222222227,0
4884,4,0,0,41,0.0,0.0,1.0,41,550,200,350,0.36363636363636365,9,2,7,412.320971445023,0.43559451219512196,0.3806310338653922,0.24131541322839928,131298.46810967516,2627.422384044937,133925.8904937201,1324,21,336.609756097561,35,6,20,33.21440335027292,0.6354166666666667,43.77893518518519,1024.88425925926,29.28240740740743,0
4885,4,0,1,40,0.0,0.024390243902439025,0.975609756097561,41,900,600,300,0.6666666666666666,12,6,6,411.99813365310445,0.4347560975609756,0.38271230704658876,0.2421067684276108,131453.76778162242,2631.748095498938,134085.51587712136,1325,22,337.609756097561,33,8,21,33.06494980879541,0.6414141414141414,43.627450980392155,1025.4901960784312,31.075460487225186,0
4886,4,0,0,40,0.0,0.0,1.0,40,1250,1000,250,0.8,15,10,5,414.00530605629353,0.43398771367521366,0.37280226545185924,0.24331049897172297,131457.57607642052,2884.826803387374,134342.4028798079,1326,23,343.175,32,8,21,33.00962406632191,0.6438802083333333,43.623737373737356,1025.5050505050485,32.04703282828277,0
4887,4,0,0,40,0.0,0.0,1.0,40,1300,900,400,0.6923076923076923,17,9,8,412.1235334463506,0.4329326923076923,0.37394353587203133,0.24398295686784993,131736.68368235763,2858.3575127354716,134595.0411950931,1327,24,344.175,33,7,19,32.77463590784291,0.6442550505050505,43.3517156862745,1026.593137254901,31.10888294711821,0
4888,4,0,0,40,0.0,0.0,1.0,40,1600,1000,600,0.625,22,10,12,411.9855776624652,0.4324786324786325,0.3737470167064445,0.24450702130392737,131831.05656478263,2862.4987985390067,134693.55536332165,1328,25,345.175,33,7,20,32.68247812251392,0.6452020202020202,43.25980392156862,1026.9607843137244,31.120023767082557,0
4889,4,0,0,40,0.0,0.0,1.0,40,950,500,450,0.5263157894736842,14,5,9,409.537161211938,0.43274572649572646,0.37439158651060445,0.2435490119984707,131908.37762188195,2804.2765022675603,134712.65412414953,1329,26,346.175,34,6,20,32.66697570208985,0.6436887254901961,43.1845238095238,1027.2619047619037,30.213585434173638,0
4890,4,0,1,39,0.0,0.025,0.975,40,900,400,500,0.4444444444444444,14,4,10,450.55292751755485,0.43205128205128207,0.35729063429137753,0.25397089601408557,129844.02101826353,3702.134817042838,133546.15583530636,1330,27,347.175,32,8,17,33.72202262966633,0.6276041666666667,45.20202020202021,1019.19191919192,31.8497474747475,8
4891,4,1,0,40,0.025,0.0,1.0,40,1200,900,300,0.75,15,9,6,429.85937644733235,0.4334935897435897,0.2938654680719157,0.24091840660512434,129618.91842987972,3169.128947301312,132788.04737718104,1331,0,341.775,32,8,16,34.47974788179377,0.6253255208333333,45.42297979797981,1018.3080808080817,31.822127525252554,8
4892,4,0,0,40,0.0,0.0,1.0,40,1250,900,350,0.72,16,9,7,427.7512574472172,0.433079594017094,0.2952677575306808,0.24013009003665284,129683.21352731863,3094.431531221303,132777.64505853993,1332,1,342.775,32,8,16,34.467583984132894,0.6259765625,45.359848484848484,1018.560606060606,31.830018939393938,0
4893,4,0,0,40,0.0,0.0,1.0,40,1000,700,300,0.7,13,7,6,426.4250244327536,0.4332932692307692,0.2950037170115225,0.24017281034171345,129811.85154894902,3071.0043936843094,132882.85594263332,1333,2,343.775,32,8,16,34.36970842109611,0.6272786458333333,45.233585858585855,1019.065656565656,31.84580176767675,0
4894,4,0,0,40,0.0,0.0,1.0,40,1200,700,500,0.5833333333333334,17,7,10,428.62678256415467,0.4325988247863248,0.296768202080238,0.2424082560215765,129972.73875114789,3141.9593663911896,133114.69811753908,1334,3,344.775,32,8,16,34.14902179296681,0.62890625,45.07575757575758,1019.69696969697,31.86553030303031,0
4895,4,2,1,41,0.047619047619047616,0.023809523809523808,0.9761904761904762,42,900,500,400,0.5555555555555556,13,5,8,410.5820108405711,0.4366289198606272,0.28789744955421304,0.23540583827953393,130505.75573979596,2316.663123582771,132822.41886337873,1335,0,329.3095238095238,34,8,16,34.065400598081474,0.6295955882352942,44.55357142857143,1021.7857142857147,30.052521008403374,0
4896,4,1,0,42,0.023809523809523808,0.0,1.0,42,1100,800,300,0.7272727272727273,14,8,6,410.20899303940035,0.436048199767712,0.2911435555481652,0.2366759878577227,130749.15143140599,2326.8955498866335,133076.04698129263,1336,0,330.2857142857143,34,8,18,33.827067085709864,0.632046568627451,44.3154761904762,1022.738095238096,30.080532212885174,0
4897,4,0,1,41,0.0,0.023809523809523808,0.9761904761904762,42,1300,900,400,0.6923076923076923,17,9,8,409.2449885072247,0.4356005613627565,0.2922138368961731,0.23667910035202505,130840.48327664408,2309.162414965996,133149.6456916101,1337,1,331.2857142857143,34,8,19,33.75877550228842,0.6329656862745099,44.22619047619048,1023.0952380952389,30.09103641456585,0
4898,4,0,0,41,0.0,0.0,1.0,41,1100,800,300,0.7272727272727273,14,8,6,407.5429942260184,0.43412093495934956,0.31442174903088427,0.23700319765638833,131053.71492346934,2482.00467687074,133535.71960034006,1338,2,339.5365853658537,34,7,19,33.585484246017906,0.6351102941176471,44.01785714285714,1023.928571428571,30.11554621848738,0
4899,4,1,0,42,0.023809523809523808,0.0,1.0,42,1300,900,400,0.6923076923076923,17,9,8,397.4461798298197,0.43480207123499803,0.3233424536384495,0.23372005728558998,131480.69905045338,2051.587301587284,133532.28635204065,1339,0,332.42857142857144,34,8,20,33.41071774037532,0.6393995098039216,43.60119047619047,1025.595238095237,30.1645658263305,0
4900,4,0,0,42,0.0,0.0,1.0,42,1350,1100,250,0.8148148148148148,16,11,5,390.16839894422264,0.43403987611304684,0.3076224850418403,0.2303084570598853,131624.87809713642,1871.1735896776354,133496.05168681405,1340,1,333.42857142857144,35,7,19,33.45129333032559,0.6386904761904761,43.460648148148145,1026.157407407407,29.318783068783056,0
4901,4,0,0,42,0.0,0.0,1.0,42,1150,800,350,0.6956521739130435,15,8,7,390.8976470202085,0.4334228610143244,0.3087991368343077,0.23164014874524153,131773.38023244584,1901.9808545524527,133675.36108699828,1341,2,334.42857142857144,35,7,19,33.28225397362192,0.6401785714285715,43.315972222222214,1026.73611111111,29.335317460317427,0
4902,4,0,0,42,0.0,0.0,1.0,42,900,700,200,0.7777777777777778,11,7,4,389.00821792386483,0.4331566976384049,0.3090381673011344,0.23079804419308558,131819.1518165125,1855.7466672753872,133674.89848378787,1342,3,335.42857142857144,36,6,19,33.28444273860437,0.638599537037037,43.2713963963964,1026.9144144144148,28.52540040040041,0
4903,4,0,0,42,0.0,0.0,1.0,42,1450,1000,450,0.6896551724137931,19,10,9,351.7158544939565,0.4336769260549748,0.13070441833594093,0.20097432323660788,130374.54433094789,772.2270127758487,131146.77134372373,1343,4,336.42857142857144,37,5,16,35.70207930713621,0.6221846846846847,44.682017543859644,1021.2719298245606,27.60194404931245,8
4904,4,0,1,41,0.0,0.023809523809523808,0.9761904761904762,42,1050,600,450,0.5714285714285714,15,6,9,353.1294550911952,0.4333260743321719,0.12652338540309316,0.20251159335352917,130514.55886667053,817.7070108110182,131332.26587748155,1344,5,337.42857142857144,37,5,14,35.52408609650534,0.6235923423423424,44.54495614035088,1021.8201754385966,27.61676149834045,0
4905,4,0,1,40,0.0,0.024390243902439025,0.975609756097561,41,1350,1000,350,0.7407407407407407,17,10,7,358.23250156465787,0.43107215447154473,0.14415349134756505,0.20547419211110676,130521.37230135562,1151.3995414333488,131672.77184278896,1345,6,346.4634146341463,36,5,15,35.386819484240675,0.6255787037037037,44.5382882882883,1021.8468468468485,28.38463463463468,0
4906,4,0,0,40,0.0,0.0,1.0,40,950,600,350,0.631578947368421,13,6,7,359.80358603446786,0.4276976495726496,0.15512891141472007,0.2066821105600527,130578.91506371248,1396.5523800827984,131975.4674437953,1346,7,355.875,36,4,15,35.28835206405171,0.6261574074074074,44.48198198198199,1022.0720720720731,28.39089089089092,0
4907,4,0,0,40,0.0,0.0,1.0,40,1200,700,500,0.5833333333333334,17,7,10,358.031657089174,0.42751068376068374,0.15821039304194673,0.20673881381697176,130780.4145995657,1364.705710778339,132145.12031034403,1347,8,356.875,36,4,15,35.129500165143675,0.6281828703703703,44.284909909909906,1022.8603603603598,28.41278778778777,0
4908,4,0,1,39,0.0,0.025,0.975,40,1150,800,350,0.6956521739130435,15,8,7,363.43717617198536,0.42688301282051283,0.16322364076601392,0.21033058488526465,130866.81909950472,1512.373437626795,132379.19253713152,1348,9,357.875,36,4,15,34.90374385501503,0.6290509259259259,44.20045045045044,1023.1981981981967,28.42217217217213,0
4909,4,0,0,39,0.0,0.0,1.0,39,1500,1200,300,0.8,18,12,6,368.3523725161948,0.4240890688259109,0.17142161085153962,0.21326806322303046,130883.62328800134,1842.2586323302205,132725.88192033157,1349,18,367.8205128205128,35,4,15,34.760985748218516,0.63125,44.184027777777764,1023.2638888888873,29.236111111111068,0
4910,4,0,0,39,0.0,0.0,1.0,39,1250,1000,250,0.8,15,10,5,366.2518080967822,0.4236111111111111,0.10548502198987597,0.20281686147294933,129145.65659626044,1787.3110028780238,130932.96759913846,1350,19,368.8205128205128,37,2,19,36.58126573175116,0.6097972972972974,45.88815789473684,1016.447368421053,27.4715504978663,8
4911,4,2,0,41,0.04878048780487805,0.0,1.0,41,1450,1100,350,0.7586206896551724,18,11,7,361.8009668843578,0.4273119918699187,0.12335766050048802,0.20371060343229092,129799.4797373805,1192.3274769443162,130991.80721432483,1351,0,351.780487804878,38,3,18,36.02869224854965,0.6145833333333333,45.2457264957265,1019.017094017095,26.816239316239344,0
4912,4,1,0,42,0.023809523809523808,0.0,1.0,42,900,600,300,0.6666666666666666,12,6,6,355.0736369425037,0.429369918699187,0.13495304205798253,0.20175761876385,130156.27170138921,843.0121527778131,130999.28385416702,1352,0,344.3809523809524,39,3,20,35.837756907581344,0.6164529914529915,44.89583333333335,1020.4166666666692,26.164529914529982,0
4913,4,0,0,42,0.0,0.0,1.0,42,600,200,400,0.3333333333333333,10,2,8,355.2952252303128,0.4290069686411149,0.13308209292493367,0.20229738012968282,130236.0039605037,854.4460720486313,131090.45003255233,1353,1,345.3809523809524,39,3,20,35.75120335408375,0.6172542735042735,44.81770833333334,1020.7291666666684,26.172542735042782,0
4914,4,0,1,41,0.0,0.023809523809523808,0.9761904761904762,42,1450,1200,250,0.8275862068965517,17,12,5,354.38790756760153,0.4274583817266744,0.1327552809252932,0.20293989765257184,130458.54403518395,846.5915143361526,131305.1355495201,1354,2,346.3809523809524,37,5,21,35.54870577081323,0.6230292792792793,44.59978070175439,1021.6008771929828,27.610834518729266,0
4915,4,1,0,42,0.023809523809523808,0.0,1.0,42,1550,1300,250,0.8387096774193549,18,13,5,344.15860305703785,0.4269381533101045,0.12382794698005473,0.19907690219235752,130848.09570312523,606.4995659722526,131454.59526909748,1355,0,333.4047619047619,39,3,17,35.415818231181724,0.6233974358974359,44.218750000000014,1023.1250000000018,26.233974358974404,0
4916,4,0,0,42,0.0,0.0,1.0,42,1500,1100,400,0.7333333333333333,19,11,8,344.0540243057578,0.42678087495160666,0.12629346904156113,0.1994295450621873,130928.03955078148,609.2637803819739,131537.30333116345,1356,1,334.4047619047619,39,3,17,35.337680237489415,0.624198717948718,44.140625000000014,1023.4375000000018,26.241987179487225,0
4917,4,0,1,41,0.0,0.023809523809523808,0.9761904761904762,42,1250,900,350,0.72,16,9,7,341.6294009799068,0.42638162988772743,0.12947624375759892,0.19884894263075586,131088.0004882814,556.7030164930709,131644.70350477446,1357,2,335.4047619047619,39,3,17,35.23812853897535,0.625801282051282,43.98437500000001,1024.0625000000011,26.25801282051285,0
4918,4,0,0,41,0.0,0.0,1.0,41,1350,1000,350,0.7407407407407407,17,10,7,345.3989458161274,0.4248983739837398,0.12708078234106646,0.20044017564290212,130972.46334876528,847.5501543209716,131820.01350308626,1358,3,344.4390243902439,38,3,17,35.2583672546359,0.6263706140350878,44.097222222222214,1023.61111111111,26.937134502923946,0
4919,4,0,0,41,0.0,0.0,1.0,41,1300,1200,100,0.9230769230769231,14,12,2,342.62100471239273,0.4245426829268293,0.11840453975009524,0.1998419312183672,131168.01757812515,788.1835937500141,131956.20117187515,1359,4,345.4390243902439,39,2,20,35.131940207443556,0.6266025641025641,43.90625000000001,1024.3750000000011,26.26602564102567,0
4920,4,0,0,41,0.0,0.0,1.0,41,1300,1100,200,0.8461538461538461,15,11,4,340.7363341926104,0.42378048780487804,0.11818362086059886,0.19957413859852882,131328.12499999985,749.750434027763,132077.8754340276,1360,5,346.4390243902439,38,3,20,35.01863143631437,0.6299342105263157,43.74999999999999,1024.9999999999989,26.973684210526287,0
4921,4,0,1,40,0.0,0.024390243902439025,0.975609756097561,41,650,600,50,0.9230769230769231,7,6,1,342.3262251479224,0.4238821138211382,0.11130002516030202,0.2009360723391197,131410.26925131466,797.0362836949099,132207.30553500957,1361,6,347.4390243902439,38,3,20,34.89501927685735,0.6307565789473684,43.66987179487178,1025.3205128205107,26.982118758434492,0
4922,4,0,0,40,0.0,0.0,1.0,40,1100,700,400,0.6363636363636364,15,7,8,346.5767271173693,0.4221955128205128,0.12033304821982282,0.20374180570262404,131468.65051025283,1112.7949224761135,132581.44543272894,1362,7,356.375,37,3,21,34.72715973484443,0.6331644144144144,43.61293859649121,1025.5482456140326,27.71752015173061,0
4923,4,0,1,39,0.0,0.025,0.975,40,1050,700,350,0.6666666666666666,14,7,7,346.74625546921965,0.42140758547008544,0.11802810129287322,0.2047443662420455,131637.38031173026,1128.953740573988,132766.33405230424,1363,8,357.375,37,3,19,34.55263649962601,0.6348536036036037,43.448464912280684,1026.2061403508749,27.735301090564185,0
4924,4,0,0,39,0.0,0.0,1.0,39,1700,1400,300,0.8235294117647058,20,14,6,344.7043280941278,0.4207714799820063,0.11028133104390747,0.20414083642917857,131749.92696069923,1282.9540098876314,133032.88097058685,1364,9,364.6923076923077,37,2,20,34.49159368436042,0.6359797297297297,43.33881578947367,1026.6447368421034,27.747155049786578,0
4925,4,0,0,39,0.0,0.0,1.0,39,1150,1000,150,0.8695652173913043,13,10,3,344.01324493458003,0.42065901934322986,0.10749580586276042,0.2046387359867987,131918.83710612872,1276.3654441751169,133195.20255030383,1365,10,365.6923076923077,37,2,20,34.33919930978048,0.6376689189189189,43.17434210526315,1027.3026315789466,27.764935988620177,0
4926,4,0,0,39,0.0,0.0,1.0,39,1200,600,600,0.5,18,6,12,343.3039258203614,0.4197312190733244,0.10666710432018722,0.20497649685605518,132059.67821829783,1267.3211949830538,133326.9994132809,1366,11,366.6923076923077,37,2,20,34.215649669298045,0.6390765765765766,43.037280701754376,1027.8508771929814,27.779753437648147,0
4927,4,0,0,39,0.0,0.0,1.0,39,1050,700,350,0.6666666666666666,14,7,7,348.6199692987415,0.41956252811515965,0.1042592866009373,0.20877126897085563,132172.4052112189,1415.5879693751958,133587.9931805941,1367,12,367.6923076923077,37,2,20,33.965575460297146,0.6402027027027026,42.92763157894737,1028.289473684211,27.79160739687057,0
4928,4,0,0,39,0.0,0.0,1.0,39,1300,900,400,0.6923076923076923,17,9,8,351.2637902424632,0.4198436797121008,0.10462518407268662,0.210999316047703,132288.07259706702,1493.6019568631832,133781.6745539302,1368,13,368.6923076923077,38,1,20,33.7811991553294,0.6395285087719298,42.815170940170944,1028.7393162393166,27.0720872694557,0
4929,4,0,1,38,0.0,0.02564102564102564,0.9743589743589743,39,850,600,250,0.7058823529411765,11,6,5,353.61912025452364,0.41945006747638325,0.0279421778319644,0.19759116473107607,129500.26167223687,1358.7993781503394,130859.06105038722,1369,14,369.6923076923077,38,1,14,36.54132115741226,0.6115679824561404,45.539529914529915,1017.8418803418806,26.785312640575807,8
4930,4,0,2,36,0.0,0.05263157894736842,0.9473684210526316,38,1400,1100,300,0.7857142857142857,17,11,6,355.07051011245727,0.4183854907539118,0.04672902356604891,0.1990901236701143,129636.22708013741,1606.0002556797501,131242.22733581715,1370,15,377.89473684210526,38,0,16,36.36610015386768,0.6129385964912281,45.40598290598291,1018.3760683760689,26.799370220422865,0
4931,4,0,0,36,0.0,0.0,1.0,36,1300,1100,200,0.8461538461538461,15,11,4,365.4395566104118,0.41569113756613757,0.05671360290955563,0.20487724181202452,129631.08114448923,2274.4649632741016,131905.54610776334,1371,16,396.19444444444446,36,0,16,36.10734822514653,0.6166087962962963,45.411036036036045,1018.355855855857,28.287662662662697,0
4932,4,0,0,36,0.0,0.0,1.0,36,750,600,150,0.8,9,6,3,366.5220365480392,0.41583994708994704,0.05795739348370943,0.20563432373079835,129659.75265806359,2304.6313205097103,131964.3839785733,1372,17,397.19444444444446,36,0,16,36.05060445230723,0.6168981481481481,45.38288288288289,1018.4684684684694,28.290790790790815,0
4933,4,0,0,36,0.0,0.0,1.0,36,750,700,50,0.9333333333333333,8,7,1,366.5220365480392,0.41583994708994704,0.05795739348370943,0.20563432373079835,129659.75265806359,2304.6313205097103,131964.3839785733,1373,18,398.19444444444446,36,0,16,36.05060445230723,0.6168981481481481,45.38288288288289,1018.4684684684694,28.290790790790815,0
4934,4,3,0,39,0.07692307692307693,0.0,1.0,39,750,400,350,0.5333333333333333,11,4,7,358.69619979234074,0.42498875393612234,0.08176258150000426,0.19959944583418324,129337.19735051865,1489.2174623214546,130826.4148128401,1374,0,368.4871794871795,38,1,16,36.578134299618384,0.6099232456140351,45.699786324786324,1017.2008547008545,26.76844354475933,8
4935,4,0,1,38,0.0,0.02564102564102564,0.9743589743589743,39,700,600,100,0.8571428571428571,8,6,2,358.69619979234074,0.42498875393612234,0.08176258150000426,0.19959944583418324,129337.19735051865,1478.5522362846068,130815.74958680326,1375,1,369.4871794871795,38,1,16,36.578134299618384,0.6099232456140351,45.699786324786324,1017.2008547008545,26.76844354475933,0
4936,4,1,0,39,0.02564102564102564,0.0,1.0,39,1150,700,450,0.6086956521739131,16,7,9,351.7813186426537,0.4270973909131804,0.07636190086588934,0.19745796404637594,129678.39084201398,1323.6870659722279,131002.07790798621,1376,0,361.56410256410254,39,0,15,36.40698506852116,0.6116452991452992,45.364583333333336,1018.5416666666674,26.11645299145301,0
4937,4,1,1,39,0.025,0.025,0.975,40,1150,700,450,0.6086956521739131,16,7,9,346.02026222265454,0.4301014957264957,0.0821307554315327,0.1957140536156774,129977.4491456806,994.9662072840381,130972.41535296464,1377,0,353.5,40,0,16,36.25008305096008,0.6130208333333333,45.07113821138212,1019.7154471544725,25.492886178861813,0
4938,4,0,0,39,0.0,0.0,1.0,39,900,400,500,0.4444444444444444,14,4,10,363.0141354022745,0.4290092217723797,0.06957441184245305,0.1934745666704428,127617.73003472204,1639.5277436958586,129257.2577784179,1378,1,363.0,35,4,18,38.22594501718213,0.5982142857142857,47.39583333333332,1010.4166666666652,28.869047619047574,8
4939,4,0,0,39,0.0,0.0,1.0,39,1150,800,350,0.6956521739130435,15,8,7,364.02769999049417,0.42853126405757985,0.06918261155549299,0.19429644720764022,127676.20991941002,1495.535408093262,129171.74532750327,1379,2,364.0,35,4,18,38.14036494121238,0.5988095238095238,47.337962962962955,1010.6481481481471,28.87566137566135,0
4940,4,1,0,40,0.025,0.0,1.0,40,900,500,400,0.5555555555555556,13,5,8,355.46749309895193,0.43084935897435894,0.09043209876543234,0.1919524462734339,128144.53124999987,1111.1003943758433,129255.63164437571,1380,0,355.875,35,5,20,37.877229080932786,0.6035714285714286,46.87499999999999,1012.499999999999,28.9285714285714,0
4941,4,1,0,41,0.024390243902439025,0.0,1.0,41,700,500,200,0.7142857142857143,9,5,4,344.12114019811236,0.43224085365853654,0.09785648700277605,0.1871209305877262,128422.23087873167,638.5609033548562,129060.79178208653,1381,0,348.1707317073171,37,4,17,37.88087768642724,0.6024774774774775,46.600877192982445,1013.5964912280682,27.394499762920763,0
4942,4,0,1,40,0.0,0.024390243902439025,0.975609756097561,41,1000,800,200,0.8,12,8,4,342.6765868982744,0.43201219512195127,0.09722335787216463,0.18672542127568278,128505.5993791356,607.1720385118182,129112.77141764743,1382,1,349.1707317073171,37,4,17,37.83242763418767,0.603322072072072,46.51864035087718,1013.9254385964889,27.40339023233754,0
4943,4,1,0,41,0.024390243902439025,0.0,1.0,41,1650,1400,250,0.8484848484848485,19,14,5,346.1891919113387,0.4328760162601626,0.11133706542616872,0.19131931460015905,129065.65176647293,736.2267377090918,129801.87850418202,1383,0,344.0731707317073,38,3,18,37.17252830056425,0.6071820175438596,45.966880341880334,1016.1324786324775,26.740328385065197,0
4944,4,0,0,41,0.0,0.0,1.0,41,1250,800,450,0.64,17,8,9,347.67561465716835,0.4330538617886179,0.11395101444445888,0.19266939274682301,129174.23575726828,782.146362955622,129956.3821202239,1384,1,345.0731707317073,38,3,18,37.024216149938674,0.6082785087719298,45.86004273504272,1016.5598290598265,26.7515744489428,0
4945,4,0,0,41,0.0,0.0,1.0,41,1250,800,450,0.64,17,8,9,348.7650343702517,0.4326727642276423,0.11421028828658275,0.19395350472532713,129312.88954293629,819.9657267603075,130132.85526969659,1385,2,346.0731707317073,37,4,19,36.85541540894064,0.6114864864864865,45.723684210526315,1017.1052631578947,27.489331436699857,0
4946,4,1,0,42,0.023809523809523808,0.0,1.0,42,1200,1100,100,0.9166666666666666,13,11,2,344.764039696973,0.4325154858691444,0.12630333173537855,0.19384846005603404,129745.05077069196,546.2855668785353,130291.3363375705,1386,0,338.8095238095238,38,4,17,36.517975741051465,0.6140350877192983,45.29914529914531,1018.8034188034202,26.810616284300533,0
4947,4,0,0,42,0.0,0.0,1.0,42,1150,900,250,0.782608695652174,14,9,5,346.70107986234655,0.43216463414634143,0.13000898472596556,0.1954803960926003,129853.92011834364,604.0988658777594,130458.0189842214,1387,1,339.8095238095238,38,4,17,36.35809748427673,0.6151315789473684,45.192307692307715,1019.2307692307728,26.821862348178232,0
4948,4,0,0,42,0.0,0.0,1.0,42,1550,1200,350,0.7741935483870968,19,12,7,349.72957657562966,0.4312572590011614,0.13770003443062184,0.19760031671173722,129935.60209155195,688.4646203156157,130624.06671186756,1388,2,340.8095238095238,38,4,17,36.197998532956106,0.615953947368421,45.1121794871795,1019.5512820512847,26.83029689608644,0
4949,4,0,0,42,0.0,0.0,1.0,42,1150,800,350,0.6956521739130435,15,8,7,348.4098654049929,0.4305797522260937,0.1382857741399688,0.19740468753836662,130044.55133912306,661.7609257433434,130706.31226486641,1389,3,341.8095238095238,38,4,17,36.121076428895634,0.6170504385964912,45.0053418803419,1019.9786324786359,26.8415429599641,0
4950,4,0,1,41,0.0,0.023809523809523808,0.9761904761904762,42,1400,1300,100,0.9285714285714286,15,13,2,346.6492323426171,0.4308338172667441,0.1354690117252928,0.19709484924623127,130180.80210387928,625.4150230112011,130806.21712689048,1390,4,342.8095238095238,38,4,17,36.027795226130664,0.618421052631579,44.87179487179488,1020.5128205128226,26.85560053981112,0
4951,4,1,0,42,0.023809523809523808,0.0,1.0,42,900,500,400,0.5555555555555556,13,5,8,340.20426182079694,0.43211624080526523,0.143252875739875,0.19476842940318517,130448.7426757815,475.8436414930852,130924.58631727459,1391,0,340.7142857142857,39,3,18,35.92087709459232,0.6193910256410257,44.609375000000014,1021.5625000000019,26.193910256410305,0
4952,4,0,2,40,0.0,0.047619047619047616,0.9523809523809523,42,950,600,350,0.631578947368421,13,6,7,345.3585866031454,0.43188637243515293,0.07424592120970908,0.18438984620840163,127688.8559801356,552.4658004975062,128241.32178063311,1392,1,341.7142857142857,36,6,19,38.59911792014856,0.5969328703703703,47.325450450450454,1010.6981981981987,28.074949949949964,8
4953,4,1,0,41,0.024390243902439025,0.0,1.0,41,900,500,400,0.5555555555555556,13,5,8,353.44868766933416,0.43252032520325207,0.09262372449692013,0.18892416389865127,127734.70320001701,829.5326431755726,128564.23584319258,1393,0,350.7317073170732,35,6,20,38.347740630486236,0.5994047619047619,47.28009259259259,1010.8796296296285,28.8822751322751,0
4954,4,2,1,42,0.046511627906976744,0.023255813953488372,0.9767441860465116,43,1350,1200,150,0.8888888888888888,15,12,3,340.31234567901265,0.4377076411960133,0.09857881136950941,0.18495236178207208,128401.20525931343,139.95946999616183,128541.16472930959,1394,0,335.3720930232558,36,7,17,37.998842592592624,0.6041666666666667,46.62162162162163,1013.513513513514,28.153153153153166,0
4955,4,1,0,43,0.023255813953488372,0.0,1.0,43,1250,800,450,0.64,17,8,9,342.4232834339621,0.43576965669988926,0.09890047461898765,0.18690085397613715,128572.46393352811,205.24105186267283,128777.70498539078,1395,0,336.3488372093023,36,7,19,37.77065289806795,0.6059027777777778,46.4527027027027,1014.1891891891892,28.17192192192192,0
4956,4,0,0,43,0.0,0.0,1.0,43,1050,800,250,0.7619047619047619,13,8,5,342.3665670845368,0.4357235142118863,0.09645106327370723,0.18747101844972194,128700.23108071701,212.53125961832754,128912.76234033534,1396,1,337.3488372093023,37,6,19,37.64183055975794,0.6052927927927928,46.326754385964904,1014.6929824561392,27.424134660976737,0
4957,4,0,0,43,0.0,0.0,1.0,43,1150,700,450,0.6086956521739131,16,7,9,332.2324368570449,0.4353313030638612,0.06243080026046144,0.17163318526510446,126350.17108078873,-204.4749529049958,126145.69612788373,1397,2,338.3488372093023,40,3,13,40.30290777991175,0.5763020833333333,48.653455284552855,1005.3861788617901,25.134654471544753,8
4958,4,0,2,41,0.0,0.046511627906976744,0.9534883720930233,43,750,500,250,0.6666666666666666,10,5,5,335.75723498515487,0.43503137689184196,0.0655374029441067,0.1737789538395971,126426.81274373739,-110.25658503534646,126316.55615870205,1398,3,339.3488372093023,40,3,13,40.13553455941795,0.5770833333333334,48.57723577235773,1005.6910569105708,25.14227642276427,0
4959,4,2,0,43,0.046511627906976744,0.0,1.0,43,1050,700,350,0.6666666666666666,14,7,7,338.5820249615517,0.4367386489479513,0.0790876095765316,0.17634035432540132,126682.45278108273,-21.519722056966884,126660.93305902576,1399,0,340.1162790697674,40,3,15,39.801845682751235,0.5796875,48.32317073170732,1006.707317073171,25.167682926829276,0
4960,4,1,0,44,0.022727272727272728,0.0,1.0,44,2050,1700,350,0.8292682926829268,24,17,7,334.33508640120243,0.4399334918957012,0.08696468820435777,0.175889328063241,127092.0138888887,-299.7531644523967,126792.2607244363,1400,0,333.3636363636364,38,6,18,39.48863636363639,0.587171052631579,47.91666666666666,1008.3333333333318,26.535087719298204,0
4961,4,2,2,44,0.043478260869565216,0.043478260869565216,0.9565217391304348,46,1000,700,300,0.7,13,7,6,321.09807991888107,0.4437600644122383,0.09453383659241688,0.17097139863275798,127579.22620670544,-1006.9110854980725,126572.31512120737,1401,0,319.82608695652175,40,6,14,39.32409549676423,0.5888020833333334,47.43394308943088,1010.2642276422747,25.25660569105687,0
4962,4,1,0,45,0.022222222222222223,0.0,1.0,45,1350,800,550,0.5925925925925926,19,8,11,331.2147943458394,0.4390993265993266,0.1073997709049257,0.17652656621728782,127617.73003472212,-546.223958333343,127071.50607638877,1402,0,327.3777777777778,39,6,16,39.02920962199312,0.5908119658119658,47.39583333333333,1010.4166666666657,25.908119658119634,0
4963,4,2,1,46,0.0425531914893617,0.02127659574468085,0.9787234042553191,47,1750,1300,450,0.7428571428571429,22,13,9,319.5684925953951,0.4434358618563059,0.11793837123991202,0.1727836426066628,128194.75938523552,-1206.5987969261846,126988.16058830933,1403,0,314.40425531914894,41,6,19,38.73473419540229,0.5934959349593496,46.82539682539682,1012.6984126984122,24.699961285327127,0
4964,4,2,1,47,0.041666666666666664,0.020833333333333332,0.9791666666666666,48,2050,1700,350,0.8292682926829268,24,17,7,332.2677935796982,0.44563571217494086,0.19221845999498366,0.17317015594800744,126710.3564049587,-1175.7091308362933,125534.64727412241,1404,0,308.7291666666667,43,5,16,39.93212315023826,0.5755813953488372,48.29545454545455,1006.8181818181821,23.41437632135307,8
4965,4,3,0,50,0.06,0.0,1.0,50,1600,1000,600,0.625,22,10,12,320.07918771159075,0.44937925170068027,0.2110635903207656,0.16978528852641675,127426.43498192137,-1841.5421975436334,125584.89278437773,1405,0,297.3,43,7,17,39.50595573063215,0.5828488372093024,47.585227272727266,1009.6590909090899,23.480443974629996,0
4966,4,0,2,48,0.0,0.04,0.96,50,1950,1600,350,0.8205128205128205,23,16,7,314.60877915147466,0.4497534013605442,0.20462461336582627,0.16757668820604493,127593.81030654546,-1971.5734224345829,125622.23688411088,1406,1,298.3,43,7,17,39.47310353985067,0.5845445736434108,47.41950757575757,1010.3219696969688,23.495859760394623,0
4967,4,1,1,48,0.02040816326530612,0.02040816326530612,0.9795918367346939,49,1300,900,400,0.6923076923076923,17,9,8,316.38180153055566,0.45137117346938777,0.21130160089131622,0.16952540183365825,127833.10847286812,-1711.1861692205903,126121.92230364753,1407,0,302.6326530612245,43,6,18,39.18408792958142,0.5869670542635659,47.18276515151516,1011.2689393939413,23.517882311487007,0
4968,4,0,1,47,0.0,0.020833333333333332,0.9791666666666666,48,1750,1400,350,0.8,21,14,7,371.6978854675459,0.4504838947990544,0.29215892573437396,0.1882543835950426,125534.10590794201,-132.58836923212698,125401.51753870989,1408,1,309.25,40,8,18,40.15418483588549,0.56796875,49.46646341463416,1002.134146341466,25.05335365853665,8
4969,4,5,2,50,0.09615384615384616,0.038461538461538464,0.9615384615384616,52,1400,1100,300,0.7857142857142857,17,11,6,357.98039541119863,0.4564165409753645,0.33158766871308476,0.18702918813497058,126810.3696233229,-1316.7436091281509,125493.62601419474,1409,0,284.03846153846155,40,12,16,39.1820536104665,0.5809895833333334,48.19613821138212,1007.2154471544726,25.180386178861816,0
4970,4,1,1,50,0.0196078431372549,0.0196078431372549,0.9803921568627451,51,1050,500,550,0.47619047619047616,16,5,11,364.4613555291319,0.4557516339869281,0.3327653820148748,0.19009675018605812,126742.13927469144,-961.4776234567814,125780.66165123465,1410,0,290.5882352941176,41,10,17,39.089080459770116,0.578760162601626,48.26388888888889,1006.944444444445,24.559620596205978,0
4971,4,1,1,50,0.0196078431372549,0.0196078431372549,0.9803921568627451,51,1000,600,400,0.6,14,6,8,359.56870222406025,0.4580392156862745,0.32668367988709024,0.18929326584743458,127119.65610812938,-1056.4210328605393,126063.23507526884,1411,0,283.62745098039215,37,14,18,38.82414102424705,0.5892454954954955,47.88925438596491,1008.4429824561399,27.255215742057835,0
4972,4,1,3,48,0.0196078431372549,0.058823529411764705,0.9411764705882353,51,1600,1200,400,0.75,20,12,8,356.0878436070818,0.4589052287581699,0.32922262974275096,0.1886159199221401,127368.57133925824,-1129.1200176977516,126239.45132156048,1412,0,284.05882352941177,37,14,14,38.65640162213051,0.5917792792792793,47.64254385964912,1009.4298245614036,27.281887150308204,0
4973,4,0,0,48,0.0,0.0,1.0,48,1500,1000,500,0.6666666666666666,20,10,10,375.41699569053395,0.45646793735224583,0.32682580493378977,0.1970045377385566,126989.5616448544,-65.1920566461672,126924.36958820824,1413,2,302.4375,40,8,19,38.5584711299321,0.5828125,48.018292682926834,1007.9268292682939,25.198170731707346,0
4974,4,3,3,48,0.058823529411764705,0.058823529411764705,0.9411764705882353,51,1150,700,450,0.6086956521739131,16,7,9,350.66269092177004,0.4600653594771242,0.3166917139014127,0.1868321796969046,127604.89477989297,-1250.620910172507,126354.27386972046,1414,0,285.5882352941176,40,11,14,38.55109635888154,0.5890625,47.40853658536586,1010.3658536585369,25.259146341463424,0
4975,4,2,2,48,0.04,0.04,0.96,50,1250,700,550,0.56,18,7,11,356.47914487043835,0.45900510204081635,0.31759581531033065,0.189810347035727,127579.22620670548,-904.1333077202928,126675.0928989852,1415,0,292.26,40,10,15,38.43048989035307,0.5888020833333334,47.43394308943088,1010.264227642275,25.256605691056876,0
4976,4,2,0,50,0.04,0.0,1.0,50,1600,1000,600,0.625,22,10,12,354.15701719773585,0.4590816326530612,0.32622719246615706,0.18981475464320258,127843.36911848049,-944.6747448979811,126898.6943735825,1416,0,293.22,41,9,17,38.21855993721796,0.5899390243902439,47.17261904761904,1011.3095238095219,24.666085946573705,0
4977,4,2,3,49,0.038461538461538464,0.057692307692307696,0.9423076923076923,52,1450,1000,450,0.6896551724137931,19,10,9,343.27285321388126,0.4600694444444444,0.3282316416072253,0.18576390143234947,128230.0607195033,-1593.9400790752147,126636.12064042808,1417,0,282.90384615384613,36,16,19,38.098547179601205,0.6024305555555556,46.79054054054054,1012.8378378378379,28.134384384384386,0
4978,4,1,0,50,0.02,0.0,1.0,50,1750,1200,550,0.6857142857142857,23,12,11,358.3688177083124,0.4567857142857143,0.33099055030572533,0.19407149399676515,128258.57688347127,-807.2250882639473,127451.35179520732,1418,0,294.62,36,14,21,37.687141004261626,0.6027199074074074,46.762387387387385,1012.95045045045,28.1375125125125,0
4979,4,1,1,50,0.0196078431372549,0.0196078431372549,0.9803921568627451,51,1750,1300,450,0.7428571428571429,22,13,9,344.3330922606807,0.45725490196078433,0.32323820617355903,0.18809541875275593,128604.67916757963,-1343.4306286069282,127261.2485389727,1419,0,289.8235294117647,38,13,17,37.68937399059055,0.6025219298245614,46.42094017094016,1014.3162393162378,26.692532613585204,0
4980,4,0,3,47,0.0,0.06,0.94,50,1250,900,350,0.72,16,9,7,349.5375393763967,0.45714285714285713,0.31901426718547343,0.1911301013185825,128644.60699445952,-1006.7761234226273,127637.83087103689,1420,1,295.96,37,13,19,37.51666306384204,0.6047297297297297,46.3815789473684,1014.4736842105239,27.41820768136551,0
4981,4,0,0,47,0.0,0.0,1.0,47,1150,800,350,0.6956521739130435,15,8,7,364.21579771174277,0.45494141227258716,0.3213920313012628,0.19768811586895854,128349.69142500403,-50.60295031724729,128299.08847468678,1421,2,314.74468085106383,35,12,21,37.44586426803731,0.6056547619047619,46.67245370370369,1013.3101851851831,28.951719576719515,0
4982,4,0,1,46,0.0,0.02127659574468085,0.9787234042553191,47,1550,1100,450,0.7096774193548387,20,11,9,355.5110903247713,0.45478723404255317,0.31023747782489597,0.19371897773913696,128505.5993791356,-262.9668503770704,128242.63252875854,1422,3,315.74468085106383,37,10,19,37.50709689629067,0.603322072072072,46.51864035087718,1013.9254385964889,27.40339023233754,0
4983,4,0,0,46,0.0,0.0,1.0,46,1800,1200,600,0.6666666666666666,24,12,12,367.75910738727316,0.45382447665056364,0.3152065253611116,0.20029856284377603,128486.82032962002,250.43967108999254,128737.26000071001,1423,4,323.1304347826087,36,10,19,37.215835462253324,0.6050347222222222,46.537162162162154,1013.8513513513502,28.162537537537506,0
4984,4,0,0,46,0.0,0.0,1.0,46,1200,1000,200,0.8333333333333334,14,10,4,368.97219746237874,0.4533313204508857,0.31257960361512094,0.20161617239955454,128616.79945992965,291.20462546164146,128908.0040853913,1424,5,324.1304347826087,37,9,20,37.05218805174215,0.6044481981981982,46.40899122807016,1014.3640350877166,27.415244191559907,0
4985,4,2,0,48,0.041666666666666664,0.0,1.0,48,1300,800,500,0.6153846153846154,18,8,10,356.44468785811296,0.45519355791962174,0.30860496104961066,0.19713573552969066,129095.50781249975,-396.91840277780824,128698.58940972194,1425,0,311.5833333333333,39,9,22,36.88157714910481,0.6057692307692308,45.937499999999986,1016.2499999999981,26.057692307692257,0
4986,4,2,1,49,0.04,0.02,0.98,50,1600,1100,500,0.6875,21,11,10,373.68598623480483,0.4581547619047619,0.3705381212058845,0.20165764021188629,128118.16541883693,-400.32823350693593,127717.83718532999,1426,0,300.08,39,11,18,37.4430882806873,0.5958867521367521,46.90104166666667,1012.3958333333344,25.958867521367548,7
4987,4,2,2,49,0.0392156862745098,0.0392156862745098,0.9607843137254902,51,950,600,350,0.631578947368421,13,6,7,371.4803077666205,0.4579248366013072,0.38005454904377967,0.20246300760359964,128513.93771701411,-651.9178602430313,127862.01985677108,1427,0,294.7450980392157,39,12,14,37.09377782343675,0.5998931623931624,46.51041666666668,1013.9583333333352,25.99893162393167,0
4988,4,0,1,48,0.0,0.02040816326530612,0.9795918367346939,49,1350,800,550,0.5925925925925926,19,8,11,413.59644507351464,0.4558708900226757,0.39403261582750804,0.2230245017855924,128087.5274556652,802.64427222832,128890.17172789352,1428,1,307.61224489795916,36,13,17,36.46447509919532,0.6009837962962963,46.93130630630631,1012.2747747747754,28.118743743743764,8
4989,4,1,1,48,0.02040816326530612,0.02040816326530612,0.9795918367346939,49,1150,700,450,0.6086956521739131,16,7,9,363.0991603783608,0.455516581632653,0.27468966968230535,0.19351988217967606,127617.7300347224,-532.4091933994613,127085.32084132293,1429,0,308.53061224489795,37,12,18,38.223797250859114,0.5943130630630631,47.39583333333334,1010.4166666666681,27.308558558558598,8
4990,4,0,0,48,0.0,0.0,1.0,48,1800,1600,200,0.8888888888888888,20,16,4,364.0616261399146,0.4552674349881796,0.2720895239128074,0.19483530206826222,127783.97108966237,-295.75193809632117,127488.21915156605,1430,1,311.8125,37,11,19,38.02902342479123,0.5960022522522522,47.231359649122815,1011.0745614035102,27.326339497392166,0
4991,4,1,0,49,0.02040816326530612,0.0,1.0,49,1000,300,700,0.3,17,3,14,356.4338315661959,0.45615433673469385,0.27732701523881276,0.19221460182639205,128090.45041867568,-668.8459940463063,127421.60442462937,1431,0,306.42857142857144,38,11,21,37.90809146877746,0.5973135964912281,46.92841880341881,1012.2863247863256,26.639113810166464,0
4992,4,1,0,50,0.02,0.0,1.0,50,1450,900,550,0.6206896551724138,20,9,11,348.79889754403337,0.4565901360544218,0.27076527991782195,0.19022729790426707,128540.3442382814,-1033.0539279513757,127507.29031033002,1432,0,301.28,39,11,17,37.64177794898134,0.6001602564102564,46.48437500000001,1014.0625000000011,26.001602564102594,0
4993,4,0,0,50,0.0,0.0,1.0,50,1200,800,400,0.6666666666666666,16,8,8,347.91133362615614,0.45648809523809525,0.27054836722119546,0.19012124393106122,128619.58007812512,-1050.358072916655,127569.22200520846,1433,1,302.28,39,11,17,37.5834360238242,0.6009615384615384,46.40625000000001,1014.3750000000009,26.009615384615408,0
4994,4,2,0,52,0.038461538461538464,0.0,1.0,52,1500,1000,500,0.6666666666666666,20,10,10,334.6596288725416,0.45734351432880843,0.27037413918698716,0.18499290763850212,129075.34490937582,-1760.7385952065965,127314.60631416923,1434,0,291.61538461538464,41,11,20,37.45555908099842,0.6023882113821138,45.95734126984127,1016.1706349206352,24.784649632210613,0
4995,4,2,3,51,0.037037037037037035,0.05555555555555555,0.9444444444444444,54,2100,1500,600,0.7142857142857143,27,15,12,318.5244479490247,0.45921412764966224,0.2727010729804027,0.17897360236777013,129718.50419723688,-2536.1124767405877,127182.39172049629,1435,0,281.77777777777777,40,14,15,37.21318834796489,0.6104166666666666,45.32520325203251,1018.6991869918681,25.467479674796703,0
4996,4,0,0,51,0.0,0.0,1.0,51,1200,600,600,0.5,18,6,12,333.37541238897336,0.45679738562091504,0.2699369649789012,0.18578921630974632,129396.54659366306,-1572.4745835257384,127824.07201013733,1436,1,298.6470588235294,37,14,23,37.16175863059957,0.6123310810810811,45.641447368421034,1017.4342105263129,27.498221906116566,0
4997,4,1,2,50,0.019230769230769232,0.038461538461538464,0.9615384615384616,52,1600,800,800,0.5,24,8,16,324.35810183099886,0.45611802413273,0.2784871902426438,0.18237493272761784,129745.05077069145,-1983.2283220104123,127761.82244868104,1437,0,293.88461538461536,38,14,16,37.03771672259507,0.6140350877192983,45.29914529914528,1018.803418803416,26.81061628430042,0
4998,4,0,0,50,0.0,0.0,1.0,50,1450,900,550,0.6206896551724138,20,9,11,334.816200446171,0.4546428571428571,0.2773429587328953,0.18685683441617018,129452.33298947733,-1331.4523459141483,128120.88064356319,1438,1,306.48,37,13,16,37.06845077757426,0.6128941441441442,45.586622807017534,1017.6535087719283,27.50414888572779,0
4999,4,0,0,50,0.0,0.0,1.0,50,1550,1000,550,0.6451612903225806,21,10,11,338.92535455794774,0.4542687074829932,0.2796015078082932,0.18968787926886946,129563.941849896,-1217.4990141197436,128346.44283577625,1439,2,307.48,37,13,17,36.85054299048645,0.6140202702702703,45.47697368421052,1018.0921052631569,27.516002844950187,0
5000,4,2,0,52,0.038461538461538464,0.0,1.0,52,1100,900,200,0.8181818181818182,13,9,4,336.2479086444179,0.4542169431875314,0.30976779095058715,0.19145544186080113,130236.65229030329,-1641.6396077070608,128595.01268259622,1440,0,296.61538461538464,40,12,19,36.236600623921404,0.615625,44.8170731707317,1020.7317073170724,25.51829268292681,0
