period,mktsize,entries,exits,surviv,entryrate,exitrate,survivrate,firms,totresinv,totinninv,totimiinv,costshareinn,firmsres,firmsinn,firmsimi,hindex,div,gini,pcm,cs,totprofits,ts,maxage,minage,avgage,actfirms,inactfirms,profitablefirms,wmc,avgproxopt,price,totoutput,avgoutput,magtechshock
1,4,40,23,17,1.0,0.575,0.42500000000000004,40,0,0,0,0,0,0,0,353.54590950221257,0.5004674145299145,-0.050957784285017294,0.15380373005733208,119002.29591836747,1614.5549886621423,120616.85090702961,0,0,0.0,34,6,17,47.447433707499556,0.5110294117647058,56.07142857142858,975.7142857142868,28.69747899159667,0
2,4,27,31,13,0.6136363636363636,0.7045454545454546,0.2954545454545454,44,550,400,150,0.7272727272727273,7,4,3,285.8589190420139,0.4975665081042988,-0.04871041282101496,0.13440273945455333,122397.94345850454,-1802.2912379972868,120595.65222050725,1,0,0.38636363636363635,44,0,10,45.544041046754614,0.5300662878787878,52.615740740740726,989.5370370370349,22.489478114478064,0
3,4,34,31,16,0.723404255319149,0.6595744680851063,0.34042553191489366,47,200,100,100,0.5,3,1,2,317.49039034343406,0.5006552574776442,-0.22890782920374242,0.14910657246579875,122349.47287572874,-631.0436196742872,121718.42925605446,2,0,0.46808510638297873,42,5,14,44.81207149853087,0.5322420634920635,52.66472868217055,989.3410852713189,23.555740125507594,0
4,4,22,19,19,0.5789473684210527,0.5,0.5,38,400,300,100,0.75,5,3,2,339.6269872730602,0.4937618539592224,-0.09063195258232748,0.16317891993166064,123322.97059911216,776.7617932281089,124099.73239234027,3,0,0.9473684210526315,38,0,16,43.24916639776273,0.5485197368421053,51.68269230769229,993.2692307692286,26.13866396761128,0
5,4,11,6,24,0.36666666666666664,0.2,0.8,30,450,100,350,0.2222222222222222,8,1,7,383.2087379868385,0.49518678160919544,-0.021472225994839444,0.18029175321387195,122426.02333000935,3382.944379408037,125808.9677094174,4,0,1.6333333333333333,30,0,19,43.106297252025904,0.5565972222222222,52.587365591397855,989.6505376344095,32.988351254480314,8
6,4,10,13,21,0.29411764705882354,0.38235294117647056,0.6176470588235294,34,900,600,300,0.6666666666666666,12,6,6,346.0654934283805,0.491403000594177,0.01659350307287122,0.16998818225587603,124257.05959467123,1800.2161281179174,126057.27572278914,5,0,2.088235294117647,34,0,13,42.11815920398011,0.5658700980392157,50.74404761904762,997.0238095238097,29.324229691876756,0
7,4,11,8,24,0.34375,0.25,0.75,32,600,400,200,0.6666666666666666,8,4,4,357.564266487381,0.4888062836021505,-0.022302232199316485,0.17703573294400257,124589.9832446944,2509.7851941128474,127099.76843880725,6,0,2.4375,32,0,16,41.48591964925595,0.5738932291666667,50.410353535353536,998.3585858585857,31.198705808080803,0
8,4,5,1,28,0.1724137931034483,0.034482758620689655,0.9655172413793104,29,550,500,50,0.9090909090909091,6,5,1,382.5625311510037,0.4883004926108374,0.04863752572176794,0.18954114655028034,124618.34731867294,3734.862075617294,128353.20939429023,7,0,3.5172413793103448,29,0,20,40.83249292901192,0.5822557471264368,50.38194444444445,998.4722222222231,34.43007662835252,0
9,4,6,4,30,0.17647058823529413,0.11764705882352941,0.8823529411764706,34,750,400,350,0.5333333333333333,11,4,7,351.27113506278937,0.4886920677361854,0.11159633799852653,0.17377041106203467,124553.9700255101,1950.4428854875093,126504.41291099762,8,0,3.823529411764706,34,0,18,41.680331941959814,0.5689338235294117,50.44642857142856,998.2142857142849,29.359243697478966,8
10,4,2,2,30,0.0625,0.0625,0.9375,32,1100,900,200,0.8181818181818182,13,9,4,380.04756288013186,0.4866431451612903,0.175224090552212,0.1845186452052074,123766.08106825071,3092.5220861456355,126858.60315439635,9,0,4.5625,31,1,20,41.78280118642589,0.5678763440860215,51.23697916666666,995.052083333332,32.09845430107523,8
11,4,2,3,29,0.0625,0.09375,0.90625,32,1000,600,400,0.6,14,6,8,369.2969075468673,0.4856770833333333,0.1422863924050628,0.18188563401622532,124369.48398122647,2785.853165493325,127155.3371467198,10,0,5.125,32,0,16,41.42220464135021,0.5716145833333333,50.631313131313135,997.474747474748,31.171085858585876,0
12,4,9,6,32,0.23684210526315788,0.15789473684210525,0.8421052631578947,38,1000,600,400,0.6,14,6,8,319.8983071485103,0.4850788288288288,0.12882905211228546,0.16425866444775855,126100.38406227189,490.2507696951516,126590.63483196704,11,0,4.815789473684211,36,2,17,40.86944537877942,0.5807291666666667,48.90202702702704,1004.3918918918931,27.89977477477481,0
13,4,2,3,31,0.058823529411764705,0.08823529411764706,0.9117647058823529,34,1100,800,300,0.7272727272727273,14,8,6,358.5054879948021,0.4836972667855021,0.18479125109849504,0.18369594688627947,126013.95266439904,2235.338718820853,128249.2913832199,12,0,6.205882352941177,34,0,19,39.98918069717807,0.5839460784313726,48.988095238095234,1004.0476190476186,29.530812324929958,0
14,4,3,4,30,0.08823529411764706,0.11764705882352941,0.8823529411764706,34,950,700,250,0.7368421052631579,12,7,5,349.54245193445934,0.48044786096256686,0.1637562180401433,0.18186962652959107,126642.26367630389,2053.3694727891207,128695.63314909302,13,0,6.5,34,0,21,39.567317169327815,0.5903799019607843,48.36309523809524,1006.5476190476194,29.60434173669469,0
15,4,3,1,32,0.09090909090909091,0.030303030303030304,0.9696969696969697,33,800,500,300,0.625,11,5,6,340.87427211019445,0.47758838383838387,0.11458931225808344,0.1804267676799205,127339.27455786237,2081.336505190313,129420.61106305268,14,0,6.303030303030303,33,0,17,39.070341589768475,0.5997474747474747,47.67156862745098,1009.3137254901962,30.585264408793826,0
16,4,0,2,30,0.0,0.0625,0.9375,32,1350,1000,350,0.7407407407407407,17,10,7,350.78941062157116,0.4754074260752688,0.11615905113139191,0.1864428236253783,127506.1238170848,2545.559604887235,130051.68342197203,15,1,7.28125,32,0,18,38.64910197107973,0.6038411458333333,47.50631313131312,1009.9747474747459,31.56171085858581,0
17,4,2,2,30,0.0625,0.0625,0.9375,32,900,700,200,0.7777777777777778,11,7,4,349.05891287880956,0.4744623655913978,0.09859429605591652,0.18744370040114075,127920.90730537682,2530.3865676971504,130451.29387307397,16,0,7.4375,32,0,20,38.26811865535032,0.6080729166666667,47.095959595959584,1011.6161616161602,31.613005050505006,0
18,4,1,1,30,0.03225806451612903,0.03225806451612903,0.967741935483871,31,900,400,500,0.4444444444444444,14,4,10,375.79260484008466,0.47352150537634413,0.11467905725763305,0.19476674893512438,126482.86651636033,3327.5042387807193,129810.37075514105,16,0,8.03225806451613,30,1,21,39.071129520755385,0.5986111111111111,48.52150537634409,1005.9139784946242,33.53046594982081,8
19,4,1,2,29,0.03225806451612903,0.06451612903225806,0.935483870967742,31,950,600,350,0.631578947368421,13,6,7,373.37352759832964,0.47464157706093185,0.0975750477929147,0.19479905771355738,126753.41802520519,3265.2741646433064,130018.6921898485,17,0,8.483870967741936,30,1,22,38.85310998398292,0.6013888888888889,48.25268817204301,1006.9892473118276,33.56630824372759,0
20,4,0,1,28,0.0,0.034482758620689655,0.9655172413793104,29,1250,1000,250,0.8,15,10,5,381.42586680920965,0.4731629720853859,0.06162390398843631,0.19928677133288078,126812.07561728382,3873.881172839489,130685.95679012331,18,1,9.10344827586207,29,0,22,38.58992921492923,0.6048850574712643,48.194444444444436,1007.222222222221,34.731800766283484,0
21,4,2,2,28,0.06666666666666667,0.06666666666666667,0.9333333333333333,30,800,600,200,0.75,10,6,4,356.72051934152233,0.472389846743295,0.021593682062203134,0.18940220931539611,127464.99098522932,3093.8755564226794,130558.866541652,19,0,9.233333333333333,30,0,19,38.54152801810196,0.6086805555555556,47.547043010752674,1009.8118279569877,33.660394265232924,0
22,4,7,4,31,0.2,0.11428571428571428,0.8857142857142857,35,1350,800,550,0.5925925925925926,19,8,11,306.50322444400945,0.4752100840336135,0.02531002831754714,0.16921291221191875,129024.94454089469,909.3123070987192,129934.25684799341,20,0,8.6,35,0,21,38.221975393028025,0.6125,46.00694444444442,1015.9722222222192,29.027777777777693,0
23,4,0,0,31,0.0,0.0,1.0,31,700,400,300,0.5714285714285714,10,4,6,342.7685852402124,0.4719534050179211,0.0318229846478959,0.18647473347973803,128441.33377075175,2605.130852593287,131046.46462334503,19,1,9.96774193548387,31,0,21,37.895659387711405,0.6159274193548387,46.582031249999986,1013.6718749999984,32.69909274193543,0
24,4,1,3,29,0.03125,0.09375,0.90625,32,1100,800,300,0.7272727272727273,14,8,6,336.7110952574809,0.4698840725806452,0.04869222166998011,0.18611613287309106,129073.05377002346,2292.065860626465,131365.11963064992,20,0,10.625,32,0,24,37.40577369118621,0.6197916666666667,45.95959595959596,1016.161616161616,31.7550505050505,0
25,4,0,0,29,0.0,0.0,1.0,29,1150,700,450,0.6086956521739131,16,7,9,367.20650675256906,0.4688013136288998,0.06599164483466691,0.20093209976236082,128672.41753472228,3649.869791666678,132322.28732638896,21,1,11.827586206896552,29,0,25,37.04012662559891,0.6239224137931034,46.35416666666667,1014.5833333333338,34.985632183908066,0
26,4,1,1,29,0.03333333333333333,0.03333333333333333,0.9666666666666667,30,1000,600,400,0.6,14,6,8,355.0239636226941,0.46875,0.05618468051329528,0.19602820606456886,129030.63441221538,3161.793451555107,132192.42786377048,22,0,12.4,30,0,27,36.98378312827975,0.6246527777777777,46.00134408602151,1015.9946236559148,33.86648745519716,0
27,4,0,1,28,0.0,0.034482758620689655,0.9655172413793104,29,1600,1300,300,0.8125,19,13,6,384.57257547453355,0.4671592775041051,0.049771878888428045,0.19769818325567154,126148.45920138873,3902.647569444424,130051.10677083315,23,1,13.275862068965518,29,0,20,39.19578667219688,0.5980603448275862,48.85416666666666,1004.583333333332,34.640804597701106,8
28,4,1,1,28,0.034482758620689655,0.034482758620689655,0.9655172413793104,29,1450,1100,350,0.7586206896551724,18,11,7,387.2551233201608,0.4673645320197044,0.06055787514222999,0.20077944582733906,126497.51398533955,3997.362075617293,130494.87606095684,24,0,14.068965517241379,29,0,21,38.767747020111365,0.6016522988505747,48.50694444444445,1005.9722222222226,34.68869731800768,0
29,4,0,0,28,0.0,0.0,1.0,28,1100,700,400,0.6363636363636364,15,7,8,429.7151663937132,0.466820987654321,0.13367905502736965,0.21156614787979824,124354.28433412593,5087.384396882,129441.66873100793,25,1,15.321428571428571,28,0,18,39.9314558724671,0.5825892857142857,50.64655172413792,997.4137931034472,35.62192118226597,8
30,4,2,0,30,0.06666666666666667,0.0,1.0,30,1150,800,350,0.6956521739130435,15,8,7,411.2819025438299,0.4665708812260536,0.11438294823571549,0.2063060972059482,125134.44473349523,4293.106500751535,129427.55123424676,26,0,15.233333333333333,30,0,21,39.57801585169264,0.5847222222222221,49.865591397849464,1000.5376344086023,33.35125448028675,0
31,4,6,3,33,0.16666666666666666,0.08333333333333333,0.9166666666666666,36,1300,1000,300,0.7692307692307693,16,10,6,362.3386380711702,0.4710978835978836,0.12557392102846698,0.1906216313330938,127092.01388888882,2031.8476124407384,129123.86150132955,27,0,13.527777777777779,33,3,21,38.7827134986226,0.5972222222222222,47.916666666666664,1008.3333333333327,30.555555555555536,0
32,4,2,1,34,0.05714285714285714,0.02857142857142857,0.9714285714285714,35,1050,800,250,0.7619047619047619,13,8,5,362.966535135116,0.47079831932773114,0.12116858751005122,0.19230731931114997,127378.63363751149,2246.836260330578,129625.46989784206,27,0,14.057142857142857,32,3,19,38.4724828017511,0.6025390625,47.63257575757576,1009.469696969697,31.54592803030303,0
33,4,1,4,31,0.02857142857142857,0.11428571428571428,0.8857142857142857,35,1300,900,400,0.6923076923076923,17,9,8,365.2008142678153,0.4695728291316527,0.12627557396365208,0.19456304365985733,127601.7833001734,2320.055032649724,129921.83833282311,28,0,14.971428571428572,32,3,21,38.18706781637925,0.6048177083333333,47.41161616161616,1010.3535353535349,31.573547979797965,0
34,4,4,2,33,0.11428571428571428,0.05714285714285714,0.9428571428571428,35,1250,700,550,0.56,18,7,11,351.12181229091243,0.47072829131652666,0.1140437300146917,0.19004726775274322,128237.60880730957,2005.4043216551147,130243.0131289647,29,0,14.6,33,2,23,37.89209013914093,0.6089015151515151,46.78308823529411,1012.8676470588226,30.692959001782505,0
35,4,1,0,34,0.029411764705882353,0.0,1.0,34,1200,700,500,0.5833333333333334,17,7,10,362.56540696952027,0.4691770647653,0.1202275526362091,0.19656924496779932,128304.38220589732,2503.7461100908054,130808.12831598813,30,0,16.0,32,2,24,37.53401254569626,0.6119791666666667,46.717171717171716,1013.1313131313128,31.660353535353526,0
36,4,0,0,34,0.0,0.0,1.0,34,1000,700,300,0.7,13,7,6,365.4725277671647,0.4683972073677956,0.1232084762155985,0.19878139924896993,128432.33471074373,2587.698002754811,131020.03271349854,31,1,17.0,32,2,17,37.32950298953663,0.61328125,46.590909090909086,1013.6363636363631,31.676136363636346,0
37,4,1,3,32,0.02857142857142857,0.08571428571428572,0.9142857142857143,35,1200,800,400,0.6666666666666666,16,8,8,356.4246646278273,0.46736694677871143,0.12346002621232,0.19579720966690423,128827.88470780446,2183.487120338305,131011.37182814277,32,0,17.485714285714284,33,2,18,37.154957347497195,0.6148989898989898,46.20098039215685,1015.1960784313707,30.763517528223353,0
38,4,0,1,31,0.0,0.03125,0.96875,32,1350,1000,350,0.7407407407407407,17,10,7,370.71541118889684,0.46490675403225806,0.10122369771619244,0.2031895861326485,128738.47961425778,3145.0676812065954,131883.54729546438,33,1,17.71875,31,1,18,36.88360704815671,0.6189516129032258,46.2890625,1014.8437499999998,32.73689516129031,0
39,4,1,2,30,0.03125,0.0625,0.9375,32,1100,800,300,0.7272727272727273,14,8,6,370.37409885699583,0.46522177419354843,0.10024288187764552,0.20350999639097928,128837.60452270506,3143.622334798177,131981.22685750324,34,0,18.46875,31,1,19,36.79099333076825,0.6199596774193548,46.19140625,1015.2343749999999,32.74949596774193,0
40,4,1,1,30,0.03225806451612903,0.03225806451612903,0.967741935483871,31,550,400,150,0.7272727272727273,7,4,3,378.69035605260837,0.4646505376344086,0.09114738981198456,0.2085557092079818,128928.23592322822,3564.775913400406,132493.01183662863,34,0,18.70967741935484,30,1,20,36.48728383624492,0.6236111111111111,46.102150537634415,1015.5913978494632,33.853046594982104,0
41,4,0,0,30,0.0,0.0,1.0,30,750,400,350,0.5333333333333333,11,4,7,375.0328938159624,0.46254789272030655,0.05850088183421498,0.20725502026671638,129064.77627471407,3680.7073072031762,132745.48358191724,35,1,19.3,30,0,22,36.440696649029995,0.625,45.967741935483886,1016.1290322580664,33.87096774193555,0
42,4,0,0,30,0.0,0.0,1.0,30,1450,1000,450,0.6896551724137931,19,10,9,403.02800224072917,0.4619731800766283,0.06023422943838175,0.21416919440147378,127498.92509249625,4277.127413573828,131776.0525060701,36,2,20.3,30,0,17,37.33752550794075,0.6090277777777777,47.513440860215056,1009.9462365591398,33.66487455197133,8
43,4,2,1,31,0.0625,0.03125,0.96875,32,750,600,150,0.8,9,6,3,369.4697190183461,0.46268061155913975,0.06622706422018321,0.19003688133348307,126170.65741059605,2923.2474683706005,129093.90487896664,37,0,19.96875,32,0,20,39.55217628084286,0.5901692708333333,48.83207070707072,1004.6717171717188,31.395991161616212,8
44,4,1,0,32,0.03125,0.0,1.0,32,1250,800,450,0.64,17,8,9,375.9224130468298,0.4604544690860215,0.1126575630252098,0.19576939250309458,126678.5775207889,3124.2633085909856,129802.84082937989,38,0,20.8125,32,0,20,38.86606881558594,0.5953776041666667,48.327020202020215,1006.6919191919208,31.459122474747524,0
45,4,1,0,33,0.030303030303030304,0.0,1.0,33,900,500,400,0.5555555555555556,13,5,8,369.1687726248208,0.46216066919191917,0.11244678186826951,0.19421487603305806,127092.01388888904,2783.6805555555798,129875.69444444461,39,0,21.151515151515152,33,0,21,38.61053719008265,0.5972222222222222,47.91666666666668,1008.3333333333346,30.555555555555596,0
46,4,0,0,33,0.0,0.0,1.0,33,1150,500,650,0.43478260869565216,18,5,13,373.53795236678116,0.4618844696969697,0.11447811447811485,0.1974414891081559,127283.05785123975,2909.0105601469377,130192.06841138669,40,1,22.151515151515152,32,1,21,38.303928928928926,0.6015625,47.727272727272734,1009.0909090909098,31.53409090909093,0
47,4,1,3,31,0.029411764705882353,0.08823529411764706,0.9117647058823529,34,1200,700,500,0.5833333333333334,17,7,10,365.54257399848166,0.46241830065359474,0.11553603012495017,0.19527170662820445,127710.61610918876,2536.7334678969655,130247.34957708573,41,0,22.470588235294116,33,1,21,38.066804073714835,0.6035353535353536,47.30392156862745,1010.7843137254902,30.62982768865122,0
48,4,1,2,30,0.03125,0.0625,0.9375,32,1000,600,400,0.6,14,6,8,367.41697786298465,0.46186155913978494,0.06125218367856222,0.1976160846036216,127984.77993317024,3004.756211100925,130989.53614427117,41,0,21.21875,32,0,22,37.73838490974129,0.6087239583333333,47.03282828282829,1011.8686868686881,31.620896464646503,0
49,4,0,0,30,0.0,0.0,1.0,30,950,700,250,0.7368421052631579,12,7,5,371.97610619937274,0.46053639846743294,0.06971226206285985,0.20035622887562776,128042.48504162328,3525.7490027748895,131568.23404439818,42,1,22.266666666666666,30,0,22,37.56391102257636,0.6145833333333333,46.975806451612904,1012.0967741935482,33.73655913978494,0
50,4,1,1,30,0.03225806451612903,0.03225806451612903,0.967741935483871,31,1100,800,300,0.7272727272727273,14,8,6,359.54322725933156,0.46160394265232974,0.06683685309816623,0.19543886040409492,128408.33875868063,3033.6697048611168,131442.00846354174,43,0,22.516129032258064,31,0,18,37.50428228845495,0.6155913978494624,46.614583333333336,1013.5416666666673,32.6948924731183,0
51,4,1,0,31,0.03225806451612903,0.0,1.0,31,850,600,250,0.7058823529411765,11,6,5,361.61265493830774,0.4593189964157706,0.07019460792834842,0.19820035390922439,128738.47961425783,3110.6926812065967,131849.17229546444,44,0,22.580645161290324,31,0,19,37.114553930373795,0.6189516129032258,46.2890625,1014.8437500000001,32.73689516129033,0
52,4,0,1,30,0.0,0.03225806451612903,0.967741935483871,31,1050,800,250,0.7619047619047619,13,8,5,362.1932938856017,0.4584677419354839,0.0717287014061212,0.19951325510647533,128936.76757812488,3140.0065104166515,132076.77408854154,45,1,23.580645161290324,31,0,19,36.8974358974359,0.6209677419354839,46.09374999999999,1015.6249999999991,32.762096774193516,0
53,4,0,1,29,0.0,0.03333333333333333,0.9666666666666667,30,850,600,250,0.7058823529411765,11,6,5,371.0548249649884,0.4562739463601533,0.0807291666666663,0.20364869463194707,128791.76783443171,3557.7613741472965,132349.529208579,46,2,25.233333333333334,30,0,20,36.82054422669491,0.6222222222222222,46.236559139784944,1015.0537634408602,33.83512544802867,0
54,4,1,1,29,0.03333333333333333,0.03333333333333333,0.9666666666666667,30,750,500,250,0.6666666666666666,10,5,5,366.4607394795811,0.4538553639846743,0.0556378709705867,0.20234307740877674,129030.63441221527,3456.9323404439792,132487.56675265924,47,0,24.733333333333334,30,0,21,36.69329055871587,0.6246527777777777,46.001344086021504,1015.9946236559139,33.86648745519713,0
55,4,1,0,30,0.03333333333333333,0.0,1.0,30,500,200,300,0.4,8,2,6,364.6927218466745,0.45622605363984675,0.047528416600582046,0.2025892168496283,129269.72229448486,3428.745375187882,132698.46766967274,48,0,24.633333333333333,30,0,23,36.49440479337389,0.6270833333333333,45.766129032258064,1016.9354838709673,33.89784946236558,0
56,4,1,1,30,0.03225806451612903,0.03225806451612903,0.967741935483871,31,950,600,350,0.631578947368421,13,6,7,355.45735394730053,0.4568996415770609,0.041179454817674266,0.19928544553561575,129631.97708129896,3015.727912055136,132647.7049933541,49,0,24.806451612903224,31,0,17,36.36057302987682,0.6280241935483871,45.41015625000001,1018.359375000001,32.85030241935487,0
57,4,1,1,30,0.03225806451612903,0.03225806451612903,0.967741935483871,31,850,500,350,0.5882352941176471,12,5,7,354.5903538375968,0.45474910394265233,0.04776040635925849,0.19930423336389078,129731.4453125001,3000.3038194444594,132731.74913194455,50,0,25.741935483870968,31,0,18,36.2815269256987,0.6290322580645161,45.31250000000001,1018.7500000000008,32.86290322580648,0
58,4,0,1,29,0.0,0.03333333333333333,0.9666666666666667,30,1200,1000,200,0.8333333333333334,14,10,4,362.65227487912983,0.4533045977011494,0.04172604908946953,0.20356881029881832,129680.10210718008,3405.7568071453425,133085.85891432542,51,1,26.733333333333334,30,0,21,36.12843098442861,0.63125,45.362903225806456,1018.5483870967747,33.95161290322582,0
59,4,0,0,29,0.0,0.0,1.0,29,850,600,250,0.7058823529411765,11,6,5,374.4279244912707,0.4528427750410509,0.04825986951961192,0.20969680018682246,129589.9908371914,3904.4222608024775,133494.41309799388,52,2,28.517241379310345,29,0,22,35.92037807484201,0.6332614942528736,45.45138888888889,1018.1944444444448,35.11015325670499,0
60,4,1,0,30,0.03333333333333333,0.0,1.0,30,1200,900,300,0.75,15,9,6,365.78690795442947,0.45155651340996167,0.056205276790025405,0.2080464413556542,130193.99144771077,3524.651513180716,133718.64296089148,53,0,28.533333333333335,30,0,23,35.52614249967075,0.6364583333333333,44.858870967741936,1020.5645161290327,34.01881720430109,0
61,4,1,0,31,0.03225806451612903,0.0,1.0,31,1300,900,400,0.6923076923076923,17,9,8,357.7896441202106,0.45094086021505375,0.048385042382108834,0.20578802168408591,130628.37600708005,3147.4960327148433,133775.8720397949,54,0,28.580645161290324,31,0,21,35.28969239587314,0.6381048387096775,44.43359375,1022.2656249999998,32.97631048387096,0
62,4,0,0,31,0.0,0.0,1.0,31,1000,600,400,0.6,14,6,8,358.6883455733305,0.44959677419354843,0.04020249048516411,0.2073741229705413,130828.11355590819,3185.303921169705,134013.4174770779,55,1,29.580645161290324,31,0,21,35.06440647405711,0.6401209677419355,44.23828125,1023.0468749999999,33.00151209677419,0
63,4,0,1,30,0.0,0.03225806451612903,0.967741935483871,31,600,500,100,0.8333333333333334,7,5,2,361.61297713786416,0.4491935483870968,0.04123254449282032,0.20978890134913297,130961.3566928441,3271.4652167426298,134232.82190958672,56,2,30.580645161290324,31,0,21,34.85468875885171,0.6414650537634409,44.10807291666667,1023.5677083333344,33.018313172043044,0
64,4,0,0,30,0.0,0.0,1.0,30,1250,900,350,0.72,16,9,7,364.2692970502346,0.4477250957854406,0.008813366574815129,0.2124021662448232,131155.97043372074,3555.218630766568,134711.1890644873,55,3,30.733333333333334,30,0,22,34.58973013165376,0.6461805555555555,43.918010752688176,1024.327956989248,34.14426523297493,0
65,4,0,0,30,0.0,0.0,1.0,30,1200,800,400,0.6666666666666666,16,8,8,366.9729379471023,0.4469348659003831,0.010571878279117985,0.2145553434745942,131259.2496242341,3633.7184934674574,134892.96811770156,56,4,31.733333333333334,30,0,22,34.415988982161586,0.6472222222222221,43.81720430107527,1024.7311827956996,34.15770609318999,0
66,4,1,2,29,0.03225806451612903,0.06451612903225806,0.935483870967742,31,950,800,150,0.8421052631578947,11,8,3,356.52427479388507,0.44717741935483873,0.0031431354413078427,0.21065399804538232,131661.99578179242,3188.139512803813,134850.13529459623,57,0,31.677419354838708,31,0,15,34.276939017169944,0.648521505376344,43.424479166666664,1026.3020833333326,33.106518817204275,0
67,4,0,0,29,0.0,0.0,1.0,29,800,600,200,0.75,10,6,4,378.07281944007894,0.4445299671592775,0.010371457002835482,0.22164856872813551,131363.71768904332,4133.0102237654455,135496.72791280877,58,6,34.06896551724138,29,0,23,34.02584902678047,0.6512212643678161,43.715277777777786,1025.1388888888898,35.34961685823758,0
68,4,0,0,29,0.0,0.0,1.0,29,1300,1100,200,0.8461538461538461,15,11,4,380.8934009128462,0.4431444991789819,0.015128522400952527,0.22413528013875436,131506.1366705246,4217.963927469131,135724.10059799373,59,7,35.06896551724138,29,0,23,33.80938275784247,0.6526580459770115,43.576388888888886,1025.694444444444,35.368773946360136,0
69,4,0,0,29,0.0,0.0,1.0,29,1250,900,350,0.72,16,9,7,380.496792513467,0.44278530377668307,0.015126474130928047,0.22411079023161623,131541.75347222216,4210.243055555552,135751.99652777772,60,8,36.06896551724138,29,0,23,33.783509341998375,0.6530172413793103,43.541666666666664,1025.833333333333,35.37356321839079,0
70,4,0,0,29,0.0,0.0,1.0,29,1200,900,300,0.75,15,9,6,379.0105495998867,0.4424774220032841,0.015682467374867004,0.22365255115367108,131613.00154320986,4176.543209876542,135789.5447530864,61,9,37.06896551724138,29,0,18,33.749548817902905,0.6537356321839081,43.47222222222222,1026.111111111111,35.383141762452105,0
71,4,0,0,29,0.0,0.0,1.0,29,750,500,250,0.6666666666666666,10,5,5,381.1060186295711,0.44170771756978655,0.01707806448602489,0.22530987821380227,131684.2689043209,4237.133487654308,135921.4023919752,62,10,38.06896551724138,29,0,18,33.62370320252594,0.6544540229885057,43.40277777777777,1026.3888888888882,35.39272030651339,0
72,4,0,0,29,0.0,0.0,1.0,29,700,400,300,0.5714285714285714,10,4,6,383.6657957782805,0.44129720853858784,0.01567186108014562,0.22746120514746002,131791.2061149691,4312.755594135795,136103.9617091049,63,11,39.06896551724138,29,0,18,33.44985684656657,0.6555316091954023,43.29861111111111,1026.8055555555552,35.40708812260535,0
73,4,0,0,29,0.0,0.0,1.0,29,750,500,250,0.6666666666666666,10,5,5,383.17845969313737,0.4410406403940887,0.01790827604861356,0.22738535561565468,131826.86149691354,4302.642746913573,136129.5042438271,64,12,40.06896551724138,29,0,19,33.42631412857272,0.6558908045977012,43.263888888888886,1026.9444444444441,35.411877394636,0
74,4,0,0,29,0.0,0.0,1.0,29,1100,800,300,0.7272727272727273,14,8,6,383.48678381689956,0.4405275041050903,0.022659032841610527,0.22799584028213749,131898.18672839514,4316.24228395063,136214.42901234576,65,13,41.06896551724138,29,0,20,33.34629078781323,0.6566091954022988,43.19444444444445,1027.2222222222229,35.42145593869734,0
75,4,0,3,26,0.0,0.10344827586206896,0.896551724137931,29,1150,500,650,0.43478260869565216,18,5,13,388.6584635880283,0.4391420361247948,0.02767566358693352,0.2321599103321225,132076.58420138893,4466.536458333338,136543.12065972228,66,14,42.06896551724138,29,0,20,33.03312052425347,0.6584051724137931,43.020833333333336,1027.916666666667,35.44540229885059,0
76,4,0,0,26,0.0,0.0,1.0,26,750,500,250,0.6666666666666666,10,5,5,425.7761081207889,0.43378205128205133,0.04623715634545955,0.2509361318073586,131565.50068587105,6003.489368998631,137568.99005486968,67,16,45.0,26,0,21,32.59814981949459,0.6634615384615384,43.51851851851852,1025.9259259259259,39.458689458689456,0
77,4,0,0,26,0.0,0.0,1.0,26,800,800,0,1.0,8,8,0,440.9453607714934,0.4335576923076923,0.028876836580832732,0.24283359156796627,128926.97199836149,6169.950036198747,135096.92203456024,68,17,46.0,26,0,18,34.90794205541203,0.6366185897435898,46.10339506172839,1015.5864197530861,39.061016144349466,8
78,4,0,0,26,0.0,0.0,1.0,26,1050,700,350,0.6666666666666666,14,7,7,439.7054440767568,0.43272435897435896,0.025697469374408755,0.24359459715169016,129162.16861473095,6158.66174173144,135320.8303564624,69,18,47.0,26,0,18,34.697763271089535,0.6390224358974359,45.87191358024691,1016.512345679012,39.096628679962,0
79,4,1,0,27,0.037037037037037035,0.0,1.0,27,1000,800,200,0.8,12,8,4,426.0589011197839,0.4342948717948718,0.01970400684227047,0.23855114578245173,129579.88989866784,5641.733099489801,135221.62299815763,70,0,46.22222222222222,27,0,19,34.61646204813407,0.6396604938271605,45.461309523809526,1018.1547619047622,37.709435626102305,0
80,4,0,1,26,0.0,0.037037037037037035,0.962962962962963,27,650,200,450,0.3076923076923077,11,2,9,446.2705056817938,0.4341168091168091,-0.004907599110497429,0.2317727464992542,126567.38281250001,5896.657986111112,132464.04079861112,71,1,47.22222222222222,27,0,19,37.21100759144236,0.6087962962962963,48.4375,1006.2500000000001,37.268518518518526,8
81,4,0,1,25,0.0,0.038461538461538464,0.9615384615384616,26,800,700,100,0.875,9,7,2,450.45296310804235,0.43445512820512816,-0.02563905960624213,0.2340560774842663,126586.794243446,6204.279311461653,132791.07355490766,72,2,47.42307692307692,26,0,19,37.08563359402955,0.6125801282051282,48.4182098765432,1006.3271604938261,38.704890788224084,0
82,4,3,3,25,0.10714285714285714,0.10714285714285714,0.8928571428571429,28,650,500,150,0.7692307692307693,8,5,3,419.9477153376395,0.44485780423280424,-0.021660264618010627,0.2231150786929905,127490.73368757417,5107.888467763228,132598.6221553374,73,0,44.07142857142857,28,0,17,36.918776971593886,0.6149553571428572,47.52155172413792,1009.913793103447,36.068349753694534,0
83,4,2,1,26,0.07407407407407407,0.037037037037037035,0.962962962962963,27,750,500,250,0.6666666666666666,10,5,5,428.890726813504,0.4386870845204178,-0.006113703976637019,0.22752334491240214,127429.84970680966,5530.696171697824,132960.5458785075,74,0,46.51851851851852,27,0,18,36.755864652419554,0.6176697530864197,47.58184523809523,1009.6726190476179,37.39528218694881,0
84,4,0,1,25,0.0,0.038461538461538464,0.9615384615384616,26,350,100,250,0.2857142857142857,6,1,5,458.54522875033126,0.4355448717948718,0.009147319995720382,0.22737518584240557,124653.01890432088,6231.80941358023,130884.8283179011,75,1,49.30769230769231,26,0,19,38.899513212795554,0.5925480769230769,50.347222222222214,998.6111111111103,38.408119658119624,8
85,4,1,1,25,0.038461538461538464,0.038461538461538464,0.9615384615384616,26,1150,900,250,0.782608695652174,14,9,5,441.4111077609028,0.43570512820512824,0.04512267393623337,0.22276501472537014,125386.10015622624,5869.36347355587,131255.4636297821,76,0,48.96153846153846,26,0,19,38.56189008731383,0.6001602564102564,49.6141975308642,1001.5432098765436,38.52089268755937,0
86,4,3,1,27,0.10714285714285714,0.03571428571428571,0.9642857142857143,28,800,500,300,0.625,11,5,6,410.56311267740534,0.4442791005291005,-0.005923444585154369,0.21144907290616866,126224.24734112818,4764.6039767472475,130988.85131787544,77,0,43.642857142857146,28,0,22,38.46451720522352,0.6019345238095238,48.7787356321839,1004.8850574712635,35.88875205254512,0
87,4,3,3,27,0.1,0.1,0.9,30,750,500,250,0.6666666666666666,10,5,5,378.43626666666665,0.4493295019157088,-0.017360000000000264,0.19875854341736696,127024.2585848075,3614.117238987166,130638.37582379466,78,0,40.1,30,0,21,38.44666666666665,0.6041666666666667,47.983870967741936,1008.0645161290323,33.60215053763441,0
88,4,2,1,28,0.06896551724137931,0.034482758620689655,0.9655172413793104,29,700,500,200,0.7142857142857143,9,5,4,387.4446678915819,0.4466851395730706,-0.04767727906434527,0.20156579384137074,126637.27092978396,4012.987075617288,130650.25800540125,79,0,42.310344827586206,29,0,20,38.618710040936485,0.6030890804597702,48.36805555555556,1006.5277777777778,34.70785440613027,8
89,4,1,0,29,0.034482758620689655,0.0,1.0,29,1300,1000,300,0.7692307692307693,16,10,6,387.4922093124285,0.44612068965517243,-0.043923447705428,0.2028043640946866,126882.03125000001,4033.1597222222226,130915.19097222223,80,0,43.241379310344826,29,0,22,38.3650399779432,0.6056034482758621,48.125,1007.5000000000001,34.74137931034483,0
90,4,4,3,30,0.12121212121212122,0.09090909090909091,0.9090909090909091,33,1250,1000,250,0.8,15,10,5,357.8173749258168,0.45059974747474746,-0.013207415795395194,0.19427392470529062,128361.7647809735,2586.0139429546116,130947.77872392812,81,0,38.878787878787875,33,0,20,37.595613133389755,0.6101641414141414,46.66053921568626,1013.3578431372537,30.707813428401625,0
91,4,2,5,27,0.0625,0.15625,0.84375,32,1250,1000,250,0.8,15,10,5,365.45670445044743,0.44716061827956993,-0.009241971620612244,0.1997332764323055,128624.38303489421,3001.3286271808815,131625.7116620751,82,0,40.78125,32,0,19,37.133588498879774,0.615234375,46.40151515151514,1014.3939393939378,31.699810606060556,0
92,4,3,0,30,0.1,0.0,1.0,30,1250,900,350,0.72,16,9,7,384.2843195033758,0.4381944444444445,0.012726791153489625,0.21072846017211255,128757.66210327778,3895.9101124407357,132653.5722157185,83,0,43.833333333333336,30,0,22,36.51972144969762,0.621875,46.27016129032258,1014.9193548387092,33.830645161290306,0
93,4,0,0,30,0.0,0.0,1.0,30,550,300,250,0.5454545454545454,8,3,5,384.1978104352198,0.4381226053639847,0.013956567796610253,0.21086205409932993,128791.76783443168,3896.303040813964,132688.07087524564,84,1,44.833333333333336,30,0,22,36.487023305084755,0.6222222222222222,46.236559139784944,1015.0537634408599,33.83512544802866,0
94,4,0,2,28,0.0,0.06666666666666667,0.9333333333333333,30,1100,800,300,0.7272727272727273,14,8,6,385.0865715276179,0.43769157088122607,0.009025939650609383,0.2120782896838688,128928.23592322807,3929.7064689559484,132857.94239218402,85,2,45.833333333333336,30,0,22,36.324885300864665,0.6236111111111111,46.10215053763441,1015.5913978494619,33.85304659498207,0
95,4,0,0,28,0.0,0.0,1.0,28,600,400,200,0.6666666666666666,8,4,4,400.9680607081448,0.4334490740740741,0.006010514609240625,0.22011183752160407,128800.00092895374,4728.937318337975,133528.93824729172,86,3,45.607142857142854,28,0,23,36.05301958008965,0.6283482142857143,46.22844827586208,1015.0862068965528,36.25307881773403,0
96,4,0,0,28,0.0,0.0,1.0,28,950,800,150,0.8421052631578947,11,8,3,401.06273346527547,0.43284281305114636,0.010988622355151856,0.2209752504182414,128945.8879351634,4743.078056876762,133688.96599204015,87,4,46.607142857142854,28,0,23,35.901176498325995,0.6298363095238095,46.08477011494254,1015.6609195402318,36.27360426929399,0
97,4,0,1,27,0.0,0.03571428571428571,0.9642857142857143,28,700,400,300,0.5714285714285714,10,4,6,401.51631310167426,0.43245701058201064,0.017713276123169752,0.2224532431632221,129164.87327008194,4772.360739529661,133937.2340096116,88,5,47.607142857142854,28,0,23,35.66548881036515,0.6320684523809523,45.86925287356322,1016.5229885057473,36.304392446633834,0
98,4,0,0,27,0.0,0.0,1.0,27,650,500,150,0.7692307692307693,8,5,3,412.37406579548843,0.43019943019943024,0.023682883586265246,0.22846125251005556,129163.56923628847,5252.741239725086,134416.31047601355,89,6,48.074074074074076,27,0,23,35.39089567169276,0.6354166666666667,45.87053571428573,1016.5178571428588,37.64880952380958,0
99,4,0,0,27,0.0,0.0,1.0,27,550,300,250,0.5454545454545454,8,3,5,411.652938391008,0.4296058879392213,0.0245865651983026,0.22849914931159704,129239.21407755821,5240.340446074284,134479.55452363248,90,7,49.074074074074076,27,0,23,35.33175398799943,0.6361882716049383,45.79613095238096,1016.815476190477,37.65983245149915,0
100,4,3,0,30,0.1,0.0,1.0,30,750,400,350,0.5333333333333333,11,4,7,376.7881196903946,0.4321120689655173,0.014289477150006835,0.21430353504188537,130193.99144771091,3811.109846514077,134005.101294225,91,0,45.06666666666667,30,0,24,35.24545634136706,0.6364583333333333,44.85887096774195,1020.5645161290338,34.01881720430113,0
101,4,0,0,30,0.0,0.0,1.0,30,1400,1200,200,0.8571428571428571,16,12,4,378.6990997229917,0.4314176245210728,0.013868421052631863,0.21672538839568806,130434.1542374841,3879.0593565730164,134313.2135940571,92,1,46.06666666666667,30,0,24,34.952576754385966,0.6388888888888888,44.623655913978496,1021.505376344086,34.05017921146953,0
102,4,0,0,30,0.0,0.0,1.0,30,700,600,100,0.8571428571428571,8,6,2,381.4364835757644,0.4305316091954023,0.00856015779092667,0.21926110790579637,130605.8345798646,3963.5660553242965,134569.4006351889,93,2,47.06666666666667,30,0,18,34.70825115055883,0.640625,44.45564516129031,1022.1774193548378,34.07258064516126,0
103,4,0,3,27,0.0,0.1,0.9,30,600,300,300,0.5,9,3,6,379.90748047471953,0.42983716475095785,0.008961892247043135,0.21935477438638956,130777.62783269734,3936.6798184761137,134714.30765117344,94,3,48.06666666666667,30,0,18,34.572930354796306,0.6423611111111112,44.287634408602145,1022.8494623655907,34.09498207885302,0
104,4,0,0,27,0.0,0.0,1.0,27,550,200,350,0.36363636363636365,9,2,7,415.3778677927727,0.4256291547958215,0.03719905382197619,0.23620741437171086,130186.64301658147,5415.330038265282,135601.97305484675,95,4,53.74074074074074,27,0,23,34.26837270341207,0.6458333333333333,44.866071428571416,1020.535714285713,37.797619047619,0
105,4,1,0,28,0.03571428571428571,0.0,1.0,28,850,500,350,0.5882352941176471,12,5,7,402.20861628434466,0.4278824955908289,0.026653876288245115,0.23046780583384147,130482.68688482618,4896.252188201859,135378.93907302804,96,0,52.785714285714285,28,0,24,34.30278207471991,0.6454613095238095,44.57614942528735,1021.6954022988499,36.48912151067321,0
106,4,2,1,29,0.06666666666666667,0.03333333333333333,0.9666666666666667,30,450,300,150,0.6666666666666666,6,3,3,377.83721838087797,0.4341235632183908,0.023185933604513487,0.22031349971542974,131155.97043372047,3911.1214085443034,135067.09184226478,97,0,50.2,30,0,22,34.24228010322353,0.6461805555555555,43.918010752688154,1024.3279569892456,34.14426523297485,0
107,4,0,1,28,0.0,0.034482758620689655,0.9655172413793104,29,950,600,350,0.631578947368421,13,6,7,406.23380926891554,0.43139367816091956,0.025469415476915058,0.22347444541497663,128883.87586805546,4671.397569444434,133555.27343749988,98,1,52.89655172413793,29,0,18,35.83341882095474,0.6260775862068966,46.14583333333333,1015.4166666666658,35.01436781609193,8
108,4,1,0,29,0.034482758620689655,0.0,1.0,29,1250,1000,250,0.8,15,10,5,402.78884052572977,0.43149630541871925,0.026282446811016102,0.22356460208406884,129236.69222608028,4611.019483024696,133847.71170910497,99,0,53.172413793103445,29,0,20,35.559662842052546,0.6296695402298851,45.798611111111114,1016.8055555555559,35.062260536398476,0
109,4,0,0,29,0.0,0.0,1.0,29,950,700,250,0.7368421052631579,12,7,5,401.36052836957936,0.43108579638752054,0.028810168294692406,0.22357154907278823,129377.9538001542,4585.440779320974,133963.39457947516,100,1,54.172413793103445,29,0,20,35.45150739476677,0.6311063218390804,45.659722222222214,1017.3611111111102,35.08141762452104,0
110,4,0,0,29,0.0,0.0,1.0,29,1050,700,350,0.6666666666666666,14,7,7,398.20751736194063,0.4303674055829228,0.03584212531573572,0.22301446216809678,129589.99083719138,4520.741705246923,134110.7325424383,101,2,55.172413793103445,29,0,17,35.31507184104034,0.6332614942528736,45.45138888888889,1018.1944444444446,35.11015325670498,0
111,4,0,0,29,0.0,0.0,1.0,29,1100,600,500,0.5454545454545454,16,6,10,401.81744152851195,0.43026477832512317,0.03552598189866618,0.22646208801353476,129837.58680555563,4634.201388888894,134471.78819444453,102,3,56.172413793103445,29,0,17,34.970359771054774,0.6357758620689655,45.208333333333336,1019.1666666666673,35.14367816091956,0
112,4,1,1,29,0.03333333333333333,0.03333333333333333,0.9666666666666667,30,1050,800,250,0.7619047619047619,13,8,5,391.09404883421644,0.43309386973180075,0.02285413375460732,0.22302930892978284,130296.8912591051,4191.667750607006,134488.5590097121,103,0,55.266666666666666,30,0,19,34.77570431806214,0.6375,44.75806451612903,1020.9677419354839,34.03225806451613,0
113,4,0,0,29,0.0,0.0,1.0,29,750,700,50,0.9333333333333333,8,7,1,402.3323615160349,0.4302134646962233,0.02702322308233618,0.2292358803986709,130262.58680555545,4681.770833333315,134944.35763888876,104,1,57.96551724137931,29,0,20,34.52380952380951,0.6400862068965517,44.79166666666666,1020.8333333333325,35.201149425287326,0
114,4,1,0,30,0.03333333333333333,0.0,1.0,30,700,400,300,0.5714285714285714,10,4,6,391.9745638273288,0.43074712643678165,0.03205397826848899,0.22591988496956936,130708.89698230998,4246.912576598431,134955.8095589084,105,0,57.0,30,0,18,34.334198650543286,0.6416666666666666,44.35483870967741,1022.5806451612893,34.08602150537631,0
115,4,0,2,28,0.0,0.06666666666666667,0.9333333333333333,30,950,700,250,0.7368421052631579,12,7,5,391.59357566023607,0.42990900383141767,0.02646788388283161,0.22670736817500967,130880.75798141398,4250.412800612775,135131.17078202675,106,1,58.0,30,0,18,34.16934848285826,0.6434027777777778,44.18682795698924,1023.2526881720426,34.108422939068085,0
116,4,0,0,28,0.0,0.0,1.0,28,1300,1000,300,0.7692307692307693,16,10,6,411.523043337722,0.4232253086419753,0.04046213763751694,0.23692540262064965,130666.24554102258,5154.434205311133,135820.6797463337,107,2,60.142857142857146,28,0,19,33.87788083192804,0.6473214285714286,44.39655172413793,1022.4137931034483,36.51477832512315,0
117,4,0,0,28,0.0,0.0,1.0,28,1100,600,500,0.5454545454545454,16,6,10,414.5817102986496,0.42162698412698413,0.04479078910418455,0.24005292201194975,130886.68623662302,5252.645247060377,136139.3314836834,108,3,61.142857142857146,28,0,19,33.57524805766172,0.6495535714285714,44.18103448275862,1023.2758620689651,36.54556650246304,0
118,4,0,0,28,0.0,0.0,1.0,28,850,700,150,0.8235294117647058,10,7,3,413.29480406600237,0.42212301587301587,0.04477821448624386,0.23976483584415303,130960.20775531765,5225.034680935383,136185.24243625303,109,4,62.142857142857146,28,0,19,33.53336140744899,0.6502976190476191,44.109195402298845,1023.5632183908039,36.55582922824299,0
119,4,0,0,28,0.0,0.0,1.0,28,700,300,400,0.42857142857142855,11,3,8,412.30281317328433,0.42154431216931215,0.04346365914786987,0.23941789273509786,130996.97625594531,5202.084365504036,136199.06062144935,110,5,63.142857142857146,28,0,19,33.52134502923978,0.6506696428571428,44.07327586206897,1023.7068965517242,36.560960591133004,0
120,4,0,0,28,0.0,0.0,1.0,28,900,700,200,0.7777777777777778,11,7,4,413.56284821024843,0.4210207231040564,0.04242825076158452,0.24083954101655633,131107.31272294882,5244.222734178888,136351.5354571277,111,6,64.14285714285714,28,0,20,33.37688224841003,0.6517857142857143,43.96551724137931,1024.1379310344823,36.57635467980294,0
121,4,0,0,28,0.0,0.0,1.0,28,1100,800,300,0.7272727272727273,14,8,6,412.97994488358165,0.41964285714285715,0.04618019389472017,0.24142401368112335,131254.50026423574,5241.095256969225,136495.59552120496,112,7,65.14285714285714,28,0,22,33.24219480276688,0.6532738095238095,43.821839080459775,1024.7126436781612,36.5968801313629,0
122,4,1,1,28,0.034482758620689655,0.034482758620689655,0.9655172413793104,29,900,500,400,0.5555555555555556,13,5,8,400.1161983215734,0.4211309523809524,0.040326344678229153,0.23610690680509466,131613.00154320995,4732.0987654321125,136345.10030864205,113,0,63.86206896551724,29,0,19,33.20813030138964,0.6537356321839081,43.47222222222223,1026.1111111111118,35.38314176245213,0
123,4,0,0,28,0.0,0.0,1.0,28,1250,1000,250,0.8,15,10,5,412.0866814514912,0.4176862874779541,0.045119364456806865,0.24252982843216805,131512.27715434675,5238.891572532713,136751.16872687946,114,9,67.14285714285714,28,0,22,33.00328010458982,0.6558779761904762,43.57040229885058,1025.7183908045984,36.6327996715928,0
124,4,0,0,28,0.0,0.0,1.0,28,850,500,350,0.5882352941176471,12,5,7,410.4066917362103,0.4177414021164021,0.0422059735531235,0.24200777751348299,131585.97414205977,5200.752865305856,136786.72700736564,115,10,68.14285714285714,28,0,19,32.97157260887831,0.6566220238095238,43.49856321839081,1026.0057471264372,36.64306239737276,0
125,4,0,0,28,0.0,0.0,1.0,28,950,800,150,0.8421052631578947,11,8,3,408.13150746944297,0.41672178130511467,0.03972364421692487,0.24136518951669728,131696.5583300305,5149.902975954564,136846.46130598505,116,11,69.14285714285714,28,0,20,32.91777482269504,0.6577380952380952,43.390804597701155,1026.4367816091963,36.658456486042724,0
126,4,0,0,28,0.0,0.0,1.0,28,800,500,300,0.625,11,5,6,409.6322443201956,0.4161706349206349,0.04348086841789578,0.2427223895449519,131770.30692627837,5195.4733121944955,136965.78023847286,117,12,70.14285714285714,28,0,20,32.80448269428118,0.6584821428571428,43.31896551724139,1026.7241379310356,36.6687192118227,0
127,4,0,1,27,0.0,0.03571428571428571,0.9642857142857143,28,800,700,100,0.875,9,7,2,409.4382766288516,0.4150132275132275,0.04404828523463089,0.24307847187234505,131844.07616594018,5196.402265821135,137040.47843176132,118,13,71.14285714285714,28,0,20,32.734681029658645,0.6592261904761905,43.24712643678162,1027.0114942528749,36.67898193760267,0
128,4,0,0,27,0.0,0.0,1.0,27,1100,900,200,0.8181818181818182,13,9,4,424.45226075087965,0.4137583095916429,0.03877054855173956,0.2518611394189012,131824.31452398672,5790.625664328237,137614.94018831494,119,14,73.22222222222223,27,0,20,32.369252040767044,0.6624228395061729,43.26636904761905,1026.934523809524,38.03461199294534,0
129,4,0,0,27,0.0,0.0,1.0,27,750,400,350,0.5333333333333333,11,4,7,422.19718209422274,0.41292735042735046,0.029136160055783566,0.25153335136847355,131977.17645000713,5744.078399589005,137721.25484959612,120,15,74.22222222222223,27,0,20,32.27205527395607,0.663966049382716,43.117559523809526,1027.5297619047622,38.05665784832453,0
130,4,0,0,27,0.0,0.0,1.0,27,1150,900,250,0.782608695652174,14,9,5,419.77268879113984,0.4123931623931624,0.018907056383543175,0.2516087642875599,132206.63542109547,5699.34696534863,137905.9823864441,121,16,75.22222222222223,27,0,21,32.10175203781412,0.6662808641975309,42.894345238095234,1028.4226190476186,38.08972663139328,0
131,4,0,0,27,0.0,0.0,1.0,27,550,400,150,0.7272727272727273,7,4,3,421.38463311941587,0.41162155745489076,0.017401460479719022,0.2530870520203751,132283.16603334018,5748.418677366749,138031.58471070693,122,17,76.22222222222223,27,0,21,31.982767973383492,0.6670524691358024,42.81994047619046,1028.7202380952363,38.10074955908282,0
132,4,0,0,27,0.0,0.0,1.0,27,950,600,350,0.631578947368421,13,6,7,421.30654800649774,0.41096866096866097,0.01709648911384254,0.2535539407715344,132359.7187898597,5752.803243693314,138112.52203355302,123,18,77.22222222222223,27,0,22,31.9072366835382,0.6678240740740741,42.745535714285715,1029.0178571428573,38.111772486772495,0
133,4,0,0,27,0.0,0.0,1.0,27,900,700,200,0.7777777777777778,11,7,4,425.84921403253463,0.40972222222222227,0.020087158566487906,0.2570702323452944,132474.58944515305,5882.839958900223,138357.42940405328,124,19,78.22222222222223,27,0,22,31.674014647778748,0.6689814814814814,42.63392857142857,1029.4642857142856,38.12830687830687,0
134,4,0,0,27,0.0,0.0,1.0,27,750,500,250,0.6666666666666666,10,5,5,426.9007041424003,0.40942545109211775,0.020983550395315076,0.25796733379574355,132512.8907357212,5913.969272604845,138426.86000832604,125,20,79.22222222222223,27,0,22,31.608162306691717,0.6693672839506173,42.596726190476176,1029.6130952380936,38.13381834215161,0
135,4,0,0,27,0.0,0.0,1.0,27,1050,800,250,0.7619047619047619,13,8,5,425.69201269780683,0.4086538461538462,0.022775556946919684,0.2577615415469395,132589.50992506358,5888.459068523218,138477.9689935868,126,21,80.22222222222223,27,0,23,31.561702306988405,0.6701388888888888,42.522321428571416,1029.9107142857129,38.144841269841216,0
136,4,0,0,27,0.0,0.0,1.0,27,1050,500,550,0.47619047619047616,16,5,11,428.675101641719,0.4077041785375119,0.026951583405524948,0.26089663918897577,132781.15477962012,5983.99500425169,138765.1497838718,127,22,81.22222222222223,27,0,20,31.290908653383376,0.6720679012345678,42.33630952380952,1030.6547619047615,38.17239858906524,0
137,4,0,1,26,0.0,0.037037037037037035,0.962962962962963,27,750,400,350,0.5333333333333333,11,4,7,445.3222902095831,0.4075261158594492,-0.07420334819985785,0.25774714372736474,130870.93431122447,6255.948837868474,137126.88314909293,128,23,82.22222222222223,27,0,19,32.804925344192355,0.6527777777777778,44.19642857142857,1023.2142857142854,37.896825396825385,8
138,4,0,0,26,0.0,0.0,1.0,26,950,600,350,0.631578947368421,13,6,7,457.42949180489444,0.4051602564102564,-0.06879200473587099,0.26382813247963754,130735.62349965707,6760.465963648827,137496.0894633059,129,24,82.42307692307692,26,0,20,32.633544590312354,0.6550480769230769,44.3287037037037,1022.6851851851852,39.33404558404558,0
139,4,1,0,27,0.037037037037037035,0.0,1.0,27,850,500,350,0.5882352941176471,12,5,7,443.6105568560267,0.40823836657169993,-0.06264992846462514,0.2593125886681325,131251.8711911849,6244.943133503409,137496.8143246883,130,0,80.33333333333333,27,0,21,32.460184916255194,0.6566358024691358,43.824404761904766,1024.7023809523816,37.951940035273395,0
140,4,0,0,27,0.0,0.0,1.0,27,600,400,200,0.6666666666666666,8,4,4,444.2809934215751,0.40740740740740744,-0.06232157545846029,0.2604810011643601,131366.2602085105,6272.706517502835,137638.96672601334,131,1,81.33333333333333,27,0,21,32.32644433154304,0.6577932098765432,43.71279761904762,1025.1488095238096,37.96847442680777,0
141,4,0,0,27,0.0,0.0,1.0,27,350,200,150,0.5714285714285714,5,2,3,444.69993954343715,0.40699192782526117,-0.06562382411439038,0.2609865914356288,131404.4009530895,6287.105831916088,137691.5067850056,132,2,82.33333333333333,27,0,21,32.276850507982594,0.658179012345679,43.675595238095234,1025.2976190476186,37.97398589065254,0
142,4,0,0,27,0.0,0.0,1.0,27,700,400,300,0.5714285714285714,10,4,6,447.53202403807825,0.4073480531813865,-0.06619705444600266,0.26343622900892166,131518.8564032383,6371.78000106291,137890.63640430119,133,3,83.33333333333333,27,0,21,32.08765535083901,0.6593364197530864,43.56398809523809,1025.7440476190468,37.99052028218692,0
143,4,0,0,27,0.0,0.0,1.0,27,950,700,250,0.7368421052631579,12,7,5,442.9898077448967,0.4068732193732194,-0.06975720283925513,0.26207064269505137,131709.72620819166,6269.213258219967,137978.93946641163,134,4,84.33333333333333,27,0,19,32.00988209142747,0.6612654320987654,43.3779761904762,1026.4880952380956,38.01807760141095,0
144,4,0,0,27,0.0,0.0,1.0,27,800,400,400,0.5,12,4,8,442.25799499884903,0.40556742640075977,-0.06548126692949297,0.2634850263560873,131977.17645000704,6273.592288477878,138250.7687384849,135,5,85.33333333333333,27,0,19,31.7567282162684,0.663966049382716,43.11755952380952,1027.5297619047615,38.0566578483245,0
145,4,0,0,27,0.0,0.0,1.0,27,1000,900,100,0.9,11,9,2,442.41810199257026,0.40408357075023743,-0.06694435063229376,0.26464646464646463,132130.12695312488,6291.351996527766,138421.47894965264,136,6,86.33333333333333,27,0,19,31.597222222222225,0.6655092592592593,42.96874999999999,1028.124999999999,38.07870370370367,0
146,4,0,0,27,0.0,0.0,1.0,27,950,600,350,0.631578947368421,13,6,7,442.2634617921973,0.4035493827160494,-0.06693466259312852,0.2648215356138717,132168.3784190758,6290.648915816299,138459.0273348921,137,7,87.33333333333333,27,0,19,31.562349252291376,0.6658950617283951,42.931547619047606,1028.273809523808,38.08421516754844,0
147,4,0,0,27,0.0,0.0,1.0,27,950,700,250,0.7368421052631579,12,7,5,441.4401589919303,0.40366809116809116,-0.06722508936370875,0.26459609182942134,132206.63542109545,6272.263632015298,138478.89905311074,138,8,88.33333333333333,27,0,20,31.5446691265133,0.6662808641975309,42.894345238095234,1028.4226190476184,38.08972663139327,0
148,4,0,1,26,0.0,0.037037037037037035,0.962962962962963,27,1150,900,250,0.782608695652174,14,9,5,438.29919075987067,0.40141263057929727,-0.06236013405715635,0.26458584656865486,132474.58944515296,6212.701070011317,138687.29051516426,139,9,89.33333333333333,27,0,21,31.353594487809588,0.6689814814814814,42.63392857142856,1029.4642857142849,38.128306878306844,0
149,4,0,0,26,0.0,0.0,1.0,26,650,400,250,0.6153846153846154,9,4,5,441.9575850111277,0.4000641025641026,-0.08747232982844544,0.2670961057241162,132517.1467764059,6513.391632373093,139030.538408779,137,10,88.42307692307692,26,0,21,31.216276978417262,0.6730769230769231,42.59259259259258,1029.6296296296287,39.601139601139565,0
150,4,0,0,26,0.0,0.0,1.0,26,650,500,150,0.7692307692307693,8,5,3,441.1678469236732,0.39955128205128204,-0.08059980175652948,0.26718277771039856,132596.60541457086,6499.4717840268095,139096.07719859766,138,11,89.42307692307692,26,0,21,31.15604085505943,0.6738782051282051,42.51543209876542,1029.9382716049374,39.61301044634375,0
151,4,0,0,26,0.0,0.0,1.0,26,700,400,300,0.5714285714285714,10,4,6,442.0633758363847,0.39964743589743584,-0.08416594641313746,0.26800844992805306,132636.34366426594,6526.7339677640375,139163.07763202998,139,12,90.42307692307692,26,0,20,31.092696629213492,0.6742788461538461,42.47685185185184,1030.0925925925912,39.618945868945815,0
152,4,0,0,26,0.0,0.0,1.0,26,1150,900,250,0.782608695652174,14,9,5,442.0633758363847,0.39964743589743584,-0.08416594641313746,0.26800844992805306,132636.34366426594,6526.7339677640375,139163.07763202998,140,13,91.42307692307692,26,0,20,31.092696629213492,0.6742788461538461,42.47685185185184,1030.0925925925912,39.618945868945815,0
153,4,0,0,26,0.0,0.0,1.0,26,850,400,450,0.47058823529411764,13,4,9,445.51439695823103,0.39887820512820515,-0.09220058276803311,0.2712480088681882,132795.3562004648,6632.448607300702,139427.8048077655,141,14,92.42307692307692,26,0,20,30.8426286370215,0.6758814102564102,42.322530864197525,1030.7098765432092,39.6426875593542,0
154,4,0,0,26,0.0,0.0,1.0,26,450,200,250,0.4444444444444444,7,2,5,446.1814821528417,0.39836538461538457,-0.08564471002728735,0.27223182486421316,132874.89819101503,6657.263803154999,139532.16199417002,142,15,93.42307692307692,26,0,20,30.744836102379885,0.6766826923076923,42.24537037037037,1031.018518518518,39.65455840455839,0
155,4,0,0,26,0.0,0.0,1.0,26,750,600,150,0.8,9,6,3,448.2918858609633,0.39801282051282055,-0.08858471669007473,0.2738104553311662,132914.6781169029,6716.914342325869,139631.5924592288,143,16,94.42307692307692,26,0,20,30.650129701686115,0.6770833333333333,42.20679012345679,1031.172839506173,39.6604938271605,0
156,4,0,0,26,0.0,0.0,1.0,26,500,200,300,0.4,8,2,6,451.60393808574656,0.39766025641025643,-0.09553535469765828,0.27671607022027656,133034.05361701726,6815.74050259107,139849.79411960833,144,17,95.42307692307692,26,0,20,30.44377960608326,0.6782852564102564,42.09104938271605,1031.635802469136,39.67830009496677,0
157,4,0,0,26,0.0,0.0,1.0,26,550,300,250,0.5454545454545454,8,3,5,450.9473172183695,0.3965705128205128,-0.0886472624400566,0.2774964677896665,133193.30430288834,6812.632649367488,140005.93695225584,145,18,96.42307692307692,26,0,20,30.2994343947775,0.6798878205128205,41.936728395061735,1032.2530864197536,39.70204178537514,0
158,4,0,0,26,0.0,0.0,1.0,26,850,600,250,0.7058823529411765,11,6,5,452.6957156613717,0.3955448717948718,-0.08983553425507695,0.2797684602882328,133352.6502486283,6873.634687928678,140226.284936557,146,19,97.42307692307692,26,0,20,30.093007619901385,0.6814903846153846,41.78240740740741,1032.8703703703707,39.72578347578349,0
159,4,0,0,26,0.0,0.0,1.0,26,1000,700,300,0.7,13,7,6,449.10199612810607,0.39516025641025637,-0.08701671741253503,0.27814411323567734,133432.35894394916,6784.947749961911,140217.3066939111,147,20,98.42307692307692,26,0,21,30.10517799352751,0.6822916666666667,41.705246913580254,1033.1790123456797,39.73765432098768,0
160,4,0,2,24,0.0,0.07692307692307693,0.9230769230769231,26,500,300,200,0.6,7,3,4,449.10199612810607,0.39516025641025637,-0.08701671741253503,0.27814411323567734,133432.35894394916,6784.947749961911,140217.3066939111,148,21,99.42307692307692,26,0,21,30.10517799352751,0.6822916666666667,41.705246913580254,1033.1790123456797,39.73765432098768,0
161,4,0,0,24,0.0,0.0,1.0,24,1300,900,400,0.6923076923076923,17,9,8,473.2431217402015,0.39390851449275366,-0.09068944166262827,0.29037147340868086,133085.00347222234,7796.3125000000255,140881.31597222236,149,22,98.70833333333333,24,0,21,29.833965972110057,0.6870659722222222,42.04166666666668,1031.8333333333344,42.9930555555556,0
162,4,0,1,23,0.0,0.041666666666666664,0.9583333333333334,24,850,700,150,0.8235294117647058,10,7,3,472.4643855435497,0.393455615942029,-0.09063088512241035,0.2912355092977409,133257.03125000026,7791.840277777823,141048.87152777807,150,23,99.70833333333333,24,0,21,29.67951304815712,0.6888020833333333,41.87500000000002,1032.500000000002,43.02083333333342,0
163,4,0,0,23,0.0,0.0,1.0,23,800,500,300,0.625,11,5,6,479.17858908269193,0.3906455862977602,-0.08067226890756285,0.2963734516675693,133382.53821855708,8182.811294367284,141565.34951292435,151,24,101.82608695652173,23,0,21,29.378851540616246,0.6947463768115942,41.75347222222222,1032.986111111111,44.912439613526566,0
164,4,0,0,23,0.0,0.0,1.0,23,650,400,250,0.6153846153846154,9,4,5,480.5048133216891,0.3904808959156785,-0.08063161431211163,0.2982737386552674,133517.07552686144,8231.119490258481,141748.19501711993,152,25,102.82608695652173,23,0,21,29.20813735371521,0.6961050724637681,41.623263888888886,1033.5069444444441,44.935084541062785,0
165,4,0,0,23,0.0,0.0,1.0,23,700,500,200,0.7142857142857143,9,5,4,479.9091422444152,0.39031620553359686,-0.0767495345526229,0.29862684870067824,133606.8047417534,8223.825412326378,141830.6301540798,153,26,103.82608695652173,23,0,21,29.132556675062972,0.6970108695652174,41.53645833333333,1033.854166666666,44.95018115942026,0
166,4,0,0,23,0.0,0.0,1.0,23,700,500,200,0.7142857142857143,9,5,4,480.6961925827215,0.3893280632411067,-0.0739086650028461,0.3002083768771336,133741.455078125,8257.801649305557,141999.25672743056,154,27,104.82608695652173,23,0,21,28.97574689493118,0.6983695652173914,41.40625,1034.375,44.97282608695652,0
167,4,0,0,23,0.0,0.0,1.0,23,550,400,150,0.7272727272727273,7,4,3,480.17299845639286,0.38899868247694336,-0.07774867390939555,0.30024668392462156,133786.35359399102,8248.118911554766,142034.4725055458,155,28,105.82608695652173,23,0,21,28.943789506069244,0.698822463768116,41.362847222222214,1034.5486111111104,44.98037439613523,0
168,4,0,0,23,0.0,0.0,1.0,23,600,400,200,0.6666666666666666,8,4,4,480.3821720904044,0.38866930171277997,-0.07807268987549498,0.30111021323143017,133876.17323133684,8262.345377604177,142138.51860894103,156,29,106.82608695652173,23,0,21,28.84740395906727,0.6997282608695652,41.27604166666667,1034.8958333333337,44.99547101449277,0
169,4,0,0,23,0.0,0.0,1.0,23,750,600,150,0.8,9,6,3,479.01189461577013,0.38644598155467724,-0.07102299646488563,0.3017218533667444,134055.90292848187,8242.874409239974,142298.77733772184,157,30,107.82608695652173,23,0,21,28.700929030455438,0.7015398550724637,41.10243055555556,1035.5902777777778,45.02566425120773,0
170,4,0,0,23,0.0,0.0,1.0,23,400,300,100,0.75,5,3,2,479.0392849681552,0.3856225296442688,-0.06891224183416145,0.3021087076236801,134100.85419077933,8247.915461033954,142348.7696518133,158,31,108.82608695652173,23,0,21,28.654737959548555,0.7019927536231885,41.05902777777778,1035.763888888889,45.033212560386474,0
171,4,0,0,23,0.0,0.0,1.0,23,750,600,150,0.8,9,6,3,481.6236431929629,0.3848814229249012,-0.06957687180869299,0.30485806216530187,134235.75318889855,8330.222499517746,142565.9756884163,159,32,109.82608695652173,23,0,21,28.45133886189757,0.7033514492753623,40.92881944444444,1036.2847222222224,45.055857487922715,0
172,4,0,0,23,0.0,0.0,1.0,23,550,400,150,0.7272727272727273,7,4,3,481.55012387371875,0.38356389986824774,-0.06780598982036345,0.3055617204728986,134325.72353033375,8336.913761091833,142662.63729142558,160,33,110.82608695652173,23,0,21,28.36225785742199,0.7042572463768115,40.84201388888889,1036.6319444444448,45.07095410628021,0
173,4,0,0,23,0.0,0.0,1.0,23,1000,700,300,0.7,13,7,6,487.14499803803324,0.38241106719367585,-0.06881995895256243,0.31025631324938263,134460.73555652,8500.37495177468,142961.1105082947,161,34,111.82608695652173,23,0,21,28.080710858163158,0.7056159420289856,40.71180555555555,1037.1527777777771,45.093599033816396,0
174,4,0,0,23,0.0,0.0,1.0,23,600,300,300,0.5,9,3,6,491.12111094982356,0.38224637681159424,-0.06949537279552986,0.31356194006796406,134550.7812499999,8616.145833333318,143166.92708333323,162,35,112.82608695652173,23,0,21,27.886546184738958,0.7065217391304348,40.62499999999999,1037.4999999999993,45.108695652173886,0
175,4,0,0,23,0.0,0.0,1.0,23,650,600,50,0.9230769230769231,7,6,1,493.225202552328,0.3815052700922266,-0.06839048290601402,0.3168614324882356,134776.02734977813,8694.986677758483,143471.0140275366,163,36,113.82608695652173,23,0,21,27.60425374797971,0.708786231884058,40.40798611111111,1038.3680555555552,45.146437198067616,0
176,4,0,0,23,0.0,0.0,1.0,23,850,700,150,0.8235294117647058,10,7,3,496.51698167725084,0.3805171277997365,-0.0655551923286477,0.32056678914113756,134956.35986328116,8801.624891493037,143757.9847547742,164,37,114.82608695652173,23,0,20,27.33657059314954,0.7105978260869565,40.23437499999999,1039.0624999999993,45.17663043478258,0
177,4,0,0,23,0.0,0.0,1.0,23,700,400,300,0.5714285714285714,10,4,6,496.51698167725084,0.3805171277997365,-0.0655551923286477,0.32056678914113756,134956.35986328116,8801.624891493037,143757.9847547742,165,38,115.82608695652173,23,0,20,27.33657059314954,0.7105978260869565,40.23437499999999,1039.0624999999993,45.17663043478258,0
178,4,0,0,23,0.0,0.0,1.0,23,250,200,50,0.8,3,2,1,473.79029014650973,0.3797760210803689,-0.08383198231392774,0.27622161184430877,131150.2338927468,7827.541473765411,138977.7753665122,166,39,116.82608695652173,23,0,20,31.7909604519774,0.6721014492753623,43.9236111111111,1024.3055555555545,44.53502415458933,8
179,4,0,0,23,0.0,0.0,1.0,23,400,300,100,0.75,5,3,2,473.05929067804755,0.38002305665349145,-0.08627878537857481,0.2764352409486966,131239.16437596446,7816.781201774678,139055.94557773916,167,40,117.82608695652173,23,0,21,31.71876764938438,0.6730072463768115,43.83680555555555,1024.6527777777774,44.55012077294684,0
180,4,0,0,23,0.0,0.0,1.0,23,350,200,150,0.5714285714285714,5,2,3,473.9242514376362,0.38027009222661395,-0.08907741251325574,0.2775842044134726,131328.12500000003,7847.916666666667,139176.0416666667,168,41,118.82608695652173,23,0,21,31.605691056910562,0.6739130434782609,43.75,1025.0000000000002,44.56521739130436,0
181,4,0,0,23,0.0,0.0,1.0,23,600,300,300,0.5,9,3,6,472.5176571469953,0.38002305665349145,-0.08800206162794977,0.2770821018324732,131372.61661482434,7815.176203221433,139187.79281804577,169,42,119.82608695652173,23,0,22,31.596281399943557,0.6743659420289856,43.706597222222214,1025.1736111111102,44.57276570048305,0
182,4,0,0,23,0.0,0.0,1.0,23,300,0,300,0.0,6,0,6,472.5176571469953,0.38002305665349145,-0.08800206162794977,0.2770821018324732,131372.61661482434,7815.176203221433,139187.79281804577,170,43,120.82608695652173,23,0,22,31.596281399943557,0.6743659420289856,43.706597222222214,1025.1736111111102,44.57276570048305,0
183,4,0,0,23,0.0,0.0,1.0,23,850,600,250,0.7058823529411765,11,6,5,472.30549907517775,0.3799407114624506,-0.08231942941683024,0.27760284408329094,131461.62245008675,7818.00944010416,139279.6318901909,171,44,121.82608695652173,23,0,22,31.510813441679367,0.6752717391304348,43.619791666666664,1025.520833333333,44.587862318840564,0
184,4,1,0,24,0.041666666666666664,0.0,1.0,24,400,300,100,0.75,5,3,2,455.3539694652928,0.3867376207729469,-0.08977844505762078,0.27001307082537707,131798.33680555553,7202.97916666666,139001.3159722222,172,0,117.70833333333333,24,0,19,31.602350808851376,0.6740451388888888,43.291666666666664,1026.8333333333333,42.78472222222222,0
185,4,0,0,24,0.0,0.0,1.0,24,650,600,50,0.9230769230769231,7,6,1,454.2783554406445,0.3862469806763285,-0.08891864113383108,0.2696785381719896,131841.125,7178.51388888889,139019.63888888888,173,1,118.70833333333333,24,0,20,31.586403224061446,0.6744791666666667,43.25,1027.0,42.791666666666664,0
186,4,0,0,24,0.0,0.0,1.0,24,750,500,250,0.6666666666666666,10,5,5,454.5061183196956,0.38658665458937197,-0.09008734923468042,0.27011776347196537,131883.92013888876,7188.409722222198,139072.32986111095,174,2,119.70833333333333,24,0,20,31.536994969982157,0.6749131944444444,43.20833333333332,1027.1666666666656,42.798611111111065,0
187,4,0,0,24,0.0,0.0,1.0,24,450,100,350,0.2222222222222222,8,1,7,453.7330487758147,0.38692632850241543,-0.08753785420722482,0.26996240469634364,131926.72222222216,7171.902777777775,139098.62499999994,175,3,120.70833333333333,24,0,20,31.513289530607842,0.6753472222222222,43.166666666666664,1027.333333333333,42.80555555555554,0
188,4,0,0,24,0.0,0.0,1.0,24,600,400,200,0.6666666666666666,8,4,4,454.92008427345064,0.3868131038647343,-0.09073398215733997,0.2709741371541857,131969.53125,7207.118055555554,139176.64930555556,176,4,121.70833333333333,24,0,20,31.439240335225744,0.67578125,43.125,1027.5,42.8125,0
189,4,0,0,24,0.0,0.0,1.0,24,750,400,350,0.5333333333333333,11,4,7,453.4236615108642,0.3861714975845411,-0.05261637504126804,0.24052894408343412,127428.34722222234,6755.805555555575,134184.1527777779,177,5,122.70833333333333,24,0,19,36.13816441069659,0.6293402777777778,47.58333333333334,1009.6666666666677,42.069444444444485,8
190,4,1,0,25,0.04,0.0,1.0,25,700,600,100,0.8571428571428571,8,6,2,459.51385391252006,0.3956944444444444,-0.006317135549872344,0.23333755438934478,125641.84746877062,6546.833908612767,132188.6813773834,178,0,118.76,25,0,20,37.841671994884905,0.6066666666666667,49.358974358974365,1002.5641025641032,40.10256410256413,8
191,4,2,1,26,0.07407407407407407,0.037037037037037035,0.962962962962963,27,550,300,250,0.5454545454545454,8,3,5,430.04592629948684,0.40343067426400764,-0.010127914241557567,0.2225306561969321,126417.68751771547,5473.082305839005,131890.76982355447,179,0,110.88888888888889,27,0,18,37.77436618328894,0.6072530864197531,48.586309523809526,1005.6547619047623,37.24647266313934,0
192,4,0,0,26,0.0,0.0,1.0,26,800,500,300,0.625,11,5,6,445.5131193304255,0.4023076923076923,-0.002231879265959691,0.22995819804424647,126315.16965782645,6055.013050602029,132370.18270842847,180,1,116.15384615384616,26,0,20,37.492004400777816,0.609775641025641,48.688271604938265,1005.2469135802462,38.66334283000947,0
193,4,1,0,27,0.037037037037037035,0.0,1.0,27,1100,800,300,0.7272727272727273,14,8,6,433.01393290075947,0.40788224121557454,-0.004290342351808141,0.22612949829261877,126792.09183673462,5580.548469387743,132372.64030612237,181,0,112.81481481481481,27,0,21,37.311613475177296,0.6111111111111112,48.21428571428571,1007.1428571428565,37.30158730158728,0
194,4,3,1,29,0.1,0.03333333333333333,0.9666666666666667,30,600,300,300,0.5,9,3,6,398.4295296541889,0.4194204980842912,-0.0015109220612345986,0.21333703570024629,127804.53529671051,4184.220177188099,131988.7554738986,182,0,102.43333333333334,30,0,16,37.13916212503878,0.6121527777777778,47.21102150537634,1011.1559139784938,33.70519713261646,0
195,4,1,0,30,0.03333333333333333,0.0,1.0,30,500,300,200,0.6,7,3,4,395.89794326083637,0.4198515325670498,-0.007587099159042321,0.20028104927655482,125486.5837191358,3936.4277220552212,129423.01144119102,183,0,103.4,29,1,20,39.597195268459515,0.5912356321839081,49.51388888888889,1001.9444444444445,34.54980842911878,8
196,4,4,0,34,0.11764705882352941,0.0,1.0,34,1100,800,300,0.7272727272727273,14,8,6,353.91856585117944,0.43605169340463457,0.01707606774615944,0.18520461679583383,126875.85791822872,2180.744335111513,129056.60225334023,184,0,92.11764705882354,33,1,21,39.21702043547015,0.5950126262626263,48.1311274509804,1007.4754901960796,30.52956030897211,0
197,4,0,0,34,0.0,0.0,1.0,34,900,500,400,0.5555555555555556,13,5,8,355.74109926073936,0.43577317290552586,0.012864518528052926,0.1868663015656988,127030.23626730115,2237.975177816236,129268.21144511738,185,1,93.11764705882354,33,1,22,39.01248075208687,0.5965909090909092,47.977941176470594,1008.0882352941186,30.548128342246017,0
198,4,1,2,33,0.02857142857142857,0.05714285714285714,0.9428571428571428,35,700,400,300,0.5714285714285714,10,4,6,367.7042457552441,0.43890056022408963,0.13840504594409442,0.18000019399373168,124113.09840265731,2132.248564254094,126245.34696691141,186,0,91.42857142857143,33,2,15,41.728544049522405,0.5666035353535354,50.88848039215684,996.44607843137,30.195335710041515,8
199,4,5,5,33,0.13157894736842105,0.13157894736842105,0.868421052631579,38,1100,900,200,0.8181818181818182,13,9,4,337.6234050713022,0.4504356330014225,0.1184180884741699,0.16858383522064233,124943.70003449396,836.783489570647,125780.4835240646,187,0,82.13157894736842,36,2,15,41.61762221220994,0.5688657407407407,50.056306306306304,999.7747747747749,27.771521521521525,0
200,4,0,0,33,0.0,0.0,1.0,33,900,700,200,0.7777777777777778,11,7,4,380.4541615767223,0.4354482323232323,0.14447705390065924,0.18599711119638976,124057.77189466682,2839.659118652339,126897.43101331916,188,2,95.57575757575758,31,2,17,41.468571646407895,0.5709005376344086,50.944010416666664,996.2239583333328,32.13625672043009,0
201,4,3,0,36,0.08333333333333333,0.0,1.0,36,800,500,300,0.625,11,5,6,362.789933592068,0.4444940476190476,0.172469400163904,0.18217516020160815,125178.63520408151,1882.7097505668748,127061.34495464839,189,0,88.52777777777777,34,2,19,40.74520183995558,0.5753676470588236,49.82142857142856,1000.7142857142846,29.432773109243666,0
202,4,3,1,38,0.07692307692307693,0.02564102564102564,0.9743589743589743,39,750,500,250,0.6666666666666666,10,5,5,341.7860144085692,0.44823999100314893,0.18982648340446562,0.17502196576760942,125988.78981994448,812.2412665435379,126801.03108648802,190,0,82.64102564102564,37,2,17,40.43477865152177,0.5777027027027026,49.013157894736835,1003.9473684210516,27.133712660028422,0
203,4,3,3,38,0.07317073170731707,0.07317073170731707,0.926829268292683,41,750,300,450,0.4,12,3,9,328.61029157582755,0.4505335365853658,0.19342753656982148,0.17016156682589859,126446.46819526608,110.33417940611699,126556.80237467219,191,0,79.51219512195122,38,3,15,40.2950393031655,0.580592105263158,48.5576923076923,1005.7692307692291,26.467611336032345,0
204,4,0,2,36,0.0,0.05263157894736842,0.9473684210526316,38,1250,1000,250,0.8,15,10,5,311.80521398417545,0.44636083451872927,0.07670528040472613,0.15956270173421588,125961.27083573774,255.07620133116433,126216.3470370689,192,1,86.44736842105263,37,1,20,41.215524303659244,0.5774211711711712,49.04057017543859,1003.8377192982441,27.130749170222813,7
205,4,1,0,37,0.02702702702702703,0.0,1.0,37,850,500,350,0.5882352941176471,12,5,7,318.82605362731283,0.4476976976976977,0.08414000090949081,0.16325871729393993,125987.30223043989,633.6068754565399,126620.90910589643,193,0,89.35135135135135,36,1,22,41.012572443447375,0.5795717592592593,49.01463963963964,1003.9414414414414,27.88726226226226,0
206,4,0,0,37,0.0,0.0,1.0,37,1350,1100,250,0.8148148148148148,16,11,5,322.8790872194825,0.4478853853853854,0.08917131857846883,0.16624639903401264,126213.51662050544,750.3410082379434,126963.85762874338,194,1,90.35135135135135,36,1,22,40.67834995703986,0.5818865740740741,48.7894144144144,1004.8423423423408,27.912287287287242,0
207,4,6,5,38,0.13953488372093023,0.11627906976744186,0.8837209302325582,43,1300,1000,300,0.7692307692307693,16,10,6,285.4030678313282,0.455749354005168,0.11871287083502735,0.15220500779737692,127642.79120212856,-1311.0244063470032,126331.76679578156,195,0,78.6046511627907,41,2,15,40.1609234897572,0.5879065040650406,47.371031746031726,1010.5158730158694,24.646728610143157,0
208,4,0,1,37,0.0,0.02631578947368421,0.9736842105263158,38,1250,700,550,0.56,18,7,11,316.94777438767176,0.4462274774774775,0.12183575100465993,0.16651530501258566,127036.7384676052,452.80230455522434,127489.54077216043,196,1,89.57894736842105,37,1,20,39.98350373431948,0.5884009009009009,47.971491228070164,1008.1140350877175,27.246325272641013,0
209,4,0,0,37,0.0,0.0,1.0,37,1000,500,500,0.5,15,5,10,324.2434479272233,0.4441941941941942,0.12735792092360443,0.17034198038993578,127035.2447041638,838.0691502313323,127873.31385439512,197,2,92.67567567567568,36,1,20,39.8011617515639,0.5902777777777778,47.97297297297298,1008.1081081081095,28.00300300300304,0
210,4,2,0,39,0.05128205128205128,0.0,1.0,39,950,500,450,0.5263157894736842,14,5,9,316.13627795472075,0.44767768780926676,0.1478059545304209,0.16854661312828353,127631.22420374032,269.7720341149926,127900.99623785532,198,0,88.87179487179488,38,1,18,39.3963223373511,0.5926535087719298,47.38247863247864,1010.4700854700862,26.59131803868648,0
211,4,0,0,39,0.0,0.0,1.0,39,1050,900,150,0.8571428571428571,12,9,3,318.5414621808666,0.4471434997750787,0.15467538168869832,0.17028470707092416,127739.20323800124,338.04651545035347,128077.24975345159,199,1,89.87179487179488,38,1,19,39.22532234199958,0.59375,47.27564102564102,1010.8974358974352,26.602564102564084,0
212,4,1,0,40,0.025,0.0,1.0,40,1100,600,500,0.5454545454545454,16,6,10,314.10892097664055,0.44858440170940167,0.17035462912831623,0.1697364473504547,128172.28768707656,53.295902750431594,128225.58358982699,200,0,88.6,37,3,20,38.89584461288577,0.5999436936936937,46.84758771929823,1012.6096491228052,27.36782835467041,0
213,4,0,1,39,0.0,0.025,0.975,40,850,600,250,0.7058823529411765,11,6,5,315.89980876208904,0.4482104700854701,0.17522729732655073,0.17117878786820742,128283.34349270911,104.93673534162497,128388.28022805075,201,1,89.6,37,3,20,38.73739492008514,0.6010698198198199,46.73793859649122,1013.0482456140337,27.379682313892804,0
214,4,3,1,41,0.07142857142857142,0.023809523809523808,0.9761904761904762,42,1100,700,400,0.6363636363636364,15,7,8,303.2005259697566,0.4499249903213318,0.1779975579975579,0.16701723888164563,128936.76757812503,-581.2608506944432,128355.50672743059,202,0,86.0,39,3,20,38.39529914529915,0.6041666666666667,46.09375,1015.6250000000002,26.04166666666667,0
215,4,1,0,42,0.023809523809523808,0.0,1.0,42,1650,1300,350,0.7878787878787878,20,13,7,298.15378168839794,0.4494410569105691,0.173213155778847,0.16588222350856993,129330.57089240855,-687.9202401017966,128642.65065230675,203,0,84.26190476190476,40,2,22,38.1244380057948,0.6065104166666666,45.70630081300813,1017.1747967479669,25.429369918699173,0
216,4,0,0,42,0.0,0.0,1.0,42,1150,800,350,0.6956521739130435,15,8,7,300.42907667550446,0.44886033681765386,0.17828965202379798,0.16758754009759463,129433.96297053661,-622.8548028620582,128811.10816767455,204,1,85.26190476190476,40,2,13,37.96189953061022,0.6075520833333333,45.604674796747965,1017.5813008130073,25.43953252032518,0
217,4,0,1,41,0.0,0.023809523809523808,0.9761904761904762,42,1100,800,300,0.7272727272727273,14,8,6,301.896579149777,0.4487877468060395,0.17712507784385578,0.16884969477070438,129537.3963600535,-578.6206333862169,128958.77572666729,205,2,86.26190476190476,40,2,13,37.81987288276596,0.60859375,45.5030487804878,1017.9878048780486,25.449695121951216,0
218,4,0,0,41,0.0,0.0,1.0,41,650,400,250,0.6153846153846154,9,4,5,309.98673219217267,0.44677337398373984,0.17854726904653173,0.17317783649226515,129492.7856445311,-171.7909071180689,129320.99473741304,206,3,89.0,39,2,14,37.659165728516356,0.609775641025641,45.54687499999999,1017.8124999999989,26.09775641025638,0
219,4,0,0,41,0.0,0.0,1.0,41,1350,900,450,0.6666666666666666,18,9,9,309.18695333764447,0.44593495934959354,0.1813542708491822,0.1736668131354868,129704.91672092005,-179.3863932291705,129525.53032769088,207,4,90.0,39,2,15,37.464741623206216,0.6119123931623931,45.338541666666664,1018.6458333333326,26.11912393162391,0
220,4,1,3,39,0.023809523809523808,0.07142857142857142,0.9285714285714286,42,1050,600,450,0.5714285714285714,15,6,9,306.37175068670115,0.44532762291908634,0.19047619047619047,0.17374913183011897,130081.09941998811,-429.36516788948495,129651.73425209863,208,0,88.83333333333333,40,2,18,37.15609849239555,0.6140625,44.96951219512195,1020.1219512195122,25.503048780487806,0
221,4,0,0,39,0.0,0.0,1.0,39,1300,1000,300,0.7692307692307693,16,10,6,328.07658047599324,0.44011470985155193,0.2011430968486183,0.1844016641985757,129731.44531250013,712.3697916666827,130443.81510416682,209,1,96.2051282051282,37,2,18,36.95679959100205,0.6157094594594594,45.31250000000001,1018.750000000001,27.53378378378381,0
222,4,1,0,40,0.025,0.0,1.0,40,1250,800,450,0.64,17,8,9,320.112354502262,0.43965010683760686,0.2028592375366567,0.18149838246957278,130071.79578493716,327.5177606107511,130399.3135455479,210,0,94.775,38,2,20,36.815083438067326,0.6173245614035088,44.9786324786325,1020.0854700854729,26.8443544759335,0
223,4,1,1,40,0.024390243902439025,0.024390243902439025,0.975609756097561,41,850,400,450,0.47058823529411764,13,4,9,312.1819126811442,0.4407774390243902,0.20228750283014363,0.17823641758959033,130342.35161675386,-61.89507378468227,130280.45654296919,211,0,93.4390243902439,39,2,21,36.74396018225711,0.6183226495726496,44.713541666666686,1021.1458333333364,26.183226495726576,0
224,4,0,0,40,0.0,0.0,1.0,40,1400,1000,400,0.7142857142857143,18,10,8,315.01598526825387,0.4417601495726496,0.19551161330822353,0.17986396578219696,130344.39718934949,212.11374095993423,130556.51093030942,212,1,91.9,38,2,21,36.66954383762292,0.6200657894736843,44.71153846153848,1021.1538461538491,26.87246963562761,0
225,4,0,0,40,0.0,0.0,1.0,40,950,600,350,0.631578947368421,13,6,7,313.2538850911133,0.44137286324786323,0.19622685911515547,0.179235212169727,130426.23325525991,171.30485700199966,130597.53811226191,213,2,92.9,38,2,21,36.63188996966846,0.6208881578947368,44.63141025641027,1021.4743589743607,26.880904183535808,0
226,4,0,0,40,0.0,0.0,1.0,40,1000,600,400,0.6,14,6,8,344.0957909237085,0.4407986111111111,0.21069424964936956,0.1904133663326478,129117.7949585448,920.9367739288303,130038.73173247362,214,3,93.9,37,3,22,37.1726318912504,0.6095157657657657,45.91557017543859,1016.3377192982445,27.46858700806066,8
227,4,1,2,39,0.024390243902439025,0.04878048780487805,0.9512195121951219,41,1550,1300,250,0.8387096774193549,18,13,5,333.93332179721654,0.44197154471544714,0.20402139417208565,0.1862907211447416,129436.83556241434,444.73564723381776,129881.57120964816,215,0,92.58536585365853,35,6,19,37.10664998483469,0.6166666666666667,45.601851851851855,1017.5925925925932,29.07407407407409,0
228,4,0,0,39,0.0,0.0,1.0,39,1100,700,400,0.6363636363636364,15,7,8,347.3528621338349,0.43845591542959966,0.20996216897856246,0.1926229508196723,129201.38888888902,1175.6944444444625,130377.08333333349,216,5,97.53846153846153,33,6,23,37.00478142076504,0.6186868686868687,45.83333333333334,1016.6666666666678,30.80808080808084,0
229,4,1,1,39,0.025,0.025,0.975,40,1500,1100,400,0.7333333333333333,19,11,8,341.7390063721766,0.4396233974358974,0.2039138314041855,0.19141412714480888,129595.04145408182,857.5361394558067,130452.57759353763,217,0,96.075,34,6,20,36.74734011457968,0.6204044117647058,45.446428571428584,1018.2142857142873,29.947478991596682,0
230,4,0,0,39,0.0,0.0,1.0,39,1500,1200,300,0.8,18,12,6,349.96916063375653,0.43735942420152946,0.20641684947435324,0.19647874923769193,129685.96938775528,1277.2179705215653,130963.18735827685,218,7,99.53846153846153,34,5,21,36.44542815957614,0.6213235294117647,45.35714285714287,1018.5714285714299,29.95798319327735,0
231,4,1,1,39,0.025,0.025,0.975,40,1250,800,450,0.64,17,8,9,355.82186402352374,0.43838141025641025,0.2101233671988394,0.19304036560016352,128330.72015570926,1235.0376547677822,129565.75781047705,219,0,98.025,33,7,19,37.67789469440414,0.6098484848484849,46.69117647058823,1013.2352941176464,30.704099821746862,8
232,4,2,1,40,0.04878048780487805,0.024390243902439025,0.975609756097561,41,1150,800,350,0.6956521739130435,15,8,7,344.11468769618455,0.4420731707317073,0.2050497103211506,0.18865451528038382,128747.91843820848,660.8099489795765,129408.72838718805,220,0,96.0,34,7,16,37.548875855327466,0.6118259803921569,46.2797619047619,1014.8809523809513,29.84943977591033,0
233,4,0,0,40,0.0,0.0,1.0,40,800,600,200,0.75,10,6,4,351.31850019038245,0.4405048076923077,0.21269026334863517,0.19208814693368453,128641.33536380234,1038.8162004998026,129680.15156430214,221,1,99.4,33,7,17,37.474832890392214,0.6130050505050505,46.384803921568626,1014.4607843137251,30.7412358882947,0
234,4,0,0,40,0.0,0.0,1.0,40,700,300,400,0.42857142857142855,11,3,8,350.8823864777815,0.43977029914529914,0.20812205722564303,0.1926016439493347,128796.78376405698,1038.5045715590052,129835.28833561599,222,2,100.4,33,7,19,37.32733208579823,0.6145833333333333,46.23161764705882,1015.0735294117637,30.759803921568597,0
235,4,0,0,40,0.0,0.0,1.0,40,1250,1000,250,0.8,15,10,5,352.52299183180395,0.43971688034188033,0.2117954133977067,0.19380577221808182,128858.98940611772,1085.15129397346,129944.14070009117,223,3,101.4,33,7,19,37.2222641319654,0.6152146464646464,46.170343137254896,1015.3186274509794,30.767231134878163,0
236,4,1,0,41,0.024390243902439025,0.0,1.0,41,1000,900,100,0.9,11,9,2,344.7879462001438,0.44108231707317075,0.21134783378754363,0.19090787838241424,129140.88010204077,705.243764172328,129846.12386621309,224,0,99.90243902439025,34,7,20,37.13154915280706,0.6158088235294117,45.89285714285714,1016.4285714285711,29.89495798319327,0
237,4,0,0,41,0.0,0.0,1.0,41,1000,800,200,0.8,12,8,4,346.6809997312554,0.4407774390243902,0.21531387445022032,0.1922503725782414,129201.38888888876,758.3475056689256,129959.73639455768,225,1,100.90243902439025,33,8,20,37.021857923497286,0.6186868686868687,45.83333333333333,1016.6666666666656,30.808080808080774,0
238,4,0,2,39,0.0,0.04878048780487805,0.9512195121951219,41,1000,800,200,0.8,12,8,4,349.019875691551,0.44059959349593497,0.0780084660350735,0.18361480416816386,127092.01388888898,671.5277777777881,127763.54166666676,226,2,101.90243902439025,37,4,19,39.118457300275466,0.5889639639639639,47.91666666666667,1008.3333333333342,27.252252252252276,8
239,4,3,2,40,0.07142857142857142,0.047619047619047616,0.9523809523809523,42,1400,1000,400,0.7142857142857143,18,10,8,337.0659028312786,0.44175861401471156,0.09880990137888346,0.17982551465770275,127658.21468195284,205.84627712033586,127864.06095907318,227,0,100.21428571428571,38,4,17,38.83999365683477,0.5929276315789473,47.35576923076924,1010.5769230769245,26.594129554655908,0
240,4,1,0,41,0.024390243902439025,0.0,1.0,41,950,500,450,0.5263157894736842,14,5,9,360.0673767605524,0.4398882113821138,0.0946227868010876,0.18654998893417976,126468.2503449397,908.3427852528848,127376.59313019259,228,0,103.63414634146342,36,5,18,39.48163905060456,0.5844907407407407,48.536036036036045,1005.8558558558573,27.94044044044048,8
241,4,1,0,42,0.023809523809523808,0.0,1.0,42,1500,1200,300,0.8,18,12,6,346.87149148725996,0.44298054587688734,0.16747007935644054,0.18137213388124396,126843.369173688,455.75093800634147,127299.12011169434,229,0,102.14285714285714,37,5,19,39.427882696563984,0.5864301801801801,48.16337719298245,1007.3464912280698,27.225580844001886,8
242,4,1,0,43,0.023255813953488372,0.0,1.0,43,1550,1100,450,0.7096774193548387,20,11,9,352.2488329157632,0.4431293835363603,0.11751845443774056,0.17863775948192903,125588.29740119787,325.8212948152625,125914.11869601313,230,0,100.74418604651163,38,5,15,40.58547395722304,0.5718201754385965,49.41239316239315,1002.3504273504259,26.377642825011208,8
243,4,5,2,46,0.10416666666666667,0.041666666666666664,0.9583333333333334,48,1300,1000,300,0.7692307692307693,16,10,6,323.06607818212194,0.4521738327423168,0.1538427618497853,0.16874114656406905,126799.06274412587,-1406.2801351038277,125392.78260902205,231,0,91.14583333333333,42,6,17,40.07279840933872,0.5778769841269842,48.20736434108527,1007.1705426356583,23.980251015134723,0
244,4,5,2,49,0.09803921568627451,0.0392156862745098,0.9607843137254902,51,2050,1700,350,0.8292682926829268,24,17,7,309.94659858405464,0.4565196078431373,0.17224741833825963,0.1652414688156707,127629.96890210907,-2287.2909906255845,125342.6779114835,232,0,86.68627450980392,42,9,15,39.553965285769074,0.5863095238095238,47.38372093023255,1010.4651162790684,24.058693244739725,0
245,4,1,5,45,0.02,0.1,0.9,50,1050,700,350,0.6666666666666666,14,7,7,314.7349447541527,0.45408163265306123,0.06460949012673178,0.1671198227779094,127467.41470025528,-1913.8795372743696,125553.53516298092,233,0,89.4,41,9,13,39.59899056881815,0.5861280487804879,47.54464285714287,1009.82142857143,24.629790940766586,8
246,4,2,1,46,0.0425531914893617,0.02127659574468085,0.9787234042553191,47,1300,800,500,0.6153846153846154,18,8,10,318.55367348367383,0.45390070921985815,0.08191401659328923,0.17022273389237755,127723.00347222244,-1262.6736111110863,126460.32986111136,234,0,89.97872340425532,39,8,15,39.24154987633966,0.5918803418803419,47.29166666666668,1010.8333333333351,25.918803418803464,0
247,4,1,0,47,0.02127659574468085,0.0,1.0,47,1900,1400,500,0.7368421052631579,24,14,10,317.7914422740604,0.45312981806968855,0.0715302141334031,0.17105768552243755,128015.94309769328,-1263.5257617819973,126752.41733591128,235,0,90.8936170212766,40,7,18,38.96197362254805,0.5932291666666667,47.00203252032521,1011.9918699187,25.2997967479675,0
248,4,2,2,47,0.04081632653061224,0.04081632653061224,0.9591836734693877,49,1450,1200,250,0.8275862068965517,17,12,5,307.72820136436206,0.45415249433106575,0.09358428209443903,0.16789610286577222,128556.44710696374,-1887.7820535064818,126668.66505345725,236,0,88.14285714285714,40,9,13,38.66661656144571,0.5986979166666666,46.468495934959364,1014.126016260165,25.353150406504124,0
249,4,0,2,45,0.0,0.0425531914893617,0.9574468085106383,47,1600,1200,400,0.75,20,12,8,322.28294795959863,0.4529178230033919,0.09054745299750855,0.1750692797710187,128381.9458007817,-1124.9376085069007,127257.0081922748,237,1,92.76595744680851,39,8,14,38.47528437317984,0.5985576923076923,46.64062500000002,1013.4375000000036,25.985576923077016,0
250,4,1,3,43,0.021739130434782608,0.06521739130434782,0.9347826086956522,46,1550,1100,450,0.7096774193548387,20,11,9,326.1888088642657,0.45237520128824477,0.09585812356979417,0.17891418500060802,128767.28121119174,-799.5107842062667,127967.77042698547,238,0,93.5,38,8,15,37.98399122807017,0.6041666666666667,46.260683760683776,1014.9572649572672,26.709401709401767,0
251,4,0,1,42,0.0,0.023255813953488372,0.9767441860465116,43,1100,800,300,0.7272727272727273,14,8,6,349.512346717408,0.44730527870062753,0.009760934570751223,0.1907701936083015,128572.46393352808,396.16476341939597,128968.62869694747,239,1,99.86046511627907,36,7,15,37.59091161447924,0.6059027777777778,46.4527027027027,1014.1891891891889,28.171921921921914,8
252,4,0,1,41,0.0,0.023809523809523808,0.9761904761904762,42,1200,800,400,0.6666666666666666,16,8,8,357.2289332981446,0.44600512969415407,0.018064365342073785,0.19475312287648056,128525.67361379019,782.6178572959433,129308.29147108614,240,2,103.11904761904762,35,7,15,37.443047787543286,0.6074404761904761,46.49884259259259,1014.0046296296288,28.971560846560823,0
253,4,1,4,38,0.023809523809523808,0.09523809523809523,0.9047619047619048,42,1350,1100,250,0.8148148148148148,16,11,5,355.1583146731202,0.44523083623693377,0.043559034275516995,0.19621993986880545,129054.34355977783,766.9446319872962,129821.28819176512,241,0,103.80952380952381,35,7,17,36.95620704712,0.612797619047619,45.97800925925925,1016.0879629629619,29.031084656084627,0
254,4,0,0,38,0.0,0.0,1.0,38,1400,900,500,0.6428571428571429,19,9,10,378.85791935295674,0.44059684684684686,0.04145162557962845,0.20739116075751757,128688.4310274461,2150.9262447709325,130839.35727221704,242,1,110.10526315789474,32,6,17,36.72821262651403,0.6158854166666667,46.338383838383834,1014.646464646464,31.707702020202,0
255,4,0,1,37,0.0,0.02631578947368421,0.9736842105263158,38,800,600,200,0.75,10,6,4,375.84372911561616,0.440493124703651,0.03782403770620579,0.206405982383166,128816.57483930199,2082.9803719008096,130899.5552112028,243,2,111.10526315789474,32,6,17,36.673662935323385,0.6171875,46.212121212121204,1015.1515151515141,31.723484848484816,0
256,4,2,2,37,0.05128205128205128,0.05128205128205128,0.9487179487179487,39,1150,800,350,0.6956521739130435,15,8,7,356.5511299526159,0.44177350427350426,0.06138409052316374,0.19913632375631934,129481.87183114637,1433.9554629834486,130915.82729412982,244,0,108.35897435897436,33,6,15,36.485425446518185,0.6215277777777778,45.55759803921567,1017.7696078431348,30.841503267973785,0
257,4,0,1,36,0.0,0.02702702702702703,0.972972972972973,37,900,600,300,0.6666666666666666,12,6,6,365.0866378098622,0.4388138138138138,0.06808247989829241,0.2032828639138945,129361.89746263105,2045.6600410671972,131407.55750369825,245,1,113.64864864864865,32,5,19,36.39045757312481,0.6227213541666667,45.67550505050503,1017.2979797979772,31.790561868686787,0
258,4,1,1,36,0.02702702702702703,0.02702702702702703,0.972972972972973,37,850,600,250,0.7058823529411765,11,6,5,361.6374826757399,0.4388763763763764,0.09636246752203159,0.20385040224571035,129844.0210182634,1991.292980308129,131835.31399857154,246,0,114.13513513513513,32,5,18,35.98757020151967,0.6276041666666667,45.2020202020202,1019.1919191919189,31.849747474747467,0
259,4,1,0,37,0.02702702702702703,0.0,1.0,37,1050,600,450,0.5714285714285714,15,6,9,360.8331935539142,0.43596721721721726,0.09884911938966034,0.20476730309041133,130106.25608239608,1989.3311767108662,132095.58725910695,247,0,114.70270270270271,33,4,19,35.74161661661661,0.6278409090909092,44.944852941176464,1020.2205882352932,30.915775401069492,0
260,4,0,0,37,0.0,0.0,1.0,37,900,700,200,0.7777777777777778,11,7,4,361.59547128474793,0.43543543543543545,0.09960345229764433,0.2058645133330297,130232.20663265292,2018.2752267573505,132250.48185941027,248,1,115.70270270270271,34,3,20,35.59428699168028,0.6268382352941176,44.82142857142856,1020.7142857142845,30.02100840336131,0
261,4,1,1,37,0.02631578947368421,0.02631578947368421,0.9736842105263158,38,1250,800,450,0.64,17,8,9,351.0443544954039,0.4354551920341394,0.09237347883395142,0.20158634002294568,130566.58340419481,1566.935941043058,132133.51934523787,249,0,113.63157894736842,34,4,18,35.52465540671715,0.6302083333333333,44.494047619047606,1022.0238095238078,30.05952380952376,0
262,4,0,0,37,0.0,0.0,1.0,37,1500,1000,500,0.6666666666666666,20,10,10,358.240833182902,0.43390265265265265,0.09896508792862013,0.20510271877834266,130450.30757400986,1946.5253748558127,132396.83294886566,250,3,117.70270270270271,33,4,20,35.45865323096611,0.6313131313131313,44.607843137254896,1021.5686274509793,30.9566250742721,0
263,4,0,1,36,0.0,0.02702702702702703,0.972972972972973,37,800,500,300,0.625,11,5,6,358.78876406808723,0.4338088088088088,0.09415700180871656,0.20574832976614252,130512.91120001924,1965.3132208765862,132478.22442089583,251,4,118.70270270270271,33,4,18,35.3811865355401,0.6319444444444444,44.54656862745098,1021.8137254901962,30.964052287581705,0
264,4,0,0,36,0.0,0.0,1.0,36,1050,700,350,0.6666666666666666,14,7,7,360.9765925751229,0.43349867724867724,0.10320361713745374,0.20784180206033462,130669.4859699394,2233.7251597943045,132903.2111297337,252,5,121.13888888888889,33,3,18,35.166581765152415,0.6335227272727273,44.393382352941174,1022.4264705882349,30.982620320855602,0
265,4,0,0,36,0.0,0.0,1.0,36,1000,700,300,0.7,13,7,6,360.5854941111021,0.4330026455026455,0.09986423893946639,0.20846036737115534,130826.15460399864,2234.80272010767,133060.9573241063,253,6,122.13888888888889,33,3,19,35.0178685513496,0.6351010101010102,44.24019607843138,1023.039215686276,31.001188354129575,0
266,4,0,0,36,0.0,0.0,1.0,36,1150,900,250,0.782608695652174,14,9,5,361.0263616298098,0.43278769841269843,0.10148152583190329,0.209224923384493,130920.20083922063,2253.1287545655673,133173.3295937862,254,7,123.13888888888889,33,3,19,34.91136291062948,0.6360479797979798,44.1482843137255,1023.4068627450991,31.012329174093914,0
267,4,0,1,35,0.0,0.027777777777777776,0.9722222222222222,36,1500,1000,500,0.6666666666666666,20,10,10,364.0182704564196,0.4313822751322751,0.11059929276009695,0.2121662973831768,131139.77346453292,2347.454704921191,133487.22816945412,255,8,124.13888888888889,33,3,21,34.61254686129059,0.6382575757575757,43.93382352941177,1024.2647058823534,31.038324420677377,0
268,4,0,0,35,0.0,0.0,1.0,35,1200,700,500,0.5833333333333334,17,7,10,372.74741113633274,0.42913165266106446,0.1087968997710056,0.21685663589065002,131069.41415416806,2771.1569610244,133840.57111519246,256,9,128.02857142857144,32,3,22,34.46028565556926,0.6399739583333333,44.00252525252526,1023.9898989898999,31.99968434343437,0
269,4,0,1,34,0.0,0.02857142857142857,0.9714285714285714,35,1400,1000,400,0.7142857142857143,18,10,8,371.21278340126344,0.42860644257703084,0.09998064027878018,0.21724110763288065,131295.7721948015,2747.7338090500916,134043.5060038516,257,10,129.02857142857144,32,3,23,34.27040983943165,0.6422526041666667,43.781565656565654,1024.873737373737,32.02730429292928,0
270,4,0,0,34,0.0,0.0,1.0,34,1150,800,350,0.6956521739130435,15,8,7,382.5873225808184,0.42624777183600715,0.1000478052015139,0.22469273933557074,131431.47193678466,3256.80697579278,134688.27891257743,258,11,132.7058823529412,30,4,23,33.84153668021145,0.6489583333333333,43.649193548387096,1025.403225806452,34.180107526881734,0
271,4,0,0,34,0.0,0.0,1.0,34,650,400,250,0.6153846153846154,9,4,5,388.86227946828336,0.4255978906714201,0.1254636989931106,0.21269075981352187,128655.37200832463,3205.8442449994145,131861.21625332403,259,12,133.7058823529412,30,4,20,36.508291379614896,0.6208333333333333,46.37096774193548,1014.5161290322578,33.81720430107526,8
272,4,1,0,35,0.02857142857142857,0.0,1.0,35,950,500,450,0.5263157894736842,14,5,9,377.9568293146922,0.4275210084033614,0.11645393447726549,0.2083704046278383,128969.8304070366,2749.0056355794213,131718.83604261602,260,0,130.85714285714286,31,4,21,36.46340746912789,0.6213037634408602,46.061197916666664,1015.7552083333327,32.76629704301073,0
273,4,0,0,35,0.0,0.0,1.0,35,1400,1000,400,0.7142857142857143,18,10,8,375.03185642205347,0.4267156862745098,0.10392138922944594,0.2077979917024112,129168.29639010967,2688.44519721138,131856.74158732104,261,1,131.85714285714286,31,4,21,36.33504653943042,0.6233198924731183,45.86588541666667,1016.5364583333339,32.791498655914,0
274,4,0,1,34,0.0,0.02857142857142857,0.9714285714285714,35,1400,1100,300,0.7857142857142857,17,11,6,380.29396669231517,0.4254551820728291,0.10415211206741337,0.1921816771806897,125442.3097770635,2558.89859961898,128001.20837668248,262,2,132.85714285714286,32,3,20,40.033925720527684,0.5826822916666667,49.5580808080808,1001.7676767676763,31.305239898989885,8
275,4,3,0,37,0.08108108108108109,0.0,1.0,37,1250,700,550,0.56,18,7,11,358.43069601427703,0.4343718718718719,0.1198549769281474,0.18461882583649963,126228.49384851994,1650.272169525651,127878.76601804559,263,0,126.54054054054055,33,4,24,39.76981707317073,0.5883838383838385,48.774509803921575,1004.9019607843148,30.451574569221663,0
276,4,1,1,37,0.02631578947368421,0.02631578947368421,0.9736842105263158,38,1250,1000,250,0.8,15,10,5,326.7582073395894,0.43609234234234234,0.03775201769966663,0.16877511076347584,126342.87308673466,691.3162201154956,127034.18930685015,264,0,124.1842105263158,34,4,19,40.44799684231302,0.5873161764705883,48.660714285714285,1005.3571428571425,29.56932773109243,8
277,4,0,1,36,0.0,0.02702702702702703,0.972972972972973,37,800,600,200,0.75,10,6,4,366.14335825329493,0.43477852852852855,-0.04782352445903881,0.18655875872905983,125782.47070312501,1810.8832465277785,127593.3539496528,265,1,126.75675675675676,35,2,17,40.036561093804075,0.5794642857142858,49.21875,1003.1250000000001,28.66071428571429,8
278,4,4,3,37,0.1,0.075,0.925,40,1100,600,500,0.5454545454545454,16,6,10,353.25174859367235,0.4407986111111111,0.0032308111050625143,0.18445806201437626,126788.14785559008,957.8982535491559,127746.04610913924,266,0,118.1,37,3,15,39.32396570495372,0.5858671171171171,48.21820175438596,1007.1271929824554,27.219653864390686,0
279,4,2,1,38,0.05128205128205128,0.02564102564102564,0.9743589743589743,39,950,600,350,0.631578947368421,13,6,7,367.8913548312727,0.4369376968061178,0.03054413228864572,0.18456886999863692,125140.80539576754,1414.8608521570632,126555.6662479246,267,0,122.0,36,3,19,40.65677171262429,0.5708912037037037,49.85923423423424,1000.5630630630643,27.793418418418455,8
280,4,3,1,40,0.07317073170731707,0.024390243902439025,0.975609756097561,41,1000,700,300,0.7,13,7,6,348.070567522735,0.44247967479674793,0.05715383956097053,0.17755191198294454,125829.362592684,559.4995297319135,126388.86212241591,268,0,116.8780487804878,38,3,21,40.441424413445496,0.5742872807017544,49.17200854700855,1003.3119658119666,26.402946468735962,0
281,4,4,3,41,0.09090909090909091,0.06818181818181818,0.9318181818181819,44,800,400,400,0.5,12,4,8,321.77302763962075,0.4484782417195208,0.008046944637021047,0.16252837719245886,125421.98252275454,-728.5177902179316,124693.46473253661,269,0,109.72727272727273,41,3,12,41.5204805057608,0.5652947154471545,49.57837301587302,1001.6865079365084,24.431378242353862,8
282,4,6,1,46,0.1276595744680851,0.02127659574468085,0.9787234042553191,47,1450,1000,450,0.6896551724137931,19,10,9,316.35947534843893,0.4535923527597903,0.09008626728848501,0.16468664167257116,126662.68957328956,-1384.2737992426978,125278.41577404687,270,0,103.53191489361703,43,4,11,40.38138915020382,0.5750968992248062,48.342803030303024,1006.6287878787867,23.409971811134575,0
283,4,1,3,44,0.02127659574468085,0.06382978723404255,0.9361702127659575,47,1200,900,300,0.75,15,9,6,321.1292162535595,0.45374653098982426,0.0944132681131149,0.1676587734342958,126781.87346655481,-1257.3272677054606,125524.54619884935,271,0,104.51063829787235,43,4,12,40.13918272997962,0.5763081395348837,48.22443181818182,1007.1022727272732,23.42098308668077,0
284,4,1,5,40,0.022222222222222223,0.1111111111111111,0.8888888888888888,45,950,700,250,0.7368421052631579,12,7,5,329.7816452335842,0.45490319865319867,0.09201470974520642,0.1722193036219829,126792.09183673472,-637.2590702947838,126154.83276643994,272,0,105.57777777777778,41,4,14,39.910855003940114,0.5792682926829269,48.214285714285715,1007.1428571428573,24.564459930313593,0
285,4,2,0,42,0.047619047619047616,0.0,1.0,42,1350,900,450,0.6666666666666666,18,9,9,356.4412165328199,0.4500217770034843,0.09588545435748963,0.186673301977367,126908.26958550353,647.0675998263935,127555.33718532992,273,0,107.30952380952381,39,3,16,39.1201669595782,0.5836004273504274,48.098958333333336,1007.6041666666672,25.836004273504287,0
286,4,1,0,43,0.023255813953488372,0.0,1.0,43,950,500,450,0.5263157894736842,14,5,9,350.382808955566,0.4517118863049096,0.10067669395112433,0.18506796687787294,127253.65713346492,317.76460927228436,127571.4217427372,274,0,105.79069767441861,38,5,17,38.91822850487083,0.5888157894736843,47.75641025641026,1008.9743589743598,26.551956815114732,0
287,4,1,1,43,0.022727272727272728,0.022727272727272728,0.9772727272727273,44,950,600,350,0.631578947368421,13,6,7,346.093660937064,0.4528607293868922,0.10539101421454311,0.18475048083838455,127681.91599122557,37.98034817239113,127719.89633939796,275,0,104.36363636363636,40,4,16,38.58764873470755,0.58984375,47.332317073170735,1010.6707317073179,25.266768292682947,0
288,4,2,2,43,0.044444444444444446,0.044444444444444446,0.9555555555555556,45,1100,600,500,0.5454545454545454,16,6,10,338.8214414035672,0.45528198653198654,0.12850777983412187,0.18368881488802105,128302.78320312513,-303.98010056223325,127998.8031025629,276,0,101.57777777777778,39,6,18,38.13703817945027,0.5977564102564102,46.71875000000001,1013.125000000001,25.977564102564127,0
289,4,0,1,42,0.0,0.023255813953488372,0.9767441860465116,43,1600,1300,300,0.8125,19,13,6,343.1871583404207,0.4535806570690291,0.11676458760409236,0.18620062984556915,128333.90404704504,208.50956972751754,128542.41361677257,277,1,106.51162790697674,38,5,18,37.994692815970765,0.5997807017543859,46.68803418803419,1013.2478632478629,26.66441745389113,0
290,4,2,1,43,0.045454545454545456,0.022727272727272728,0.9772727272727273,44,800,500,300,0.625,11,5,6,338.1787031682428,0.4555584918957012,0.130719731967037,0.18517137423057073,128698.84033203124,-95.35861545138877,128603.48171657984,278,0,104.88636363636364,39,5,14,37.74948242822436,0.6017628205128205,46.328125,1014.6874999999999,26.0176282051282,0
291,4,0,2,41,0.0,0.046511627906976744,0.9534883720930233,43,1500,1000,500,0.6666666666666666,20,10,10,373.44893525662167,0.4537421557770395,0.0802066058158526,0.19500446107629663,126788.1478555897,941.0769644866141,127729.22482007631,279,1,108.32558139534883,37,6,16,38.815437307203766,0.5858671171171171,48.21820175438594,1007.1271929824522,27.2196538643906,8
292,4,1,1,41,0.023809523809523808,0.023809523809523808,0.9761904761904762,42,1100,1000,100,0.9090909090909091,12,10,2,371.0518610288119,0.45492160278745647,0.0574975542839653,0.1953459133017545,127121.19187510715,1121.8781166848778,128243.06999179203,280,0,109.85714285714286,35,7,20,38.53305883928231,0.5931547619047619,47.88773148148148,1008.4490740740739,28.812830687830683,8
293,4,2,2,41,0.046511627906976744,0.046511627906976744,0.9534883720930233,43,1400,1300,100,0.9285714285714286,15,13,2,361.149334860384,0.4559339239571798,0.0756047237400077,0.19241281664889348,127603.5072234397,616.784351919493,128220.29157535918,281,0,108.11627906976744,36,7,19,38.28763560707386,0.5960648148148149,47.40990990990991,1010.3603603603607,28.065565565565574,0
294,4,0,1,40,0.0,0.024390243902439025,0.975609756097561,41,900,600,300,0.6666666666666666,12,6,6,374.829199508819,0.45383638211382116,0.07767625663872746,0.19847513351040733,127354.73632812497,1347.2547743055538,128701.99110243052,282,1,114.14634146341463,35,6,19,38.19766941864465,0.5955357142857143,47.65625,1009.3749999999998,28.839285714285708,0
295,4,0,2,38,0.0,0.05,0.95,40,1350,800,550,0.5925925925925926,19,8,11,382.74018778924926,0.4518696581196581,0.0816627358490567,0.20285229952830172,127392.29024943287,1751.6298185940761,129143.92006802696,283,2,117.85,34,6,20,37.95941430817609,0.5980392156862745,47.619047619047606,1009.5238095238076,29.691876750700224,0
296,4,1,1,38,0.02564102564102564,0.02564102564102564,0.9743589743589743,39,1350,1100,250,0.8148148148148148,16,11,5,381.22513755246916,0.45040485829959515,0.10424802791215027,0.20443476674597305,127865.50132461057,1949.1086661380052,129814.60999074858,284,0,120.58974358974359,33,6,21,37.51148572236359,0.6051136363636364,47.15073529411764,1011.397058823528,30.64839572192509,0
297,4,0,0,38,0.0,0.0,1.0,38,750,400,350,0.5333333333333333,11,4,7,383.016706040197,0.4488205310573732,0.12237794386140011,0.20600643504739205,127984.77993317021,2204.0617666564804,130188.84169982669,285,1,124.39473684210526,32,6,21,37.34376299808668,0.6087239583333333,47.03282828282829,1011.8686868686879,31.620896464646496,0
298,4,0,1,37,0.0,0.02631578947368421,0.9736842105263158,38,1100,700,400,0.6363636363636364,15,7,8,385.27324764178894,0.4487464438122333,0.11836690491661228,0.20804755372656614,128144.53125,2274.1319444444443,130418.66319444444,286,2,125.39473684210526,32,6,21,37.122770919067214,0.6103515625,46.875,1012.5,31.640625,0
299,4,2,1,38,0.05128205128205128,0.02564102564102564,0.9743589743589743,39,1100,700,400,0.6363636363636364,15,7,8,377.7657296780389,0.45296333783175885,0.12055030467498806,0.2063872570656849,128610.25694744803,1916.9095119665494,130527.16645941457,287,0,121.0,33,6,21,36.8358855865652,0.6126893939393939,46.41544117647059,1014.3382352941171,30.73752228163991,0
300,4,0,0,38,0.0,0.0,1.0,38,1100,900,200,0.8181818181818182,13,9,4,384.07252464246596,0.4501837363679469,0.12426609352065432,0.20957000801143263,128560.35098459348,2275.29971431488,130835.65069890836,288,1,125.1842105263158,32,6,21,36.727050132802134,0.6145833333333333,46.46464646464647,1014.1414141414148,31.69191919191921,0
301,4,0,0,38,0.0,0.0,1.0,38,750,400,350,0.5333333333333333,11,4,7,380.37877196667296,0.44972439544807963,0.11716247139588032,0.20830266083889276,128703.50346020787,2191.2161188004857,130894.71957900835,289,2,126.1842105263158,33,5,21,36.674214975845395,0.6136363636363636,46.32352941176472,1014.7058823529433,30.74866310160434,0
302,4,0,0,38,0.0,0.0,1.0,38,850,700,150,0.8235294117647058,10,7,3,375.42701197421803,0.4494873162636321,0.12094463678810774,0.20639766384913064,128858.98940611797,2075.429071751268,130934.41847786923,290,3,127.1842105263158,33,5,21,36.640892174612766,0.6152146464646464,46.17034313725491,1015.3186274509815,30.767231134878227,0
303,4,2,2,38,0.05,0.05,0.95,40,1050,700,350,0.6666666666666666,14,7,7,367.0376351735755,0.4499866452991453,0.14883707339878427,0.20606128651870834,129685.96938775522,1520.3806062866422,131206.34999404187,291,0,121.775,34,6,19,36.01079164718716,0.6213235294117647,45.35714285714286,1018.5714285714295,29.957983193277336,0
304,4,1,0,39,0.02564102564102564,0.0,1.0,39,1350,800,550,0.5925925925925926,19,8,11,364.1897553623226,0.448015069725596,0.14833710583360293,0.2057335794804046,129928.59977324269,1663.7329931972831,131592.33276643997,292,0,123.02564102564102,34,5,23,35.836544449634125,0.6237745098039216,45.11904761904762,1019.52380952381,29.985994397759118,0
305,4,1,0,40,0.025,0.0,1.0,40,1050,500,550,0.47619047619047616,16,5,11,356.03117214057454,0.44847756410256406,0.1511056929008847,0.20254728231842506,130203.5175004288,1271.302190500703,131474.8196909295,293,0,120.925,35,5,24,35.765385196945665,0.6244047619047619,44.849537037037045,1020.6018518518529,29.16005291005294,0
306,4,0,1,39,0.0,0.025,0.975,40,1050,800,250,0.7619047619047619,13,8,5,356.8626845410687,0.4484909188034188,0.15437974827077916,0.20317443608571234,130233.05047850226,1295.063201946166,131528.11368044844,294,1,121.925,35,5,24,35.714201345579625,0.624702380952381,44.820601851851855,1020.7175925925928,29.163359788359795,0
307,4,1,2,38,0.025,0.05,0.95,40,1200,900,300,0.75,15,9,6,353.0814798168127,0.4481036324786325,0.1676962252846026,0.2036257739510229,130732.1421598663,1231.8296896247996,131963.9718494911,295,0,120.1,33,7,17,35.30494807269824,0.6341540404040404,44.33210784313725,1022.6715686274501,30.990047534165157,0
308,4,0,0,38,0.0,0.0,1.0,38,1050,700,350,0.6666666666666666,14,7,7,352.45415441283245,0.4476055002370792,0.16084253403365878,0.2035941056667065,130794.81336805536,1619.8350694444216,132414.64843749977,296,1,123.23684210526316,33,5,17,35.25755261371351,0.6347853535353536,44.27083333333332,1022.916666666665,30.997474747474698,0
309,4,0,0,38,0.0,0.0,1.0,38,700,400,300,0.5714285714285714,10,4,6,353.4456192534103,0.4475758653390232,0.1647061419268614,0.20449878552645348,130857.49959450697,1650.2019956266859,132507.70159013366,297,2,124.23684210526316,33,5,17,35.16875773545733,0.6354166666666667,44.20955882352941,1023.1617647058828,31.004901960784327,0
310,4,1,1,38,0.02564102564102564,0.02564102564102564,0.9743589743589743,39,1200,900,300,0.75,15,9,6,341.224792187781,0.448015069725596,0.16094152130397532,0.1995423241272022,131267.12018140577,1158.3191609977198,132425.4393424035,298,0,122.02564102564102,34,5,19,35.06766960966543,0.6372549019607843,43.8095238095238,1024.7619047619037,30.14005602240893,0
311,4,1,2,37,0.02564102564102564,0.05128205128205128,0.9487179487179487,39,950,700,250,0.7368421052631579,12,7,5,343.6901291128697,0.44655308142150246,0.1036106750392467,0.19582344565733265,130262.58680555539,1158.8577097505472,131421.44451530592,299,0,122.84615384615384,33,6,22,36.020408163265294,0.6294191919191919,44.79166666666666,1020.833333333332,30.934343434343393,7
312,4,1,1,37,0.02631578947368421,0.02631578947368421,0.9736842105263158,38,1100,700,400,0.6363636363636364,15,7,8,346.4606318625683,0.445945945945946,0.09997266906137758,0.19789361514861925,130359.27456381988,1432.8713269053999,131792.14589072528,300,0,118.92105263157895,32,6,24,35.851724777448055,0.6328125,44.69696969696969,1021.2121212121201,31.912878787878753,0
313,4,0,0,37,0.0,0.0,1.0,37,950,600,350,0.631578947368421,13,6,7,356.37726766479096,0.4447572572572573,0.1065641004432134,0.203399602112612,130329.05578613267,1889.2625596788057,132218.31834581148,301,1,123.08108108108108,31,6,24,35.62919748363514,0.6350806451612903,44.72656249999999,1021.0937499999989,32.93850806451609,0
314,4,0,1,36,0.0,0.02702702702702703,0.972972972972973,37,1150,700,450,0.6086956521739131,16,7,9,351.1399890947133,0.4442254754754755,0.1046462629576086,0.20136212029379089,130512.91120001924,1765.6604430988093,132278.57164311805,302,2,124.08108108108108,33,4,21,35.57657711681459,0.6319444444444444,44.54656862745098,1021.8137254901962,30.964052287581705,0
315,4,0,0,36,0.0,0.0,1.0,36,1150,600,550,0.5217391304347826,17,6,11,349.13064663529104,0.44363425925925926,0.09608007672021102,0.20085847270562754,130638.16350682429,1921.9573000768896,132560.1208069012,303,3,126.83333333333333,33,3,21,35.50107887796692,0.6332070707070707,44.424019607843135,1022.3039215686274,30.978906714200832,0
316,4,0,0,36,0.0,0.0,1.0,36,1400,1100,300,0.7857142857142857,17,11,6,386.69757728617617,0.44313822751322757,0.11727400429681056,0.2172615636173308,129715.36705438222,2835.7580547973944,132551.12510917961,304,4,127.83333333333333,32,4,16,35.48018922492151,0.6263020833333333,45.32828282828283,1018.6868686868688,31.83396464646465,8
317,4,0,0,36,0.0,0.0,1.0,36,950,700,250,0.7368421052631579,12,7,5,388.7726833778893,0.44275793650793654,0.12346711259754772,0.21932647609431866,129876.1944731405,2898.4633264462846,132774.65779958677,305,5,128.83333333333334,32,4,17,35.263377926421406,0.6279296875,45.17045454545455,1019.3181818181819,31.853693181818183,0
318,4,0,0,36,0.0,0.0,1.0,36,1050,900,150,0.8571428571428571,12,9,3,388.5531863446811,0.4425099206349206,0.12618341812549283,0.2197927303585377,129981.25908604855,2900.9264765955313,132882.1855626441,306,6,129.83333333333334,33,3,17,35.16191463365781,0.6265782828282829,45.06740196078431,1019.7303921568621,30.900920974450365,0
319,4,0,0,36,0.0,0.0,1.0,36,1250,800,450,0.64,17,8,9,386.74697696957855,0.44221230158730157,0.12770903855881133,0.21898620962976711,130019.64462868468,2856.9409013605305,132876.5855300452,307,7,130.83333333333334,34,2,17,35.168865024707216,0.6246936274509804,45.0297619047619,1019.8809523809514,29.996498599439747,0
320,4,0,0,36,0.0,0.0,1.0,36,1300,900,400,0.6923076923076923,17,9,8,386.70374274383744,0.4419146825396825,0.12415230611636208,0.21930273802593936,130080.35891439913,2860.5123299319716,132940.8712443311,308,8,131.83333333333334,34,2,18,35.10814175127396,0.6253063725490196,44.970238095238095,1020.1190476190479,30.003501400560232,0
321,4,0,0,36,0.0,0.0,1.0,36,850,600,250,0.7058823529411765,11,6,5,384.7315451951671,0.44130291005291006,0.11938741120962315,0.21869488099555517,130171.45691609975,2816.213151927436,132987.6700680272,309,9,132.83333333333334,34,2,19,35.06571784103283,0.6262254901960784,44.88095238095238,1020.4761904761903,30.01400560224089,0
322,4,0,0,36,0.0,0.0,1.0,36,1000,700,300,0.7,13,7,6,385.33987211774013,0.4407407407407407,0.11541564971525387,0.21973076486056753,130293.86421388402,2841.516082535949,133135.38029641996,310,10,133.83333333333334,33,3,19,34.9256541831713,0.6297348484848485,44.7610294117647,1020.9558823529406,30.938057040998203,0
323,4,0,0,36,0.0,0.0,1.0,36,1300,900,400,0.6923076923076923,17,9,8,383.9830934391406,0.43964947089947093,0.1153848716206316,0.22037405479621416,130544.21864487215,2825.354581170704,133369.57322604285,311,11,134.83333333333334,33,3,16,34.705775072950416,0.632260101010101,44.51593137254902,1021.9362745098038,30.96776589423648,0
324,4,0,1,35,0.0,0.027777777777777776,0.9722222222222222,36,1200,900,300,0.75,15,9,6,387.7502760033791,0.4385912698412699,0.11796899968040897,0.2234384187135495,130700.81218762019,2935.8551999231163,133636.6673875433,312,12,135.83333333333334,33,3,17,34.450403483541066,0.6338383838383839,44.36274509803922,1022.5490196078435,30.98633392751041,0
325,4,0,1,34,0.0,0.02857142857142857,0.9714285714285714,35,850,500,350,0.5882352941176471,12,5,7,390.0960219478738,0.4363095238095238,0.11707936507936512,0.22505539727761958,130746.3842975207,3200.7288797061588,133947.11317722686,313,13,139.5142857142857,32,3,17,34.34413580246914,0.63671875,44.31818181818182,1022.727272727273,31.96022727272728,0
326,4,0,0,34,0.0,0.0,1.0,34,900,600,300,0.6666666666666666,12,6,6,397.5943851677555,0.43425059417706474,0.1223604346197078,0.2284857923548228,130595.10125054247,3584.775797526034,134179.8770480685,314,14,143.85294117647058,31,3,17,34.30626326963906,0.637768817204301,44.46614583333333,1022.1354166666661,32.972110215053746,0
327,4,0,0,34,0.0,0.0,1.0,34,700,500,200,0.7142857142857143,9,5,4,398.8250058844637,0.43365641711229946,0.11822432960346219,0.23028377567142133,130778.66934815333,3631.5607144679216,134410.23006262124,315,15,144.85294117647058,32,2,17,34.0881269802082,0.6370442708333333,44.286616161616166,1022.853535353536,31.964172979798,0
328,4,0,0,34,0.0,0.0,1.0,34,700,400,300,0.5714285714285714,10,4,6,397.5014258703561,0.4336007130124777,0.11113771933643934,0.23048258641667438,130940.15438475672,3609.7796143250775,134549.9339990818,316,16,145.85294117647058,32,2,19,33.957870713052074,0.638671875,44.12878787878788,1023.484848484849,31.98390151515153,0
329,4,0,0,34,0.0,0.0,1.0,34,1350,1000,350,0.7407407407407407,17,10,7,403.8748952823459,0.4325794711824124,0.12160731123522162,0.23496595414202498,131069.41415416809,3787.129183246623,134856.5433374147,317,17,146.85294117647058,32,2,19,33.6634299219071,0.6399739583333333,44.00252525252526,1023.9898989899001,31.999684343434378,0
330,4,0,0,34,0.0,0.0,1.0,34,450,0,450,0.0,9,0,9,387.89850259630447,0.43226381461675584,0.08597285067873273,0.2076397866839044,127793.20987654335,3135.9838919498156,130929.19376849316,318,18,147.85294117647058,32,2,19,37.417010073260066,0.6067708333333333,47.22222222222223,1011.1111111111122,31.597222222222257,8
331,4,3,2,35,0.08108108108108109,0.05405405405405406,0.9459459459459459,37,900,700,200,0.7777777777777778,11,7,4,372.97301911786604,0.43737487487487486,0.12565713796807731,0.20509908962322895,128868.76594387762,2213.396793902759,131082.16273778037,319,0,136.78378378378378,34,3,19,36.69319380935632,0.6130514705882353,46.16071428571429,1015.3571428571433,29.863445378151276,0
332,4,0,0,35,0.0,0.0,1.0,35,950,600,350,0.631578947368421,13,6,7,379.1892527424865,0.43368347338935576,0.12453734844173114,0.20813946855308257,128796.78376405712,2767.6712382256883,131564.4550022828,320,1,144.0857142857143,33,2,20,36.60899331965069,0.6145833333333333,46.231617647058826,1015.073529411765,30.759803921568636,0
333,4,0,1,34,0.0,0.02857142857142857,0.9714285714285714,35,1250,800,450,0.64,17,8,9,380.9120008136236,0.43280812324929974,0.12845419527717294,0.20962447528646536,128898.98667800475,2819.8341836734967,131718.82086167825,321,2,145.0857142857143,34,1,20,36.46077569363034,0.6133578431372548,46.130952380952394,1015.4761904761922,29.866946778711537,0
334,4,1,0,35,0.02857142857142857,0.0,1.0,35,900,500,400,0.5555555555555556,13,5,8,371.99421574441106,0.43403361344537816,0.118669859005055,0.20679181558462587,129297.68207644619,2620.306585099598,131917.9886615458,322,0,139.11428571428573,32,3,21,36.28026070763502,0.6220703125,45.73863636363636,1017.0454545454538,31.782670454545432,0
335,4,0,1,34,0.0,0.02857142857142857,0.9714285714285714,35,1000,800,200,0.8,12,8,4,373.8100118817998,0.4339985994397759,0.11573964077377252,0.20814010129451707,129361.89746263142,2671.354485511687,132033.2519481431,323,1,140.11428571428573,32,3,21,36.16860080261469,0.6227213541666667,45.67550505050505,1017.2979797979802,31.790561868686883,0
336,4,1,0,35,0.02857142857142857,0.0,1.0,35,1400,1100,300,0.7857142857142857,17,11,6,369.01065472721143,0.43196778711484596,0.11489763996080948,0.20707951056298804,129669.02941476827,2569.850688437128,132238.8801032054,324,0,139.8,33,2,18,35.97779549191834,0.6234217171717171,45.373774509803916,1018.5049019607836,30.863784907902534,0
337,4,0,0,35,0.0,0.0,1.0,35,800,700,100,0.875,9,7,2,367.5535445617216,0.43077731092436977,0.10840376554662257,0.20708504583843335,129825.09731833909,2543.534938485195,132368.6322568243,325,1,140.8,33,2,19,35.85608064774731,0.625,45.220588235294116,1019.1176470588234,30.882352941176467,0
338,4,0,0,35,0.0,0.0,1.0,35,850,300,550,0.35294117647058826,14,3,11,358.98811231407507,0.43126750700280114,0.08627258925510528,0.1942798374063371,128232.43694540893,2206.7840952932056,130439.22104070213,326,2,141.8,35,0,21,37.69819163524167,0.6044642857142857,46.78819444444444,1012.8472222222222,28.938492063492063,8
339,4,0,1,34,0.0,0.02857142857142857,0.9714285714285714,35,1050,800,250,0.7619047619047619,13,8,5,363.53947699299505,0.4304621848739496,0.09680672268907564,0.1973210242451129,128349.69142500428,2332.0359385716706,130681.72736357595,327,3,142.8,35,0,21,37.46299733485627,0.6056547619047619,46.6724537037037,1013.3101851851851,28.951719576719576,0
340,4,0,2,32,0.0,0.058823529411764705,0.9411764705882353,34,1150,800,350,0.6956521739130435,15,8,7,368.43250575902954,0.4296457219251337,0.09349492352457411,0.19985526172817697,128325.3985969386,2655.849631519256,130981.24822845786,328,4,146.64705882352942,34,0,21,37.3639016175146,0.6075367647058824,46.69642857142856,1013.2142857142843,29.800420168067184,0
341,4,2,1,33,0.058823529411764705,0.029411764705882353,0.9705882352941176,34,750,400,350,0.5333333333333333,11,4,7,368.4518621095696,0.4338420974450386,0.10428246894485027,0.20107888618266617,128566.75347222203,2674.1319444444202,131240.88541666645,329,0,145.47058823529412,34,0,17,37.11654341276363,0.6099877450980392,46.45833333333332,1014.166666666665,29.828431372548973,0
342,4,1,0,34,0.029411764705882353,0.0,1.0,34,650,300,350,0.46153846153846156,10,3,7,361.5774572818534,0.43551322043969104,0.10531776287217132,0.19944023548713968,128989.67013888864,2527.9513888888546,131517.6215277775,330,0,144.58823529411765,34,0,19,36.85910582444626,0.6142769607843137,46.04166666666665,1015.8333333333313,29.877450980392098,0
343,4,1,1,34,0.02857142857142857,0.02857142857142857,0.9714285714285714,35,800,600,200,0.75,10,6,4,352.8978330165913,0.4377450980392157,0.10022410275278482,0.19599826330479303,129261.91184807225,2123.423327664359,131385.3351757366,331,0,141.42857142857142,34,1,21,36.80222235229844,0.6170343137254901,45.773809523809504,1016.9047619047594,29.9089635854341,0
344,4,2,1,35,0.05555555555555555,0.027777777777777776,0.9722222222222222,36,600,400,200,0.6666666666666666,8,4,4,360.35761634908386,0.43875661375661373,0.15434987126163624,0.19253392644936768,127717.3119065011,2004.7812170278407,129722.09312352893,332,0,138.19444444444446,36,0,18,38.19096293820559,0.5972222222222222,47.2972972972973,1010.8108108108108,28.07807807807808,8
345,4,2,0,37,0.05405405405405406,0.0,1.0,37,1100,600,500,0.5454545454545454,16,6,10,352.8749994945844,0.44087837837837834,0.1612425279722065,0.1908241052588573,128201.5477259353,1648.537557828088,129850.0852837634,333,0,135.3783783783784,36,1,21,37.884558360206086,0.6021412037037037,46.81869369369369,1012.7252252252246,28.131256256256236,0
346,4,0,1,36,0.0,0.02702702702702703,0.972972972972973,37,1100,900,200,0.8181818181818182,13,9,4,349.76589565719735,0.44097222222222227,0.1619758931897659,0.18954783116458707,128287.09621783938,1574.0902219787254,129861.1864398181,334,1,136.3783783783784,36,1,21,37.87586149399732,0.6030092592592593,46.73423423423423,1013.0630630630625,28.140640640640626,0
347,4,1,0,37,0.02702702702702703,0.0,1.0,37,950,800,150,0.8421052631578947,11,8,3,354.7038968415441,0.4390953453453454,0.17984799548549013,0.1933265064867591,128515.36502718917,1716.9801558314848,130232.34518302065,335,0,137.21621621621622,36,1,18,37.51758477713609,0.6053240740740741,46.509009009009,1013.9639639639624,28.165665665665625,0
348,4,0,1,36,0.0,0.02702702702702703,0.972972972972973,37,1200,800,400,0.6666666666666666,16,8,8,355.6792220954829,0.4389702202202202,0.17946402047656673,0.1942754853495458,128601.01814229762,1748.1420187078897,130349.16016100551,336,1,138.21621621621622,36,1,18,37.40539765367678,0.6061921296296297,46.424549549549546,1014.301801801801,28.17505005005003,0
349,4,0,0,36,0.0,0.0,1.0,36,950,500,450,0.5263157894736842,14,5,9,364.54953690677206,0.43683862433862436,0.17984993213329847,0.1984517957592547,128466.9994882755,2166.5170342506403,130633.51652252614,337,2,142.97222222222223,35,1,19,37.317449670814774,0.606845238095238,46.55671296296294,1013.773148148145,28.964947089947,0
350,4,2,0,38,0.05263157894736842,0.0,1.0,38,750,500,250,0.6666666666666666,10,5,5,361.9853319988072,0.4376778093883357,0.20590319446825567,0.1922655656118229,127479.2784799166,1629.125788704182,129108.40426862078,338,0,136.39473684210526,37,1,15,38.39395584509589,0.5929054054054055,47.53289473684209,1009.8684210526291,27.293741109530515,7
351,4,0,0,38,0.0,0.0,1.0,38,1250,1000,250,0.8,15,10,5,362.4773647881384,0.43800379326695116,0.2010688557930156,0.1929233946732014,127562.3403956024,1647.6921985610818,129210.03259416348,339,1,137.39473684210526,37,1,15,38.29631589420744,0.59375,47.450657894736835,1010.1973684210518,27.302631578947345,0
352,4,1,1,38,0.02564102564102564,0.02564102564102564,0.9743589743589743,39,1400,1000,400,0.7142857142857143,18,10,8,357.0877732642945,0.4399460188933873,0.19746487187610895,0.19179036443786743,127928.27641034764,1336.3246721820346,129264.60108252967,340,0,134.84615384615384,38,1,17,38.05752103354807,0.5956688596491229,47.08867521367521,1011.6452991452984,26.622244714349957,0
353,4,0,0,38,0.0,0.0,1.0,38,750,600,150,0.8,9,6,3,367.42080274710924,0.43861130867709813,0.20511943056601156,0.19758503308568337,127978.05574792258,1804.359995383212,129782.4157433058,341,1,139.18421052631578,37,1,19,37.745177719982664,0.597972972972973,47.039473684210535,1011.842105263159,27.347083926031324,0
354,4,2,2,38,0.05,0.05,0.95,40,1000,700,300,0.7,13,7,6,360.4065919600896,0.44174679487179486,0.23041440142017056,0.19770813227853282,128772.40997331822,1282.4097025078152,130054.81967582603,342,0,133.175,36,4,15,37.11051629128296,0.6079282407407407,46.25563063063065,1014.9774774774801,28.19381881881889,0
355,4,1,2,37,0.02564102564102564,0.05128205128205128,0.9487179487179487,39,1050,800,250,0.7619047619047619,13,8,5,375.93610993609593,0.4389901034637877,0.25203106383099705,0.20682220276350094,128886.73460200077,1890.6355257284474,130777.37012772921,343,0,137.02564102564102,36,3,16,36.599617389375624,0.6090856481481481,46.143018018018026,1015.427927927929,28.20633133133136,0
356,4,3,0,40,0.075,0.0,1.0,40,1600,1100,500,0.6875,21,11,10,369.45873845330806,0.4394497863247863,0.25365574560346893,0.2058554662174069,129388.34372597079,1562.2653223748846,130950.60904834566,344,0,131.825,33,7,20,36.2523086806392,0.6205808080808081,45.64950980392157,1017.4019607843138,30.83036244800951,0
357,4,1,1,40,0.024390243902439025,0.024390243902439025,0.975609756097561,41,900,400,500,0.4444444444444444,14,4,10,362.45248221611655,0.44136178861788616,0.2483914409696244,0.20372329172836895,129731.4453125,1204.2968750000002,130935.7421875,345,0,129.58536585365854,35,6,17,36.08128834355828,0.6196428571428572,45.3125,1018.75,29.107142857142858,0
358,4,0,3,37,0.0,0.075,0.925,40,1600,1400,200,0.875,18,14,4,360.7867870577355,0.44043803418803423,0.12828240894497966,0.20080018776910233,129344.54038075256,1334.2452989307108,130678.78567968326,346,1,133.8,36,4,16,36.517491420347625,0.6137152777777778,45.69256756756758,1017.2297297297313,28.256381381381424,8
359,4,1,0,38,0.02631578947368421,0.0,1.0,38,1400,800,600,0.5714285714285714,20,8,12,363.5392155490082,0.43764817449027976,0.1486940574073159,0.2034677599067483,129564.73922902481,1820.372732426286,131385.1119614511,347,0,132.89473684210526,34,4,16,36.22325187090739,0.6200980392156863,45.47619047619047,1018.095238095237,29.943977591036383,0
360,4,1,3,36,0.02564102564102564,0.07692307692307693,0.9230769230769231,39,950,600,350,0.631578947368421,13,6,7,356.27649484944845,0.4387370670265407,0.14431261622272884,0.2016154268541097,129996.88042534713,1462.9665798611022,131459.84700520823,348,0,130.46153846153845,35,4,17,35.96888832141641,0.6223214285714286,45.05208333333333,1019.7916666666658,29.136904761904738,0
361,4,0,1,35,0.0,0.027777777777777776,0.9722222222222222,36,1050,700,350,0.6666666666666666,14,7,7,375.5771600889446,0.4363095238095238,0.15951846507402045,0.2116056682452345,129825.097318339,2551.8682718185146,132376.96559015752,349,1,133.91666666666666,33,3,18,35.651655443322106,0.625,45.22058823529411,1019.1176470588227,30.882352941176446,0
362,4,0,0,35,0.0,0.0,1.0,35,1300,1100,200,0.8461538461538461,15,11,4,386.6975772861762,0.4336484593837535,0.1754090233019343,0.21726156361733082,129715.36705438221,3032.1236353433374,132747.49068972556,350,2,138.6,32,3,18,35.48018922492152,0.6263020833333333,45.32828282828283,1018.6868686868687,31.833964646464647,0
363,4,0,0,35,0.0,0.0,1.0,35,900,600,300,0.6666666666666666,12,6,6,390.3150703409852,0.4328781512605042,0.1725613749402628,0.21983481735674057,129811.85154894913,3133.504393684325,132945.35594263344,351,3,139.6,32,3,18,35.28966877297321,0.6272786458333333,45.23358585858586,1019.0656565656568,31.845801767676775,0
364,4,0,0,35,0.0,0.0,1.0,35,1250,1000,250,0.8,15,10,5,391.1983053609255,0.4321778711484594,0.17577355152587337,0.22105852454789893,129940.5533395828,3166.5048528211546,133107.05819240396,352,4,140.6,32,3,18,35.1359649122807,0.6285807291666667,45.10732323232324,1019.5707070707078,31.86158459595962,0
365,4,0,0,35,0.0,0.0,1.0,35,1050,800,250,0.7619047619047619,13,8,5,390.4562684911244,0.4322829131652661,0.17549450549450563,0.2206926734949834,129950.01922337565,3147.959919261829,133097.9791426375,353,5,141.6,33,2,18,35.145232371794876,0.6262626262626263,45.09803921568628,1019.6078431372551,30.89720736779561,0
366,4,0,0,35,0.0,0.0,1.0,35,1150,1000,150,0.8695652173913043,13,10,3,395.4244369628869,0.43214285714285716,0.1683291958173474,0.22549880053829494,130296.8912591051,3305.641342494741,133602.53260159984,354,6,142.6,30,5,19,34.66517465332631,0.6375,44.75806451612903,1020.9677419354839,34.03225806451613,0
367,4,1,0,36,0.027777777777777776,0.0,1.0,36,1250,800,450,0.64,17,8,9,383.3446090431624,0.43230820105820106,0.1641663579865824,0.22097565755448925,130714.10323245087,2821.709360014296,133535.81259246517,355,0,139.61111111111111,32,4,18,34.5495328641396,0.6363932291666667,44.34974747474748,1022.601010101011,31.956281565656592,0
368,4,1,0,37,0.02702702702702703,0.0,1.0,37,1250,800,450,0.64,17,8,9,378.25699876314593,0.43427802802802806,0.1839332362101882,0.22119811449410054,131267.12018140592,2530.5413832199565,133797.6615646259,356,0,136.8108108108108,34,3,19,34.11893974597273,0.6372549019607843,43.80952380952381,1024.7619047619048,30.140056022408967,0
369,4,0,0,37,0.0,0.0,1.0,37,1000,800,200,0.8,12,8,4,377.80118012802944,0.4337775275275275,0.18454657095218607,0.22184550859144808,131425.20732897156,2530.5480301624802,133955.75535913405,357,1,137.8108108108108,32,5,19,33.97057012683168,0.6435546875,43.65530303030303,1025.378787878788,32.043087121212125,0
370,4,0,0,37,0.0,0.0,1.0,37,800,600,200,0.75,10,6,4,379.4081325859807,0.4336836836836837,0.18320092618467787,0.22335591805279045,131522.32552800738,2580.1279843893517,134102.45351239672,358,2,138.8108108108108,32,5,19,33.831086903003445,0.64453125,43.56060606060606,1025.757575757576,32.05492424242425,0
371,4,0,1,36,0.0,0.02702702702702703,0.972972972972973,37,850,500,350,0.5882352941176471,12,5,7,379.5927100591712,0.4334021521521521,0.18531392931392898,0.22365415295364535,131554.7062321448,2587.441491939607,134142.14772408438,359,3,139.8108108108108,32,5,17,33.793589743589735,0.6448567708333333,43.52904040404041,1025.8838383838392,32.05886994949498,0
372,4,0,0,36,0.0,0.0,1.0,36,1050,700,350,0.6666666666666666,14,7,7,379.3049500597056,0.43206018518518513,0.1762442958718029,0.2243685213065039,131705.23356401388,2791.289407920032,134496.5229719339,360,4,141.19444444444446,33,3,17,33.64871856096784,0.6439393939393939,43.38235294117647,1026.4705882352944,31.105169340463465,0
373,4,0,0,36,0.0,0.0,1.0,36,900,600,300,0.6666666666666666,12,6,6,380.68590217498917,0.43151455026455027,0.1787021564414739,0.22555774316987676,131768.13755526708,2832.454464628974,134600.59201989605,361,5,142.19444444444446,33,3,17,33.549673748706944,0.6445707070707071,43.32107843137254,1026.7156862745087,31.112596553772992,0
374,4,0,1,35,0.0,0.027777777777777776,0.9722222222222222,36,900,800,100,0.8888888888888888,10,8,2,363.4561581793318,0.43176256613756614,0.059361508748011715,0.20428742683872786,129731.4453125,2230.3385416666674,131961.78385416666,362,6,143.19444444444446,35,1,17,36.05572597137014,0.6196428571428572,45.3125,1018.75,29.107142857142858,8
375,4,0,0,35,0.0,0.0,1.0,35,1000,600,400,0.6,14,6,8,369.71504294452814,0.43119747899159666,0.07017965671542137,0.20756442962161276,129685.96938775493,2589.3707482992995,132275.34013605423,363,7,148.0857142857143,34,1,17,35.942613370733994,0.6213235294117647,45.35714285714285,1018.5714285714271,29.95798319327727,0
376,4,0,2,33,0.0,0.05714285714285714,0.9428571428571428,35,1300,1000,300,0.7692307692307693,16,10,6,389.00595757243684,0.4313025210084034,0.09010722093063595,0.20558889952833415,127277.4368632257,2930.4010084425954,130207.8378716683,364,8,149.0857142857143,33,2,21,37.919500445308074,0.5991161616161615,47.7328431372549,1009.0686274509806,30.57783719548426,8
377,4,2,0,35,0.05714285714285714,0.0,1.0,35,400,100,300,0.25,7,1,6,405.7902230659708,0.43609943977591037,0.09169435215946886,0.20702179176755445,125834.72222222216,3212.499999999995,129047.22222222216,365,0,148.9142857142857,34,1,16,38.98809523809525,0.5821078431372548,49.166666666666664,1003.3333333333328,29.50980392156861,8
378,4,2,2,35,0.05405405405405406,0.05405405405405406,0.9459459459459459,37,1200,1000,200,0.8333333333333334,14,10,4,384.36399472250673,0.4397522522522523,0.08192402322912185,0.19891237344513757,126421.84452428408,2318.574647419406,128740.41917170348,366,0,141.8108108108108,35,2,14,38.918580005370764,0.5860119047619048,48.582175925925924,1005.671296296296,28.7334656084656,0
379,4,2,1,36,0.05405405405405406,0.02702702702702703,0.972972972972973,37,1150,900,250,0.782608695652174,14,9,5,385.2140334758848,0.44175425425425424,0.08984551098895976,0.19992033391079791,126538.26845689728,2348.8633562671434,128887.13181316442,367,0,142.75675675675674,35,2,15,38.777009279496916,0.587202380952381,48.46643518518518,1006.1342592592591,28.746693121693117,0
380,4,2,1,37,0.05263157894736842,0.02631578947368421,0.9736842105263158,38,900,600,300,0.6666666666666666,12,6,6,375.7945242061201,0.44196005215742057,0.0975031475402115,0.19659987213730729,126865.01323959103,1935.0354577550584,128800.0486973461,368,0,139.94736842105263,36,2,17,38.67720210149786,0.5885416666666667,48.141891891891895,1007.4324324324332,27.984234234234254,0
381,4,1,0,38,0.02631578947368421,0.0,1.0,38,1150,700,450,0.6086956521739131,16,7,9,370.7104326867899,0.44188596491228066,0.10604541308510562,0.19516616314199392,127121.19187510716,1825.2333143445921,128946.42518945175,369,0,140.1315789473684,35,3,19,38.54166666666667,0.5931547619047619,47.88773148148148,1008.449074074074,28.812830687830687,0
382,4,2,1,39,0.05,0.025,0.975,40,1000,600,400,0.6,14,6,8,352.7034548262767,0.4433627136752137,0.11633812493393925,0.1884205186962961,127712.20419908321,1008.9071288991136,128721.11132798232,370,0,134.075,38,2,17,38.38961702427507,0.5934758771929824,47.302350427350426,1010.7905982905984,26.599752586594693,0
383,4,0,1,38,0.0,0.02564102564102564,0.9743589743589743,39,950,600,350,0.631578947368421,13,6,7,360.12117456078107,0.443544759334233,0.11357892893185095,0.19299230639012716,127839.40882050266,1407.5356119190733,129246.94443242173,371,1,136.71794871794873,37,2,19,38.07182677364558,0.5965653153153153,47.17653508771931,1011.2938596491244,27.332266477003362,0
384,4,1,1,38,0.02564102564102564,0.02564102564102564,0.9743589743589743,39,1100,900,200,0.8181818181818182,13,9,4,359.9677278774276,0.44298245614035087,0.12063978929294805,0.1937109131533982,128005.79415060405,1415.5909751077304,129421.38512571178,372,0,137.6153846153846,37,2,20,37.905312059811486,0.5982545045045045,47.012061403508774,1011.951754385965,27.350047415836894,0
385,4,2,0,40,0.05,0.0,1.0,40,1500,900,600,0.6,21,9,12,351.58205837894536,0.4454861111111111,0.13609670448406308,0.19265198047940416,128728.04763244456,1051.7695348568784,129779.81716730144,373,0,127.825,37,3,18,37.37968215379074,0.6055743243243243,46.29934210526316,1014.8026315789471,27.427098150782353,0
386,4,0,1,39,0.0,0.025,0.975,40,1250,900,350,0.72,16,9,7,354.7893723263571,0.44463141025641023,0.14074174044482834,0.19536618112287257,128922.84765504759,1148.0912396121728,130070.93889465976,374,1,128.825,37,3,18,37.09961851292016,0.607545045045045,46.10745614035087,1015.5701754385956,27.4478425794215,0
387,4,0,0,39,0.0,0.0,1.0,39,850,400,450,0.47058823529411764,13,4,9,360.09340596775974,0.4434604138551507,0.13629510789484156,0.19767856037718562,128800.98637488855,1476.0771751481373,130277.06355003669,375,2,133.07692307692307,36,3,18,37.089296279860946,0.6082175925925926,46.227477477477485,1015.0900900900914,28.196946946946984,0
388,4,2,1,40,0.04878048780487805,0.024390243902439025,0.975609756097561,41,1600,1100,500,0.6875,21,11,10,347.25473945112583,0.445630081300813,0.14014887731632397,0.19357745177646438,129407.39300679418,789.3303036010906,130196.72331039527,376,0,127.53658536585365,35,6,20,36.797695559852876,0.6163690476190475,45.630787037037024,1017.4768518518499,29.07076719576714,0
389,4,0,1,39,0.0,0.025,0.975,40,1050,800,250,0.7619047619047619,13,8,5,346.4279038945998,0.4439102564102564,0.16539191603394365,0.1825063710164727,127148.79575521465,809.5781592403215,127958.37391445498,377,1,131.575,36,4,19,39.125539675450355,0.5914351851851851,47.86036036036036,1008.5585585585584,28.01551551551551,8
390,4,1,1,39,0.025,0.025,0.975,40,1100,800,300,0.7272727272727273,14,8,6,346.7822678543744,0.4424412393162393,0.179686976899899,0.18333427151876425,127290.8059030316,828.4388696128751,128119.24477264448,378,0,132.525,36,4,20,38.97095748242382,0.5928819444444444,47.719594594594604,1009.1216216216233,28.0311561561562,0
391,4,2,1,40,0.04878048780487805,0.024390243902439025,0.975609756097561,41,1100,500,600,0.45454545454545453,17,5,12,344.1641971750382,0.4438770325203252,0.20018352845352183,0.1844408129311665,127839.40882050237,599.5495008079326,128438.9583213103,379,0,130.1951219512195,37,4,17,38.475256604864654,0.5965653153153153,47.176535087719294,1011.293859649122,27.332266477003298,0
392,4,1,0,41,0.024390243902439025,0.0,1.0,41,1150,700,450,0.6086956521739131,16,7,9,346.0345906914919,0.4453506097560975,0.20617646514603272,0.1859558047938494,127950.32035097336,655.0473462988614,128605.36769727222,380,0,131.14634146341464,37,4,19,38.31452530616669,0.5976914414414414,47.06688596491228,1011.7324561403507,27.344120436225694,0
393,4,1,0,42,0.023809523809523808,0.0,1.0,42,1350,700,650,0.5185185185185185,20,7,13,340.8663314825623,0.4458599496709253,0.20843315147112595,0.1852220753611595,128394.44739006225,353.2161338103923,128747.66352387264,381,0,129.0,37,5,18,37.99170092682749,0.6021959459459459,46.628289473684205,1013.4868421052627,27.391536273115207,0
394,4,0,2,40,0.0,0.047619047619047616,0.9523809523809523,42,1650,1400,250,0.8484848484848485,19,14,5,344.87864578968197,0.4451219512195122,0.21096968199044364,0.18805646911927915,128533.39489073533,465.6846337334265,128999.07952446876,382,1,130.0,37,5,18,37.748251874279134,0.6036036036036037,46.491228070175424,1014.035087719296,27.406353722143137,0
395,4,1,1,40,0.024390243902439025,0.024390243902439025,0.975609756097561,41,1450,1100,350,0.7586206896551724,18,11,7,346.04529061967025,0.4436229674796748,0.2007551305933284,0.1898838918355828,128783.68975309689,712.9978695367545,129496.68762263365,383,0,125.14634146341463,37,4,20,37.463428576572674,0.6061373873873874,46.24451754385964,1015.0219298245596,27.433025130393503,0
396,4,0,0,40,0.0,0.0,1.0,40,1550,1100,450,0.7096774193548387,20,11,9,354.72381151835765,0.4411324786324786,0.20900621118012408,0.19501157833228722,128858.1486892297,1141.8107296485591,129999.95941887825,384,1,129.2,36,4,20,37.16725820763087,0.6087962962962963,46.17117117117117,1015.3153153153148,28.203203203203188,0
397,4,0,0,40,0.0,0.0,1.0,40,1300,1000,300,0.7692307692307693,16,10,6,356.39177277391195,0.44127938034188036,0.2086660013306716,0.1962112946810219,128915.32368517164,1188.8721491761992,130104.19583434783,385,2,130.2,36,4,20,37.066607525689356,0.609375,46.11486486486486,1015.5405405405404,28.209459459459456,0
398,4,0,0,40,0.0,0.0,1.0,40,1350,1000,350,0.7407407407407407,17,10,7,368.02660707628576,0.44204059829059833,0.19419946482327988,0.19566275274850092,127518.18700034512,1386.33418046427,128904.52118080939,386,3,131.2,36,4,15,38.20149031850449,0.5951967592592593,47.49436936936938,1010.022522522524,28.056181181181223,8
399,4,1,0,41,0.024390243902439025,0.0,1.0,41,800,500,300,0.625,11,5,6,359.3064218391927,0.44410569105691056,0.1974760686767476,0.19229045361457928,127783.97108966237,982.7202841259007,128766.69137378827,387,0,128.97560975609755,37,4,16,38.149220077359644,0.5960022522522522,47.231359649122815,1011.0745614035102,27.326339497392166,0
400,4,0,0,41,0.0,0.0,1.0,41,1500,1200,300,0.8,18,12,6,355.87185059129445,0.4444867886178862,0.19410161588339636,0.1912422577405868,127950.32035097349,906.7834574099868,128857.10380838347,388,1,129.97560975609755,37,4,17,38.06570842816373,0.5976914414414414,47.06688596491229,1011.7324561403517,27.344120436225722,0
401,4,0,0,41,0.0,0.0,1.0,41,1250,900,350,0.72,16,9,7,356.88727926975423,0.44400406504065043,0.19115906497019908,0.1924522991949983,128089.02739304397,942.6688981224945,129031.69629116647,389,2,130.97560975609755,37,4,17,37.898071923743494,0.5990990990990991,46.92982456140351,1012.2807017543856,27.358937885253667,0
402,4,3,2,42,0.06818181818181818,0.045454545454545456,0.9545454545454546,44,1250,1100,150,0.88,14,11,3,337.2150957514678,0.44823599365750527,0.20046070056328547,0.18550636305786183,128883.87586805574,-107.67026873651511,128776.20559931922,390,0,122.97727272727273,39,5,14,37.585487621392424,0.6036324786324787,46.14583333333334,1015.4166666666681,26.036324786324823,0
403,4,0,2,40,0.0,0.047619047619047616,0.9523809523809523,42,1300,1000,300,0.7692307692307693,16,10,6,335.62311201821666,0.44497677119628337,0.1644308464736799,0.1802860433584581,127933.68055555563,440.01736111111654,128373.69791666674,391,1,129.42857142857142,39,3,17,38.59486545853925,0.594017094017094,47.083333333333336,1011.6666666666673,25.940170940170958,8
404,4,2,0,42,0.047619047619047616,0.0,1.0,42,1550,1100,450,0.7096774193548387,20,11,9,329.04946769999447,0.4473480449090205,0.19670700138462527,0.17950215789703114,128550.50131492416,60.24202827085196,128610.743343195,392,0,129.02380952380952,38,4,17,38.132111251580284,0.6019736842105263,46.474358974358964,1014.1025641025622,26.686909581646372,0
405,4,0,1,41,0.0,0.023809523809523808,0.9761904761904762,42,1250,1100,150,0.88,14,11,3,329.54437783939886,0.44683991482771973,0.19514482288281765,0.180262293315837,128658.8684345094,79.76135035429047,128738.62978486369,393,1,130.02380952380952,38,4,17,38.00920563044089,0.6030701754385965,46.36752136752136,1014.529914529914,26.698155645524054,0
406,4,1,0,42,0.023809523809523808,0.0,1.0,42,1350,1000,350,0.7407407407407407,17,10,7,328.0432268032062,0.4473601432442896,0.20173586676049715,0.17998047308392137,128778.12500000001,48.958333333333826,128827.08333333334,394,0,130.66666666666666,39,3,18,37.92590311986862,0.6025641025641026,46.25,1015.0000000000001,26.02564102564103,0
407,4,2,0,44,0.045454545454545456,0.0,1.0,44,1200,800,400,0.6666666666666666,16,8,8,321.84151690763736,0.4475753171247357,0.22547942469037152,0.17941410174160707,129408.11107806192,-469.5250016524643,128938.58607640945,395,0,125.68181818181819,40,4,20,37.44340125183113,0.6072916666666667,45.630081300813,1017.4796747967473,25.436991869918682,0
408,4,0,0,44,0.0,0.0,1.0,44,1400,1100,300,0.7857142857142857,17,11,6,318.69254721388336,0.4467714940098661,0.21868411261317178,0.17832186038761538,129554.63927469113,-542.3804012345909,129012.25887345654,396,1,126.68181818181819,41,3,17,37.37494315597999,0.6072154471544715,45.4861111111111,1018.0555555555536,24.830623306233015,0
409,4,0,0,44,0.0,0.0,1.0,44,1750,1200,550,0.6857142857142857,23,12,11,313.188720354967,0.4463420542635659,0.21095928611266057,0.17603366006158455,129731.44531249971,-673.9149305555852,129057.53038194412,397,2,127.68181818181819,41,3,17,37.33597477845944,0.6089939024390244,45.312499999999986,1018.7499999999977,24.8475609756097,0
410,4,0,2,42,0.0,0.045454545454545456,0.9545454545454546,44,1250,1000,250,0.8,15,10,5,314.8558539681758,0.4463530655391121,0.2127777286005137,0.177084864197873,129756.71315980068,-629.0678539934818,129127.6453058072,398,3,128.6818181818182,41,3,17,37.26793248945145,0.6092479674796748,45.2876984126984,1018.8492063492041,24.849980642663514,0
411,4,1,0,43,0.023255813953488372,0.0,1.0,43,1000,600,400,0.6,14,6,8,323.5135164643202,0.4460594315245478,0.22777657031080212,0.1821891908509591,129807.25623582758,-201.1196145124798,129606.13662131509,399,0,129.72093023255815,41,2,18,36.99620327102804,0.6097560975609756,45.238095238095234,1019.0476190476184,24.85481997677118,0
412,4,0,1,42,0.0,0.023255813953488372,0.9767441860465116,43,1450,1100,350,0.7586206896551724,18,11,7,320.66464224992404,0.44552879291251385,0.2205817121855398,0.18105219031649541,129908.3719135802,-268.5956790123521,129639.77623456785,400,1,130.72093023255815,41,2,18,36.96639418710264,0.6107723577235773,45.138888888888886,1019.444444444444,24.86449864498644,0
413,4,0,0,42,0.0,0.0,1.0,42,1100,900,200,0.8181818181818182,13,9,4,330.45813615782725,0.4433918892760356,0.18829469557090484,0.1780111001634089,128046.43956380294,62.79755198001766,128109.23711578296,401,2,134.64285714285714,42,0,18,38.61037976703365,0.5905257936507937,46.97189922480619,1012.1124031007726,24.097914359542205,8
414,4,1,1,42,0.023255813953488372,0.023255813953488372,0.9767441860465116,43,1600,1200,400,0.75,20,12,8,323.56948145616,0.44296788482835,0.18931475533805897,0.17577871017988947,128384.34504849622,-291.74880911387777,128092.59623938234,402,0,132.48837209302326,43,0,11,38.44024481405344,0.5925387596899225,46.63825757575757,1013.4469696969688,23.568534178999275,0
415,4,0,1,41,0.0,0.023809523809523808,0.9761904761904762,42,1150,700,450,0.6086956521739131,16,7,9,331.084691489997,0.44296844754161824,0.18509661373636876,0.17933468211587672,128267.19867345683,93.46118021750243,128360.65985367434,403,4,136.64285714285714,42,0,18,38.36928448440784,0.5927579365079365,46.75387596899223,1012.9844961240287,24.11867847914354,0
416,4,0,0,41,0.0,0.0,1.0,41,1250,900,350,0.72,16,9,7,335.47802853815705,0.44214939024390243,0.18771128979888085,0.1823001882737132,128395.77034517495,414.79198160744073,128810.5623267824,404,5,140.4390243902439,41,0,12,38.126876141999475,0.5955284552845528,46.62698412698412,1013.4920634920622,24.719318621757616,0
417,4,0,1,40,0.0,0.024390243902439025,0.975609756097561,41,1200,1000,200,0.8333333333333334,14,10,4,366.62632697073974,0.44192073170731705,0.23040653868322858,0.18738235666828745,125909.7690207463,1039.9258081492192,126949.69482889552,405,6,141.4390243902439,38,3,15,39.892928110141206,0.575109649122807,49.09188034188033,1003.6324786324762,26.41138101664411,8
418,4,2,0,42,0.047619047619047616,0.0,1.0,42,650,300,350,0.46153846153846156,10,3,7,357.8046903599619,0.44594463801780876,0.23445341479380377,0.18445656871987634,126264.14497730027,635.7233378615556,126899.86831516182,406,0,138.71428571428572,37,5,18,39.74879991272091,0.5805180180180181,48.73903508771927,1005.0438596491192,27.163347558084304,0
419,4,3,2,43,0.06666666666666667,0.044444444444444446,0.9555555555555556,45,1350,1100,250,0.8148148148148148,16,11,5,342.11014356857277,0.45092592592592595,0.2462343384276484,0.1804463306273446,127197.07031249952,-294.21324349804473,126902.85706900147,407,0,130.4,39,6,18,39.1849098168801,0.5865384615384616,47.81249999999998,1008.7499999999961,25.865384615384517,0
420,4,1,1,43,0.022727272727272728,0.022727272727272728,0.9772727272727273,44,1550,1200,350,0.7741935483870968,19,12,7,342.23171710463123,0.45082364341085274,0.24339388934764772,0.18097930542083293,127302.17013888848,-86.63194444448419,127215.538194444,408,0,131.77272727272728,39,5,19,39.07411230388109,0.5876068376068376,47.708333333333314,1009.1666666666633,25.87606837606829,0
421,4,0,1,42,0.0,0.023255813953488372,0.9767441860465116,43,1300,900,400,0.6923076923076923,17,9,8,345.203385244708,0.4499815430047988,0.250599788874317,0.18318457012620595,127442.37075617252,198.7075617283612,127641.07831790087,409,1,134.90697674418604,38,5,16,38.85545621274646,0.590734649122807,47.56944444444443,1009.7222222222196,26.571637426900516,0
422,4,0,1,41,0.0,0.023809523809523808,0.9761904761904762,42,1400,1000,400,0.7142857142857143,18,10,8,343.9662030714527,0.44934427022841655,0.2382160986221904,0.1831387621758813,127577.25180802082,376.45258053909384,127953.70438855991,410,2,135.8095238095238,38,4,16,38.748545896785096,0.5921052631578947,47.435897435897424,1010.2564102564086,26.585695006747596,0
423,4,1,0,42,0.023809523809523808,0.0,1.0,42,1350,800,550,0.5925925925925926,19,8,11,342.7498308077382,0.4502032520325203,0.24611678588600094,0.18339194365049083,127775.6564670138,359.0169270833224,128134.67339409713,411,0,136.71428571428572,39,3,17,38.576224328593995,0.5924145299145299,47.23958333333333,1011.041666666666,25.92414529914528,0
424,4,0,0,42,0.0,0.0,1.0,42,800,600,200,0.75,10,6,4,344.7133396113759,0.4489329268292683,0.24886991461577201,0.18519273048198806,127938.8211898503,420.4436636591673,128359.26485350948,412,1,137.71428571428572,40,2,17,38.35970199229867,0.5924479166666667,47.07825203252031,1011.6869918699161,25.292174796747904,0
425,4,0,1,41,0.0,0.023809523809523808,0.9761904761904762,42,1400,1200,200,0.8571428571428571,16,12,4,344.73843436194363,0.4480860433604336,0.24572933741584957,0.1866760642811041,128255.57503270243,443.42096365761114,128698.99599636004,413,2,138.71428571428572,37,5,19,38.03537923071372,0.6007882882882882,46.765350877192986,1012.9385964912285,27.376718824087256,0
426,4,2,0,43,0.046511627906976744,0.0,1.0,43,1450,1100,350,0.7586206896551724,18,11,7,334.97324094655187,0.4506506090808416,0.24338118988326674,0.18323495147229749,128659.52934967625,19.499904983821153,128679.02925466007,414,0,134.62790697674419,40,3,15,37.87083875922403,0.5997395833333333,46.366869918699194,1014.5325203252042,25.363313008130106,0
427,4,1,0,44,0.022727272727272728,0.0,1.0,44,1150,900,250,0.782608695652174,14,9,5,332.84370371560465,0.4515283650458069,0.25658864479923316,0.18340440466309796,128949.36244173597,-216.0033226253413,128733.35911911062,415,0,132.54545454545453,41,3,16,37.62982678908641,0.6011178861788617,46.08134920634921,1015.6746031746034,24.772551296941547,0
428,4,1,0,45,0.022222222222222223,0.0,1.0,45,1100,700,400,0.6363636363636364,15,7,8,327.8770064448288,0.4523779461279461,0.2601106675071798,0.1820731241156287,129255.70371283495,-523.0211701709143,128732.68254266403,416,0,130.57777777777778,38,7,18,37.44462246970651,0.6091008771929824,45.77991452991452,1016.8803418803404,26.760008996851063,0
429,4,0,1,44,0.0,0.022222222222222223,0.9777777777777777,45,1300,1000,300,0.7692307692307693,16,10,6,327.7428586680316,0.45113636363636367,0.25902201687143456,0.18262698906352612,129391.54071015025,-518.56931203889,128872.97139811136,417,1,131.57777777777778,38,7,18,37.31010885925303,0.6104714912280702,45.64636752136751,1017.414529914528,26.774066576698104,0
430,4,1,3,42,0.022222222222222223,0.06666666666666667,0.9333333333333333,45,1200,800,400,0.6666666666666666,16,8,8,329.3891671841942,0.4528409090909091,0.2739551738631587,0.18526483290561277,129757.97661675356,-451.82562934027186,129306.15098741329,418,0,131.57777777777778,39,6,14,36.89647019732132,0.6124465811965811,45.286458333333336,1018.8541666666673,26.124465811965827,0
431,4,0,1,41,0.0,0.023809523809523808,0.9761904761904762,42,1150,800,350,0.6956521739130435,15,8,7,351.50064533358653,0.4494652535811072,0.2787444251114979,0.19600071113331832,129418.71667031922,698.1524855723579,130116.86915589157,419,1,136.33333333333334,38,4,18,36.67817268654626,0.6107456140350878,45.61965811965812,1017.5213675213673,26.776878092667562,0
432,4,0,0,41,0.0,0.0,1.0,41,1450,900,550,0.6206896551724138,20,9,11,356.6627782975462,0.4488313008130081,0.2758885242628146,0.19933176224780974,129508.13140822173,1038.1459920360094,130546.27740025774,420,2,134.6341463414634,37,4,15,36.455864663004064,0.6134572072072072,45.531798245614034,1017.8728070175436,27.510075865339015,0
433,4,0,0,41,0.0,0.0,1.0,41,1350,1100,250,0.8148148148148148,16,11,5,358.1819908283213,0.44888211382113824,0.27724925537000367,0.2006078387715193,129591.85157933201,1083.493478762685,130675.3450580947,421,3,135.6341463414634,37,4,16,36.33202311723742,0.6143018018018018,45.44956140350877,1018.2017543859641,27.51896633475579,0
434,4,0,0,41,0.0,0.0,1.0,41,1350,900,450,0.6666666666666666,18,9,9,355.36549062641063,0.4488567073170732,0.2706596265267285,0.19960477500492063,129704.91672092008,1018.5302734374953,130723.44699435758,422,4,136.6341463414634,39,2,16,36.288752258240464,0.6119123931623931,45.338541666666664,1018.6458333333328,26.119123931623918,0
435,4,0,1,40,0.0,0.024390243902439025,0.975609756097561,41,1200,800,400,0.6666666666666666,16,8,8,360.4161857048999,0.4488058943089431,0.23896414199020044,0.1941002005220306,128036.38100162544,1039.3706729199798,129075.75167454542,423,5,137.6341463414634,38,3,18,37.86265350645694,0.596765350877193,46.98183760683761,1012.07264957265,26.633490778227632,8
436,4,1,1,40,0.024390243902439025,0.024390243902439025,0.975609756097561,41,1100,1000,100,0.9090909090909091,12,10,2,362.6374304804952,0.44939024390243903,0.2479930226013105,0.19654275102140992,128291.05748724689,1104.7648594509424,129395.82234669782,424,0,137.6341463414634,35,6,19,37.545817624433525,0.6050595238095238,46.73032407407406,1013.0787037037021,28.945105820105773,0
437,4,0,0,40,0.0,0.0,1.0,40,1000,800,200,0.8,12,8,4,372.444942771413,0.4468082264957265,0.2575205640423033,0.2018793925467977,128295.24518140583,1556.5830498866173,129851.82823129244,425,1,141.675,34,6,20,37.29313552683118,0.6072303921568627,46.726190476190474,1013.0952380952376,29.796918767506988,0
438,4,0,1,39,0.0,0.025,0.975,40,1100,800,300,0.7272727272727273,14,8,6,371.5232320755389,0.44624732905982906,0.2596736323080533,0.20260146548139835,128536.5717120182,1550.8645124716609,130087.43622448985,426,2,142.675,34,6,18,37.06953901541833,0.6096813725490196,46.48809523809524,1014.0476190476195,29.82492997198881,0
439,4,0,0,39,0.0,0.0,1.0,39,800,400,400,0.5,12,4,8,375.6135220062647,0.44545659019343226,0.27004974045838237,0.20452204305660843,128476.21882086188,1851.4810090703168,130327.69982993219,427,3,147.02564102564102,34,5,18,37.027604900579306,0.6090686274509804,46.54761904761906,1013.8095238095254,29.817927170868394,0
440,4,2,1,40,0.04878048780487805,0.024390243902439025,0.975609756097561,41,1350,1000,350,0.7407407407407407,17,10,7,384.58254023123254,0.44872967479674797,0.321487775170078,0.19958423864086056,126536.55595203748,1599.4450353670616,128136.00098740454,428,0,140.8048780487805,33,8,14,38.7946609825416,0.591540404040404,48.46813725490195,1006.1274509803904,30.488710635769408,8
441,4,2,0,42,0.047619047619047616,0.0,1.0,42,550,300,250,0.5454545454545454,8,3,5,377.1112329339285,0.45239305071622143,0.32770051973591796,0.19912882860529857,127242.10778061209,1196.885629251679,128438.99340986376,429,0,136.11904761904762,34,8,17,38.25589970501473,0.5965073529411764,47.76785714285713,1008.9285714285702,29.674369747899124,0
442,4,2,1,43,0.045454545454545456,0.022727272727272728,0.9772727272727273,44,1250,800,450,0.64,17,8,9,363.07521871275685,0.45473264622973925,0.32577106775682063,0.19508778498297868,127945.07345183,490.73710534856787,128435.81055717857,430,0,130.88636363636363,36,8,15,37.88888579697242,0.599537037037037,47.07207207207206,1011.71171171171,28.103103103103056,0
443,4,1,1,43,0.022727272727272728,0.022727272727272728,0.9772727272727273,44,1150,900,250,0.782608695652174,14,9,5,367.14860059901235,0.45418208245243125,0.3456524901547189,0.19840538027429003,128173.8297994897,611.9237984660774,128785.75359795577,431,0,131.8409090909091,35,9,17,37.55155351087742,0.6038690476190476,46.8460648148148,1012.6157407407393,28.931878306878264,0
444,4,3,1,45,0.06521739130434782,0.021739130434782608,0.9782608695652174,46,1250,900,350,0.72,16,9,7,348.93390241791917,0.45847423510466984,0.3331526884080833,0.19230809334997997,128957.11343277436,-200.49823307036246,128756.615199704,432,0,125.6086956521739,38,8,16,37.21336909645524,0.6060855263157895,46.07371794871794,1015.7051282051273,26.72908232118756,0
445,4,1,2,44,0.021739130434782608,0.043478260869565216,0.9565217391304348,46,1500,1100,400,0.7333333333333333,19,11,8,358.3832676100317,0.4552636876006441,0.35040721308708256,0.1988801939286551,129229.25954380205,62.95200027979257,129292.21154408185,433,0,126.58695652173913,37,9,17,36.69603059060352,0.6106418918918919,45.80592105263158,1016.7763157894746,27.480440967283094,0
446,4,2,0,46,0.043478260869565216,0.0,1.0,46,1100,700,400,0.6363636363636364,15,7,8,361.62602529803354,0.4543075684380032,0.35801345209621505,0.20296943498449746,129675.5988020352,178.81427458448445,129854.41307661968,434,0,125.6304347826087,37,9,17,36.159144328417135,0.6151463963963963,45.36732456140351,1018.5307017543856,27.527856804172586,0
447,4,0,0,46,0.0,0.0,1.0,46,1000,500,500,0.5,15,5,10,364.2089151517433,0.45386473429951696,0.3617409086867609,0.20471052817149704,129731.44531249999,249.86979166666657,129981.31510416666,435,1,126.6304347826087,37,9,17,36.03655419222904,0.6157094594594594,45.3125,1018.7499999999999,27.533783783783782,0
448,4,0,0,46,0.0,0.0,1.0,46,1850,1200,650,0.6486486486486487,25,12,13,366.8428720083245,0.4529790660225443,0.3584198223468906,0.20752060277843187,129982.90339335185,336.66031855956015,130319.56371191141,436,2,127.6304347826087,37,9,18,35.71370967741935,0.6182432432432432,45.06578947368421,1019.7368421052636,27.56045519203415,0
449,4,0,0,46,0.0,0.0,1.0,46,1150,600,550,0.5217391304347826,17,6,11,368.2205861586357,0.4530394524959742,0.3647986840629551,0.2088978252207285,130094.7406894429,380.71233456447914,130475.45302400738,437,3,128.6304347826087,37,9,19,35.5649004012611,0.6193693693693694,44.95614035087719,1020.1754385964913,27.572309151256523,0
450,4,0,0,46,0.0,0.0,1.0,46,1200,800,400,0.6666666666666666,16,8,8,370.1883876651013,0.4526670692431562,0.36674328857492555,0.21031582024489823,130150.67737188366,436.0538819636833,130586.73125384735,438,4,129.6304347826087,37,9,19,35.457858729135324,0.6199324324324325,44.901315789473685,1020.3947368421054,27.578236130867715,0
451,4,2,2,46,0.041666666666666664,0.041666666666666664,0.9583333333333334,48,1900,1200,700,0.631578947368421,26,12,14,351.5994210775044,0.45421468676122934,0.3464107789855069,0.2021696671195653,130617.2839506174,-414.95962432884403,130202.32432628857,439,0,125.1875,38,10,14,35.45912590579708,0.6228070175438596,44.44444444444445,1022.2222222222232,26.900584795321663,0
452,4,0,0,46,0.0,0.0,1.0,46,1150,900,250,0.782608695652174,14,9,5,363.7549218324196,0.45188204508856683,0.34879711903174915,0.20756235848046267,130320.07250071027,280.9135571382312,130600.98605784851,440,6,131.6304347826087,36,10,20,35.44998345649057,0.6235532407407407,44.73536036036037,1021.0585585585594,28.36273773773776,0
453,4,0,0,46,0.0,0.0,1.0,46,1200,800,400,0.6666666666666666,16,8,8,360.9660985426346,0.4517512077294686,0.34382340252145127,0.20642891007450812,130406.3248214432,214.45245921598757,130620.77728065918,441,7,132.6304347826087,36,10,20,35.433664094083056,0.6244212962962963,44.65090090090091,1021.3963963963974,28.37212212212215,0
454,4,0,1,45,0.0,0.021739130434782608,0.9782608695652174,46,1400,1200,200,0.8571428571428571,16,12,4,359.3552960104426,0.4512479871175523,0.3367229608336333,0.2062713036872085,130550.14209733382,182.7769915185504,130732.91908885237,442,8,133.6304347826087,36,10,15,35.32897153351699,0.6258680555555556,44.51013513513514,1021.9594594594595,28.387762762762762,0
455,4,1,0,46,0.021739130434782608,0.0,1.0,46,1350,700,650,0.5185185185185185,20,7,13,357.41742667078825,0.4521135265700483,0.34395742076168245,0.20777744522319713,131039.71370018649,167.17545247948385,131206.88915266597,443,0,133.58695652173913,36,10,16,34.88277240064524,0.630787037037037,44.03153153153152,1023.8738738738724,28.4409409409409,0
456,4,0,1,45,0.0,0.021739130434782608,0.9782608695652174,46,1400,1000,400,0.7142857142857143,18,10,8,355.3407851886771,0.45172101449275365,0.34165383769518387,0.2068802241040862,131097.37059694814,116.84852081809561,131214.21911776625,444,1,134.58695652173913,36,10,17,34.87762077560296,0.6313657407407407,43.975225225225216,1024.0990990990979,28.447197197197163,0
457,4,1,0,46,0.021739130434782608,0.0,1.0,46,1500,1100,400,0.7333333333333333,19,11,8,355.5140683492333,0.45099637681159416,0.3483612040133779,0.20791632531992424,131270.41737683627,133.69602710818472,131404.11340394444,445,0,135.30434782608697,36,10,20,34.69826007326006,0.6331018518518519,43.806306306306304,1024.7747747747744,28.465965965965957,0
458,4,1,1,46,0.02127659574468085,0.02127659574468085,0.9787234042553191,47,1600,1200,400,0.75,20,12,8,345.87686424278473,0.4519927536231884,0.339870648485896,0.20377984520500586,131553.00188519532,-299.77204524470494,131253.22983995063,446,0,133.40425531914894,37,10,21,34.660022089211914,0.634009009009009,43.53070175438596,1025.8771929824552,27.726410621147437,0
459,4,0,1,45,0.0,0.021739130434782608,0.9782608695652174,46,1450,1000,450,0.6896551724137931,19,10,9,351.34985203337624,0.45162037037037034,0.33897346838486775,0.20750817897473509,131645.74361100982,50.742507710429436,131696.48611872026,447,1,136.45652173913044,36,10,15,34.426094590145944,0.6368634259259259,43.440315315315324,1026.23873873874,28.506631631631667,0
460,4,0,0,45,0.0,0.0,1.0,45,1300,800,500,0.6153846153846154,18,8,10,358.4042539326718,0.4501262626262626,0.34797432811873197,0.21122974114755363,131565.50068587135,430.72702331964535,131996.22770919098,448,3,140.46666666666667,35,10,15,34.32611311672683,0.638095238095238,43.51851851851853,1025.9259259259281,29.312169312169374,0
461,4,0,0,45,0.0,0.0,1.0,45,1100,800,300,0.7272727272727273,14,8,6,359.17227442663483,0.4497685185185185,0.3506830087475248,0.21201207623612175,131624.87809713668,455.20136745544244,132080.07946459213,449,4,141.46666666666667,35,10,16,34.2464658996917,0.6386904761904761,43.46064814814816,1026.157407407409,29.318783068783112,0
462,4,0,1,44,0.0,0.022222222222222223,0.9777777777777777,45,1050,600,450,0.5714285714285714,15,6,9,358.6165697936749,0.44928451178451173,0.35050482274833983,0.2123450583491256,131743.67310742478,449.0928283607917,132192.76593578557,450,5,142.46666666666667,35,10,16,34.14083051484404,0.6398809523809523,43.34490740740742,1026.620370370372,29.33201058201063,0
463,4,0,0,44,0.0,0.0,1.0,44,1200,700,500,0.5833333333333334,17,7,10,366.73467520092987,0.44766340732910503,0.35517295929128845,0.2165241712487685,131633.36167800473,854.903628117936,132488.26530612266,451,8,146.5909090909091,34,10,16,34.043890177880904,0.6409313725490196,43.45238095238096,1026.1904761904777,30.182072829131698,0
464,4,0,3,41,0.0,0.06818181818181818,0.9318181818181819,44,1650,1100,550,0.6666666666666666,22,11,11,390.9329665623119,0.44693666314305847,0.3537272833736118,0.21662404941437927,129171.13272392306,1314.4203514739438,130485.55307539701,452,9,147.5909090909091,34,10,20,35.92804582894171,0.6161151960784313,45.86309523809525,1016.5476190476203,29.898459383753536,8
465,4,2,0,43,0.046511627906976744,0.0,1.0,43,1450,1100,350,0.7586206896551724,18,11,7,384.31158983918885,0.45060446659283865,0.28215635144484086,0.20631961272693533,127910.26341735241,1236.0711748691094,129146.33459222152,453,0,143.1860465116279,35,8,19,37.38749046529367,0.6011904761904762,47.106481481481474,1011.574074074073,28.90211640211637,8
466,4,1,0,44,0.022727272727272728,0.0,1.0,44,1300,1100,200,0.8461538461538461,15,11,4,371.6455697881294,0.4504712825933756,0.2706970979185366,0.2011425259387663,128234.94897959194,732.0188054645853,128966.96778505652,454,0,140.9090909090909,34,10,20,37.37511753643629,0.6066176470588236,46.78571428571429,1012.8571428571436,29.789915966386577,0
467,4,2,1,45,0.043478260869565216,0.021739130434782608,0.9782608695652174,46,1200,1000,200,0.8333333333333334,14,10,4,360.0952157930016,0.4529488727858293,0.28384294213505346,0.19825022320032307,128915.32368517177,84.3582602873272,128999.68194545909,455,0,135.7391304347826,36,10,17,36.97258261255266,0.609375,46.11486486486487,1015.5405405405414,28.209459459459485,0
468,4,0,1,44,0.0,0.022222222222222223,0.9777777777777777,45,1100,800,300,0.7272727272727273,14,8,6,349.93586984647726,0.45233585858585856,0.20341416988928684,0.18753390630993957,127839.4088205025,-8.140368115027513,127831.26845238748,456,1,139.73333333333332,37,8,14,38.32933517655139,0.5965653153153153,47.1765350877193,1011.2938596491231,27.332266477003326,8
469,4,3,2,45,0.06382978723404255,0.0425531914893617,0.9574468085106383,47,1100,700,400,0.6363636363636364,15,7,8,328.47106788676615,0.4552112241751465,0.19565772783706636,0.17943062822307018,128604.6791675799,-950.689352445002,127653.9898151349,457,0,132.0212765957447,38,9,14,38.09160171336282,0.6025219298245614,46.42094017094018,1014.3162393162402,26.692532613585268,0
470,4,0,2,43,0.0,0.044444444444444446,0.9555555555555556,45,900,400,500,0.4444444444444444,14,4,10,336.9348353653676,0.45260942760942763,0.17921007413815904,0.1835967249630851,128505.59937913588,-340.3974059325973,128165.20197320328,456,1,128.73333333333332,37,8,14,37.977970332720524,0.603322072072072,46.51864035087719,1013.9254385964912,27.4033902323376,0
471,4,0,0,43,0.0,0.0,1.0,43,850,300,550,0.35294117647058826,14,3,11,348.5989037458287,0.44827427094868955,0.18251044921950688,0.18905029156125505,128315.61872260776,346.1368040337637,128661.75552664153,457,2,135.53488372093022,36,7,17,37.876282835019076,0.6032986111111112,46.70608108108108,1013.1756756756758,28.143768768768773,0
472,4,0,0,43,0.0,0.0,1.0,43,1250,1000,250,0.8,15,10,5,350.86913467784177,0.44855112587670726,0.179934853756758,0.19109950511219645,128486.82032962005,416.4118933122162,128903.23222293227,458,3,136.53488372093022,36,7,16,37.64393350364693,0.6050347222222222,46.537162162162154,1013.8513513513504,28.162537537537514,0
473,4,1,0,44,0.022727272727272728,0.0,1.0,44,1950,1400,550,0.717948717948718,25,14,11,344.41418623488994,0.44990970754052145,0.19056087487530404,0.189846395137163,128963.2175021702,83.3523220486164,129046.56982421881,459,0,134.4090909090909,39,5,18,37.32191997401976,0.6044337606837606,46.067708333333336,1015.7291666666672,26.04433760683762,0
474,4,1,0,45,0.022222222222222223,0.0,1.0,45,900,300,600,0.3333333333333333,15,3,12,340.37399579490443,0.44983164983164986,0.19976043313688874,0.18928712140248982,129312.88954293614,-196.3918360096526,129116.49770692649,460,0,132.4,37,8,19,37.068779646399314,0.6114864864864865,45.72368421052631,1017.1052631578935,27.489331436699825,0
475,4,1,0,46,0.021739130434782608,0.0,1.0,46,1300,1000,300,0.7692307692307693,16,10,6,336.066426836066,0.45058373590982287,0.21557667055733876,0.18895810414556158,129745.05077069171,-479.40887756593804,129265.64189312578,461,0,130.5,38,8,16,36.73950468400449,0.6140350877192983,45.299145299145295,1018.8034188034181,26.810616284300476,0
476,4,0,2,44,0.0,0.043478260869565216,0.9565217391304348,46,1400,1000,400,0.7142857142857143,18,10,8,337.0566030236251,0.45059380032206114,0.21614229580533695,0.18977838722782403,129799.47973738049,-450.0456570969275,129349.43408028356,462,1,131.5,38,8,17,36.6590654924163,0.6145833333333333,45.2457264957265,1019.0170940170949,26.81623931623934,0
477,4,0,0,44,0.0,0.0,1.0,44,1350,900,450,0.6666666666666666,18,9,9,342.04681778727627,0.4499647639182523,0.2092323740390385,0.19325948976577753,129935.60209155179,88.81184253782368,130024.4139340896,463,2,133.72727272727272,38,6,17,36.39382269726502,0.615953947368421,45.112179487179496,1019.5512820512835,26.830296896086406,0
478,4,1,1,44,0.022222222222222223,0.022222222222222223,0.9777777777777777,45,1600,1100,500,0.6875,21,11,10,338.025822573927,0.4511784511784512,0.21913832199546435,0.1925961082107264,130262.58680555594,-193.5763888888485,130069.0104166671,464,0,131.73333333333332,39,6,18,36.16496598639456,0.6175213675213675,44.791666666666686,1020.8333333333364,26.175213675213755,0
479,4,0,2,42,0.0,0.045454545454545456,0.9545454545454546,44,1050,800,250,0.7619047619047619,13,8,5,344.31090098993604,0.4503942036645525,0.2169112343109172,0.19647547015091918,130321.66950660128,174.23428926609193,130495.90379586737,465,1,134.54545454545453,35,9,18,35.944702637346026,0.6255952380952381,44.73379629629628,1021.064814814813,29.17328042328037,0
480,4,0,1,41,0.0,0.023809523809523808,0.9761904761904762,42,1350,1100,250,0.8148148148148148,16,11,5,331.4009115056424,0.44800135501355015,0.161367434579341,0.18062553312329294,128515.36502718915,155.65095915796144,128671.01598634712,466,2,140.23809523809524,36,6,21,38.10829446172071,0.6053240740740741,46.509009009009,1013.9639639639623,28.16566566566562,7
481,4,1,0,42,0.023809523809523808,0.0,1.0,42,1500,1300,200,0.8666666666666667,17,13,4,331.7573175396178,0.4494289585753,0.16301585540462704,0.18199200870265222,128772.40997331789,144.23786117197577,128916.64783448986,467,0,138.85714285714286,36,6,22,37.83747549835421,0.6079282407407407,46.25563063063063,1014.9774774774774,28.193818818818816,0
482,4,0,0,42,0.0,0.0,1.0,42,950,800,150,0.8421052631578947,11,8,3,330.0337489911975,0.4494652535811072,0.15828871779838494,0.18135207607771459,128839.34389667938,104.26633675742866,128943.6102334368,468,1,139.85714285714286,37,5,22,37.813096266695474,0.6067004504504505,46.18969298245612,1015.2412280701724,27.43895211000466,0
483,4,0,1,41,0.0,0.023809523809523808,0.9761904761904762,42,1700,1300,400,0.7647058823529411,21,13,8,331.17284154660604,0.4492958768873403,0.1559869601657753,0.18223361173874697,128895.01006319221,137.30534876112526,129032.31541195334,469,2,140.85714285714286,37,5,22,37.72754472159235,0.6072635135135135,46.134868421052616,1015.4605263157869,27.44487908961586,0
484,4,0,0,41,0.0,0.0,1.0,41,1500,1000,500,0.6666666666666666,20,10,10,329.65257498023885,0.4481707317073171,0.15928150647791894,0.182035802131519,129034.22807979355,307.2931094182609,129341.52118921181,470,3,144.390243902439,37,4,23,37.62455932081445,0.6086711711711712,45.99780701754385,1016.0087719298226,27.459696538643854,0
485,4,0,0,41,0.0,0.0,1.0,41,1100,900,200,0.8181818181818182,13,9,4,340.1426498988973,0.4479674796747968,0.062047782865291,0.18446434123811822,128315.61872260788,693.8130120977969,129009.43173470568,471,4,145.390243902439,36,5,17,38.090474602645315,0.6032986111111112,46.70608108108109,1013.1756756756768,28.143768768768798,8
486,4,0,0,41,0.0,0.0,1.0,41,850,500,350,0.5882352941176471,12,5,7,340.7351510521829,0.44705284552845526,0.0642712591737713,0.18558007047324884,128486.82032962015,555.9952266455631,129042.81555626572,472,5,146.390243902439,36,5,15,37.9007923284831,0.6050347222222222,46.53716216216216,1013.8513513513512,28.162537537537535,0
487,4,0,2,39,0.0,0.04878048780487805,0.9512195121951219,41,1050,800,250,0.7619047619047619,13,8,5,341.1949198352237,0.44695121951219513,0.06230293311373725,0.18596362337750347,128515.36502718947,569.7579336092926,129085.12296079876,473,6,147.390243902439,36,5,15,37.86002517399674,0.6053240740740741,46.50900900900901,1013.9639639639649,28.165665665665692,0
488,4,2,1,40,0.04878048780487805,0.024390243902439025,0.975609756097561,41,1100,900,200,0.8181818181818182,13,9,4,342.2612486605691,0.44425813008130083,0.0929675157443679,0.18816020840998118,128858.14868922981,620.6301740930178,129478.77886332283,474,0,147.97560975609755,36,5,17,37.48359398107069,0.6087962962962963,46.171171171171174,1015.3153153153157,28.203203203203216,0
489,4,0,0,40,0.0,0.0,1.0,40,1600,1300,300,0.8125,19,13,6,354.5149312220895,0.44397702991452986,0.09128092577813285,0.19470572709761716,128819.24518014827,1133.6691690243479,129952.91434917261,475,1,148.75,35,5,17,37.21223824725423,0.6104166666666666,46.20949074074074,1015.1620370370366,29.00462962962962,0
490,4,2,0,42,0.047619047619047616,0.0,1.0,42,1200,900,300,0.75,15,9,6,340.7797411734558,0.4480739450251645,0.10084511620347802,0.18982597749776134,129377.95380015417,419.00907707474397,129796.96287722891,476,0,142.61904761904762,35,7,19,36.99232081911262,0.6160714285714286,45.659722222222214,1017.36111111111,29.067460317460284,0
491,4,0,2,40,0.0,0.047619047619047616,0.9523809523809523,42,1150,800,350,0.6956521739130435,15,8,7,341.46702770289835,0.4476626016260163,0.09320748995527284,0.1907789734192683,129495.73072059301,443.7044538751412,129939.43517446815,477,1,143.61904761904762,35,7,15,36.855147449018254,0.6172619047619048,45.54398148148147,1017.824074074072,29.080687830687772,0
492,4,2,3,39,0.047619047619047616,0.07142857142857142,0.9285714285714286,42,1100,700,400,0.6363636363636364,15,7,8,338.7383142926397,0.4475537166085946,0.0969493060382054,0.19004648352745807,129659.75265806304,384.14520939854265,130043.89786746158,478,0,144.02380952380952,36,6,16,36.75802557865252,0.6168981481481481,45.38288288288286,1018.468468468465,28.290790790790695,0
493,4,0,1,38,0.0,0.02564102564102564,0.9743589743589743,39,1200,800,400,0.6666666666666666,16,8,8,343.1629108540574,0.44568151147098517,0.09657405859213486,0.184363061080228,127939.53517500403,980.820660793869,128920.35583579789,479,1,155.02564102564102,35,4,19,38.39818575296497,0.6014880952380952,47.07754629629628,1011.6898148148127,28.90542328042322,8
494,4,2,1,39,0.05,0.025,0.975,40,1450,1100,350,0.7586206896551724,18,11,7,337.0132725922531,0.44867788461538466,0.1241326181237159,0.18386739068825145,128555.015700017,665.1134098508028,129220.1291098678,480,0,151.975,35,5,18,37.925606786882746,0.6077380952380953,46.4699074074074,1014.1203703703692,28.974867724867693,0
495,4,1,1,39,0.025,0.025,0.975,40,1300,600,700,0.46153846153846156,20,6,14,336.6076491360707,0.4478899572649573,0.13293433652530773,0.1850076627958403,128848.62075617278,674.286265432086,129522.90702160487,481,0,151.35,35,5,19,37.636798905608735,0.6107142857142858,46.18055555555555,1015.2777777777773,29.007936507936492,0
496,4,1,0,40,0.025,0.0,1.0,40,1100,600,500,0.5454545454545454,16,6,10,338.07853065990605,0.4495325854700855,0.14394431158182464,0.1870615991004808,129113.15164448284,730.0769193672618,129843.2285638501,482,0,151.825,35,5,21,37.33024427741714,0.6133928571428571,45.92013888888888,1016.319444444443,29.037698412698372,0
497,4,0,0,40,0.0,0.0,1.0,40,1650,1500,150,0.9090909090909091,18,15,3,340.37161482176344,0.448170405982906,0.155891645214135,0.18962293482834378,129383.00028344685,807.6902882102061,130190.69057165705,483,1,152.825,34,6,22,36.997571963491694,0.6182598039215687,45.65476190476191,1017.3809523809535,29.922969187675104,0
498,4,0,1,39,0.0,0.025,0.975,40,1150,900,250,0.782608695652174,14,9,5,338.45051899001373,0.44724893162393164,0.15227996361155327,0.18909363811932534,129495.73072059326,765.5794538751707,130261.31017446842,484,2,153.825,35,5,17,36.93190432870897,0.6172619047619048,45.54398148148148,1017.8240740740739,29.080687830687825,0
499,4,0,1,38,0.0,0.02564102564102564,0.9743589743589743,39,1000,600,400,0.6,14,6,8,342.0999119675943,0.448268106162843,0.15468566357247382,0.19146848476092054,129564.7392290249,1064.8171768707448,130629.55640589564,485,3,155.71794871794873,34,5,17,36.76893319301528,0.6200980392156863,45.476190476190474,1018.0952380952377,29.943977591036404,0
500,4,0,2,36,0.0,0.05263157894736842,0.9473684210526316,38,500,500,0,1.0,5,5,0,352.35100213855384,0.4467016358463727,0.15536522588089063,0.19632335703048828,129388.3437259708,1518.0225153786985,130906.3662413495,486,4,160.68421052631578,33,5,22,36.6874447924195,0.6205808080808081,45.64950980392157,1017.4019607843139,30.830362448009513,0
501,4,1,0,37,0.02702702702702703,0.0,1.0,37,800,600,200,0.75,10,6,4,345.7829907894336,0.4480417917917918,0.14066279946934435,0.19419920401633592,129700.23548635139,1569.62706651288,131269.86255286427,487,0,156.27027027027026,33,4,19,36.53753609239654,0.6237373737373737,45.34313725490196,1018.627450980392,30.867498514557333,0
502,4,1,0,38,0.02631578947368421,0.0,1.0,38,1550,1200,350,0.7741935483870968,19,12,7,336.7985460250068,0.4478870317686107,0.1463444487566048,0.19117058488154776,130114.93866008666,1164.5044313700325,131279.4430914567,488,0,153.1315789473684,35,3,21,36.34583569672906,0.6235119047619048,44.936342592592595,1020.2546296296302,29.150132275132293,0
503,4,0,0,38,0.0,0.0,1.0,38,1400,1200,200,0.8571428571428571,16,12,4,340.19918106852174,0.447724039829303,0.14922625193213213,0.1936873194217749,130233.05047850228,1261.0354241683872,131494.08590267066,489,1,154.1315789473684,35,3,21,36.13941962429603,0.624702380952381,44.820601851851855,1020.717592592593,29.1633597883598,0
504,4,0,0,38,0.0,0.0,1.0,38,1400,1300,100,0.9285714285714286,15,13,2,343.33840765740854,0.44767958748221903,0.15464236545286858,0.1962539293152843,130387.71896626307,1353.429059551233,131741.1480258143,490,2,155.1315789473684,33,5,22,35.902627789776794,0.6306818181818181,44.669117647058826,1021.3235294117655,30.94919786096259,0
505,4,0,1,37,0.0,0.02631578947368421,0.9736842105263158,38,1900,1600,300,0.8421052631578947,22,16,6,342.0753320727612,0.4468646277856804,0.15360278608917466,0.19628172797544,130536.16780045352,1330.6405895691641,131866.8083900227,491,3,156.1315789473684,34,4,21,35.78459925442686,0.6299019607843137,44.523809523809526,1021.9047619047619,30.056022408963585,0
506,4,0,0,37,0.0,0.0,1.0,37,1350,1200,150,0.8888888888888888,15,12,3,351.4004768638847,0.44597722722722727,0.15048145639343646,0.20167436865574204,130544.21864487203,1774.6601367262429,132318.87878159827,492,4,159.13513513513513,33,4,22,35.538209017867864,0.632260101010101,44.51593137254901,1021.9362745098028,30.96776589423645,0
507,4,0,0,37,0.0,0.0,1.0,37,1000,500,500,0.5,15,5,10,352.5500781818068,0.4451951951951952,0.15863802440983732,0.2031545478141569,130700.81218761993,1815.7163110341953,132516.52849865414,493,5,160.13513513513513,33,4,22,35.35025167785235,0.6338383838383839,44.362745098039206,1022.5490196078414,30.986333927510344,0
508,4,0,0,37,0.0,0.0,1.0,37,1550,1200,350,0.7741935483870968,19,12,7,351.41225664458074,0.4441941941941942,0.15688038655348002,0.20365327933649485,130920.20083922028,1801.3926434544103,132721.59348267468,494,6,161.13513513513513,33,4,22,35.15734143615535,0.6360479797979798,44.148284313725476,1023.4068627450963,31.01232917409383,0
509,4,1,2,36,0.02631578947368421,0.05263157894736842,0.9473684210526316,38,1450,800,650,0.5517241379310345,21,8,13,345.19252860657,0.44470128022759603,0.15277098415182966,0.20186258738079832,131267.12018140565,1462.4858276643697,132729.60600907003,495,0,157.8684210526316,34,4,24,34.966019981412636,0.6372549019607843,43.809523809523796,1024.7619047619028,30.140056022408906,0
510,4,0,0,36,0.0,0.0,1.0,36,950,600,350,0.631578947368421,13,6,7,353.1379782718247,0.44275793650793654,0.1405330454295266,0.20701826529665524,131361.493004693,2077.7605848247595,133439.25358951776,496,1,153.25,31,5,24,34.66713768576144,0.645497311827957,43.71744791666667,1025.1302083333342,33.06871639784949,0
511,4,0,0,36,0.0,0.0,1.0,36,1350,900,450,0.6666666666666666,18,9,9,354.9431760273229,0.44130291005291006,0.14316890186289832,0.20916957994908594,131561.79004245345,2139.3919203016576,133701.1819627551,497,2,154.25,31,5,20,34.41862863307525,0.647513440860215,43.52213541666667,1025.9114583333342,33.093918010752716,0
512,4,0,0,36,0.0,0.0,1.0,36,1400,1300,100,0.9285714285714286,15,13,2,351.3623180512245,0.4408399470899471,0.13833538335383366,0.20790215762419642,131716.66953627198,2056.0548668503416,133772.72440312232,498,3,155.25,32,4,20,34.354243542435434,0.646484375,43.37121212121213,1026.5151515151529,32.07859848484853,0
513,4,0,0,36,0.0,0.0,1.0,36,550,400,150,0.7272727272727273,7,4,3,371.8068591239604,0.44108796296296293,0.19871383066998582,0.20716379492933693,129388.3437259708,2433.116638427367,131821.46036439817,499,4,156.25,33,3,21,36.19258411627721,0.6205808080808081,45.64950980392157,1017.4019607843139,30.830362448009513,8
514,4,0,0,36,0.0,0.0,1.0,36,1200,1000,200,0.8333333333333334,14,10,4,375.39213093215045,0.44039351851851855,0.19979404054993877,0.21015888300433305,129575.43372741235,2528.3196366781767,132103.75336409052,500,5,157.25,33,3,17,35.91066843203339,0.6224747474747474,45.46568627450979,1018.1372549019593,30.85264408793816,0
515,4,0,1,35,0.0,0.027777777777777776,0.9722222222222222,36,750,600,150,0.8,9,6,3,376.7092076769353,0.4398478835978836,0.19476530434898875,0.21139974510486198,129669.02941476816,2569.503466214891,132238.53288098305,501,6,158.25,33,3,17,35.781770143985874,0.6234217171717171,45.37377450980391,1018.5049019607827,30.863784907902506,0
516,4,0,0,35,0.0,0.0,1.0,35,900,500,400,0.5555555555555556,13,5,8,388.55655039887864,0.43669467787114846,0.20816228296372707,0.2178748268430958,129637.8270977508,3074.3253796616577,132712.15247741246,502,14,163.6,33,2,17,35.511933413557955,0.6231060606060606,45.40441176470588,1018.3823529411759,30.860071301247753,0
517,4,0,0,35,0.0,0.0,1.0,35,1300,900,400,0.6923076923076923,17,9,8,391.76514235305336,0.43634453781512605,0.22309555299816242,0.22090241958985363,129856.32216274974,3174.63610750671,133030.95827025644,503,15,164.6,33,2,19,35.20738146767665,0.6253156565656566,45.18995098039215,1019.2401960784301,30.886066547831216,0
518,4,0,0,35,0.0,0.0,1.0,35,850,800,50,0.9411764705882353,9,8,1,398.4033797968598,0.43616946778711485,0.2239371105885588,0.22572575425794822,130043.75007509111,3361.9739102748686,133405.72398536597,504,16,165.6,33,2,19,34.84708538587848,0.627209595959596,45.00612745098038,1019.9754901960769,30.908348187759906,0
519,4,0,0,35,0.0,0.0,1.0,35,1450,1200,250,0.8275862068965517,17,12,5,395.9091014265025,0.4356792717086835,0.21712364023197517,0.22485260426173653,130137.51471789686,3304.525302768152,133442.040020665,505,17,166.6,33,2,19,34.81513732084234,0.6281565656565656,44.9142156862745,1020.3431372549012,30.91948900772428,0
520,4,0,1,34,0.0,0.02857142857142857,0.9714285714285714,35,1200,800,400,0.6666666666666666,16,8,8,395.3271453346881,0.43546918767507004,0.21731300276143628,0.22506355389559904,130231.31315179246,3296.7946522971756,133528.10780408964,506,18,167.6,33,2,20,34.73443690719173,0.6291035353535354,44.82230392156862,1020.7107843137245,30.93062982768862,0
521,4,0,0,34,0.0,0.0,1.0,34,1500,1300,200,0.8666666666666667,17,13,4,401.5450623586376,0.4336749851455734,0.22768439519575412,0.2299651503113772,130462.04460991747,3677.2817222304784,134139.32633214796,507,19,171.2941176470588,31,3,20,34.34074687738976,0.6364247311827957,44.596354166666664,1021.6145833333328,32.95530913978493,0
522,4,0,0,34,0.0,0.0,1.0,34,750,600,150,0.8,9,6,3,393.2484832641678,0.4340463458110517,0.18345952242283037,0.2090426147877947,127512.50000000022,3228.8194444444734,130741.31944444469,508,20,172.2941176470588,34,0,17,37.57047579757977,0.5992647058823529,47.500000000000014,1010.0000000000017,29.705882352941227,8
523,4,1,0,35,0.02857142857142857,0.0,1.0,35,1350,1000,350,0.7407407407407407,17,10,7,380.40909231643616,0.4352591036414566,0.17327273321780057,0.2039272790589585,127851.7299489885,2727.1921081961796,130578.92205718468,509,0,168.34285714285716,35,0,18,37.54625391012436,0.6005952380952381,47.16435185185186,1011.3425925925939,28.89550264550268,0
524,4,0,0,35,0.0,0.0,1.0,35,700,400,300,0.5714285714285714,10,4,6,385.2292231716891,0.4355042016806723,0.17744945821824887,0.20696303870582283,127939.53517500442,2857.209549682802,130796.74472468722,510,1,169.34285714285716,35,0,18,37.33423426000077,0.6014880952380952,47.077546296296305,1011.6898148148159,28.90542328042331,0
525,4,1,0,36,0.027777777777777776,0.0,1.0,36,1150,900,250,0.782608695652174,14,9,5,381.57870749574056,0.43723544973544975,0.18047220369958739,0.20708354704744758,128344.14439777646,2594.678546790071,130938.82294456653,511,0,165.61111111111111,36,0,20,37.01169704378752,0.603587962962963,46.677927927927946,1013.2882882882908,28.146896896896966,0
526,4,2,2,36,0.05263157894736842,0.05263157894736842,0.9473684210526316,38,1300,1000,300,0.7692307692307693,16,10,6,370.6238592745866,0.44080429113323855,0.1907140603638655,0.2045422099734211,129011.37689248672,1962.9388788443339,130974.31577133105,512,0,157.8421052631579,38,0,17,36.60720545448172,0.6066337719298245,46.02029914529915,1015.9188034188038,26.734705353126415,0
527,4,1,1,36,0.02702702702702703,0.02702702702702703,0.972972972972973,37,950,600,350,0.631578947368421,13,6,7,376.29096597155547,0.4401901901901902,0.21125794098767026,0.2097951002060592,129413.28125000015,2339.829196800367,131753.1104468005,513,0,159.16216216216216,34,3,20,36.05309855309855,0.6185661764705883,45.62500000000001,1017.5000000000011,29.92647058823533,0
528,4,0,0,36,0.0,0.0,1.0,36,850,600,250,0.7058823529411765,11,6,5,381.99244587450954,0.43933531746031745,0.21232596232596213,0.2129738705081171,129413.28125000004,2686.9791666666692,132100.26041666672,514,1,164.47222222222223,34,2,20,35.90806715806715,0.6185661764705883,45.625,1017.5000000000003,29.926470588235304,0
529,4,0,0,36,0.0,0.0,1.0,36,1250,900,350,0.72,16,9,7,385.51047114606547,0.43910383597883595,0.217270601987142,0.21626505446915323,129655.65653344656,2796.722647392271,132452.37918083882,515,2,165.47222222222223,34,2,15,35.571303331385145,0.6210171568627452,45.38690476190475,1018.4523809523797,29.95448179271705,0
530,4,1,0,37,0.02702702702702703,0.0,1.0,37,800,300,500,0.375,13,3,10,377.03661044123385,0.43993993993993996,0.2223097559301599,0.21355976114860897,130032.77084094238,2405.4230328301337,132438.1938737725,516,0,161.97297297297297,36,1,17,35.4030952118067,0.6206597222222222,45.016891891891895,1019.9324324324332,28.33145645645648,0
531,4,0,0,37,0.0,0.0,1.0,37,850,600,250,0.7058823529411765,11,6,5,379.09814338727443,0.43903278278278274,0.22466943270386608,0.21536102051611877,130147.65346004789,2467.746758582908,132615.4002186308,517,1,162.97297297297297,36,1,17,35.2336478681529,0.6218171296296297,44.90427927927928,1020.3828828828829,28.34396896896897,0
532,4,0,0,37,0.0,0.0,1.0,37,500,300,200,0.6,7,3,4,377.6759683465225,0.4385322822822823,0.22548262548262588,0.21518747033697178,130262.5868055553,2439.511175026345,132702.09798058163,518,2,163.97297297297297,34,3,17,35.15306122448978,0.6271446078431373,44.79166666666665,1020.8333333333313,30.02450980392151,0
533,4,0,0,37,0.0,0.0,1.0,37,1150,900,250,0.782608695652174,14,9,5,377.8494158764241,0.4377815315315315,0.23238832667663156,0.21594192005787308,130380.76560356625,2452.8592249656745,132833.62482853193,519,3,164.97297297297297,35,2,17,35.028520701118154,0.6261904761904762,44.67592592592591,1021.2962962962941,29.17989417989412,0
534,4,0,0,37,0.0,0.0,1.0,37,1250,800,450,0.64,17,8,9,376.41038516068085,0.4376564064064064,0.22811398354876666,0.2164359714673911,130617.28395061703,2433.1404320987335,133050.42438271575,520,4,165.97297297297297,35,2,13,34.8250679347826,0.6285714285714286,44.44444444444443,1022.2222222222201,29.206349206349145,0
535,4,0,1,36,0.0,0.02702702702702703,0.972972972972973,37,1000,700,300,0.7,13,7,6,374.13716183496456,0.4371246246246246,0.22377742160449277,0.21578824817060968,130735.62349965681,2382.611025377198,133118.234525034,521,5,166.97297297297297,35,2,13,34.763090387807445,0.6297619047619047,44.32870370370369,1022.6851851851832,29.21957671957666,0
536,4,0,0,36,0.0,0.0,1.0,36,1050,700,350,0.6666666666666666,14,7,7,378.2583035971274,0.4354497354497355,0.22113594040968376,0.2184136656254379,130779.59183673457,2693.6933106575802,133473.28514739216,522,6,170.02777777777777,34,2,13,34.6131090937306,0.6323529411764706,44.28571428571428,1022.8571428571419,30.08403361344535,0
537,4,0,1,35,0.0,0.027777777777777776,0.9722222222222222,36,1350,900,450,0.6666666666666666,18,9,9,379.8940465036043,0.4354828042328042,0.22618871369704152,0.20735307774614903,128572.46393352808,2568.782718529338,131141.24665205742,523,7,171.02777777777777,36,0,14,36.820591827670434,0.6059027777777778,46.4527027027027,1014.1891891891889,28.171921921921914,7
538,4,0,0,35,0.0,0.0,1.0,35,650,300,350,0.46153846153846156,10,3,7,390.66096970910905,0.43340336134453783,0.2441991292579122,0.21297951186194805,128525.67361379034,3041.9928572959593,131567.6664710863,524,8,176.6,35,0,15,36.59554179507666,0.6074404761904761,46.498842592592595,1014.00462962963,28.97156084656086,0
539,4,0,0,35,0.0,0.0,1.0,35,1350,1000,350,0.7407407407407407,17,10,7,395.7184101131926,0.4325280112044818,0.25406382874737266,0.21701405492699094,128760.50407503854,3190.580391589497,131951.08446662803,525,9,177.6,35,0,16,36.22669346561751,0.6098214285714285,46.26736111111111,1014.9305555555552,28.998015873015863,0
540,4,1,0,36,0.027777777777777776,0.0,1.0,36,1250,600,650,0.48,19,6,13,372.0631759320194,0.4335482804232804,0.200799130545966,0.19268349218410338,126450.94548396798,2210.301595721907,128661.24707968989,526,0,173.63888888888889,35,1,19,39.19783275795933,0.5863095238095238,48.553240740740755,1005.7870370370389,28.73677248677254,8
541,4,1,0,37,0.02702702702702703,0.0,1.0,37,700,300,400,0.42857142857142855,11,3,8,368.28341385668114,0.43615490490490494,0.20545374888583368,0.19253624412320386,126836.65242522949,1942.3670714633797,128779.01949669287,527,0,169.9189189189189,36,1,20,38.89556549282654,0.5882523148148149,48.17004504504506,1007.3198198198215,27.981106106106154,0
542,4,1,0,38,0.02631578947368421,0.0,1.0,38,1200,700,500,0.5833333333333334,17,7,10,358.1896723533163,0.4378408013276434,0.20175046992481205,0.18923227973382767,127262.39753266796,1517.0720974352957,128779.46963010327,528,0,166.42105263157896,36,2,21,38.71233258928572,0.5925925925925926,47.74774774774776,1009.0090090090104,28.028028028028064,0
543,4,3,1,40,0.07317073170731707,0.024390243902439025,0.975609756097561,41,1100,600,500,0.5454545454545454,16,6,10,369.4551184595997,0.44359756097560976,0.17454143845890369,0.19318065869597845,126843.36917368798,1222.1999884080947,128065.56916209609,529,0,155.17073170731706,37,4,18,38.85914426181923,0.5864301801801801,48.16337719298245,1007.3464912280697,27.225580844001882,8
544,4,1,0,41,0.024390243902439025,0.0,1.0,41,950,500,450,0.5263157894736842,14,5,9,370.22426011725304,0.44453760162601624,0.18645340123874332,0.194637625601952,127064.37467538081,1208.4628202908516,128272.83749567166,530,0,156.09756097560975,37,4,19,38.612357259380104,0.5886824324324325,47.94407894736842,1008.2236842105257,27.24928876244664,0
545,4,0,0,41,0.0,0.0,1.0,41,1000,800,200,0.8,12,8,4,369.4209973418975,0.4445630081300813,0.1882699844610971,0.1946125047852676,127147.30133310247,1194.1765735610936,128341.47790666357,531,1,157.09756097560975,37,4,19,38.54732912952092,0.589527027027027,47.86184210526316,1008.5526315789472,27.258179231863437,0
546,4,1,0,42,0.023809523809523808,0.0,1.0,42,1400,700,700,0.5,21,7,14,380.2083489732694,0.4450130662020906,0.20899115798444678,0.19808057341614396,126694.89590942298,1258.341689489338,127953.23759891232,532,0,154.33333333333334,36,6,14,38.74137770320656,0.5868055555555556,48.310810810810814,1006.7567567567571,27.965465465465474,7
547,4,0,1,41,0.0,0.023809523809523808,0.9761904761904762,42,1350,1000,350,0.7407407407407407,17,10,7,374.7681708403784,0.44383952768099105,0.20614161157420696,0.19606292727122965,126865.01323959102,1108.993791088391,127974.00703067941,533,1,155.33333333333334,36,6,14,38.70305164319248,0.5885416666666667,48.141891891891895,1007.4324324324331,27.98423423423425,0
548,4,2,0,43,0.046511627906976744,0.0,1.0,43,1150,700,450,0.6086956521739131,16,7,9,368.4892907365383,0.446359357696567,0.21876842074379166,0.194836757182042,127296.33012099171,781.8726911462982,128078.20281213801,534,0,152.58139534883722,35,8,16,38.417655885613804,0.5949404761904762,47.71412037037036,1009.1435185185167,28.832671957671906,0
549,4,1,0,44,0.022727272727272728,0.0,1.0,44,1250,900,350,0.72,16,9,7,358.08809455046054,0.44694767441860467,0.21537206663154063,0.19078185179968704,127603.50722343959,338.6593519194788,127942.16657535906,535,0,150.0909090909091,36,8,15,38.364959503640954,0.5960648148148149,47.409909909909906,1010.3603603603599,28.065565565565553,0
550,4,0,0,44,0.0,0.0,1.0,44,1550,1100,450,0.7096774193548387,20,11,9,356.52236366763714,0.44705778717406625,0.2127408472962291,0.19021591507451682,127660.40322417,302.7577408489386,127963.16096501895,536,1,151.0909090909091,36,8,15,38.346194562068185,0.5966435185185186,47.353603603603595,1010.5855855855847,28.071821821821796,0
551,4,0,0,44,0.0,0.0,1.0,44,1200,800,400,0.6666666666666666,16,8,8,352.61881986431047,0.44717891120507397,0.2062615800504206,0.18879930730838645,127802.69870799845,213.12735877768304,128015.82606677614,537,2,152.0909090909091,36,8,15,38.29908675799086,0.5980902777777778,47.21283783783783,1011.148648648648,28.087462462462444,0
552,4,1,1,44,0.022222222222222223,0.022222222222222223,0.9777777777777777,45,1500,1100,400,0.7333333333333333,19,11,8,343.2742298768821,0.44753787878787876,0.2022862368541387,0.18536808413351616,128144.53124999985,-202.25694444446026,127942.27430555539,538,0,149.6888888888889,37,8,19,38.185871056241425,0.5996621621621622,46.87499999999999,1012.4999999999989,27.364864864864835,0
553,4,0,0,44,0.0,0.0,1.0,44,1300,1000,300,0.7692307692307693,16,10,6,346.8951939090183,0.44655126849894294,0.20781603849886743,0.18745682593929652,128173.03790276771,92.52216743771606,128265.56007020542,539,1,153.8181818181818,36,8,21,38.06508563167261,0.6018518518518519,46.84684684684685,1012.6126126126132,28.128128128128147,0
554,4,2,1,45,0.043478260869565216,0.021739130434782608,0.9782608695652174,46,1250,1000,250,0.8,15,10,5,334.6154016620495,0.4482085346215781,0.22239816933638368,0.18353616141971546,128767.28121119153,-582.496895317409,128184.78431587412,540,0,148.08695652173913,38,8,14,37.770175438596475,0.6041666666666667,46.26068376068376,1014.9572649572655,26.70940170940172,0
555,4,0,4,41,0.0,0.08888888888888889,0.9111111111111111,45,1350,800,550,0.5925925925925926,19,8,11,335.9033885861389,0.4468644781144781,0.1764868045049588,0.17593671937831848,126912.74957242713,-473.9154727675333,126438.8340996596,541,1,152.24444444444444,40,5,15,39.632921499411665,0.58203125,48.09451219512195,1007.6219512195122,25.190548780487806,8
556,4,1,0,42,0.023809523809523808,0.0,1.0,42,1400,1100,300,0.7857142857142857,17,11,6,345.27807938088574,0.4454969996128533,0.21062749365252142,0.18090681582156992,126926.2236938287,364.9685480147557,127291.19224184346,542,0,162.97619047619048,37,5,16,39.38293434893001,0.5872747747747749,48.081140350877185,1007.6754385964898,27.234471313418645,0
557,4,1,1,42,0.023255813953488372,0.023255813953488372,0.9767441860465116,43,1600,1300,300,0.8125,19,13,6,334.23989691213416,0.44603636028054633,0.2029584881136135,0.1768943588867747,127334.51727892821,-87.94481426694563,127246.57246466127,543,0,160.1627906976744,38,5,13,39.242616703715456,0.5896381578947368,47.676282051282044,1009.2948717948707,26.560391363022912,0
558,4,0,1,41,0.0,0.023809523809523808,0.9761904761904762,42,1350,1000,350,0.7407407407407407,17,10,7,341.9271998770684,0.44532762291908634,0.2112994964315471,0.1804975425168619,127230.2550424167,300.69696925974904,127530.95201167645,544,2,164.97619047619048,37,5,17,39.15550393073215,0.5903716216216216,47.77960526315788,1008.8815789473668,27.267069701280185,0
559,4,1,1,41,0.023809523809523808,0.023809523809523808,0.9761904761904762,42,950,600,350,0.631578947368421,13,6,7,337.63929135712607,0.44675522648083626,0.2018395331648346,0.17970368522664354,127562.34039560238,214.0116430055265,127776.3520386079,545,0,162.23809523809524,37,5,14,38.92359980462389,0.59375,47.450657894736835,1010.1973684210517,27.30263157894734,0
560,4,0,1,40,0.0,0.024390243902439025,0.975609756097561,41,1200,800,400,0.6666666666666666,16,8,8,349.1550643001379,0.4454776422764228,0.20336937389992404,0.18608813866545823,127617.7300347223,711.6753472222285,128329.40538194454,546,1,166.390243902439,37,4,14,38.57603092783505,0.5943130630630631,47.395833333333336,1010.4166666666674,27.30855855855858,0
561,4,1,0,41,0.024390243902439025,0.0,1.0,41,1050,700,350,0.6666666666666666,14,7,7,351.9729307893381,0.444994918699187,0.21382387086366816,0.18862558632597695,127839.40882050239,799.2022785857105,128638.6110990881,547,0,167.26829268292684,37,4,16,38.27783349597023,0.5965653153153153,47.176535087719294,1011.2938596491222,27.3322664770033,0
562,4,2,1,42,0.046511627906976744,0.023255813953488372,0.9767441860465116,43,1550,1200,350,0.7741935483870968,19,12,7,337.3616063051231,0.4475129198966408,0.21223319528512263,0.18378654671846245,128496.3348765431,70.30968129081094,128566.6445578339,548,0,160.4418604651163,38,5,16,37.97659817351598,0.6014254385964912,46.52777777777777,1013.888888888888,26.68128654970758,0
563,4,1,0,43,0.023255813953488372,0.0,1.0,43,1100,900,200,0.8181818181818182,13,9,4,340.6974530795263,0.4474437061646364,0.22333220702522483,0.18661732464529043,128713.06911571317,170.44296515448556,128883.51208086766,549,0,161.41860465116278,38,5,18,37.67108865024217,0.6036184210526316,46.314102564102555,1014.7435897435882,26.70377867746285,0
564,4,0,0,43,0.0,0.0,1.0,43,1700,1400,300,0.8235294117647058,20,14,6,344.13065324752387,0.44712070874861576,0.23071294499411454,0.18914248686010496,128848.62075617262,268.15200617281414,129116.77276234543,550,1,162.41860465116278,38,5,18,37.44585043319653,0.6049890350877193,46.18055555555554,1015.277777777776,26.717836257309894,0
565,4,1,1,43,0.022727272727272728,0.022727272727272728,0.9772727272727273,44,1300,800,500,0.6153846153846154,18,8,10,335.2593388873962,0.44765239605355883,0.22745901639344335,0.1859165424739195,129201.38888888876,-136.32330246914535,129065.06558641962,551,0,159.70454545454547,38,6,19,37.31215846994538,0.6085526315789473,45.83333333333333,1016.6666666666656,26.754385964912252,0
566,4,2,2,43,0.044444444444444446,0.044444444444444446,0.9555555555555556,45,1450,1300,150,0.896551724137931,16,13,3,322.8641725117412,0.4490109427609428,0.24195610507306609,0.18201263553233565,129847.9443969363,-615.3501759865213,129232.59422094979,552,0,155.55555555555554,40,5,17,36.97153255558878,0.61171875,45.198170731707314,1019.2073170731703,25.480182926829258,0
567,4,0,0,43,0.0,0.0,1.0,43,1200,1000,200,0.8333333333333334,14,10,4,329.72365743218853,0.4475129198966408,0.24057558198976126,0.1854529668398067,129757.97661675357,-43.145073784716686,129714.83154296885,553,1,160.93023255813952,39,4,17,36.88795027774936,0.6124465811965811,45.286458333333336,1018.8541666666674,26.12446581196583,0
568,4,0,1,42,0.0,0.023255813953488372,0.9767441860465116,43,1500,700,800,0.4666666666666667,23,7,16,328.5544580404548,0.447328349944629,0.2337082175928673,0.18554890252982878,129917.22140842021,-63.023546006939824,129854.19786241328,554,2,161.93023255813952,39,4,17,36.75634770614079,0.6140491452991452,45.130208333333336,1019.4791666666673,26.14049145299147,0
569,4,0,0,42,0.0,0.0,1.0,42,1250,800,450,0.64,17,8,9,336.03422395291244,0.44559378629500584,0.23680034730018984,0.18986232085154806,129935.60209155169,332.561842537806,130268.16393408949,555,3,166.64285714285714,38,4,19,36.54707639107199,0.615953947368421,45.11217948717949,1019.5512820512827,26.830296896086384,0
570,4,0,1,41,0.0,0.023809523809523808,0.9761904761904762,42,1300,800,500,0.6153846153846154,18,8,10,337.4734498320393,0.4454002129307007,0.2367381151957848,0.19080844817517664,129962.83512309151,371.80126378844216,130334.63638687995,556,4,167.64285714285714,38,4,19,36.4827815032132,0.6162280701754386,45.085470085470085,1019.6581196581195,26.833108412055775,0
571,4,1,1,41,0.023809523809523808,0.023809523809523808,0.9761904761904762,42,1250,800,450,0.64,17,8,9,335.9054850470107,0.4439000193573364,0.24025430067314857,0.19071922605225655,130126.29323727095,342.02712944701875,130468.32036671796,557,0,167.97619047619048,38,4,20,36.357111692844676,0.6178728070175439,44.92521367521368,1020.2991452991465,26.84997750787228,0
572,4,0,1,40,0.0,0.024390243902439025,0.975609756097561,41,1400,1200,200,0.8571428571428571,16,12,4,342.02415660141594,0.4426321138211382,0.23733200597312032,0.19487422876127203,130262.58680555565,710.5902777777864,130973.17708333343,558,1,171.1951219512195,37,4,20,36.062925170068034,0.6210585585585586,44.79166666666667,1020.8333333333342,27.59009009009011,0
573,4,0,0,40,0.0,0.0,1.0,40,1350,1000,350,0.7407407407407407,17,10,7,337.0878184003043,0.4418269230769231,0.23374208436191957,0.19303301807225778,130458.54403518383,795.1972001000241,131253.74123528384,559,2,174.725,37,3,21,35.9905504275339,0.6230292792792793,44.59978070175438,1021.6008771929819,27.61083451872924,0
574,4,1,1,40,0.024390243902439025,0.024390243902439025,0.975609756097561,41,950,800,150,0.8421052631578947,11,8,3,330.66892047232903,0.4416920731707317,0.2398208375690778,0.19080732825085017,130753.83434007232,447.2458497698922,131201.0801898422,560,0,171.4390243902439,38,3,18,35.85605348375641,0.6241776315789473,44.31089743589744,1022.7564102564103,26.914642375168693,0
575,4,1,2,39,0.024390243902439025,0.04878048780487805,0.9512195121951219,41,1150,900,250,0.782608695652174,14,9,5,332.0958640722857,0.4427083333333333,0.24330693432143136,0.1931314782323289,131054.49631090638,504.53123858571115,131559.0275494921,561,0,169.14634146341464,38,3,19,35.51600758208126,0.6271929824561404,44.01709401709401,1023.9316239316224,26.94556905083217,0
576,4,0,0,39,0.0,0.0,1.0,39,1400,1000,400,0.7142857142857143,18,10,8,346.74789989232715,0.44115497076023397,0.25003599285224265,0.20022321517622424,130780.41459956573,1269.5668218894493,132049.9814214552,562,1,178.46153846153845,36,3,19,35.418042863958306,0.6281828703703703,44.284909909909906,1022.86036036036,28.412787787787778,0
577,4,0,0,39,0.0,0.0,1.0,39,1100,800,300,0.7272727272727273,14,8,6,344.22714212209877,0.4413236617183986,0.24735351209823064,0.19951124155648167,130924.43795146485,1213.549021994949,132137.9869734598,563,2,179.46153846153845,36,3,19,35.33689113849764,0.6296296296296297,44.144144144144136,1023.4234234234224,28.4284284284284,0
578,4,0,0,39,0.0,0.0,1.0,39,1450,1100,350,0.7586206896551724,18,11,7,366.44087603878097,0.4412393162393162,0.27842442645074184,0.19892504699248123,128355.55555555565,1632.1174214755406,129987.6729770312,564,3,180.46153846153845,34,5,16,37.38349780701755,0.607843137254902,46.66666666666667,1013.3333333333342,29.803921568627477,7
579,4,0,0,39,0.0,0.0,1.0,39,1100,700,400,0.6363636363636364,15,7,8,369.8733436107536,0.44062078272604593,0.2835117515094028,0.20124418663549953,128446.04768990935,1701.7538265306207,130147.80151643997,565,4,181.46153846153845,34,5,15,37.20395380700725,0.6087622549019608,46.577380952380956,1013.6904761904766,29.814425770308134,0
580,4,1,1,39,0.025,0.025,0.975,40,1600,1400,200,0.875,18,14,4,365.9704745485603,0.443082264957265,0.2850843689431086,0.20099730947184846,128819.2451801483,1428.8080579132375,130248.05323806153,566,0,177.9,35,5,17,36.92150742978757,0.6104166666666666,46.20949074074074,1015.1620370370368,29.004629629629623,0
581,4,1,0,40,0.025,0.0,1.0,40,1400,1100,300,0.7857142857142857,17,11,6,366.7171408294555,0.44376335470085465,0.28952494873547585,0.20245553850320477,129024.94454089488,1463.131751543192,130488.07629243807,567,0,178.725,35,5,18,36.69258373205741,0.6125,46.006944444444436,1015.9722222222207,29.027777777777732,0
582,4,1,0,41,0.024390243902439025,0.0,1.0,41,1250,900,350,0.72,16,9,7,357.76861121464236,0.4428607723577236,0.28569114689486663,0.19941020372142468,129401.82317029867,1059.182112856099,130461.00528315477,568,0,175.34146341463415,36,5,19,36.53592510606899,0.6142939814814814,45.63626126126126,1017.4549549549549,28.26263763763764,0
583,4,0,0,41,0.0,0.0,1.0,41,1200,900,300,0.75,15,9,6,359.3361661855429,0.4428861788617886,0.2886893920382947,0.20086825022579613,129516.42679419291,1107.9872524551654,130624.41404664807,569,1,176.34146341463415,36,5,15,36.379393000700674,0.6154513888888888,45.52364864864865,1017.905405405406,28.275150150150168,0
584,4,0,0,41,0.0,0.0,1.0,41,1350,1000,350,0.7407407407407407,17,10,7,359.56266820189313,0.44250508130081306,0.2819075354932652,0.20187736399044853,129688.42734203806,1126.2233940021172,130814.65073604017,570,2,177.34146341463415,36,5,15,36.198636447392666,0.6171875,45.35472972972973,1018.5810810810817,28.293918918918937,0
585,4,0,1,40,0.0,0.024390243902439025,0.975609756097561,41,1150,700,450,0.6086956521739131,16,7,9,357.7886709069744,0.4420223577235773,0.27832684866839785,0.2019141551776766,129889.23890106328,1094.5796303059826,130983.81853136925,571,3,178.34146341463415,36,5,16,36.03968736190896,0.619212962962963,45.15765765765766,1019.3693693693698,28.315815815815828,0
586,4,1,1,40,0.024390243902439025,0.024390243902439025,0.975609756097561,41,1100,800,300,0.7272727272727273,14,8,6,355.67447411349565,0.4424288617886179,0.27953045346948935,0.20145989443689372,130032.77084094236,1049.8674772745767,131082.63831821695,572,0,179.21951219512195,36,5,18,35.94779360347429,0.6206597222222222,45.016891891891895,1019.9324324324331,28.331456456456475,0
587,4,0,0,40,0.0,0.0,1.0,40,1200,900,300,0.75,15,9,6,362.1301556147728,0.4401041666666667,0.2850522193211489,0.20461863635731453,129937.87140185611,1410.8843182012995,131348.7557200574,573,1,184.55,35,5,18,35.879616490710255,0.6217261904761905,45.1099537037037,1019.560185185185,29.130291005291,0
588,4,1,0,41,0.024390243902439025,0.0,1.0,41,1100,700,400,0.6363636363636364,15,7,8,358.68388171595194,0.44120934959349595,0.28292682926829293,0.2043663977218792,130262.58680555529,1145.0232821073046,131407.6100876626,574,0,181.02439024390245,35,6,19,35.63775510204079,0.625,44.79166666666665,1020.8333333333312,29.166666666666607,0
589,4,0,0,41,0.0,0.0,1.0,41,1550,1000,550,0.6451612903225806,21,10,11,363.82432146833594,0.44072662601626017,0.2873666439168081,0.2084021600000646,130469.43486636208,1293.590722522268,131763.02558888434,575,1,182.02439024390245,35,6,21,35.29665137268231,0.6270833333333333,44.58912037037036,1021.6435185185167,29.189814814814763,0
590,4,0,0,41,0.0,0.0,1.0,41,750,500,250,0.6666666666666666,10,5,5,361.48765893120077,0.4406758130081301,0.282930142784956,0.20801436425663158,130646.86381440746,1245.4457893947042,131892.30960380216,576,2,183.02439024390245,35,6,18,35.17644533755992,0.6288690476190476,44.41550925925925,1022.337962962962,29.209656084656057,0
591,4,0,2,39,0.0,0.04878048780487805,0.9512195121951219,41,1500,1000,500,0.6666666666666666,20,10,10,365.8374389637357,0.4401676829268293,0.28409279113162356,0.21100128007072888,130735.62349965691,1365.5971364883244,132101.22063614524,577,3,184.02439024390245,35,6,18,34.97529047834616,0.6297619047619047,44.328703703703695,1022.685185185184,29.219576719576686,0
592,4,0,0,39,0.0,0.0,1.0,39,1200,900,300,0.75,15,9,6,381.3232880044256,0.4357287449392713,0.30054639768034663,0.2188475498051551,130544.21864487206,2155.9101367262447,132700.1287815983,578,6,193.56410256410257,33,6,18,34.77372886437223,0.632260101010101,44.51593137254901,1021.9362745098031,30.967765894236457,0
593,4,0,0,39,0.0,0.0,1.0,39,1400,1000,400,0.7142857142857143,18,10,8,379.3641761932251,0.4359817813765183,0.30158173960619417,0.2182521350209576,130638.16350682439,2111.88785563246,132750.05136245684,579,7,194.56410256410257,33,6,19,34.72838248221849,0.6332070707070707,44.42401960784314,1022.3039215686282,30.978906714200853,0
594,4,0,0,39,0.0,0.0,1.0,39,1350,1000,350,0.7407407407407407,17,10,7,372.80735185376847,0.4360098965362123,0.2008848164792698,0.20891459118531577,129613.56122470861,1864.1777049039924,131477.7389296126,580,8,195.56410256410257,35,4,16,35.93761839812078,0.618452380952381,45.42824074074075,1018.287037037038,29.09391534391537,8
595,4,0,0,39,0.0,0.0,1.0,39,1350,800,550,0.5925925925925926,19,8,11,373.4434866147538,0.4362629329734593,0.19571523433404425,0.21021716471587554,129790.40745027442,1893.8764574760025,131684.28390775042,581,9,196.56410256410257,35,4,17,35.74132969862184,0.6202380952380953,45.25462962962963,1018.981481481482,29.113756613756628,0
596,4,0,2,37,0.0,0.05128205128205128,0.9487179487179487,39,1350,1000,350,0.7407407407407407,17,10,7,374.48916042570477,0.4360942420152947,0.18896757686631704,0.2116019893643383,129937.87140185622,1932.0648737568715,131869.9362756131,582,10,197.56410256410257,35,4,17,35.56459775986682,0.6217261904761905,45.10995370370371,1019.5601851851858,29.130291005291024,0
597,4,1,0,38,0.02631578947368421,0.0,1.0,38,1050,700,350,0.6666666666666666,14,7,7,383.4088061953287,0.4346995021337126,0.2081456998396536,0.2170960504081549,130019.64462868492,2370.135345805004,132389.77997448994,583,0,200.8421052631579,34,4,18,35.253978444418514,0.6246936274509804,45.02976190476191,1019.8809523809534,29.996498599439807,0
598,4,0,0,38,0.0,0.0,1.0,38,1100,900,200,0.8181818181818182,13,9,4,381.49687725083686,0.4345365101944049,0.2032487870785482,0.21651842636024335,130110.72137188219,2327.3667800453645,132438.08815192754,584,1,201.8421052631579,34,4,18,35.2100350058343,0.6256127450980392,44.9404761904762,1020.2380952380961,30.007002801120475,0
599,4,1,1,38,0.02564102564102564,0.02564102564102564,0.9743589743589743,39,1700,1300,400,0.7647058823529411,21,13,8,369.96966171562207,0.43570062977957713,0.19480728914691148,0.2126211188413878,130597.00255102056,1863.474348072579,132460.47689909313,585,0,197.64102564102564,34,5,15,35.010239537231136,0.6305147058823529,44.46428571428572,1022.1428571428584,30.06302521008407,0
600,4,0,0,38,0.0,0.0,1.0,38,750,500,250,0.6666666666666666,10,5,5,379.07464551920964,0.4324620673304884,0.20689676938808987,0.2173813201058577,130512.91120001933,2294.8271097654906,132807.73830978482,586,3,203.8421052631579,33,5,16,34.86297673302952,0.6319444444444444,44.54656862745099,1021.8137254901969,30.964052287581726,0
601,4,0,1,37,0.0,0.02631578947368421,0.9736842105263158,38,1550,1300,250,0.8387096774193549,18,13,5,375.5091685512213,0.432106448553817,0.19737788035869697,0.21673578981524844,130763.47588667825,2220.576821414847,132984.0527080931,587,4,204.8421052631579,33,5,16,34.69975637031712,0.634469696969697,44.3014705882353,1022.7941176470592,30.993761140819977,0
602,4,0,1,36,0.0,0.02702702702702703,0.972972972972973,37,1050,700,350,0.6666666666666666,14,7,7,420.7466196347442,0.4327765265265265,0.13937485989415332,0.2376232945513533,129918.783115268,3533.79424380044,133452.57735906844,588,5,207.1891891891892,33,4,17,34.40505168890491,0.6259469696969697,45.128676470588225,1019.4852941176457,30.89349376114078,8
603,4,0,0,36,0.0,0.0,1.0,36,1150,900,250,0.782608695652174,14,9,5,427.92802176257254,0.43067129629629625,0.16351760176017627,0.24281309100011123,130101.52025303525,3934.817238036919,134036.33749107216,589,21,213.80555555555554,32,4,18,34.035169141914196,0.6302083333333333,44.94949494949494,1020.2020202020191,31.881313131313096,0
604,4,1,0,37,0.02702702702702703,0.0,1.0,37,850,400,450,0.47058823529411764,13,4,9,417.5351535559256,0.4319319319319319,0.18094680667929097,0.23994516511083558,130595.10125054246,3505.8084089942513,134100.9096595367,590,0,209.0,31,6,16,33.79670912951168,0.637768817204301,44.46614583333333,1022.135416666666,32.97211021505374,0
605,4,0,0,37,0.0,0.0,1.0,37,1200,700,500,0.5833333333333334,17,7,10,418.09517773781425,0.43108733733733734,0.17449086527871427,0.24080616993746942,130681.82615294353,3527.4882665034115,134209.31441944695,591,1,210.0,32,5,16,33.6940190993661,0.6360677083333333,44.38131313131313,1022.4747474747471,31.952335858585847,0
606,4,0,0,37,0.0,0.0,1.0,37,950,600,350,0.631578947368421,13,6,7,415.8342525054385,0.43002377377377377,0.16977456350450693,0.24030592823103156,130810.95838434852,3479.135419855118,134290.09380420364,592,2,211.0,32,5,17,33.620299514523154,0.6373697916666667,44.255050505050505,1022.9797979797979,31.968118686868685,0
607,4,0,0,37,0.0,0.0,1.0,37,600,200,400,0.3333333333333333,10,2,8,415.90722703248235,0.4298048048048048,0.17090767183325517,0.24054934051707388,130843.25140610659,3483.730773645553,134326.98217975214,593,3,212.0,32,5,17,33.585554732815,0.6376953125,44.22348484848485,1023.1060606060611,31.97206439393941,0
608,4,0,0,37,0.0,0.0,1.0,37,1250,500,750,0.4,20,5,15,415.1733602560027,0.42955455455455455,0.12214890475760032,0.23422044286140536,129876.19447314054,3394.3067033976145,133270.50117653815,594,4,213.0,32,5,18,34.5906106775672,0.6279296875,45.17045454545455,1019.3181818181822,31.853693181818194,8
609,4,0,1,36,0.0,0.02702702702702703,0.972972972972973,37,1200,900,300,0.75,15,9,6,414.2457034956724,0.4294607107107107,0.11873818090536337,0.23408215925315282,129940.5533395827,3365.4631861544726,133306.01652573716,595,5,214.0,32,5,18,34.54850361197109,0.6285807291666667,45.10732323232323,1019.570707070707,31.861584595959595,0
610,4,1,0,37,0.02702702702702703,0.0,1.0,37,1550,1000,550,0.6451612903225806,21,10,11,408.74870812802754,0.4305555555555556,0.1000740076569464,0.23309723625679402,130296.89125910515,3252.5343075910023,133549.42556669615,596,0,201.59459459459458,30,7,19,34.325083377216096,0.6375,44.75806451612904,1020.9677419354842,34.03225806451614,0
611,4,0,0,37,0.0,0.0,1.0,37,1200,900,300,0.75,15,9,6,406.01589598969974,0.4297422422422423,0.1071125065336358,0.2325641918174611,130468.48127312411,3194.455464504573,133662.93673762868,597,1,202.59459459459458,30,7,20,34.22000394684908,0.6392361111111111,44.590053763440864,1021.639784946237,34.0546594982079,0
612,4,1,1,37,0.02631578947368421,0.02631578947368421,0.9736842105263158,38,1200,900,300,0.75,15,9,6,400.85130042399317,0.43154338549075394,0.1119402985074629,0.23262000662400242,130972.46334876552,2900.0964506172977,133872.5597993828,598,0,198.23684210526315,32,6,17,33.83932609678879,0.6389973958333333,44.09722222222223,1023.6111111111119,31.987847222222246,0
613,4,0,0,37,0.0,0.0,1.0,37,1150,900,250,0.782608695652174,14,9,5,415.63816486368216,0.4287725225225225,0.12017422160561364,0.24059512057537738,130875.54841342739,3479.3745536170036,134354.9229670444,599,1,204.54054054054055,32,5,17,33.55955906548208,0.6380208333333333,44.191919191919204,1023.2323232323247,31.976010101010147,0
614,4,0,0,37,0.0,0.0,1.0,37,900,500,400,0.5555555555555556,13,5,8,415.73229468973483,0.4284284284284284,0.12115149938984104,0.241053360569027,130940.15438475697,3487.21016988066,134427.36455463764,600,2,205.54054054054055,32,5,18,33.491395262768314,0.638671875,44.1287878787879,1023.484848484851,31.983901515151594,0
615,4,0,0,37,0.0,0.0,1.0,37,1050,800,250,0.7619047619047619,13,8,5,418.84351252004774,0.4279592092092092,0.1296624532622619,0.24372258987587198,131077.01965590173,3580.1518646674576,134657.1715205692,601,3,206.54054054054055,33,4,19,33.27249880325516,0.6376262626262627,43.9950980392157,1024.0196078431386,31.030897207367836,0
616,4,0,0,37,0.0,0.0,1.0,37,1000,600,400,0.6,14,6,8,421.9790221616874,0.4275838338338338,0.12580710869979872,0.24614952172013627,131171.15600069714,3670.295228998496,134841.45122969564,602,4,207.54054054054055,33,4,19,33.09643797104917,0.6385732323232323,43.90318627450982,1024.3872549019632,31.042038027332218,0
617,4,0,2,35,0.0,0.05405405405405406,0.9459459459459459,37,950,600,350,0.631578947368421,13,6,7,419.7294385524748,0.42761511511511513,0.11711927186694004,0.24543899057173402,131265.3261365822,3619.1843281430374,134884.51046472526,603,5,208.54054054054055,33,4,20,33.058279518456516,0.639520202020202,43.81127450980393,1024.7549019607852,31.053178847296522,0
618,4,0,0,35,0.0,0.0,1.0,35,1200,1000,200,0.8333333333333334,14,10,4,424.3383185144875,0.42696078431372547,0.1270648030495547,0.2481086602309825,131261.401706272,4139.848497178857,135401.25020345085,604,6,209.71428571428572,31,4,20,32.94419737399407,0.644489247311828,43.815104166666686,1024.7395833333358,33.056115591397926,0
619,4,0,0,35,0.0,0.0,1.0,35,650,300,350,0.46153846153846156,10,3,7,423.0286205301075,0.42731092436974794,0.12566782810685218,0.24777390631049168,131328.12500000012,4111.111111111124,135439.23611111124,605,7,210.71428571428572,31,4,20,32.90989159891598,0.6451612903225806,43.75000000000001,1025.000000000001,33.064516129032285,0
620,4,0,1,34,0.0,0.02857142857142857,0.9714285714285714,35,950,500,450,0.5263157894736842,14,5,9,448.5686284092028,0.426750700280112,0.13238403759211148,0.24358672609013945,128368.35048719513,4516.4029818385825,132884.75346903372,606,8,211.71428571428572,32,3,16,35.289735443143115,0.6126302083333333,46.6540404040404,1013.383838383838,31.668244949494937,8
621,4,1,0,35,0.02857142857142857,0.0,1.0,35,1150,600,550,0.5217391304347826,17,6,11,444.37672851527503,0.4292366946778712,0.16082760091718673,0.2434530175240128,128720.46100206621,4440.075470615254,133160.53647268147,607,0,212.22857142857143,32,3,17,35.03328356351872,0.6162109375,46.30681818181819,1014.772727272728,31.71164772727275,0
622,4,2,0,37,0.05405405405405406,0.0,1.0,37,850,700,150,0.8235294117647058,10,7,3,426.2881559242858,0.4337775275275275,0.16041638167451633,0.23676968660373002,129263.69214965412,3621.612942495117,132885.30509214924,608,0,201.7027027027027,33,4,19,34.934622800674866,0.6193181818181819,45.77205882352942,1016.9117647058835,30.815508021390407,0
623,4,0,0,37,0.0,0.0,1.0,37,1100,1000,100,0.9090909090909091,12,10,2,424.2365307741932,0.43262012012012013,0.1588984256899073,0.23634454967381083,129383.0002834468,3577.799036281195,132960.799319728,609,1,202.7027027027027,34,3,19,34.86450776191592,0.6182598039215687,45.65476190476191,1017.3809523809532,29.922969187675093,0
624,4,1,1,37,0.02631578947368421,0.02631578947368421,0.9736842105263158,38,900,500,400,0.5555555555555556,13,5,8,412.9034735150951,0.43520329540066377,0.14881991439297937,0.23242980695824156,129790.4074502744,3118.1820130315577,132908.58946330595,610,0,198.3421052631579,35,3,17,34.7361048008481,0.6202380952380953,45.25462962962963,1018.9814814814819,29.113756613756625,0
625,4,1,1,37,0.02631578947368421,0.02631578947368421,0.9736842105263158,38,1250,800,450,0.64,17,8,9,407.6427919132219,0.43624051683262205,0.1525168507098804,0.23016139174177325,129908.37191358043,2991.2422839506403,132899.61419753107,611,0,199.26315789473685,35,3,18,34.74965940054496,0.6214285714285714,45.1388888888889,1019.4444444444459,29.12698412698417,0
626,4,1,1,37,0.02631578947368421,0.02631578947368421,0.9736842105263158,38,1150,900,250,0.782608695652174,14,9,5,390.9878821265835,0.4364627785680417,0.16715472437848233,0.20378691351822362,126713.00482521011,2309.6143850737376,129022.61921028385,612,0,191.97368421052633,35,3,15,38.451378510939946,0.5889880952380953,48.292824074074076,1006.8287037037043,28.766534391534407,8
627,4,0,0,37,0.0,0.0,1.0,37,950,800,150,0.8421052631578947,11,8,3,398.63150634875143,0.4340903403403404,0.1801226350552112,0.20725896400198923,126612.30867346945,2694.3310657596458,129306.6397392291,613,1,198.1081081081081,34,3,15,38.363003706332314,0.5900735294117647,48.392857142857146,1006.4285714285719,29.600840336134468,0
628,4,0,0,37,0.0,0.0,1.0,37,450,200,250,0.4444444444444444,7,2,5,397.5656829307664,0.43337087087087084,0.17982016066669626,0.20731261074157972,126732.14994331071,2676.870748299324,129409.02069161003,614,2,199.1081081081081,34,3,16,38.266040040986816,0.5912990196078431,48.273809523809526,1006.9047619047623,29.61484593837536,0
629,4,2,0,39,0.05128205128205128,0.0,1.0,39,1150,900,250,0.782608695652174,14,9,5,387.84142841959846,0.43631916329284753,0.21401004493788012,0.20670669536648908,127617.73003472206,2099.598745748276,129717.32878047033,615,0,189.84615384615384,35,4,15,37.598797250859114,0.5982142857142857,47.39583333333332,1010.4166666666653,28.869047619047578,0
630,4,0,1,38,0.0,0.02564102564102564,0.9743589743589743,39,1200,700,500,0.5833333333333334,17,7,10,395.0801497537783,0.43581309041835353,0.22090549182228214,0.2116379686326648,127822.46823827595,2300.0239786951342,130122.49221697108,616,1,190.84615384615384,35,4,15,37.205395635420224,0.600297619047619,47.19328703703704,1011.2268518518523,28.89219576719578,0
631,4,4,3,39,0.09523809523809523,0.07142857142857142,0.9285714285714286,42,1200,900,300,0.75,15,9,6,364.8458113198334,0.4428958575300039,0.21748397015646792,0.20076274858187632,128895.01006319259,1006.1713574202906,129901.18142061288,617,0,176.16666666666666,37,5,15,36.872705431378904,0.6072635135135135,46.13486842105264,1015.46052631579,27.44487908961595,0
632,4,0,0,39,0.0,0.0,1.0,39,1650,1200,450,0.7272727272727273,21,12,9,400.9839840812945,0.4352226720647773,0.1690768700082257,0.20869884557480656,126654.74597318671,2364.8853860749855,129019.6313592617,618,1,190.71794871794873,35,4,16,38.259960331148676,0.5883928571428572,48.35069444444444,1006.5972222222222,28.759920634920633,7
633,4,0,1,38,0.0,0.02564102564102564,0.9743589743589743,39,1000,700,300,0.7,13,7,6,402.1888163879779,0.43533513270355373,0.17295978357925312,0.2099247085417993,126771.27707315239,2397.197975608707,129168.4750487611,619,2,191.71794871794873,35,4,18,38.10924510592652,0.5895833333333333,48.2349537037037,1007.0601851851848,28.773148148148135,0
634,4,3,1,40,0.07317073170731707,0.024390243902439025,0.975609756097561,41,1200,900,300,0.75,15,9,6,380.71748238603215,0.4406758130081301,0.172222876663918,0.2031370652404165,127662.84190759632,1521.9108327165698,129184.75274031289,620,0,178.9512195121951,34,7,19,37.73240860721718,0.600796568627451,47.351190476190474,1010.5952380952377,29.723389355742285,0
635,4,1,1,40,0.024390243902439025,0.024390243902439025,0.975609756097561,41,1250,900,350,0.72,16,9,7,343.0212444519933,0.4400914634146342,0.08899602949517882,0.18312533704942754,127685.20801373367,559.7477901965106,128244.95580393019,621,0,179.9268292682927,38,3,17,38.66190979563073,0.5932017543859649,47.32905982905983,1010.6837606837607,26.59694107062528,7
636,4,1,2,39,0.024390243902439025,0.04878048780487805,0.9512195121951219,41,1500,1200,300,0.8,18,12,6,337.653267921885,0.44110772357723577,0.10015765556895095,0.18123022339480796,127901.25739644995,437.25550624591676,128338.51290269586,622,0,180.8048780487805,38,3,18,38.57665293620617,0.5953947368421053,47.11538461538463,1011.5384615384636,26.61943319838062,0
637,4,1,0,40,0.025,0.0,1.0,40,1200,800,400,0.6666666666666666,16,8,8,341.9640003881244,0.4402110042735043,0.10597973339113453,0.18376830702278577,127950.32035097369,750.880679632225,128701.20103060592,623,0,185.875,37,3,20,38.41748401430583,0.5976914414414414,47.066885964912295,1011.7324561403534,27.34412043622577,0
638,4,1,0,41,0.024390243902439025,0.0,1.0,41,1200,1100,100,0.9166666666666666,13,11,2,333.0780937919743,0.4407012195121951,0.10205168169998702,0.18059345702854768,128306.84222961895,347.2396860618346,128654.08191568078,624,0,182.3170731707317,38,3,21,38.278366550669624,0.5995065789473684,46.714743589743605,1013.1410256410279,26.661605937921788,0
639,4,1,1,41,0.023809523809523808,0.023809523809523808,0.9761904761904762,42,1100,800,300,0.7272727272727273,14,8,6,328.0770238583143,0.4415166473093302,0.10043427867192878,0.17916354353945121,128593.16541883719,37.69259982642876,128630.85801866362,625,0,178.95238095238096,39,3,16,38.11331775700934,0.6006944444444444,46.432291666666686,1014.2708333333364,26.006944444444525,0
640,4,2,2,41,0.046511627906976744,0.046511627906976744,0.9534883720930233,43,1050,600,450,0.5714285714285714,15,6,9,325.3221158334483,0.44398301956441494,0.1120270565741055,0.17970002840347088,129046.45568940473,-203.6667988630832,128842.78889054165,626,0,167.7674418604651,40,3,18,37.72212775888511,0.6036458333333333,45.98577235772359,1016.0569105691079,25.401422764227696,0
641,4,1,1,41,0.023809523809523808,0.023809523809523808,0.9761904761904762,42,1100,700,400,0.6363636363636364,15,7,8,333.47773920824403,0.4430652342237708,0.11665568328817955,0.18431021790234697,129069.0443250869,208.33062065973226,129277.37494574663,627,0,172.0,39,3,19,37.49199128651974,0.6055021367521367,45.96354166666667,1016.1458333333342,26.055021367521388,0
642,4,1,3,39,0.023809523809523808,0.07142857142857142,0.9285714285714286,42,950,600,350,0.631578947368421,13,6,7,333.582630619254,0.4439363143631436,0.11861809094281428,0.18449161815881196,129095.50781250003,212.80381944444562,129308.31163194448,628,0,172.85714285714286,39,3,20,37.462416290829566,0.6057692307692308,45.9375,1016.2500000000002,26.057692307692314,0
643,4,1,0,40,0.025,0.0,1.0,40,800,400,400,0.5,12,4,8,339.0684045361738,0.4435763888888889,0.11593655589123841,0.18749916308122072,129089.93632656205,754.0637503847321,129844.00007694679,629,0,174.55,37,3,21,37.328711696158805,0.6092342342342343,45.94298245614035,1016.2280701754388,27.465623518255104,0
644,4,1,0,41,0.024390243902439025,0.0,1.0,41,1450,1100,350,0.7586206896551724,18,11,7,336.27641414528716,0.44596036585365856,0.12003227922065629,0.18770413555472276,129459.11864144557,506.9058224719874,129966.02446391757,630,0,171.26829268292684,36,5,15,37.024408911511934,0.6148726851851851,45.57995495495496,1017.6801801801807,28.26889389389391,0
645,4,0,1,40,0.0,0.024390243902439025,0.975609756097561,41,600,300,300,0.5,9,3,6,337.1179048276443,0.44552845528455287,0.12037843860354336,0.18872340418246003,129573.7476285406,536.3260642399009,130110.0736927805,631,1,172.26829268292684,36,5,15,36.88659071636617,0.6160300925925926,45.467342342342334,1018.1306306306298,28.281406406406383,0
646,4,0,0,40,0.0,0.0,1.0,40,1250,1100,150,0.88,14,11,3,343.81722140559873,0.44635416666666666,0.12606182944364597,0.19247377701102272,129573.74762854069,909.9371753510271,130483.68480389171,632,2,176.0,36,4,16,36.71607123105852,0.6160300925925926,45.46734234234234,1018.1306306306304,28.2814064064064,0
647,4,1,3,38,0.024390243902439025,0.07317073170731707,0.926829268292683,41,1000,800,200,0.8,12,8,4,335.83251275145193,0.4475863821138211,0.12361747070940332,0.1893003763508031,129843.17440221987,521.1119046244946,130364.28630684437,633,0,172.6829268292683,37,4,17,36.645934194011105,0.6168355855855856,45.20285087719298,1019.1885964912277,27.545637743006154,0
648,4,0,1,37,0.0,0.02631578947368421,0.9736842105263158,38,1850,1400,450,0.7567567567567568,23,14,9,356.3535895568087,0.4433528923660503,0.13398188828118052,0.20074813538373015,129819.89354263125,1652.3570119598883,131472.25055459116,634,1,184.94736842105263,35,3,17,36.14672061328792,0.6205357142857143,45.22569444444445,1019.0972222222229,29.11706349206351,0
649,4,0,2,35,0.0,0.05405405405405406,0.9459459459459459,37,1000,500,500,0.5,15,5,10,365.4610276084506,0.4421296296296296,0.14137894025770725,0.2061315756510906,129867.92091836737,2092.332766439915,131960.25368480728,635,2,190.35135135135135,34,3,17,35.86584131433465,0.6231617647058824,45.17857142857143,1019.2857142857144,29.97899159663866,0
650,4,0,0,35,0.0,0.0,1.0,35,1300,900,400,0.6923076923076923,17,9,8,378.660274079685,0.438375350140056,0.1517832781134283,0.21187632129802242,129554.63927469142,2811.4390432098835,132366.0783179013,636,3,201.68571428571428,32,3,17,35.848681218735784,0.6246744791666667,45.486111111111114,1018.0555555555561,31.81423611111113,0
651,4,0,1,34,0.0,0.02857142857142857,0.9714285714285714,35,700,400,300,0.5714285714285714,10,4,6,376.80697278911566,0.4382002801120448,0.15284863945578242,0.21101190476190473,129586.77685950411,2765.840220385673,132352.61707988978,637,4,202.68571428571428,32,3,17,35.86309523809525,0.625,45.45454545454545,1018.181818181818,31.818181818181813,0
652,4,2,0,36,0.05555555555555555,0.0,1.0,36,1100,800,300,0.7272727272727273,14,8,6,368.605779878717,0.4393849206349207,0.17400891344088154,0.20951401563481759,130168.77710796331,2396.192720347943,132564.96982831127,638,0,197.63888888888889,33,3,19,35.47983967815539,0.6284722222222222,44.88357843137255,1020.46568627451,30.92320261437909,0
653,4,0,0,36,0.0,0.0,1.0,36,1150,900,250,0.782608695652174,14,9,5,372.5234030212032,0.438723544973545,0.17553206105821384,0.21260386451887586,130327.04132550258,2510.0083791422117,132837.0497046448,639,1,198.63888888888889,32,4,20,35.219075883104566,0.6324869791666667,44.72853535353536,1021.0858585858592,31.9089330808081,0
654,4,2,0,38,0.05263157894736842,0.0,1.0,38,1050,900,150,0.8571428571428571,12,9,3,354.82444223633604,0.441100640113798,0.17949039750708606,0.20569290154455705,130931.84700963716,1691.563917233555,132623.4109268707,640,0,189.1315789473684,34,4,19,35.05825675623279,0.6338848039215687,44.13690476190476,1023.4523809523807,30.101540616246492,0
655,4,0,0,38,0.0,0.0,1.0,38,1350,900,450,0.6666666666666666,18,9,9,356.20961112059365,0.4409080132764343,0.18722119215023914,0.20715070082814238,131053.71492346934,1736.5185657596282,132790.23348922897,641,1,190.1315789473684,34,4,19,34.899527186761226,0.6351102941176471,44.01785714285714,1023.928571428571,30.11554621848738,0
656,4,0,0,38,0.0,0.0,1.0,38,1100,900,200,0.8181818181818182,13,9,4,357.2223066245714,0.44080429113323855,0.1863326687623077,0.20856547970224296,131206.12953514734,1773.9512471655219,132980.08078231287,642,2,191.1315789473684,34,4,19,34.7194786583004,0.6366421568627452,43.86904761904761,1024.523809523809,30.1330532212885,0
657,4,0,3,35,0.0,0.07894736842105263,0.9210526315789473,38,1050,700,350,0.6666666666666666,14,7,7,359.1666024532914,0.4405523944997629,0.1859712296189422,0.21020158263224897,131297.6208191608,1831.54407596369,133129.1648951245,643,3,192.1315789473684,34,4,19,34.57718666511789,0.6375612745098039,43.77976190476189,1024.8809523809507,30.14355742296914,0
658,4,0,0,35,0.0,0.0,1.0,35,1100,700,400,0.6363636363636364,15,7,8,379.6690224146195,0.4360294117647059,0.18648452259845993,0.22083707043406547,131061.33355034716,2951.985677083328,134013.31922743047,644,4,202.62857142857143,31,4,19,34.29128518141743,0.6424731182795699,44.010416666666664,1023.9583333333328,33.03091397849461,0
659,4,0,1,34,0.0,0.02857142857142857,0.9714285714285714,35,1050,900,150,0.8571428571428571,12,9,3,379.2908356463237,0.4358543417366947,0.19487253976323626,0.22138429487131134,131194.69536675356,2952.189127604172,134146.88449435774,645,5,203.62857142857143,31,4,19,34.165819352652086,0.6438172043010753,43.880208333333336,1024.4791666666672,33.04771505376346,0
660,4,0,0,34,0.0,0.0,1.0,34,1600,1400,200,0.875,18,14,4,387.1434741342576,0.432876559714795,0.19690142583791115,0.22634830113493695,131259.24962423395,3363.2323823563333,134622.4820065903,646,6,209.61764705882354,30,4,22,33.899254547044414,0.6472222222222221,43.817204301075265,1024.7311827956985,34.15770609318995,0
661,4,0,0,34,0.0,0.0,1.0,34,1200,800,400,0.6666666666666666,16,8,8,387.5407911608538,0.43172534165181226,0.1990277038853292,0.22760190113673245,131431.47193678463,3387.0113235634153,134818.48326034803,647,7,210.61764705882354,30,4,23,33.71455411368899,0.6489583333333333,43.649193548387096,1025.4032258064517,34.18010752688172,0
662,4,0,0,34,0.0,0.0,1.0,34,950,600,350,0.631578947368421,13,6,7,387.97664253787434,0.43111259655377304,0.2000632013811814,0.2284751339389704,131534.85952133193,3406.4906347554615,134941.3501560874,648,8,211.61764705882354,30,4,23,33.598663522012586,0.65,43.54838709677419,1025.8064516129032,34.193548387096776,0
663,4,0,1,33,0.0,0.029411764705882353,0.9705882352941176,34,1150,700,450,0.6086956521739131,16,7,9,387.89082659633596,0.43049985145573383,0.19855059069975245,0.22966745221262108,131741.7566337148,3420.283775580987,135162.0404092958,649,9,212.61764705882354,30,4,19,33.39143100288034,0.6520833333333333,43.346774193548384,1026.612903225806,34.220430107526866,0
664,4,0,1,32,0.0,0.030303030303030304,0.9696969696969697,33,1250,1100,150,0.88,14,11,3,397.8077679926389,0.4309501262626263,0.2028350642319241,0.2347447116557202,131613.00154320983,3871.3348765432083,135484.33641975303,650,10,217.3939393939394,29,4,19,33.26734795163328,0.6537356321839081,43.47222222222222,1026.1111111111109,35.3831417624521,0
665,4,0,0,32,0.0,0.0,1.0,32,550,300,250,0.5454545454545454,8,3,5,398.5889793429953,0.4301495295698925,0.17787538084514476,0.21819783938073042,128689.46419022432,3858.840436755693,132548.30462698,651,11,205.8125,30,2,18,36.226652536759815,0.6211805555555556,46.33736559139785,1014.6505376344087,33.82168458781362,8
666,4,0,0,32,0.0,0.0,1.0,32,1050,800,250,0.7619047619047619,13,8,5,397.6772146548519,0.4293934811827957,0.180191098610192,0.21882384244118028,128894.11212640186,3851.6502991675293,132745.76242556938,652,12,206.8125,30,2,18,36.04015001103022,0.6232638888888888,46.13575268817204,1015.4569892473115,33.84856630824372,0
667,4,0,0,32,0.0,0.0,1.0,32,1050,800,250,0.7619047619047619,13,8,5,397.4073094452758,0.428721438172043,0.17865706442651175,0.21943037634016338,129030.63441221515,3855.5434515550774,132886.17786377022,653,13,207.8125,30,2,18,35.907251841072444,0.6246527777777777,46.0013440860215,1015.994623655913,33.866487455197095,0
668,4,3,1,34,0.08571428571428572,0.02857142857142857,0.9714285714285714,35,1150,900,250,0.782608695652174,14,9,5,375.8449620791963,0.4354341736694678,0.19406606606606625,0.2132862514866604,130106.2560823961,2779.9561767108676,132886.21225910695,654,0,190.9142857142857,33,2,16,35.35873373373373,0.6278409090909092,44.944852941176464,1020.2205882352933,30.915775401069496,0
669,4,0,0,34,0.0,0.0,1.0,34,1200,900,300,0.75,15,9,6,386.24279822853697,0.43460338680926913,0.19833826078091565,0.2187986903289004,130037.12153096613,3245.1803387409323,133282.30186970707,655,1,197.52941176470588,32,2,17,35.163922588099354,0.6295572916666667,45.012626262626256,1019.9494949494942,31.873421717171695,0
670,4,0,1,33,0.0,0.029411764705882353,0.9705882352941176,34,800,600,200,0.75,10,6,4,386.5372140611763,0.4342877302436126,0.18980251424911065,0.21950858937655393,130133.72559241392,3260.305549178644,133394.03114159257,656,2,198.52941176470588,32,2,18,35.058057996122585,0.6305338541666667,44.91792929292929,1020.3282828282818,31.885258838383805,0
671,4,1,0,34,0.029411764705882353,0.0,1.0,34,850,600,250,0.7058823529411765,11,6,5,386.8379981489663,0.43374925727866903,0.1921196120932116,0.22097381059594606,130362.29663425009,3285.8817418221556,133648.17837607223,657,0,199.02941176470588,31,3,20,34.81780462408092,0.6354166666666667,44.69401041666666,1021.2239583333322,32.9427083333333,0
672,4,0,0,34,0.0,0.0,1.0,34,1000,700,300,0.7,13,7,6,386.45099991428935,0.43371212121212116,0.1924680388407758,0.2211311520297298,130428.79104614235,3280.8673434787047,133709.65838962104,658,1,200.02941176470588,31,3,21,34.7600647971107,0.6360887096774194,44.628906249999986,1021.4843749999982,32.95110887096768,0
673,4,0,0,34,0.0,0.0,1.0,34,600,400,200,0.6666666666666666,8,4,4,387.4533569003731,0.4332479203802733,0.19382982550818517,0.22227587316916142,130528.56445312501,3314.746093750001,133843.31054687503,659,2,201.02941176470588,31,3,16,34.63302752293578,0.6370967741935484,44.53125,1021.8750000000001,32.96370967741936,0
674,4,0,0,34,0.0,0.0,1.0,34,1200,1100,100,0.9166666666666666,13,11,2,390.6151162318962,0.4331365121806298,0.19561633570625747,0.22447501189021835,130595.10125054243,3402.4841308593664,133997.5853814018,660,3,202.02941176470588,31,3,16,34.484607218683664,0.637768817204301,44.46614583333333,1022.1354166666657,32.97211021505373,0
675,4,0,1,33,0.0,0.029411764705882353,0.9705882352941176,34,500,200,300,0.4,8,2,6,386.2111217116135,0.4330808080808081,0.1942091729257771,0.22244222358610571,130681.82615294354,3294.1549331700785,133975.9810861136,661,4,203.02941176470588,32,2,16,34.509035152712606,0.6360677083333333,44.38131313131313,1022.4747474747472,31.95233585858585,0
676,4,0,0,33,0.0,0.0,1.0,33,1050,900,150,0.8571428571428571,12,9,3,398.51428091518676,0.4315419823232323,0.201585224135868,0.2288177462255523,130561.83073255746,3806.1508178710897,134367.98155042855,662,8,210.06060606060606,31,2,17,34.31660614940331,0.6374327956989247,44.498697916666664,1022.0052083333329,32.967909946236546,0
677,4,1,0,34,0.029411764705882353,0.0,1.0,34,500,300,200,0.6,7,3,4,387.1769393155306,0.433322192513369,0.19096055448706317,0.22430801237686745,130907.84940631059,3336.9000931027467,134244.74949941333,663,0,204.85294117647058,32,2,19,34.25483240797862,0.6383463541666667,44.160353535353536,1023.3585858585859,31.97995580808081,0
678,4,0,0,34,0.0,0.0,1.0,34,1000,700,300,0.7,13,7,6,389.2976508063212,0.43298796791443855,0.19119279232225672,0.22629495701709382,131037.09323347111,3402.48651285584,134439.57974632696,664,1,205.85294117647058,32,2,20,34.069398199531406,0.6396484375,44.034090909090914,1023.8636363636366,31.995738636363644,0
679,4,0,1,33,0.0,0.029411764705882353,0.9705882352941176,34,550,200,350,0.36363636363636365,9,2,7,387.2779122346625,0.43261660724896017,0.18687872042691134,0.22587963349818968,131166.40082963483,3359.5699737271866,134525.97080336203,665,2,206.85294117647058,32,2,20,33.989944122601585,0.6409505208333333,43.90782828282829,1024.3686868686877,32.01152146464649,0
680,4,0,1,32,0.0,0.030303030303030304,0.9696969696969697,33,900,500,400,0.5555555555555556,13,5,8,397.8171605770763,0.4320943813131313,0.18428309531512377,0.23219773141101185,131194.69536675359,3838.300238715296,135032.9956054689,666,3,210.54545454545453,31,2,20,33.69132350449077,0.6438172043010753,43.88020833333334,1024.4791666666677,33.047715053763476,0
681,4,0,1,31,0.0,0.03125,0.96875,32,1000,700,300,0.7,13,7,6,393.56451463887385,0.43075856854838707,0.09537241402029228,0.2230590815231078,130056.85492903802,3837.2204139613314,133894.07534299936,667,4,216.3125,30,2,21,34.95711995431985,0.6350694444444445,44.99327956989247,1020.02688172043,34.00089605734767,8
682,4,0,0,31,0.0,0.0,1.0,31,900,700,200,0.7777777777777778,11,7,4,395.1104795276668,0.42782258064516127,0.12427359650441816,0.21411113207093624,128285.19483024692,3937.3649691358078,132222.55979938273,668,14,224.16129032258064,29,2,24,36.729389452518056,0.6199712643678161,46.736111111111114,1013.0555555555557,34.93295019157088,8
683,4,0,0,31,0.0,0.0,1.0,31,1400,1000,400,0.7142857142857143,18,10,8,392.9469003510894,0.42692652329749103,0.12537006930777772,0.21345962742415084,128382.79714417855,3889.52443924153,132272.32158342007,669,15,225.16129032258064,30,1,20,36.68407382847037,0.6180555555555556,46.63978494623656,1013.4408602150539,33.78136200716846,0
684,4,0,0,31,0.0,0.0,1.0,31,550,200,350,0.36363636363636365,9,2,7,395.03275601649784,0.42629928315412186,0.12443862755665025,0.21495938281936686,128450.91376170653,3948.463695224875,132399.3774569314,670,16,226.16129032258064,30,1,20,36.56136745337223,0.61875,46.57258064516129,1013.7096774193545,33.79032258064515,0
685,4,0,0,31,0.0,0.0,1.0,31,800,600,200,0.75,10,6,4,393.3565008226044,0.42576164874551975,0.12403790237060885,0.2144133990033038,128519.04844490683,3910.7606370678577,132429.8090819747,671,17,227.16129032258064,30,1,20,36.534000530222706,0.6194444444444445,46.50537634408602,1013.9784946236551,33.79928315412184,0
686,4,0,0,31,0.0,0.0,1.0,31,500,200,300,0.4,8,2,6,393.6838434820721,0.4252688172043011,0.11999401440817503,0.21477545907969872,128553.12256113417,3921.8574762978315,132474.980037432,672,18,228.16129032258064,30,1,20,36.49077755688093,0.6197916666666667,46.471774193548384,1014.1129032258059,33.803763440860195,0
687,4,1,0,32,0.03125,0.0,1.0,32,650,300,350,0.46153846153846156,10,3,7,383.00484453353806,0.42704133064516125,0.1215028521984367,0.21115341287675815,128969.83040703658,3479.213968912755,132449.04437594934,673,0,222.0,31,1,21,36.335218775370684,0.6213037634408602,46.061197916666664,1015.7552083333326,32.76629704301073,0
688,4,0,0,32,0.0,0.0,1.0,32,750,300,450,0.4,12,3,9,384.00571916111824,0.4254452284946237,0.1319947149263292,0.2124142195643182,129102.12410820863,3515.190802680126,132617.31491088876,674,1,223.0,31,1,22,36.17459427717274,0.6226478494623655,45.930989583333336,1016.2760416666673,32.78309811827959,0
689,4,0,0,32,0.0,0.0,1.0,32,650,500,150,0.7692307692307693,8,5,3,384.9007139505019,0.42588625672043007,0.13512842685114013,0.21308758674451184,129135.20812988281,3540.8467610677085,132676.05489095053,675,2,224.0,31,1,22,36.118050217781196,0.622983870967742,45.8984375,1016.40625,32.787298387096776,0
690,4,0,0,32,0.0,0.0,1.0,32,350,300,50,0.8571428571428571,4,3,1,384.9007139505019,0.42588625672043007,0.13512842685114013,0.21308758674451184,129135.20812988281,3540.8467610677085,132676.05489095053,676,3,225.0,31,1,22,36.118050217781196,0.622983870967742,45.8984375,1016.40625,32.787298387096776,0
691,4,2,0,34,0.058823529411764705,0.0,1.0,34,750,400,350,0.5333333333333333,11,4,7,367.16811156620514,0.429794266191325,0.14574346208788902,0.20719839565859544,129887.5507617263,2738.1133458285362,132625.66410755485,677,0,212.7058823529412,33,1,23,35.80237637252545,0.6256313131313131,45.1593137254902,1019.3627450980396,30.889780154486047,0
692,4,0,0,34,0.0,0.0,1.0,34,1600,1200,400,0.75,20,12,8,367.50509067626166,0.4294971776589424,0.1453700759583112,0.20855350237763326,130106.25608239621,2762.9422878219916,132869.1983702182,678,1,213.7058823529412,33,1,24,35.571446446446444,0.6278409090909092,44.94485294117647,1020.2205882352943,30.915775401069524,0
693,4,0,0,34,0.0,0.0,1.0,34,600,300,300,0.5,9,3,6,368.97389545447436,0.42933006535947715,0.15152285698140955,0.2098917077421353,130200.0432525951,2808.0834294502083,133008.12668204532,679,2,214.7058823529412,33,1,24,35.43868075568364,0.6287878787878788,44.85294117647059,1020.5882352941172,30.926916221033856,0
694,4,1,0,35,0.02857142857142857,0.0,1.0,35,800,600,200,0.75,10,6,4,358.29868479317264,0.4319327731092437,0.15112024665981494,0.20579965779442552,130575.52984429065,2357.0231401384062,132932.55298442906,680,0,209.54285714285714,33,2,18,35.33023581135092,0.6325757575757576,44.48529411764706,1022.0588235294117,30.971479500891263,0
695,4,0,0,35,0.0,0.0,1.0,35,1100,800,300,0.7272727272727273,14,8,6,357.3228661369135,0.43249299719887957,0.1476687043030085,0.20573807261423546,130669.48596993953,2338.2390486832073,133007.72501862273,681,1,210.54285714285714,33,2,18,35.25997343082024,0.6335227272727273,44.39338235294118,1022.426470588236,30.982620320855638,0
696,4,0,0,35,0.0,0.0,1.0,35,1100,700,400,0.6363636363636364,15,7,8,361.9005222773104,0.4320728291316527,0.15306562596282203,0.20888117281648907,130763.47588667824,2464.6740436370687,133228.1499303153,682,2,211.54285714285714,33,2,18,35.047727454269506,0.634469696969697,44.3014705882353,1022.7941176470591,30.993761140819974,0
697,4,0,0,35,0.0,0.0,1.0,35,700,400,300,0.5714285714285714,10,4,6,364.2348450914221,0.4315826330532213,0.1590663289752896,0.2105701168160105,130826.15460399848,2530.2888312187656,133356.44343521725,683,3,212.54285714285714,33,2,18,34.92453282223286,0.6351010101010102,44.240196078431374,1023.0392156862747,31.001188354129535,0
698,4,0,0,35,0.0,0.0,1.0,35,750,400,350,0.5333333333333333,11,4,7,365.2003298791638,0.43109243697478994,0.16041060735671508,0.21147175828647832,130888.84833958095,2560.1301182237617,133448.9784578047,684,4,213.54285714285714,33,2,18,34.83632734530938,0.6357323232323233,44.17892156862745,1023.2843137254904,31.008615567439104,0
699,4,0,1,34,0.0,0.02857142857142857,0.9714285714285714,35,700,600,100,0.8571428571428571,8,6,2,366.33069541476374,0.4306372549019608,0.16352532630822636,0.21229893389373303,130920.20083922053,2592.017643454442,133512.21848267497,685,5,214.54285714285714,33,2,18,34.775650620684154,0.6360479797979798,44.14828431372549,1023.4068627450984,31.01232917409389,0
700,4,0,0,34,0.0,0.0,1.0,34,800,500,300,0.625,11,5,6,375.2615514038363,0.4281231431966726,0.17163095333183231,0.21667810605292082,130778.66934815334,3015.2412700234777,133793.91061817683,686,6,221.61764705882354,32,2,18,34.69067604822449,0.6370442708333333,44.286616161616166,1022.8535353535361,31.964172979798004,0
701,4,0,0,34,0.0,0.0,1.0,34,800,500,300,0.625,11,5,6,417.6627279557404,0.428048871063577,0.19980554205153123,0.21972691340280276,127092.01388888896,3816.3194444444543,130908.33333333342,687,7,222.61764705882354,33,1,18,37.38808539944904,0.5972222222222222,47.91666666666667,1008.333333333334,30.55555555555558,8
702,4,3,2,35,0.08108108108108109,0.05405405405405406,0.9459459459459459,37,1200,700,500,0.5833333333333334,17,7,10,390.60941134094634,0.43928303303303307,0.1926903960084334,0.20998035338309326,127963.79145408167,2596.7722505668976,130560.56370464856,688,0,205.48648648648648,34,3,18,37.173245872063376,0.6038602941176471,47.05357142857143,1011.7857142857147,29.75840336134455,0
703,4,0,0,35,0.0,0.0,1.0,35,1250,1000,250,0.8,15,10,5,434.4003556274994,0.4320728291316527,0.1847347248029152,0.21703573603874884,124968.43633621576,3857.3941883533416,128825.8305245691,689,1,218.22857142857143,32,3,18,39.17292797912195,0.5777994791666667,50.03156565656566,999.8737373737379,31.24605429292931,8
704,4,6,1,40,0.14634146341463414,0.024390243902439025,0.975609756097561,41,950,600,350,0.631578947368421,13,6,7,376.18964080522767,0.4475609756097561,0.19160878694879613,0.19587805435030822,126672.22222222228,1339.778147638001,128012.00036986028,690,0,187.14634146341464,34,7,20,38.86589403973508,0.5906862745098039,48.333333333333336,1006.6666666666672,29.607843137254918,0
705,4,2,0,42,0.047619047619047616,0.0,1.0,42,1000,800,200,0.8,12,8,4,373.4156191726755,0.44761420828494,0.2039652576462394,0.1973236152186782,127272.13718820864,1105.7752267573746,128377.91241496602,691,0,183.64285714285714,34,8,22,38.31824170206073,0.5968137254901961,47.73809523809524,1009.0476190476193,29.67787114845939,0
706,4,1,3,40,0.023255813953488372,0.06976744186046512,0.9302325581395349,43,650,200,450,0.3076923076923077,11,2,9,366.40730888267717,0.4485972683647102,0.209462122745528,0.19556654163591297,127676.20991941002,756.2992969821505,128432.50921639217,692,0,180.34883720930233,35,8,17,38.08024125820735,0.5988095238095238,47.337962962962955,1010.6481481481471,28.87566137566135,0
707,4,1,0,41,0.024390243902439025,0.0,1.0,41,1000,800,200,0.8,12,8,4,379.7259754112852,0.4467479674796748,0.22315712240091812,0.2022261589981029,127586.77551903109,1489.6025567089487,129076.37807574004,693,0,188.6829268292683,33,8,18,37.83559760633997,0.6022727272727273,47.42647058823529,1010.2941176470584,30.614973262032073,0
708,4,0,2,39,0.0,0.04878048780487805,0.9512195121951219,41,1450,1100,350,0.7586206896551724,18,11,7,352.5633526456974,0.4461636178861788,0.1946978203479508,0.18770598436703545,127575.06397867449,795.6584540621542,128370.72243273664,694,1,189.6829268292683,36,5,15,38.533654739345295,0.595775462962963,47.438063063063055,1010.2477477477466,28.062437437437406,8
709,4,0,1,38,0.0,0.02564102564102564,0.9743589743589743,39,1050,700,350,0.6666666666666666,14,7,7,365.0236961552157,0.44188596491228066,0.20503749395258852,0.19346255896226386,127392.29024943279,1500.2409297051754,128892.53117913796,695,2,200.2051282051282,34,5,16,38.40654481132074,0.5980392156862745,47.6190476190476,1009.5238095238069,29.691876750700203,0
710,4,0,1,37,0.0,0.02631578947368421,0.9736842105263158,38,1200,700,500,0.5833333333333334,17,7,10,372.97852485671,0.43948553816974867,0.21094179461283757,0.19711843219962422,127277.43686322548,1894.3501297577598,129171.78699298324,696,4,206.42105263157896,33,5,19,38.32381993360861,0.5991161616161615,47.73284313725489,1009.0686274509787,30.577837195484204,0
711,4,2,0,39,0.05128205128205128,0.0,1.0,39,450,200,250,0.4444444444444444,7,2,5,364.05847590198056,0.441689158794422,0.21795928969918887,0.19424842249729163,127662.84190759622,1495.3479308389842,129158.1898384352,697,0,201.92307692307693,34,5,19,38.1532964228217,0.600796568627451,47.35119047619047,1010.5952380952369,29.723389355742263,0
712,4,1,0,40,0.025,0.0,1.0,40,600,300,300,0.5,9,3,6,356.66922654171407,0.4428685897435898,0.2173072644343086,0.19232751513998012,128087.5274556651,1136.9758694505274,129224.50332511563,698,0,197.85,36,4,20,37.90512478214114,0.6009837962962963,46.931306306306304,1012.2747747747746,28.11874374374374,0
713,4,1,0,41,0.024390243902439025,0.0,1.0,41,1050,800,250,0.7619047619047619,13,8,5,351.6643770151221,0.4445121951219512,0.23246036991689345,0.19166985778717666,128515.3650271893,838.8678374320211,129354.23286462131,699,0,194.0,36,5,20,37.594633866429746,0.6053240740740741,46.509009009009006,1013.9639639639635,28.165665665665653,0
714,4,0,0,41,0.0,0.0,1.0,41,1100,700,400,0.6363636363636364,15,7,8,352.3860969053755,0.4447916666666667,0.23377052376207574,0.1926149248133266,128629.57552146734,865.4548129210184,129495.03033438836,700,1,195.0,36,5,20,37.4597579928952,0.6064814814814814,46.39639639639639,1014.4144144144138,28.17817817817816,0
715,4,1,0,42,0.023809523809523808,0.0,1.0,42,1150,600,550,0.5217391304347826,17,6,11,346.4110981728427,0.44711817653890823,0.22682407735846133,0.19088673422814026,128950.68825263533,533.9899055478487,129484.67815818317,701,0,191.33333333333334,37,5,21,37.28397477419122,0.6078265765765766,46.080043859649116,1015.6798245614027,27.4508060692271,0
716,4,2,1,43,0.045454545454545456,0.022727272727272728,0.9772727272727273,44,1300,1100,200,0.8461538461538461,15,11,4,345.21640220705615,0.4506915081042988,0.16657320116806584,0.18721591143200025,128315.61872260776,353.829916337549,128669.44863894531,702,0,183.5909090909091,36,8,18,37.96195954206957,0.6032986111111112,46.70608108108108,1013.1756756756758,28.143768768768773,8
717,4,1,1,43,0.022727272727272728,0.022727272727272728,0.9772727272727273,44,1050,800,250,0.7619047619047619,13,8,5,352.5216155190742,0.4500528541226216,0.20182120875794562,0.19296596329446297,128686.6997910073,272.9686612288039,128959.6684522361,703,0,184.54545454545453,36,8,18,37.39802996670365,0.6070601851851851,46.340090090090094,1014.6396396396402,28.18443443443445,0
718,4,0,0,43,0.0,0.0,1.0,43,1700,1300,400,0.7647058823529411,21,13,8,351.3555512865229,0.44797434477667036,0.2265739460597178,0.19315985673166391,128858.1486892297,455.0051740930039,129313.1538633227,704,1,189.69767441860466,36,7,19,37.2527543626146,0.6087962962962963,46.17117117117117,1015.3153153153148,28.203203203203188,0
719,4,0,0,43,0.0,0.0,1.0,43,900,700,200,0.7777777777777778,11,7,4,351.7097317442599,0.44790513104466595,0.1589441445182722,0.18580891488376036,127262.39753266811,475.3813357276581,127737.77886839576,705,2,190.69767441860466,36,7,18,38.87579055059524,0.5925925925925926,47.747747747747766,1009.0090090090116,28.0280280280281,8
720,4,2,0,45,0.044444444444444446,0.0,1.0,45,1300,900,400,0.6923076923076923,17,9,8,341.04696341429724,0.45143097643097646,0.17183306920232466,0.18268305086113895,127820.21747616706,-281.4605933596231,127538.75688280744,706,0,183.17777777777778,38,7,17,38.57369255150556,0.5945723684210527,47.195512820512825,1011.2179487179492,26.610998650472347,0
721,4,1,0,46,0.021739130434782608,0.0,1.0,46,900,700,200,0.7777777777777778,11,7,4,332.9449225093509,0.45317028985507246,0.1749017958606618,0.17955376009688537,128091.80230034729,-670.49696180555,127421.30533854174,707,0,180.17391304347825,39,7,18,38.50114907045345,0.5956196581196581,46.927083333333336,1012.2916666666672,25.956196581196593,0
722,4,0,1,45,0.0,0.021739130434782608,0.9782608695652174,46,1250,800,450,0.64,17,8,9,330.06109645643005,0.452506038647343,0.17185880799317643,0.17883653237713545,128279.78326576082,-731.955965727508,127547.82730003331,708,1,181.17391304347825,38,8,18,38.382373620192624,0.5992324561403508,46.74145299145299,1013.034188034188,26.658794421952315,0
723,4,1,1,45,0.021739130434782608,0.021739130434782608,0.9782608695652174,46,1600,1200,400,0.75,20,12,8,331.37159631764257,0.4532407407407408,0.18315715679940592,0.18040075028445818,128469.25593770538,-685.7875164365652,127783.46842126882,709,0,182.02173913043478,38,8,13,38.15602276319948,0.6011513157894737,46.554487179487175,1013.7820512820507,26.678475033738177,0
724,4,0,0,45,0.0,0.0,1.0,45,1350,800,550,0.5925925925925926,19,8,11,342.0933241036183,0.4502525252525253,0.18354728592720804,0.18601827576552044,128422.23087873196,-213.52242997844937,128208.70844875352,710,3,187.06666666666666,37,8,13,37.93226236838307,0.6024774774774775,46.60087719298246,1013.5964912280706,27.394499762920827,0
725,4,0,1,44,0.0,0.022222222222222223,0.9777777777777777,45,1050,700,350,0.6666666666666666,14,7,7,341.48932067202327,0.4503787878787879,0.17476996996996985,0.18646848974121713,128588.9949311328,-217.64629501383305,128371.34863611896,711,4,188.06666666666666,37,8,13,37.77747747747748,0.6041666666666667,46.43640350877194,1014.2543859649135,27.41228070175442,0
726,4,0,0,44,0.0,0.0,1.0,44,1500,900,600,0.6,21,9,12,349.38840271541505,0.447938689217759,0.17609723091838148,0.19015685618163045,128458.27880245115,176.36656927197737,128634.64537172313,712,6,193.25,36,8,13,37.71060134784862,0.6047453703703703,46.56531531531532,1013.7387387387392,28.159409409409424,0
727,4,0,0,44,0.0,0.0,1.0,44,950,500,450,0.5263157894736842,14,5,9,348.16204894913244,0.4475312720225511,0.17570104778632412,0.19003317653550839,128572.46393352823,152.8104963071316,128725.27442983536,713,7,194.25,36,8,14,37.62514804944852,0.6059027777777778,46.45270270270271,1014.1891891891901,28.171921921921946,0
728,4,0,2,42,0.0,0.045454545454545456,0.9545454545454546,44,1050,900,150,0.8571428571428571,12,9,3,349.08506103977265,0.4474101479915433,0.174424060787697,0.1909476208201163,128658.1360710374,182.52665672430533,128840.66272776171,714,8,195.25,36,8,15,37.51433751433752,0.6067708333333333,46.36824324324325,1014.5270270270282,28.18130630630634,0
729,4,0,0,42,0.0,0.0,1.0,42,1300,1100,200,0.8461538461538461,15,11,4,367.4553107686979,0.4434765776229191,0.1762609649122806,0.19947574013157898,128355.55555555563,1032.9861111111213,129388.54166666676,715,12,205.16666666666666,34,8,19,37.357798793859644,0.607843137254902,46.66666666666667,1013.333333333334,29.803921568627473,0
730,4,1,2,41,0.023255813953488372,0.046511627906976744,0.9534883720930233,43,1450,1200,250,0.8275862068965517,17,12,5,357.73457741375967,0.4443060169804356,0.1818256871739563,0.19638364682141488,128800.98637488857,615.3132862592487,129416.29966114782,716,0,201.37209302325581,36,7,16,37.14915686709562,0.6082175925925926,46.227477477477485,1015.0900900900915,28.196946946946987,0
731,4,0,0,41,0.0,0.0,1.0,41,900,600,300,0.6666666666666666,12,6,6,360.66193902126287,0.4412855691056911,0.20510167469105411,0.1977889020186025,128760.50407503854,1087.8026138117207,129848.30668885027,717,1,210.70731707317074,35,6,16,37.11619055764625,0.6098214285714285,46.26736111111111,1014.9305555555552,28.998015873015863,0
732,4,2,0,43,0.046511627906976744,0.0,1.0,43,950,900,50,0.9473684210526315,10,9,1,345.4964271704141,0.44432908822443706,0.20060091858479678,0.19173633055540668,129230.80800165034,331.2635298782515,129562.07153152859,718,0,201.86046511627907,35,8,19,37.02203092392335,0.6145833333333333,45.804398148148145,1016.7824074074072,29.05092592592592,0
733,4,0,1,42,0.0,0.023255813953488372,0.9767441860465116,43,1050,700,350,0.6666666666666666,14,7,7,340.52512506667546,0.4442829457364341,0.18664808474159944,0.18963938237506672,129368.65790435509,210.65568251768534,129579.31358687277,719,1,202.86046511627907,37,6,19,37.008245311489546,0.6120495495495495,45.6688596491228,1017.3245614035079,27.495258416311025,0
734,4,0,0,42,0.0,0.0,1.0,42,950,600,350,0.631578947368421,13,6,7,343.7759244824759,0.4444686411149826,0.18221825567797145,0.19226600499369284,129536.03512619255,506.2740458602502,130042.3091720528,720,2,201.73809523809524,37,5,15,36.7554394657475,0.6137387387387387,45.504385964912274,1017.9824561403499,27.513039355144592,0
735,4,1,2,41,0.023255813953488372,0.046511627906976744,0.9534883720930233,43,1300,700,600,0.5384615384615384,19,7,12,339.37455386089255,0.44366002214839423,0.18030018350233568,0.19174963691500876,129935.60209155166,219.36739809336302,130154.96948964502,721,0,198.02325581395348,38,5,17,36.46193545006811,0.615953947368421,45.11217948717949,1019.5512820512824,26.83029689608638,0
736,4,0,2,39,0.0,0.04878048780487805,0.9512195121951219,41,1200,800,400,0.6666666666666666,16,8,8,352.53460600687964,0.43940548780487804,0.18599145195432065,0.1979314408027456,129688.42734203827,943.9317273354798,130632.35906937375,722,1,208.53658536585365,36,5,17,36.377602727105234,0.6171875,45.35472972972975,1018.5810810810833,28.29391891891898,0
737,4,0,1,38,0.0,0.02564102564102564,0.9743589743589743,39,1300,900,400,0.6923076923076923,17,9,8,363.4561581793316,0.4383715699505173,0.1687378742593466,0.20428742683872797,129731.4453125001,1630.3385416666804,131361.78385416677,723,2,212.46153846153845,35,4,17,36.05572597137015,0.6196428571428572,45.31250000000001,1018.7500000000008,29.10714285714288,0
738,4,0,0,38,0.0,0.0,1.0,38,1200,1000,200,0.8333333333333334,14,10,4,372.8426742669174,0.4359441678520626,0.1707726763717805,0.20899713208907064,129625.34722222254,2065.972222222261,131691.3194444448,724,3,218.3684210526316,34,4,17,35.92471358428805,0.6207107843137255,45.416666666666686,1018.3333333333359,29.950980392156936,0
739,4,0,2,36,0.0,0.05263157894736842,0.9473684210526316,38,1000,400,600,0.4,16,4,12,370.71907085863455,0.43585526315789475,0.16332029231564182,0.20812810828520226,129685.96938775529,2015.4124149660092,131701.3818027213,725,4,219.3684210526316,34,4,17,35.917046517064065,0.6213235294117647,45.35714285714287,1018.57142857143,29.957983193277354,0
740,4,0,0,36,0.0,0.0,1.0,36,850,500,350,0.5882352941176471,12,5,7,379.68017206726813,0.4325231481481482,0.1618469462840324,0.21205405709607714,129481.87183114696,2632.339875288388,132114.21170643534,726,5,226.41666666666666,33,3,17,35.89692454344773,0.6215277777777778,45.557598039215705,1017.7696078431395,30.841503267973923,0
741,4,1,0,37,0.02702702702702703,0.0,1.0,37,600,200,400,0.3333333333333333,10,2,8,347.3890547102711,0.43649899899899897,0.12980961256823353,0.1905945354221215,128778.12499999987,1549.5688256920264,130327.6938256919,727,0,221.27027027027026,34,3,18,37.435002736726865,0.6121323529411764,46.24999999999999,1014.999999999999,29.85294117647056,8
742,4,1,0,38,0.02631578947368421,0.0,1.0,38,800,500,300,0.625,11,5,6,340.02418631970056,0.4384186818397345,0.1273763346742527,0.18785854825051262,129054.34355977771,1176.3196319872825,130230.663191765,728,0,216.42105263157896,35,3,19,37.340647188366184,0.612797619047619,45.978009259259245,1016.087962962961,29.0310846560846,0
743,4,1,0,39,0.02564102564102564,0.0,1.0,39,1350,900,450,0.6666666666666666,18,9,9,334.449668739336,0.4392150247413405,0.12640038138046084,0.18654859300794083,129430.46932067211,857.5955178151221,130288.06483848723,729,0,211.84615384615384,36,3,18,37.09997971078647,0.6145833333333333,45.60810810810811,1017.5675675675683,28.265765765765785,0
744,4,0,1,38,0.0,0.02564102564102564,0.9743589743589743,39,950,600,350,0.631578947368421,13,6,7,333.4332807097693,0.43809041835357626,0.12784494567483162,0.18666069912675082,129573.7476285408,840.8399531288176,130414.58758166962,730,1,212.84615384615384,36,3,19,36.98037643328541,0.6160300925925926,45.46734234234235,1018.1306306306315,28.28140640640643,0
745,4,0,0,38,0.0,0.0,1.0,38,1150,1000,150,0.8695652173913043,13,10,3,335.3027029175091,0.43705547652916077,0.1276426460559219,0.1878976547941555,129613.56122470836,1091.955482681741,130705.51670739011,731,2,218.39473684210526,35,3,19,36.892380844131246,0.618452380952381,45.42824074074073,1018.2870370370359,29.093915343915313,0
746,4,0,1,37,0.0,0.02631578947368421,0.9736842105263158,38,1350,900,450,0.6666666666666666,18,9,9,339.04752602179406,0.43690730203888095,0.11857516719976702,0.1910572920608492,129831.8483179126,1203.8333942050272,131035.68171211763,732,3,219.39473684210526,36,2,19,36.57550644567219,0.6186342592592593,45.21396396396397,1019.144144144145,28.309559559559585,0
747,4,1,0,38,0.02631578947368421,0.0,1.0,38,1050,700,350,0.6666666666666666,14,7,7,340.6542220080545,0.4356478188715031,0.12398958642050606,0.19295217565521913,130032.77084094245,1259.242477274592,131292.01331821704,733,0,220.26315789473685,36,2,21,36.330784660115576,0.6206597222222222,45.0168918918919,1019.9324324324338,28.331456456456493,0
748,4,1,0,39,0.02564102564102564,0.0,1.0,39,1150,700,450,0.6086956521739131,16,7,9,335.82732820323463,0.4365159694107063,0.1280383159311378,0.1919103994628316,130377.57087746545,957.0731626897352,131334.6440401552,734,0,215.5897435897436,36,3,22,36.10467894291911,0.6241319444444444,44.67905405405406,1021.283783783785,28.368993993994028,0
749,4,1,0,40,0.025,0.0,1.0,40,1350,1000,350,0.7407407407407407,17,10,7,328.18760195395487,0.43696581196581197,0.12386672237309337,0.1895095356518193,130781.15297866902,584.1505953685438,131365.30357403756,735,0,211.175,38,2,17,35.89191212311118,0.6244517543859649,44.284188034188034,1022.863247863248,26.917453891138106,0
750,4,0,1,39,0.0,0.025,0.975,40,1050,700,350,0.6666666666666666,14,7,7,327.72237743036317,0.4360844017094017,0.11486430062630504,0.19004723824351594,130945.12473518899,582.7295182263301,131527.8542534153,736,1,212.175,38,2,18,35.73830027835769,0.6260964912280702,44.12393162393163,1023.5042735042748,26.9343229869546,0
751,4,0,0,39,0.0,0.0,1.0,39,1000,800,200,0.8,12,8,4,334.726217262041,0.43421052631578944,0.11658108668716127,0.19391680854789775,130906.99932912066,963.6009397122327,131870.6002688329,737,2,218.53846153846155,37,2,18,35.59758830672523,0.6275337837837838,44.16118421052632,1023.355263157896,27.65825035561881,0
752,4,0,1,38,0.0,0.02564102564102564,0.9743589743589743,39,1350,1100,250,0.8148148148148148,16,11,5,334.8997238394608,0.43421052631578944,0.11824094214839675,0.1944417799605231,130991.17036011102,973.7813558018053,131964.95171591282,738,3,219.53846153846155,37,2,19,35.50815838331905,0.6283783783783784,44.07894736842106,1023.6842105263175,27.66714082503561,0
753,4,0,0,38,0.0,0.0,1.0,38,1400,1000,400,0.7142857142857143,18,10,8,343.88494955106063,0.4321212660028449,0.11509466736147322,0.19961137876239743,130982.06948502568,1408.552471390325,132390.621956416,739,4,226.07894736842104,36,2,21,35.287403740374046,0.6302083333333333,44.087837837837846,1023.6486486486496,28.43468468468471,0
754,4,0,0,38,0.0,0.0,1.0,38,1350,900,450,0.6666666666666666,18,9,9,347.66935417819525,0.4316619250829777,0.11292207980093161,0.20256584088729593,131126.20380092945,1517.712518261525,132643.91631919096,740,5,227.07894736842104,36,2,22,35.04489646325821,0.6316550925925926,43.94707207207208,1024.211711711713,28.45032532532536,0
755,4,1,0,39,0.02564102564102564,0.0,1.0,39,1300,700,600,0.5384615384615384,19,7,12,344.39606349491544,0.433563877642825,0.1320070135236011,0.20265856007250632,131506.1366705249,1258.3498581633658,132764.48652868826,741,0,222.23076923076923,35,4,23,34.745260663507096,0.6375,43.5763888888889,1025.6944444444462,29.305555555555603,0
756,4,0,0,39,0.0,0.0,1.0,39,850,600,250,0.7058823529411765,11,6,5,344.5486712976839,0.43297345928924874,0.13542534481162627,0.20306379138182679,131565.50068587132,1266.1436899863124,132831.64437585764,742,1,223.23076923076923,35,4,14,34.68148315282793,0.638095238095238,43.51851851851853,1025.925925925928,29.31216931216937,0
757,4,1,0,40,0.025,0.0,1.0,40,1100,800,300,0.7272727272727273,14,8,6,343.9899306666665,0.4326923076923077,0.16327200000000008,0.20553891650732967,132087.85545792957,1087.3784481763876,133175.23390610598,743,0,218.625,37,3,16,34.16966666666668,0.6393581081081081,43.009868421052644,1027.9605263157912,27.782716927453816,0
758,4,0,1,39,0.0,0.025,0.975,40,950,600,350,0.631578947368421,13,6,7,342.7068259350767,0.4326655982905983,0.15884877892716243,0.20507733929758903,132144.21895439006,1057.345168705786,133201.56412309586,744,1,219.625,37,3,16,34.14593775550106,0.6399211711711712,42.95504385964914,1028.1798245614057,27.78864390706502,0
759,4,1,0,40,0.025,0.0,1.0,40,1200,900,300,0.75,15,9,6,342.1491520747605,0.432545405982906,0.16546883324453887,0.20596983914186218,132369.79316953314,1058.0424986534504,133427.8356681866,745,0,220.375,37,3,19,33.933470964304746,0.6421734234234234,42.735745614035096,1029.057017543861,27.812351825509758,0
760,4,0,0,40,0.0,0.0,1.0,40,1300,900,400,0.6923076923076923,17,9,8,340.6884643758439,0.4325988247863248,0.1663537216100739,0.20556873827399982,132457.5684263546,1025.3591278916756,133482.9275542463,746,1,221.375,35,5,19,33.882861104864695,0.6470238095238094,42.65046296296296,1029.3981481481483,29.411375661375665,0
761,4,0,0,40,0.0,0.0,1.0,40,1750,1300,450,0.7428571428571429,22,13,9,339.97755978818765,0.4316907051282051,0.1715515356869599,0.2064004442270824,132687.90486009675,1022.1820215485882,133710.08688164534,747,2,222.375,36,4,15,33.66989106277551,0.6472800925925926,42.42680180180181,1030.292792792794,28.61924424424428,0
762,4,0,0,40,0.0,0.0,1.0,40,1250,800,450,0.64,17,8,9,341.9567439713969,0.43165064102564105,0.1766825084671697,0.20824551414306045,132803.9541864501,1082.6415520250198,133886.59573847512,748,3,223.375,36,4,16,33.50244910593977,0.6484375,42.3141891891892,1030.7432432432445,28.63175675675679,0
763,4,0,0,40,0.0,0.0,1.0,40,1250,600,650,0.48,19,6,13,341.8281234770171,0.4307692307692308,0.17433384296166898,0.20881388436818174,132920.0542392054,1087.16254261018,134007.21678181557,749,4,224.375,36,4,16,33.389301445160356,0.6495949074074074,42.20157657657658,1031.1936936936936,28.644269269269266,0
764,4,0,0,40,0.0,0.0,1.0,40,1450,1100,350,0.7586206896551724,18,11,7,341.3420922282198,0.4302751068376069,0.168240514401105,0.2092304720374802,133047.67001625497,1082.9540098876514,134130.6240261426,750,5,225.375,37,3,17,33.273882275835184,0.6489301801801801,42.07785087719298,1031.6885964912278,27.883475580843996,0
765,4,0,0,40,0.0,0.0,1.0,40,800,500,300,0.625,11,5,6,343.4311609822288,0.4297142094017094,0.16754222883246594,0.21115071968162755,133160.81781173043,1146.3148516851209,134307.13266341554,751,6,226.375,37,3,19,33.10658575020363,0.6500563063063063,41.96820175438596,1032.1271929824554,27.895329540066363,0
766,4,0,0,40,0.0,0.0,1.0,40,1200,1000,200,0.8333333333333334,14,10,4,341.0856842649229,0.42904647435897436,0.16689935237286413,0.21066793836664294,133330.62967691963,1095.4338113650201,134426.06348828465,752,7,227.375,37,3,21,32.99702286159181,0.6517454954954955,41.80372807017543,1032.7850877192968,27.913110478899913,0
767,4,0,0,40,0.0,0.0,1.0,40,1100,600,500,0.5454545454545454,16,6,10,333.8796003644942,0.4285790598290598,0.09233083121757346,0.18939356917357233,130090.2058096947,687.04347204178,130777.24928173648,753,8,228.375,36,4,18,36.44533980939764,0.6212384259259259,44.96058558558558,1020.1576576576566,28.337712712712683,7
768,4,0,0,40,0.0,0.0,1.0,40,1000,600,400,0.6,14,6,8,333.2374824120624,0.4283787393162393,0.09247765640516414,0.18958765242313358,130205.11379200134,677.8448634445156,130882.95865544585,754,9,229.375,36,4,18,36.34535106109089,0.6223958333333333,44.84797297297297,1020.6081081081072,28.350225225225202,0
769,4,0,0,40,0.0,0.0,1.0,40,1200,1000,200,0.8333333333333334,14,10,4,330.6788192777238,0.42753739316239314,0.08743109151047435,0.18910825289085456,130406.32482144304,624.5219036604167,131030.84672510345,755,10,230.375,36,4,19,36.20704704152885,0.6244212962962963,44.6509009009009,1021.3963963963961,28.372122122122114,0
770,4,1,0,41,0.024390243902439025,0.0,1.0,41,1100,700,400,0.6363636363636364,15,7,8,321.8529404843925,0.42815040650406505,0.09393133493895167,0.1856476422942443,130738.73842191834,215.72947926285144,130954.4679011812,756,0,225.73170731707316,37,4,16,36.09670401343767,0.6258445945945945,44.32565789473684,1022.6973684210532,27.64046941678522,0
771,4,0,0,41,0.0,0.0,1.0,41,600,300,300,0.5,9,3,6,324.28300133502046,0.42787093495934964,0.0997984687809581,0.18759359488264588,130850.90033712306,286.5445377423911,131137.44487486547,757,1,226.73170731707316,37,4,16,35.9213687350409,0.6269707207207207,44.21600877192983,1023.1359649122816,27.652323376007608,0
772,4,0,0,41,0.0,0.0,1.0,41,1850,1300,550,0.7027027027027027,24,13,11,324.7274688818699,0.4275406504065041,0.0936539400729699,0.18894889918303942,131075.36844269387,312.7545254308983,131388.12296812478,758,2,227.73170731707316,37,4,17,35.68358050469358,0.629222972972973,43.99671052631579,1024.0131578947364,27.676031294452336,0
773,4,1,0,42,0.023809523809523808,0.0,1.0,42,1300,900,400,0.6923076923076923,17,9,8,321.3459419717759,0.4278213317847464,0.09472038321148801,0.1887855579093544,131443.57829112903,48.259025091113614,131491.83731622013,759,0,223.28571428571428,36,6,20,35.39927886375284,0.634837962962963,43.63738738738739,1025.450450450451,28.484734734734747,0
774,4,0,1,41,0.0,0.023809523809523808,0.9761904761904762,42,1050,700,350,0.6666666666666666,14,7,7,319.06670142887594,0.42730110336817656,0.09306433713104711,0.18770754246325194,131496.76462950147,-8.752212219131962,131488.01241728233,760,1,224.28571428571428,37,5,20,35.404194284085264,0.6334459459459459,43.58552631578948,1025.6578947368428,27.72048364153629,0
775,4,0,1,40,0.0,0.024390243902439025,0.975609756097561,41,1150,800,350,0.6956521739130435,15,8,7,325.45579011785605,0.42576219512195124,0.09490479798858753,0.1916339232180709,131530.2015486773,361.45313387714396,131891.65468255442,761,2,229.2439024390244,36,5,21,35.2067094814652,0.6357060185185186,43.55292792792794,1025.7882882882902,28.494119119119173,0
776,4,0,0,40,0.0,0.0,1.0,40,1250,800,450,0.64,17,8,9,323.5419857537187,0.4247596153846154,0.08267669007901701,0.1909400630950705,131616.85333982648,516.715617644695,132133.56895747117,762,3,232.325,36,4,13,35.168596356453044,0.6365740740740741,43.46846846846848,1026.1261261261275,28.50350350350354,0
777,4,0,1,39,0.0,0.025,0.975,40,1050,700,350,0.6666666666666666,14,7,7,321.38269910995456,0.4239983974358974,0.0819430733794011,0.19038635918034158,131761.33639974444,469.1627860969206,132230.49918584136,763,4,233.325,36,4,14,35.07869913348689,0.6380208333333333,43.32770270270271,1026.68918918919,28.519144144144168,0
778,4,0,0,39,0.0,0.0,1.0,39,1000,900,100,0.9,11,9,2,331.2269625229575,0.4222896986054881,0.08618715519933406,0.19582138024357246,131684.26890432098,923.4760802469154,132607.7449845679,764,8,240.2051282051282,35,4,15,34.90358592692829,0.6392857142857142,43.40277777777778,1026.388888888889,29.325396825396826,0
779,4,0,0,39,0.0,0.0,1.0,39,1250,800,450,0.64,17,8,9,331.2269625229575,0.4222053531264058,0.08618715519933406,0.19582138024357246,131684.26890432098,923.4760802469154,132607.7449845679,765,9,241.2051282051282,35,4,15,34.90358592692829,0.6392857142857142,43.40277777777778,1026.388888888889,29.325396825396826,0
780,4,0,0,39,0.0,0.0,1.0,39,1100,600,500,0.5454545454545454,16,6,10,332.237532349444,0.4218679712100765,0.09445051230041113,0.19734108849189846,131862.52170138876,961.9357638888704,132824.45746527764,766,10,242.2051282051282,35,4,18,34.69827586206896,0.6410714285714285,43.22916666666666,1027.0833333333321,29.34523809523806,0
781,4,0,0,39,0.0,0.0,1.0,39,850,600,250,0.7058823529411765,11,6,5,328.43777381665575,0.42141812865497075,0.02760875488148229,0.1880795782821008,130458.54403518385,857.3933806555804,131315.93741583943,767,11,243.2051282051282,37,2,20,36.21147275589424,0.6230292792792793,44.59978070175438,1021.600877192982,27.610834518729245,8
782,4,0,0,39,0.0,0.0,1.0,39,1200,900,300,0.75,15,9,6,348.12419288970324,0.42203666216824115,-0.002436323366555637,0.19333096320996437,129258.63997443396,1202.5004519884098,130461.14042642237,768,12,244.2051282051282,36,3,19,36.92691029900332,0.6128472222222222,45.77702702702703,1016.8918918918924,28.246996996997012,8
783,4,0,0,39,0.0,0.0,1.0,39,1350,1100,250,0.8148148148148148,16,11,5,335.9250535952762,0.42167116509221775,-0.051671636745930005,0.1763557275502236,127006.86486740102,800.5378266780108,127807.40269407904,769,13,245.2051282051282,36,3,20,39.53585260492311,0.5899884259259259,48.00112612612612,1007.9954954954941,27.999874874874834,8
784,4,0,1,38,0.0,0.02564102564102564,0.9743589743589743,39,950,700,250,0.7368421052631579,12,7,5,335.2661315137009,0.4216149347728295,-0.04938653380864466,0.17650254013551972,127120.40323685166,723.833165936197,127844.23640278786,770,14,246.2051282051282,36,3,20,39.43606923506419,0.5911458333333333,47.88851351351351,1008.4459459459455,28.012387387387374,0
785,4,1,1,38,0.02564102564102564,0.02564102564102564,0.9743589743589743,39,1450,1200,250,0.8275862068965517,17,12,5,333.87493922289633,0.42535425101214575,-0.006375946384866937,0.17738095112268604,127489.75326678054,713.1267246976979,128202.87999147823,771,0,246.82051282051282,36,3,13,39.092932277728224,0.5949074074074074,47.522522522522536,1009.9099099099119,28.05305305305311,0
786,4,3,0,41,0.07317073170731707,0.0,1.0,41,1000,600,400,0.6,14,6,8,342.4304399524375,0.4345528455284553,0.10455845248107631,0.17860580501116344,126742.1392746913,480.07330246912943,127222.21257716043,772,0,234.6341463414634,38,3,17,39.64367816091955,0.5836074561403508,48.263888888888886,1006.944444444444,26.498538011695896,8
787,4,0,0,41,0.0,0.0,1.0,41,1350,800,550,0.5925925925925926,19,8,11,345.22142134686146,0.4342987804878049,0.11048563179734461,0.18041837918282758,126822.83676674697,556.391993571476,127379.22876031845,773,1,235.6341463414634,38,3,17,39.49052467826334,0.5844298245614035,48.18376068376068,1007.2649572649568,26.506972559604126,0
788,4,1,0,42,0.023809523809523808,0.0,1.0,42,1050,600,450,0.5714285714285714,15,6,9,337.9998974151458,0.4351045296167247,0.12619207093420082,0.1783158469402164,127205.59030314088,199.95136518654112,127405.54166832742,774,0,231.0,36,6,18,39.2798336682295,0.5920138888888888,47.80405405405405,1008.7837837837831,28.021771771771753,0
789,4,1,0,43,0.023255813953488372,0.0,1.0,43,1200,800,400,0.6666666666666666,16,8,8,332.1192834322769,0.4375,0.12877986889405824,0.17706787952099629,127631.22420374017,-122.24185477391006,127508.98234896627,775,0,226.6046511627907,38,5,16,38.99256361457674,0.5926535087719298,47.38247863247863,1010.470085470085,26.59131803868645,0
790,4,2,1,44,0.044444444444444446,0.022222222222222223,0.9777777777777777,45,1350,1000,350,0.7407407407407407,17,10,7,340.9147384244935,0.4417508417508418,0.18695837850267716,0.1774890636630754,126667.22888518848,-223.28481835834782,126443.94406683014,776,0,217.48888888888888,41,4,18,39.758775171643514,0.5779979674796748,48.33829365079366,1006.6468253968267,24.55236159504455,8
791,4,2,0,46,0.043478260869565216,0.0,1.0,46,1600,1100,500,0.6875,21,11,10,343.25769525028636,0.44522946859903384,0.22583965405285777,0.1809433780490207,127172.82267011865,-466.5456893364119,126706.27698078223,777,0,213.69565217391303,38,8,21,39.18083359813577,0.5879934210526316,47.836538461538474,1008.6538461538487,26.543522267206544,0
792,4,0,0,46,0.0,0.0,1.0,46,800,600,200,0.75,10,6,4,343.2202774113651,0.4449778582930757,0.22835754930666785,0.18128480424345295,127253.65713346507,-464.79289940825566,126788.8642340568,778,1,214.69565217391303,38,8,21,39.098898771706914,0.5888157894736843,47.75641025641027,1008.9743589743609,26.55195681511476,0
793,4,3,0,49,0.061224489795918366,0.0,1.0,49,1200,800,400,0.6666666666666666,16,8,8,325.52018179169147,0.4490327380952381,0.24852894332108,0.1751369015172921,127997.40780489473,-1466.8521084970635,126530.55569639767,779,0,202.48979591836735,42,7,19,38.785350633598284,0.5900297619047619,47.02034883720931,1011.9186046511644,24.09330011074201,0
794,4,0,1,48,0.0,0.02040816326530612,0.9795918367346939,49,1300,1100,200,0.8461538461538461,15,11,4,327.0165455807886,0.44853670634920634,0.24943310657596318,0.17658893461362601,128144.53125000017,-1418.9236111110954,126725.60763888908,780,1,203.48979591836735,42,7,19,38.597393689986305,0.5915178571428572,46.87500000000001,1012.5000000000014,24.10714285714289,0
795,4,2,2,48,0.04,0.04,0.96,50,1350,1100,250,0.8148148148148148,16,11,5,319.8905439949237,0.4500850340136054,0.2563235294117654,0.1744308815368545,128533.39489073544,-1776.6764773776692,126756.71841335777,781,0,200.26,37,13,18,38.3817221741638,0.6036036036036037,46.49122807017543,1014.0350877192968,27.40635372214316,0
796,4,0,0,48,0.0,0.0,1.0,48,1100,700,400,0.6363636363636364,15,7,8,326.8847033949167,0.44681774527186763,0.26036708495600824,0.17774836459897667,128422.23087873167,-1204.1474299784768,127218.0834487532,782,1,208.85416666666666,37,11,18,38.317647483052085,0.6024774774774775,46.600877192982445,1013.5964912280682,27.394499762920763,0
797,4,0,0,48,0.0,0.0,1.0,48,1550,1000,550,0.6451612903225806,21,10,11,327.6989392358088,0.4473533540189125,0.25845448798988646,0.17876542133484444,128550.5013149242,-1174.8274161735933,127375.67389875061,783,2,209.85416666666666,38,10,18,38.16635061104088,0.6019736842105263,46.474358974358964,1014.1025641025625,26.686909581646383,0
798,4,0,1,47,0.0,0.020833333333333332,0.9791666666666666,48,1350,900,450,0.6666666666666666,18,9,9,324.1337983722672,0.44684544917257685,0.2559887486645298,0.1774206054248199,128685.3063652587,-1257.7485706259613,127427.55779463274,784,3,210.85416666666666,40,8,18,38.119532919337594,0.6,46.34146341463414,1014.6341463414628,25.365853658536572,0
799,4,1,0,48,0.020833333333333332,0.0,1.0,48,1350,1000,350,0.7407407407407407,17,10,7,325.27192599653387,0.44670692966903075,0.2668422413505491,0.17885480531818204,128865.8177692675,-1216.7134518144094,127649.10431745308,785,0,211.72916666666666,40,8,19,37.907032996363405,0.6018229166666667,46.163617886178855,1015.3455284552834,25.383638211382085,0
800,4,1,1,48,0.02040816326530612,0.02040816326530612,0.9795918367346939,49,1100,900,200,0.8181818181818182,13,9,4,320.8934143470638,0.4475269274376417,0.27166518781425597,0.17750686337932522,129102.89345592214,-1514.3463433687825,127588.54711255335,786,0,208.3877551020408,42,7,20,37.77730104246123,0.6011904761904762,45.93023255813954,1016.279069767442,24.19712070874862,0
801,4,1,0,49,0.02040816326530612,0.0,1.0,49,1150,800,350,0.6956521739130435,15,8,7,326.1924218089811,0.44639314058956914,0.2738790029324225,0.18152892004330617,129340.77222077931,-1361.8162649366946,127978.95595584261,787,0,209.18367346938774,37,12,21,37.40107703639826,0.6117680180180181,45.696271929824555,1017.2149122807004,27.492294926505416,0
802,4,0,0,49,0.0,0.0,1.0,49,1200,700,500,0.5833333333333334,17,7,10,323.6651772634437,0.4465880102040816,0.2727888299376875,0.18047934123284745,129418.7166703192,-1422.3336255387542,127996.38304478045,788,1,210.18367346938774,38,11,21,37.386252274954494,0.6107456140350878,45.61965811965812,1017.5213675213672,26.77687809266756,0
803,4,0,1,48,0.0,0.02040816326530612,0.9795918367346939,49,1250,1000,250,0.8,15,10,5,322.3398449423787,0.44616284013605445,0.27285300785650124,0.18052112389478445,129589.12854658274,-1445.652079615307,128143.47646696743,789,2,211.18367346938774,40,9,18,37.247147087201,0.6091145833333333,45.452235772357724,1018.1910569105692,25.45477642276423,0
804,4,0,0,48,0.0,0.0,1.0,48,1650,1300,350,0.7878787878787878,20,13,7,334.9402476435917,0.4455156619385343,0.2830456095481666,0.18762412153100919,129598.8294813369,-918.427191840273,128680.40228949663,790,4,216.54166666666666,39,9,18,36.91656010230177,0.610844017094017,45.442708333333336,1018.2291666666674,26.10844017094019,0
805,4,0,1,47,0.0,0.020833333333333332,0.9791666666666666,48,1000,500,500,0.5,15,5,10,334.33411173128155,0.4450262263593381,0.28150984500764986,0.18760898475760943,129666.74619108994,-929.5967182232822,128737.14947286666,791,5,217.54166666666666,40,8,18,36.86306791724871,0.6098958333333333,45.3760162601626,1018.4959349593495,25.46239837398374,0
806,4,0,1,46,0.0,0.02127659574468085,0.9787234042553191,47,1050,600,450,0.5714285714285714,15,6,9,334.3963221114102,0.44468855997533147,0.27905081811025134,0.18826456607586245,129796.16057117128,-719.3282561636573,129076.83231500762,792,6,219.68085106382978,40,7,18,36.73020345068316,0.6111979166666667,45.2489837398374,1019.0040650406505,25.47510162601626,0
807,4,1,0,47,0.02127659574468085,0.0,1.0,47,1150,700,450,0.6086956521739131,16,7,9,330.15372861729685,0.4451703669441875,0.2892639437040747,0.18799131768943803,130237.85848957393,-800.2970825070613,129437.56140706687,793,0,219.4255319148936,42,5,20,36.39089298145688,0.6125992063492063,44.815891472868216,1020.736434108527,24.303248431155403,0
808,4,1,2,46,0.020833333333333332,0.041666666666666664,0.9583333333333334,48,1300,900,400,0.6923076923076923,17,9,8,318.6981665625872,0.4455156619385343,0.2813100921689544,0.1826790972987601,130496.1136311058,-1282.218526349884,129213.89510475592,794,0,215.83333333333334,40,8,15,36.422278031960744,0.6182291666666666,44.5630081300813,1021.7479674796747,25.543699186991866,0
809,4,0,0,46,0.0,0.0,1.0,46,1800,1400,400,0.7777777777777778,22,14,8,334.0153590060394,0.44340780998389695,0.2906474198288529,0.1905781961803414,130317.12420784937,-494.41579461611525,129822.70841323325,795,2,225.8913043478261,38,8,21,36.21211328520108,0.6197916666666667,44.738247863247864,1021.0470085470085,26.86965811965812,0
810,4,0,0,46,0.0,0.0,1.0,46,1500,900,600,0.6,21,9,12,334.4972458392065,0.44278381642512077,0.2923756172530756,0.19152471046194577,130453.51765103378,-472.73152713856905,129980.7861238952,796,3,226.8913043478261,38,8,22,36.061798438262535,0.6211622807017544,44.60470085470086,1021.5811965811974,26.883715699505196,0
811,4,0,1,45,0.0,0.021739130434782608,0.9782608695652174,46,2000,1400,600,0.7,26,14,12,336.6543032675232,0.4415157004830918,0.29439715872355054,0.19419929197888053,130741.5418836808,-397.0594618055327,130344.48242187526,797,4,227.8913043478261,39,7,18,35.71543763156107,0.6223290598290598,44.32291666666668,1022.7083333333353,26.22329059829065,0
812,4,0,0,45,0.0,0.0,1.0,45,1250,900,350,0.72,16,9,7,338.0522409428104,0.44042508417508414,0.28567421131810833,0.19567985638074412,130874.74093967018,-151.50010850694167,130723.24083116325,798,5,228.24444444444444,39,6,19,35.54508551359055,0.6236645299145299,44.192708333333336,1023.2291666666671,26.23664529914531,0
813,4,0,0,45,0.0,0.0,1.0,45,1100,600,500,0.5454545454545454,16,6,10,337.75550505344796,0.43989898989898985,0.28338139666383944,0.19577863346018454,130928.03955078138,-155.66677517359744,130772.37277560779,799,6,229.24444444444444,39,6,19,35.49883375742155,0.624198717948718,44.14062500000001,1023.437500000001,26.241987179487207,0
814,4,0,1,44,0.0,0.022222222222222223,0.9777777777777777,45,1300,1000,300,0.7692307692307693,16,10,6,339.37943886755096,0.43928872053872053,0.29218299589649677,0.19726555320101488,131034.66932508697,-105.90549045137101,130928.7638346356,800,7,230.24444444444444,39,6,19,35.34958201919492,0.625267094017094,44.03645833333334,1023.854166666668,26.252670940170976,0
815,4,0,0,44,0.0,0.0,1.0,44,1350,1100,250,0.8148148148148148,16,11,5,338.42090750906164,0.4387552854122621,0.16360263566952438,0.19130553306545697,129954.95158366053,189.9157974088352,130144.86738106936,801,8,233.6818181818182,37,7,17,36.46662275513495,0.6179617117117118,45.09320175438597,1019.6271929824575,27.55749170222858,8
816,4,1,0,45,0.022222222222222223,0.0,1.0,45,1500,1200,300,0.8,18,12,6,328.0203679045325,0.43952020202020203,0.1637798937369932,0.18715765110827595,130317.12420784963,-450.66579461608484,129866.45841323354,802,0,229.46666666666667,38,7,19,36.36514247846259,0.6197916666666667,44.73824786324788,1021.0470085470106,26.869658119658173,0
817,4,0,1,44,0.0,0.022222222222222223,0.9777777777777777,45,1500,800,700,0.5333333333333333,22,8,14,301.74733527611613,0.4385732323232323,0.05696357813602537,0.16595292727302802,128873.8024868514,-1222.534702538407,127651.267784313,803,1,230.46666666666667,41,4,19,38.49607148672853,0.6003556910569106,46.155753968253975,1015.3769841269856,24.765292295780135,8
818,4,1,1,44,0.022222222222222223,0.022222222222222223,0.9777777777777777,45,1800,1300,500,0.7222222222222222,23,13,10,300.46590851961264,0.43922558922558924,0.07022451076994796,0.16610363640723141,129078.27546609289,-1243.2757383871092,127834.99972770578,804,0,231.42222222222222,42,3,20,38.32125488700296,0.6009424603174602,45.95445736434109,1016.1821705426365,24.194813584348488,0
819,4,0,2,42,0.0,0.045454545454545456,0.9545454545454546,44,950,600,350,0.631578947368421,13,6,7,303.50498822349437,0.43829281183932345,0.09343976507536667,0.16819987097491318,129176.1751720363,-958.8772951310216,128217.29787690527,805,1,237.11363636363637,41,3,21,38.14480254383399,0.6034044715447154,45.85813492063492,1016.5674603174594,24.79432830042584,0
820,4,0,0,42,0.0,0.0,1.0,42,1150,800,350,0.6956521739130435,15,8,7,309.13073534063426,0.4364837398373984,0.10276992220603498,0.1712029687085838,129149.73416121356,-415.1695419393244,128734.56461927424,806,2,246.5952380952381,40,2,21,38.028644271145765,0.6046875,45.88414634146341,1016.4634146341463,25.411585365853657,0
821,4,0,0,42,0.0,0.0,1.0,42,1250,700,550,0.56,18,7,11,307.5523314412687,0.4363506581494387,0.1018495485872315,0.1708954702254474,129280.82817925366,-447.86564871529964,128832.96253053835,807,3,247.5952380952381,39,3,21,37.93585048994504,0.6076388888888888,45.75520833333334,1016.9791666666682,26.07638888888893,0
822,4,0,2,40,0.0,0.047619047619047616,0.9523809523809523,42,850,500,350,0.5882352941176471,12,5,7,320.691493104446,0.4356005613627565,0.03769430656480033,0.16700332377719332,126677.74128818476,-234.25776140255257,126443.4835267822,808,4,248.5952380952381,37,5,17,40.256939149693224,0.584740990990991,48.32785087719298,1006.6885964912275,27.20779990516831,8
823,4,0,0,40,0.0,0.0,1.0,40,950,600,350,0.631578947368421,13,6,7,329.33400203181463,0.4329326923076923,0.06257763975155295,0.17104120750684562,126567.3828125,336.5885416666664,126903.97135416667,809,16,261.375,35,5,17,40.15269151138716,0.5875,48.4375,1006.25,28.75,0
824,4,2,0,42,0.047619047619047616,0.0,1.0,42,1350,900,450,0.6666666666666666,18,9,9,311.76815685662905,0.4379839334107627,0.06674795611405404,0.16412889173499798,127119.65610812927,-473.6278229840119,126646.02828514526,810,0,249.88095238095238,37,5,20,40.02924413758109,0.5892454954954955,47.889254385964904,1008.4429824561391,27.255215742057814,0
825,4,1,1,42,0.023255813953488372,0.023255813953488372,0.9767441860465116,43,750,700,50,0.9333333333333333,8,7,1,307.3148262401257,0.44003783684016246,0.07485557381728025,0.16318762570908252,127469.34125940541,-765.3563079845067,126703.9849514209,811,0,245.04651162790697,38,5,18,39.784348991395106,0.5910087719298245,47.542735042735046,1009.8290598290603,26.574448942870006,0
826,4,1,2,41,0.023255813953488372,0.046511627906976744,0.9534883720930233,43,1100,800,300,0.7272727272727273,14,8,6,311.02825745682884,0.44093761535622006,0.10612062356248386,0.1664915966386556,127793.20987654332,-650.540123456777,127142.66975308653,812,0,245.6046511627907,38,5,19,39.36011904761905,0.5942982456140351,47.22222222222223,1011.111111111112,26.60818713450295,0
827,4,1,0,42,0.023809523809523808,0.0,1.0,42,850,600,250,0.7058823529411765,11,6,5,317.86190920609306,0.4376209833526907,0.1147748890298037,0.1699214341755964,127739.20323800149,-279.3145956607283,127459.88864234075,813,0,252.33333333333334,38,4,20,39.24249630099346,0.59375,47.275641025641036,1010.8974358974374,26.60256410256414,0
828,4,2,0,44,0.045454545454545456,0.0,1.0,44,950,700,250,0.7368421052631579,12,7,5,306.6844620961032,0.44070428118393234,0.132470603630382,0.16626605787885756,128302.78320312523,-929.6639366575968,127373.11926646763,814,0,241.8181818181818,39,5,22,38.951007608472146,0.5977564102564102,46.718750000000014,1013.1250000000018,25.97756410256415,0
829,4,1,0,45,0.022222222222222223,0.0,1.0,45,1150,700,450,0.6086956521739131,16,7,9,301.82509618208,0.44313973063973067,0.14042842040839054,0.16531670791980624,128711.08596280328,-1230.3528199153866,127480.7331428879,815,0,237.42222222222222,40,5,16,38.65923885828743,0.6002604166666667,46.31605691056911,1014.7357723577239,25.3683943089431,0
830,4,0,1,44,0.0,0.022222222222222223,0.9777777777777777,45,950,500,450,0.5263157894736842,14,5,9,300.69199100715366,0.4431818181818182,0.14191782650779317,0.16490998979618046,128762.65290377769,-1256.4203061999983,127506.23259757769,816,1,238.42222222222222,40,5,16,38.63564300256999,0.60078125,46.26524390243903,1014.9390243902453,25.373475609756134,0
831,4,0,0,44,0.0,0.0,1.0,44,1400,1000,400,0.7142857142857143,18,10,8,302.2981355504302,0.4423559725158563,0.13278371192686222,0.1659659341374054,128804.55864800364,-1012.5244140624804,127792.03423394116,817,2,236.0909090909091,39,5,17,38.55235590901317,0.6028311965811965,46.22395833333334,1015.1041666666681,26.028311965812,0
832,4,0,0,44,0.0,0.0,1.0,44,1050,700,350,0.6666666666666666,14,7,7,301.1484524488178,0.4420586680761099,0.13297296793089908,0.16544491643552328,128830.9950086808,-1040.549045138865,127790.44596354193,818,3,237.0909090909091,39,5,17,38.554706204254735,0.6030982905982907,46.19791666666668,1015.2083333333353,26.030982905982956,0
833,4,0,1,43,0.0,0.022727272727272728,0.9772727272727273,44,950,700,250,0.7368421052631579,12,7,5,301.3540155366093,0.44166226215644816,0.1344729995617262,0.16588934485976356,128910.32036675385,-1030.471462673573,127879.84890408028,819,4,238.0909090909091,39,5,17,38.46900964201457,0.6038995726495726,46.119791666666686,1015.5208333333363,26.038995726495802,0
834,4,1,1,43,0.022727272727272728,0.022727272727272728,0.9772727272727273,44,1650,1200,450,0.7272727272727273,21,12,9,304.3543888143492,0.4424550739957717,0.16211802902979344,0.16924379564910078,129310.02995105564,-928.456739829308,128381.57321122632,820,0,238.29545454545453,38,6,19,37.98757002801119,0.6096491228070176,45.72649572649573,1017.0940170940174,26.765632028789934,0
835,4,0,0,43,0.0,0.0,1.0,43,1100,900,200,0.8181818181818182,13,9,4,309.32391761256764,0.43994555186415657,0.15451405425186926,0.17226334379408176,129368.65790435513,-596.6359841489657,128772.02192020617,821,1,243.8372093023256,37,6,22,37.801789178702336,0.6120495495495495,45.66885964912281,1017.3245614035083,27.495258416311035,0
836,4,0,0,43,0.0,0.0,1.0,43,1650,1400,250,0.8484848484848485,19,14,5,307.98262892252893,0.4394610557401255,0.15536084209909906,0.1725680444597662,129609.02829142011,-616.5341469428013,128992.49414447731,822,2,244.8372093023256,38,5,15,37.592461441611576,0.6126644736842105,45.43269230769231,1018.2692307692307,26.79655870445344,0
837,4,0,0,43,0.0,0.0,1.0,43,1200,600,600,0.5,18,6,12,307.29739968075756,0.43996862310815804,0.1511774231309504,0.1727823115186146,129745.05077069174,-625.9366553437152,129119.11411534803,823,3,245.8372093023256,38,5,17,37.47225426454138,0.6140350877192983,45.299145299145295,1018.8034188034184,26.810616284300483,0
838,4,0,0,43,0.0,0.0,1.0,43,1150,900,250,0.782608695652174,14,9,5,308.3987694214874,0.43978405315614616,0.1525119252771998,0.17400547954171575,129881.1445891775,-588.9629675286737,129292.18162164882,824,4,246.8372093023256,38,5,19,37.30653670125424,0.6154057017543859,45.16559829059829,1019.3376068376073,26.82467386414756,0
839,4,0,0,43,0.0,0.0,1.0,43,1200,700,500,0.5833333333333334,17,7,10,308.43344122936526,0.43959948320413433,0.1490583684882254,0.17487663283004615,130071.79578493671,-576.3016838337525,129495.49410110296,825,5,247.8372093023256,38,5,21,37.11292068146904,0.6173245614035088,44.97863247863247,1020.0854700854693,26.844354475933404,0
840,4,0,0,43,0.0,0.0,1.0,43,1000,500,500,0.5,15,5,10,307.6409844448375,0.43959948320413433,0.149935725137315,0.17491587401292175,130180.80210387894,-590.2099769888297,129590.59212689011,826,6,248.8372093023256,38,5,21,37.023005653266345,0.618421052631579,44.87179487179487,1020.5128205128199,26.85560053981105,0
841,4,1,0,44,0.022727272727272728,0.0,1.0,44,1300,1000,300,0.7692307692307693,16,10,6,303.2714247316837,0.4396251761804087,0.15797864452024335,0.17374334893506732,130475.34722222213,-886.1111111111206,129589.23611111101,827,0,244.1590909090909,39,5,22,36.83727569331158,0.6196581196581197,44.58333333333333,1021.6666666666658,26.196581196581175,0
842,4,0,2,42,0.0,0.045454545454545456,0.9545454545454546,44,1550,1100,450,0.7096774193548387,20,11,9,302.51732987835413,0.43884337561663145,0.15695993773857642,0.17378805859288096,130581.79253472203,-899.3489583333528,129682.44357638867,828,1,245.1590909090909,39,5,12,36.749218643837466,0.6207264957264957,44.47916666666666,1022.0833333333318,26.20726495726492,0
843,4,0,1,41,0.0,0.023809523809523808,0.9761904761904762,42,1250,900,350,0.72,16,9,7,344.0218365868723,0.436060298102981,0.09990394596185714,0.18411058358488414,127783.97108966237,436.27931190367855,128220.25040156605,829,9,256.4761904761905,37,5,18,38.53556646061526,0.5960022522522522,47.231359649122815,1011.0745614035102,27.326339497392166,8
844,4,1,1,41,0.023809523809523808,0.023809523809523808,0.9761904761904762,42,1200,1100,100,0.9166666666666666,13,11,2,322.32649006778286,0.4387219318621758,0.11874305206572533,0.16335736376692983,125561.52664776461,-297.82085529617234,125263.70579246843,830,0,256.1904761904762,38,4,14,41.362861102227896,0.571546052631579,49.43910256410256,1002.2435897435896,26.37483130904183,8
845,4,0,0,41,0.0,0.0,1.0,41,1150,600,550,0.5217391304347826,17,6,11,330.87280722766866,0.4375508130081301,0.11926727886836996,0.1678601111917506,125603.79756271157,111.77621960603426,125715.5737823176,831,1,262.1219512195122,37,4,15,41.10515569167944,0.5737612612612613,49.396929824561404,1002.4122807017541,27.09222380275011,0
846,4,0,0,41,0.0,0.0,1.0,41,1350,1000,350,0.7407407407407407,17,10,7,328.6515573786746,0.4375762195121951,0.1161996336263793,0.16728858070911173,125741.22716845572,65.01002712374157,125806.23719557947,832,2,263.1219512195122,37,4,16,41.01925494697716,0.5751689189189189,49.25986842105264,1002.9605263157898,27.107041251778103,0
847,4,3,1,43,0.06818181818181818,0.022727272727272728,0.9772727272727273,44,1100,700,400,0.6363636363636364,15,7,8,308.6798653089378,0.44365530303030304,0.13474232773595896,0.16047264521027543,126607.70052596959,-983.0230236408795,125624.6775023287,833,0,246.11363636363637,38,6,17,40.630971337579645,0.5822368421052632,48.39743589743589,1006.410256410255,26.484480431848816,0
848,4,3,0,46,0.06521739130434782,0.0,1.0,46,1400,800,600,0.5714285714285714,20,8,12,298.7478990505987,0.4483393719806763,0.15001905212398392,0.15766456107789958,127220.1372880725,-1598.6502536519283,125621.48703442057,834,0,236.34782608695653,40,6,20,40.25490245458515,0.58515625,47.78963414634146,1008.8414634146335,25.221036585365837,0
849,4,0,1,45,0.0,0.021739130434782608,0.9782608695652174,46,1200,800,400,0.6666666666666666,16,8,8,300.2224032194598,0.4482689210950081,0.14194450645411139,0.15904582032954132,127373.9705718325,-1551.8960894639217,125822.07448236858,835,1,237.34782608695653,40,6,13,40.06069834558205,0.58671875,47.63719512195123,1009.4512195121972,25.23628048780493,0
850,4,0,0,45,0.0,0.0,1.0,45,900,600,300,0.6666666666666666,12,6,6,304.87871093548205,0.4483164983164983,0.14428892692914452,0.16130796368142114,127322.68248273195,-1236.4049383633958,126086.27754436855,836,2,243.15555555555557,40,5,13,39.99555264659484,0.5861979166666667,47.68800813008131,1009.2479674796757,25.231199186991894,0
851,4,1,2,44,0.021739130434782608,0.043478260869565216,0.9565217391304348,46,1250,800,450,0.64,17,8,9,299.6764815610152,0.4493156199677939,0.1509876379898183,0.16011555692843127,127717.989467199,-1545.1844568845984,126172.8050103144,837,0,238.84782608695653,41,5,15,39.72370121372721,0.5886686991869918,47.29662698412699,1010.8134920634927,24.6539876113047,0
852,4,0,0,44,0.0,0.0,1.0,44,1250,800,450,0.64,17,8,9,311.57013656158097,0.44608879492600423,0.15268912446456495,0.16594831161508927,127591.4184570314,-849.2648654513747,126742.15359158002,838,1,250.5681818181818,39,5,16,39.55229491012818,0.5905448717948718,47.42187500000001,1010.3125000000011,25.905448717948747,0
853,4,2,0,46,0.043478260869565216,0.0,1.0,46,1450,900,550,0.6206896551724138,20,9,11,298.40621847459784,0.449627616747182,0.1582737337121587,0.1612404590773011,128169.64408738025,-1550.67623692996,126618.9678504503,839,0,240.6304347826087,41,5,18,39.2960509127723,0.5932418699186992,46.85019841269841,1012.5992063492057,24.69754161827331,0
854,4,3,1,48,0.061224489795918366,0.02040816326530612,0.9795918367346939,49,1750,1400,350,0.8,21,14,7,288.9459819374869,0.4539044784580499,0.19864912349197672,0.15994755641592517,129130.7966820988,-2337.6350308641954,126793.1616512346,840,0,226.83673469387756,44,5,18,38.56074063951898,0.5987215909090908,45.90277777777778,1016.388888888889,23.099747474747478,0
855,4,0,0,48,0.0,0.0,1.0,48,1150,800,350,0.6956521739130435,15,8,7,294.2389540584415,0.45170286643026003,0.1973836486780376,0.16247502512058776,129032.96212300565,-2006.6952371728626,127026.26688583278,841,1,232.54166666666666,43,5,18,38.525355733681295,0.5990794573643411,45.99905303030303,1016.0037878787881,23.62799506694856,0
856,4,1,1,48,0.02040816326530612,0.02040816326530612,0.9795918367346939,49,1400,900,500,0.6428571428571429,19,9,10,289.23314583904505,0.45303642290249435,0.20441977405315703,0.1610799215007186,129369.92550684407,-2316.2760416666574,127053.64946517741,842,0,228.77551020408163,43,6,19,38.31147801669307,0.6024709302325582,45.66761363636364,1017.3295454545458,23.65882663847781,0
857,4,0,0,48,0.0,0.0,1.0,48,1350,1000,350,0.7407407407407407,17,10,7,295.1223034581043,0.4516843971631206,0.19822823394932332,0.16427327368521633,129349.20245928735,-1965.2330839492827,127383.96937533807,843,1,234.4375,42,6,20,38.1826697148663,0.6036706349206349,45.68798449612403,1017.2480620155043,24.220191952750103,0
858,4,1,0,49,0.02040816326530612,0.0,1.0,49,1900,1300,600,0.6842105263157895,25,13,12,290.2043982440569,0.4525049603174603,0.19576656325012598,0.16281420464866098,129659.10099754644,-2274.471723628331,127384.62927391811,844,0,230.6326530612245,43,6,17,37.9944405702774,0.6053779069767442,45.38352272727273,1018.4659090909087,23.685253699788575,0
859,4,0,0,49,0.0,0.0,1.0,49,1500,700,800,0.4666666666666667,23,7,16,289.4325078685181,0.4524340986394558,0.19536914291783036,0.16298185333192705,129803.80980436485,-2286.1115594868975,127517.69824487795,845,1,231.6326530612245,43,6,17,37.86793745934392,0.6068313953488372,45.24147727272728,1019.0340909090924,23.69846723044401,0
860,4,0,1,48,0.0,0.02040816326530612,0.9795918367346939,49,950,800,150,0.8421052631578947,11,8,3,294.4142459414168,0.4521329365079365,0.20204991357612845,0.16650486346098625,129972.73875114789,-2146.8348255280025,127825.90392561989,846,2,232.6326530612245,43,6,17,37.57042471520555,0.6085271317829457,45.07575757575758,1019.69696969697,23.713883016208605,0
861,4,1,1,48,0.02040816326530612,0.02040816326530612,0.9795918367346939,49,1500,1000,500,0.6666666666666666,20,10,10,298.29272231343646,0.4504499716553288,0.2181264487977821,0.1695359902768772,130165.93491735544,-2034.4897842056878,128131.44513314975,847,0,233.48979591836735,43,6,18,37.27650952734472,0.6104651162790697,44.88636363636364,1020.454545454546,23.731501057082465,0
862,4,0,1,47,0.0,0.020833333333333332,0.9791666666666666,48,1550,1200,350,0.7741935483870968,19,12,7,306.0421432434081,0.44928339243498816,0.2220455120901379,0.17404081277751465,130188.4088997055,-1631.3720629769944,128557.0368367285,848,1,239.1875,42,6,18,37.05611469806305,0.6121031746031746,44.86434108527131,1020.5426356589143,24.2986341823551,0
863,4,0,0,47,0.0,0.0,1.0,47,1500,1000,500,0.6666666666666666,20,10,10,308.6795233288254,0.44742522355843356,0.21745458153823227,0.1761047480099929,130313.22830057955,-1354.9949609473392,128958.2333396322,849,2,244.53191489361703,41,6,18,36.86277367534653,0.6148373983739837,44.742063492063494,1021.0317460317465,24.903213317847474,0
864,4,0,0,47,0.0,0.0,1.0,47,1400,1100,300,0.7857142857142857,17,11,6,311.8598573144028,0.44713613937712,0.22266031840499934,0.1783838383838383,130414.54081632647,-1265.787981859417,129148.75283446704,850,3,245.53191489361703,41,6,18,36.679292929292934,0.6158536585365854,44.64285714285714,1021.4285714285709,24.912891986062704,0
865,4,0,0,47,0.0,0.0,1.0,47,1650,1400,250,0.8484848484848485,19,14,5,311.17084120983,0.4469626888683318,0.22386679000925125,0.17892323369565222,130617.28395061725,-1271.1419753086436,129346.14197530861,851,4,246.53191489361703,41,6,15,36.4923007246377,0.6178861788617886,44.44444444444444,1022.222222222222,24.932249322493217,0
866,4,0,1,46,0.0,0.02127659574468085,0.9787234042553191,47,1400,900,500,0.6428571428571429,19,9,10,312.30167454092225,0.44640379278445885,0.2227325908913642,0.18040014376422672,130794.81336805545,-1230.5121527777853,129564.30121527766,852,5,247.53191489361703,41,6,16,36.28436863543787,0.6196646341463414,44.27083333333333,1022.9166666666657,24.949186991869894,0
867,4,1,0,47,0.02127659574468085,0.0,1.0,47,1650,1300,350,0.7878787878787878,20,13,7,312.6030099621799,0.44771430773974713,0.21798462841702437,0.18200794539422357,131099.43000637766,-1203.584715136041,129895.84529124163,853,0,241.63829787234042,41,6,18,35.96973990119153,0.6227134146341464,43.97321428571429,1024.1071428571436,24.978222996515697,0
868,4,0,2,45,0.0,0.0425531914893617,0.9574468085106383,47,1150,900,250,0.782608695652174,14,9,5,315.55711464592474,0.44744449583718776,0.2176864020176299,0.18409281162902916,131175.63952664388,-1121.318735827674,130054.3207908162,854,1,242.63829787234042,41,6,18,35.817354251404225,0.6234756097560976,43.89880952380952,1024.404761904761,24.9854819976771,0
869,4,0,0,45,0.0,0.0,1.0,45,1400,1100,300,0.7857142857142857,17,11,6,328.964663518998,0.4452651515151515,0.2122733233844345,0.1910794747674181,131008.00781250013,-380.59895833331814,130627.40885416682,855,2,253.88888888888889,39,6,18,35.64306064306064,0.625,44.06250000000001,1023.750000000001,26.250000000000025,0
870,4,0,0,45,0.0,0.0,1.0,45,1150,900,250,0.782608695652174,14,9,5,330.49288254225064,0.44543350168350165,0.21137329355392764,0.19250035670351953,131114.670138889,-333.5069444444396,130781.16319444455,856,3,254.88888888888889,39,6,18,35.496338486574444,0.6260683760683761,43.958333333333336,1024.1666666666674,26.26068376068378,0
871,4,0,1,44,0.0,0.022222222222222223,0.9777777777777777,45,1300,1000,300,0.7692307692307693,16,10,6,330.63805331363983,0.44469696969696965,0.211107722544136,0.19325528998492425,131248.05908203125,-320.879448784722,130927.17963324653,857,4,255.88888888888889,39,6,19,35.358107993629496,0.6274038461538461,43.828125,1024.6875,26.27403846153846,0
872,4,0,1,43,0.0,0.022727272727272728,0.9772727272727273,44,1800,1300,500,0.7222222222222222,23,13,10,340.00683791772406,0.443930584918957,0.21450276646019528,0.19929303621898434,131356.22409058546,132.42729283287986,131488.65138341833,858,5,259.20454545454544,37,7,19,35.008980461368424,0.6320382882882882,43.72258771929824,1025.109649122806,27.70566619250827,0
873,4,0,0,43,0.0,0.0,1.0,43,1200,900,300,0.75,15,9,6,345.7556268358451,0.44266795865633074,0.21400764294764407,0.20281953780370696,131385.8453047641,485.47906014121367,131871.32436490533,859,6,265.2093023255814,36,7,20,34.831758933802,0.6342592592592593,43.69369369369369,1025.2252252252244,28.478478478478458,0
874,4,2,1,44,0.044444444444444446,0.022222222222222223,0.9777777777777777,45,800,400,400,0.5,12,4,8,334.721732083012,0.4432028619528619,0.21933784018027414,0.19903212455028807,131903.6740836619,-169.79474852072755,131733.87933514116,860,0,254.37777777777777,38,7,17,34.59308372334894,0.6356907894736843,43.189102564102555,1027.2435897435885,27.03272604588391,0
875,4,1,0,45,0.022222222222222223,0.0,1.0,45,2100,1500,600,0.7142857142857143,27,15,12,324.71465719197363,0.44145622895622894,0.21010520487264683,0.195478223629568,132370.51647308056,-403.470624223835,131967.0458488567,861,0,253.4,38,7,20,34.38127249446289,0.6403508771929824,42.73504273504273,1029.0598290598289,27.080521817363916,0
876,4,0,0,45,0.0,0.0,1.0,45,1750,1400,350,0.8,21,14,7,326.2147931144947,0.4406986531986532,0.21338160650268034,0.19726227444547445,132539.10007165666,-352.7541245400889,132186.34594711658,862,1,254.4,37,8,20,34.173566002910604,0.6438626126126126,42.57127192982456,1029.7149122807016,27.830132764343286,0
877,4,0,0,45,0.0,0.0,1.0,45,950,600,350,0.631578947368421,13,6,7,330.4432327298503,0.43985690235690234,0.22180596944326214,0.20057135754067643,132680.27181440438,-231.34041243459873,132448.93140196978,863,2,255.4,37,8,14,33.923123314885764,0.6452702702702703,42.43421052631579,1030.2631578947364,27.844950213371256,0
878,4,0,0,45,0.0,0.0,1.0,45,1400,900,500,0.6428571428571429,19,9,10,329.60079408474417,0.4395833333333334,0.21517655542551783,0.20051248308106867,132765.01092884352,-248.1093942366857,132516.90153460685,864,3,256.4,37,8,14,33.8598742774054,0.6461148648648649,42.35197368421053,1030.5921052631581,27.853840682788057,0
879,4,0,3,42,0.0,0.06666666666666667,0.9333333333333333,45,750,500,250,0.6666666666666666,10,5,5,329.33336066439114,0.4394360269360269,0.21645512775059705,0.20080364831171207,132849.77709487514,-249.62728916591877,132600.14980570922,865,4,257.4,37,8,14,33.78181947103453,0.6469594594594594,42.26973684210525,1030.9210526315774,27.862731152204795,0
880,4,0,0,42,0.0,0.0,1.0,42,1750,1200,550,0.6857142857142857,23,12,11,354.38819428306357,0.4377903600464576,0.22361253260259528,0.21506840345902017,132673.8166099771,1003.6068594104006,133677.42346938752,866,6,247.61904761904762,34,8,15,33.312870734149904,0.6513480392156863,42.440476190476176,1030.2380952380934,30.301120448179216,0
881,4,0,0,42,0.0,0.0,1.0,42,1500,800,700,0.5333333333333333,22,8,14,356.4377529540855,0.43710075493612077,0.2275666936135814,0.21719876867202143,132827.17013888876,1068.9236111110918,133896.09374999985,867,7,248.61904761904762,34,8,15,33.10596874157909,0.6528799019607843,42.29166666666666,1030.8333333333321,30.318627450980358,0
882,4,0,1,41,0.0,0.023809523809523808,0.9761904761904762,42,1450,1100,350,0.7586206896551724,18,11,7,359.0357017060641,0.43521341463414637,0.23260895114159674,0.22011308425088383,133053.9547432268,1154.2240012002462,134208.17874442704,868,8,249.61904761904762,35,7,16,32.81121456884302,0.6529761904761905,42.071759259259245,1031.712962962961,29.47751322751317,0
883,4,1,2,40,0.023809523809523808,0.047619047619047616,0.9523809523809523,42,1150,900,250,0.782608695652174,14,9,5,354.71156976289217,0.4351166279519938,0.22542866748851287,0.21903746276777042,133322.76562767895,1058.225496184819,134380.99112386376,869,0,239.16666666666666,35,7,17,32.65309219619708,0.6556547619047619,41.81134259259258,1032.754629629628,29.507275132275083,0
884,4,0,0,40,0.0,0.0,1.0,40,1000,800,200,0.8,12,8,4,372.6844906257368,0.43330662393162395,0.2420050761421324,0.2287839351801619,133103.4297052154,1921.1167800453543,135024.54648526077,870,1,251.675,34,6,18,32.409437009690826,0.6556372549019608,42.023809523809526,1031.904761904762,30.35014005602241,0
885,4,0,0,40,0.0,0.0,1.0,40,1050,600,450,0.5714285714285714,15,6,9,373.4591545812218,0.4325854700854701,0.24077672702110475,0.22982713480296482,133195.58000283447,1948.6217403628125,135144.20174319728,871,2,252.675,34,6,19,32.29683235305424,0.6565563725490196,41.93452380952381,1032.2619047619048,30.360644257703083,0
886,4,0,0,40,0.0,0.0,1.0,40,900,400,500,0.4444444444444444,14,4,10,374.24777217649824,0.43249198717948717,0.24041786743515825,0.23107469207338965,133318.49666950124,1978.830073696157,135297.3267431974,872,3,253.675,34,6,19,32.15297790585974,0.657781862745098,41.8154761904762,1032.738095238096,30.374649859944004,0
887,4,0,0,40,0.0,0.0,1.0,40,1250,900,350,0.72,16,9,7,367.78095733610803,0.43195779914529914,0.2310483870967739,0.22802419354838732,133472.22222222242,1817.7083333333567,135289.93055555577,873,4,254.675,34,6,19,32.16565860215054,0.6593137254901961,41.66666666666668,1033.3333333333348,30.392156862745143,0
888,4,0,0,40,0.0,0.0,1.0,40,550,300,250,0.5454545454545454,8,3,5,369.3458431209559,0.4317174145299145,0.23311003082760262,0.22938607075715348,133535.54672481745,1864.1598183391077,135399.70654315656,874,5,255.675,33,7,19,32.06169472768951,0.6622474747474747,41.60539215686275,1033.5784313725496,31.320558526440898,0
889,4,0,0,40,0.0,0.0,1.0,40,1200,800,400,0.6666666666666666,16,8,8,369.57036395533044,0.4316105769230769,0.2303342816500713,0.2299185538589359,133598.8862456749,1874.837802768186,135473.72404844308,875,6,256.675,33,7,19,31.99235419630157,0.6628787878787878,41.54411764705883,1033.823529411766,31.327985739750485,0
890,4,0,0,40,0.0,0.0,1.0,40,900,400,500,0.4444444444444444,14,4,10,370.1465623081642,0.43086271367521367,0.23457067219152794,0.23102250957854392,133718.36734693885,1899.078798185946,135617.4461451248,876,7,257.675,34,6,15,31.857638888888882,0.6617647058823529,41.42857142857143,1034.285714285715,30.42016806722691,0
891,4,0,0,40,0.0,0.0,1.0,40,1100,600,500,0.5454545454545454,16,6,10,371.18909556843107,0.4301148504273504,0.23830380766133663,0.23264216350226186,133872.32320011337,1938.3893140589576,135810.71251417234,877,8,258.675,34,6,15,31.67634878637984,0.663296568627451,41.279761904761905,1034.8809523809525,30.437675070028014,0
892,4,0,0,40,0.0,0.0,1.0,40,900,500,400,0.5555555555555556,13,5,8,375.0943580333415,0.4294871794871795,0.24316065192083802,0.21624567352391963,130718.71456916099,1809.800170068026,132528.51473922902,878,9,259.675,34,6,18,34.75577221575475,0.6317401960784313,44.345238095238095,1022.6190476190476,30.077030812324928,8
893,4,0,0,40,0.0,0.0,1.0,40,1100,800,300,0.7272727272727273,14,8,6,380.14992201508784,0.4291666666666667,0.24022801302931596,0.22020004916723002,130901.38888888885,1952.4305555555516,132853.8194444444,879,10,260.675,34,6,18,34.441164495114,0.633578431372549,44.166666666666664,1023.3333333333329,30.098039215686264,0
894,4,0,0,40,0.0,0.0,1.0,40,1350,900,450,0.6666666666666666,18,9,9,382.19586274871705,0.4294471153846154,0.24305070946731844,0.22173549446109772,130962.30867346932,2010.650510204075,132972.9591836734,880,11,261.675,34,6,18,34.327023726448004,0.6341911764705883,44.107142857142854,1023.5714285714281,30.10504201680671,0
895,4,0,1,39,0.0,0.025,0.975,40,1100,700,400,0.6363636363636364,15,7,8,378.5590362460661,0.429286858974359,0.23180867894677348,0.22053119892965373,131120.5970963006,1927.3773737568608,133047.97447005747,881,12,262.675,35,5,18,34.25963856556297,0.6336309523809525,43.9525462962963,1024.189814814815,29.262566137566143,0
896,4,0,0,39,0.0,0.0,1.0,39,900,700,200,0.7777777777777778,11,7,4,384.44813165727254,0.42706927575348624,0.2306857871711432,0.22410513040509306,131145.1530612245,2283.7018140589616,133428.85487528346,882,13,269.1794871794872,34,5,18,34.08395320006199,0.6360294117647058,43.92857142857143,1024.2857142857144,30.12605042016807,0
897,4,0,1,38,0.0,0.02564102564102564,0.9743589743589743,39,1450,1000,450,0.6896551724137931,19,10,9,393.5285329143886,0.4274910031488979,0.21223881767219432,0.21218599336531668,128084.27047902484,2307.3837868480596,130391.6542658729,883,14,270.1794871794872,34,5,17,36.9756752518719,0.6050857843137255,46.9345238095238,1012.2619047619039,29.77240896358541,8
898,4,1,0,39,0.02564102564102564,0.0,1.0,39,950,500,450,0.5263157894736842,14,5,9,388.00320038609743,0.4299932523616734,0.20909874865839106,0.2101726379024564,128268.64216887744,2153.742906476326,130422.38507535377,884,0,268.53846153846155,33,6,18,36.926365029437854,0.6092171717171717,46.75245098039216,1012.9901960784321,30.696672608437336,0
899,4,2,1,40,0.04878048780487805,0.024390243902439025,0.975609756097561,41,950,700,250,0.7368421052631579,12,7,5,387.3818402787403,0.4339684959349594,0.19715329925245295,0.197658220916798,125840.52861636227,1549.6671114111723,127390.19572777343,885,0,256.390243902439,35,6,18,39.443827623332176,0.5800595238095239,49.160879629629626,1003.3564814814811,28.66732804232803,8
900,4,3,1,42,0.06976744186046512,0.023255813953488372,0.9767441860465116,43,1050,800,250,0.7619047619047619,13,8,5,369.09859283175143,0.43950719822812845,0.21164795284794535,0.19136144688137183,126496.56994409962,738.1052928906565,127234.67523699028,886,0,245.37209302325581,36,7,19,39.225344229262284,0.5847800925925926,48.50788288288289,1005.9684684684694,27.943568568568594,0
901,4,1,0,43,0.023255813953488372,0.0,1.0,43,1300,900,400,0.6923076923076923,17,9,8,359.32319711579834,0.438999630860096,0.19651175898472362,0.1785745703985573,124746.7500228268,421.5194079214219,125168.26943074823,887,0,246.34883720930233,36,7,18,41.27940292338329,0.5668402777777778,50.25337837837837,998.9864864864859,27.74962462462461,8
902,4,2,1,44,0.044444444444444446,0.022222222222222223,0.9777777777777777,45,1900,1400,500,0.7368421052631579,24,14,10,344.4437126784078,0.444023569023569,0.1949549154893584,0.1734757606434937,125301.7169345375,-367.8654804072779,124933.85145413023,888,0,236.35555555555555,37,8,17,41.07698590880883,0.5706644144144144,49.6984649122807,1001.2061403508768,27.05962541488856,0
903,4,1,1,44,0.022222222222222223,0.022222222222222223,0.9777777777777777,45,1050,900,150,0.8571428571428571,12,9,3,354.9306139058269,0.44400252525252526,0.213742722045972,0.17994568728303728,125576.32065876032,-85.82388331025061,125490.49677545007,889,0,237.33333333333334,37,8,18,40.530644896619634,0.5734797297297297,49.42434210526316,1002.3026315789468,27.08926031294451,0
904,4,0,0,44,0.0,0.0,1.0,44,1250,1000,250,0.8,15,10,5,362.1580608509026,0.4434571000704722,0.22153217568947903,0.1835539146681682,125563.69714308906,294.7810141222334,125858.47815721128,890,1,243.63636363636363,36,8,19,40.362593632958806,0.5752314814814814,49.43693693693694,1002.2522522522524,27.840340340340347,0
905,4,2,0,46,0.043478260869565216,0.0,1.0,46,1400,800,600,0.5714285714285714,20,8,12,350.56223679559525,0.4482487922705314,0.23924594557131673,0.18105327377862482,126339.03704616817,-342.06091569876526,125996.97613046941,891,0,234.0,38,8,18,39.85365745660644,0.5794956140350878,48.6645299145299,1005.3418803418781,26.456365272154688,0
906,4,2,0,48,0.041666666666666664,0.0,1.0,48,1400,1000,400,0.7142857142857143,18,10,8,341.37521428358934,0.4519799054373523,0.2485943015632881,0.17880270732286216,126912.74957242687,-935.0265838786747,125977.7229885482,892,0,225.20833333333334,40,8,20,39.49508320726169,0.58203125,48.094512195121936,1007.62195121951,25.190548780487752,0
907,4,3,2,49,0.058823529411764705,0.0392156862745098,0.9607843137254902,51,1250,1000,250,0.8,15,10,5,324.48619707729574,0.4564052287581699,0.2469108163404914,0.17311420970976527,127658.21468195255,-1914.7016977954188,125743.51298415713,893,0,212.90196078431373,38,13,19,39.15781266518659,0.5929276315789473,47.355769230769226,1010.5769230769222,26.594129554655847,0
908,4,0,1,48,0.0,0.02040816326530612,0.9795918367346939,49,1850,1600,250,0.8648648648648649,21,16,5,343.2835078901675,0.45287698412698413,0.25233772438741386,0.1826365993935236,127546.62390430998,-1043.0695053160962,126503.55439899387,894,1,222.48979591836735,36,13,19,38.797147900408774,0.5954861111111112,47.46621621621623,1010.1351351351373,28.05930930930937,0
909,4,0,0,48,0.0,0.0,1.0,48,1200,600,600,0.5,18,6,12,351.7530734339201,0.4516566932624113,0.26220210815765377,0.18720126981288154,127559.26354595346,-626.1274005486861,126933.13614540477,895,2,228.08333333333334,35,13,20,38.570310113046126,0.5976190476190476,47.45370370370371,1010.185185185186,28.862433862433885,0
910,4,0,0,48,0.0,0.0,1.0,48,1600,1200,400,0.75,20,12,8,355.0126416828918,0.4508717494089835,0.26302649650909893,0.19017446047721792,127822.46823827582,-524.2815768604371,127298.18666141538,896,3,229.08333333333334,35,13,21,38.21832913662202,0.600297619047619,47.19328703703703,1011.2268518518513,28.89219576719575,0
911,4,0,1,47,0.0,0.020833333333333332,0.9791666666666666,48,1450,1000,450,0.6896551724137931,19,10,9,354.96502113055345,0.45056700650118203,0.26330058629262654,0.1905947868987307,127916.59216226371,-518.8168320347273,127397.77533022898,897,4,230.08333333333334,36,12,21,38.123167835541224,0.5992476851851851,47.10022522522523,1011.5990990990999,28.099974974974998,0
912,4,0,1,46,0.0,0.02127659574468085,0.9787234042553191,47,950,800,150,0.8421052631578947,11,8,3,365.83130142155096,0.4495451742213999,0.24540305089810865,0.18746360800216655,126017.0175414566,-179.80609430930724,125837.2114471473,898,5,229.9787234042553,38,9,14,39.8021298857913,0.5762061403508771,48.98504273504273,1004.0598290598288,26.42262708052181,8
913,4,2,3,45,0.041666666666666664,0.0625,0.9375,48,750,500,250,0.6666666666666666,10,5,5,353.92864114582926,0.4525155141843971,0.24072229306131154,0.18291172113253146,126365.89055309004,-655.0955603038988,125710.79499278613,899,0,225.20833333333334,38,10,11,39.741393050685375,0.5797697368421053,48.63782051282051,1005.4487179487176,26.459176788124147,0
914,4,2,2,45,0.0425531914893617,0.0425531914893617,0.9574468085106383,47,1650,1100,550,0.6666666666666666,22,11,11,362.88603951920294,0.4531876349059513,0.2529344628889034,0.18783243535384442,126429.50234687574,-224.09972299171642,126205.40262388403,900,0,230.82978723404256,37,10,13,39.45068323884284,0.5822072072072072,48.57456140350876,1005.7017543859631,27.18112849691792,0
915,4,2,1,46,0.0425531914893617,0.02127659574468085,0.9787234042553191,47,1250,700,550,0.56,18,7,11,347.1163139690692,0.45070151094665434,0.2076711067315291,0.17887614532778148,126248.01834432219,-605.3933199530159,125642.62502436918,901,0,231.61702127659575,40,7,17,40.033960292580986,0.5752604166666666,48.75508130081301,1004.9796747967482,25.124491869918707,8
916,4,2,1,47,0.041666666666666664,0.020833333333333332,0.9791666666666666,48,1450,1000,450,0.6896551724137931,19,10,9,343.6082885257958,0.4518136820330969,0.23321879002857449,0.17911045301737544,126717.16668438206,-891.7862457483019,125825.38043863376,902,0,227.72916666666666,41,7,17,39.63968124938419,0.5785060975609756,48.288690476190474,1006.8452380952378,24.557200929152142,0
917,4,0,0,47,0.0,0.0,1.0,47,1550,1100,450,0.7096774193548387,20,11,9,339.5146906462857,0.45052806043786614,0.2313561576819756,0.1779401518207489,126938.35101460773,-780.5130048251658,126157.83800978257,903,1,233.2127659574468,40,7,17,39.51568172650262,0.5822916666666667,48.06910569105691,1007.7235772357725,25.19308943089431,0
918,4,2,0,49,0.04081632653061224,0.0,1.0,49,1200,700,500,0.5833333333333334,17,7,10,332.35700703908304,0.45316043083900226,0.25223807949264043,0.1765169203071817,127476.57773357464,-1326.2673301275636,126150.31040344707,904,0,224.6530612244898,40,9,16,39.14473684210526,0.5877604166666667,47.53556910569106,1009.8577235772361,25.246443089430905,0
919,4,0,2,47,0.0,0.04081632653061224,0.9591836734693877,49,1500,900,600,0.6,21,9,12,305.20959552006923,0.45248724489795916,0.19068787345206806,0.15659157041559435,126067.61081159613,-2045.5235592128213,124022.08725238331,905,1,225.6530612244898,43,6,19,41.2719039761119,0.5690406976744187,48.93465909090909,1004.2613636363641,23.354915433403814,8
920,4,3,1,49,0.06,0.02,0.98,50,1150,1100,50,0.9565217391304348,12,11,1,298.9449631718269,0.4545323129251701,0.2158539501517518,0.15574645829263423,126695.52576303156,-2425.002143347055,124270.5236196845,906,0,221.62,44,6,18,40.786044943131294,0.5741003787878788,48.31018518518518,1006.7592592592594,22.88089225589226,0
921,4,3,0,52,0.057692307692307696,0.0,1.0,52,1300,800,500,0.6153846153846154,18,8,10,298.5979745783894,0.45683289341377575,0.24841246933179417,0.15820349945356,127378.63363751133,-2791.141316362291,124587.49232114904,907,0,214.03846153846155,43,9,14,40.09693558474046,0.5823643410852712,47.63257575757575,1009.4696969696957,23.476039464411528,0
922,4,2,1,53,0.037037037037037035,0.018518518518518517,0.9814814814814815,54,900,500,400,0.5555555555555556,13,5,8,298.75653245463013,0.4590030281854181,0.2817172531112897,0.16050080379921897,127938.26242025048,-3155.5216702110947,124782.74075003939,908,0,207.07407407407408,45,9,17,39.522618408093834,0.5854166666666667,47.078804347826086,1011.6847826086957,22.481884057971016,0
923,4,0,1,52,0.0,0.018867924528301886,0.9811320754716981,53,1300,1000,300,0.7692307692307693,16,10,6,307.8228826764831,0.4578041848089018,0.23615800307922363,0.155089979266447,125317.23000026261,-2840.574048913036,122476.65595134957,909,1,211.9433962264151,45,8,13,41.977640069959605,0.5587962962962962,49.68297101449276,1001.2681159420295,22.25040257648954,8
924,4,2,2,52,0.037037037037037035,0.037037037037037035,0.962962962962963,54,1200,900,300,0.75,15,9,6,302.5222335617431,0.46016771488469604,0.24612701344003218,0.15381764269829512,125695.40895061767,-3194.868827160462,122500.5401234572,910,0,208.88888888888889,47,7,16,41.72149122807017,0.5602836879432624,49.30555555555557,1002.7777777777809,21.335697399527252,0
925,4,0,2,50,0.0,0.038461538461538464,0.9615384615384616,52,1550,1000,550,0.6451612903225806,21,10,11,307.01536345561107,0.45774415535444946,0.2418413865473219,0.15595929591969546,125657.56541594479,-2684.2393765752863,122973.3260393695,911,1,217.80769230769232,45,7,16,41.64775122715089,0.5622685185185186,49.34329710144928,1002.626811594204,22.280595813204535,0
926,4,3,1,52,0.05660377358490566,0.018867924528301886,0.9811320754716981,53,1300,1000,300,0.7692307692307693,16,10,6,318.41978341277786,0.457138969521045,0.22748399853627554,0.15888552520376117,124914.98044796137,-2604.267638646088,122310.71280931527,912,0,214.37735849056602,48,5,16,42.12724707950551,0.5512152777777778,50.08503401360544,999.6598639455771,20.826247165532855,8
927,4,2,2,52,0.037037037037037035,0.037037037037037035,0.962962962962963,54,1000,300,700,0.3,17,3,14,316.2457058067779,0.4586609014675052,0.26673399455347524,0.15959510584689846,125385.26016232155,-2869.374287904508,122515.88587441704,913,0,211.33333333333334,45,9,15,41.69671927285884,0.5594907407407408,49.61503623188406,1001.5398550724644,22.256441223832542,0
928,4,1,0,53,0.018867924528301886,0.0,1.0,53,1200,900,300,0.75,15,9,6,322.79320660083806,0.45969400096758584,0.30087258521092286,0.1640950094320037,125688.00083151009,-2485.7534360696063,123202.24739544048,914,0,211.56603773584905,46,7,16,41.220935372646096,0.5613677536231885,49.31294326241135,1002.7482269503554,21.79887449892077,0
929,4,2,0,55,0.03636363636363636,0.0,1.0,55,1650,1300,350,0.7878787878787878,20,13,7,319.0033702000015,0.46301907968574635,0.3163673240192091,0.16375908928345567,126090.33028978057,-2953.3399663569194,123136.99032342366,915,0,204.83636363636364,44,11,18,40.90224639685319,0.5679450757575757,48.91203703703704,1004.3518518518522,22.82617845117846,0
930,4,1,1,55,0.017857142857142856,0.017857142857142856,0.9821428571428571,56,1700,1200,500,0.7058823529411765,22,12,10,314.7053631236727,0.46457656926406926,0.3190595205928899,0.1628985383105891,126430.7009835775,-3242.3160673965554,123188.38491618093,916,0,202.16071428571428,45,11,17,40.66083866222342,0.5701388888888889,48.57336956521739,1005.7065217391303,22.349033816425116,0
931,4,1,1,55,0.017857142857142856,0.017857142857142856,0.9821428571428571,56,1650,1100,550,0.6666666666666666,22,11,11,314.7256899592314,0.4636837121212121,0.3247759991946042,0.16358818829749067,126600.837483024,-3231.0928147477453,123369.74466827627,917,0,202.73214285714286,46,10,18,40.4858908856002,0.5706521739130435,48.40425531914894,1006.3829787234044,21.87789084181314,0
932,4,3,4,54,0.05172413793103448,0.06896551724137931,0.9310344827586207,58,1850,1400,450,0.7567567567567568,23,14,9,311.25326150997364,0.4642190965920549,0.3454286618158804,0.16469225973100554,127325.5315500686,-3669.147752429428,123656.38379763917,918,0,191.67241379310346,44,14,15,39.831804281345555,0.5804924242424243,47.68518518518518,1009.2592592592594,22.93771043771044,0
933,4,1,3,52,0.01818181818181818,0.05454545454545454,0.9454545454545454,55,1900,1300,600,0.6842105263157895,25,13,12,320.89724706350944,0.46440796857463523,0.3447602964630829,0.16991772262543206,127354.73632812503,-2826.4431423611095,124528.29318576392,919,0,184.8,43,12,15,39.55860853113173,0.5821220930232558,47.65625,1009.3750000000002,23.47383720930233,0
934,4,2,2,52,0.037037037037037035,0.037037037037037035,0.962962962962963,54,1600,900,700,0.5625,23,9,14,322.9953398682309,0.46513947123223853,0.3441444819397581,0.17194183062446552,127569.89282024807,-2559.103822314029,125010.78899793404,920,0,187.24074074074073,43,11,17,39.2857142857143,0.5843023255813953,47.44318181818183,1010.2272727272738,23.493657505285437,0
935,4,1,0,53,0.018867924528301886,0.0,1.0,53,1250,800,450,0.64,17,8,9,334.5581122308402,0.46466799709724244,0.35574295053025917,0.1786879502652278,127703.4144300975,-2055.1573485667736,125648.25708153073,921,0,188.37735849056602,42,11,18,38.857132585562276,0.5870535714285714,47.311046511627914,1010.7558139534897,24.06561461794023,0
936,4,1,1,53,0.018518518518518517,0.018518518518518517,0.9814814814814815,54,1600,1100,500,0.6875,21,11,10,332.68693581493176,0.4645280107151177,0.35802064813948387,0.1791146238314449,128024.70842121524,-2281.5704093491468,125743.13801186609,922,0,185.87037037037038,43,11,19,38.5761712048907,0.5889050387596899,46.993371212121225,1012.0265151515172,23.535500352360863,0
937,4,0,3,50,0.0,0.05660377358490566,0.9433962264150944,53,1200,800,400,0.6666666666666666,16,8,8,340.88419496902316,0.46351898887276244,0.36395103240253457,0.18319953415739684,127952.84162649243,-1876.579717630826,126076.2619088616,923,1,190.28301886792454,43,10,19,38.442218894296786,0.5881782945736433,47.06439393939395,1011.7424242424261,23.528893587033163,0
938,4,0,0,50,0.0,0.0,1.0,50,1700,1300,400,0.7647058823529411,21,13,8,353.67754963973454,0.4639030612244898,0.3507494474583075,0.18988707276774142,127913.11905116045,-952.0002974419576,126961.11875371849,924,2,195.48,40,10,21,38.15928270042196,0.5921875,47.103658536585385,1011.585365853662,25.289634146341548,0
939,4,2,2,50,0.038461538461538464,0.038461538461538464,0.9615384615384616,52,1150,700,450,0.6086956521739131,16,7,9,342.15248040987836,0.46512066365007537,0.35206985548614234,0.18608546683802496,128429.74044568214,-1610.234316190119,126819.50612949202,925,0,188.92307692307693,36,16,22,37.92310113691072,0.6044560185185186,46.593468468468465,1013.6261261261259,28.156281281281274,0
940,4,1,0,51,0.0196078431372549,0.0,1.0,51,1550,900,650,0.5806451612903226,22,9,13,341.2414571265184,0.4666503267973856,0.35313257859993663,0.18746445679436705,128829.56594685902,-1407.6022390633898,127421.96370779563,926,0,188.07843137254903,36,15,23,37.53859308559806,0.6085069444444444,46.19932432432432,1015.2027027027027,28.200075075075077,0
941,4,0,0,51,0.0,0.0,1.0,51,1800,1200,600,0.6666666666666666,24,12,12,341.4364496404451,0.46566993464052286,0.34884833572551366,0.18858273668136494,129042.58355034732,-1388.0316840277724,127654.55186631955,927,1,189.07843137254903,39,12,23,37.31674184949763,0.6052350427350428,45.989583333333336,1016.0416666666674,26.052350427350447,0
942,4,0,0,51,0.0,0.0,1.0,51,1350,700,650,0.5185185185185185,20,7,13,344.4305863683132,0.4651797385620915,0.35721017089006146,0.19127971678387892,129258.63997443409,-1295.5811993369844,127963.0587750971,928,2,190.07843137254903,36,15,23,37.020810262089334,0.6128472222222222,45.77702702702704,1016.8918918918935,28.24699699699704,0
943,4,2,0,53,0.03773584905660377,0.0,1.0,53,1600,1200,400,0.75,20,12,8,332.857796081944,0.4656507014997581,0.35914132053713943,0.18754462592000368,129826.69850107744,-1957.2342528672734,127869.46424821016,929,0,183.8679245283019,38,15,19,36.73843344864942,0.6148574561403508,45.21901709401709,1019.1239316239311,26.819050832208713,0
944,4,1,1,53,0.018518518518518517,0.018518518518518517,0.9814814814814815,54,1800,1500,300,0.8333333333333334,21,15,6,332.0644370974331,0.46502300256231077,0.36066875368631224,0.18868348177531627,130156.27170138877,-2155.9461805555666,128000.32552083321,930,0,181.44444444444446,39,15,20,36.42473118279569,0.6164529914529915,44.89583333333333,1020.4166666666657,26.16452991452989,0
945,4,0,1,52,0.0,0.018867924528301886,0.9811320754716981,53,1100,800,300,0.7272727272727273,14,8,6,333.6533677864437,0.46429003386550555,0.3166895873767206,0.18341935260020809,128856.2845006956,-1909.1892459567464,126947.09525473886,931,1,185.71698113207546,45,8,19,37.70398414964164,0.594675925925926,46.173007246376805,1015.3079710144916,22.56239935587759,8
946,4,0,0,52,0.0,0.0,1.0,52,1850,1200,650,0.6486486486486487,25,12,13,341.5251569315629,0.46300747863247865,0.3243246086517424,0.188044574358704,128919.13580246917,-1594.1743827160449,127324.96141975313,932,2,190.25,44,8,19,37.44016684901533,0.5965909090909092,46.111111111111114,1015.5555555555559,23.080808080808087,0
947,4,1,1,52,0.018867924528301886,0.018867924528301886,0.9811320754716981,53,1700,1000,700,0.5882352941176471,24,10,14,339.0671344103159,0.4635643444605709,0.3307163317136532,0.18828062378347535,129254.34570312474,-1832.9680266203995,127421.37767650434,933,0,187.64150943396226,39,14,20,37.16152769241274,0.6073717948717949,45.781249999999986,1016.874999999998,26.073717948717896,0
948,4,1,0,53,0.018867924528301886,0.0,1.0,53,1300,800,500,0.6153846153846154,18,8,10,332.5940752006725,0.46336780358006774,0.33040550969856985,0.1868203481488236,129706.17992567354,-1972.0986079617478,127734.0813177118,934,0,185.58490566037736,41,12,18,36.86737112063367,0.608739837398374,45.33730158730157,1018.6507936507902,24.84514130855586,0
949,4,0,1,52,0.0,0.018867924528301886,0.9811320754716981,53,2250,1700,550,0.7555555555555555,28,17,11,328.31544393940595,0.4623397435897436,0.25536778571402774,0.17915273390353645,128561.83992097863,-2062.834956521789,126499.00496445684,935,1,186.58490566037736,42,11,16,38.139172877253344,0.595734126984127,46.46317829457366,1014.147286821708,24.14636397194543,8
950,4,0,0,52,0.0,0.0,1.0,52,2100,1600,500,0.7619047619047619,26,16,10,330.2557170608566,0.4605250754147813,0.2681052495530236,0.1806038538475222,128648.39916386889,-1902.6261370810266,126745.77302678787,936,2,190.80769230769232,43,9,16,38.00182410778183,0.595203488372093,46.377840909090914,1014.488636363637,23.592758985200863,0
951,4,0,1,51,0.0,0.019230769230769232,0.9807692307692307,52,1250,600,650,0.48,19,6,13,330.0601658210962,0.4599673202614379,0.262777454842946,0.1811528375543435,128792.54301717454,-1898.1423790461429,126894.4006381284,937,3,191.80769230769232,43,9,16,37.86004991137234,0.596656976744186,46.23579545454545,1015.0568181818178,23.605972515856227,0
952,4,1,2,50,0.019230769230769232,0.038461538461538464,0.9615384615384616,52,1600,1000,600,0.625,22,10,12,331.26859560358196,0.4603208270487682,0.2703548199726076,0.18270016581180573,128984.86036680723,-1854.2732904327352,127130.58707637449,938,0,191.90384615384616,43,9,18,37.63371632329636,0.5985949612403101,46.046401515151516,1015.8143939393935,23.623590556730083,0
953,4,2,2,50,0.038461538461538464,0.038461538461538464,0.9615384615384616,52,1600,1300,300,0.8125,19,13,6,335.9616877661666,0.4628032302664655,0.2721884754914361,0.1762794991187421,126984.85819710576,-1867.2273594697492,125117.63083763601,939,0,190.6346153846154,48,4,18,39.55749599257573,0.572265625,48.022959183673485,1007.9081632653092,20.998086734693942,8
954,4,0,0,50,0.0,0.0,1.0,50,1400,1000,400,0.7142857142857143,18,10,8,369.79166666666663,0.4611394557823129,0.3228333333333331,0.18489583333333334,125000.00000000001,-660.8646860104575,124339.13531398955,940,1,198.46,37,13,16,40.75520833333333,0.5675675675675675,50.0,1000.0000000000001,27.02702702702703,8
955,4,3,2,51,0.05660377358490566,0.03773584905660377,0.9622641509433962,53,1150,700,450,0.6086956521739131,16,7,9,347.4434044501581,0.4634131591678761,0.3267678181512794,0.17687073610227078,125745.1548327664,-1862.1350623582816,123883.01977040812,941,0,188.16981132075472,41,12,16,40.54401582591496,0.5685975609756098,49.25595238095238,1002.9761904761903,24.46283391405342,0
956,4,3,3,51,0.05555555555555555,0.05555555555555555,0.9444444444444444,54,1650,1100,550,0.6666666666666666,22,11,11,348.2058307720579,0.46487013743303046,0.34383989239412105,0.17974374341381882,126317.93986402435,-2002.7170532564874,124315.22281076785,942,0,184.94444444444446,41,13,15,39.9345989999671,0.5744410569105691,48.68551587301587,1005.2579365079367,24.51848625629114,0
957,4,1,0,52,0.019230769230769232,0.0,1.0,52,1450,1100,350,0.7586206896551724,18,11,7,352.61695036361823,0.4633609854198089,0.3576176326454419,0.18171073591171535,126248.01834432207,-1496.5617563950111,124751.45658792707,943,0,192.6153846153846,40,12,18,39.89575959820677,0.5752604166666666,48.755081300813,1004.9796747967472,25.12449186991868,0
958,4,3,1,54,0.05454545454545454,0.01818181818181818,0.9818181818181818,55,1600,1100,500,0.6875,21,11,10,337.6461751318059,0.4662878787878788,0.36545420375527504,0.17700643328830923,126948.8250760445,-2427.242955119384,124521.58212092512,944,0,183.05454545454546,43,12,19,39.552010900206724,0.5780038759689923,48.05871212121212,1007.7651515151512,23.436398872445377,0
959,4,0,1,53,0.0,0.018518518518518517,0.9814814814814815,54,1850,1300,550,0.7027027027027027,24,13,11,342.10340551885383,0.46417860470533423,0.3593769034517096,0.17923792900670185,126924.96812048009,-2115.707232122381,124809.2608883577,945,1,187.38888888888889,43,11,19,39.46419901011811,0.5777616279069768,48.08238636363635,1007.6704545454522,23.4341966173361,0
960,4,1,0,54,0.018518518518518517,0.0,1.0,54,1850,1200,650,0.6486486486486487,25,12,13,335.83584588595505,0.46489925460051246,0.3507217186975491,0.1775745447096662,127297.04231112418,-2249.3786150452743,125047.6636960789,946,0,184.62962962962962,40,14,20,39.24072675394427,0.5859375,47.71341463414633,1009.1463414634134,25.228658536585336,0
961,4,0,2,52,0.0,0.037037037037037035,0.962962962962963,54,1350,1000,350,0.7407407407407407,17,10,7,333.68450033420555,0.46438970416957837,0.347322410482954,0.1769970908072787,127425.2689887797,-2296.0325575054676,125129.23643127423,947,1,185.62962962962962,40,14,15,39.16373091763125,0.5872395833333333,47.58638211382113,1009.6544715447144,25.24136178861786,0
962,4,1,0,53,0.018867924528301886,0.0,1.0,53,1300,700,600,0.5384615384615384,19,7,12,342.86804846899486,0.46413884857281085,0.35843800914489976,0.18190585625670308,127433.6059570311,-1861.417643229182,125572.18831380192,948,0,189.8490566037736,39,14,16,38.92338543278656,0.5889423076923077,47.57812499999999,1009.6874999999989,25.88942307692305,0
963,4,1,5,49,0.018518518518518517,0.09259259259259259,0.9074074074074074,54,1550,1200,350,0.7741935483870968,19,12,7,335.3768932063086,0.4648337409736781,0.35957335427300174,0.1790786052403492,127692.92091836697,-2234.9489795918716,125457.9719387751,949,0,187.3148148148148,41,13,17,38.847173144876315,0.5884146341463414,47.321428571428555,1010.7142857142827,24.651567944250797,0
964,4,2,5,46,0.0392156862745098,0.09803921568627451,0.9019607843137255,51,1800,1200,600,0.6666666666666666,24,12,12,334.57919069484956,0.4655228758169934,0.3378899798816928,0.18056215828407984,128120.00480740325,-1626.7424959437667,126493.26231145949,950,0,190.84313725490196,42,9,19,38.43099955334355,0.5912698412698413,46.899224806201545,1012.4031007751926,24.10483573274268,0
965,4,2,1,47,0.041666666666666664,0.020833333333333332,0.9791666666666666,48,1200,900,300,0.75,15,9,6,349.4906575728682,0.4651854314420804,0.34577642194770863,0.18799991774462724,127990.23321311723,-653.7218462885796,127336.51136682865,951,0,201.41666666666666,40,8,21,38.18628435606442,0.59296875,47.02743902439025,1011.8902439024394,25.297256097560982,0
966,4,0,1,46,0.0,0.02127659574468085,0.9787234042553191,47,1200,900,300,0.75,15,9,6,344.9677386577245,0.46552189330866484,0.32974345503896285,0.18628257887517155,128144.53125000029,-558.8541666666372,127585.67708333365,952,1,200.08510638297872,40,7,21,38.143004115226354,0.59453125,46.875000000000014,1012.5000000000023,25.312500000000057,0
967,4,0,1,45,0.0,0.021739130434782608,0.9782608695652174,46,850,500,350,0.5882352941176471,12,5,7,350.38696675642234,0.46529790660225445,0.32501341921631766,0.18920896204846835,128144.53125000026,-219.96527777774853,127924.56597222251,953,2,198.2173913043478,39,7,21,38.00582990397808,0.5961538461538461,46.875000000000014,1012.500000000002,25.961538461538513,0
968,4,3,2,46,0.0625,0.041666666666666664,0.9583333333333334,48,1350,800,550,0.5925925925925926,19,8,11,338.4039906870929,0.4672909278959811,0.32563898583453077,0.1854179795991937,128725.26584201405,-887.7712673610937,127837.49457465296,954,0,190.16666666666666,39,9,17,37.716844590433176,0.6020299145299146,46.30208333333334,1014.791666666668,26.02029914529918,0
969,4,0,1,45,0.0,0.021739130434782608,0.9782608695652174,46,1400,900,500,0.6428571428571429,19,9,10,351.34564845040245,0.46578099838969406,0.3336414395853027,0.19091639204156782,128394.44739006223,-177.83392486150666,128216.61346520072,955,1,199.43478260869566,37,9,17,37.7261846802986,0.6021959459459459,46.628289473684205,1013.4868421052624,27.3915362731152,0
970,4,0,0,45,0.0,0.0,1.0,45,1600,1200,400,0.75,20,12,8,354.16008996408715,0.46515151515151515,0.3274575538012332,0.19298281390087887,128505.59937913585,102.31092740073558,128607.91030653658,956,2,203.44444444444446,37,8,19,37.54134223712196,0.603322072072072,46.51864035087719,1013.925438596491,27.403390232337593,0
971,4,1,1,45,0.021739130434782608,0.021739130434782608,0.9782608695652174,46,1350,800,550,0.5925925925925926,19,8,11,351.20452278515864,0.4655293880837359,0.3338785463629337,0.1930304557563538,128848.6207561726,-149.55632716051912,128699.06442901208,957,0,200.0,38,8,21,37.26630186958505,0.6049890350877193,46.18055555555554,1015.2777777777759,26.71783625730989,0
972,4,1,0,46,0.021739130434782608,0.0,1.0,46,1250,900,350,0.72,16,9,7,353.64584790672495,0.463768115942029,0.34008122161702503,0.1949049899158972,128957.11343277416,-78.97045529260032,128878.14297748156,958,0,200.84782608695653,38,8,22,37.09372041653519,0.6060855263157895,46.073717948717935,1015.7051282051256,26.729082321187516,0
973,4,1,1,46,0.02127659574468085,0.02127659574468085,0.9787234042553191,47,1100,600,500,0.5454545454545454,16,6,10,347.59403158484236,0.4630743139068763,0.34185882102286524,0.19333268035237905,129319.08543381323,-408.9669904262384,128910.118443387,959,0,197.5531914893617,35,12,23,36.87888787740857,0.6154761904761905,45.71759259259258,1017.129629629628,29.060846560846514,0
974,4,0,3,43,0.0,0.06521739130434782,0.9347826086956522,46,1350,700,650,0.5185185185185185,20,7,13,367.78212138848613,0.46145330112721417,0.2969525001117119,0.19991732073240037,128408.33875868037,264.17328425066125,128672.51204293103,960,1,202.6086956521739,35,11,17,37.29552072627612,0.60625,46.61458333333332,1013.5416666666652,28.95833333333329,8
975,4,2,0,45,0.044444444444444446,0.0,1.0,45,1300,900,400,0.6923076923076923,17,9,8,358.1661086793386,0.4630892255892256,0.29822161422708593,0.19685671086059872,128848.62075617275,229.84182098764265,129078.46257716039,961,0,206.13333333333333,35,10,19,37.08960328317373,0.6107142857142858,46.18055555555555,1015.277777777777,29.00793650793649,0
976,4,2,1,46,0.0425531914893617,0.02127659574468085,0.9787234042553191,47,1150,800,350,0.6956521739130435,15,8,7,341.38867288416725,0.4638452050570459,0.30466654747005206,0.19066002778043548,129480.23069598322,-559.3831755925094,128920.84752039071,962,0,198.31914893617022,37,10,17,36.872890181713714,0.6131756756756757,45.55921052631578,1017.7631578947355,27.507112375533392,0
977,4,1,1,46,0.02127659574468085,0.02127659574468085,0.9787234042553191,47,1450,900,550,0.6206896551724138,20,9,11,348.57715355541995,0.4637102991057663,0.27732254065069584,0.18389600362482067,127205.59030314116,-468.843398055707,126736.74690508546,963,0,199.04255319148936,36,11,19,39.01307955644862,0.5920138888888888,47.80405405405406,1008.7837837837852,28.02177177177181,8
978,4,3,3,46,0.061224489795918366,0.061224489795918366,0.9387755102040817,49,1400,900,500,0.6428571428571429,19,9,10,337.0347227427909,0.46495890022675734,0.2944321320911276,0.18140123719923645,128012.72922092033,-1171.053059895814,126841.67616102452,964,0,191.81632653061226,39,10,18,38.478405386858824,0.5948183760683761,47.00520833333334,1011.9791666666682,25.9481837606838,0
979,4,1,2,45,0.02127659574468085,0.0425531914893617,0.9574468085106383,47,1850,1700,150,0.918918918918919,20,17,3,352.92637856259273,0.4629394079555967,0.31831966206472284,0.1907197582485556,128173.82979948954,-352.6792507930767,127821.15054869646,965,0,199.80851063829786,35,12,20,37.911594658437146,0.6038690476190476,46.846064814814795,1012.6157407407379,28.931878306878225,0
980,4,3,4,44,0.0625,0.08333333333333333,0.9166666666666666,48,1100,600,500,0.5454545454545454,16,6,10,334.15406129612774,0.4663028221040189,0.2929541198501875,0.18323044972493815,128755.86718990444,-995.1408125577246,127760.72637734671,966,0,193.33333333333334,37,11,17,37.79350331316625,0.6058558558558558,46.2719298245614,1014.9122807017533,27.430061640587926,0
981,4,3,2,45,0.06382978723404255,0.0425531914893617,0.9574468085106383,47,1350,900,450,0.6666666666666666,18,9,9,362.2949277631757,0.46698658649398705,0.30118309209156746,0.19244507653193604,127482.44224773243,-152.4479078334931,127329.99433989893,967,0,197.85106382978722,34,13,21,38.38289323745531,0.5989583333333333,47.529761904761905,1009.8809523809523,29.70238095238095,8
982,4,1,1,45,0.021739130434782608,0.021739130434782608,0.9782608695652174,46,1400,1100,300,0.7857142857142857,17,11,6,358.38729724104945,0.467079307568438,0.30414064058687273,0.1926586742094672,127963.79145408148,-27.88052721089565,127935.91092687058,968,0,199.8695652173913,34,12,22,37.98829274032242,0.6038602941176471,47.05357142857142,1011.7857142857131,29.758403361344502,0
983,4,2,0,47,0.0425531914893617,0.0,1.0,47,1550,1300,250,0.8387096774193549,18,13,5,350.8569757742025,0.4672178538390379,0.34047544768203686,0.19235085006270541,128747.91843820825,-365.4513888889312,128382.46704931931,969,0,196.48936170212767,34,13,18,37.37781036168133,0.6118259803921569,46.279761904761884,1014.8809523809493,29.849439775910273,0
984,4,0,4,43,0.0,0.0851063829787234,0.9148936170212766,47,1700,1000,700,0.5882352941176471,24,10,14,342.5734757074858,0.46611933395004623,0.31883459220606536,0.18486482094556575,128117.48940755345,-622.0692709474877,127495.42013660597,970,1,197.48936170212767,38,9,18,38.2312332911214,0.5975877192982456,46.9017094017094,1012.393162393162,26.641925326135844,8
985,4,0,2,41,0.0,0.046511627906976744,0.9534883720930233,43,1200,900,300,0.75,15,9,6,357.3625888061039,0.4635243632336656,0.3187822673771312,0.19174616324112445,127888.11404309704,540.4855023942728,128428.5995454913,971,2,203.09302325581396,36,7,18,38.091692644548345,0.5989583333333333,47.12837837837837,1011.4864864864857,28.096846846846823,0
986,4,3,1,43,0.06818181818181818,0.022727272727272728,0.9772727272727273,44,900,500,400,0.5555555555555556,13,5,8,342.8292052700978,0.4676048273431994,0.3052278135016624,0.18667837643859356,128477.80687326849,9.188885041532728,128486.99575831002,972,0,195.5909090909091,37,7,16,37.85691109669047,0.6030405405405406,46.54605263157894,1013.8157894736826,27.400426742531963,0
987,4,2,0,45,0.044444444444444446,0.0,1.0,45,1450,1100,350,0.7586206896551724,18,11,7,339.5360645597387,0.4666456228956229,0.3176767676767669,0.1867448355078563,128875.73964497044,-248.4077087442484,128627.3319362262,973,0,192.2,38,7,18,37.53485374579124,0.6052631578947368,46.15384615384615,1015.3846153846156,26.720647773279357,0
988,4,0,1,44,0.0,0.022222222222222223,0.9777777777777777,45,950,600,350,0.631578947368421,13,6,7,339.1734439053944,0.46639309764309766,0.3180393394341017,0.18692880760629463,128957.11343277435,-252.234344181474,128704.87908859288,974,1,193.2,38,7,18,37.46121279057537,0.6060855263157895,46.07371794871794,1015.7051282051272,26.72908232118756,0
989,4,1,3,42,0.022222222222222223,0.06666666666666667,0.9333333333333333,45,1500,1200,300,0.8,18,12,6,332.3954926221114,0.4664562289562289,0.29779454926624793,0.1847194843660921,129285.00987082535,-405.01795201325945,128879.99191881208,975,0,186.7111111111111,37,8,20,37.29997753818507,0.611204954954955,45.751096491228054,1016.9956140350854,27.486367946894198,0
990,4,1,0,43,0.023255813953488372,0.0,1.0,43,950,700,250,0.7368421052631579,12,7,5,336.4616885367878,0.4661314138058324,0.27416947198286934,0.18767085293940844,129430.46932067211,109.6788511484558,129540.14817182058,976,0,181.41860465116278,36,7,16,37.048795558506704,0.6145833333333333,45.60810810810811,1017.5675675675683,28.265765765765785,0
991,4,0,1,42,0.0,0.023255813953488372,0.9767441860465116,43,1350,1000,350,0.7407407407407407,17,10,7,343.9188968034889,0.46578534514581027,0.28210984398388916,0.19267129274455683,129602.41280131489,314.5437667397197,129916.95656805461,977,1,182.41860465116278,36,7,16,36.68436186684364,0.6163194444444444,45.43918918918919,1018.2432432432437,28.284534534534547,0
992,4,1,1,42,0.023255813953488372,0.023255813953488372,0.9767441860465116,43,1500,1100,400,0.7333333333333333,19,11,8,342.89380696955124,0.4649317091177556,0.2813732396176647,0.1926594644625195,129717.10519641277,295.83840597355777,130012.94360238632,978,0,183.34883720930233,36,7,17,36.593982607413956,0.6174768518518519,45.326576576576585,1018.6936936936949,28.29704704704708,0
993,4,0,2,40,0.0,0.047619047619047616,0.9523809523809523,42,850,200,650,0.23529411764705882,15,2,13,351.0646744215538,0.4642494192799071,0.28754079197311344,0.1968781434184356,129643.0272231869,702.6174286265611,130345.64465181346,979,1,188.57142857142858,35,7,18,36.4611745652915,0.61875,45.399305555555564,1018.4027777777792,29.097222222222264,0
994,4,0,0,40,0.0,0.0,1.0,40,1200,800,400,0.6666666666666666,16,8,8,361.9936721258043,0.4649572649572649,0.2757944150216658,0.20265791293943278,129575.4337274125,1381.0974144559705,130956.53114186847,980,2,196.375,33,7,18,36.25170518375861,0.6224747474747474,45.4656862745098,1018.1372549019605,30.8526440879382,0
995,4,0,0,40,0.0,0.0,1.0,40,1250,900,350,0.72,16,9,7,360.8641385799036,0.4645299145299145,0.2716230427670019,0.2029090208913808,129746.60572562364,1364.1794217687147,131110.78514739237,981,3,197.375,34,6,18,36.10632351795592,0.6219362745098039,45.29761904761905,1018.8095238095242,29.96498599439777,0
996,4,0,2,38,0.0,0.05,0.95,40,1000,700,300,0.7,13,7,6,355.7690224800499,0.46426282051282053,0.2607685120298997,0.20066497829210733,129867.92091836738,1240.5966553288029,131108.51757369618,982,4,198.375,34,6,18,36.11281437358872,0.6231617647058824,45.17857142857143,1019.2857142857146,29.978991596638664,0
997,4,0,1,37,0.0,0.02631578947368421,0.9736842105263158,38,1250,600,650,0.48,19,6,13,374.07603487444794,0.46190433854907537,0.2688021193574066,0.2098259594782543,129651.06398581775,2099.8711866136046,131750.93517243135,983,5,209.31578947368422,32,6,18,35.867117117117104,0.6256510416666667,45.39141414141414,1018.4343434343432,31.826073232323225,0
998,4,0,0,37,0.0,0.0,1.0,37,950,500,450,0.5263157894736842,14,5,9,379.2292448927699,0.46155530530530525,0.2640569222847704,0.21261304116891425,129631.97708129884,2432.0473564995664,132064.02443779842,984,6,215.1891891891892,31,6,18,35.75536482973192,0.6280241935483871,45.41015625,1018.3593750000001,32.85030241935484,0
999,4,0,0,37,0.0,0.0,1.0,37,1350,800,550,0.5925925925925926,19,8,11,377.3662908092566,0.4612112112112112,0.2666371968697552,0.21246536632181612,129797.77865939685,2396.261257595506,132194.03991699236,985,7,216.1891891891892,31,6,19,35.63389130249595,0.6297043010752688,45.24739583333334,1019.0104166666679,32.8713037634409,0
1000,4,0,0,37,0.0,0.0,1.0,37,1150,900,250,0.782608695652174,14,9,5,376.32191777882963,0.4608671171171171,0.26478132238765784,0.21241703635836054,129897.31046888579,2376.6409979926407,132273.95146687844,986,8,217.1891891891892,31,6,19,35.55916570868993,0.6307123655913979,45.14973958333334,1019.4010416666679,32.883904569892515,0
1001,4,0,0,37,0.0,0.0,1.0,37,850,600,250,0.7058823529411765,11,6,5,376.4500910417905,0.45989739739739743,0.26437007670251633,0.21321283898267165,130030.07888793967,2389.9670071072333,132420.0458950469,987,9,218.1891891891892,31,6,19,35.420789182518405,0.6320564516129032,45.019531250000014,1019.9218750000017,32.900705645161345,0
1002,4,0,0,37,0.0,0.0,1.0,37,900,800,100,0.8888888888888888,10,8,2,375.2818277744272,0.45989739739739743,0.2619569154348991,0.2129133324122115,130096.48852878167,2364.5696004232104,132461.05812920487,988,10,219.1891891891892,31,6,20,35.38303020633909,0.632728494623656,44.95442708333335,1020.1822916666683,32.90910618279575,0
1003,4,0,0,37,0.0,0.0,1.0,37,1100,700,400,0.6363636363636364,15,7,8,375.0104123281963,0.4596471471471471,0.25901820187534463,0.21366872330327497,130262.58680555574,2369.9652777778006,132632.55208333355,989,11,220.1891891891892,31,6,21,35.221088435374156,0.6344086021505376,44.79166666666668,1020.8333333333348,32.93010752688177,0
1004,4,0,0,37,0.0,0.0,1.0,37,1500,1100,400,0.7333333333333333,19,11,8,376.46790244869413,0.45880255255255253,0.2602725096032936,0.21541872317359642,130428.79104614268,2420.450676812079,132849.24172295476,990,12,221.1891891891892,31,6,22,35.01500424899086,0.6360887096774194,44.62890625000001,1021.4843750000008,32.951108870967765,0
1005,4,0,0,37,0.0,0.0,1.0,37,900,600,300,0.6666666666666666,12,6,6,375.26293980953363,0.45861486486486486,0.2559817018139732,0.21491335954347476,130462.04460991772,2391.5140787760643,132853.5586886938,991,13,222.1891891891892,31,6,22,35.01200186931769,0.6364247311827957,44.59635416666668,1021.6145833333348,32.955309139784994,0
1006,4,0,0,37,0.0,0.0,1.0,37,850,600,250,0.7058823529411765,11,6,5,378.42213780047143,0.45805180180180183,0.25639602641656034,0.20706919225711182,128672.4175347222,2338.498263888884,131010.9157986111,992,14,223.1891891891892,31,6,20,36.75564681724847,0.6182795698924731,46.354166666666664,1014.5833333333331,32.728494623655905,8
1007,4,0,0,37,0.0,0.0,1.0,37,1200,900,300,0.75,15,9,6,376.11764914023206,0.4574261761761762,0.2483227294003434,0.2063221023960667,128771.51701185433,2286.648050944006,131058.16506279833,993,15,224.1891891891892,31,6,22,36.71276993799444,0.6192876344086021,46.256510416666664,1014.9739583333329,32.741095430107514,0
1008,4,0,0,37,0.0,0.0,1.0,37,1350,1100,250,0.8148148148148148,16,11,5,374.39249750743335,0.45748873873873874,0.2431392664785843,0.20588947077312866,128870.65463595919,2249.641248914926,131120.29588487413,994,16,225.1891891891892,31,6,22,36.65523211079763,0.6202956989247312,46.158854166666664,1015.3645833333331,32.753696236559136,0
1009,4,1,1,37,0.02631578947368421,0.02631578947368421,0.9736842105263158,38,1200,1000,200,0.8333333333333334,14,10,4,365.09691035619926,0.45830369843527735,0.23771134653970072,0.20262752716047355,129233.48263251196,1836.5490447403288,131070.0316772523,995,0,220.23684210526315,32,6,23,36.52106875284572,0.6214192708333333,45.801767676767675,1016.7929292929291,31.774779040404034,0
1010,4,1,0,38,0.02631578947368421,0.0,1.0,38,950,500,450,0.5263157894736842,14,5,9,363.5845885547627,0.4583333333333333,0.2511308968191279,0.2034408422981993,129554.63927469132,1820.8140432098685,131375.45331790118,996,0,220.39473684210526,32,6,19,36.23237835379716,0.6246744791666667,45.48611111111111,1018.0555555555553,31.814236111111104,0
1011,4,2,0,40,0.05,0.0,1.0,40,1450,1100,350,0.7586206896551724,18,11,7,360.7498631995145,0.45869391025641026,0.23169406928948977,0.19628019713379313,128446.0476899091,1361.9004314688625,129807.94812137797,997,0,210.325,34,6,19,37.435163437071836,0.6087622549019608,46.57738095238094,1013.6904761904746,29.814425770308077,8
1012,4,1,0,41,0.024390243902439025,0.0,1.0,41,1750,1300,450,0.7428571428571429,22,13,9,353.7133334488075,0.45835873983739833,0.23140974311251594,0.19445606185210024,128858.14868922955,915.7690629818773,129773.91775221143,998,0,206.17073170731706,36,5,20,37.192907054126,0.6087962962962963,46.17117117117116,1015.3153153153135,28.203203203203152,0
1013,4,0,0,41,0.0,0.0,1.0,41,1700,1200,500,0.7058823529411765,22,12,10,356.58370698174144,0.4584349593495935,0.23275894696433097,0.19688483502994314,129029.71172185692,1001.9785833130347,130031.69030516995,999,1,207.17073170731706,36,5,20,36.94510640656174,0.6105324074074074,46.00225225225225,1015.9909909909904,28.221971971971957,0
1014,4,0,2,39,0.0,0.04878048780487805,0.9512195121951219,41,1200,900,300,0.75,15,9,6,357.51382764924745,0.45838414634146346,0.23279922119609564,0.19797808735415287,129145.65659626015,1034.271602800834,130179.92819906097,1000,2,208.17073170731706,37,4,20,36.80330816253145,0.6097972972972974,45.88815789473683,1016.4473684210507,27.471550497866236,0
1015,4,2,0,41,0.04878048780487805,0.0,1.0,41,850,500,350,0.5882352941176471,12,5,7,342.67508295898045,0.45729166666666665,0.2178443735393385,0.18803457278905017,128783.6897530969,631.0014860341382,129414.69123913103,1001,0,208.90243902439025,37,4,18,37.54894944366424,0.6061373873873874,46.24451754385964,1015.0219298245597,27.433025130393506,8
1016,4,1,0,42,0.023809523809523808,0.0,1.0,42,1000,700,300,0.7,13,7,6,335.5795492859272,0.4578252032520325,0.21821935290143402,0.1859661858739427,129174.23575726856,269.64636295565276,129443.88212022421,1002,0,204.9047619047619,38,4,20,37.331625503590814,0.6082785087719298,45.86004273504273,1016.5598290598286,26.751574448942858,0
1017,4,0,2,40,0.0,0.047619047619047616,0.9523809523809523,42,1250,900,350,0.72,16,9,7,332.5793987673341,0.4577526132404181,0.21874390188985116,0.18455732583491063,129228.54487407762,195.75035155963332,129424.29522563725,1003,1,205.9047619047619,38,4,20,37.35267591327798,0.6088267543859649,45.806623931623925,1016.7735042735035,26.757197480881672,0
1018,4,1,0,41,0.024390243902439025,0.0,1.0,41,850,500,350,0.5882352941176471,12,5,7,342.09645056138976,0.4559959349593496,0.2465782950749007,0.19064942731286072,129396.54659366321,653.2198609187205,130049.76645458193,1004,0,210.73170731707316,37,4,21,36.9399315659015,0.6123310810810811,45.64144736842104,1017.434210526314,27.498221906116594,0
1019,4,0,1,40,0.0,0.024390243902439025,0.975609756097561,41,1450,1200,250,0.8275862068965517,17,12,5,344.941131582442,0.4557418699186992,0.2503158099310079,0.19332940790622433,129619.76431450054,742.2376356186448,130362.00195011919,1005,1,211.73170731707316,37,4,16,36.64071192706652,0.6145833333333333,45.422149122807014,1018.3114035087714,27.52192982456139,0
1020,4,0,1,39,0.0,0.025,0.975,40,1250,700,550,0.56,18,7,11,349.15377570351404,0.45655715811965814,0.23900817995910018,0.196248501516113,129731.44531249988,1059.2447916666522,130790.69010416654,1006,2,210.2,37,3,16,36.4199897750511,0.6157094594594594,45.31249999999999,1018.7499999999991,27.533783783783758,0
1021,4,0,0,39,0.0,0.0,1.0,39,1300,1100,200,0.8461538461538461,15,11,4,350.771474247384,0.45408794421952314,0.2264806191010349,0.1979540763645459,129889.2389010631,1312.2879636393013,131201.5268647024,1007,3,212.07692307692307,36,3,16,36.218515245249655,0.619212962962963,45.15765765765765,1019.3693693693683,28.315815815815785,0
1022,4,0,0,39,0.0,0.0,1.0,39,1050,700,350,0.6666666666666666,14,7,7,340.91349480968876,0.4538911381016644,0.19019607843137232,0.18340282948622458,127993.90589569129,976.2538246671529,128970.15972035844,1008,4,213.07692307692307,34,5,18,38.39950980392156,0.6041666666666667,47.023809523809504,1011.9047619047594,29.761904761904688,8
1023,4,1,0,40,0.025,0.0,1.0,40,1150,900,250,0.782608695652174,14,9,5,328.9313899076474,0.4539663461538461,0.1839444825222758,0.17840553824358973,128320.3727816355,441.7197145061367,128762.09249614163,1009,0,208.725,35,5,20,38.36960246744346,0.6053571428571429,46.70138888888887,1013.1944444444418,28.948412698412625,0
1024,4,1,0,41,0.024390243902439025,0.0,1.0,41,1300,900,400,0.6923076923076923,17,9,8,318.5699138831317,0.4549542682926829,0.1747588581078885,0.17463212067608141,128743.8367421474,2.7825967859584466,128746.61933893335,1010,0,204.609756097561,36,5,18,38.20114846870839,0.6076388888888888,46.283783783783775,1014.8648648648636,28.19069069069066,0
1025,4,0,1,40,0.0,0.024390243902439025,0.975609756097561,41,1150,800,350,0.6956521739130435,15,8,7,318.6834270377267,0.4544715447154472,0.16994719414807347,0.17519815720561813,128858.14868922952,12.991285204099256,128871.13997443362,1011,1,205.609756097561,36,5,18,38.082067065956856,0.6087962962962963,46.17117117117116,1015.3153153153132,28.203203203203145,0
1026,4,1,1,40,0.024390243902439025,0.024390243902439025,0.975609756097561,41,1100,600,500,0.5454545454545454,16,6,10,345.5642054159093,0.45457317073170733,0.2190758949474314,0.17838584657956377,126319.25207756217,653.32245322265,126972.57453078481,1012,0,205.78048780487805,37,4,20,39.999636416521234,0.5810810810810811,48.68421052631578,1005.2631578947355,27.169274537695554,8
1027,4,1,0,41,0.024390243902439025,0.0,1.0,41,900,500,400,0.5555555555555556,13,5,8,344.7145369500226,0.45635162601626017,0.22485603534910426,0.1786672972869778,126484.64551592793,520.2192020621663,127004.8647179901,1013,0,206.4878048780488,37,4,21,39.8508465954509,0.5827702702702703,48.51973684210526,1005.9210526315785,27.18705547652915,0
1028,4,0,2,39,0.0,0.04878048780487805,0.9512195121951219,41,1000,400,600,0.4,16,4,12,343.1366245300893,0.45627540650406506,0.22309751047821047,0.1782096662882076,126567.3828125,485.98090277777754,127053.36371527778,1014,1,207.4878048780488,37,4,21,39.80546928916494,0.5836148648648649,48.4375,1006.25,27.195945945945947,0
1029,4,2,0,41,0.04878048780487805,0.0,1.0,41,1550,1200,350,0.7741935483870968,19,12,7,335.0194953354464,0.45835873983739833,0.20567424825499603,0.17553187925500294,126926.22369382886,304.55188134810464,127230.77557517696,1015,0,204.2439024390244,37,4,23,39.641367428364156,0.5872747747747749,48.08114035087719,1007.6754385964912,27.23447131341868,0
1030,4,1,0,42,0.023809523809523808,0.0,1.0,42,1350,1000,350,0.7407407407407407,17,10,7,329.69089138777,0.45963995354239257,0.21628139032097127,0.17471953071918334,127388.4383104135,-0.23844418876024065,127388.19986622475,1016,0,200.35714285714286,38,4,16,39.30221892969274,0.5901864035087719,47.62286324786325,1009.5085470085473,26.566014394961773,0
1031,4,1,1,42,0.023255813953488372,0.023255813953488372,0.9767441860465116,43,1350,900,450,0.6666666666666666,18,9,9,337.23501289627825,0.45969453672942046,0.1821588641217886,0.17828689973826295,127290.80590303171,23.812321837303415,127314.61822486902,1017,0,196.67441860465115,36,7,21,39.21181601755758,0.5928819444444444,47.71959459459461,1009.1216216216241,28.031156156156225,8
1032,4,1,1,42,0.023255813953488372,0.023255813953488372,0.9767441860465116,43,1100,700,400,0.6363636363636364,15,7,8,331.6936940979585,0.45930232558139533,0.1901766149309796,0.17641814723039254,127534.65008464166,-139.51215758692328,127395.13792705473,1018,0,197.48837209302326,37,6,18,39.10207700101318,0.5934684684684685,47.47807017543861,1010.0877192982475,27.299668089141825,0
1033,4,4,2,44,0.08695652173913043,0.043478260869565216,0.9565217391304348,46,1050,700,350,0.6666666666666666,14,7,7,348.86729786088677,0.461664653784219,0.21528047889648905,0.17984913679375059,126264.1449773005,-304.197926285033,125959.94705101546,1019,0,185.32608695652175,37,9,19,39.97336169903266,0.5805180180180181,48.73903508771929,1005.0438596491211,27.163347558084354,7
1034,4,1,2,43,0.022222222222222223,0.044444444444444446,0.9555555555555556,45,1600,1200,400,0.75,20,12,8,352.93255822968666,0.4610690235690236,0.24482224159643518,0.18317359470110894,126539.80070791022,-67.99688365649769,126471.80382425373,1020,0,190.3111111111111,37,8,18,39.5874200813717,0.5833333333333333,48.46491228070176,1006.1403508771938,27.192982456140374,0
1035,4,0,0,43,0.0,0.0,1.0,43,1100,800,300,0.7272727272727273,14,8,6,361.136669474524,0.45921004060538945,0.2579896316961956,0.1876230975828113,126581.54776398055,542.6477152828922,127124.19547926344,1021,1,199.5581395348837,36,7,19,39.338070725156655,0.5856481481481481,48.42342342342344,1006.3063063063092,27.952952952953034,0
1036,4,1,2,42,0.022727272727272728,0.045454545454545456,0.9545454545454546,44,1150,700,450,0.6086956521739131,16,7,9,359.9480909773921,0.4598639006342495,0.2712246431254697,0.18936399568810655,127092.01388888907,349.3055555555808,127441.31944444464,1022,0,196.0,37,7,20,38.84297520661157,0.5889639639639639,47.91666666666668,1008.3333333333348,27.252252252252294,0
1037,4,3,1,44,0.06666666666666667,0.022222222222222223,0.9777777777777777,45,950,600,350,0.631578947368421,13,6,7,346.243037586071,0.46380471380471383,0.22774098601913217,0.18028516784654025,126672.22222222213,-206.42361111112058,126465.79861111101,1023,0,188.75555555555556,39,6,15,39.61955022075057,0.5811965811965811,48.33333333333333,1006.6666666666658,25.81196581196579,8
1038,4,2,0,46,0.043478260869565216,0.0,1.0,46,1350,700,650,0.5185185185185185,20,7,13,340.10705161017756,0.46418075684380034,0.22873952281225907,0.17904777067308528,127119.65610812927,-551.058378539567,126568.5977295897,1024,0,185.47826086956522,37,9,19,39.31479014896162,0.5892454954954955,47.889254385964904,1008.4429824561391,27.255215742057814,0
1039,4,0,2,44,0.0,0.043478260869565216,0.9565217391304348,46,1350,1000,350,0.7407407407407407,17,10,7,342.05982465399137,0.4641002415458937,0.23328858996960933,0.18032139409696643,127174.94956380797,-499.7118103647407,126675.23775344323,1025,1,186.47826086956522,37,9,20,39.20885875276298,0.5898085585585586,47.8344298245614,1008.6622807017534,27.26114272166901,0
1040,4,3,2,45,0.06382978723404255,0.0425531914893617,0.9574468085106383,47,1350,1100,250,0.8148148148148148,16,11,5,321.5637929790262,0.4662542399013259,0.22037507616250984,0.17279709534194615,127948.38543544558,-1171.2863747671431,126777.09906067845,1026,0,165.5744680851064,42,5,15,38.93544679628388,0.5895337301587302,47.0687984496124,1011.7248062015505,24.088685861941677,0
1041,4,2,0,47,0.0425531914893617,0.0,1.0,47,950,700,250,0.7368421052631579,12,7,5,321.466908996379,0.4655411655874191,0.22471015415976625,0.1731773348464361,128048.66850321363,-1167.318067034007,126881.35043617962,1027,0,166.4468085106383,43,4,17,38.83561002994012,0.5891472868217054,46.969696969696955,1012.1212121212094,23.537702607469985,0
1042,4,2,2,47,0.04081632653061224,0.04081632653061224,0.9591836734693877,49,1500,1200,300,0.8,18,12,6,310.091516867253,0.46566751700680276,0.22010303269519005,0.16918552470302436,128556.44710696333,-1826.9679123860028,126729.47919457733,1028,0,160.6122448979592,40,9,10,38.606699068042886,0.5986979166666666,46.46849593495934,1014.1260162601617,25.353150406504042,0
1043,4,0,0,47,0.0,0.0,1.0,47,1200,700,500,0.5833333333333334,17,7,10,322.1703077289102,0.4646160962072155,0.20557278711884974,0.17520865045191653,128427.65239771294,-1124.8847412254654,127302.76765648747,1029,2,168.4468085106383,40,7,10,38.43158879754028,0.5973958333333333,46.59552845528455,1013.6178861788613,25.340447154471534,0
1044,4,1,2,46,0.020833333333333332,0.041666666666666664,0.9583333333333334,48,1350,900,450,0.6666666666666666,18,9,9,319.0971387648483,0.4638279403073286,0.21624841168996256,0.17505001751759547,128773.09032698693,-1381.7750653502471,127391.31526163669,1030,0,165.91666666666666,41,7,11,38.15802870361319,0.599339430894309,46.2549603174603,1014.980158730156,24.75561362756478,0
1045,4,0,1,45,0.0,0.021739130434782608,0.9782608695652174,46,1300,900,400,0.6923076923076923,17,9,8,332.1947566959175,0.46207729468599035,0.22058876067307298,0.18129193672597835,128566.75347222229,-658.1597222222172,127908.59375000007,1031,1,174.0,39,7,12,38.03581210627224,0.6004273504273504,46.458333333333336,1014.1666666666672,26.004273504273517,0
1046,4,1,0,46,0.021739130434782608,0.0,1.0,46,1500,1200,300,0.8,18,12,6,337.29775811822867,0.45971215780998387,0.22591399540186918,0.1850344966920962,128773.0903269871,-513.0250653502311,128260.06526163688,1032,0,174.8695652173913,41,5,13,37.69619701560616,0.599339430894309,46.25496031746031,1014.9801587301573,24.755613627564813,0
1047,4,2,1,47,0.041666666666666664,0.020833333333333332,0.9791666666666666,48,1450,800,650,0.5517241379310345,21,8,13,334.5024720946095,0.46025413711583923,0.24889093639093618,0.18649658375685774,129413.28125000015,-939.3431909800811,128473.93805902006,1033,0,168.54166666666666,39,9,15,37.11609336609336,0.608974358974359,45.62500000000001,1017.5000000000011,26.08974358974362,0
1048,4,1,1,47,0.020833333333333332,0.020833333333333332,0.9791666666666666,48,1550,700,850,0.45161290322580644,24,7,17,335.13129846826956,0.45882276891252954,0.2607288363847129,0.18798500889984343,129651.86767578124,-909.9202473958344,128741.9474283854,1034,0,169.3125,39,9,14,36.85786795540555,0.6113782051282051,45.390625,1018.4374999999999,26.113782051282048,0
1049,4,1,0,48,0.020833333333333332,0.0,1.0,48,1250,1000,250,0.8,15,10,5,340.84737443012193,0.4576130319148936,0.27582072643020217,0.1919694797956179,129811.04736328124,-750.8490668402799,129060.19829644095,1035,0,170.27083333333334,39,9,15,36.55075556237011,0.6129807692307692,45.234375,1019.0624999999999,26.12980769230769,0
1050,4,0,2,46,0.0,0.041666666666666664,0.9583333333333334,48,1300,800,500,0.6153846153846154,18,8,10,340.84737443012193,0.4574837470449173,0.27582072643020217,0.1919694797956179,129811.04736328124,-750.8490668402799,129060.19829644095,1036,1,171.27083333333334,39,9,15,36.55075556237011,0.6129807692307692,45.234375,1019.0624999999999,26.12980769230769,0
1051,4,0,0,46,0.0,0.0,1.0,46,1350,900,450,0.6666666666666666,18,9,9,351.91964593920704,0.45680354267310785,0.2748622728145027,0.1975215462918002,129675.59880203517,-72.9218365266268,129602.67696550854,1037,2,178.8913043478261,37,9,16,36.40630046291314,0.6151463963963963,45.36732456140351,1018.5307017543854,27.52785680417258,0
1052,4,0,1,45,0.0,0.021739130434782608,0.9782608695652174,46,1250,800,450,0.64,17,8,9,350.91070836470163,0.4568438003220612,0.271259406464081,0.19771631701659131,129826.69850107757,-88.48425286725973,129738.21424821031,1038,3,179.8913043478261,38,8,16,36.27847957507776,0.6148574561403508,45.2190170940171,1019.1239316239321,26.819050832208738,0
1053,4,0,0,45,0.0,0.0,1.0,45,1350,1000,350,0.7407407407407407,17,10,7,336.6194867327032,0.4561237373737374,0.21595824011931408,0.19067685636908654,130034.82187145685,-195.07222661555915,129839.74964484129,1039,4,184.37777777777777,41,4,16,36.43158496255228,0.6120426829268293,45.01488095238095,1019.9404761904757,24.876596980255506,8
1054,4,0,0,45,0.0,0.0,1.0,45,1500,1300,200,0.8666666666666667,17,13,4,333.03004119008665,0.4551346801346801,0.2063763608087097,0.1895029349426775,130211.95515243118,-327.1014424288368,129884.85371000235,1040,5,185.37777777777777,41,4,17,36.343717599792654,0.6138211382113821,44.841269841269835,1020.6349206349192,24.893534649632176,0
1055,4,0,1,44,0.0,0.022222222222222223,0.9777777777777777,45,1200,900,300,0.75,15,9,6,330.3623490212415,0.4550925925925926,0.20426303854875316,0.18822971048884676,130262.58680555547,-393.2193247669493,129869.36748078853,1041,6,186.37777777777777,40,5,17,36.36054421768708,0.6158854166666667,44.791666666666664,1020.8333333333327,25.520833333333318,0
1056,4,1,0,45,0.022222222222222223,0.0,1.0,45,900,400,500,0.4444444444444444,14,4,10,327.8345586037895,0.454040404040404,0.19774669774669795,0.18752136752136736,130414.54081632635,-449.1213151927669,129965.41950113358,1042,0,186.86666666666667,41,4,18,36.2713675213675,0.6158536585365854,44.64285714285713,1021.42857142857,24.912891986062682,0
1057,4,0,0,45,0.0,0.0,1.0,45,1150,800,350,0.6956521739130435,15,8,7,328.9451729709834,0.45315656565656565,0.20407080218748974,0.18877238032167679,130541.2368216962,-411.81805476821313,130129.41876692799,1043,1,187.86666666666667,41,4,14,36.11492007248486,0.6171239837398375,44.5188492063492,1021.9246031746027,24.924990321331773,0
1058,4,0,1,44,0.0,0.022222222222222223,0.9777777777777777,45,1600,1300,300,0.8125,19,13,6,327.8823009329133,0.45265151515151514,0.20879014262152018,0.18890345867610586,130693.35322381252,-429.5925256676859,130263.76069814483,1044,2,188.86666666666667,41,4,14,35.98838572491189,0.6186483739837398,44.37003968253968,1022.51984126984,24.939508323654632,0
1059,4,0,3,41,0.0,0.06818181818181818,0.9318181818181819,44,1300,900,400,0.6923076923076923,17,9,8,331.0691594016221,0.4522881430584919,0.2047126499109797,0.19040735702806844,130625.94112507439,-150.7558951351681,130475.18522993922,1045,10,194.11363636363637,40,4,15,35.97503893693874,0.61953125,44.4359756097561,1022.2560975609758,25.556402439024396,0
1060,4,0,0,41,0.0,0.0,1.0,41,1400,1000,400,0.7142857142857143,18,10,8,342.5033665778018,0.45142276422764227,0.21364283055333155,0.19666189703981102,130562.68376981525,743.6317481189333,131306.31551793418,1046,11,206.3658536585366,38,3,15,35.746829047320375,0.6222587719298245,44.49786324786325,1022.0085470085476,26.89496176338283,0
1061,4,1,0,42,0.023809523809523808,0.0,1.0,42,1550,1300,250,0.8387096774193549,18,13,5,335.5871149826517,0.45184862562911343,0.21153249573444954,0.19438725339561183,130901.38888888917,385.76388888891233,131287.15277777807,1047,0,202.42857142857142,39,3,17,35.58122964169381,0.6239316239316239,44.16666666666668,1023.3333333333355,26.239316239316295,0
1062,4,0,1,41,0.0,0.023809523809523808,0.9761904761904762,42,1600,1100,500,0.6875,21,11,10,319.21376017783894,0.45108643050716224,0.1704233157538504,0.1760293449733979,128979.82698042522,-165.57288849825235,128814.25409192697,1048,1,203.42857142857142,42,0,18,37.94496645362334,0.5999503968253967,46.051356589147304,1015.7945736434137,24.185585086747945,8
1063,4,0,0,41,0.0,0.0,1.0,41,1100,600,500,0.5454545454545454,16,6,10,330.6343078613281,0.4509400406504065,0.16926448170731745,0.1824189284752155,128999.74804736709,330.3484819853877,129330.09652935248,1049,2,208.2439024390244,41,0,19,37.634684244791664,0.6016260162601625,46.03174603174603,1015.8730158730158,24.777390631049165,0
1064,4,0,0,41,0.0,0.0,1.0,41,700,400,300,0.5714285714285714,10,4,6,330.8289832728059,0.4501270325203252,0.1671984076342128,0.18299201428977444,129100.54878432857,342.0406588561382,129442.5894431847,1050,3,209.2439024390244,41,0,21,37.52725172458675,0.6026422764227642,45.932539682539684,1016.2698412698414,24.787069299264424,0
1065,4,1,1,41,0.023809523809523808,0.023809523809523808,0.9761904761904762,42,1250,900,350,0.72,16,9,7,327.3885057325409,0.45112272551296945,0.18010075566750694,0.18306089686735025,129527.44904667974,81.31706934362407,129608.76611602337,1051,0,205.23809523809524,38,4,16,37.18120277078089,0.611842105263158,45.51282051282051,1017.9487179487173,26.788124156545194,0
1066,4,0,0,41,0.0,0.0,1.0,41,1000,600,400,0.6,14,6,8,326.61213706191705,0.4504065040650407,0.161740171744982,0.18313334649848184,129636.2270801373,268.15303345751465,129904.38011359482,1052,1,185.6341463414634,38,3,17,37.09063330535738,0.6129385964912281,45.4059829059829,1018.376068376068,26.799370220422844,0
1067,4,0,0,41,0.0,0.0,1.0,41,1300,500,800,0.38461538461538464,21,5,16,329.3444200119141,0.44982215447154467,0.16141834353748274,0.18561669385924914,129837.58680555546,352.25694444443525,130189.8437499999,1053,2,186.6341463414634,39,2,17,36.81691196511311,0.6132478632478633,45.20833333333333,1019.1666666666658,26.132478632478612,0
1068,4,0,2,39,0.0,0.04878048780487805,0.9512195121951219,41,1300,800,500,0.6153846153846154,18,8,10,325.01739804536766,0.449364837398374,0.16278432447245872,0.18392603045457495,129996.8804253471,250.24956597221208,130247.12999131932,1054,3,187.6341463414634,39,2,17,36.76583248212463,0.6148504273504274,45.05208333333333,1019.7916666666656,26.148504273504248,0
1069,4,1,1,39,0.025,0.025,0.975,40,1200,900,300,0.75,15,9,6,325.00451540502377,0.448704594017094,0.14739087197738954,0.18491769718071394,130208.06081753573,463.6415415661965,130671.70235910192,1055,0,189.175,38,2,19,36.55243553508497,0.6186951754385965,44.84508547008546,1020.6196581196562,26.858412055780423,0
1070,4,0,0,39,0.0,0.0,1.0,39,1200,900,300,0.75,15,9,6,331.18420152218096,0.4477620332883491,0.14519902451122246,0.1880212931765642,130122.70752779674,818.9169984995084,130941.62452629625,1056,1,194.82051282051282,37,2,19,36.481170517642845,0.6196509009009009,44.928728070175424,1020.285087719296,27.575272641062053,0
1071,4,0,1,38,0.0,0.02564102564102564,0.9743589743589743,39,1050,800,250,0.7619047619047619,13,8,5,334.4104821140603,0.4477620332883491,0.15287108422783602,0.19039921577980323,130234.60493853858,910.3634050861585,131144.96834362476,1057,2,195.82051282051282,37,2,20,36.28556146381637,0.620777027027027,44.81907894736841,1020.7236842105248,27.587126600284453,0
1072,4,0,0,38,0.0,0.0,1.0,38,950,900,50,0.9473684210526315,10,9,1,337.5729976641622,0.4473684210526316,0.15610087429029207,0.19248030168699962,130291.32806793276,1196.5668371073677,131487.89490504013,1058,3,199.76315789473685,36,2,20,36.14741892786233,0.6232638888888888,44.76351351351351,1020.9459459459456,28.3596096096096,0
1073,4,1,1,38,0.02564102564102564,0.02564102564102564,0.9743589743589743,39,1250,900,350,0.72,16,9,7,332.20680088263396,0.44823999100314893,0.15499003230906672,0.1913420888345004,130682.67549871118,882.7347116420417,131565.4102103532,1059,0,195.6153846153846,37,2,14,35.888628239499546,0.6252815315315315,44.38048245614035,1022.4780701754389,27.634542437174026,0
1074,4,1,2,37,0.02564102564102564,0.05128205128205128,0.9487179487179487,39,1050,700,350,0.6666666666666666,14,7,7,322.66282740926465,0.4468904633378317,0.13896456266063484,0.1849060409470804,130486.54994806091,622.2218615343157,131108.77180959523,1060,0,196.5897435897436,37,2,21,36.33066824068112,0.6233108108108107,44.57236842105263,1021.7105263157893,27.613798008534843,7
1075,4,2,1,38,0.05128205128205128,0.02564102564102564,0.9743589743589743,39,800,700,100,0.875,9,7,2,322.1963746813569,0.4487460638776428,0.1549124687388348,0.18625106417453918,130822.85534972312,630.1299438288784,131452.985293552,1061,0,194.76923076923077,37,2,18,36.00303679885672,0.6266891891891893,44.24342105263158,1023.0263157894747,27.649359886202017,0
1076,4,0,1,37,0.0,0.02631578947368421,0.9736842105263158,38,1150,700,450,0.6086956521739131,16,7,9,327.21629777248046,0.44627192982456143,0.15340448214327074,0.18908605909447918,130809.2129291454,960.5812738414118,131769.7942029868,1062,1,200.89473684210526,36,2,20,35.88842103331864,0.6284722222222222,44.25675675675676,1022.9729729729734,28.415915915915928,0
1077,4,0,0,37,0.0,0.0,1.0,37,800,500,300,0.625,11,5,6,328.89036477371025,0.44544544544544545,0.14726840855106915,0.19042041355365877,130883.62328800143,1209.2725212191233,132092.89580922056,1063,2,205.56756756756758,35,2,21,35.770486935866984,0.63125,44.18402777777777,1023.263888888888,29.236111111111086,0
1078,4,0,0,37,0.0,0.0,1.0,37,650,300,350,0.46153846153846156,10,3,7,331.76877518689633,0.4450075075075075,0.15150172223563652,0.19238237894935886,130942.84664619763,1288.549570258911,132231.39621645655,1064,3,206.56756756756758,35,2,21,35.637062271476495,0.6318452380952381,44.126157407407405,1023.4953703703698,29.24272486772485,0
1079,4,0,0,37,0.0,0.0,1.0,37,850,500,350,0.5882352941176471,12,5,7,331.5387997369925,0.4448511011011011,0.1531185266206747,0.1926933129088985,131031.70680084023,1288.4189600480167,132320.12576088824,1065,4,207.56756756756758,35,2,22,35.5532632451579,0.6327380952380952,44.039351851851855,1023.8425925925928,29.25264550264551,0
1080,4,0,0,37,0.0,0.0,1.0,37,1050,700,350,0.6666666666666666,14,7,7,332.98765180886835,0.44350600600600604,0.15857199117111032,0.1945834773243505,131239.1643759644,1340.2042341820877,132579.36861014648,1066,5,208.56756756756758,35,2,22,35.30688749576413,0.6348214285714286,43.83680555555555,1024.652777777777,29.275793650793627,0
1081,4,0,0,37,0.0,0.0,1.0,37,1400,1100,300,0.7857142857142857,17,11,6,333.83466366938063,0.4422234734734735,0.16735896356749458,0.19644374431859557,131506.1366705246,1380.261381172832,132886.39805169744,1067,6,209.56756756756758,35,2,22,35.01607989167231,0.6375,43.576388888888886,1025.694444444444,29.30555555555554,0
1082,4,0,0,37,0.0,0.0,1.0,37,1450,1100,350,0.7586206896551724,18,11,7,346.3082420066254,0.4420045045045045,0.12834755307215517,0.1864752648839748,128030.5363429307,1467.6059928171321,129498.14233574783,1068,7,210.56756756756758,36,1,17,38.22558510441007,0.6004050925925926,46.98761261261261,1012.049549549549,28.112487487487474,8
1083,4,1,2,36,0.02631578947368421,0.05263157894736842,0.9473684210526316,38,1450,1200,250,0.8275862068965517,17,12,5,338.83807658556174,0.4442715742057847,0.13028066758912904,0.18411994955204825,128394.44739006205,1100.9855195829232,129495.43290964498,1069,0,206.0,37,1,16,38.043091168091166,0.6021959459459459,46.6282894736842,1013.4868421052608,27.391536273115157,0
1084,4,0,0,36,0.0,0.0,1.0,36,1050,800,250,0.7619047619047619,13,8,5,346.46473822845763,0.44049272486772484,0.13774616234335157,0.18750234534553042,128232.43694540868,1685.6035397376222,129918.04048514631,1070,9,217.94444444444446,35,1,17,38.01529825162837,0.6044642857142857,46.78819444444443,1012.84722222222,28.938492063492,0
1085,4,0,0,36,0.0,0.0,1.0,36,950,800,150,0.8421052631578947,11,8,3,343.47560766502824,0.44079034391534394,0.13363414819891872,0.18629401917593894,128320.37278163564,1614.9836033950414,129935.35638503068,1071,10,218.94444444444446,35,1,17,38.00119945167922,0.6053571428571429,46.70138888888888,1013.1944444444432,28.948412698412664,0
1086,4,2,1,37,0.05263157894736842,0.02631578947368421,0.9736842105263158,38,1500,1100,400,0.7333333333333333,19,11,8,332.6845820668604,0.44707207207207206,0.13460042141611717,0.18383947656610589,129062.08070031162,987.3928756925161,130049.47357600414,1072,0,208.3684210526316,37,1,18,37.519221430883775,0.6089527027027026,45.9703947368421,1016.1184210526314,27.4626600284495,0
1087,4,1,0,38,0.02631578947368421,0.0,1.0,38,1000,400,600,0.4,16,4,12,326.89042063020224,0.44773885727833096,0.12748411978221452,0.18230427304376673,129424.43828870426,861.5218144044395,130285.9601031087,1073,0,205.1315789473684,37,1,19,37.298401580459775,0.6126126126126126,45.6140350877193,1017.5438596491231,27.501185395922246,0
1088,4,0,0,38,0.0,0.0,1.0,38,950,800,150,0.8421052631578947,11,8,3,331.3785805602744,0.44732396870554764,0.12964012789405688,0.18533245433262588,129536.03512619277,985.0934903047258,130521.1286164975,1074,1,206.1315789473684,37,1,13,37.07094643113601,0.6137387387387387,45.50438596491229,1017.9824561403516,27.513039355144638,0
1089,4,0,0,38,0.0,0.0,1.0,38,1000,900,100,0.9,11,9,2,331.69692437464806,0.447116524419156,0.13545491636066953,0.18603870975795503,129647.68005540184,1000.7473453370509,130648.42740073889,1075,2,207.1315789473684,37,1,15,36.949558570198114,0.6148648648648649,45.394736842105274,1018.4210526315803,27.524893314367034,0
1090,4,1,1,38,0.02564102564102564,0.02564102564102564,0.9743589743589743,39,950,600,350,0.631578947368421,13,6,7,325.78474497435064,0.447733918128655,0.13994024974745822,0.18419962121061648,129962.8351230917,667.9818193440142,130630.81694243572,1076,0,202.7948717948718,38,1,16,36.78074357362391,0.6162280701754386,45.08547008547009,1019.658119658121,26.833108412055815,0
1091,4,0,2,36,0.0,0.05263157894736842,0.9473684210526316,38,1300,1000,300,0.7692307692307693,16,10,6,328.1091455659611,0.4438863205310574,0.13308432371250656,0.18560918818512423,129982.903393352,929.7158741151318,130912.61926746713,1077,1,209.02631578947367,37,1,17,36.701164874551964,0.6182432432432432,45.06578947368422,1019.7368421052647,27.56045519203418,0
1092,4,1,0,37,0.02702702702702703,0.0,1.0,37,1100,1000,100,0.9090909090909091,12,10,2,334.4106513918262,0.442505005005005,0.1341418672839041,0.18997460264961397,130147.65346004815,1304.552314138493,131452.20577418664,1078,0,211.21621621621622,36,1,20,36.37360666593091,0.6218171296296297,44.904279279279294,1020.382882882885,28.34396896896903,0
1093,4,1,0,38,0.02631578947368421,0.0,1.0,38,850,500,350,0.5882352941176471,12,5,7,341.8744074445103,0.4437085111427217,0.12630415389985683,0.1873897862847895,128740.17373666802,1202.5941221053304,129942.76785877335,1079,0,206.6315789473684,38,0,14,37.613608450012286,0.6038925438596492,46.28739316239316,1014.8504273504265,26.706590193432277,8
1094,4,0,0,38,0.0,0.0,1.0,38,600,400,200,0.6666666666666666,8,4,4,341.1672851015598,0.4438863205310574,0.1297342661991252,0.1872576762420519,128794.39153928324,1188.086579552908,129982.47811883615,1080,1,207.6315789473684,38,0,14,37.57630775707817,0.6044407894736843,46.23397435897435,1015.0641025641016,26.712213225371094,0
1095,4,0,0,38,0.0,0.0,1.0,38,1250,700,550,0.56,18,7,11,342.5391192545409,0.4434417970602181,0.1324591851987178,0.1887837337248068,128957.11343277435,1234.5712113740806,130191.68464414842,1081,2,208.6315789473684,38,0,15,37.37574944777533,0.6060855263157895,46.07371794871794,1015.7051282051272,26.72908232118756,0
1096,4,0,0,38,0.0,0.0,1.0,38,1100,800,300,0.7272727272727273,14,8,6,342.539740868248,0.44292318634423894,0.12753419503342078,0.18943244274062615,129092.79348381891,1243.8824055811017,130336.67588940001,1082,3,209.6315789473684,38,0,16,37.23761213905243,0.6074561403508771,45.94017094017093,1016.2393162393145,26.743139901034592,0
1097,4,0,0,38,0.0,0.0,1.0,38,1100,800,300,0.7272727272727273,14,8,6,345.67796251718323,0.4422564011379801,0.12908479562887454,0.1918260740102642,129228.5448740776,1334.2920182262983,130562.83689230391,1083,4,210.6315789473684,38,0,17,37.01971909915589,0.6088267543859649,45.806623931623925,1016.7735042735034,26.75719748088167,0
1098,4,1,0,39,0.02564102564102564,0.0,1.0,39,750,600,150,0.8,9,6,3,340.02380544735,0.44436009896536216,0.134527501010006,0.1903432230493928,129572.31445312499,1011.5342881944441,130583.84874131942,1084,0,206.2051282051282,39,0,16,36.814081576972924,0.6105769230769231,45.46875,1018.1249999999999,26.105769230769226,0
1099,4,0,0,39,0.0,0.0,1.0,39,1200,600,600,0.5,18,6,12,340.7363661461997,0.4433198380566801,0.12901804679264273,0.19125833456817115,129678.39084201393,1037.2287326388937,130715.61957465282,1085,1,207.2051282051282,39,0,16,36.68822867662098,0.6116452991452992,45.364583333333336,1018.5416666666671,26.116452991453002,0
1100,4,0,0,39,0.0,0.0,1.0,39,1300,1000,300,0.7692307692307693,16,10,6,340.84737443012193,0.44253261358524515,0.13146824554368264,0.19196947979561788,129811.04736328125,1049.1509331597224,130860.19829644097,1086,2,208.2051282051282,39,0,16,36.55075556237009,0.6129807692307692,45.234375,1019.0625,26.129807692307693,0
1101,4,1,0,40,0.025,0.0,1.0,40,1400,900,500,0.6428571428571429,19,9,10,341.5800822854948,0.4426549145299145,0.14797391477499033,0.19449151624010813,130236.65229030329,897.2492811818281,131133.90157148513,1087,0,203.975,40,0,18,36.10053265631222,0.615625,44.8170731707317,1020.7317073170724,25.51829268292681,0
1102,4,0,1,39,0.0,0.025,0.975,40,1250,1100,150,0.88,14,11,3,342.0507896222433,0.4424278846153846,0.14147427604736817,0.19541036867049016,130366.35068618211,918.3826384757706,131284.7333246579,1088,1,204.975,40,0,19,35.95714333101138,0.6169270833333333,44.6900406504065,1021.2398373983735,25.53099593495934,0
1103,4,0,0,39,0.0,0.0,1.0,39,1400,1100,300,0.7857142857142857,17,11,6,348.5239591372648,0.44115497076023397,0.13910897043672854,0.199394745816804,130422.14084201399,1291.0481770833433,131713.18901909734,1089,2,208.07692307692307,39,0,19,35.735349105989535,0.6191239316239316,44.63541666666667,1021.4583333333342,26.191239316239336,0
1104,4,2,0,41,0.04878048780487805,0.0,1.0,41,1000,600,400,0.6,14,6,8,339.6704464625475,0.4425558943089431,0.14954747065888663,0.1968561980734629,130921.69390904512,694.0460443436687,131615.73995338878,1090,0,198.8780487804878,41,0,16,35.45624919219336,0.6209349593495934,44.1468253968254,1023.4126984126985,24.961285327138988,0
1105,4,1,2,40,0.023809523809523808,0.047619047619047616,0.9523809523809523,42,1650,1100,550,0.6666666666666666,22,11,11,333.8396013327688,0.44394841269841273,0.1494113548274707,0.19567096585561536,131354.81906467033,372.1777306843075,131726.99679535464,1091,0,195.11904761904762,39,3,18,35.168449175219315,0.6284722222222222,43.72395833333334,1025.1041666666683,26.284722222222264,0
1106,4,0,0,40,0.0,0.0,1.0,40,650,400,250,0.6153846153846154,9,4,5,332.8836213679897,0.44166666666666665,0.1434921763869128,0.19524675813490844,131381.51584201428,746.9509548611511,132128.46679687544,1092,1,195.4,39,1,18,35.166040100250626,0.6287393162393162,43.697916666666686,1025.2083333333364,26.287393162393244,0
1107,4,0,0,40,0.0,0.0,1.0,40,1750,1300,450,0.7428571428571429,22,13,9,332.6028894054249,0.44111912393162395,0.14612318472631247,0.19576453388973242,131515.04041883696,748.4564887152972,132263.49690755227,1093,2,196.4,39,1,19,35.03869621881453,0.6300747863247863,43.56770833333334,1025.729166666668,26.3007478632479,0
1108,4,0,1,39,0.0,0.025,0.975,40,1750,1300,450,0.7428571428571429,22,13,9,332.7129652331986,0.4404780982905983,0.14895209580838298,0.1966539200025621,131675.35942925364,762.0198567708517,132437.3792860245,1094,3,197.4,39,1,14,34.874424879055454,0.6316773504273504,43.41145833333334,1026.354166666668,26.31677350427354,0
1109,4,0,1,38,0.0,0.02564102564102564,0.9743589743589743,39,600,400,200,0.6666666666666666,8,4,4,340.31754173977765,0.4394680611785875,0.1526766475220085,0.2006181309593054,131574.6348002958,1155.4312541091283,132730.06605440495,1095,4,203.05128205128204,38,1,15,34.780797667395596,0.6324013157894737,43.50961538461538,1025.9615384615379,26.998987854251,0
1110,4,0,0,38,0.0,0.0,1.0,38,1050,500,550,0.47619047619047616,16,5,11,345.40603877295564,0.4392632764343291,0.15273957577496144,0.20365244516689018,131581.1250216413,1489.7830342028353,133070.90805584413,1096,5,207.47368421052633,37,1,15,34.643738199565384,0.6342905405405406,43.50328947368421,1025.9868421052633,27.729374110953064,0
1111,4,0,0,38,0.0,0.0,1.0,38,850,700,150,0.8235294117647058,10,7,3,346.08682609323216,0.4387891180654338,0.14611041440549744,0.20435499087738543,131637.3803117305,1511.592629462905,133148.9729411934,1097,6,208.47368421052633,37,1,15,34.56955426149516,0.6348536036036037,43.4484649122807,1026.206140350877,27.735301090564242,0
1112,4,0,0,38,0.0,0.0,1.0,38,700,400,300,0.5714285714285714,10,4,6,343.18404475974853,0.43788525367472736,0.14353964792373897,0.2033908477930561,131778.07113727304,1444.8262927054511,133222.8974299785,1098,7,209.47368421052633,37,1,15,34.50226043001565,0.6362612612612613,43.31140350877193,1026.7543859649127,27.750118539592233,0
1113,4,0,1,37,0.0,0.02631578947368421,0.9736842105263158,38,800,500,300,0.625,11,5,6,341.2069171237074,0.4376333570412518,0.13862495996583735,0.20266868691805767,131862.521701389,1398.4809027777874,133261.00260416677,1099,8,210.47368421052633,37,1,15,34.467968221771464,0.6371058558558558,43.22916666666667,1027.0833333333342,27.75900900900903,0
1114,4,0,1,36,0.0,0.02702702702702703,0.972972972972973,37,1000,800,200,0.8,12,8,4,338.5321441142587,0.43706206206206205,0.03633948012646249,0.18829243559975323,129319.08543381322,1365.499078360743,130684.58451217397,1100,9,216.45945945945945,35,2,17,37.109315733576096,0.6154761904761905,45.71759259259258,1017.1296296296279,29.06084656084651,8
1115,4,0,0,36,0.0,0.0,1.0,36,1450,1000,450,0.6896551724137931,19,10,9,345.6732061273853,0.4363095238095238,0.04644808743169415,0.19169150521609532,129201.38888888879,1732.291666666656,130933.68055555545,1101,10,223.19444444444446,34,2,17,37.047472677595636,0.616421568627451,45.83333333333333,1016.6666666666658,29.9019607843137,0
1116,4,0,0,36,0.0,0.0,1.0,36,1050,700,350,0.6666666666666666,14,7,7,346.70338869599266,0.43546626984126985,0.04942786554840395,0.1930019841307657,129352.72285997709,1769.4054705215135,131122.1283304986,1102,11,224.19444444444446,34,2,18,36.8673200702165,0.617953431372549,45.684523809523796,1017.2619047619029,29.91946778711479,0
1117,4,0,1,35,0.0,0.027777777777777776,0.9722222222222222,36,1100,700,400,0.6363636363636364,15,7,8,347.13492186707964,0.43554894179894177,0.052169448343992286,0.19368859739685335,129443.56575963704,1786.876417233543,131230.4421768706,1103,12,225.19444444444446,34,2,16,36.763960380595854,0.6188725490196079,45.59523809523809,1017.6190476190463,29.92997198879548,0
1118,4,1,1,35,0.027777777777777776,0.027777777777777776,0.9722222222222222,36,1000,900,100,0.9,11,9,2,340.9743766850765,0.4367559523809524,0.06234147264811685,0.192084413737178,129819.89354263087,1653.0514564042874,131472.94499903516,1104,0,223.41666666666666,35,1,17,36.53854344122657,0.6205357142857143,45.22569444444443,1019.0972222222198,29.117063492063423,0
1119,4,0,0,35,0.0,0.0,1.0,35,1150,800,350,0.6956521739130435,15,8,7,346.95425510510603,0.43480392156862746,0.06776663719323972,0.1958450419555056,129898.25857426287,2013.750708616754,131912.00928287962,1105,1,230.42857142857142,34,1,17,36.3066390283779,0.623468137254902,45.14880952380951,1019.4047619047606,29.98249299719884,0
1120,4,0,0,35,0.0,0.0,1.0,35,1050,800,250,0.7619047619047619,13,8,5,347.85510471520297,0.4349439775910364,0.0758480370901573,0.19681154735735965,129989.29280045329,2043.4878117913554,132032.78061224465,1106,2,231.42857142857142,34,1,17,36.19128920538564,0.6243872549019608,45.059523809523796,1019.7619047619029,29.992997198879497,0
1121,4,0,0,35,0.0,0.0,1.0,35,1250,1000,250,0.8,15,10,5,353.2707456358314,0.4334733893557423,0.0818374252045937,0.20065497421104755,130141.08737244885,2195.0077947845643,132336.0951672334,1107,3,232.42857142857142,34,1,17,35.89915606891456,0.6259191176470589,44.91071428571428,1020.3571428571418,30.01050420168064,0
1122,4,1,1,35,0.027777777777777776,0.027777777777777776,0.9722222222222222,36,1100,800,300,0.7272727272727273,14,8,6,362.1278348543179,0.43619378306878304,0.055286409028473926,0.19389062785670388,127802.69870799867,2056.1829143332675,129858.88162233194,1108,0,226.94444444444446,36,0,18,38.05871106656272,0.5980902777777778,47.212837837837846,1011.1486486486497,28.08746246246249,8
1123,4,1,0,36,0.027777777777777776,0.0,1.0,36,900,500,400,0.5555555555555556,13,5,8,362.46744463354526,0.43685515873015873,0.06191156639325035,0.1943474698659027,127859.63909433085,2068.991330857891,129928.63042518875,1109,0,227.11111111111111,36,0,19,37.99177894072672,0.5986689814814814,47.156531531531535,1011.3738738738741,28.093718718718726,0
1124,4,1,0,37,0.02702702702702703,0.0,1.0,37,1250,900,350,0.72,16,9,7,355.87073369997825,0.43968968968968974,0.06563539275844321,0.19190412462139,128089.02739304396,1716.6272314558282,129805.65462449979,1110,0,221.94594594594594,37,0,20,37.92379766031197,0.5990990990990991,46.92982456140351,1012.2807017543855,27.358937885253663,0
1125,4,2,1,38,0.05128205128205128,0.02564102564102564,0.9743589743589743,39,800,500,300,0.625,11,5,6,341.4893206720232,0.4427856500224921,0.07163963963963949,0.18646848974121713,128588.99493113281,982.3777508464325,129571.37268197924,1111,0,211.51282051282053,37,2,14,37.777477477477476,0.6041666666666667,46.43640350877194,1014.2543859649136,27.412280701754423,0
1126,4,1,1,38,0.02564102564102564,0.02564102564102564,0.9743589743589743,39,950,700,250,0.7368421052631579,12,7,5,346.41263157894707,0.44244826810616283,0.09055870445344083,0.19000692840646663,128767.28121119163,1121.3225491270525,129888.60376031869,1112,0,212.48717948717947,38,1,15,37.47083333333334,0.6041666666666667,46.26068376068377,1014.9572649572663,26.709401709401742,0
1127,4,2,0,40,0.05,0.0,1.0,40,1050,700,350,0.6666666666666666,14,7,7,342.31389411448515,0.4423477564102564,0.1143442622950821,0.18982861400894196,129201.38888888905,847.6776517642088,130049.06654065326,1113,0,208.075,36,4,18,37.13285519125682,0.6122685185185186,45.83333333333334,1016.666666666668,28.240740740740776,0
1128,4,0,0,40,0.0,0.0,1.0,40,850,500,350,0.5882352941176471,12,5,7,342.95642878530526,0.44198717948717947,0.11195604030561412,0.19059935436062114,129287.27027280675,867.980100032483,130155.25037283923,1114,1,209.075,36,4,18,37.02916805078804,0.6131365740740741,45.74887387387388,1017.0045045045058,28.250125125125162,0
1129,4,1,0,41,0.024390243902439025,0.0,1.0,41,1300,800,500,0.6153846153846154,18,8,10,337.38283296784346,0.4427083333333333,0.12227355753733749,0.18943509596675,129690.63321827733,551.0786489151724,130241.7118671925,1115,0,204.9512195121951,38,3,16,36.76119676945667,0.6134868421052632,45.352564102564095,1018.5897435897426,26.804993252361648,0
1130,4,0,0,41,0.0,0.0,1.0,41,1000,800,200,0.8,12,8,4,340.54699946163737,0.4423526422764228,0.1202355413846623,0.19187701286855013,129826.69850107729,642.4185249104903,130469.11702598778,1116,1,205.9512195121951,38,3,16,36.54252716916518,0.6148574561403508,45.21901709401708,1019.1239316239299,26.81905083220868,0
1131,4,0,0,41,0.0,0.0,1.0,41,1300,800,500,0.6153846153846154,18,8,10,343.0698151122789,0.4425304878048781,0.1224391776755307,0.19437908159506964,130044.55133912252,722.8720368543958,130767.42337597693,1117,2,206.9512195121951,38,3,18,36.25724485876891,0.6170504385964912,45.005341880341874,1019.9786324786314,26.841542959963984,0
1132,4,0,2,39,0.0,0.04878048780487805,0.9512195121951219,41,1500,1100,400,0.7333333333333333,19,11,8,340.6479634352669,0.4424034552845528,0.11920884912366714,0.19368269921033737,130180.80210387897,669.1650230111715,130849.96712689014,1118,3,207.9512195121951,38,3,19,36.180904522613055,0.618421052631579,44.87179487179487,1020.5128205128201,26.855600539811054,0
1133,4,0,0,39,0.0,0.0,1.0,39,1450,900,550,0.6206896551724138,20,9,11,359.29563806583656,0.4404520917678812,0.11126019781352037,0.20366081912392706,130061.4867401188,1546.1049732164895,131607.59171333528,1119,4,218.66666666666666,36,3,19,35.82629535585485,0.6209490740740741,44.98873873873875,1020.0450450450475,28.33458458458465,0
1134,4,0,1,38,0.0,0.02564102564102564,0.9743589743589743,39,1350,1200,150,0.8888888888888888,15,12,3,364.0149937526034,0.4397210976158345,0.11763474620617531,0.20740389178927393,130262.58680555547,1683.8176436571662,131946.40444921263,1120,5,219.66666666666666,34,5,19,35.50170068027212,0.6271446078431373,44.791666666666664,1020.8333333333327,30.02450980392155,0
1135,4,0,0,38,0.0,0.0,1.0,38,950,700,250,0.7368421052631579,12,7,5,366.685459108961,0.43904101469890944,0.12250061596194284,0.20909353592311788,130293.86421388394,1955.3730836697216,132249.23729755366,1121,6,224.07894736842104,33,5,19,35.401787500500134,0.6297348484848485,44.761029411764696,1020.95588235294,30.93805704099818,0
1136,4,0,0,38,0.0,0.0,1.0,38,1000,600,400,0.6,14,6,8,370.09564881133616,0.43881875296348977,0.12575904861698484,0.21223229159483614,130512.9112000191,2060.4521097654615,132573.36330978456,1122,7,225.07894736842104,33,5,15,35.09234828496043,0.6319444444444444,44.546568627450974,1021.813725490195,30.964052287581666,0
1137,4,0,1,37,0.0,0.02631578947368421,0.9736842105263158,38,1350,1000,350,0.7407407407407407,17,10,7,365.5768309199329,0.4381519677572309,0.12396734733900416,0.21042719999600418,130657.85147392278,1953.0966553287851,132610.94812925157,1123,8,226.07894736842104,34,4,16,35.060792190653636,0.6311274509803921,44.4047619047619,1022.3809523809514,30.070028011204453,0
1138,4,0,1,36,0.0,0.02702702702702703,0.972972972972973,37,900,800,100,0.8888888888888888,10,8,2,370.3515905862276,0.4381569069069069,0.12016477443986773,0.212550716717037,130544.21864487202,2269.451803392911,132813.67044826492,1124,9,230.3783783783784,33,4,16,35.0540382539873,0.632260101010101,44.51593137254901,1021.9362745098027,30.967765894236447,0
1139,4,0,0,36,0.0,0.0,1.0,36,950,600,350,0.631578947368421,13,6,7,378.7941883866455,0.43682208994709,0.1273974765572441,0.21726303094352395,130520.50053884817,2688.0814138863484,133208.5819527345,1125,10,236.66666666666666,32,4,16,34.86243255488281,0.6344401041666667,44.53914141414142,1021.8434343434351,31.932607323232347,0
1140,4,0,1,35,0.0,0.027777777777777776,0.9722222222222222,36,1250,900,350,0.72,16,9,7,397.6193006695716,0.43659060846560843,0.17038946162657465,0.21191797892828815,127617.73003472228,2962.061946803902,130579.79198152618,1126,11,237.66666666666666,33,3,17,37.35180412371133,0.6025883838383839,47.395833333333336,1010.4166666666671,30.618686868686883,8
1141,4,1,0,36,0.027777777777777776,0.0,1.0,36,1050,800,250,0.7619047619047619,13,8,5,398.6240926185151,0.4376818783068783,0.17829825341036099,0.21343591097958287,127803.5359747455,2989.1137122741516,130792.64968701964,1127,0,238.33333333333334,33,3,19,37.13527148224458,0.6044823232323233,47.21200980392158,1011.1519607843154,30.640968508615618,0
1142,4,0,0,36,0.0,0.0,1.0,36,1150,1000,150,0.8695652173913043,13,10,3,397.14128507902143,0.4369047619047619,0.1812957579672696,0.21346344072997428,127958.47750865067,2963.518838908132,130921.9963475588,1128,1,239.33333333333334,33,3,19,37.013485142118874,0.6060606060606061,47.058823529411775,1011.7647058823542,30.65953654188952,0
1143,4,1,1,36,0.02702702702702703,0.02702702702702703,0.972972972972973,37,1050,600,450,0.5714285714285714,15,6,9,393.2388854921827,0.4384384384384385,0.1795200808284918,0.2133699835074218,128336.36435376504,2693.6401060383814,131030.00445980341,1129,0,233.83783783783784,32,5,20,36.72429906542056,0.6123046875,46.68560606060607,1013.2575757575767,31.66429924242427,0
1144,4,4,7,33,0.1,0.175,0.825,40,1350,1000,350,0.7407407407407407,17,10,7,356.39906794415504,0.44285523504273505,0.14100363719027098,0.19971968151418318,129613.5612247085,1241.7359578883672,130855.29718259686,1130,0,190.125,35,5,14,36.35532696825035,0.618452380952381,45.42824074074074,1018.287037037037,29.09391534391534,0
1145,4,0,1,32,0.0,0.030303030303030304,0.9696969696969697,33,900,400,500,0.4444444444444444,14,4,10,421.7613833102497,0.432449494949495,0.15983851674641203,0.22895617951127822,128355.55555555547,4227.0833333333285,132582.63888888882,1131,1,223.93939393939394,29,4,20,35.98204495614036,0.6206896551724138,46.666666666666664,1013.3333333333327,34.94252873563216,0
1146,4,0,0,32,0.0,0.0,1.0,32,900,700,200,0.7777777777777778,11,7,4,429.08743057407736,0.43283770161290325,0.16006983834373179,0.2327634277237226,128326.43843308232,4612.652348394766,132939.09078147708,1132,2,228.5625,28,4,21,35.826420400831914,0.6235119047619048,46.695402298850574,1013.2183908045978,36.18637110016421,0
1147,4,0,0,32,0.0,0.0,1.0,32,1250,1000,250,0.8,15,10,5,424.4097453022429,0.4329427083333333,0.15713221186789061,0.23059701500152396,128390.74315200617,4498.056520061725,132888.7996720679,1133,3,229.5625,29,3,18,35.87875725183864,0.6210488505747127,46.63194444444444,1013.4722222222222,34.94731800766284,0
1148,4,2,0,34,0.058823529411764705,0.0,1.0,34,1200,700,500,0.5833333333333334,17,7,10,402.15995183691507,0.4358845811051693,0.14928213437841498,0.22245630220319798,129102.1241082086,3583.940802680125,132686.06491088873,1134,0,217.0,31,3,21,35.7133514840914,0.6226478494623655,45.930989583333336,1016.2760416666671,32.78309811827958,0
1149,4,1,0,35,0.02857142857142857,0.0,1.0,35,900,600,300,0.6666666666666666,12,6,6,415.3654588153153,0.4363095238095238,0.16943147044612727,0.21800542128354128,126996.54571280994,3662.647944398718,130659.19365720866,1135,0,211.77142857142857,32,3,18,37.54462608042091,0.5986328125,48.01136363636364,1007.9545454545456,31.49857954545455,8
1150,4,1,1,35,0.027777777777777776,0.027777777777777776,0.9722222222222222,36,900,500,400,0.5555555555555556,13,5,8,405.0954020043361,0.43776455026455025,0.17605629054227157,0.21491184913803785,127432.05925905913,3124.428254757797,130556.48751381692,1136,0,206.86111111111111,33,3,16,37.354224825019216,0.6006944444444444,47.579656862745104,1009.6813725490206,30.5964052287582,0
1151,4,3,0,38,0.07894736842105263,0.0,1.0,38,900,600,300,0.6666666666666666,12,6,6,391.0596107683733,0.4437529634898056,0.19889515076256914,0.2116638954158877,128237.60880730965,2433.6822075643936,130671.29101487403,1137,0,196.8421052631579,33,5,19,36.88079753982658,0.6089015151515151,46.783088235294116,1012.8676470588232,30.692959001782523,0
1152,4,0,1,37,0.0,0.02631578947368421,0.9736842105263158,38,600,100,500,0.16666666666666666,11,1,10,373.2781302073812,0.44299727358937885,0.1521589637474139,0.18920099808645038,125566.11571712016,1777.825115953246,127343.94083307341,1138,1,197.8421052631579,34,4,19,40.08146256483354,0.5793504901960784,49.43452380952381,1002.2619047619046,29.478291316526605,8
1153,4,3,2,38,0.075,0.05,0.95,40,950,800,150,0.8421052631578947,11,8,3,343.81248875856943,0.449599358974359,0.1639802999776132,0.17837519016080514,126524.89271365984,727.2793287634252,127252.17204242326,1139,0,188.85,36,4,15,39.83214872024475,0.5850694444444444,48.47972972972974,1006.081081081083,27.946696696696748,8
1154,4,4,4,38,0.09523809523809523,0.09523809523809523,0.9047619047619048,42,1150,600,550,0.5217391304347826,17,6,11,335.70799389169224,0.45015485869144406,0.18870121402179696,0.17733553156092716,127257.91229032014,145.56784841760302,127403.48013873774,1140,0,180.76190476190476,37,5,19,39.28403245671232,0.5906531531531531,47.752192982456144,1008.9912280701757,27.27003319108583,0
1155,4,1,3,36,0.02564102564102564,0.07692307692307693,0.9230769230769231,39,1050,700,350,0.6666666666666666,14,7,7,343.7477370227454,0.45020805218173643,0.17147578855875034,0.1826261673945489,127489.75326678039,964.8628358087949,128454.61610258918,1141,0,182.97435897435898,36,3,15,38.84366636931311,0.5949074074074074,47.52252252252253,1009.9099099099108,28.053053053053077,0
1156,4,1,0,37,0.02702702702702703,0.0,1.0,37,1300,1000,300,0.7692307692307693,16,10,6,358.00941516345995,0.4461961961961962,0.17711871163198611,0.18904235473584574,127242.1077806122,1710.774518140583,128952.88229875278,1142,0,193.75675675675674,34,3,19,38.737708947885935,0.5965073529411764,47.76785714285714,1008.9285714285711,29.67436974789915,0
1157,4,1,2,36,0.02631578947368421,0.05263157894736842,0.9473684210526316,38,600,300,300,0.5,9,3,6,359.2706148826479,0.4476499525841631,0.1470364121264902,0.18779172140082157,126829.56271701366,1513.2269965277526,128342.78971354141,1143,0,189.6315789473684,35,3,16,39.12982592209584,0.5901785714285714,48.17708333333332,1007.2916666666648,28.779761904761852,8
1158,4,0,0,36,0.0,0.0,1.0,36,850,600,250,0.7058823529411765,11,6,5,373.2498544405164,0.4434027777777778,0.17209873623919503,0.19463300054610871,126732.14994331046,2260.5513038548497,128992.70124716531,1144,1,201.02777777777777,34,2,16,38.878133128399135,0.5912990196078431,48.27380952380951,1006.9047619047603,29.614845938375304,0
1159,4,2,0,38,0.05263157894736842,0.0,1.0,38,1350,1000,350,0.7407407407407407,17,10,7,360.3062844733052,0.44793148411569467,0.16564852318892265,0.19051003604140349,127296.3301209917,1573.6437506779748,128869.97387166967,1145,0,191.39473684210526,35,3,19,38.62410157892727,0.5949404761904762,47.71412037037036,1009.1435185185165,28.832671957671902,0
1160,4,0,2,36,0.0,0.05263157894736842,0.9473684210526316,38,1100,500,600,0.45454545454545453,17,5,12,358.8114948331187,0.4475906827880512,0.1646026831785341,0.18999362759196273,127354.73632812491,1539.2686631944298,128894.00499131934,1146,1,192.39473684210526,35,3,12,38.60186618507049,0.5955357142857143,47.65624999999999,1009.3749999999993,28.839285714285694,0
1161,4,1,0,37,0.02702702702702703,0.0,1.0,37,1050,700,350,0.6666666666666666,14,7,7,368.38557656771326,0.44456956956956956,0.18398653430500622,0.1949546141161717,127332.20663265296,1981.4696712018035,129313.67630385477,1147,0,198.51351351351352,34,3,13,38.383413934103956,0.5974264705882353,47.67857142857142,1009.2857142857134,29.684873949579806,0
1162,4,0,0,37,0.0,0.0,1.0,37,1150,900,250,0.782608695652174,14,9,5,369.9513177138818,0.4445382882882883,0.18454217628908198,0.19631723210072383,127442.37075617265,2029.494598765415,129471.86535493807,1148,1,199.51351351351352,35,2,13,38.230742778541966,0.5964285714285714,47.569444444444436,1009.7222222222207,28.849206349206305,0
1163,4,3,1,39,0.075,0.025,0.975,40,650,500,150,0.7692307692307693,8,5,3,373.1183659824142,0.4487313034188034,0.20123876469232527,0.19159296923049646,126101.95500042866,1473.84848679698,127575.80348722564,1149,0,185.475,35,5,19,39.53147806714296,0.5827380952380952,48.90046296296296,1004.398148148148,28.697089947089943,7
1164,4,2,0,41,0.04878048780487805,0.0,1.0,41,1100,800,300,0.7272727272727273,14,8,6,366.27992833149915,0.44972052845528454,0.22013996549992365,0.1902951999750162,126581.5477639803,1072.856048616196,127654.4038125965,1150,0,181.609756097561,36,5,18,39.208678379588186,0.5856481481481481,48.42342342342343,1006.3063063063072,27.952952952952977,0
1165,4,1,1,41,0.023809523809523808,0.023809523809523808,0.9761904761904762,42,1000,600,400,0.6,14,6,8,358.98144163033305,0.4516671506000774,0.2281368328904505,0.18847038223344648,127009.10526556232,718.7823416820443,127727.88760724437,1151,0,178.26190476190476,37,5,19,38.952531817687394,0.5881193693693694,47.998903508771924,1008.004385964911,27.243361782835432,0
1166,4,2,1,42,0.046511627906976744,0.023255813953488372,0.9767441860465116,43,1350,1000,350,0.7407407407407407,17,10,7,349.1550643001381,0.45263473606496857,0.23936705825941007,0.18608813866545812,127617.73003472216,311.70239881500896,127929.43243353716,1152,0,174.97674418604652,37,6,17,38.576030927835035,0.5943130630630631,47.39583333333333,1010.4166666666661,27.30855855855854,0
1167,4,1,1,42,0.023255813953488372,0.023255813953488372,0.9767441860465116,43,1700,1400,300,0.8235294117647058,20,14,6,352.8357424847607,0.45143503137689184,0.2606831625549719,0.1897619146549217,127982.32299884956,431.34759204471834,128413.67059089428,1153,0,175.69767441860466,38,5,19,38.10975609756098,0.596217105263158,47.035256410256416,1011.8589743589753,26.627867746288825,0
1168,4,0,1,41,0.0,0.023809523809523808,0.9761904761904762,42,1000,700,300,0.7,13,7,6,354.5333936837606,0.4509654471544715,0.26227630193820106,0.19065467114881937,127978.05574792232,674.4988842720697,128652.55463219438,1154,1,180.47619047619048,37,5,20,38.071178297933834,0.597972972972973,47.03947368421052,1011.8421052631569,27.347083926031267,0
1169,4,1,0,42,0.023809523809523808,0.0,1.0,42,1300,700,600,0.5384615384615384,19,7,12,355.8986723071995,0.4513162988772745,0.26509312283960185,0.19165371910125137,128033.53555901808,713.3930632502223,128746.9286222683,1155,0,181.35714285714286,37,5,21,37.97986637775371,0.5985360360360361,46.984649122807014,1012.0614035087713,27.353010905642467,0
1170,4,0,1,41,0.0,0.023809523809523808,0.9761904761904762,42,1450,1100,350,0.7586206896551724,18,11,7,380.13195486967993,0.45134049554781264,0.29738279435554915,0.19518692604966492,126100.38406227194,1206.2899723346038,127306.67403460655,1156,1,182.35714285714286,36,6,17,39.356990694024,0.5807291666666667,48.90202702702704,1004.3918918918936,27.899774774774823,8
1171,4,5,3,43,0.10869565217391304,0.06521739130434782,0.9347826086956522,46,1900,1500,400,0.7894736842105263,23,15,8,359.94037492677415,0.4590378421900161,0.3247182314183761,0.19144172828091482,127534.65008464146,-7.374825998604905,127527.27525864285,1157,0,167.1086956521739,37,9,13,38.38878636561007,0.5934684684684685,47.478070175438596,1010.0877192982458,27.29966808914178,0
1172,4,1,0,44,0.022727272727272728,0.0,1.0,44,1500,1200,300,0.8,18,12,6,381.71247017259253,0.455547480620155,0.3629776398421152,0.20329274875756886,127588.49511584766,940.4239272547719,128528.91904310243,1158,0,175.5681818181818,35,9,14,37.783656967197466,0.5979166666666667,47.424768518518505,1010.3009259259239,28.865740740740684,0
1173,4,2,2,44,0.043478260869565216,0.043478260869565216,0.9565217391304348,46,1550,1200,350,0.7741935483870968,19,12,7,369.5360370979989,0.4583635265700483,0.3667327259105302,0.20011900383482806,128258.57688347102,280.44222676517404,128539.01911023619,1159,0,168.8913043478261,36,10,17,37.40434500648506,0.6027199074074074,46.76238738738737,1012.9504504504481,28.137512512512448,0
1174,4,1,2,43,0.022222222222222223,0.044444444444444446,0.9555555555555556,45,1500,900,600,0.6,21,9,12,372.92886323852287,0.4589436026936027,0.35657050062165463,0.20286403628838345,128437.66744898792,579.6226637516668,129017.29011273959,1160,0,169.88888888888889,35,10,18,37.135095531704344,0.6065476190476191,46.585648148148124,1013.657407407404,28.961640211640113,0
1175,4,0,0,43,0.0,0.0,1.0,43,1450,1100,350,0.7586206896551724,18,11,7,376.8153788722456,0.4579641934293097,0.35154742343844214,0.20543120935281475,128525.67361378984,1086.0900795181224,129611.76369330796,1161,1,171.97674418604652,35,8,18,36.9465291252901,0.6074404761904761,46.49884259259257,1014.0046296296259,28.97156084656074,0
1176,4,2,0,45,0.044444444444444446,0.0,1.0,45,1500,1300,200,0.8666666666666667,17,13,4,362.22705415319194,0.46031144781144784,0.34590377753168444,0.20116299501865437,129258.63997443373,365.96688665405685,129624.60686108778,1162,0,165.2888888888889,36,9,20,36.568383167220375,0.6128472222222222,45.77702702702702,1016.8918918918906,28.246996996996963,0
1177,4,0,1,44,0.0,0.022222222222222223,0.9777777777777777,45,1450,1200,250,0.8275862068965517,17,12,5,365.14905939988614,0.4598695286195286,0.34809156549442144,0.2032280624497332,129344.54038075237,446.00745170845903,129790.54783246083,1163,1,166.2888888888889,36,9,20,36.40655559245728,0.6137152777777778,45.692567567567565,1017.2297297297296,28.256381381381377,0
1178,4,1,2,43,0.022222222222222223,0.044444444444444446,0.9555555555555556,45,1300,900,400,0.6923076923076923,17,9,8,362.90936448523286,0.4608375420875421,0.34701062588293086,0.20375637503221197,129688.42734203817,413.0289495576881,130101.45629159585,1164,0,166.64444444444445,36,9,19,36.11341440943432,0.6171875,45.35472972972974,1018.5810810810825,28.29391891891896,0
1179,4,0,0,43,0.0,0.0,1.0,43,800,300,500,0.375,13,3,10,364.70487530753826,0.4586101882613511,0.24575629361096207,0.19397582628943677,127534.65008464144,702.5017313019371,128237.15181594338,1165,1,175.02325581395348,37,6,14,38.26847228253003,0.5934684684684685,47.478070175438596,1010.0877192982457,27.299668089141775,8
1180,4,0,1,42,0.0,0.023255813953488372,0.9767441860465116,43,1150,800,350,0.6956521739130435,15,8,7,362.43247796755975,0.45782576596530083,0.24927972066785364,0.19356330138499248,127700.83703639593,656.5861611265109,128357.42319752244,1166,2,176.02325581395348,37,6,15,38.155420553988556,0.5951576576576576,47.313596491228076,1010.7456140350887,27.31744902797537,0
1181,4,1,2,41,0.023255813953488372,0.046511627906976744,0.9534883720930233,43,1300,900,400,0.6923076923076923,17,9,8,369.46400445463064,0.4549418604651163,0.2905153620774814,0.19979493638367352,128201.54772593529,873.940907549562,129075.48863348486,1167,0,176.8372093023256,36,7,16,37.464555765595456,0.6021412037037037,46.81869369369369,1012.7252252252244,28.131256256256236,0
1182,4,1,0,42,0.023809523809523808,0.0,1.0,42,1100,700,400,0.6363636363636364,15,7,8,354.79547928472607,0.4553329461866047,0.22709244766042458,0.18652952300891146,127065.0833356162,684.0036776508109,127749.08701326701,1168,0,178.38095238095238,38,4,16,39.000520998905024,0.5868969298245614,47.94337606837607,1008.2264957264958,26.532276203328838,8
1183,4,2,1,43,0.045454545454545456,0.022727272727272728,0.9772727272727273,44,1500,1000,500,0.6666666666666666,20,10,10,348.1562380847115,0.4559659090909091,0.24975785597456124,0.1863263266651316,127784.64708713403,97.80440296781904,127882.45149010184,1169,0,171.22727272727272,40,4,14,38.43036988642074,0.5908854166666666,47.23069105691057,1011.0772357723582,25.276930894308954,0
1184,4,1,1,43,0.022727272727272728,0.022727272727272728,0.9772727272727273,44,1700,1200,500,0.7058823529411765,22,12,10,352.09101105592043,0.4543912966878083,0.26577963176064445,0.19051499913299813,128225.67389875084,230.43356229132075,128456.10746104216,1170,0,172.0,38,6,15,37.87974683544304,0.5986842105263157,46.794871794871796,1012.820512820513,26.6531713900135,0
1185,4,0,1,42,0.0,0.023255813953488372,0.9767441860465116,43,1950,1500,450,0.7692307692307693,24,15,9,358.35501995354343,0.45205795496493173,0.2612889384707804,0.19456195559584186,128360.96871803996,599.7595012418687,128960.72821928184,1171,1,176.86046511627907,38,5,16,37.58280618520472,0.6000548245614035,46.66132478632478,1013.3547008547002,26.66722896986053,0
1186,4,0,0,42,0.0,0.0,1.0,42,1350,1100,250,0.8148148148148148,16,11,5,363.97399394323423,0.44990079365079366,0.26293525417091734,0.19764087262181973,128366.66690712528,944.4256886734402,129311.09259579872,1172,2,181.73809523809524,37,5,18,37.43462814686577,0.6019144144144144,46.655701754385966,1013.3771929824563,27.38857278330963,0
1187,4,0,0,42,0.0,0.0,1.0,42,950,700,250,0.7368421052631579,12,7,5,363.95082806566404,0.4495499419279907,0.2654006353325198,0.19859476157990133,128561.19340806788,957.9905595952616,129519.18396766314,1173,3,182.73809523809524,37,5,13,37.23634537067069,0.6038851351351351,46.463815789473685,1014.1447368421054,27.409317211948796,0
1188,4,0,0,42,0.0,0.0,1.0,42,1300,1000,300,0.7692307692307693,16,10,6,364.508009056833,0.4486667634533488,0.26434927153612975,0.19945550607941298,128672.4175347222,980.4253472222183,129652.84288194442,1174,4,183.73809523809524,37,5,14,37.10857289527721,0.6050112612612613,46.354166666666664,1014.5833333333331,27.421171171171167,0
1189,4,1,1,42,0.023255813953488372,0.023255813953488372,0.9767441860465116,43,1100,700,400,0.6363636363636364,15,7,8,384.48661296741454,0.45053525286083423,0.2770726308064344,0.2003268525245313,126698.4388563366,1195.939127604146,127894.37798394074,1175,0,180.4418604651163,39,4,15,38.630043973098815,0.5814636752136753,48.30729166666666,1006.7708333333317,25.81463675213671,8
1190,4,0,1,41,0.0,0.023809523809523808,0.9761904761904762,42,1250,900,350,0.72,16,9,7,382.8447755787412,0.44964672861014326,0.25944230210441876,0.19998520448789003,126803.33251953108,1309.1986762152624,128112.53119574634,1176,1,179.38095238095238,39,3,16,38.56321318991968,0.5825320512820513,48.20312499999999,1007.1874999999986,25.82532051282048,0
1191,4,2,2,41,0.046511627906976744,0.046511627906976744,0.9534883720930233,43,1150,800,350,0.6956521739130435,15,8,7,389.8224930138381,0.45150424510889625,0.28907660594014595,0.20727681940117118,127523.29082657606,1342.945896482803,128866.23672305887,1177,0,175.6046511627907,38,5,16,37.64588181369437,0.5915570175438596,47.48931623931624,1010.0427350427349,26.580071974808813,0
1192,4,0,3,38,0.0,0.07317073170731707,0.926829268292683,41,1200,600,600,0.5,18,6,12,395.60743119109827,0.4490853658536585,0.290669976851075,0.20993182662476523,127442.37075617282,1883.429783950613,129325.80054012344,1178,1,183.609756097561,38,3,16,37.58310408069692,0.590734649122807,47.56944444444444,1009.7222222222222,26.571637426900583,0
1193,4,2,0,40,0.05,0.0,1.0,40,1300,1000,300,0.7692307692307693,16,10,6,406.3986784818953,0.45136217948717944,0.3250000000000002,0.21824413315913654,127922.58795975681,2397.5141389658343,130320.10209872265,1179,0,187.475,37,3,18,36.81624394826217,0.5974099099099099,47.094298245614034,1011.6228070175436,27.341156946420096,0
1194,4,1,0,41,0.024390243902439025,0.0,1.0,41,1000,600,400,0.6,14,6,8,398.91123450900534,0.45170223577235774,0.31842085643993023,0.21557426688269374,128174.66695011339,2026.8323926985383,130201.49934281192,1180,0,183.8780487804878,34,7,19,36.7466102359119,0.6060049019607843,46.845238095238095,1012.6190476190477,29.78291316526611,0
1195,4,0,1,40,0.0,0.024390243902439025,0.975609756097561,41,1150,1000,150,0.8695652173913043,13,10,3,395.4904557844038,0.45142276422764227,0.3094073379930131,0.21453277687578454,128325.39859693873,1950.2940759637142,130275.69267290244,1181,1,184.8780487804878,34,7,19,36.67851407981828,0.6075367647058824,46.69642857142857,1013.2142857142853,29.800420168067216,0
1196,4,0,0,40,0.0,0.0,1.0,40,1200,800,400,0.6666666666666666,16,8,8,391.1770146301758,0.451696047008547,0.30794131080155296,0.21279057727522227,128437.6674489883,2048.3726637517093,130486.04011274001,1182,2,189.7,35,5,16,36.6726611859633,0.6065476190476191,46.585648148148145,1013.6574074074072,28.961640211640205,0
1197,4,0,0,40,0.0,0.0,1.0,40,1850,1400,450,0.7567567567567568,23,14,9,396.7479496513308,0.45096153846153847,0.23600993377483448,0.20658255309431384,126672.22222222236,2053.652799211267,128725.87502143363,1183,3,190.7,34,6,16,38.34850993377484,0.5906862745098039,48.33333333333334,1006.6666666666679,29.60784313725494,8
1198,4,1,0,41,0.024390243902439025,0.0,1.0,41,1150,700,450,0.6086956521739131,16,7,9,390.8444323355089,0.4523882113821138,0.24330885255816193,0.20547047978724317,127062.83925165042,1732.3606556498676,128795.1999073003,1184,0,187.02439024390245,35,6,17,38.094196035663714,0.5925595238095238,47.945601851851855,1008.217592592593,28.80621693121694,0
1199,4,2,0,43,0.046511627906976744,0.0,1.0,43,1300,700,600,0.5384615384615384,19,7,12,376.9702593865657,0.454734219269103,0.2476647016907425,0.2012675834618935,127688.85598013562,1026.9835809008832,128715.8395610365,1185,0,179.27906976744185,36,7,17,37.80037140204271,0.5969328703703703,47.325450450450454,1010.6981981981988,28.074949949949968,0
1200,4,0,0,43,0.0,0.0,1.0,43,1450,900,550,0.6206896551724138,20,9,11,374.3806011608069,0.4542727943890735,0.2441368772204977,0.2006340665023897,127839.40882050268,972.1189452524059,128811.52776575509,1186,1,180.27906976744185,37,6,17,37.71131500957749,0.5965653153153153,47.17653508771931,1011.2938596491246,27.332266477003365,0
1201,4,1,0,44,0.022727272727272728,0.0,1.0,44,1350,900,450,0.6666666666666666,18,9,9,368.12679070087745,0.4559328752642706,0.25112194969925494,0.19922557485611497,128232.43694540893,642.2501762027177,128874.68712161166,1187,0,177.1590909090909,35,9,18,37.4667895097703,0.6044642857142857,46.78819444444444,1012.8472222222222,28.938492063492063,0
1202,4,0,0,44,0.0,0.0,1.0,44,950,600,350,0.631578947368421,13,6,7,370.8728550684673,0.4555915257223397,0.2554208984983488,0.2011537158159456,128320.37278163576,718.1086033950559,129038.48138503081,1188,1,178.1590909090909,35,9,19,37.307230980123364,0.6053571428571429,46.701388888888886,1013.1944444444441,28.94841269841269,0
1203,4,0,0,44,0.0,0.0,1.0,44,1850,1500,350,0.8108108108108109,22,15,7,371.02060333561377,0.4546996124031008,0.25326586239967686,0.20236465978420362,128543.91289515868,738.4880234964714,129282.40091865514,1189,2,179.1590909090909,36,8,16,37.07477327410698,0.6056134259259259,46.48085585585586,1014.0765765765766,28.168793793793796,0
1204,4,0,1,43,0.0,0.022727272727272728,0.9772727272727273,44,1650,1200,450,0.7272727272727273,21,12,9,369.2997234784293,0.45418208245243125,0.25348139491490485,0.2026441932566579,128783.689753097,711.9562028701025,129495.6459559671,1190,3,180.1590909090909,37,7,18,36.87333459364085,0.6061373873873874,46.244517543859644,1015.0219298245605,27.433025130393528,0
1205,4,2,1,44,0.044444444444444446,0.022222222222222223,0.9777777777777777,45,1700,1300,400,0.7647058823529411,21,13,8,368.40281022099714,0.45359848484848486,0.2676174581500026,0.20490657571026055,129319.08543381315,530.3317672650073,129849.41720107815,1191,0,176.9777777777778,35,10,21,36.34975724472764,0.6154761904761905,45.717592592592574,1017.1296296296273,29.060846560846493,0
1206,4,1,2,43,0.022222222222222223,0.044444444444444446,0.9555555555555556,45,1050,600,450,0.5714285714285714,15,6,9,357.5446431192815,0.45448232323232324,0.1866511792103671,0.19787652200311007,129121.97401258687,269.5965885952549,129391.57060118213,1192,0,177.7111111111111,39,6,19,36.826658638242634,0.6060363247863247,45.911458333333336,1016.3541666666672,26.06036324786326,8
1207,4,1,1,43,0.022727272727272728,0.022727272727272728,0.9772727272727273,44,1650,1400,250,0.8484848484848485,19,14,5,356.5187531655889,0.4534553382663848,0.21352562166515643,0.1979928869056134,129258.63997443412,416.6746600380182,129675.31463447213,1193,0,182.6818181818182,36,8,20,36.71350129198966,0.6128472222222222,45.77702702702704,1016.8918918918937,28.246996996997048,0
1208,4,1,1,43,0.022727272727272728,0.022727272727272728,0.9772727272727273,44,1300,1000,300,0.7692307692307693,16,10,6,359.0010521088801,0.4552721987315011,0.20839744943628102,0.20068092207867474,129516.42679419304,499.30669689962554,130015.73349109267,1194,0,178.72727272727272,36,8,16,36.387920861452216,0.6154513888888888,45.52364864864866,1017.905405405407,28.275150150150196,0
1209,4,0,0,43,0.0,0.0,1.0,43,1050,700,350,0.6666666666666666,14,7,7,371.15385729933985,0.4528423772609819,0.2180840933618302,0.20705486759998712,129436.8355624143,1008.1961591220911,130445.03172153639,1195,2,183.88372093023256,35,8,17,36.15976645435245,0.6166666666666667,45.601851851851855,1017.5925925925928,29.07407407407408,0
1210,4,0,1,42,0.0,0.023255813953488372,0.9767441860465116,43,1200,900,300,0.75,15,9,6,370.39493071540875,0.4533499446290144,0.21967340490947396,0.20705007908080322,129516.4267941932,994.4455857885289,130510.87237998174,1196,3,184.88372093023256,36,7,17,36.09797359589925,0.6154513888888888,45.52364864864867,1017.9054054054084,28.275150150150232,0
1211,4,0,0,42,0.0,0.0,1.0,42,1350,800,550,0.5925925925925926,19,8,11,372.1376259799066,0.45130420054200543,0.22466686151614512,0.20853928874975944,129613.56122470874,1246.816593792895,130860.37781850164,1197,4,189.78571428571428,35,7,19,35.954667727513836,0.618452380952381,45.428240740740755,1018.287037037039,29.0939153439154,0
1212,4,0,0,42,0.0,0.0,1.0,42,1450,1300,150,0.896551724137931,16,13,3,371.39847171393814,0.4511590205187766,0.21475622617019563,0.20922351525535698,129819.8935426314,1242.982011959903,131062.8755545913,1198,5,190.78571428571428,35,7,19,35.76341567291312,0.6205357142857143,45.22569444444446,1019.097222222224,29.117063492063544,0
1213,4,1,1,42,0.023255813953488372,0.023255813953488372,0.9767441860465116,43,1200,800,400,0.6666666666666666,16,8,8,364.5741136885548,0.4531653746770026,0.21003909769803575,0.20680506549183658,130090.20580969533,885.5042965263101,130975.71010622164,1199,0,187.32558139534885,36,7,20,35.66250873900724,0.6212384259259259,44.96058558558561,1020.1576576576617,28.337712712712825,0
1214,4,0,0,42,0.0,0.0,1.0,42,1350,1000,350,0.7407407407407407,17,10,7,372.64402546802046,0.4514372822299652,0.21853347212146024,0.21122713283412622,130061.48674011881,1293.3271954387133,131354.81393555753,1200,1,192.45238095238096,36,6,20,35.48589644513137,0.6209490740740741,44.98873873873875,1020.0450450450476,28.334584584584654,0
1215,4,1,1,42,0.023255813953488372,0.023255813953488372,0.9767441860465116,43,1250,700,550,0.56,18,7,11,368.9337717339557,0.45168881506090813,0.21884739331203562,0.21105442603998073,130419.0113928536,1023.816954221291,131442.8283470749,1201,0,188.95348837209303,33,10,22,35.21733153369327,0.6309974747474747,44.63848039215686,1021.4460784313717,30.952911467617323,0
1216,4,1,1,42,0.023255813953488372,0.023255813953488372,0.9767441860465116,43,1000,600,400,0.6,14,6,8,369.8359408397149,0.45205795496493173,0.22357477632206324,0.2125983171980744,130606.84479827463,1060.6210652153,131667.46586348992,1202,0,189.13953488372093,33,10,17,35.00367162210767,0.6328914141414141,44.4546568627451,1022.181372549019,30.97519310754603,0
1217,4,0,0,42,0.0,0.0,1.0,42,1300,900,400,0.6923076923076923,17,9,8,375.44815426404284,0.4504694154084398,0.2214135746925674,0.21606280775237782,130649.55305899907,1410.4267102846663,132059.97976928373,1203,1,194.61904761904762,32,10,17,34.81690749660369,0.6357421875,44.41287878787879,1022.3484848484848,31.94839015151515,0
1218,4,1,0,43,0.023255813953488372,0.0,1.0,43,1500,900,600,0.6,21,9,12,363.994050838291,0.45037375415282394,0.21519740400216314,0.21151005656819602,131023.24263038543,938.3361678004455,131961.5787981859,1204,0,191.06976744186048,34,9,18,34.73110465116279,0.6348039215686274,44.047619047619044,1023.8095238095233,30.112044817927156,0
1219,4,0,1,42,0.0,0.023255813953488372,0.9767441860465116,43,1250,1000,250,0.8,15,10,5,361.99440163069613,0.44984311554079,0.2105729873528599,0.21068172143621436,131084.19075963713,890.3486394557731,131974.5393990929,1205,1,192.06976744186048,34,9,18,34.72060761063318,0.6354166666666667,43.988095238095234,1024.0476190476186,30.119047619047606,0
1220,4,1,1,42,0.023255813953488372,0.023255813953488372,0.9767441860465116,43,1400,900,500,0.6428571428571429,19,9,10,362.40554182272234,0.44811277224067925,0.2212388218454957,0.2121018554421812,131298.4681096749,916.6584951560162,132215.1266048309,1206,0,192.90697674418604,35,8,20,34.49334180312442,0.6354166666666667,43.778935185185176,1024.8842592592578,29.282407407407366,0
1221,4,0,1,41,0.0,0.023809523809523808,0.9761904761904762,42,1150,600,550,0.5217391304347826,17,6,11,371.3976144682738,0.4464164730933024,0.2287224333338862,0.2173597595484277,131297.62081916112,1352.7246315192892,132650.3454506804,1207,1,198.1904761904762,34,8,20,34.26380338405546,0.6375612745098039,43.77976190476191,1024.8809523809534,30.14355742296922,0
1222,4,0,0,41,0.0,0.0,1.0,41,900,600,300,0.6666666666666666,12,6,6,377.89041068279175,0.44469004065040646,0.22352922957801025,0.22191550962915607,131428.2417297362,1733.1015346812405,133161.34326441746,1208,2,202.8048780487805,31,10,21,33.965211640211635,0.6461693548387097,43.65234374999999,1025.390624999999,33.07711693548384,0
1223,4,0,1,40,0.0,0.024390243902439025,0.975609756097561,41,1400,1000,400,0.7142857142857143,18,10,8,367.92540244978926,0.44433434959349594,0.2161627347572328,0.20553337970531857,129490.37606175372,1344.3313990961456,130834.70746084987,1209,3,203.8048780487805,32,9,18,36.18735268577101,0.6240234375,45.549242424242415,1017.8030303030288,31.80634469696965,7
1224,4,1,1,40,0.024390243902439025,0.024390243902439025,0.975609756097561,41,1350,1000,350,0.7407407407407407,17,10,7,364.37619447894576,0.4470020325203252,0.21746720534689978,0.20480455068989,129731.4453124998,1254.2100694444143,130985.6553819442,1210,0,198.1951219512195,33,8,20,36.03229379686432,0.6240530303030303,45.312499999999986,1018.7499999999984,30.87121212121207,0
1225,4,0,1,39,0.0,0.025,0.975,40,1100,800,300,0.7272727272727273,14,8,6,363.81476209560407,0.44564636752136755,0.2059665427509294,0.20474094352242136,129779.68606519733,1443.1531221303806,131222.8391873277,1211,1,200.7,32,8,20,35.997521685254036,0.626953125,45.26515151515151,1018.9393939393931,31.841856060606034,0
1226,4,0,0,39,0.0,0.0,1.0,39,800,500,300,0.625,11,5,6,372.96078850799154,0.4441351776878093,0.21953018220434783,0.20945242272060433,129698.2849968805,1874.474928114153,131572.75992499464,1212,2,206.23076923076923,31,8,20,35.84742106608716,0.6286962365591398,45.345052083333336,1018.6197916666672,32.85870295698926,0
1227,4,0,1,38,0.0,0.02564102564102564,0.9743589743589743,39,1650,1300,350,0.7878787878787878,20,13,7,370.33052739155016,0.443544759334233,0.2042634592455752,0.20885787956924015,129864.1289605034,1818.5302734374936,131682.65923394088,1213,3,207.23076923076923,31,8,21,35.74561403508772,0.6303763440860215,45.182291666666664,1019.2708333333327,32.87970430107525,0
1228,4,0,0,38,0.0,0.0,1.0,38,1150,700,450,0.6086956521739131,16,7,9,371.50956605570883,0.44222676623992413,0.19404870705875998,0.21023576021302842,129996.8804253473,2059.0169270833376,132055.89735243065,1214,4,207.26315789473685,31,7,21,35.58052434456928,0.6317204301075269,45.052083333333336,1019.7916666666673,32.89650537634411,0
1229,4,1,0,39,0.02564102564102564,0.0,1.0,39,1050,900,150,0.8571428571428571,12,9,3,361.8664520556704,0.4442476383265857,0.19763279464033778,0.2065218064766552,130327.04132550243,1632.1968102744538,131959.2381357769,1215,0,202.92307692307693,32,7,23,35.49111743126829,0.6324869791666667,44.72853535353535,1021.085858585858,31.908933080808062,0
1230,4,0,0,39,0.0,0.0,1.0,39,1100,700,400,0.6363636363636364,15,7,8,363.10686739231147,0.44261695906432746,0.20566061055493834,0.20791915527750818,130455.99819214868,1673.893767217628,132129.8919593663,1216,1,203.92307692307693,32,7,23,35.32860585836115,0.6337890625,44.60227272727273,1021.5909090909084,31.92471590909089,0
1231,4,0,0,39,0.0,0.0,1.0,39,1500,1000,500,0.6666666666666666,20,10,10,363.4975279422312,0.4418297345928925,0.20841689716025624,0.2084894042265398,130520.500538848,1688.7758583307775,132209.2763971788,1217,2,204.92307692307693,32,7,17,35.25320235594549,0.6344401041666667,44.53914141414141,1021.8434343434337,31.932607323232304,0
1232,4,1,1,39,0.025,0.025,0.975,40,1250,900,350,0.72,16,9,7,353.0941612896735,0.4435363247863248,0.21273042853722757,0.2051285551748214,131014.28086553248,1252.0755238369818,132266.35638936947,1218,0,200.775,33,7,19,35.019152501795546,0.6369949494949495,44.056372549019606,1023.7745098039215,31.023469994058228,0
1233,4,0,0,39,0.0,0.0,1.0,39,1100,800,300,0.7272727272727273,14,8,6,362.46841556270823,0.4406770130454341,0.2285399888063595,0.21069938220774223,131037.09323347126,1699.3615128558545,132736.4547463271,1219,1,206.84615384615384,32,7,19,34.756135158465895,0.6396484375,44.03409090909092,1023.8636363636379,31.995738636363683,0
1234,4,0,1,38,0.0,0.02564102564102564,0.9743589743589743,39,1000,600,400,0.6,14,6,8,363.4532133770725,0.43974921277552853,0.2271441529422551,0.21198389073531207,131166.40082963483,1734.5699737271864,132900.97080336203,1220,2,207.84615384615384,32,7,21,34.600076009696366,0.6409505208333333,43.90782828282829,1024.3686868686877,32.01152146464649,0
1235,4,0,0,38,0.0,0.0,1.0,38,1150,900,250,0.782608695652174,14,9,5,360.3621684684933,0.4392040066382172,0.20650566781665836,0.21071321032350815,131263.42337516593,1860.4743776145474,133123.89775278047,1221,3,204.5,32,6,21,34.58112575981603,0.6419270833333333,43.81313131313132,1024.7474747474757,32.02335858585862,0
1236,4,0,0,38,0.0,0.0,1.0,38,1200,900,300,0.75,15,9,6,360.817256415876,0.4391299193930773,0.2006631617842487,0.2115144624433572,131360.4817907612,1879.4257282420213,133239.90751900323,1222,4,205.5,32,6,21,34.47135320441763,0.6429036458333333,43.718434343434346,1025.126262626263,32.03519570707072,0
1237,4,0,0,38,0.0,0.0,1.0,38,1200,1000,200,0.8333333333333334,14,10,4,359.96784322384394,0.4390854670459934,0.20211731767542274,0.21137374221408797,131425.2073289716,1861.769685491291,133286.97701446287,1223,5,206.5,32,6,21,34.42771826129788,0.6435546875,43.65530303030304,1025.3787878787884,32.04308712121214,0
1238,4,0,0,38,0.0,0.0,1.0,38,1400,1000,400,0.7142857142857143,18,10,8,362.37884384052165,0.4392632764343291,0.1990805833986664,0.21315013385348008,131489.9488094328,1929.8351252423347,133419.78393467513,1224,6,207.5,32,6,21,34.30049448069268,0.6442057291666667,43.59217171717172,1025.6313131313138,32.05097853535356,0
1239,4,0,1,37,0.0,0.02631578947368421,0.9736842105263158,38,1400,1000,400,0.7142857142857143,18,10,8,362.75843631722626,0.4384038643907065,0.19147496617050042,0.21446278755074427,131684.268904321,1953.9158950617307,133638.18479938275,1225,7,208.5,32,6,19,34.094497068110066,0.6461588541666667,43.40277777777778,1026.3888888888891,32.074652777777786,0
1240,4,0,0,37,0.0,0.0,1.0,37,1250,1000,250,0.8,15,10,5,364.1262624637412,0.43850100100100103,0.18034857287193784,0.21582177597340682,131781.4827568615,2197.0197556371827,133978.50251249867,1226,8,211.1081081081081,32,5,19,33.96125389408102,0.6471354166666667,43.30808080808081,1026.7676767676764,32.08648989898989,0
1241,4,0,0,37,0.0,0.0,1.0,37,1950,1600,350,0.8205128205128205,23,16,7,362.5774230170924,0.4376564064064064,0.16832021895313032,0.2158224207088576,131943.5855556832,2167.953046882987,134111.5386025662,1227,9,212.1081081081081,32,5,20,33.83746057105404,0.6487630208333333,43.15025252525253,1027.398989898991,32.10621843434347,0
1242,4,0,0,37,0.0,0.0,1.0,37,700,400,300,0.5714285714285714,10,4,6,364.7182191850003,0.43681181181181183,0.17076619729530562,0.21802758741587924,132105.78799357222,2236.277548209381,134342.0655417816,1228,10,213.1081081081081,32,5,22,33.61888970768853,0.650390625,42.99242424242425,1028.0303030303041,32.125946969697004,0
1243,4,0,1,36,0.0,0.02702702702702703,0.972972972972973,37,1500,1100,400,0.7333333333333333,19,11,8,366.8762648007444,0.43674924924924924,0.17531743820403634,0.22045042814133226,132300.56244260792,2307.5872359963305,134608.14967860424,1229,11,214.1081081081081,32,5,22,33.36708394698086,0.65234375,42.803030303030305,1028.787878787879,32.14962121212122,0
1244,4,0,0,36,0.0,0.0,1.0,36,900,600,300,0.6666666666666666,12,6,6,378.8465854382844,0.4356150793650793,0.1857161947363235,0.2272216536353082,132230.5488586426,2819.0183851453994,135049.567243788,1230,12,220.41666666666666,31,5,22,33.129852934970664,0.654233870967742,42.87109375,1028.5156250000002,33.17792338709678,0
1245,4,0,0,36,0.0,0.0,1.0,36,1100,700,400,0.6363636363636364,15,7,8,373.93836196578076,0.4354497354497355,0.18321103690878582,0.21323452714071287,130294.81207274791,2550.248298220805,132845.0603709687,1231,13,221.41666666666666,32,4,20,35.215702036441584,0.6321614583333333,44.760101010101025,1020.9595959595979,31.904987373737434,8
1246,4,0,0,36,0.0,0.0,1.0,36,1600,1300,300,0.8125,19,13,6,373.28599259773057,0.4341435185185185,0.17250919975833412,0.21392565524793505,130488.24737271736,2541.886988572627,133030.13436129,1232,14,222.41666666666666,32,4,18,35.035889355742285,0.6341145833333333,44.57070707070709,1021.7171717171741,31.92866161616169,0
1247,4,0,1,35,0.0,0.027777777777777776,0.9722222222222222,36,950,500,450,0.5263157894736842,14,5,9,379.9665462114615,0.43381283068783066,0.2041116919757695,0.20766334913352935,128624.38303489437,2588.4662598204222,131212.8492947148,1233,15,223.41666666666666,32,4,20,36.7656211102813,0.615234375,46.40151515151515,1014.3939393939393,31.699810606060602,8
1248,4,1,1,35,0.027777777777777776,0.027777777777777776,0.9722222222222222,36,950,700,250,0.7368421052631579,12,7,5,383.12104727872776,0.4334656084656085,0.19710310061459846,0.21125488864683784,128976.84427928271,2682.7487309968333,131659.59301027955,1234,0,216.86111111111111,32,4,21,36.32509840480628,0.6188151041666667,46.05429292929293,1015.7828282828282,31.74321338383838,0
1249,4,1,0,36,0.027777777777777776,0.0,1.0,36,900,400,500,0.4444444444444444,14,4,10,379.1503453535721,0.4337632275132275,0.2138348686455136,0.21167422137739442,129466.28146701396,2617.6323585444193,132083.91382555838,1235,0,216.30555555555554,31,5,17,35.92630501535312,0.6263440860215054,45.57291666666667,1017.7083333333339,32.82930107526884,0
1250,4,0,0,36,0.0,0.0,1.0,36,800,500,300,0.625,11,5,6,374.74131153267996,0.4329695767195767,0.21004035753364292,0.20974247064237833,129565.68611992737,2510.723029242633,132076.40914917,1236,1,217.30555555555554,31,5,17,35.93716694376945,0.6273521505376345,45.47526041666667,1018.0989583333339,32.84190188172045,0
1251,4,0,1,35,0.0,0.027777777777777776,0.9722222222222222,36,1250,1100,150,0.88,14,11,3,376.094854577251,0.4326719576719577,0.2096879690447666,0.21147800568528505,129747.52456700857,2559.4752767574846,132306.99984376607,1237,2,218.30555555555554,32,4,18,35.71745776015203,0.6266276041666667,45.29671717171718,1018.8131313131321,31.837910353535378,0
1252,4,0,0,35,0.0,0.0,1.0,35,1050,700,350,0.6666666666666666,14,7,7,385.6772678014163,0.43161764705882355,0.22350212742645303,0.2165939171579672,129698.28499688058,3004.33603922528,132702.62103610585,1238,3,225.45714285714286,31,4,19,35.52358962887212,0.6286962365591398,45.34505208333334,1018.619791666668,32.85870295698929,0
1253,4,2,0,37,0.05405405405405406,0.0,1.0,37,1050,600,450,0.5714285714285714,15,6,9,365.94367169303933,0.4359046546546546,0.2127400712609715,0.20867563676374626,130294.81207274791,2137.3373281687227,132432.14940091662,1239,0,214.21621621621622,32,5,21,35.419758430208596,0.6321614583333333,44.760101010101025,1020.9595959595979,31.904987373737434,0
1254,4,0,0,37,0.0,0.0,1.0,37,1150,900,250,0.782608695652174,14,9,5,368.0973751166685,0.4351851851851852,0.21345038030243813,0.2107767772164874,130455.99819214885,2204.1021005509783,132660.10029269982,1240,1,215.21621621621622,32,5,22,35.201149425287355,0.6337890625,44.602272727272734,1021.5909090909099,31.924715909090935,0
1255,4,0,0,37,0.0,0.0,1.0,37,950,600,350,0.631578947368421,13,6,7,367.27996344605685,0.4345282782782783,0.21492794350290012,0.21153863043998367,130681.82615294364,2199.363266503426,132881.18941944707,1241,2,216.21621621621622,32,5,18,34.99295093438709,0.6360677083333333,44.381313131313135,1022.474747474748,31.952335858585876,0
1256,4,0,2,35,0.0,0.05405405405405406,0.9459459459459459,37,600,400,200,0.6666666666666666,8,4,4,369.79872662242974,0.4344344344344344,0.21805737614697285,0.21388144766749093,130843.25140610656,2277.133551423331,133120.3849575299,1242,3,217.21621621621622,32,5,18,34.76490188818955,0.6376953125,44.22348484848485,1023.1060606060609,31.9720643939394,0
1257,4,0,0,35,0.0,0.0,1.0,35,1250,800,450,0.64,17,8,9,389.3824618628327,0.42902661064425773,0.23806641983197707,0.22303663094343582,130468.48127312411,3160.4276867267963,133628.9089598509,1243,8,230.45714285714286,30,5,22,34.64483839845634,0.6392361111111111,44.590053763440864,1021.639784946237,34.0546594982079,0
1258,4,0,0,35,0.0,0.0,1.0,35,1150,800,350,0.6956521739130435,15,8,7,384.767658761509,0.4287464985994398,0.2289471706620574,0.22097985477511442,130571.48947855247,3047.9372615331304,133619.4267400856,1244,9,231.45714285714286,30,5,19,34.658019901806064,0.6402777777777777,44.48924731182796,1022.0430107526885,34.068100358422946,0
1259,4,0,0,35,0.0,0.0,1.0,35,1250,900,350,0.72,16,9,7,383.079455726754,0.4286414565826331,0.2279178092483376,0.2204010847396135,130640.1841975951,3009.114131691525,133649.29832928663,1245,10,232.45714285714286,30,5,19,34.631376544833024,0.6409722222222223,44.42204301075269,1022.3118279569893,34.077060931899645,0
1260,4,0,0,35,0.0,0.0,1.0,35,1000,800,200,0.8,12,8,4,379.24371590738394,0.42902661064425773,0.2207396283086165,0.21897152337292788,130777.62783269734,2919.3187073650015,133696.94654006234,1246,11,233.45714285714286,30,5,20,34.58990363556724,0.6423611111111112,44.287634408602145,1022.8494623655907,34.09498207885302,0
1261,4,1,0,36,0.027777777777777776,0.0,1.0,36,1450,1000,450,0.6896551724137931,19,10,9,365.08820976545985,0.4307208994708995,0.13455029013539654,0.19868484678815013,128454.92118415987,2179.475442137629,130634.3966262975,1247,0,227.94444444444446,33,3,19,37.3161468407479,0.6111111111111112,46.56862745098039,1013.7254901960779,30.718954248365996,8
1262,4,1,0,37,0.02702702702702703,0.0,1.0,37,1050,500,550,0.47619047619047616,16,5,11,359.6303667160643,0.4331519019019019,0.14693093656508305,0.1976113252161467,128838.54875283445,1866.8509070294779,130705.39965986394,1248,0,222.75675675675674,34,3,20,37.06271497811132,0.6127450980392157,46.19047619047619,1015.2380952380952,29.859943977591033,0
1263,4,0,1,36,0.0,0.02702702702702703,0.972972972972973,37,1450,1100,350,0.7586206896551724,18,11,7,358.5491140077027,0.4328703703703704,0.14513446999090984,0.1977698506675972,128989.67013888896,1849.8263888889,130839.49652777787,1249,1,223.75675675675674,34,3,21,36.936013125512694,0.6142769607843137,46.04166666666667,1015.8333333333339,29.877450980392176,0
1264,4,2,2,36,0.05263157894736842,0.05263157894736842,0.9473684210526316,38,950,700,250,0.7368421052631579,12,7,5,343.44659210921304,0.4372184684684685,0.12861118636553903,0.19163064421341744,129443.56575963722,1291.737528344672,130735.3032879819,1250,0,215.23684210526315,34,4,15,36.85779324598347,0.6188725490196079,45.595238095238095,1017.6190476190479,29.92997198879553,0
1265,4,1,0,37,0.02702702702702703,0.0,1.0,37,1550,1300,250,0.8387096774193549,18,13,5,350.4354047360552,0.43440315315315314,0.13285810968937573,0.19522952860979959,129383.00028344661,1668.0768140589448,131051.07709750556,1251,0,222.02702702702703,34,3,22,36.74160425930259,0.6182598039215687,45.6547619047619,1017.3809523809516,29.922969187675047,0
1266,4,0,0,37,0.0,0.0,1.0,37,800,600,200,0.75,10,6,4,350.15264621442407,0.4341841841841842,0.13431306833272139,0.19537237727421003,129443.56575963722,1665.001417233561,131108.56717687077,1252,1,223.02702702702703,34,3,16,36.687188036187806,0.6188725490196079,45.595238095238095,1017.6190476190479,29.92997198879553,0
1267,4,1,2,36,0.02631578947368421,0.05263157894736842,0.9473684210526316,38,1000,500,500,0.5,15,5,10,342.3660897361458,0.4366998577524894,0.13465206239499716,0.19257819092314948,129760.9247068972,1285.1480784893586,131046.07278538657,1253,0,218.1315789473684,35,3,18,36.56293782422659,0.6199404761904762,45.28356481481481,1018.8657407407401,29.110449735449716,0
1268,4,0,1,35,0.0,0.027777777777777776,0.9722222222222222,36,1000,700,300,0.7,13,7,6,359.4934172431348,0.4349867724867725,0.13432726007972806,0.2009389181441102,129513.0553753364,2111.818170895803,131624.8735462322,1254,1,228.36111111111111,33,3,18,36.37882253792437,0.6218434343434344,45.52696078431372,1017.892156862745,30.845216874628637,0
1269,4,0,0,35,0.0,0.0,1.0,35,900,700,200,0.7777777777777778,11,7,4,359.2293905142296,0.43326330532212887,0.11896316507503424,0.20100392614269483,129554.63927469133,2307.9668209876463,131862.606095679,1255,2,231.6,32,3,18,36.343224192814894,0.6246744791666667,45.48611111111111,1018.0555555555554,31.814236111111107,0
1270,4,0,0,35,0.0,0.0,1.0,35,1150,800,350,0.6956521739130435,15,8,7,361.30321408610894,0.4328781512605042,0.12044457029590827,0.20366197933680671,129844.02101826343,2382.6124247525727,132226.633443016,1256,3,232.6,32,3,18,35.996087297654434,0.6276041666666667,45.2020202020202,1019.1919191919192,31.849747474747474,0
1271,4,1,0,36,0.027777777777777776,0.0,1.0,36,1150,800,350,0.6956521739130435,15,8,7,351.26403218914606,0.43579695767195764,0.12786071585931635,0.19998259043756533,130232.20663265279,1949.1780045351147,132181.3846371879,1257,0,227.11111111111111,34,2,19,35.857923178601965,0.6268382352941176,44.821428571428555,1020.7142857142835,30.02100840336128,0
1272,4,0,0,36,0.0,0.0,1.0,36,1100,800,300,0.7272727272727273,14,8,6,348.3573203800371,0.4358300264550265,0.12931994458040386,0.19941655544903897,130444.94224773225,1888.2901077097276,132333.23235544199,1258,1,228.11111111111111,34,2,20,35.71650545779434,0.6289828431372548,44.61309523809523,1021.5476190476177,30.04551820728287,0
1273,4,0,0,36,0.0,0.0,1.0,36,1150,700,450,0.6086956521739131,16,7,9,349.69684233441075,0.4354828042328042,0.1255079328105182,0.2009703539680891,130597.00255102044,1933.8718820861711,132530.87443310663,1259,2,229.11111111111111,34,2,17,35.52828247534745,0.6305147058823529,44.464285714285715,1022.1428571428575,30.063025210084042,0
1274,4,1,0,37,0.02702702702702703,0.0,1.0,37,850,500,350,0.5882352941176471,12,5,7,357.3536159456137,0.4381569069069069,0.13055300993044172,0.1935217203751231,128258.57688347127,1766.7332450693889,130025.31012854066,1260,0,223.8918918918919,36,1,15,37.71284973133221,0.6027199074074074,46.762387387387385,1012.95045045045,28.1375125125125,8
1275,4,0,0,37,0.0,0.0,1.0,37,1200,1000,200,0.8333333333333334,14,10,4,355.18543209876543,0.43837587587587584,0.12263663663663671,0.1930355609232421,128401.20525931337,1721.2475144062976,130122.45277371966,1261,1,224.8918918918919,36,1,15,37.62199074074074,0.6041666666666667,46.62162162162162,1013.5135135135135,28.153153153153156,0
1276,4,0,0,37,0.0,0.0,1.0,37,1150,900,250,0.782608695652174,14,9,5,377.11680388815836,0.43825075075075076,0.10954751145631314,0.20091590173250443,127602.69451530588,2270.6038481255355,129873.29836343142,1262,2,225.8918918918919,34,3,16,37.88514787321785,0.6001838235294117,47.41071428571427,1010.3571428571408,29.71638655462179,8
1277,4,1,0,38,0.02631578947368421,0.0,1.0,38,700,500,200,0.7142857142857143,9,5,4,372.665946231906,0.4413229018492177,0.12091298695045016,0.20065215725688323,128027.370541838,1942.2882373113698,129969.65877914937,1263,0,220.92105263157896,35,3,17,37.56194724001221,0.6023809523809525,46.99074074074073,1012.0370370370359,28.915343915343882,0
1278,4,4,0,42,0.09523809523809523,0.0,1.0,42,1000,700,300,0.7,13,7,6,380.9108652154979,0.4487514518002323,0.16254448085121376,0.20348942381726867,127712.2041990833,1329.5004073627765,129041.70460644607,1264,0,200.78571428571428,38,4,17,37.67682239368636,0.5934758771929824,47.30235042735043,1010.7905982905991,26.59975258659471,8
1279,4,2,0,44,0.045454545454545456,0.0,1.0,44,1100,900,200,0.8181818181818182,13,9,4,366.5198583769094,0.4529818534178999,0.16340731141975873,0.1977936527167266,128118.80845561514,591.6175061140957,128710.42596172924,1265,0,192.61363636363637,40,4,19,37.6238037877267,0.5942708333333333,46.900406504065046,1012.3983739837406,25.309959349593516,0
1280,4,0,1,43,0.0,0.022727272727272728,0.9772727272727273,44,1400,1100,300,0.7857142857142857,17,11,6,370.9234139017278,0.4522551092318534,0.1708625097254639,0.20115720041433677,128315.61872260776,719.0637985476105,129034.68252115537,1266,1,193.61363636363637,36,8,19,37.31081656848579,0.6032986111111112,46.70608108108108,1013.1756756756758,28.143768768768773,0
1281,4,0,0,43,0.0,0.0,1.0,43,1300,1000,300,0.7692307692307693,16,10,6,404.88617730958424,0.4522425249169435,0.18508211176016753,0.20836825222517624,126193.31065759639,1753.080409939726,127946.39106753611,1267,2,189.2093023255814,34,9,18,38.63916864139021,0.5857843137254901,48.80952380952381,1004.7619047619048,29.551820728291318,8
1282,4,1,0,44,0.022727272727272728,0.0,1.0,44,1150,700,450,0.6086956521739131,16,7,9,392.41705865118024,0.45260747004933055,0.1865476925007581,0.20365859646893786,126538.26845689728,1131.1550229338097,127669.42347983108,1268,0,185.88636363636363,35,9,18,38.59582901951762,0.587202380952381,48.46643518518518,1006.1342592592591,28.746693121693117,0
1283,4,2,0,46,0.043478260869565216,0.0,1.0,46,950,600,350,0.631578947368421,13,6,7,379.5193615147926,0.45570652173913045,0.20053327721689862,0.19980786273410864,127122.02558106571,452.68094168608235,127574.70652275179,1269,0,178.7608695652174,34,12,20,38.318724668476754,0.595281862745098,47.88690476190476,1008.4523809523805,29.66036414565825,0
1284,4,0,1,45,0.0,0.021739130434782608,0.9782608695652174,46,1600,1300,300,0.8125,19,13,6,380.02802977644535,0.4557467793880838,0.20500567613983667,0.2010514287400535,127319.21744379526,476.9742715688786,127796.19171536414,1270,1,179.7608695652174,36,10,17,38.103009000967056,0.5931712962962963,47.69144144144145,1009.2342342342351,28.03428428428431,0
1285,4,0,1,44,0.0,0.022222222222222223,0.9777777777777777,45,1650,1200,450,0.7272727272727273,21,12,9,379.9368163536882,0.45614478114478113,0.20501152502044762,0.20156884588326457,127432.89531085145,683.2897086275538,128116.185019479,1271,2,183.9777777777778,36,9,18,37.98841921332442,0.5943287037037037,47.57882882882883,1009.6846846846852,28.046796796796812,0
1286,4,0,0,44,0.0,0.0,1.0,44,1250,900,350,0.72,16,9,7,388.44083472540547,0.4543362403100775,0.20746254662138197,0.20642720607879966,127500.81045310361,1105.3042481138589,128606.11470121746,1272,3,188.97727272727272,35,9,19,37.703892581557035,0.5970238095238095,47.511574074074076,1009.953703703704,28.855820105820115,0
1287,4,1,2,43,0.022222222222222223,0.044444444444444446,0.9555555555555556,45,950,300,650,0.3157894736842105,16,3,13,384.9539532228225,0.45593434343434347,0.21563072178857023,0.2064427479376349,127867.13219452163,844.5916051092873,128711.72379963093,1273,0,185.75555555555556,37,8,20,37.41552833188783,0.5968468468468469,47.149122807017555,1011.4035087719318,27.335229966808967,0
1288,4,3,2,44,0.06521739130434782,0.043478260869565216,0.9565217391304348,46,1350,1100,250,0.8148148148148148,16,11,5,364.71987033943594,0.4576489533011272,0.21097201075208183,0.19943192910049976,128644.60699445965,184.1494498306959,128828.75644429035,1274,0,176.7173913043478,37,9,18,37.13161118316759,0.6047297297297297,46.38157894736841,1014.4736842105249,27.418207681365537,0
1289,4,1,0,45,0.022222222222222223,0.0,1.0,45,1650,1200,450,0.7272727272727273,21,12,9,365.8572579047011,0.4560395622895623,0.2077116130504224,0.20019380292088684,128672.41753472216,415.1475694444398,129087.5651041666,1275,0,181.48888888888888,37,8,19,37.07434976043807,0.6050112612612613,46.354166666666664,1014.5833333333328,27.421171171171157,0
1290,4,0,0,45,0.0,0.0,1.0,45,1800,1300,500,0.7222222222222222,23,13,10,366.4162689437908,0.45519781144781146,0.20645378070585974,0.20134410885166498,128839.34389667957,441.76633675744165,129281.11023343701,1276,1,182.48888888888888,37,8,19,36.889670410771515,0.6067004504504505,46.18969298245613,1015.241228070174,27.438952110004703,0
1291,4,1,0,46,0.021739130434782608,0.0,1.0,46,1100,800,300,0.7272727272727273,14,8,6,358.9904625986825,0.4565720611916264,0.2117607898660121,0.1993579371341421,129257.13320444708,80.92357744685768,129338.05678189393,1277,0,179.5,37,9,22,36.65219969808065,0.6109234234234234,45.7785087719298,1016.8859649122771,27.48340445708857,0
1292,4,1,1,46,0.02127659574468085,0.02127659574468085,0.9787234042553191,47,1600,1300,300,0.8125,19,13,6,355.1999543460838,0.45683009559050264,0.21113187203236072,0.1990247363240751,129609.02829141983,-192.57581360949837,129416.45247781034,1278,0,176.6595744680851,38,9,15,36.39046270066098,0.6126644736842105,45.43269230769229,1018.2692307692284,26.79655870445338,0
1293,4,0,0,46,0.0,0.0,1.0,46,1200,900,300,0.75,15,9,6,362.6880179032723,0.45563607085346214,0.20902289783287542,0.20327601824186375,129619.7643145003,202.30708006306025,129822.07139456336,1279,1,181.04347826086956,37,9,15,36.18891550913462,0.6145833333333333,45.422149122807,1018.3114035087694,27.521929824561337,0
1294,4,1,1,46,0.02127659574468085,0.02127659574468085,0.9787234042553191,47,1300,1100,200,0.8461538461538461,15,11,4,355.5074516124733,0.45656028368794327,0.20597545968504294,0.20100492406335532,129962.83512309122,-159.4487362115853,129803.38638687963,1280,0,178.17021276595744,38,9,19,36.02306859457951,0.6162280701754386,45.08547008547007,1019.6581196581171,26.833108412055715,0
1295,4,0,1,45,0.0,0.021739130434782608,0.9782608695652174,46,1200,600,600,0.5,18,6,12,360.6394473887683,0.45490136876006443,0.20614757165307185,0.20342865915813033,129871.11418898107,167.32937057554363,130038.44355955662,1281,1,182.80434782608697,37,9,19,35.98545969592656,0.6171171171171171,45.17543859649122,1019.2982456140339,27.548601232811727,0
1296,4,0,3,42,0.0,0.06666666666666667,0.9333333333333333,45,1300,900,400,0.6923076923076923,17,9,8,365.1346406129598,0.4540614478114478,0.19519619033592317,0.20621109803300852,129917.93894823888,487.5079894083394,130405.44693764723,1282,2,185.0222222222222,36,9,19,35.82329982694504,0.6195023148148149,45.12950450450451,1019.4819819819827,28.318943943943964,0
1297,4,0,0,42,0.0,0.0,1.0,42,1250,800,450,0.64,17,8,9,381.80365333092794,0.45274390243902435,0.20786006360745168,0.21492323298756313,129790.40745027429,1510.8903463648755,131301.29779663918,1283,3,197.16666666666666,35,7,20,35.528358321974856,0.6202380952380953,45.254629629629626,1018.981481481481,29.1137566137566,0
1298,4,0,4,38,0.0,0.09523809523809523,0.9047619047619048,42,1600,1300,300,0.8125,19,13,6,385.7233178150737,0.4523567557104142,0.2128256708088645,0.21745707661200614,129849.38298396765,1617.186964163223,131466.56994813087,1284,4,198.16666666666666,35,7,20,35.368404118404115,0.6208333333333333,45.19675925925925,1019.2129629629619,29.120370370370342,0
1299,4,0,0,38,0.0,0.0,1.0,38,800,600,200,0.75,10,6,4,402.781370919561,0.44979848269321954,0.20266389028505793,0.22537308769773903,129554.63927469128,2836.439043209868,132391.07831790115,1285,5,208.02631578947367,32,6,20,35.23476580263756,0.6246744791666667,45.48611111111111,1018.055555555555,31.814236111111093,0
1300,4,0,1,37,0.0,0.02631578947368421,0.9736842105263158,38,1050,500,550,0.47619047619047616,16,5,11,398.9685122686932,0.45006519677572304,0.19781370495782014,0.22397209383935637,129683.21352731877,2747.9037534435397,132431.11728076232,1286,6,209.02631578947367,32,6,20,35.200508243461016,0.6259765625,45.35984848484849,1018.5606060606071,31.830018939393973,0
1301,4,0,0,37,0.0,0.0,1.0,37,1150,700,450,0.6086956521739131,16,7,9,411.1702928360626,0.4480730730730731,0.1749983458526172,0.21931908197255556,127650.62332153333,3108.8866052548897,130759.50992678822,1287,7,215.1081081081081,31,6,18,36.97560988704205,0.6078629032258065,47.36328125000001,1010.546875000001,32.59828629032261,8
1302,4,2,0,39,0.05128205128205128,0.0,1.0,39,1000,600,400,0.6,14,6,8,360.21900245079667,0.45088281601439495,0.17524997044531143,0.19154354956125594,127524.8777513457,1413.829656510763,128938.70740785646,1288,0,205.02564102564102,33,6,19,38.391773841300655,0.6016414141414141,47.48774509803922,1010.0490196078437,30.607546048722536,8
1303,4,0,2,37,0.0,0.05128205128205128,0.9487179487179487,39,950,700,250,0.7368421052631579,12,7,5,347.6538487808208,0.4506860098965362,0.06081796990887889,0.18289615522817107,127092.01388888898,1036.8055555555661,128128.81944444454,1289,1,206.02564102564102,38,1,16,39.152892561983464,0.587171052631579,47.91666666666667,1008.3333333333342,26.535087719298268,7
1304,4,4,2,39,0.0975609756097561,0.04878048780487805,0.9512195121951219,41,1200,700,500,0.5833333333333334,17,7,10,322.5723346668272,0.4548780487804878,0.08004900139573667,0.17373130840481646,128039.08420138883,60.3732638888855,128099.45746527772,1290,0,195.9512195121951,39,2,15,38.81741457389872,0.5950854700854701,46.979166666666664,1012.0833333333328,25.950854700854688,0
1305,4,1,1,39,0.025,0.025,0.975,40,1350,900,450,0.6666666666666666,18,9,9,326.4083981111264,0.45202991452991453,0.08670628794895574,0.17591294533809307,128065.44189453138,360.3271484375157,128425.7690429689,1291,0,201.825,39,1,17,38.69346248842236,0.5953525641025641,46.95312500000001,1012.187500000001,25.953525641025667,0
1306,4,0,0,39,0.0,0.0,1.0,39,1200,800,400,0.6666666666666666,16,8,8,329.7000923530167,0.4494770580296896,0.08444004286131745,0.17791788582785828,128117.48940755372,648.0696179414338,128765.55902549515,1292,1,207.92307692307693,38,1,17,38.55705642324469,0.5975877192982456,46.90170940170941,1012.3931623931641,26.641925326135897,0
1307,4,2,1,40,0.04878048780487805,0.024390243902439025,0.975609756097561,41,1250,800,450,0.64,17,8,9,318.1337667195324,0.45185467479674796,0.09384446242039135,0.17396433206521794,128645.99745008713,-14.669997993906179,128631.32745209323,1293,0,198.73170731707316,39,2,15,38.311706369579355,0.6012286324786325,46.38020833333335,1014.4791666666692,26.01228632478639,0
1308,4,2,1,41,0.047619047619047616,0.023809523809523808,0.9761904761904762,42,750,400,350,0.5333333333333333,11,4,7,311.3554852691674,0.45228416569879987,0.11491304534217406,0.17187304175791693,129020.64252635706,-365.74304729323967,128654.89947906381,1294,0,194.95238095238096,40,2,17,38.103097595945464,0.6033854166666667,46.011178861788636,1015.9552845528486,25.398882113821216,0
1309,4,0,1,40,0.0,0.024390243902439025,0.975609756097561,41,700,500,200,0.7142857142857143,9,5,4,315.8072998484748,0.4514989837398374,0.1073761040143475,0.1740778395038148,128963.21750217046,-54.494900173576156,128908.72260199688,1295,1,200.3170731707317,39,2,17,38.0483411957748,0.6044337606837606,46.06770833333335,1015.7291666666692,26.044337606837672,0
1310,4,0,1,39,0.0,0.025,0.975,40,1400,1100,300,0.7857142857142857,17,11,6,324.869927179924,0.44918536324786323,0.10380429067199515,0.17929124419929754,129011.3768924867,382.38332328877885,129393.76021577549,1296,2,205.575,38,2,17,37.76926245311461,0.6066337719298245,46.02029914529915,1015.9188034188037,26.73470535312641,0
1311,4,1,0,40,0.025,0.0,1.0,40,800,300,500,0.375,13,3,10,329.21070460469076,0.44961271367521366,0.12216356760163882,0.18293967875843833,129282.86540516102,512.2606426692888,129795.12604783032,1297,0,206.35,38,2,19,37.38312847988234,0.609375,45.753205128205124,1016.9871794871791,26.762820512820504,0
1312,4,0,1,39,0.0,0.025,0.975,40,1000,700,300,0.7,13,7,6,362.78321748861936,0.44913194444444443,0.1510819206065075,0.19857937847201254,128685.96734832713,1337.0218560523056,130022.98920437944,1298,1,207.35,38,2,14,37.138482327752605,0.6033442982456141,46.340811965811966,1014.6367521367522,26.70096716149348,8
1313,4,2,0,41,0.04878048780487805,0.0,1.0,41,1350,800,550,0.5925925925925926,19,8,11,354.99938130533263,0.44964430894308943,0.16341838456826419,0.19620504048915144,129069.0443250869,963.8861762152878,130032.93050130218,1299,0,203.14634146341464,39,2,16,36.945263112933546,0.6055021367521367,45.96354166666667,1016.1458333333342,26.055021367521388,0
1314,4,0,0,41,0.0,0.0,1.0,41,1350,1100,250,0.8148148148148148,16,11,5,335.16846991914156,0.44989837398373983,0.11495500966192296,0.18123570601046987,128198.62349559844,478.4661637394518,128677.08965933789,1300,1,204.14634146341464,38,3,18,38.33583887189224,0.5984100877192983,46.821581196581185,1012.7136752136735,26.65035987404404,7
1315,4,0,1,40,0.0,0.024390243902439025,0.975609756097561,41,650,400,250,0.6153846153846154,9,4,5,333.474202852107,0.4498475609756098,0.11401667181228747,0.1804415207213454,128225.67389875073,351.9908777120179,128577.66477646274,1301,2,205.14634146341464,38,3,18,38.351133966244724,0.5986842105263157,46.79487179487179,1012.820512820512,26.653171390013473,0
1316,4,0,1,39,0.0,0.025,0.975,40,1150,900,250,0.782608695652174,14,9,5,340.74766664687104,0.44867788461538466,0.12099437046660144,0.18438700625759483,128227.8095784278,738.6653826177051,128966.4749610455,1302,3,211.025,37,3,18,38.16478564468983,0.6005067567567568,46.792763157894726,1012.8289473684197,27.37375533428161,0
1317,4,0,0,39,0.0,0.0,1.0,39,1300,900,400,0.6923076923076923,17,9,8,347.02665225430326,0.44798695456590193,0.13206002425614938,0.1880457032362173,128283.34349270917,1103.5478464527355,129386.89133916191,1303,4,216.5897435897436,37,2,18,37.949070065302855,0.6010698198198199,46.73793859649122,1013.0482456140342,27.379682313892815,0
1318,4,0,1,38,0.0,0.02564102564102564,0.9743589743589743,39,950,800,150,0.8421052631578947,11,8,3,344.8089145917596,0.4477058029689609,0.13431779777413322,0.1871038860682589,128338.88942992066,1050.4786328485538,129389.36806276921,1304,5,217.5897435897436,37,2,18,37.94852198535511,0.6016328828828829,46.68311403508771,1013.2675438596484,27.38560929350401,0
1319,4,0,0,38,0.0,0.0,1.0,38,900,600,300,0.6666666666666666,12,6,6,337.85925612848695,0.44707207207207206,0.1424956622325042,0.18085407239818993,127793.20987654307,1035.223765432082,128828.43364197515,1305,6,221.68421052631578,38,0,14,38.681891025641015,0.5942982456140351,47.222222222222214,1011.1111111111101,26.608187134502895,7
1320,4,3,2,39,0.07317073170731707,0.04878048780487805,0.9512195121951219,41,1300,900,400,0.6923076923076923,17,9,8,319.5721523738039,0.45248983739837395,0.1545606414968259,0.17409527703946004,128496.33487654295,12.77006172836667,128509.10493827132,1306,0,206.390243902439,41,0,13,38.42751141552511,0.5965447154471545,46.527777777777764,1013.8888888888869,24.72899728997285,0
1321,4,0,1,38,0.0,0.02564102564102564,0.9743589743589743,39,1500,1200,300,0.8,18,12,6,333.97717833033977,0.4488304093567252,0.16033882124594867,0.18070451335035576,128223.64501953124,764.7542317708333,128988.39925130206,1307,1,217.97435897435898,39,0,17,38.340468476807565,0.5969551282051282,46.796875,1012.8124999999999,25.969551282051277,0
1322,4,1,0,39,0.02564102564102564,0.0,1.0,39,1050,700,350,0.6666666666666666,14,7,7,332.42520998259306,0.4497300944669366,0.158131517983507,0.18057871959355953,128381.9458007814,735.4790581597368,129117.42485894113,1308,0,218.51282051282053,39,0,15,38.21832065645663,0.5985576923076923,46.64062500000001,1013.4375000000011,25.98557692307695,0
1323,4,0,1,38,0.0,0.02564102564102564,0.9743589743589743,39,1300,1000,300,0.7692307692307693,16,10,6,347.97667841785085,0.4488304093567252,0.07421639244025902,0.18902652732145542,128381.94580078112,1134.7846137152624,129516.73041449639,1309,1,219.51282051282053,39,0,10,37.82430962414774,0.5985576923076923,46.64062499999999,1013.437499999999,25.9855769230769,8
1324,4,1,1,38,0.02564102564102564,0.02564102564102564,0.9743589743589743,39,1250,800,450,0.64,17,8,9,349.22359273129075,0.44891475483580745,0.01047242845093277,0.18561445543265562,127506.962779413,1152.7853672524361,128659.74814666544,1310,0,220.46153846153845,37,2,17,38.68777819997828,0.5931869369369369,47.505482456140356,1009.9780701754395,27.296704599336202,8
1325,4,0,0,38,0.0,0.0,1.0,38,1400,1000,400,0.7142857142857143,18,10,8,363.7989847086255,0.4467609056424846,0.030344888522369162,0.18887530089317697,126553.2186536201,1607.986491559158,128161.20514517926,1311,1,226.92105263157896,36,2,15,39.3002704719269,0.5853587962962963,48.45157657657659,1006.1936936936959,27.949824824824887,7
1326,4,1,0,39,0.02564102564102564,0.0,1.0,39,1050,600,450,0.5714285714285714,15,6,9,360.9814386155683,0.4484649122807018,0.05142715230864159,0.18900617888538235,126898.60251471614,1361.6080188134902,128260.21053352964,1312,0,222.07692307692307,37,2,16,39.0157389269779,0.5869932432432432,48.10855263157895,1007.5657894736848,27.231507823613104,0
1327,4,0,1,38,0.0,0.02564102564102564,0.9743589743589743,39,1300,1000,300,0.7692307692307693,16,10,6,363.7656568062313,0.4478463787674314,0.04992092645742141,0.19098216350769226,127009.10526556279,1440.310119459866,128449.41538502266,1313,1,223.07692307692307,37,2,16,38.8319690706697,0.5881193693693694,47.998903508771946,1008.0043859649147,27.24336178283553,0
1328,4,3,2,39,0.07317073170731707,0.04878048780487805,0.9512195121951219,41,1000,500,500,0.5,15,5,10,338.5271841027461,0.4520579268292683,0.06474780164965543,0.18067197775767307,127673.13169677221,444.21925496307426,128117.35095173528,1314,0,211.53658536585365,37,4,17,38.78781508806191,0.5948761261261262,47.34100877192983,1010.6359649122818,27.314485538169777,0
1329,4,2,1,40,0.04878048780487805,0.024390243902439025,0.975609756097561,41,1100,800,300,0.7272727272727273,14,8,6,340.88886262292175,0.4509146341463415,0.08481726633528242,0.18321325363445357,127955.29827781444,523.7072193001836,128479.00549711462,1315,0,212.4878048780488,38,3,19,38.43958993312215,0.5959429824561404,47.06196581196582,1011.7521367521379,26.625056230319416,0
1330,4,0,1,39,0.0,0.025,0.975,40,550,400,150,0.7272727272727273,7,4,3,369.9917141699739,0.4490518162393162,0.11683921341816128,0.18564006784674517,125144.7177881728,1348.3944959291377,126493.11228410194,1316,1,218.25,35,5,20,40.60017833044148,0.5729166666666667,49.85532407407406,1000.578703703702,28.587962962962916,8
1331,4,3,1,41,0.07142857142857142,0.023809523809523808,0.9761904761904762,42,900,700,200,0.7777777777777778,11,7,4,344.29793343475046,0.453397212543554,0.13236777414531598,0.17608487123677077,125936.57687057117,271.9406320768435,126208.51750264801,1317,0,207.54761904761904,38,4,20,40.4255366329608,0.5753837719298245,49.06517094017094,1003.7393162393155,26.414192532613566,0
1332,4,2,1,42,0.046511627906976744,0.023255813953488372,0.9767441860465116,43,1000,600,400,0.6,14,6,8,334.9127323507825,0.4552417866371355,0.14839279191525634,0.1728873834567549,126319.25207756207,-138.7235134454284,126180.52856411664,1318,0,203.6046511627907,37,6,15,40.26732475276323,0.5810810810810811,48.68421052631577,1005.2631578947347,27.169274537695532,0
1333,4,2,4,40,0.045454545454545456,0.09090909090909091,0.9090909090909091,44,1200,700,500,0.5833333333333334,17,7,10,328.3263039636988,0.45636231501057084,0.16059047031254536,0.17147546080142864,126795.9347491598,-473.9118772372137,126322.02287192259,1319,0,199.9318181818182,38,6,19,39.94355751211058,0.5841557017543859,48.21047008547008,1007.1581196581188,26.504161043634706,0
1334,4,4,0,44,0.09090909090909091,0.0,1.0,44,1500,1300,200,0.8666666666666667,17,13,4,331.2827248376978,0.4586967054263566,0.18873455007508366,0.17497953318608572,127253.65713346457,-368.6123438527605,126885.04478961181,1320,0,199.63636363636363,38,6,23,39.400015883100366,0.5888157894736843,47.75641025641024,1008.974358974357,26.551956815114657,0
1335,4,1,2,43,0.022222222222222223,0.044444444444444446,0.9555555555555556,45,1450,1200,250,0.8275862068965517,17,12,5,325.6590543738243,0.4590277777777778,0.19505689044721808,0.17322632201113353,127538.80343966973,-693.1667751736504,126845.63666449608,1321,0,196.17777777777778,39,6,16,39.2502191399402,0.5900106837606838,47.473958333333314,1010.1041666666633,25.900106837606753,0
1336,4,0,1,42,0.0,0.023255813953488372,0.9767441860465116,43,1700,1300,400,0.7647058823529411,21,13,8,342.5363507424888,0.45498800295311925,0.18977431151880042,0.18168633166110806,127423.91889812243,129.46483533393837,127553.38373345637,1322,1,206.25581395348837,37,6,18,38.94168114682882,0.5923423423423424,47.58771929824561,1009.649122807017,27.287814129919376,0
1337,4,1,0,43,0.023255813953488372,0.0,1.0,43,950,600,350,0.631578947368421,13,6,7,335.58207100063316,0.4550110741971207,0.19228304581026978,0.1792233795181828,127700.8370363958,-29.17772776239326,127671.6593086334,1323,0,205.88372093023256,37,6,19,38.83389383091053,0.5951576576576576,47.31359649122807,1010.7456140350876,27.31744902797534,0
1338,4,4,4,43,0.0851063829787234,0.0851063829787234,0.9148936170212766,47,1600,1100,500,0.6875,21,11,10,310.3057948844164,0.45804424915201974,0.20474488848091466,0.16923400073948433,128540.34423828137,-1421.0983262277678,127119.2459120536,1324,0,189.27659574468086,39,8,13,38.61763824687554,0.6001602564102564,46.48437500000001,1014.0625000000009,26.001602564102587,0
1339,4,1,1,43,0.022727272727272728,0.022727272727272728,0.9772727272727273,44,1250,900,350,0.72,16,9,7,332.8815111466079,0.4577717582804792,0.21731596920527796,0.1806554787272121,128344.1443977761,-255.32145320997165,128088.82294456613,1325,0,196.38636363636363,36,8,21,38.24530451211381,0.603587962962963,46.677927927927925,1013.2882882882878,28.146896896896884,0
1340,4,0,0,43,0.0,0.0,1.0,43,1400,1000,400,0.7142857142857143,18,10,8,339.448883711658,0.45697212993724623,0.206555860718318,0.18461506962469104,128429.74044568236,119.06640593298374,128548.80685161534,1326,1,201.72093023255815,36,7,17,37.99161204310633,0.6044560185185186,46.59346846846848,1013.6261261261276,28.156281281281323,0
1341,4,2,2,43,0.044444444444444446,0.044444444444444446,0.9555555555555556,45,1100,600,500,0.5454545454545454,16,6,10,328.5395297577412,0.45814393939393944,0.21981686483531493,0.1817024746211181,129095.5078125,-517.4045138888887,128578.10329861111,1327,0,193.7111111111111,39,6,19,37.59054257209239,0.6057692307692308,45.9375,1016.25,26.057692307692307,0
1342,4,1,1,43,0.022727272727272728,0.022727272727272728,0.9772727272727273,44,1450,1100,350,0.7586206896551724,18,11,7,338.2133455628951,0.4574524312896406,0.23833710607457936,0.1874289630521462,129174.91455078125,-62.2639973958332,129112.65055338542,1328,0,198.86363636363637,39,5,21,37.263999897530475,0.6065705128205128,45.859375,1016.5625,26.065705128205128,0
1343,4,2,0,45,0.044444444444444446,0.0,1.0,45,1450,1200,250,0.8275862068965517,17,12,5,323.5468475553323,0.4587962962962963,0.24196111663780462,0.18192220819347998,129745.78622118742,-604.2211262148992,129141.56509497252,1329,0,191.86666666666667,36,9,19,37.05763420655096,0.6177662037037037,45.29842342342342,1018.8063063063064,28.300175175175177,0
1344,4,0,0,45,0.0,0.0,1.0,45,1300,1000,300,0.7692307692307693,16,10,6,320.99532981288723,0.45888047138047133,0.23279066912216106,0.18088466592818367,129831.84831791247,-664.9166057949876,129166.93171211748,1330,1,192.86666666666667,36,9,19,37.035451197053405,0.6186342592592593,45.21396396396396,1019.144144144144,28.309559559559556,0
1345,4,0,0,45,0.0,0.0,1.0,45,1100,500,600,0.45454545454545453,17,5,12,320.0293611767775,0.45869107744107745,0.2271114056402328,0.18087052659766192,129946.6421658145,-682.6518241214123,129263.99034169309,1331,2,193.86666666666667,36,9,20,36.94384618216626,0.6197916666666667,45.101351351351354,1019.5945945945949,28.322072072072082,0
1346,4,0,1,44,0.0,0.022222222222222223,0.9777777777777777,45,1200,600,600,0.5,18,6,12,320.4888025735817,0.4586489898989899,0.22542344537614456,0.18155827293175716,130038.81602993204,-664.803112496174,129374.01291743587,1332,3,194.86666666666667,37,8,20,36.838851859815115,0.6188063063063063,45.01096491228069,1019.9561403508752,27.566382171645277,0
1347,4,0,1,43,0.0,0.022727272727272728,0.9772727272727273,44,1250,800,450,0.64,17,8,9,324.35649251872326,0.45792591613812544,0.22070428191355784,0.18345084570624856,129975.34855379032,-368.33036583881056,129607.0181879515,1333,4,199.54545454545453,36,8,20,36.80448187005338,0.6200810185185186,45.0731981981982,1019.7072072072076,28.32520020020021,0
1348,4,0,0,43,0.0,0.0,1.0,43,1200,500,700,0.4166666666666667,19,5,14,333.3895456507695,0.4559339239571798,0.22285922706654127,0.18842128254195195,129946.64216581463,64.57039810082378,130011.21256391545,1334,5,204.97674418604652,36,7,20,36.603296885354546,0.6197916666666667,45.10135135135136,1019.594594594596,28.32207207207211,0
1349,4,0,1,42,0.0,0.023255813953488372,0.9767441860465116,43,1100,700,400,0.6363636363636364,15,7,8,352.00107928041075,0.45586471022517533,0.15936854373046527,0.19462024408576833,129083.7459276404,488.29081364895967,129572.03674128935,1335,6,205.97674418604652,35,8,19,37.006454062262705,0.6130952380952381,45.94907407407406,1016.2037037037021,29.03439153439149,8
1350,4,0,1,41,0.0,0.023809523809523808,0.9761904761904762,42,1350,900,450,0.6666666666666666,18,9,9,355.4152109647946,0.45449816105303914,0.16022638563622182,0.19709388971684041,129201.3888888888,784.0277777777676,129985.41666666657,1336,7,211.73809523809524,34,8,19,36.799863387978135,0.616421568627451,45.83333333333333,1016.666666666666,29.901960784313705,0
1351,4,0,0,41,0.0,0.0,1.0,41,1150,800,350,0.6956521739130435,15,8,7,358.79161842753825,0.4542428861788618,0.15745332576864368,0.19912334836744391,129232.53864198869,1073.5103385717055,130306.0489805604,1337,8,214.21951219512195,33,8,19,36.68230987103771,0.6190025252525253,45.802696078431374,1016.7892156862748,30.8117944147356,0
1352,4,0,0,41,0.0,0.0,1.0,41,1400,1000,400,0.7142857142857143,18,10,8,359.39536415051145,0.4537093495934959,0.15104206450399826,0.20024834316627826,129388.34372597079,1100.3141820453643,130488.65790801615,1338,9,215.21951219512195,33,8,19,36.5082710993335,0.6205808080808081,45.64950980392157,1017.4019607843138,30.83036244800951,0
1353,4,2,1,42,0.046511627906976744,0.023255813953488372,0.9767441860465116,43,1100,800,300,0.7272727272727273,14,8,6,343.9449925533251,0.45625692137320045,0.1644749341453262,0.19495955835719805,130061.48674011882,346.7994176609336,130408.28615777976,1339,0,206.1627906976744,36,7,19,36.217754103186856,0.6209490740740741,44.98873873873875,1020.0450450450477,28.334584584584658,0
1354,4,0,2,40,0.0,0.047619047619047616,0.9523809523809523,42,1350,1000,350,0.7407407407407407,17,10,7,349.93285971697804,0.4545949477351916,0.16102436888953764,0.1980255894005325,129996.88042534713,698.0360243055457,130694.91644965268,1340,1,211.61904761904762,35,7,20,36.13061797752808,0.6223214285714286,45.05208333333333,1019.7916666666658,29.136904761904738,0
1355,4,0,1,39,0.0,0.025,0.975,40,1000,700,300,0.7,13,7,6,363.2074194844757,0.45367254273504276,0.16208513708513705,0.20463637536808252,129825.09731833899,1430.6877162629576,131255.78503460195,1341,2,193.375,33,7,20,35.96681096681096,0.625,45.22058823529411,1019.1176470588226,30.882352941176443,0
1356,4,1,1,39,0.025,0.025,0.975,40,1400,900,500,0.6428571428571429,19,9,10,355.3519366930446,0.453525641025641,0.17132653061224534,0.20246796392975797,130262.58680555549,1258.54839484813,131521.13520040363,1342,0,192.675,33,7,21,35.72278911564625,0.6294191919191919,44.791666666666664,1020.8333333333328,30.93434343434342,0
1357,4,0,0,39,0.0,0.0,1.0,39,1100,500,600,0.45454545454545453,17,5,12,371.479273472602,0.45479082321187586,0.16415240212897886,0.20172480709682714,128368.35048719522,1806.6807596163742,130175.03124681159,1343,1,194.76923076923077,32,7,18,37.242763103247796,0.6126302083333333,46.65404040404041,1013.3838383838387,31.66824494949496,8
1358,4,1,1,39,0.025,0.025,0.975,40,1200,700,500,0.5833333333333334,17,7,10,364.0952170601306,0.4551014957264958,0.16065814171750392,0.19945678857458565,128717.71541950115,1373.10090702948,130090.81632653064,1344,0,190.875,34,6,19,37.07277491005788,0.6115196078431373,46.30952380952381,1014.7619047619048,29.84593837535014,0
1359,4,0,1,38,0.0,0.02564102564102564,0.9743589743589743,39,1000,500,500,0.5,15,5,10,358.3815954748804,0.4544815564552407,0.15751088819834425,0.18798380342567156,126972.0025510205,1300.885770975069,128272.88832199558,1345,1,196.71794871794873,34,5,18,39.00577801401685,0.59375,48.03571428571429,1007.8571428571436,29.642857142857164,8
1360,4,2,1,39,0.05,0.025,0.975,40,1400,1100,300,0.7857142857142857,17,11,6,348.3505155505296,0.4573851495726496,0.1665902841429885,0.18539044510518443,127559.26354595346,887.0670438957593,128446.33058984923,1346,0,190.45,35,5,18,38.65624045218455,0.5976190476190476,47.45370370370371,1010.185185185186,28.862433862433885,0
1361,4,2,1,40,0.04878048780487805,0.024390243902439025,0.975609756097561,41,1300,1100,200,0.8461538461538461,15,11,4,341.2081544658882,0.4580538617886179,0.18053702576324748,0.176801033257916,126473.33311646194,430.7465163634831,126904.07963282542,1347,0,186.09756097560975,38,3,16,39.95065498318285,0.5808662280701755,48.530982905982896,1005.876068376067,26.470422852001764,8
1362,4,0,0,40,0.0,0.0,1.0,40,900,600,300,0.6666666666666666,12,6,6,347.24108950381583,0.4566773504273504,0.18795387634936223,0.1796135381748163,126401.93527094866,778.3891437749958,127180.32441472365,1348,1,191.55,37,3,16,39.87240122851015,0.5819256756756757,48.60197368421052,1005.5921052631571,27.178165007112355,0
1363,4,1,0,41,0.024390243902439025,0.0,1.0,41,1250,800,450,0.64,17,8,9,337.0932654684428,0.4569105691056911,0.1909611712285173,0.17593804652854586,126769.03558514122,346.5976331360845,127115.6332182773,1349,0,187.85365853658536,38,3,17,39.7504243581583,0.5838815789473684,48.23717948717948,1007.051282051281,26.501349527665287,0
1364,4,1,4,38,0.023809523809523808,0.09523809523809523,0.9047619047619048,42,1100,800,300,0.7272727272727273,14,8,6,334.4914933837429,0.45753484320557486,0.201159420289855,0.17645193458316727,127202.60080024638,110.45940853901459,127313.06020878539,1350,0,184.35714285714286,37,5,19,39.371376811594196,0.5900900900900901,47.80701754385966,1008.7719298245627,27.264106211474665,0
1365,4,2,0,40,0.05,0.0,1.0,40,900,600,300,0.6666666666666666,12,6,6,342.7818930008432,0.4572248931623932,0.20488742755238532,0.18262702755365606,127603.50722343972,748.034351919494,128351.54157535922,1351,0,183.475,36,4,18,38.75157898647643,0.5960648148148149,47.40990990990991,1010.3603603603609,28.06556556556558,0
1366,4,2,1,41,0.047619047619047616,0.023809523809523808,0.9761904761904762,42,1700,1200,500,0.7058823529411765,22,12,10,336.47177920572676,0.4594584785133566,0.2260732703770687,0.18283413610808502,128394.44739006208,241.36614514091423,128635.813535203,1352,0,175.6904761904762,37,5,18,38.10304644956543,0.6021959459459459,46.6282894736842,1013.4868421052611,27.391536273115165,0
1367,4,0,0,41,0.0,0.0,1.0,41,1850,1500,350,0.8108108108108109,22,15,7,338.2686094868019,0.45914634146341465,0.22268387481209628,0.18450083757896119,128543.91289515857,496.4741346075689,129040.38702976615,1353,1,180.390243902439,36,5,18,37.90509901906348,0.6056134259259259,46.48085585585585,1014.0765765765758,28.16879379379377,0
1368,4,0,0,41,0.0,0.0,1.0,41,1250,800,450,0.64,17,8,9,339.84652443481036,0.4579014227642277,0.22143083297026278,0.18642950241819484,128772.40997331774,552.5711945052933,129324.98116782303,1354,2,181.390243902439,36,5,18,37.63221642812233,0.6079282407407407,46.25563063063062,1014.977477477476,28.193818818818777,0
1369,4,1,0,42,0.023809523809523808,0.0,1.0,42,1200,900,300,0.75,15,9,6,380.84948981039884,0.459361691831204,0.21867426475404517,0.20210042269500686,127442.37075617258,1425.1922389731753,128867.56299514575,1355,0,178.04761904761904,35,7,17,37.95563961485557,0.5964285714285714,47.56944444444443,1009.72222222222,28.849206349206288,8
1370,4,0,0,42,0.0,0.0,1.0,42,1150,800,350,0.6956521739130435,15,8,7,381.6325991348184,0.45903503677893925,0.21835674448555498,0.2028091388581256,127500.81045310339,1331.6931370027191,128832.5035901061,1356,1,179.04761904761904,35,7,17,37.875792650317045,0.5970238095238095,47.51157407407406,1009.9537037037023,28.855820105820065,0
1371,4,4,1,45,0.08695652173913043,0.021739130434782608,0.9782608695652174,46,1550,1200,350,0.7741935483870968,19,12,7,355.518900371893,0.46108091787439615,0.24423281119327966,0.1946728937302658,128700.23108071688,-45.685261300753126,128654.54581941613,1357,0,164.3913043478261,37,9,19,37.30819105251781,0.6052927927927928,46.3267543859649,1014.6929824561382,27.42413466097671,0
1372,4,0,0,45,0.0,0.0,1.0,45,1400,1100,300,0.7857142857142857,17,11,6,359.0851858787047,0.45925925925925926,0.2555038072004141,0.19769415178596794,128915.32368517142,258.3165936206145,129173.64027879204,1358,1,168.8,36,9,19,36.99822577068085,0.609375,46.11486486486485,1015.5405405405386,28.209459459459406,0
1373,4,0,2,43,0.0,0.044444444444444446,0.9555555555555556,45,1700,1200,500,0.7058823529411765,22,12,10,389.4960575633034,0.45890151515151517,0.22218841682060209,0.2058892715539965,127285.57254395576,967.1898386311575,128252.76238258691,1359,2,169.8,37,8,17,37.89876036799595,0.5909346846846847,47.72478070175438,1009.1008771929819,27.272996680891403,8
1374,4,0,1,42,0.0,0.023255813953488372,0.9767441860465116,43,1350,800,550,0.5925925925925926,19,8,11,405.19469523101145,0.4580564784053156,0.22662741319439816,0.21332092927781282,127121.19187510715,1701.766519847391,128822.95839495453,1360,3,178.30232558139534,35,8,17,37.67227610084549,0.5931547619047619,47.88773148148148,1008.4490740740739,28.812830687830683,0
1375,4,3,4,41,0.06666666666666667,0.08888888888888889,0.9111111111111111,45,1300,1100,200,0.8461538461538461,15,11,4,395.9053840463329,0.4601010101010101,0.2443810931615813,0.21292560433292565,127982.32299884951,1133.7781476002745,129116.10114644979,1361,0,171.06666666666666,38,7,17,37.020246014148476,0.596217105263158,47.035256410256416,1011.8589743589749,26.627867746288814,0
1376,4,2,3,40,0.046511627906976744,0.06976744186046512,0.9302325581395349,43,1100,800,300,0.7272727272727273,14,8,6,404.27606044124366,0.4585871170173496,0.2654048760134218,0.21953448315977134,128368.35048719512,1779.866574869483,130148.21706206459,1362,0,177.2325581395349,32,11,16,36.411869756624306,0.6126302083333333,46.6540404040404,1013.3838383838379,31.668244949494934,0
1377,4,1,1,40,0.024390243902439025,0.024390243902439025,0.975609756097561,41,1500,900,600,0.6,21,9,12,424.56265135734697,0.45673272357723577,0.2780287062129876,0.22926383173296758,128144.53125000013,2681.076388888904,130825.60763888904,1363,0,186.4878048780488,36,5,19,36.12825788751715,0.6015625,46.87500000000001,1012.500000000001,28.12500000000003,0
1378,4,1,1,40,0.024390243902439025,0.024390243902439025,0.975609756097561,41,1650,1300,350,0.7878787878787878,20,13,7,410.51737245182807,0.45625,0.2528284311124478,0.22375630696089768,128517.04422577863,2351.695862168413,130868.74008794705,1364,0,181.2439024390244,33,8,16,36.101039400531796,0.6117424242424243,46.50735294117648,1013.9705882352948,30.7263814616756,0
1379,4,0,0,40,0.0,0.0,1.0,40,1100,900,200,0.8181818181818182,13,9,4,421.3816552764667,0.45550213675213674,0.2611841285660894,0.22900680750874744,128400.34060618824,2821.109612539551,131221.45021872778,1365,2,186.775,32,8,16,35.945610647398375,0.6129557291666667,46.622474747474755,1013.5101010101018,31.672190656565682,0
1380,4,0,2,38,0.0,0.05,0.95,40,850,600,250,0.7058823529411765,11,6,5,419.8587869636987,0.4554353632478632,0.2532308266932266,0.2290968598432357,128560.35098459352,2795.4386032037664,131355.78958779728,1366,3,187.775,32,8,16,35.81974186586985,0.6145833333333333,46.46464646464647,1014.1414141414151,31.691919191919222,0
1381,4,1,0,39,0.02564102564102564,0.0,1.0,39,900,500,400,0.5555555555555556,13,5,8,429.9073969237907,0.4538630229419703,0.2617912334118455,0.23495755284936962,128624.38303489437,3259.3147382920056,131883.69777318637,1367,0,192.25641025641025,32,7,17,35.49912870301219,0.615234375,46.40151515151515,1014.3939393939393,31.699810606060602,0
1382,4,0,0,39,0.0,0.0,1.0,39,1250,800,450,0.64,17,8,9,425.8314812469375,0.453778677462888,0.2600855657966521,0.23329295260951827,128720.46100206596,3162.644915059668,131883.10591712562,1368,1,193.25641025641025,32,7,17,35.50376384222969,0.6162109375,46.30681818181817,1014.7727272727261,31.71164772727269,0
1383,4,2,0,41,0.04878048780487805,0.0,1.0,41,900,500,400,0.5555555555555556,13,5,8,406.7385358334538,0.45627540650406506,0.25912246834792163,0.2264477924851441,129357.17520004323,2323.806359690407,131680.98155973363,1369,0,184.78048780487805,33,8,19,35.335978596956195,0.6202651515151515,45.68014705882353,1017.2794117647057,30.826648841354718,0
1384,4,0,1,40,0.0,0.024390243902439025,0.975609756097561,41,1000,700,300,0.7,13,7,6,403.61948203250745,0.45594512195121956,0.25761479101000795,0.22506733104875143,129419.51600646383,2247.247603085348,131666.76360954918,1370,1,185.78048780487805,33,8,19,35.351554658958605,0.6208964646464646,45.618872549019606,1017.5245098039214,30.834076054664287,0
1385,4,2,1,41,0.047619047619047616,0.023809523809523808,0.9761904761904762,42,1100,800,300,0.7272727272727273,14,8,6,396.0852161944997,0.4573654665118079,0.26285649394893085,0.22329874608250752,129849.38298396788,1886.2841863854742,131735.66717035335,1371,0,181.95238095238096,35,7,20,35.104379589673705,0.6208333333333333,45.19675925925927,1019.212962962964,29.1203703703704,0
1386,4,1,0,42,0.023809523809523808,0.0,1.0,42,650,500,150,0.7692307692307693,8,5,3,390.67585174662486,0.45824864498644985,0.26161574760118045,0.2221019177244617,130176.38204082474,1771.3537862186606,131947.7358270434,1372,0,181.71428571428572,36,6,21,34.909052453468696,0.6221064814814814,44.87612612612613,1020.4954954954966,28.347097097097127,0
1387,4,0,0,42,0.0,0.0,1.0,42,1050,600,450,0.5714285714285714,15,6,9,413.01000849869746,0.45760743321718933,0.27278699641850523,0.2225499973852694,128059.03031409798,2177.932239672119,130236.9625537701,1373,1,182.71428571428572,36,6,20,36.50863187954311,0.6006944444444444,46.95945945945947,1012.162162162163,28.11561561561564,8
1388,4,1,2,41,0.023255813953488372,0.046511627906976744,0.9534883720930233,43,1350,1000,350,0.7407407407407407,17,10,7,400.8103029308951,0.458656330749354,0.2124272548175994,0.20895034574113167,126721.57343329495,1563.4206881470088,128284.99412144195,1374,0,179.4418604651163,33,10,16,38.19528967867576,0.5934343434343434,48.2843137254902,1006.8627450980397,30.51099227569817,8
1389,4,2,1,42,0.046511627906976744,0.023255813953488372,0.9767441860465116,43,1250,900,350,0.72,16,9,7,402.6364319377093,0.4581487633813215,0.23351912358254823,0.21182177506288177,127092.01388888886,1634.915657439442,128726.9295463283,1375,0,180.1627906976744,32,11,18,37.76687327823689,0.599609375,47.916666666666664,1008.333333333333,31.510416666666657,0
1390,4,3,3,42,0.06666666666666667,0.06666666666666667,0.9333333333333333,45,1300,1000,300,0.7692307692307693,16,10,6,381.41398828587666,0.4612584175084175,0.23415080766463947,0.20442345933681536,127843.3691184808,752.2498582766513,128595.61897675745,1376,0,172.95555555555555,34,11,19,37.52942907592703,0.6026348039215687,47.17261904761905,1011.3095238095243,29.744397759103656,0
1391,4,0,0,42,0.0,0.0,1.0,42,1400,1000,400,0.7142857142857143,18,10,8,385.17432810248374,0.4569783197831978,0.24169609676153536,0.20639341269491535,127834.51677239522,1447.7148212226039,129282.23159361782,1377,1,184.66666666666666,33,9,20,37.443448052997255,0.6047979797979798,47.181372549019606,1011.2745098039214,30.644682115270346,0
1392,4,1,1,42,0.023255813953488372,0.023255813953488372,0.9767441860465116,43,1550,1000,550,0.6451612903225806,21,10,11,378.31614063412485,0.45824104835732743,0.2638480780364185,0.20599362235551202,128476.21882086172,1120.925453514746,129597.14427437646,1378,0,181.34883720930233,34,9,15,36.95910638797559,0.6090686274509804,46.54761904761905,1013.8095238095241,29.817927170868355,0
1393,4,0,1,41,0.0,0.023809523809523808,0.9761904761904762,42,1400,1000,400,0.7142857142857143,18,10,8,375.7809065327065,0.45755903987611307,0.24916872041622695,0.20538993614914638,128627.12762188197,1267.1237244897834,129894.25134637175,1379,1,183.95238095238096,34,8,15,36.86896099831788,0.6106004901960784,46.39880952380952,1014.404761904761,29.83543417366944,0
1394,4,1,0,42,0.023809523809523808,0.0,1.0,42,1400,900,500,0.6428571428571429,19,9,10,365.77164233511115,0.45751064653503676,0.24619170377314314,0.20190783930710451,129019.9050453514,1038.364512471649,130058.26955782305,1380,0,183.45238095238096,34,8,17,36.7217404890243,0.6145833333333333,46.01190476190476,1015.9523809523804,29.880952380952365,0
1395,4,0,3,39,0.0,0.07142857142857142,0.9285714285714286,42,1300,1000,300,0.7692307692307693,16,10,6,361.2562876690164,0.45729287650019357,0.24307019598656998,0.20002634138249423,129140.88010204073,930.5909863945487,130071.47108843527,1381,1,184.45238095238096,34,8,17,36.713076832981955,0.6158088235294117,45.89285714285714,1016.4285714285706,29.894957983193255,0
1396,4,1,0,40,0.025,0.0,1.0,40,1350,1200,150,0.8888888888888888,15,12,3,380.40899369727066,0.45324519230769234,0.2675037294878171,0.2095897222808799,128944.78242016124,1810.3509845934132,130755.13340475466,1382,0,194.275,32,8,18,36.42673628377259,0.6184895833333333,46.08585858585859,1015.6565656565659,31.739267676767685,0
1397,4,0,0,40,0.0,0.0,1.0,40,1250,800,450,0.64,17,8,9,382.4431640771669,0.45285790598290593,0.27330392644135126,0.21139440827562117,129073.0537700237,1872.6214161820483,130945.67518620576,1383,1,195.275,32,8,18,36.24399436713055,0.6197916666666667,45.95959595959597,1016.161616161618,31.755050505050562,0
1398,4,0,0,40,0.0,0.0,1.0,40,1650,1200,450,0.7272727272727273,21,12,9,384.0787324573721,0.4529113247863248,0.2824674115456238,0.21350960593127252,129297.68207644654,1932.0979683195937,131229.78004476614,1384,2,196.275,32,8,18,35.97299813780262,0.6220703125,45.73863636363638,1017.0454545454566,31.782670454545517,0
1399,4,0,0,40,0.0,0.0,1.0,40,800,700,100,0.875,9,7,2,382.6399168087535,0.4526442307692307,0.2793570009930484,0.2128830918377985,129329.78777675769,1897.34784715848,131227.13562391617,1385,3,197.275,32,8,18,35.97680817610062,0.6223958333333333,45.70707070707072,1017.1717171717189,31.786616161616216,0
1400,4,1,1,40,0.024390243902439025,0.024390243902439025,0.975609756097561,41,1200,1000,200,0.8333333333333334,14,10,4,374.57603628999885,0.4526930894308943,0.2003335159297741,0.2089071471599375,129426.128791067,1576.605225232089,131002.7340162991,1386,0,193.4390243902439,32,9,16,36.083622864706115,0.6233723958333333,45.61237373737372,1017.5505050505033,31.798453282828227,8
1401,4,0,0,40,0.0,0.0,1.0,40,1500,1000,500,0.6666666666666666,20,10,10,372.8209383385397,0.4519364316239316,0.21235258724428419,0.20905141684165027,129637.82709775055,1666.3392685505173,131304.16636630107,1387,1,198.55,33,7,16,35.912555154432404,0.6231060606060606,45.40441176470586,1018.3823529411738,30.860071301247693,0
1402,4,0,1,39,0.0,0.025,0.975,40,1150,800,350,0.6956521739130435,15,8,7,373.4092781478834,0.45108173076923075,0.2126278118609406,0.20988176668312042,129731.44531249978,1688.5850694444148,131420.0303819442,1388,2,199.55,33,7,16,35.80223244717108,0.6240530303030303,45.312499999999986,1018.7499999999983,30.871212121212068,0
1403,4,1,0,40,0.025,0.0,1.0,40,1600,1200,400,0.75,20,12,8,368.69916702237646,0.4503338675213675,0.22845428331130657,0.20889606311281383,130043.7500750911,1589.4044658304222,131633.15454092153,1389,0,200.325,33,7,20,35.60452461051703,0.627209595959596,45.00612745098038,1019.9754901960767,30.908348187759902,0
1404,4,2,1,41,0.047619047619047616,0.023809523809523808,0.9761904761904762,42,950,700,250,0.7368421052631579,12,7,5,352.9803495333228,0.4520421989934185,0.22511133949982853,0.20274491150880955,130575.52984429077,818.4871804113916,131394.01702470216,1390,0,191.73809523809524,33,9,16,35.466127098321344,0.6325757575757576,44.485294117647065,1022.0588235294126,30.97147950089129,0
1405,4,0,1,40,0.0,0.024390243902439025,0.975609756097561,41,1200,1000,200,0.8333333333333334,14,10,4,361.2352684377082,0.4502794715447154,0.2291793455362574,0.20681711522642438,130450.30757401012,1224.6503748558412,131674.95794886595,1391,1,197.41463414634146,33,8,21,35.38217770313501,0.6313131313131313,44.60784313725491,1021.5686274509815,30.956625074272164,0
1406,4,0,0,40,0.0,0.0,1.0,40,1150,800,350,0.6956521739130435,15,8,7,372.5234030212033,0.4490785256410256,0.24114319277853347,0.21260386451887617,130327.04132550275,1709.974588052274,132037.01591355502,1392,2,203.125,32,8,21,35.21907588310458,0.6324869791666667,44.72853535353537,1021.0858585858606,31.908933080808144,0
1407,4,0,0,40,0.0,0.0,1.0,40,900,500,400,0.5555555555555556,13,5,8,370.66296739171065,0.448838141025641,0.23892013845963667,0.21189348008703546,130391.51178770048,1666.2609363840738,132057.77272408456,1393,3,204.125,32,8,21,35.2010961387893,0.6331380208333333,44.665404040404056,1021.3383838383858,31.916824494949555,0
1408,4,0,0,40,0.0,0.0,1.0,40,950,900,50,0.9473684210526315,10,9,1,368.2967182395039,0.4483440170940171,0.23630128521997018,0.21106636288909852,130488.24737271733,1611.6786552392932,132099.92602795662,1394,4,205.125,32,8,18,35.163330037897516,0.6341145833333333,44.57070707070709,1021.7171717171739,31.928661616161683,0
1409,4,1,0,41,0.024390243902439025,0.0,1.0,41,950,700,250,0.7368421052631579,12,7,5,357.45377858766204,0.44753556910569103,0.23878159143582378,0.20679917557034896,130854.01663237308,1154.8525377229048,132008.86917009598,1395,0,201.09756097560975,35,6,19,35.06975867269985,0.6309523809523809,44.21296296296296,1023.1481481481479,29.232804232804227,0
1410,4,1,1,41,0.023809523809523808,0.023809523809523808,0.9761904761904762,42,1250,800,450,0.64,17,8,9,349.7125470412418,0.4479166666666667,0.23875501377150843,0.20360345088303783,131097.37059694823,769.279076373666,131866.6496733219,1396,0,197.28571428571428,36,6,20,35.02171761601057,0.6313657407407407,43.97522522522522,1024.0990990990986,28.447197197197184,0
1411,4,0,0,41,0.0,0.0,1.0,41,1600,1400,200,0.875,18,14,4,357.49438374933385,0.4459857723577236,0.25166497596259885,0.2080993623298752,131090.96364883392,1172.8566529492296,132263.82030178315,1397,1,202.9268292682927,35,6,20,34.82896323086196,0.6333333333333333,43.981481481481474,1024.0740740740732,29.259259259259235,0
1412,4,0,0,41,0.0,0.0,1.0,41,1250,800,450,0.64,17,8,9,355.499476705978,0.445604674796748,0.23117684638025038,0.19896803172706282,129564.73922902481,1057.3176055401414,130622.05683456495,1398,2,203.9268292682927,34,7,16,36.42788236669785,0.6200980392156863,45.47619047619047,1018.095238095237,29.943977591036383,8
1413,4,0,0,41,0.0,0.0,1.0,41,1250,900,350,0.72,16,9,7,358.0992376633545,0.444385162601626,0.23086809206683023,0.2015102810756507,129776.92920918352,1094.6038832199329,130871.53309240345,1399,3,204.9268292682927,34,7,16,36.14591852630758,0.6222426470588236,45.26785714285713,1018.9285714285702,29.968487394957947,0
1414,4,0,0,41,0.0,0.0,1.0,41,1100,800,300,0.7272727272727273,14,8,6,357.44005784701574,0.4444867886178862,0.2297388916425953,0.20160749507813888,129867.92091836728,1083.9994331065673,130951.92035147385,1400,4,205.9268292682927,34,7,16,36.07023281164836,0.6231617647058824,45.17857142857142,1019.2857142857137,29.978991596638636,0
1415,4,0,1,40,0.0,0.024390243902439025,0.975609756097561,41,850,500,350,0.5882352941176471,12,5,7,356.02543511058076,0.44408028455284554,0.2292084917346544,0.20127774598825898,129958.94451530605,1053.7379535147286,131012.68246882079,1401,5,206.9268292682927,34,7,17,36.01381591749366,0.6240808823529411,45.08928571428571,1019.6428571428567,29.989495798319314,0
1416,4,0,0,40,0.0,0.0,1.0,40,1300,1000,300,0.7692307692307693,16,10,6,365.1631721771763,0.44358974358974357,0.23646910314979586,0.20606697870893842,129887.55076172622,1486.03001249519,131373.5807742214,1402,7,212.975,33,7,18,35.85347038550934,0.6256313131313131,45.15931372549019,1019.3627450980389,30.889780154486026,0
1417,4,0,0,40,0.0,0.0,1.0,40,1150,600,550,0.5217391304347826,17,6,11,366.10499193984333,0.44272168803418804,0.2348149927919272,0.20759250360403636,130075.0012014609,1524.2214532871856,131599.22265474807,1403,8,213.975,33,7,19,35.638915585455685,0.6275252525252526,44.975490196078425,1020.0980392156856,30.912061794414715,0
1418,4,0,0,40,0.0,0.0,1.0,40,1200,700,500,0.5833333333333334,17,7,10,369.67930029154496,0.4433360042735042,0.23581632653061213,0.2106312292358804,130262.58680555565,1631.2115532487592,131893.7983588044,1404,9,214.975,32,8,21,35.35714285714286,0.6318359375,44.79166666666667,1020.8333333333342,31.901041666666693,0
1419,4,0,1,39,0.0,0.025,0.975,40,900,500,400,0.5555555555555556,13,5,8,367.6671818942924,0.44306891025641026,0.232510199035727,0.21018090702070213,130391.51178770041,1588.1359363840588,131979.64772408447,1405,10,215.975,32,8,23,35.27758890674577,0.6331380208333333,44.66540404040405,1021.3383838383852,31.916824494949537,0
1420,4,0,0,39,0.0,0.0,1.0,39,1300,800,500,0.6153846153846154,18,8,10,379.51332578767637,0.44281376518218624,0.24615776929942434,0.2167897315479059,130362.2966342503,2094.845750596797,132457.1423848471,1406,11,221.5897435897436,31,8,23,35.004807896638184,0.6354166666666667,44.69401041666667,1021.223958333334,32.94270833333336,0
1421,4,0,0,39,0.0,0.0,1.0,39,850,400,450,0.47058823529411764,13,4,9,380.6584335386543,0.44270130454340983,0.2486695694242862,0.21763008401437378,130395.54172092027,2127.232530381963,132522.77425130224,1407,12,222.5897435897436,31,8,23,34.941781404045564,0.635752688172043,44.66145833333334,1021.3541666666678,32.94690860215057,0
1422,4,1,1,39,0.025,0.025,0.975,40,1100,700,400,0.6363636363636364,15,7,8,377.4251877621277,0.443883547008547,0.2122822498007515,0.20914355988105798,129171.97312510727,1750.5512420696305,130922.5243671769,1408,0,218.0,35,5,18,36.27047041633459,0.6139880952380952,45.862268518518526,1016.5509259259268,29.044312169312192,8
1423,4,1,1,39,0.025,0.025,0.975,40,1050,600,450,0.5714285714285714,15,6,9,368.45489167220194,0.4458333333333333,0.2107289033345372,0.20611143334148027,129544.24267409174,1546.2486782075212,131090.49135229926,1409,0,217.55,33,7,16,36.119011074997,0.6221590909090908,45.49632352941177,1018.0147058823534,30.848930481283436,0
1424,4,1,0,40,0.025,0.0,1.0,40,1000,700,300,0.7,13,7,6,365.99960921906427,0.44724893162393164,0.21510276772159287,0.20659556056314093,129898.25857426306,1508.54237528345,131406.8009495465,1410,0,216.175,34,6,17,35.82126591147962,0.623468137254902,45.148809523809526,1019.404761904762,29.982492997198882,0
1425,4,0,1,39,0.0,0.025,0.975,40,1100,700,400,0.6363636363636364,15,7,8,367.5402622922806,0.4466746794871795,0.218668300653595,0.20827281529895914,130050.00000000001,1559.7222222222226,131609.72222222225,1411,1,217.175,34,6,18,35.62772331154684,0.625,45.0,1020.0000000000001,30.000000000000004,0
1426,4,0,0,39,0.0,0.0,1.0,39,1250,1000,250,0.8,15,10,5,370.1090921014621,0.4470872694556905,0.20953929939994365,0.20986294840957562,130075.00120146088,1828.3881199538514,131903.38932141472,1412,2,221.89743589743588,33,6,19,35.53680121736343,0.6275252525252526,44.975490196078425,1020.0980392156855,30.91206179441471,0
1427,4,0,1,38,0.0,0.02564102564102564,0.9743589743589743,39,1300,1200,100,0.9230769230769231,14,12,2,364.6658899198601,0.4468623481781377,0.2070492040476435,0.20760780568301543,130231.31315179265,1698.1835411860934,131929.49669297875,1413,3,222.89743589743588,33,6,19,35.516843758754554,0.6291035353535354,44.82230392156863,1020.710784313726,30.930629827688666,0
1428,4,0,0,38,0.0,0.0,1.0,38,950,700,250,0.7368421052631579,12,7,5,366.347237737587,0.4448494547178758,0.1926497713318347,0.20906884827599817,130325.14537677808,1948.851403306413,132273.9967800845,1414,4,223.3421052631579,33,5,20,35.378660585693716,0.630050505050505,44.73039215686274,1021.0784313725483,30.941770647652977,0
1429,4,0,0,38,0.0,0.0,1.0,38,1050,500,550,0.47619047619047616,16,5,11,368.6368877386856,0.44474573257468,0.19550225455647707,0.21071466546050804,130387.71896626303,2013.144583813922,132400.86355007696,1415,5,224.3421052631579,33,5,21,35.25667946564273,0.6306818181818181,44.669117647058826,1021.3235294117652,30.94919786096258,0
1430,4,0,0,38,0.0,0.0,1.0,38,1400,1000,400,0.7142857142857143,18,10,8,374.048390776446,0.44376778093883357,0.1944567123875387,0.21519390867980054,130638.1635068241,2172.9989667435407,132811.16247356765,1416,6,225.3421052631579,33,5,14,34.86424118916329,0.6332070707070707,44.42401960784313,1022.3039215686258,30.978906714200782,0
1431,4,0,0,38,0.0,0.0,1.0,38,1050,700,350,0.6666666666666666,14,7,7,372.4381031629764,0.44338252726410626,0.19257398443722828,0.21471431585033315,130718.71456916085,2136.9260204081475,132855.640589569,1417,7,226.3421052631579,34,4,16,34.82368063639891,0.6317401960784313,44.34523809523809,1022.6190476190463,30.077030812324892,0
1432,4,0,0,38,0.0,0.0,1.0,38,1150,900,250,0.782608695652174,14,9,5,375.7083987560876,0.44274537695590327,0.19299572066143034,0.21779940014201496,130931.84700963703,2238.438917233539,133170.28592687057,1418,8,227.3421052631579,34,4,17,34.52391338063664,0.6338848039215687,44.13690476190475,1023.4523809523797,30.101540616246464,0
1433,4,0,2,36,0.0,0.05263157894736842,0.9473684210526316,38,1100,900,200,0.8181818181818182,13,9,4,372.7687669610535,0.4424786628733997,0.19192076808694192,0.2167805385146733,131053.7149234692,2170.5463435373917,133224.2612670066,1419,9,228.3421052631579,34,4,17,34.4756423671666,0.6351102941176471,44.01785714285713,1023.92857142857,30.115546218487353,0
1434,4,0,0,36,0.0,0.0,1.0,36,1450,1100,350,0.7586206896551724,18,11,7,393.8079821406348,0.4383267195767196,0.20634382068681867,0.22814965655824476,130907.84940631052,3110.511204213844,134018.36061052437,1420,11,239.77777777777777,32,4,18,34.08518404277194,0.6383463541666667,44.16035353535353,1023.3585858585853,31.979955808080792,0
1435,4,0,0,36,0.0,0.0,1.0,36,1150,900,250,0.782608695652174,14,9,5,396.5432489703946,0.43816137566137564,0.20296246042514765,0.2301199799143153,130972.46334876528,3187.249228395047,134159.71257716033,1421,12,240.77777777777777,32,4,18,33.94957033016735,0.6389973958333333,44.097222222222214,1023.61111111111,31.987847222222186,0
1436,4,0,0,36,0.0,0.0,1.0,36,1150,700,450,0.6086956521739131,16,7,9,394.9292154757985,0.4375,0.1977869559856984,0.22995483608931813,131101.73906042747,3155.1813909294897,134256.92045135697,1422,13,241.77777777777777,32,4,18,33.859624789380675,0.6402994791666667,43.97095959595959,1024.1161616161612,32.00363005050504,0
1437,4,0,0,36,0.0,0.0,1.0,36,1250,900,350,0.72,16,9,7,396.2379862399778,0.43743386243386245,0.20073142669296584,0.2309111023260558,131134.06795224964,3192.059802571149,134326.12775482077,1423,14,242.77777777777777,32,4,18,33.79330004930966,0.640625,43.93939393939393,1024.242424242423,32.00757575757572,0
1438,4,1,0,37,0.02702702702702703,0.0,1.0,37,1000,600,400,0.6,14,6,8,375.4929670812627,0.4393455955955956,0.16573714951480167,0.21313396682687236,130114.93866008648,2371.4488758144616,132486.38753590095,1424,0,237.1891891891892,35,2,17,35.358881641142,0.6235119047619048,44.93634259259259,1020.2546296296288,29.15013227513225,8
1439,4,1,0,38,0.02631578947368421,0.0,1.0,38,500,400,100,0.8,6,4,2,367.11756922061244,0.4405523944997629,0.1629629414734055,0.21010242715458533,130435.08193582103,1977.0020442740115,132412.08398009505,1425,0,231.92105263157896,36,2,19,35.24740013963915,0.6247106481481481,44.62274774774775,1021.5090090090096,28.375250250250264,0
1440,4,0,0,38,0.0,0.0,1.0,38,1150,800,350,0.6956521739130435,15,8,7,368.4764889673776,0.43976706970128027,0.17575353582193398,0.21229482993805768,130694.03863322787,2031.5360969077258,132725.5747301356,1426,1,232.92105263157896,36,2,16,34.94998164464024,0.6273148148148149,44.36936936936937,1022.5225225225229,28.403403403403413,0
1441,4,0,0,38,0.0,0.0,1.0,38,1150,700,450,0.6086956521739131,16,7,9,359.05839081089135,0.43867057847321006,0.12985628945324534,0.19696854999260885,128772.40997331787,1647.362861171976,130419.77283448985,1427,2,233.92105263157896,36,2,18,37.144726136321594,0.6079282407407407,46.25563063063063,1014.9774774774772,28.193818818818812,8
1442,4,1,1,38,0.02564102564102564,0.02564102564102564,0.9743589743589743,39,1500,1100,400,0.7333333333333333,19,11,8,360.6889887239124,0.4399460188933873,0.15512475350939625,0.20047924727835958,129292.17864229037,1528.9930529674912,130821.17169525786,1428,0,228.89743589743588,34,5,19,36.57331538491554,0.6173406862745099,45.74404761904763,1017.0238095238104,29.912464985994426,0
1443,4,0,0,38,0.0,0.0,1.0,38,1150,800,350,0.6956521739130435,15,8,7,357.88885135528653,0.4395448079658606,0.13977007364828453,0.19935633735189945,129377.95380015452,1660.585455246941,131038.53925540145,1429,1,228.81578947368422,35,3,19,36.55716723549489,0.6160714285714286,45.659722222222236,1017.3611111111127,29.067460317460363,0
1444,4,0,0,38,0.0,0.0,1.0,38,1300,700,600,0.5384615384615384,19,7,12,355.544068363025,0.4394262683736368,0.1427827585794137,0.1986438714856699,129495.73072059342,1608.2877872085182,131104.01850780193,1430,2,229.81578947368422,35,3,17,36.49694867712835,0.6172619047619048,45.54398148148149,1017.8240740740753,29.080687830687864,0
1445,4,0,0,38,0.0,0.0,1.0,38,1650,1300,350,0.7878787878787878,20,13,7,357.76866105444526,0.43883357041251775,0.14686255516090818,0.20109066121336058,129731.4453125,1682.7690972222224,131414.21440972222,1431,3,230.81578947368422,35,3,17,36.20057941376959,0.6196428571428572,45.3125,1018.75,29.107142857142858,0
1446,4,1,0,39,0.02564102564102564,0.0,1.0,39,1350,1000,350,0.7407407407407407,17,10,7,349.6180571992538,0.4395242914979757,0.14898290787007973,0.19817524168403275,130061.48674011862,1294.3688621053643,131355.85560222398,1432,0,225.87179487179486,36,3,18,36.073084566129396,0.6209490740740741,44.988738738738746,1020.045045045046,28.33458458458461,0
1447,4,0,1,38,0.0,0.02564102564102564,0.9743589743589743,39,1450,1100,350,0.7586206896551724,18,11,7,351.6867971678464,0.43929937022042287,0.15656724228152763,0.20037968675842427,130262.58680555568,1362.3263888888982,131624.91319444458,1433,1,226.87179487179486,36,3,18,35.816326530612244,0.622974537037037,44.79166666666667,1020.8333333333344,28.35648148148151,0
1448,4,0,1,37,0.0,0.02631578947368421,0.9736842105263158,38,1300,900,400,0.6923076923076923,17,9,8,363.59736372824847,0.4370258416311048,0.16554806412230638,0.2078149089556722,130384.14292800434,1881.466128117891,132265.60905612222,1434,2,233.6315789473684,34,4,20,35.38898278742667,0.6283700980392157,44.67261904761904,1021.3095238095223,30.038515406162418,0
1449,4,0,0,37,0.0,0.0,1.0,37,850,500,350,0.5882352941176471,12,5,7,364.3006177971215,0.4360297797797798,0.17554967554967527,0.20837995337995324,130414.54081632636,2102.0195578231055,132516.56037414947,1435,3,239.24324324324326,34,3,20,35.340180652680644,0.6286764705882353,44.64285714285713,1021.4285714285701,30.04201680672265,0
1450,4,0,0,37,0.0,0.0,1.0,37,750,600,150,0.8,9,6,3,364.8994251310195,0.4356231231231231,0.18016385211672947,0.20917741071796342,130498.99798525362,2123.8018689986093,132622.79985425223,1436,4,240.24324324324326,35,2,16,35.2392010270352,0.6273809523809524,44.560185185185176,1021.759259259258,29.193121693121658,0
1451,4,0,0,37,0.0,0.0,1.0,37,1250,700,550,0.56,18,7,11,364.02770848376736,0.4352477477477477,0.17744176792874433,0.20899640220491952,130558.1342699758,2105.3556884430473,132663.48995841885,1437,5,241.24324324324326,35,2,16,35.20149112872782,0.6279761904761905,44.5023148148148,1021.9907407407392,29.199735449735403,0
1452,4,1,0,38,0.02631578947368421,0.0,1.0,38,1250,800,450,0.64,17,8,9,355.1457738752779,0.4362108819345662,0.1773578785175578,0.20553213384909388,130866.8190995048,1695.3595487379193,132562.17864824273,1438,0,235.8684210526316,36,2,17,35.11583755227824,0.6290509259259259,44.20045045045045,1023.1981981981974,28.42217217217215,0
1453,4,0,0,38,0.0,0.0,1.0,38,1350,1100,250,0.8148148148148148,16,11,5,352.4097298817796,0.4356626363205311,0.1766512123264279,0.20501994074312352,131068.54056336732,1637.965795187065,132706.50635855438,1439,1,236.8684210526316,36,2,17,34.98180835074599,0.6310763888888888,44.00337837837837,1023.9864864864858,28.444069069069048,0
1454,4,0,1,37,0.0,0.02631578947368421,0.9736842105263158,38,1350,1100,250,0.8148148148148148,16,11,5,352.1603041077352,0.43595898530109056,0.17413780135730095,0.20549084582861216,131183.87972009156,1639.5509952519894,132823.43071534354,1440,2,237.8684210526316,36,2,18,34.87161518449304,0.6322337962962963,43.89076576576576,1024.4369369369358,28.45658158158155,0
1455,4,0,0,37,0.0,0.0,1.0,37,800,600,200,0.75,10,6,4,355.7819566993452,0.4351851851851852,0.1811430682744657,0.2075824719015099,131179.8740381731,1934.2864529749759,133114.16049114807,1441,3,243.54054054054055,35,2,18,34.78291059390653,0.6342261904761906,43.89467592592593,1024.421296296297,29.269179894179914,0
1456,4,0,0,37,0.0,0.0,1.0,37,1700,1500,200,0.8823529411764706,19,15,4,358.10818695457675,0.4349974974974975,0.18802020541150966,0.20958678093078512,131298.46810967516,2003.8112729338247,133302.27938260898,1442,4,244.54054054054055,35,2,18,34.603449087144746,0.6354166666666667,43.77893518518519,1024.88425925926,29.28240740740743,0
1457,4,0,0,37,0.0,0.0,1.0,37,1400,1000,400,0.7142857142857143,18,10,8,360.48135162431214,0.4349036536536537,0.18932034393043273,0.21195920748128955,131476.45968632132,2078.9623789009106,133555.42206522223,1443,5,245.54054054054055,35,2,18,34.36277414136855,0.637202380952381,43.60532407407408,1025.578703703705,29.302248677248716,0
1458,4,1,0,38,0.02631578947368421,0.0,1.0,38,950,600,350,0.631578947368421,13,6,7,353.33493608235193,0.4363738738738739,0.18787632127373377,0.20931478962071523,131761.33639974458,1711.1766749858245,133472.5130747304,1444,0,240.05263157894737,36,2,16,34.25857372673759,0.6380208333333333,43.327702702702716,1026.6891891891912,28.5191441441442,0
1459,4,0,0,38,0.0,0.0,1.0,38,1100,800,300,0.7272727272727273,14,8,6,342.12163216810904,0.4359441678520626,0.16358900664630838,0.1905734567020075,129377.95380015431,1254.1338177986538,130632.08761795296,1445,1,241.05263157894737,35,3,22,36.95819112627987,0.6160714285714286,45.65972222222222,1017.3611111111111,29.067460317460316,8
1460,4,1,0,39,0.02564102564102564,0.0,1.0,39,1100,800,300,0.7272727272727273,14,8,6,338.378926162205,0.43721884840305897,0.17766822496104262,0.1906805281300097,129831.84831791259,986.4722830939163,130818.3206010065,1446,0,235.84615384615384,36,3,18,36.592541436464096,0.6186342592592593,45.21396396396397,1019.1441441441449,28.30955955955958,0
1461,4,0,0,39,0.0,0.0,1.0,39,1300,1000,300,0.7692307692307693,16,10,6,337.0712331500872,0.4368814664867296,0.17803686959674558,0.1902224939198623,129889.23890106328,956.3851858615392,130845.62408692481,1447,1,236.84615384615384,36,3,18,36.56765539843864,0.619212962962963,45.15765765765766,1019.3693693693698,28.315815815815828,0
1462,4,1,1,39,0.025,0.025,0.975,40,1050,700,350,0.6666666666666666,14,7,7,372.24628998510127,0.4394898504273504,0.1674180086987187,0.20131590520681852,128204.80619331065,1635.3944324564477,129840.2006257671,1448,0,231.9,34,6,18,37.39077622350221,0.6063112745098039,46.81547619047619,1012.7380952380952,29.78641456582633,8
1463,4,2,2,39,0.04878048780487805,0.04878048780487805,0.9512195121951219,41,1300,900,400,0.6923076923076923,17,9,8,363.34765284363516,0.44222560975609754,0.1626201836088208,0.19823487759750516,128555.01570001722,1142.0326431755916,129697.04834319282,1449,0,218.97560975609755,35,6,15,37.2579510005326,0.6077380952380953,46.46990740740741,1014.120370370371,28.974867724867742,0
1464,4,0,1,38,0.0,0.02564102564102564,0.9743589743589743,39,1050,600,450,0.5714285714285714,15,6,9,399.2497183955668,0.43924313990103464,0.11497798592220798,0.2101999956927139,127122.90833153109,2363.643944740502,129486.55227627158,1450,2,231.2051282051282,33,6,19,37.82038623567059,0.5975378787878788,47.8860294117647,1008.4558823529406,30.559269162210324,7
1465,4,1,0,39,0.02564102564102564,0.0,1.0,39,1100,600,500,0.5454545454545454,16,6,10,396.1671509135065,0.4403396311291048,0.12999258857893792,0.20937357641988527,127277.4368632257,2284.627907535567,129562.06477076127,1451,0,231.87179487179486,33,6,20,37.73884705691848,0.5991161616161615,47.7328431372549,1009.0686274509806,30.57783719548426,0
1466,4,1,1,39,0.025,0.025,0.975,40,850,400,450,0.47058823529411764,13,4,9,351.01817214524976,0.44288194444444445,0.08601842765238255,0.1815672677238626,126401.93527094863,873.8752548861054,127275.81052583474,1452,0,227.05,37,3,16,39.777446116381356,0.5819256756756757,48.60197368421052,1005.5921052631569,27.178165007112348,7
1467,4,1,0,40,0.025,0.0,1.0,40,950,600,350,0.631578947368421,13,6,7,349.44952782718553,0.444551282051282,0.10564937894966242,0.18161085879942845,126594.9679228223,847.7103531855821,127442.67827600788,1453,0,228.0,37,3,17,39.61829011404082,0.5838963963963963,48.41008771929824,1006.3596491228061,27.198909435751517,0
1468,4,3,1,42,0.06976744186046512,0.023255813953488372,0.9767441860465116,43,1350,900,450,0.6666666666666666,18,9,9,329.5372628559648,0.4498200442967885,0.1269313201752984,0.17487123364692386,127442.37075617241,-198.65027914576774,127243.72047702665,1454,0,213.02325581395348,38,5,16,39.25091701054563,0.590734649122807,47.56944444444442,1009.7222222222188,26.571637426900494,0
1469,4,1,0,43,0.023255813953488372,0.0,1.0,43,1100,700,400,0.6363636363636364,15,7,8,334.6956687686099,0.4516426725729051,0.15358317348901074,0.1797636578315349,127928.27641034739,-36.59199448466177,127891.68441586272,1455,0,211.51162790697674,38,5,17,38.6238427148238,0.5956688596491229,47.088675213675195,1011.6452991452965,26.622244714349907,0
1470,4,1,1,43,0.022727272727272728,0.022727272727272728,0.9772727272727273,44,1550,1300,250,0.8387096774193549,18,13,5,330.94317290743095,0.45177061310782246,0.16545582434014383,0.17957990962052678,128338.88942992076,-305.05888815369866,128033.83054176706,1456,0,207.6818181818182,37,7,21,38.29976463586192,0.6016328828828829,46.68311403508772,1013.2675438596493,27.385609293504036,0
1471,4,0,0,43,0.0,0.0,1.0,43,1350,900,450,0.6666666666666666,18,9,9,340.5282889997288,0.45143503137689184,0.17070869470045213,0.18503838772630776,128394.44739006236,144.3882973607295,128538.83568742308,1457,1,213.2325581395349,37,6,13,38.00026596703812,0.6021959459459459,46.62828947368421,1013.4868421052635,27.39153627311523,0
1472,4,0,1,42,0.0,0.023255813953488372,0.9767441860465116,43,1150,1000,150,0.8695652173913043,13,10,3,341.4779126590522,0.450812107788852,0.1740136526668976,0.1859425665751235,128477.80687326868,174.46666281932505,128652.273536088,1458,2,214.2325581395349,37,6,15,37.89116014132236,0.6030405405405406,46.546052631578945,1013.8157894736842,27.400426742532005,0
1473,4,0,0,42,0.0,0.0,1.0,42,1450,1000,450,0.6896551724137931,19,10,9,347.2417348957791,0.44963463027487416,0.1771452891137577,0.18966684695004749,128601.01814229779,531.1281298190156,129132.1462721168,1459,3,220.0952380952381,36,6,16,37.61935161541024,0.6061921296296297,46.42454954954955,1014.3018018018025,28.17505005005007,0
1474,4,1,0,43,0.023255813953488372,0.0,1.0,43,1350,900,450,0.6666666666666666,18,9,9,341.27473247857387,0.4511581764488741,0.1786737581706732,0.1877923527916859,128895.01006319262,197.72201542783645,129092.73207862045,1460,0,215.95348837209303,37,6,17,37.471092934528315,0.6072635135135135,46.13486842105264,1015.4605263157903,27.444879089615952,0
1475,4,0,1,42,0.0,0.023255813953488372,0.9767441860465116,43,750,300,450,0.4,12,3,9,339.5957862201021,0.4503506829088224,0.17599866941914266,0.18728983383878958,128984.24373584641,160.50113229601624,129144.74486814243,1461,1,216.95348837209303,38,5,17,37.422871967466,0.606359649122807,46.04700854700855,1015.8119658119666,26.731893837157017,0
1476,4,2,3,41,0.045454545454545456,0.06818181818181818,0.9318181818181819,44,1150,800,350,0.6956521739130435,15,8,7,330.976032590515,0.4518476920366455,0.17143949194401964,0.18406077208091218,129312.88954293617,-239.7413144771954,129073.14822845897,1462,0,212.63636363636363,37,7,19,37.30774759235303,0.6114864864864865,45.72368421052631,1017.1052631578938,27.489331436699832,0
1477,4,0,0,41,0.0,0.0,1.0,41,550,300,250,0.5454545454545454,8,3,5,346.1481069747706,0.4469258130081301,0.1749601022204208,0.19064217293755314,128929.98598327112,725.7741160785952,129655.76009934972,1463,1,228.609756097561,38,3,19,37.31174170699208,0.6058114035087719,46.100427350427346,1015.5982905982896,26.72627080521815,0
1478,4,1,0,42,0.023809523809523808,0.0,1.0,42,1600,1400,200,0.875,18,14,4,336.02534876347585,0.4489208284939992,0.1739618924492874,0.18766469838884356,129480.23069598323,302.298649230343,129782.52934521358,1464,0,224.14285714285714,37,5,15,37.009355024060916,0.6131756756756757,45.55921052631578,1017.7631578947356,27.507112375533396,0
1479,4,0,0,42,0.0,0.0,1.0,42,1700,1400,300,0.8235294117647058,20,14,6,336.4405468361207,0.44835220673635306,0.1682247541143247,0.18910279011823325,129731.44531249987,329.38368055554184,130060.82899305542,1465,1,225.14285714285714,37,5,17,36.74377982276753,0.6157094594594594,45.31249999999999,1018.749999999999,27.533783783783758,0
1480,4,0,2,40,0.0,0.047619047619047616,0.9523809523809523,42,1100,900,200,0.8181818181818182,13,9,4,338.42196448196876,0.44847319008904374,0.17222068513224076,0.19062386290275252,129815.23762119106,386.4655470914047,130201.70316828246,1466,2,226.14285714285714,37,5,18,36.6082956746288,0.6165540540540541,45.23026315789473,1019.0789473684205,27.542674253200552,0
1481,4,0,0,40,0.0,0.0,1.0,40,1100,700,400,0.6363636363636364,15,7,8,350.8612578652097,0.4447916666666667,0.17707296849087872,0.1969919352818637,129688.42734203808,1100.5289495576735,130788.95629159575,1467,3,238.25,36,4,18,36.4202137460844,0.6171875,45.35472972972973,1018.5810810810818,28.29391891891894,0
1482,4,0,0,40,0.0,0.0,1.0,40,600,300,300,0.5,9,3,6,349.6395382335122,0.44435096153846154,0.17614955233779184,0.1965934681416152,129745.78622118762,1072.8513564240195,130818.63757761163,1468,4,239.25,36,4,18,36.39304926126526,0.6177662037037037,45.298423423423436,1018.806306306308,28.300175175175223,0
1483,4,0,2,38,0.0,0.05,0.95,40,850,500,350,0.5882352941176471,12,5,7,350.10316980361296,0.44425747863247866,0.1710837384003534,0.19757692600139082,129889.23890106338,1094.9268525282203,130984.1657535916,1469,5,240.25,36,4,20,36.2355464722345,0.619212962962963,45.157657657657666,1019.3693693693706,28.31581581581585,0
1484,4,0,0,38,0.0,0.0,1.0,38,1000,600,400,0.6,14,6,8,365.4252181282389,0.4410117354196301,0.1722138484727307,0.20499755679259554,129655.65653344666,1875.889314058951,131531.54584750562,1470,6,251.10526315789474,34,4,20,36.08270017533606,0.6210171568627452,45.38690476190476,1018.4523809523805,29.954481792717075,0
1485,4,1,0,39,0.02564102564102564,0.0,1.0,39,1450,1100,350,0.7586206896551724,18,11,7,357.61199698259946,0.4421108861898336,0.1731227573924199,0.20237118210749427,129996.88042534734,1497.688802083339,131494.56922743068,1471,0,245.64102564102564,35,4,21,35.9348399727613,0.6223214285714286,45.052083333333336,1019.7916666666675,29.136904761904788,0
1486,4,0,0,39,0.0,0.0,1.0,39,500,300,200,0.6,7,3,4,357.84364530767164,0.4419140800719748,0.173283517813704,0.2026554114685865,130026.38996056259,1505.8234739369227,131532.2134344995,1472,1,246.64102564102564,35,4,21,35.898963534574065,0.6226190476190476,45.02314814814816,1019.9074074074089,29.14021164021168,0
1487,4,1,0,40,0.025,0.0,1.0,40,1250,1000,250,0.8,15,10,5,347.16997514498115,0.44416399572649573,0.16793164040358177,0.19795645447665694,130292.12648158881,1046.917197145076,131339.0436787339,1473,0,241.45,35,5,22,35.90165986471678,0.625297619047619,44.76273148148149,1020.9490740740754,29.169973544973583,0
1488,4,1,0,41,0.024390243902439025,0.0,1.0,41,800,600,200,0.75,10,6,4,335.53931047181777,0.4453506097560975,0.16845822270474708,0.19274397353431802,130578.91506371275,562.8718245272727,131141.78688824002,1474,0,236.53658536585365,36,5,18,35.90834802409284,0.6261574074074074,44.481981981982,1022.0720720720752,28.39089089089098,0
1489,4,0,1,40,0.0,0.024390243902439025,0.975609756097561,41,1150,700,450,0.6086956521739131,16,7,9,331.6139940615964,0.4451473577235772,0.16434404211883535,0.1910567935329505,130694.0386332281,467.9944302410888,131162.0330634692,1475,1,237.53658536585365,36,5,18,35.89229992657857,0.6273148148148149,44.36936936936939,1022.5225225225248,28.403403403403466,0
1490,4,0,0,40,0.0,0.0,1.0,40,900,600,300,0.6666666666666666,12,6,6,337.9004320185069,0.4434294871794872,0.1692318578059553,0.1944413365485,130646.8638144077,829.1263449502906,131475.99015935799,1476,2,244.425,35,5,20,35.77929827540663,0.6288690476190476,44.41550925925927,1022.337962962964,29.209656084656114,0
1491,4,0,0,40,0.0,0.0,1.0,40,1450,1100,350,0.7586206896551724,18,11,7,336.8385600533288,0.4428952991452992,0.1755724350506389,0.19464640454990081,130809.21292914548,812.3173849525379,131621.53031409802,1477,3,245.425,36,4,21,35.64233817701454,0.6284722222222222,44.256756756756765,1022.9729729729739,28.415915915915942,0
1492,4,0,1,39,0.0,0.025,0.975,40,1550,1200,350,0.7741935483870968,19,12,7,336.4696337531582,0.4415464743589744,0.17744666813283505,0.19589339624527657,131097.37059694825,822.0568541514455,131919.4274510997,1478,4,246.425,36,4,21,35.360769005204915,0.6313657407407407,43.97522522522522,1024.0990990990988,28.447197197197188,0
1493,4,0,0,39,0.0,0.0,1.0,39,950,700,250,0.7368421052631579,12,7,5,344.87904235968136,0.4399741340530814,0.18362810640038352,0.2001884096455621,130982.0694850255,1234.5941380569636,132216.66362308245,1479,5,253.56410256410257,36,3,21,35.26196369636961,0.6302083333333333,44.08783783783783,1023.6486486486481,28.43468468468467,0
1494,4,0,0,39,0.0,0.0,1.0,39,650,300,350,0.46153846153846156,10,3,7,342.3733536511097,0.43896198830409355,0.18656066308622665,0.19948018266859982,131126.20380092927,1178.8236293726086,132305.02743030188,1480,6,254.56410256410257,36,3,21,35.18050210738501,0.6316550925925926,43.94707207207207,1024.2117117117114,28.450325325325316,0
1495,4,0,0,39,0.0,0.0,1.0,39,1100,900,200,0.8181818181818182,13,9,4,341.9579760898441,0.438540260908682,0.18302620456466623,0.19998827650498596,131270.4173768363,1177.7932493304077,132448.2106261667,1481,7,255.56410256410257,36,3,21,35.0455586080586,0.6331018518518519,43.806306306306304,1024.7747747747746,28.465965965965964,0
1496,4,1,0,40,0.025,0.0,1.0,40,1050,700,350,0.6666666666666666,14,7,7,319.00437667373166,0.4411057692307692,0.13583481349911142,0.1838164292079645,130699.2056235848,338.72372434072497,131037.92934792553,1482,0,250.15,38,2,17,36.209426043952206,0.6236293859649122,44.364316239316246,1022.5427350427365,26.909019343229907,8
1497,4,1,0,41,0.024390243902439025,0.0,1.0,41,1150,800,350,0.6956521739130435,15,8,7,316.333933222876,0.4407774390243902,0.1478798104359471,0.18399778482727097,131061.33355034761,91.82942708337407,131153.162977431,1483,0,245.02439024390245,39,2,19,35.91259749067482,0.625534188034188,44.010416666666686,1023.9583333333364,26.25534188034196,0
1498,4,0,0,41,0.0,0.0,1.0,41,1050,700,350,0.6666666666666666,14,7,7,313.72605518360183,0.4407520325203252,0.14833078260610688,0.1828611915009107,131141.34250217053,28.491210937539165,131169.83371310806,1484,1,246.02439024390245,39,2,20,35.89878046713448,0.6263354700854701,43.932291666666686,1024.2708333333364,26.26335470085478,0
1499,4,0,1,40,0.0,0.024390243902439025,0.975609756097561,41,750,600,150,0.8,9,6,3,337.02383186338915,0.4407520325203252,0.10497828265953868,0.18360253526886117,128496.3348765431,467.3906491126429,128963.72552565574,1485,2,247.02439024390245,38,3,17,37.98515981735159,0.6014254385964912,46.52777777777777,1013.888888888888,26.68128654970758,8
1500,4,1,3,38,0.024390243902439025,0.07317073170731707,0.926829268292683,41,1400,900,500,0.6428571428571429,19,9,10,342.8690254993235,0.4398628048780488,0.14382040456991918,0.1891209692686313,128989.67013888885,645.3124999999961,129634.98263888885,1486,0,247.4878048780488,39,2,18,37.33422203992343,0.6047008547008548,46.041666666666664,1015.8333333333329,26.047008547008538,0
1501,4,1,0,39,0.02564102564102564,0.0,1.0,39,700,500,200,0.7142857142857143,9,5,4,348.92780293990137,0.4408175888439046,0.1419745099307761,0.19296518962583364,129092.79348381906,1208.8129611366726,130301.60644495573,1487,0,233.12820512820514,38,1,20,37.07531714325765,0.6074561403508771,45.94017094017094,1016.2393162393156,26.74313990103462,0
1502,4,1,2,38,0.025,0.05,0.95,40,1100,800,300,0.7272727272727273,14,8,6,345.46718017472,0.44158653846153845,0.14852290329718976,0.19297480682442023,129487.7711326191,946.8920033499028,130434.663135969,1488,0,228.275,36,4,16,36.76145164859483,0.615162037037037,45.5518018018018,1017.7927927927927,28.27202202202202,0
1503,4,1,0,39,0.02564102564102564,0.0,1.0,39,1100,600,500,0.5454545454545454,16,6,10,347.10690533342216,0.4407051282051282,0.13995962757572666,0.19474161611882584,129659.75265806357,1201.1590982874889,130860.91175635107,1489,0,227.12820512820514,36,3,18,36.54494692613889,0.6168981481481481,45.38288288288289,1018.4684684684693,28.290790790790812,0
1504,4,0,1,38,0.0,0.02564102564102564,0.9743589743589743,39,1150,900,250,0.782608695652174,14,9,5,353.69741377355894,0.44028340080971656,0.13990342107052967,0.19902078357109254,129774.47041636264,1380.1789120201643,131154.6493283828,1490,1,228.12820512820514,36,3,18,36.26054560860595,0.6180555555555556,45.27027027027029,1018.9189189189216,28.303303303303377,0
1505,4,1,0,39,0.02564102564102564,0.0,1.0,39,1050,800,250,0.7619047619047619,13,8,5,352.76181313805773,0.4387089518668466,0.138457007244283,0.19936987866117223,129946.64216581464,1368.0426203230463,131314.6847861377,1491,0,229.02564102564102,36,3,19,36.10950040497754,0.6197916666666667,45.10135135135136,1019.5945945945961,28.322072072072114,0
1506,4,0,0,39,0.0,0.0,1.0,39,800,300,500,0.375,13,3,10,351.48294600531847,0.4383715699505173,0.13745795423214813,0.19883159354315474,129982.90339335182,1337.3547630040048,131320.25815635582,1492,1,230.02564102564102,37,2,19,36.10528673835126,0.6182432432432432,45.06578947368421,1019.7368421052633,27.560455192034144,0
1507,4,0,0,39,0.0,0.0,1.0,39,1300,1100,200,0.8461538461538461,15,11,4,352.1459451936364,0.4373875393612236,0.1389363324847197,0.19966089576655827,130071.79578493688,1360.8510939440534,131432.64687888094,1493,2,231.02564102564102,38,1,19,35.99815842759393,0.6173245614035088,44.978632478632484,1020.0854700854707,26.84435447593344,0
1508,4,0,0,39,0.0,0.0,1.0,39,1400,1000,400,0.7142857142857143,18,10,8,351.67123788304184,0.4365159694107063,0.13436509406361785,0.2000902522630555,130208.06081753605,1358.0859860106696,131566.14680354673,1494,3,232.02564102564102,38,1,20,35.87202100561777,0.6186951754385965,44.84508547008547,1020.6196581196588,26.858412055780494,0
1509,4,0,1,38,0.0,0.02564102564102564,0.9743589743589743,39,750,300,450,0.4,12,3,9,354.63524778663594,0.43634727845254156,0.13951136145649867,0.2023668923656986,130321.66950660142,1443.3657543110335,131765.03526091247,1495,4,233.02564102564102,35,4,20,35.68115695609461,0.6255952380952381,44.73379629629629,1021.0648148148142,29.173280423280406,0
1510,4,0,1,37,0.0,0.02631578947368421,0.9736842105263158,38,1050,700,350,0.6666666666666666,14,7,7,353.21537157788595,0.4354700094831674,0.1420527747292073,0.20186349992249109,130380.76560356637,1610.4981138545772,131991.26371742095,1496,5,237.39473684210526,35,3,20,35.657487156240556,0.6261904761904762,44.67592592592592,1021.296296296295,29.179894179894145,0
1511,4,0,0,37,0.0,0.0,1.0,37,650,400,250,0.6153846153846154,9,4,5,353.17900143371224,0.4343405905905906,0.12047801738523423,0.20230441568172447,130469.43486636209,1815.8129447444912,132285.2478111066,1497,6,239.35135135135135,35,2,21,35.56854442808051,0.6270833333333333,44.58912037037036,1021.6435185185168,29.189814814814763,0
1512,4,1,2,36,0.02631578947368421,0.05263157894736842,0.9473684210526316,38,1450,1000,450,0.6896551724137931,19,10,9,349.5313042427097,0.43373636794689424,0.13289357857672313,0.20258549062230521,130924.43795146498,1552.4379108838534,132476.87586234882,1498,0,234.02631578947367,36,2,17,35.201181044600936,0.6296296296296297,44.14414414414414,1023.4234234234234,28.42842842842843,0
1513,4,0,1,35,0.0,0.027777777777777776,0.9722222222222222,36,1250,1100,150,0.88,14,11,3,373.47058738803287,0.4287863756613757,0.15978179368891965,0.20093866741745023,127998.08873724683,2360.704277049006,130358.79301429584,1499,1,247.58333333333334,35,1,20,37.57160490296999,0.6020833333333333,47.01967592592591,1011.9212962962943,28.912037037036978,7
1514,4,1,0,36,0.027777777777777776,0.0,1.0,36,1200,1000,200,0.8333333333333334,14,10,4,370.97900489921574,0.4281911375661376,0.13869217589948635,0.20135903210741674,128349.69142500425,2323.0081607938937,130672.69958579814,1500,0,236.36111111111111,35,1,21,37.27453359984771,0.6056547619047619,46.6724537037037,1013.3101851851849,28.95171957671957,0
1515,4,1,1,36,0.02702702702702703,0.02702702702702703,0.972972972972973,37,1300,1100,200,0.8461538461538461,15,11,4,349.4729798271816,0.43108733733733734,0.06738343527974666,0.19365823136279736,129172.76810171665,1628.4784362064865,130801.24653792313,1501,0,230.94594594594594,36,1,17,36.9800321258447,0.6119791666666667,45.86148648648649,1016.5540540540545,28.237612612612626,8
1516,4,2,2,36,0.05263157894736842,0.05263157894736842,0.9473684210526316,38,1050,800,250,0.7619047619047619,13,8,5,339.0850375929941,0.4367443100995732,0.07868659153268842,0.1896424993381542,129536.03512619277,1184.7462680825026,130720.78139427527,1502,0,225.78947368421052,37,1,12,36.874820479678306,0.6137387387387387,45.50438596491229,1017.9824561403516,27.513039355144638,0
1517,4,0,0,36,0.0,0.0,1.0,36,1150,900,250,0.782608695652174,14,9,5,354.2286500797362,0.43154761904761907,0.08568582811610703,0.19658235571386504,129230.80800165047,1955.4509334276504,131186.2589350781,1503,2,239.33333333333334,35,1,18,36.800061658129394,0.6145833333333333,45.80439814814815,1016.7824074074082,29.05092592592595,0
1518,4,0,0,36,0.0,0.0,1.0,36,1050,700,350,0.6666666666666666,14,7,7,353.71721003708376,0.43073743386243385,0.09713375796178347,0.1973275197110433,129436.83556241434,1956.8072702332026,131393.64283264754,1504,3,240.33333333333334,35,1,13,36.603351531695466,0.6166666666666667,45.601851851851855,1017.5925925925932,29.07407407407409,0
1519,4,0,0,36,0.0,0.0,1.0,36,1300,1000,300,0.7692307692307693,16,10,6,353.3528389685173,0.43039021164021163,0.10091508468796206,0.1978640944879726,129584.09857521014,1957.781823345347,131541.88039855548,1505,4,241.33333333333334,35,1,15,36.462832973362126,0.6181547619047619,45.45717592592593,1018.171296296297,29.090608465608486,0
1520,4,0,1,35,0.0,0.027777777777777776,0.9722222222222222,36,1150,700,450,0.6086956521739131,16,7,9,350.7298875941604,0.4299603174603175,0.10038072508239604,0.19669039394142865,129643.02722318663,1893.9368730709775,131536.9640962576,1506,5,242.33333333333334,35,1,15,36.469698261166045,0.61875,45.39930555555555,1018.4027777777769,29.097222222222197,0
1521,4,1,0,36,0.027777777777777776,0.0,1.0,36,900,800,100,0.8888888888888888,10,8,2,351.10725943204994,0.43253968253968256,0.11088091724372817,0.1983902404321313,129937.87140185613,1924.425984867968,131862.2973867241,1507,0,241.91666666666666,35,1,16,36.16057914254362,0.6217261904761905,45.1099537037037,1019.5601851851851,29.130291005291003,0
1522,4,0,1,35,0.0,0.027777777777777776,0.9722222222222222,36,1000,700,300,0.7,13,7,6,352.1690493856746,0.43196097883597884,0.10633227417158464,0.19944175213281257,130026.38996056236,1958.2540294924506,131984.6439900548,1508,1,242.91666666666666,35,1,17,36.04365259494628,0.6226190476190476,45.023148148148145,1019.9074074074069,29.14021164021163,0
1523,4,0,0,35,0.0,0.0,1.0,35,950,700,250,0.7368421052631579,12,7,5,357.84278649467524,0.4320028011204482,0.10561820244211617,0.20214812820187322,129928.59977324262,2298.802437641714,132227.40221088432,1509,2,250.57142857142858,34,1,17,35.99831659660593,0.6237745098039216,45.11904761904761,1019.5238095238094,29.9859943977591,0
1524,4,0,1,34,0.0,0.02857142857142857,0.9714285714285714,35,850,600,250,0.7058823529411765,11,6,5,358.86304412832703,0.430952380952381,0.09822595704948722,0.20335572500605176,130049.99999999985,2334.0277777777656,132384.0277777776,1510,3,251.57142857142858,34,1,17,35.848992374727686,0.625,44.99999999999999,1019.9999999999989,29.999999999999968,0
1525,4,0,0,34,0.0,0.0,1.0,34,750,500,250,0.6666666666666666,10,5,5,365.62404103901144,0.43107546048722517,0.09194756157060757,0.20649194822834577,129918.783115268,2700.2860978950207,132619.06921316302,1511,4,253.97058823529412,33,1,17,35.80996814520976,0.6259469696969697,45.128676470588225,1019.4852941176457,30.89349376114078,0
1526,4,0,0,34,0.0,0.0,1.0,34,850,400,450,0.47058823529411764,13,4,9,366.8933201212264,0.43087121212121215,0.10089584716903821,0.20837338221891735,130137.51471789685,2749.3169694348194,132886.83168733167,1512,5,254.97058823529412,33,1,18,35.55528865401553,0.6281565656565656,44.9142156862745,1020.3431372549011,30.919489007724277,0
1527,4,2,1,35,0.05555555555555555,0.027777777777777776,0.9722222222222222,36,1250,900,350,0.72,16,9,7,353.17604317155747,0.43348214285714287,0.1009383917235489,0.20416762888118972,130824.41332572415,2040.8097297239037,132865.22305544806,1513,0,241.75,35,1,17,35.20913470603764,0.6306547619047619,44.24189814814813,1023.0324074074049,29.229497354497283,0
1528,4,0,0,35,0.0,0.0,1.0,35,850,400,450,0.47058823529411764,13,4,9,364.56172753475585,0.4307072829131653,0.10949111402969214,0.21067107765340648,130810.03578514728,2537.666524943294,133347.70231009056,1514,1,249.65714285714284,34,1,18,34.932503200279285,0.6326593137254901,44.25595238095237,1022.9761904761896,30.087535014005574,0
1529,4,0,0,35,0.0,0.0,1.0,35,1000,800,200,0.8,12,8,4,355.87865805348525,0.43007703081232496,0.0509839519071027,0.2045750438886372,130606.84479827489,2297.06168312916,132903.90648140406,1515,2,250.65714285714284,33,2,17,35.36034348399472,0.6328914141414141,44.45465686274511,1022.1813725490211,30.975193107546094,8
1530,4,0,0,35,0.0,0.0,1.0,35,600,300,300,0.5,9,3,6,355.87865805348525,0.43007703081232496,0.0509839519071027,0.2045750438886372,130606.84479827489,2296.0377318819947,132902.88253015687,1516,3,251.65714285714284,33,2,17,35.36034348399472,0.6328914141414141,44.45465686274511,1022.1813725490211,30.975193107546094,0
1531,4,0,0,35,0.0,0.0,1.0,35,1000,600,400,0.6,14,6,8,356.9907091879855,0.42895658263305325,0.05253334703172907,0.20554682448277198,130669.48596993962,2329.5584931276667,132999.0444630673,1517,4,252.65714285714284,33,2,17,35.26846358224459,0.6335227272727273,44.39338235294119,1022.4264705882367,30.98262032085566,0
1532,4,0,0,35,0.0,0.0,1.0,35,1000,800,200,0.8,12,8,4,359.4227666220066,0.42871148459383757,0.0540005819028222,0.20761950401341814,130794.81336805571,2402.126736111131,133196.94010416683,1518,5,253.65714285714284,33,2,17,35.07934487440597,0.6347853535353536,44.27083333333334,1022.9166666666679,30.997474747474783,0
1533,4,0,0,35,0.0,0.0,1.0,35,900,500,400,0.5555555555555556,13,5,8,360.55792606403963,0.4283963585434174,0.04747989734816116,0.20878354248507144,130888.84833958092,2438.6023404459847,133327.4506800269,1519,6,254.65714285714284,33,2,18,34.955089820359284,0.6357323232323233,44.17892156862745,1023.2843137254902,31.008615567439097,0
1534,4,1,0,36,0.027777777777777776,0.0,1.0,36,1200,900,300,0.75,15,9,6,350.65106748628466,0.4275462962962963,0.049232158988256725,0.2053813395276811,131328.12500000012,2010.0694444444594,133338.19444444458,1520,0,248.55555555555554,36,0,20,34.76456639566396,0.6336805555555556,43.75000000000001,1025.000000000001,28.472222222222246,0
1535,4,0,2,34,0.0,0.05555555555555555,0.9444444444444444,36,1050,800,250,0.7619047619047619,13,8,5,344.5357683351252,0.4271825396825397,0.045008778530223115,0.20242618749663208,131446.78605109753,1857.6238854595488,133304.4099365571,1521,1,249.55555555555554,35,1,21,34.801542513167796,0.6369047619047619,43.63425925925927,1025.462962962964,29.298941798941826,0
1536,4,0,0,34,0.0,0.0,1.0,34,1150,700,450,0.6086956521739131,16,7,9,355.2779430233327,0.42294266191325014,0.069105691056911,0.2080913666279521,131328.12500000012,2531.597222222237,133859.72222222236,1522,2,262.79411764705884,34,0,22,34.646002710027105,0.6378676470588236,43.75000000000001,1025.000000000001,30.147058823529438,0
1537,4,0,0,34,0.0,0.0,1.0,34,1100,800,300,0.7272727272727273,14,8,6,368.7901056748884,0.422756981580511,0.03716985035514786,0.20295352267140634,128898.98667800454,2707.334183673468,131606.32086167802,1523,3,263.79411764705884,34,0,20,36.768513091051176,0.6133578431372548,46.13095238095238,1015.4761904761905,29.866946778711483,8
1538,4,1,0,35,0.02857142857142857,0.0,1.0,35,1350,1100,250,0.8148148148148148,16,11,5,354.22865007973616,0.42661064425770306,0.039808114480851975,0.19658235571386504,129230.80800165047,2155.450933427651,131386.2589350781,1524,0,257.22857142857146,35,0,21,36.80006165812939,0.6145833333333333,45.80439814814815,1016.7824074074082,29.05092592592595,0
1539,4,0,0,35,0.0,0.0,1.0,35,950,700,250,0.7368421052631579,12,7,5,356.655919055426,0.4258053221288515,0.038624097795695755,0.1983729251050051,129319.08543381335,2224.4834533607595,131543.5688871741,1525,1,258.22857142857146,35,0,21,36.648460021241085,0.6154761904761905,45.71759259259259,1017.1296296296289,29.06084656084654,0
1540,4,0,0,35,0.0,0.0,1.0,35,750,400,350,0.5333333333333333,11,4,7,355.6396502296586,0.42514005602240895,0.037674894778751966,0.19825162746790884,129407.39300679413,2204.4799972136234,131611.87300400774,1526,2,259.22857142857146,35,0,23,36.584409244302904,0.6163690476190475,45.630787037037024,1017.4768518518495,29.07076719576713,0
1541,4,0,0,35,0.0,0.0,1.0,35,1100,600,500,0.5454545454545454,16,6,10,355.93987358443434,0.4252801120448179,0.039295054007959074,0.199014061549593,129525.18332315233,2220.635475608699,131745.81879876103,1527,3,260.22857142857146,35,0,17,36.456912071252596,0.6175595238095238,45.51504629629629,1017.9398148148141,29.083994708994688,0
1542,4,1,0,36,0.027777777777777776,0.0,1.0,36,1050,700,350,0.6666666666666666,14,7,7,346.0933431409903,0.4263888888888889,0.03746869936662334,0.1953140238224589,129889.23890106307,1790.760185861525,131679.9990869246,1528,0,253.97222222222223,36,0,19,36.337733834143464,0.619212962962963,45.15765765765765,1019.3693693693681,28.31581581581578,0
1543,4,0,0,36,0.0,0.0,1.0,36,1000,600,400,0.6,14,6,8,346.3285394701105,0.42723214285714284,0.034838001300406596,0.19616620275051835,130032.77084094219,1806.8119217190078,131839.5827626612,1529,1,254.97222222222223,36,0,20,36.18609914982885,0.6206597222222222,45.01689189189189,1019.9324324324316,28.331456456456433,0
1544,4,0,0,36,0.0,0.0,1.0,36,1100,800,300,0.7272727272727273,14,8,6,345.904462283454,0.42604166666666665,0.03481493741341524,0.19679423362680123,130205.11379200147,1807.7059745556435,132012.8197665571,1530,2,255.97222222222223,36,0,21,36.022150502041264,0.6223958333333333,44.847972972972975,1020.6081081081082,28.35022522522523,0
1545,4,0,0,36,0.0,0.0,1.0,36,1250,1000,250,0.8,15,10,5,346.77109528305795,0.4251322751322751,0.04251199516415416,0.19802986237426662,130351.2158805941,1840.4194620789067,132191.63534267302,1531,3,256.97222222222223,35,1,22,35.85196361781707,0.6258928571428571,44.70486111111111,1021.1805555555553,29.176587301587293,0
1546,4,0,1,35,0.0,0.027777777777777776,0.9722222222222222,36,1250,900,350,0.72,16,9,7,346.60692622579745,0.42465277777777777,0.03835019886220592,0.19869129511177538,130498.99798525377,1846.37131344307,132345.36929869684,1532,4,257.97222222222223,35,1,17,35.7064642803202,0.6273809523809524,44.56018518518518,1021.7592592592592,29.193121693121693,0
1547,4,0,0,35,0.0,0.0,1.0,35,1050,800,250,0.7619047619047619,13,8,5,352.3740294136303,0.42514005602240895,0.033214077710292056,0.20234990250943263,130566.58340419503,2201.654620181409,132768.23802437645,1533,5,261.8285714285714,34,1,17,35.49068142108327,0.6302083333333333,44.49404761904762,1022.0238095238096,30.059523809523814,0
1548,4,1,0,36,0.027777777777777776,0.0,1.0,36,1300,800,500,0.6153846153846154,18,8,10,344.12587194892956,0.4259093915343915,0.04081568568342275,0.2000090317516577,131031.70680084011,1818.2800711591135,132849.98687199922,1534,0,255.52777777777777,35,1,19,35.23108372899238,0.6327380952380952,44.03935185185185,1023.8425925925919,29.252645502645482,0
1549,4,0,0,36,0.0,0.0,1.0,36,800,600,200,0.75,10,6,4,342.59537816087845,0.42594246031746036,0.03892907373920096,0.1994265727610164,131090.96364883386,1782.23165294923,132873.1953017831,1535,1,256.52777777777777,35,1,19,35.210405364677534,0.6333333333333333,43.981481481481474,1024.0740740740728,29.25925925925922,0
1550,4,0,1,35,0.0,0.027777777777777776,0.9722222222222222,36,1250,1000,250,0.8,15,10,5,344.3378339557606,0.4251818783068783,0.03297551789077291,0.20075031821531458,131150.23389274665,1831.997492283928,132982.23138503058,1536,2,257.52777777777777,35,1,20,35.10593220338986,0.6339285714285714,43.9236111111111,1024.3055555555534,29.265873015872955,0
1551,4,0,0,35,0.0,0.0,1.0,35,900,400,500,0.4444444444444444,14,4,10,352.88614506231676,0.42282913165266106,0.03711395012709118,0.20489317767662765,130992.77388038518,2245.10700113375,133237.88088151894,1537,3,265.65714285714284,34,1,20,35.04622630538433,0.6344975490196079,44.077380952380935,1023.6904761904738,30.108543417366874,0
1552,4,0,0,35,0.0,0.0,1.0,35,1350,900,450,0.6666666666666666,18,9,9,351.3990057950869,0.42188375350140056,0.03328129670840663,0.20451517238493472,131084.19075963701,2212.5708616779807,133296.761621315,1538,4,266.65714285714284,34,1,21,34.99186235759125,0.6354166666666667,43.98809523809523,1024.0476190476177,30.119047619047578,0
1553,4,0,0,35,0.0,0.0,1.0,35,1400,1100,300,0.7857142857142857,17,11,6,356.3098676523138,0.42142857142857143,-0.02980263926194071,0.20112599846451948,129898.25857426293,2263.3574263038427,132161.61600056678,1539,5,267.65714285714284,34,1,19,36.06821012884893,0.623468137254902,45.14880952380952,1019.404761904761,29.982492997198854,8
1554,4,2,1,36,0.05405405405405406,0.02702702702702703,0.972972972972973,37,1100,800,300,0.7272727272727273,14,8,6,340.95288110963855,0.42633258258258255,-0.016140290721169404,0.19545013210622617,130498.99798525345,1499.3120730802264,131998.31005833368,1540,0,254.13513513513513,35,2,16,35.85089110406284,0.6273809523809524,44.56018518518517,1021.7592592592566,29.19312169312162,0
1555,4,0,0,36,0.0,0.0,1.0,36,1050,700,350,0.6666666666666666,14,7,7,350.0209639460461,0.4232638888888889,-0.022319983425915346,0.2003689053783203,130444.94224773238,1931.6928854875187,132376.6351332199,1541,1,262.19444444444446,34,2,20,35.67401817969933,0.6289828431372548,44.613095238095234,1021.5476190476187,30.045518207282903,0
1556,4,0,0,36,0.0,0.0,1.0,36,750,600,150,0.8,9,6,3,348.7174233885069,0.4229662698412699,-0.014382320584999775,0.20025010567159404,130566.58340419493,1906.1685090702827,132472.7519132652,1542,2,263.19444444444446,34,2,16,35.584109881576396,0.6302083333333333,44.49404761904761,1022.0238095238088,30.05952380952379,0
1557,4,0,1,35,0.0,0.027777777777777776,0.9722222222222222,36,700,500,200,0.7142857142857143,9,5,4,348.035135827754,0.4230489417989418,-0.016758547506276145,0.20001537324076946,130597.00255102034,1890.4691043083767,132487.47165532873,1543,3,264.19444444444446,34,2,16,35.570745011258616,0.6305147058823529,44.46428571428571,1022.1428571428567,30.06302521008402,0
1558,4,1,0,36,0.027777777777777776,0.0,1.0,36,900,600,300,0.6666666666666666,12,6,6,340.386826887508,0.4243386243386243,-0.002893060424441485,0.1973797186994249,130942.84664619756,1714.2440147033412,132657.0906609009,1544,0,262.6666666666667,35,1,17,35.41654887104677,0.6318452380952381,44.1261574074074,1023.4953703703692,29.242724867724835,0
1559,4,0,0,36,0.0,0.0,1.0,36,1000,700,300,0.7,13,7,6,341.93320013472464,0.4247850529100529,-0.004596142254370106,0.19904111544684477,131090.9636488339,1764.8705418381178,132855.834190672,1545,1,263.6666666666667,35,1,18,35.22735834840263,0.6333333333333333,43.981481481481474,1024.074074074073,29.259259259259228,0
1560,4,0,0,36,0.0,0.0,1.0,36,1250,1100,150,0.88,14,11,3,337.6131098911155,0.4240410052910053,-0.007745153397327398,0.1975918101841258,131298.4681096748,1665.6168284893351,132964.08493816413,1546,2,264.6666666666667,35,1,19,35.12857613401092,0.6354166666666667,43.77893518518517,1024.884259259257,29.282407407407344,0
1561,4,0,2,34,0.0,0.05555555555555555,0.9444444444444444,36,1150,800,350,0.6956521739130435,15,8,7,336.24912709560635,0.42357804232804236,-0.0064826314402921525,0.1970985121565706,131357.7852393045,1633.7881247856387,132991.57336409015,1547,3,265.6666666666667,35,1,20,35.10370798991382,0.6360119047619048,43.7210648148148,1025.115740740739,29.289021164021115,0
1562,4,0,1,33,0.0,0.029411764705882353,0.9705882352941176,34,950,600,350,0.631578947368421,13,6,7,353.15460943996277,0.4177807486631016,0.006329915624582405,0.2060027481024878,131171.15600069688,2464.7396734429117,133635.89567413979,1548,4,281.2352941176471,33,1,20,34.85900925150536,0.6385732323232323,43.90318627450981,1024.3872549019611,31.042038027332154,0
1563,4,0,0,33,0.0,0.0,1.0,33,900,500,400,0.5555555555555556,13,5,8,363.7559648073858,0.4149700126262626,0.016200954579066895,0.2123392732695778,131198.73769258254,2944.864682175309,134143.60237475784,1549,5,288.75757575757575,32,1,20,34.559608906416884,0.6412760416666667,43.87626262626264,1024.4949494949508,32.01546717171721,0
1564,4,0,0,33,0.0,0.0,1.0,33,750,500,250,0.6666666666666666,10,5,5,362.879238548483,0.413510101010101,0.026361172702635827,0.21254355400696867,131328.12500000012,2931.250000000013,134259.37500000012,1550,6,289.75757575757575,32,1,20,34.45121951219511,0.642578125,43.75000000000001,1025.000000000001,32.03125000000003,0
1565,4,1,1,33,0.029411764705882353,0.029411764705882353,0.9705882352941176,34,850,600,250,0.7058823529411765,11,6,5,352.5873952134023,0.41757650029708854,0.027655419028951522,0.20804892601281347,131610.9057363757,2480.869287053089,134091.77502342878,1551,0,282.20588235294116,33,1,16,34.42949062462678,0.6429924242424243,43.47426470588237,1026.1029411764728,31.094028520499176,0
1566,4,0,0,33,0.0,0.0,1.0,33,700,300,400,0.42857142857142855,11,3,8,360.5184686304115,0.4122080176767677,0.034295180318327345,0.2118763388000147,131457.57607642084,2878.576803387416,134336.15287980824,1552,8,291.75757575757575,32,1,21,34.380899614216524,0.6438802083333333,43.62373737373738,1025.505050505051,32.047032828282845,0
1567,4,0,0,33,0.0,0.0,1.0,33,850,400,450,0.47058823529411764,13,4,9,359.73816882797405,0.41236584595959597,0.033507548711291246,0.21159689684211708,131489.9488094329,2860.3906807979038,134350.3394902308,1553,9,292.75757575757575,32,1,21,34.36820345520949,0.6442057291666667,43.59217171717173,1025.6313131313148,32.050978535353586,0
1568,4,0,0,33,0.0,0.0,1.0,33,700,400,300,0.5714285714285714,10,4,6,361.2924022723045,0.410708648989899,0.03720025053686471,0.2134145818073613,131651.87225793285,2912.9642383430228,134564.83649627588,1554,10,293.75757575757575,32,1,17,34.164821194225716,0.6458333333333333,43.43434343434343,1026.262626262626,32.070707070707066,0
1569,4,0,0,33,0.0,0.0,1.0,33,750,300,450,0.4,12,3,9,362.3631004422856,0.40991950757575757,0.04172583043570621,0.21459390893636007,131749.0741537853,2948.2005981532475,134697.27475193856,1555,11,294.75757575757575,32,1,18,34.039222317878085,0.6468098958333333,43.339646464646464,1026.641414141414,32.08254419191919,0
1570,4,0,0,33,0.0,0.0,1.0,33,600,400,200,0.6666666666666666,8,4,4,361.92698816698396,0.4097616792929293,0.04015067681611417,0.2147011082977448,131813.89534550055,2941.40122819101,134755.29657369156,1556,12,295.75757575757575,32,1,18,33.98499938522071,0.6474609375,43.276515151515156,1026.89393939394,32.09043560606062,0
1571,4,0,0,33,0.0,0.0,1.0,33,900,500,400,0.5555555555555556,13,5,8,361.77927105176974,0.4096433080808081,0.039559702743476866,0.2149798663262341,131878.7324794663,2942.1983407305283,134820.93082019684,1557,13,296.75757575757575,32,1,18,33.92337635730383,0.6481119791666667,43.213383838383834,1027.146464646464,32.098327020202,0
1572,4,0,0,33,0.0,0.0,1.0,33,750,600,150,0.8,9,6,3,362.018534668574,0.4092881944444444,0.047962112834947,0.21585852407820696,132008.45457415064,2957.9014577594094,134966.35603191005,1558,14,297.75757575757575,32,1,18,33.78639882049389,0.6494140625,43.08712121212121,1027.6515151515155,32.11410984848486,0
1573,4,0,0,33,0.0,0.0,1.0,33,900,600,300,0.6666666666666666,12,6,6,359.7705944398657,0.4078677398989899,0.048886656621462965,0.21562409799210497,132203.1572830579,2912.561696510561,135115.71897956845,1559,15,298.75757575757575,32,1,18,33.64794352363412,0.6513671875,42.89772727272727,1028.4090909090912,32.1377840909091,0
1574,4,0,0,33,0.0,0.0,1.0,33,800,600,200,0.75,10,6,4,355.00946666110303,0.4075126262626263,0.04426644652439293,0.21350347924880647,132333.03880024987,2795.89630522395,135128.93510547382,1560,16,299.75757575757575,32,1,19,33.63960813187713,0.6526692708333333,42.77146464646464,1028.9141414141407,32.153566919191896,0
1575,4,0,0,33,0.0,0.0,1.0,33,1300,1000,300,0.7692307692307693,16,10,6,355.55620529963755,0.40617108585858586,0.047450219635650326,0.21475594800098124,132495.48037190083,2821.9180440771397,135317.39841597798,1561,17,300.75757575757575,32,1,20,33.46210448859457,0.654296875,42.61363636363637,1029.5454545454547,32.17329545454546,0
1576,4,0,0,33,0.0,0.0,1.0,33,1050,900,150,0.8571428571428571,12,9,3,359.2774620826804,0.405697601010101,0.048474447837036694,0.21775524039156818,132625.5053693502,2929.870995306615,135555.3763646568,1562,18,301.75757575757575,32,1,17,33.2355254555855,0.6555989583333333,42.487373737373744,1030.050505050506,32.18907828282831,0
1577,4,0,0,33,0.0,0.0,1.0,33,1250,1000,250,0.8,15,10,5,360.23353304416054,0.405145202020202,0.04371207482046402,0.2196644359451512,132853.2025590503,2971.635706815654,135824.83826586595,1563,19,302.75757575757575,32,1,19,32.981986119616245,0.6578776041666667,42.26641414141415,1030.934343434345,32.21669823232328,0
1578,4,0,0,33,0.0,0.0,1.0,33,1100,700,400,0.6363636363636364,15,7,8,362.643689314108,0.40317234848484845,0.046055266319583676,0.22248680398460155,133081.09504132252,3052.2038567493432,136133.29889807187,1564,20,303.75757575757575,32,1,19,32.69089574155654,0.66015625,42.04545454545456,1031.8181818181836,32.24431818181824,0
1579,4,0,0,33,0.0,0.0,1.0,33,600,100,500,0.16666666666666666,11,1,10,363.66097129871207,0.40313289141414144,0.04003336113427869,0.22369664713069798,133178.82303145112,3086.38802800738,136265.2110594585,1565,21,304.75757575757575,32,1,19,32.566513761467895,0.6611328125,41.95075757575759,1032.1969696969718,32.25615530303037,0
1580,4,0,1,32,0.0,0.030303030303030304,0.9696969696969697,33,700,400,300,0.5714285714285714,10,4,6,358.40132819847327,0.40277777777777773,0.00909283553911644,0.2086474053501843,131094.66764661993,2803.9311334559097,133898.59878007584,1566,22,305.75757575757575,31,2,19,34.80199724517906,0.6428091397849462,43.97786458333333,1024.088541666666,33.03511424731181,8
1581,4,1,1,32,0.030303030303030304,0.030303030303030304,0.9696969696969697,33,800,500,300,0.625,11,5,6,354.94745191354366,0.40703914141414144,-0.014042867701404171,0.20789779326364685,131328.12499999997,2722.9166666666656,134051.04166666663,1557,0,259.27272727272725,31,2,23,34.65447154471545,0.6451612903225806,43.75,1024.9999999999998,33.06451612903225,0
1582,4,0,0,32,0.0,0.0,1.0,32,900,700,200,0.7777777777777778,11,7,4,365.07173333886,0.4070270497311828,-0.012545919706113962,0.21306100700679845,131190.39231414022,3178.7807839056354,134369.17309804587,1558,1,265.46875,30,2,23,34.534352313478536,0.6465277777777778,43.88440860215053,1024.4623655913967,34.14874551971322,0
1583,4,0,0,32,0.0,0.0,1.0,32,1050,800,250,0.7619047619047619,13,8,5,367.0037306322386,0.40631300403225806,-0.017353828002097504,0.2153464967125167,131397.01844143838,3244.639192392193,134641.6576338306,1559,2,266.46875,30,2,23,34.2758586785527,0.6486111111111111,43.682795698924735,1025.2688172043015,34.175627240143385,0
1584,4,0,0,32,0.0,0.0,1.0,32,550,500,50,0.9090909090909091,6,5,1,368.14896840252925,0.4070690524193548,-0.01632731621019512,0.2166032982174018,131500.3924767315,3282.346766967287,134782.7392436988,1560,3,267.46875,30,2,23,34.14198663346875,0.6496527777777779,43.58198924731183,1025.6720430107532,34.18906810035844,0
1585,4,0,1,31,0.0,0.03125,0.96875,32,450,300,150,0.6666666666666666,6,3,3,378.9579395085067,0.40650201612903225,-0.05502717391304335,0.21790081521739135,130617.28395061726,3499.691358024688,134116.97530864194,1561,4,268.46875,32,0,18,34.75996376811595,0.6354166666666667,44.44444444444444,1022.2222222222221,31.94444444444444,8
1586,4,0,0,31,0.0,0.0,1.0,31,1350,1100,250,0.8148148148148148,16,11,5,384.8969283561066,0.40165770609319,-0.033633456092163505,0.22252650228800053,130828.11355590809,3871.067810058581,134699.18136596668,1562,28,278.0,31,0,18,34.39409125620466,0.6401209677419355,44.23828124999999,1023.0468749999991,33.001512096774164,0
1587,4,0,0,31,0.0,0.0,1.0,31,1150,800,350,0.6956521739130435,15,8,7,385.47497795180976,0.4014336917562724,-0.0288890439121674,0.22363238388776208,130961.35669284394,3896.4652167426193,134857.82190958655,1563,29,279.0,31,0,18,34.24407942161727,0.6414650537634409,44.108072916666664,1023.567708333333,33.018313172043,0
1588,4,0,0,31,0.0,0.0,1.0,31,1250,800,450,0.64,17,8,9,385.79010529082706,0.4025985663082437,-0.02624607334137119,0.2247870346827885,131128.0059814453,3917.5774468315976,135045.5834282769,1564,30,280.0,31,0,19,34.06697601491652,0.6431451612903225,43.9453125,1024.21875,33.03931451612903,0
1589,4,0,0,31,0.0,0.0,1.0,31,600,500,100,0.8333333333333334,7,5,2,384.3649949509363,0.40237455197132616,-0.02834215608687951,0.22415117978347032,131161.34855482305,3882.766215006506,135044.11476982955,1565,31,281.0,31,0,19,34.069663361721986,0.643481182795699,43.912760416666664,1024.3489583333328,33.04351478494622,0
1590,4,0,0,31,0.0,0.0,1.0,31,600,300,300,0.5,9,3,6,385.12310839908207,0.40161290322580645,-0.0228253784757666,0.22498394506253705,131228.0464172362,3907.790629068996,135135.8370463052,1566,32,282.0,31,0,19,33.982637565129,0.6441532258064516,43.84765624999999,1024.609374999999,33.05191532258062,0
1591,4,0,0,31,0.0,0.0,1.0,31,1350,1200,150,0.8888888888888888,15,12,3,404.53370243660385,0.4017921146953405,-0.05248769819573562,0.22062384275744196,128540.34423828128,4199.780273437501,132740.12451171878,1567,33,283.0,31,0,16,36.22881355932204,0.6169354838709677,46.484375,1014.0625000000002,32.7116935483871,8
1592,4,2,0,33,0.06060606060606061,0.0,1.0,33,950,800,150,0.8421052631578947,11,8,3,386.2553202690193,0.4085385101010101,-0.0385476521078163,0.21437037175233706,129233.48263251186,3385.119465747259,132618.6020982591,1568,0,266.7878787878788,32,1,18,35.98322571298481,0.6214192708333333,45.80176767676767,1016.7929292929283,31.77477904040401,0
1593,4,2,1,34,0.05714285714285714,0.02857142857142857,0.9714285714285714,35,850,500,350,0.5882352941176471,12,5,7,374.40221809650353,0.4158963585434174,-0.020781579374087755,0.21171267916753475,129967.37423911157,2732.0146390603277,132699.38887817189,1569,0,252.4857142857143,35,0,16,35.536795308361704,0.6220238095238095,45.081018518518505,1019.675925925924,29.13359788359783,0
1594,4,0,0,34,0.0,0.0,1.0,34,900,600,300,0.6666666666666666,12,6,6,379.89015203492426,0.41209893048128343,-0.023078825177899054,0.2146028536957182,129928.59977324243,3071.719104308364,133000.3188775508,1570,1,260.88235294117646,34,0,16,35.43637124396699,0.6237745098039216,45.119047619047606,1019.5238095238078,29.985994397759054,0
1595,4,0,0,34,0.0,0.0,1.0,34,1050,800,250,0.7619047619047619,13,8,5,380.8297104359867,0.41131907308377896,-0.032191639783101134,0.21613977605539123,130110.72137188207,3110.005668934239,133220.7270408163,1571,2,261.88235294117646,34,0,17,35.22705173084404,0.6256127450980392,44.94047619047619,1020.2380952380952,30.007002801120446,0
1596,4,0,0,34,0.0,0.0,1.0,34,750,400,350,0.5333333333333333,11,4,7,384.8329622014181,0.4108548722519311,-0.030139082344707524,0.21892322395174246,130201.83000283458,3221.191184807268,133423.02118764186,1572,3,262.88235294117646,34,0,17,35.03222325906918,0.626531862745098,44.85119047619048,1020.595238095239,30.017507002801146,0
1597,4,0,0,34,0.0,0.0,1.0,34,1300,1000,300,0.7692307692307693,16,10,6,384.0074140456844,0.4109105763517528,-0.030435580786149385,0.21897096279360695,130293.86421388414,3206.776144894241,133500.6403587784,1573,4,263.88235294117646,33,1,17,34.95966370583765,0.6297348484848485,44.76102941176471,1020.9558823529416,30.938057040998228,0
1598,4,0,0,34,0.0,0.0,1.0,34,1350,1000,350,0.7407407407407407,17,10,7,382.86174527797925,0.4101121509209744,-0.02931297278988354,0.21919886735145871,130450.3075740101,3188.8864859669543,133639.19405997705,1574,5,264.88235294117646,33,1,17,34.8298544465771,0.6313131313131313,44.60784313725491,1021.5686274509814,30.95662507427216,0
1599,4,0,0,34,0.0,0.0,1.0,34,850,500,350,0.5882352941176471,12,5,7,384.3477250214561,0.41026069518716574,-0.031611829579589745,0.22111922221579225,130638.16350682435,3242.096188965793,133880.25969579016,1575,6,265.88235294117646,33,1,15,34.60101494445778,0.6332070707070707,44.42401960784314,1022.3039215686279,30.978906714200843,0
1600,4,0,0,34,0.0,0.0,1.0,34,1100,700,400,0.6363636363636364,15,7,8,380.7168235584852,0.40890522875817,-0.03329956604470996,0.2201803756165293,130840.48327664411,3162.6346371882214,134003.11791383234,1576,7,266.88235294117646,34,0,15,34.48845124505469,0.6329656862745099,44.22619047619048,1023.0952380952391,30.091036414565856,0
1601,4,1,0,35,0.02857142857142857,0.0,1.0,35,800,500,300,0.625,11,5,6,368.9596248383286,0.41200980392156866,-0.03231357861259565,0.21493902042095936,131120.59709630074,2675.641262645767,133796.23835894652,1577,0,260.22857142857146,35,0,16,34.50542905036351,0.6336309523809525,43.952546296296305,1024.1898148148161,29.262566137566175,0
1602,4,0,0,35,0.0,0.0,1.0,35,500,400,100,0.8,6,4,2,371.4748635449582,0.41183473389355746,-0.032774818401936856,0.21657131372680385,131150.233892747,2743.8030478395144,133894.03694058652,1578,1,261.22857142857146,35,0,16,34.41101694915254,0.6339285714285714,43.923611111111114,1024.305555555556,29.26587301587303,0
1603,4,1,0,36,0.027777777777777776,0.0,1.0,36,1150,800,350,0.6956521739130435,15,8,7,368.8148631014275,0.414781746031746,-0.025271374557873205,0.21732881001642984,131559.0823086601,2504.1889862835847,134063.27129494367,1579,0,254.94444444444446,36,0,15,34.06558726673984,0.6359953703703703,43.52477477477478,1025.9009009009014,28.497247247247262,0
1604,4,0,0,36,0.0,0.0,1.0,36,1100,900,200,0.8181818181818182,13,9,4,368.918093970654,0.41425264550264546,-0.026839051032599315,0.21804925476319983,131674.6370525931,2515.431225144063,134190.06827773718,1580,1,255.94444444444446,36,0,15,33.946172555043525,0.6371527777777778,43.41216216216216,1026.3513513513512,28.509759759759756,0
1605,4,0,0,36,0.0,0.0,1.0,36,950,700,250,0.7368421052631579,12,7,5,368.9233561419461,0.41400462962962964,-0.023330409036078192,0.21888172313977924,131819.15181651246,2526.2327783864976,134345.38459489896,1581,2,256.94444444444446,36,0,15,33.800078590488724,0.638599537037037,43.2713963963964,1026.9144144144145,28.525400400400404,0
1606,4,1,1,36,0.02702702702702703,0.02702702702702703,0.972972972972973,37,850,600,250,0.7058823529411765,11,6,5,359.4463661101497,0.41701076076076077,-0.013797356371191505,0.2154151736579613,132200.59447378045,2103.8046562403865,134304.39913002084,1582,0,250.97297297297297,37,0,16,33.65886110814943,0.6404842342342343,42.90021929824562,1028.3991228070179,27.79457088667616,0
1607,4,0,2,34,0.0,0.05555555555555555,0.9444444444444444,36,600,300,300,0.5,9,3,6,362.97105036822484,0.4137400793650794,-0.017865969458102482,0.20159289416419854,129261.91184807237,2227.8205941309784,131489.73244220336,1583,1,258.80555555555554,34,2,19,36.54613478498399,0.6170343137254901,45.77380952380951,1016.9047619047603,29.908963585434126,6
1608,4,0,0,34,0.0,0.0,1.0,34,1150,800,350,0.6956521739130435,15,8,7,372.8836334318735,0.4096293820558527,-0.010848601735776064,0.20678092399403863,129201.38888888867,2835.4166666666415,132036.8055555553,1584,2,264.94117647058823,32,2,20,36.355874316939904,0.62109375,45.83333333333332,1016.6666666666649,31.77083333333328,0
1609,4,0,0,34,0.0,0.0,1.0,34,1150,700,450,0.6086956521739131,16,7,9,371.90079079018886,0.41003787878787884,-0.012026111338278911,0.2069083405114474,129329.78777675732,2819.5700693806575,132149.35784613798,1585,3,265.94117647058823,32,2,21,36.24989655743132,0.6223958333333333,45.7070707070707,1017.171717171716,31.786616161616124,0
1610,4,0,0,34,0.0,0.0,1.0,34,1100,700,400,0.6363636363636364,15,7,8,372.96501510360366,0.4093137254901961,-0.023954738785008978,0.20868958478697802,129554.63927469119,2863.869598765409,132418.5088734566,1586,4,266.94117647058823,32,2,18,35.99363346975898,0.6246744791666667,45.4861111111111,1018.0555555555541,31.814236111111065,0
1611,4,1,0,35,0.02857142857142857,0.0,1.0,35,1200,800,400,0.6666666666666666,16,8,8,366.49979843652886,0.41379551820728294,-0.015141002301377604,0.20682125667537615,129887.55076172612,2520.7522347173963,132408.30299644353,1587,0,260.2857142857143,33,2,19,35.81940771018673,0.6256313131313131,45.159313725490186,1019.3627450980381,30.889780154486004,0
1612,4,0,0,35,0.0,0.0,1.0,35,850,600,250,0.7058823529411765,11,6,5,367.41054918639054,0.4128851540616247,-0.018063186813187082,0.20766683214882922,129950.01922337548,2549.0015859284663,132499.02080930394,1588,1,261.2857142857143,33,2,19,35.73267227564102,0.6262626262626263,45.09803921568626,1019.6078431372538,30.89720736779557,0
1613,4,0,0,35,0.0,0.0,1.0,35,850,600,250,0.7058823529411765,11,6,5,367.41054918639054,0.4131652661064426,-0.018063186813187082,0.20766683214882922,129950.01922337548,2549.0015859284663,132499.02080930394,1589,2,262.2857142857143,33,2,19,35.73267227564102,0.6262626262626263,45.09803921568626,1019.6078431372538,30.89720736779557,0
1614,4,0,0,35,0.0,0.0,1.0,35,1200,700,500,0.5833333333333334,17,7,10,369.9395183908885,0.41278011204481796,-0.02769647789462848,0.21027210714272523,130168.77710796305,2630.9149425701353,132799.6920505332,1590,3,263.2857142857143,33,2,20,35.44581381850206,0.6284722222222222,44.883578431372534,1020.4656862745079,30.923202614379026,0
1615,4,0,0,35,0.0,0.0,1.0,35,950,800,150,0.8421052631578947,11,8,3,370.6766870505335,0.41250000000000003,-0.0313695905630611,0.21153959976061928,130325.14537677806,2661.6986255286347,132986.8440023067,1591,4,264.2857142857143,33,2,20,35.268142902864476,0.630050505050505,44.73039215686274,1021.0784313725482,30.941770647652973,0
1616,4,0,0,35,0.0,0.0,1.0,35,550,300,250,0.5454545454545454,8,3,5,368.887714088881,0.4129901960784314,-0.027406087194954853,0.21119835059374412,130450.30757401003,2624.303152633606,133074.61072664364,1592,5,265.2857142857143,33,2,20,35.1867402431222,0.6313131313131313,44.6078431372549,1021.5686274509808,30.956625074272146,0
1617,4,0,1,34,0.0,0.02857142857142857,0.9714285714285714,35,1500,1300,200,0.8666666666666667,17,13,4,366.3613900395647,0.4129901960784314,-0.024322519900709993,0.21128443675744094,130732.14215986655,2579.0418649077483,133311.1840247743,1593,6,266.2857142857143,33,2,17,34.96542340722988,0.6341540404040404,44.332107843137265,1022.6715686274522,30.990047534165218,0
1618,4,1,2,33,0.02857142857142857,0.05714285714285714,0.9428571428571428,35,1200,900,300,0.75,15,9,6,362.5951553567385,0.4143557422969188,-0.01789605103384595,0.21047653458616,130982.91710219663,2498.754235149984,133481.6713373466,1594,0,261.0571428571429,33,2,18,34.807728760126096,0.6366792929292929,44.08700980392159,1023.6519607843167,31.019756387403536,0
1619,4,1,0,34,0.029411764705882353,0.0,1.0,34,750,500,250,0.6666666666666666,10,5,5,369.3264467858605,0.4122103386809269,-0.004920102756128086,0.21414593545394803,130940.15438475704,2871.932392102897,133812.08677685994,1595,0,267.61764705882354,32,2,19,34.678787318036036,0.638671875,44.128787878787904,1023.4848484848516,31.98390151515161,0
1620,4,0,0,34,0.0,0.0,1.0,34,1000,700,300,0.7,13,7,6,371.4238276425992,0.4119318181818182,-0.002628964296851777,0.21626838951967886,131101.7390604278,2938.8619464850863,134040.60100691288,1596,1,268.61764705882354,32,2,19,34.46143097850657,0.6402994791666667,43.97095959595961,1024.1161616161637,32.003630050505116,0
1621,4,0,0,34,0.0,0.0,1.0,34,950,700,250,0.7368421052631579,12,7,5,370.9430969036697,0.4109105763517528,-0.003928333285013963,0.21690015666211726,131263.423375166,2938.252155392339,134201.67553055834,1597,2,269.61764705882354,32,2,19,34.31005626745526,0.6419270833333333,43.81313131313133,1024.7474747474764,32.02335858585864,0
1622,4,0,0,34,0.0,0.0,1.0,34,1100,700,400,0.6363636363636364,15,7,8,370.53574657447234,0.41003787878787884,-0.0014015949933718908,0.21757923340067176,131425.20732897162,2939.54746326907,134364.75479224068,1598,3,270.61764705882354,32,2,20,34.15681566309569,0.6435546875,43.65530303030304,1025.3787878787887,32.043087121212146,0
1623,4,0,1,33,0.0,0.029411764705882353,0.9705882352941176,34,1000,600,400,0.6,14,6,8,355.8899101143046,0.40929515745692213,-0.03085614153426508,0.19279572915915363,128272.40404359241,2333.7578754718834,130606.1619190643,1599,4,271.61764705882354,32,2,23,37.735780464497914,0.6116536458333333,46.74873737373737,1013.0050505050498,31.656407828282806,8
1624,4,0,1,32,0.0,0.030303030303030304,0.9696969696969697,33,700,400,300,0.5714285714285714,10,4,6,360.30161048367364,0.40546085858585856,-0.013928487964477432,0.1952051900809877,128276.40109592021,2643.638780381954,130920.03987630217,1600,5,280.24242424242425,31,2,24,37.61996572407884,0.614247311827957,46.74479166666667,1013.0208333333339,32.678091397849485,0
1625,4,2,1,33,0.058823529411764705,0.029411764705882353,0.9705882352941176,34,1000,700,300,0.7,13,7,6,347.5724808845451,0.41200609031491386,-0.012652110881694156,0.18995900077730865,128624.38303489449,2141.259182736465,130765.64221763096,1601,0,272.79411764705884,32,2,20,37.587129698780174,0.615234375,46.401515151515156,1014.3939393939402,31.69981060606063,0
1626,4,0,0,33,0.0,0.0,1.0,33,1350,1200,150,0.8888888888888888,15,12,3,356.24849471445276,0.4075126262626263,-0.006630247000046552,0.1942901454367059,128540.34423828137,2558.46082899307,131098.80506727443,1602,1,282.06060606060606,31,2,21,37.45291902071563,0.6169354838709677,46.48437500000001,1014.0625000000009,32.711693548387125,0
1627,4,0,0,33,0.0,0.0,1.0,33,1200,1000,200,0.8333333333333334,14,10,4,356.86887894486694,0.4064472853535353,-0.007520346542545964,0.19543774937578004,128705.44645521393,2586.1936781141694,131291.6401333281,1603,2,283.06060606060606,31,2,23,37.268622481714345,0.6186155913978495,46.32161458333334,1014.713541666668,32.73269489247316,0
1628,4,0,0,33,0.0,0.0,1.0,33,950,600,350,0.631578947368421,13,6,7,354.2119848860144,0.40625,-0.009546465164730789,0.19446736860361774,128804.55864800363,2524.8236762152983,131329.38232421892,1604,3,284.06060606060606,31,2,23,37.234906789806736,0.6196236559139785,46.22395833333334,1015.104166666668,32.74529569892477,0
1629,4,4,1,36,0.10810810810810811,0.02702702702702703,0.972972972972973,37,1500,1200,300,0.8,18,12,6,318.45527361380874,0.419481981981982,0.0026254125210096735,0.18034883490262785,130026.38996056274,881.5179183813831,130907.90787894413,1605,0,254.24324324324326,35,2,23,36.903275835981226,0.6226190476190476,45.02314814814817,1019.90740740741,29.140211640211714,0
1630,4,0,0,36,0.0,0.0,1.0,36,650,600,50,0.9230769230769231,7,6,1,326.10794215643887,0.41549272486772487,0.0009341429238673982,0.1842208718092183,129928.59977324301,1274.149659863992,131202.749433107,1606,1,262.30555555555554,34,2,23,36.80717733146506,0.6237745098039216,45.11904761904764,1019.5238095238126,29.985994397759193,0
1631,4,0,0,36,0.0,0.0,1.0,36,900,500,400,0.5555555555555556,13,5,8,327.1536133519631,0.4150958994708995,-0.00012322619140259228,0.1850989334196116,129989.29280045375,1305.293367346969,131294.58616780073,1607,2,263.30555555555554,34,2,23,36.71905401198535,0.6243872549019608,45.059523809523824,1019.7619047619067,29.99299719887961,0
1632,4,2,1,37,0.05263157894736842,0.02631578947368421,0.9736842105263158,38,950,700,250,0.7368421052631579,12,7,5,310.4835887044752,0.4220898530109056,0.008708133971291998,0.1782187582222087,130550.14209733422,506.7353248519261,131056.87742218614,1608,0,250.39473684210526,36,2,17,36.57759412304868,0.6258680555555556,44.51013513513516,1021.9594594594627,28.38776276276285,0
1633,4,0,1,36,0.0,0.02702702702702703,0.972972972972973,37,800,500,300,0.625,11,5,6,319.4828085797428,0.4177615115115115,0.005034266081172412,0.18286350638941726,130439.87509645082,934.6595293210055,131374.53462577183,1609,1,258.1621621621622,35,2,25,36.45904146838885,0.6267857142857143,44.618055555555564,1021.5277777777794,29.186507936507983,0
1634,4,0,0,36,0.0,0.0,1.0,36,500,300,200,0.6,7,3,4,325.5923004300883,0.41602182539682536,0.010090412165488116,0.18594745360115186,130353.74858276662,1288.4353741496823,131642.1839569163,1610,2,265.9166666666667,34,2,25,36.39008704437711,0.6280637254901961,44.70238095238096,1021.1904761904776,30.03501400560228,0
1635,4,0,0,36,0.0,0.0,1.0,36,800,500,300,0.625,11,5,6,332.2491994096412,0.41641865079365076,0.00984251968503913,0.17844613800433234,127927.48169273835,1316.6655786088888,129244.14727134725,1611,3,266.9166666666667,33,3,23,38.686528366646485,0.6057449494949495,47.08946078431372,1011.642156862745,30.655822935234696,8
1636,4,0,0,36,0.0,0.0,1.0,36,1250,900,350,0.72,16,9,7,332.87521275156183,0.41716269841269843,0.01161836333790811,0.1791970995373138,128020.48040417129,1322.9689302191218,129343.44933439042,1612,4,267.9166666666667,33,3,23,38.57572454993135,0.6066919191919191,46.99754901960783,1012.0098039215673,30.666963755199006,0
1637,4,1,1,36,0.02702702702702703,0.02702702702702703,0.972972972972973,37,1100,700,400,0.6363636363636364,15,7,8,321.7575419652585,0.4216716716716717,0.0156109581559003,0.17453654809855387,128325.39859693851,857.9329648525743,129183.33156179108,1613,0,261.64864864864865,34,3,25,38.546195120040714,0.6075367647058824,46.696428571428555,1013.2142857142835,29.800420168067163,0
1638,4,0,0,36,0.0,0.0,1.0,36,750,200,550,0.26666666666666666,13,2,11,329.1198057500568,0.41858465608465606,0.017166646506189043,0.1784153071564405,128299.67928501044,1245.1931048154354,129544.87238982588,1614,1,269.77777777777777,33,3,25,38.38592697875083,0.6095328282828283,46.721813725490186,1013.1127450980382,30.700386215092067,0
1639,4,0,0,36,0.0,0.0,1.0,36,850,500,350,0.5882352941176471,12,5,7,327.24527571280515,0.4187665343915344,0.017529013539651528,0.17809032373002093,128454.92118415966,1207.2532199153757,129662.17440407503,1615,2,270.77777777777777,33,3,18,38.27520551257251,0.6111111111111112,46.56862745098037,1013.7254901960762,30.718954248365947,0
1640,4,0,0,36,0.0,0.0,1.0,36,500,300,200,0.6,7,3,4,326.23989052413805,0.4183366402116402,0.015171043445572074,0.17809771332307123,128579.18228565903,1189.531670511296,129768.71395617032,1616,3,271.77777777777777,33,3,19,38.174138069921035,0.6123737373737373,46.44607843137253,1014.2156862745071,30.733808674985063,0
1641,4,1,0,37,0.02702702702702703,0.0,1.0,37,950,700,250,0.7368421052631579,12,7,5,319.2923671917195,0.4223911411411411,0.02667849561167257,0.17571379949324945,128898.98667800442,831.2925170067854,129730.27919501122,1617,0,265.4054054054054,34,3,20,38.02510746385306,0.6133578431372548,46.13095238095237,1015.4761904761896,29.86694677871146,0
1642,4,0,1,36,0.0,0.02702702702702703,0.972972972972973,37,1200,1000,200,0.8333333333333334,14,10,4,317.6659084172279,0.4221096096096096,0.0247784695874691,0.17535322525437383,129019.9050453513,797.0450680271902,129816.9501133785,1618,1,266.4054054054054,34,3,20,37.943568861807655,0.6145833333333333,46.01190476190475,1015.9523809523796,29.88095238095234,0
1643,4,1,1,36,0.02702702702702703,0.02702702702702703,0.972972972972973,37,750,500,250,0.6666666666666666,10,5,5,321.150228433217,0.41888763763763764,0.043198936641559715,0.17809239940387459,129201.38888888869,898.6111111110858,130099.99999999977,1619,0,266.9189189189189,34,3,21,37.670765027322396,0.616421568627451,45.83333333333332,1016.666666666665,29.901960784313676,0
1644,4,1,0,37,0.02702702702702703,0.0,1.0,37,750,500,250,0.6666666666666666,10,5,5,321.480281845727,0.4186061061061061,0.04417198096973429,0.17882340677668523,129322.44897959156,914.9234693877279,130237.37244897928,1620,0,267.5135135135135,34,3,24,37.5395014044944,0.6176470588235294,45.7142857142857,1017.1428571428548,29.915966386554555,0
1645,4,0,0,37,0.0,0.0,1.0,37,1200,900,300,0.75,15,9,6,322.25679297603864,0.41873123123123124,0.03746339365342388,0.17953106602172245,129383.0002834465,938.9101473922615,130321.91043083876,1621,1,268.5135135135135,34,3,24,37.45831383103206,0.6182598039215687,45.65476190476189,1017.3809523809507,29.922969187675022,0
1646,4,0,0,37,0.0,0.0,1.0,37,450,300,150,0.6666666666666666,6,3,3,323.6361221619205,0.4188563563563564,0.03953339088474217,0.18043822153411165,129413.28124999978,976.5624999999703,130389.84374999975,1622,2,269.5135135135135,34,3,24,37.392506142506136,0.6185661764705883,45.624999999999986,1017.4999999999983,29.926470588235244,0
1647,4,1,1,37,0.02631578947368421,0.02631578947368421,0.9736842105263158,38,1050,600,450,0.5714285714285714,15,6,9,319.57721095049214,0.4210674490279753,0.05276607190890403,0.18003054014197564,129819.89354263095,697.4959008487467,130517.3894434797,1623,0,263.39473684210526,35,3,18,37.083688245315194,0.6205357142857143,45.225694444444436,1019.0972222222204,29.117063492063437,0
1648,4,0,0,37,0.0,0.0,1.0,37,900,500,400,0.5555555555555556,13,5,8,329.9141846449469,0.419481981981982,0.04960217226572339,0.18579377766847033,129807.25623582785,1165.0510204081825,130972.30725623603,1624,1,271.43243243243245,34,3,19,36.83313862928349,0.6225490196078431,45.23809523809525,1019.0476190476205,29.97198879551825,0
1649,4,0,0,37,0.0,0.0,1.0,37,1200,900,300,0.75,15,9,6,331.1603536158159,0.419263013013013,0.058894056325762945,0.18736589095594974,129989.29280045356,1209.4600340136055,131198.75283446716,1625,2,272.43243243243245,34,3,19,36.61690598490153,0.6243872549019608,45.05952380952381,1019.761904761905,29.99299719887956,0
1650,4,0,1,36,0.0,0.02702702702702703,0.972972972972973,37,1200,700,500,0.5833333333333334,17,7,10,332.49701491893546,0.41985735735735735,0.06272994095226703,0.18915042527538412,130201.83000283467,1258.3439625850601,131460.17396541973,1626,3,273.43243243243245,34,3,19,36.3675687235118,0.626531862745098,44.85119047619049,1020.5952380952397,30.017507002801167,0
1651,4,1,0,37,0.02702702702702703,0.0,1.0,37,850,500,350,0.5882352941176471,12,5,7,329.3103253605558,0.4176363863863864,0.072439615276775,0.18821807336896829,130384.14292800477,1187.3689058957136,131571.5118339005,1627,0,274.1621621621622,34,3,20,36.2644247581303,0.6283700980392157,44.67261904761906,1021.3095238095258,30.038515406162524,0
1652,4,0,2,35,0.0,0.05405405405405406,0.9459459459459459,37,950,500,450,0.5263157894736842,14,5,9,331.4316494515598,0.41747997997998,0.07794865337090129,0.1903237933472671,130566.58340419507,1254.7796201814103,131821.36302437648,1628,1,275.1621621621622,34,3,18,36.02577169481654,0.6302083333333333,44.49404761904762,1022.02380952381,30.059523809523824,0
1653,4,1,0,36,0.027777777777777776,0.0,1.0,36,1000,800,200,0.8,12,8,4,338.02253161499596,0.41456679894179893,0.08082867039701624,0.19415343758051415,130575.52984429062,1627.494232987313,132203.02407727792,1629,0,274.30555555555554,33,3,19,35.848321342925665,0.6325757575757576,44.48529411764706,1022.0588235294115,30.971479500891256,0
1654,4,0,0,36,0.0,0.0,1.0,36,1350,800,550,0.5925925925925926,19,8,11,340.57835892130566,0.4135085978835979,0.08669485170532454,0.19696705360495953,130840.48327664382,1712.2874149659694,132552.7706916098,1630,1,275.30555555555554,34,2,19,35.515088045923505,0.6329656862745099,44.22619047619047,1023.0952380952368,30.09103641456579,0
1655,4,0,0,36,0.0,0.0,1.0,36,800,500,300,0.625,11,5,6,339.112007796379,0.4135416666666667,0.08721020392339351,0.19673988144623905,130962.3086734692,1682.1782879818397,132644.48696145104,1631,2,276.30555555555554,34,2,20,35.42950880049626,0.6341911764705883,44.10714285714285,1023.5714285714271,30.105042016806678,0
1656,4,0,0,36,0.0,0.0,1.0,36,1250,900,350,0.72,16,9,7,340.80584099513266,0.41380621693121694,0.08701550387596946,0.19803582652419865,131023.24263038542,1730.697278911558,132753.93990929698,1632,3,277.30555555555554,34,2,20,35.32461240310079,0.6348039215686274,44.047619047619044,1023.8095238095232,30.112044817927153,0
1657,4,0,0,36,0.0,0.0,1.0,36,1250,800,450,0.64,17,8,9,342.99797540577345,0.41269841269841273,0.08620600614558316,0.20026055470434773,131206.12953514734,1800.6873582766325,133006.81689342397,1633,4,278.30555555555554,34,2,20,35.08380780850568,0.6366421568627452,43.86904761904761,1024.523809523809,30.1330532212885,0
1658,4,1,0,37,0.02702702702702703,0.0,1.0,37,1050,600,450,0.5714285714285714,15,6,9,332.364328597545,0.41557182182182184,0.042685833730609746,0.19287599226487487,130972.46334876567,1306.1149691358312,132278.5783179015,1634,0,271.7567567567568,35,2,16,35.59192672998643,0.6321428571428571,44.097222222222236,1023.611111111113,29.2460317460318,8
1659,4,1,1,37,0.02631578947368421,0.02631578947368421,0.9736842105263158,38,1100,800,300,0.7272727272727273,14,8,6,334.54372262681034,0.41847439544807963,-0.002920071464136198,0.17988482033524208,127973.55791179718,970.2661417047973,128943.82405350197,1635,0,265.57894736842104,36,2,19,38.581432016323504,0.5998263888888888,47.04391891891893,1011.8243243243263,28.106231231231288,8
1660,4,0,0,37,0.0,0.0,1.0,37,1050,800,250,0.7619047619047619,13,8,5,343.63073210484197,0.41607232232232233,0.004902763909969687,0.1848839071257007,127998.08873724718,1396.8153881601618,129394.90412540734,1636,1,273.5945945945946,35,2,19,38.32649452895651,0.6020833333333333,47.01967592592593,1011.921296296297,28.912037037037056,0
1661,4,0,0,37,0.0,0.0,1.0,37,1700,1400,300,0.8235294117647058,20,14,6,344.41857511150965,0.41626001001001,0.0036645739853358172,0.1868289670346754,128325.39859693871,1439.6139115689955,129765.01250850772,1637,2,274.5945945945946,34,3,21,37.97218305722008,0.6075367647058824,46.69642857142857,1013.2142857142852,29.800420168067213,0
1662,4,0,2,35,0.0,0.05405405405405406,0.9459459459459459,37,1000,700,300,0.7,13,7,6,344.156308559063,0.4163538538538538,0.0014032592442085878,0.18696889947436524,128385.7160572562,1436.9508219954594,129822.66687925166,1638,3,275.5945945945946,34,3,17,37.91725400368064,0.6081495098039216,46.63690476190476,1013.4523809523806,29.807422969187666,0
1663,4,1,0,36,0.027777777777777776,0.0,1.0,36,950,500,450,0.5263157894736842,14,5,9,343.05010143519587,0.4188161375661376,0.031807038819126277,0.18750031522317528,128627.12762188203,1625.1098356008974,130252.23745748293,1639,0,280.3611111111111,34,2,19,37.69901811211515,0.6106004901960784,46.39880952380952,1014.4047619047615,29.835434173669455,0
1664,4,0,0,36,0.0,0.0,1.0,36,1100,1100,0,1.0,11,11,0,343.2389357413233,0.41886574074074073,0.031888901919393975,0.18846094044212885,128808.3351048751,1642.4071712017999,130450.74227607691,1640,1,281.3611111111111,34,2,20,37.50952855635043,0.6124387254901961,46.22023809523809,1015.1190476190461,29.85644257703077,0
1665,4,0,0,36,0.0,0.0,1.0,36,750,500,250,0.6666666666666666,10,5,5,344.54631539741797,0.4183201058201058,0.02885241630845381,0.18961161744128865,128898.98667800444,1682.3341836734533,130581.32086167789,1641,2,282.3611111111111,34,2,20,37.38398788589291,0.6133578431372548,46.13095238095237,1015.4761904761897,29.866946778711462,0
1666,4,0,1,35,0.0,0.027777777777777776,0.9722222222222222,36,800,300,500,0.375,13,3,10,346.5966295146961,0.4178902116402117,0.026781761841522922,0.19132313300636564,129019.90504535133,1743.5728458049698,130763.4778911563,1642,3,283.3611111111111,34,2,21,37.20876298726661,0.6145833333333333,46.01190476190475,1015.9523809523798,29.880952380952348,0
1667,4,0,0,35,0.0,0.0,1.0,35,1100,600,500,0.5454545454545454,16,6,10,353.33225682709764,0.41407563025210087,0.0380584932309076,0.19563002257169196,129139.10064638592,2125.8019752018395,131264.90262158777,1643,4,291.8,33,2,22,36.916244674865375,0.6180555555555556,45.89460784313725,1016.4215686274503,30.80065359477122,0
1668,4,1,1,35,0.027777777777777776,0.027777777777777776,0.9722222222222222,36,900,700,200,0.7777777777777778,11,7,4,344.4525002249953,0.416468253968254,0.03706520043674977,0.19219190417253634,129443.56575963706,1717.4319727891009,131160.99773242616,1644,0,284.6666666666667,34,2,13,36.83220246451412,0.6188725490196079,45.59523809523809,1017.6190476190465,29.929971988795483,0
1669,4,0,0,35,0.0,0.0,1.0,35,1300,1000,300,0.7692307692307693,16,10,6,353.8695018813516,0.41267507002801124,0.03576502967231465,0.1976386155430142,129481.8718311465,2163.937097510552,131645.80892865706,1645,6,293.8,33,2,15,36.55365743527994,0.6215277777777778,45.55759803921568,1017.769607843136,30.841503267973817,0
1670,4,0,0,35,0.0,0.0,1.0,35,1400,1100,300,0.7857142857142857,17,11,6,374.701507887621,0.4125350140056023,0.02018934155940877,0.20880669090999,129394.01113406822,2699.1728201824358,132093.18395425065,1646,7,294.8,32,3,20,36.1131794489948,0.623046875,45.64393939393941,1017.4242424242445,31.794507575757642,8
1671,4,0,0,35,0.0,0.0,1.0,35,800,500,300,0.625,11,5,6,376.11647137781756,0.4122899159663866,0.020361573909961184,0.2099375872095022,129458.25043362938,2738.2760687685127,132196.5265023979,1647,8,295.8,32,3,18,36.01168320926387,0.6236979166666667,45.58080808080809,1017.6767676767689,31.80239898989903,0
1672,4,1,0,36,0.027777777777777776,0.0,1.0,36,750,500,250,0.6666666666666666,10,5,5,365.88195799354986,0.4156084656084656,0.03015605793383558,0.20614324950368323,129825.0973183393,2300.132160707446,132125.22947904674,1648,0,288.55555555555554,33,3,19,35.89866923200257,0.625,45.22058823529413,1019.1176470588252,30.88235294117652,0
1673,4,0,0,36,0.0,0.0,1.0,36,950,500,450,0.5263157894736842,14,5,9,365.88195799354986,0.4156084656084656,0.03015605793383558,0.20614324950368323,129825.0973183393,2300.132160707446,132125.22947904674,1649,1,289.55555555555554,33,3,19,35.89866923200257,0.625,45.22058823529413,1019.1176470588252,30.88235294117652,0
1674,4,0,1,35,0.0,0.027777777777777776,0.9722222222222222,36,1000,700,300,0.7,13,7,6,369.1730509552336,0.41522817460317457,0.029167000614463756,0.20832981260825223,129887.55076172647,2390.196679161884,132277.74744088834,1650,2,290.55555555555554,33,3,19,35.75128235954156,0.6256313131313131,45.15931372549021,1019.3627450980409,30.88978015448609,0
1675,4,0,0,35,0.0,0.0,1.0,35,1350,900,450,0.6666666666666666,18,9,9,375.93795898963316,0.41172969187675074,0.037311715666318745,0.21173728311272363,129811.85154894911,2760.2405047954353,132572.09205374453,1651,3,299.4,32,3,19,35.655949283442794,0.6272786458333333,45.23358585858586,1019.0656565656567,31.84580176767677,0
1676,4,0,0,35,0.0,0.0,1.0,35,1300,700,600,0.5384615384615384,19,7,12,376.50141379673903,0.41155462184873953,0.039048208757187064,0.2127535980691862,129940.55333958281,2784.5604083767107,132725.11374795952,1652,4,300.4,32,3,19,35.51057791537667,0.6285807291666667,45.10732323232324,1019.570707070708,31.861584595959624,0
1677,4,0,0,35,0.0,0.0,1.0,35,850,500,350,0.5882352941176471,12,5,7,372.704229418936,0.411764705882353,0.037575736770738555,0.2111652349526073,130043.75007509123,2693.5711324971053,132737.32120758833,1653,5,301.4,33,2,19,35.50239797348712,0.627209595959596,45.00612745098039,1019.9754901960778,30.908348187759934,0
1678,4,1,0,36,0.027777777777777776,0.0,1.0,36,1200,900,300,0.75,15,9,6,363.159597421755,0.41511243386243385,0.03258391304911035,0.20724017745085774,130323.35778061223,2265.635629251695,132588.99340986394,1654,0,294.0,34,2,20,35.461845633671444,0.6277573529411764,44.732142857142854,1021.0714285714286,30.031512605042018,0
1679,4,1,2,35,0.02702702702702703,0.05405405405405406,0.9459459459459459,37,900,800,100,0.8888888888888888,10,8,2,355.19781788609856,0.41801176176176175,0.03682333000874993,0.20455133788825272,130676.44702717768,1883.197766632377,132559.64479381006,1655,0,287.02702702702703,35,2,18,35.3072409629462,0.6291666666666667,44.386574074074076,1022.453703703704,29.212962962962973,0
1680,4,1,0,36,0.027777777777777776,0.0,1.0,36,950,600,350,0.631578947368421,13,6,7,354.8002702647365,0.41696428571428573,0.04700854700854684,0.2052640307028972,130854.01663237301,2085.408093278447,132939.42472565145,1656,0,290.1111111111111,35,1,19,35.13763197586725,0.6309523809523809,44.212962962962955,1023.1481481481474,29.23280423280421,0
1681,4,0,0,36,0.0,0.0,1.0,36,1400,1100,300,0.7857142857142857,17,11,6,361.01084419787986,0.41663359788359783,0.025961938977403065,0.19958475168867246,129080.38548752839,2128.9394281375194,131209.3249156659,1657,1,291.1111111111111,34,2,18,36.78098641049671,0.6151960784313726,45.952380952380956,1016.1904761904766,29.88795518207284,8
1682,4,0,0,36,0.0,0.0,1.0,36,950,800,150,0.8421052631578947,11,8,3,362.7081360103839,0.4163525132275132,0.025786912336860146,0.20098408652775296,129171.13272392318,2170.284155328834,131341.416879252,1658,2,292.1111111111111,34,2,18,36.645342936331346,0.6161151960784313,45.863095238095255,1016.5476190476212,29.898459383753565,0
1683,4,0,0,36,0.0,0.0,1.0,36,1450,1100,350,0.7586206896551724,18,11,7,363.4802979168212,0.41544312169312164,0.034766920226253495,0.20234131242340336,129352.72285997758,2203.433248299351,131556.15610827695,1659,3,293.1111111111111,34,2,18,36.44065730446657,0.617953431372549,45.684523809523824,1017.2619047619069,29.919467787114908,0
1684,4,0,0,36,0.0,0.0,1.0,36,1100,900,200,0.8181818181818182,13,9,4,398.9027423401575,0.41610449735449734,0.048434177198044104,0.20592820613066776,126320.87305663682,2942.521239500696,129263.39429613751,1660,4,294.1111111111111,33,3,15,38.657477955219626,0.5893308080808081,48.682598039215684,1005.2696078431369,30.462715389185966,8
1685,4,2,0,38,0.05263157894736842,0.0,1.0,38,850,600,250,0.7058823529411765,11,6,5,380.55933287767976,0.4243272878141299,0.060702238020965416,0.19934714512834423,126917.01630015433,2059.8910108024706,128976.9073109568,1661,0,279.57894736842104,35,3,17,38.503618194348725,0.5910714285714286,48.09027777777778,1007.6388888888889,28.78968253968254,0
1686,4,1,0,39,0.02564102564102564,0.0,1.0,39,1350,1100,250,0.8148148148148148,16,11,5,376.9599540543149,0.42622582096266304,0.08119181272495268,0.19942828265848697,127319.21744379513,1798.849271568865,129118.066715364,1662,0,273.38461538461536,36,3,17,38.180419177267,0.5931712962962963,47.69144144144144,1009.2342342342341,28.034284284284283,0
1687,4,1,1,39,0.025,0.025,0.975,40,1000,700,300,0.7,13,7,6,389.5030980986792,0.4282986111111111,0.05206888839185875,0.20320517521577536,126751.58900454507,1976.019093417738,128727.6080979628,1663,0,267.525,36,4,16,38.44893946171624,0.5873842592592593,48.2545045045045,1006.9819819819818,27.971721721721718,8
1688,4,0,0,39,0.0,0.0,1.0,39,800,500,300,0.625,11,5,6,393.04305134166066,0.42633828160143955,0.06309006929767946,0.2048580888928165,126713.00482521007,2160.733212234229,128873.7380374443,1664,1,275.0,35,4,16,38.39964842702228,0.5889880952380953,48.292824074074076,1006.8287037037039,28.766534391534396,0
1689,4,1,0,40,0.025,0.0,1.0,40,1050,800,250,0.7619047619047619,13,8,5,385.74212900737234,0.4265090811965812,0.06880585344057222,0.20265044242218277,127035.24470416352,1800.5691502313027,128835.81385439482,1665,0,269.1,36,4,17,38.25122877569258,0.5902777777777778,47.97297297297297,1008.1081081081072,28.003003003002977,0
1690,4,5,5,40,0.1111111111111111,0.1111111111111111,0.8888888888888888,45,1300,700,600,0.5384615384615384,19,7,12,353.4172658673848,0.4380050505050505,0.11735057148210615,0.1922719620728066,128442.17985243621,83.58434689753437,128525.76419933375,1666,0,240.0888888888889,38,7,15,37.6249385188308,0.6008771929824561,46.58119658119658,1013.6752136752133,26.675663517768772,0
1691,4,0,0,40,0.0,0.0,1.0,40,1000,700,300,0.7,13,7,6,389.71189416115214,0.42705662393162397,0.12842126957955524,0.2082469284658491,127723.00347222216,1955.0347222222174,129678.03819444438,1667,1,270.625,34,6,18,37.44332234130257,0.6014093137254901,47.291666666666664,1010.8333333333328,29.73039215686273,0
1692,4,1,0,41,0.024390243902439025,0.0,1.0,41,850,400,450,0.47058823529411764,13,4,9,382.7608683687893,0.4294969512195122,0.12985518886226788,0.2063969673525524,128087.52745566508,1605.3786472283043,129692.9061028934,1668,0,265.0,36,5,20,37.24482701079096,0.6009837962962963,46.931306306306304,1012.2747747747745,28.118743743743735,0
1693,4,0,1,40,0.0,0.024390243902439025,0.975609756097561,41,1200,600,600,0.5,18,6,12,386.72083809776984,0.4296747967479675,0.13101225533769556,0.20898649611560532,128174.66695011326,1713.5882883710917,129888.25523848434,1669,1,266.0,34,7,20,37.05521592601301,0.6060049019607843,46.84523809523809,1012.6190476190466,29.782913165266077,0
1694,4,2,1,41,0.047619047619047616,0.023809523809523808,0.9761904761904762,42,1300,800,500,0.6153846153846154,18,8,10,370.4723673924907,0.43567315137437085,0.14429838454228694,0.2042579922909698,128972.51136271407,1156.1503226199181,130128.66168533398,1670,0,253.85714285714286,36,6,20,36.65072985957133,0.6099537037037037,46.05855855855856,1015.7657657657658,28.215715715715717,0
1695,4,2,4,39,0.046511627906976744,0.09302325581395349,0.9069767441860466,43,1450,1000,450,0.6896551724137931,19,10,9,354.31583375055135,0.4375,0.1519083727275614,0.19825458483904895,129554.6392746914,581.0578173894685,130135.69709208088,1671,0,247.3953488372093,35,8,17,36.468281036834924,0.6178571428571429,45.486111111111114,1018.055555555556,29.0873015873016,0
1696,4,0,0,39,0.0,0.0,1.0,39,750,300,450,0.4,12,3,9,388.22631734792037,0.4314271255060729,0.16092103430667115,0.2134343091723637,128858.98940611785,2205.290182862364,131064.27958898021,1672,2,273.20512820512823,33,6,20,36.316007845503925,0.6152146464646464,46.1703431372549,1015.3186274509806,30.767231134878198,0
1697,4,0,2,37,0.0,0.05128205128205128,0.9487179487179487,39,1100,800,300,0.7272727272727273,14,8,6,389.3588428035181,0.4312303193882141,0.1615205134394131,0.21422492506440574,128890.09785899652,2236.899870242217,131126.99772923873,1673,3,274.20512820512823,33,6,20,36.25543084721219,0.615530303030303,46.13970588235294,1015.4411764705881,30.770944741532972,0
1698,4,0,0,37,0.0,0.0,1.0,37,1150,900,250,0.782608695652174,14,9,5,392.8763720994149,0.42911661661661665,0.15303417278029463,0.21623449724794172,128903.70898776574,2728.6443074544177,131632.35329522015,1674,4,280.7837837837838,31,6,20,36.152204342437074,0.6206317204301075,46.12630208333333,1015.4947916666658,32.757896505376316,0
1699,4,0,0,37,0.0,0.0,1.0,37,1150,900,250,0.782608695652174,14,9,5,396.3089936278317,0.428272022022022,0.15938429779260233,0.2188534378823757,129035.96878051748,2827.622985839829,131863.5917663573,1675,5,281.7837837837838,31,6,20,35.92969050365243,0.6219758064516129,45.99609374999999,1016.0156249999992,32.77469758064514,0
1700,4,3,2,38,0.075,0.05,0.95,40,850,500,350,0.5882352941176471,12,5,7,369.8413640849103,0.4326655982905983,0.15550012022120718,0.208706951591471,129887.5507617262,1607.6637540859006,131495.2145158121,1676,0,261.575,33,7,18,35.73425102188027,0.6256313131313131,45.15931372549019,1019.3627450980388,30.889780154486022,0
1701,4,0,0,38,0.0,0.0,1.0,38,1300,1000,300,0.7692307692307693,16,10,6,387.2648136630696,0.42917259364627786,0.1655495662824109,0.21711814391819828,129631.97708129873,2440.3806898328844,132072.35777113162,1677,1,276.3421052631579,31,7,18,35.55078740996463,0.6280241935483871,45.41015624999999,1018.3593749999992,32.85030241935481,0
1702,4,0,1,37,0.0,0.02631578947368421,0.9736842105263158,38,750,500,250,0.6666666666666666,10,5,5,384.24245659596085,0.4288614272166904,0.16117320075942976,0.21570521206399523,129683.2135273184,2365.959308999052,132049.17283631745,1678,2,277.3421052631579,32,6,18,35.57549274823355,0.6259765625,45.35984848484847,1018.5606060606041,31.830018939393877,0
1703,4,1,0,38,0.02631578947368421,0.0,1.0,38,1000,900,100,0.9,11,9,2,382.8477987903649,0.42649063537221427,0.17553527782304035,0.21633981632135735,129940.55333958271,2349.4909639322495,132290.04430351497,1679,0,277.2894736842105,32,6,19,35.34881320949431,0.6285807291666667,45.10732323232323,1019.5707070707072,31.8615845959596,0
1704,4,2,1,39,0.05,0.025,0.975,40,1250,600,650,0.48,19,6,13,361.2902483768385,0.4325186965811966,0.16851318944844196,0.20751795258008465,130575.52984429048,1435.5316781459526,132011.06152243642,1680,0,264.375,33,7,20,35.25379696243008,0.6325757575757576,44.48529411764705,1022.0588235294102,30.97147950089122,0
1705,4,0,0,39,0.0,0.0,1.0,39,1500,1100,400,0.7333333333333333,19,11,8,371.1458581644384,0.4284750337381917,0.1702515944453422,0.21287621758503184,130520.50053884803,1888.428636108554,132408.92917495657,1681,1,272.15384615384613,32,7,20,35.05781745541415,0.6344401041666667,44.53914141414141,1021.843434343434,31.93260732323231,0
1706,4,0,0,39,0.0,0.0,1.0,39,1100,800,300,0.7272727272727273,14,8,6,373.64130434782584,0.42825011246063877,0.17098662207357873,0.21484374999999994,130617.28395061727,1960.802469135798,132578.08641975306,1682,2,273.15384615384613,32,7,20,34.895833333333336,0.6354166666666667,44.44444444444444,1022.2222222222222,31.944444444444443,0
1707,4,0,0,39,0.0,0.0,1.0,39,1300,1100,200,0.8461538461538461,15,11,4,372.58864510030094,0.4279689608636977,0.16692450054572183,0.21585639517783695,130907.8494063106,1954.9556486583003,132862.8050549689,1683,3,274.15384615384613,32,7,22,34.62805881143328,0.6383463541666667,44.160353535353536,1023.358585858586,31.979955808080813,0
1708,4,0,0,39,0.0,0.0,1.0,39,1150,800,350,0.6956521739130435,15,8,7,364.6786663341389,0.4276034637876743,0.09146552372358818,0.1999283363664651,128747.91843820851,1598.7572885367663,130346.67572674528,1684,4,275.15384615384613,34,5,19,37.02712609970674,0.6118259803921569,46.2797619047619,1014.8809523809515,29.849439775910337,8
1709,4,0,2,37,0.0,0.05128205128205128,0.9487179487179487,39,1200,1100,100,0.9166666666666666,13,11,2,364.6786663341389,0.427266081871345,0.09146552372358818,0.1999283363664651,128747.91843820851,1590.3238378684669,130338.24227607697,1685,5,276.15384615384613,34,5,19,37.02712609970674,0.6118259803921569,46.2797619047619,1014.8809523809515,29.849439775910337,0
1710,4,1,0,38,0.02631578947368421,0.0,1.0,38,950,800,150,0.8421052631578947,11,8,3,361.57745728185336,0.4274241346609768,0.09410215448383052,0.19944023548713982,128989.67013888874,1727.95138888887,130717.62152777762,1686,0,275.1842105263158,34,4,22,36.85910582444626,0.6142769607843137,46.04166666666666,1015.8333333333321,29.877450980392123,0
1711,4,1,0,39,0.02564102564102564,0.0,1.0,39,1500,1200,300,0.8,18,12,6,352.375929478449,0.4297402159244264,0.10657707472994127,0.1965792621811246,129436.83556241429,1322.085048010981,130758.92061042527,1687,0,269.1025641025641,35,4,18,36.63747346072189,0.6166666666666667,45.601851851851855,1017.5925925925927,29.074074074074076,0
1712,4,0,0,39,0.0,0.0,1.0,39,850,500,350,0.5882352941176471,12,5,7,351.6781436063936,0.4291216824111561,0.10588108416913711,0.19692632904554078,129584.09857521002,1314.3790455675553,130898.47762077759,1688,1,270.1025641025641,35,4,18,36.505461142056,0.6181547619047619,45.457175925925924,1018.1712962962961,29.090608465608458,0
1713,4,0,0,39,0.0,0.0,1.0,39,1050,800,250,0.7619047619047619,13,8,5,350.7438016528927,0.42867183985605034,0.10428904428904429,0.19684601113172542,129672.49657064465,1296.3648834019134,130968.86145404656,1689,2,271.1025641025641,35,4,19,36.439393939393945,0.6190476190476191,45.37037037037037,1018.518518518518,29.100529100529087,0
1714,4,0,3,36,0.0,0.07692307692307693,0.9230769230769231,39,1250,800,450,0.64,17,8,9,352.675951696177,0.42819388214125054,0.10443366968068823,0.1986763758595545,129819.89354263117,1356.8709008487633,131176.76444347991,1690,3,272.1025641025641,35,4,19,36.24041737649063,0.6205357142857143,45.22569444444444,1019.0972222222222,29.11706349206349,0
1715,4,1,0,37,0.02702702702702703,0.0,1.0,37,400,100,300,0.25,7,1,6,357.89237221448536,0.42855355355355357,0.09829617025038129,0.20170616185175833,129837.58680555549,1893.5763888888803,131731.16319444438,1691,0,270.94594594594594,34,3,20,36.089533932951745,0.6228553921568627,45.20833333333333,1019.1666666666661,29.975490196078415,0
1716,4,0,0,37,0.0,0.0,1.0,37,650,400,250,0.6153846153846154,9,4,5,357.6953000798469,0.42742742742742745,0.09898865590634398,0.20222179836197268,129958.94451530604,1897.1407312925055,131856.08524659855,1692,1,271.94594594594594,34,3,21,35.97124927028605,0.6240808823529411,45.08928571428571,1019.6428571428565,29.98949579831931,0
1717,4,0,1,36,0.0,0.02702702702702703,0.972972972972973,37,800,400,400,0.5,12,4,8,361.5329574095434,0.42686436436436437,0.10166048401342542,0.20486867586540786,130050.0,2003.4722222222222,132053.47222222222,1693,2,272.94594594594594,34,3,21,35.78090958605665,0.625,45.0,1020.0,30.0,0
1718,4,1,1,36,0.02702702702702703,0.02702702702702703,0.972972972972973,37,1050,800,250,0.7619047619047619,13,8,5,361.6887413387526,0.4270833333333333,0.11057366332843488,0.2062442781720154,130293.8642138839,2025.3383614474997,132319.2025753314,1694,0,273.18918918918916,33,4,22,35.529323210498944,0.6297348484848485,44.761029411764696,1020.9558823529397,30.938057040998174,0
1719,4,0,0,36,0.0,0.0,1.0,36,900,700,200,0.7777777777777778,11,7,4,361.33772243965495,0.426223544973545,0.11862141152312766,0.20637609603081852,130356.4302942376,2220.539125576678,132576.96941981427,1695,1,280.1388888888889,33,3,23,35.47479399175967,0.6303661616161615,44.69975490196077,1021.2009803921553,30.945484254307736,0
1720,4,1,1,36,0.02702702702702703,0.02702702702702703,0.972972972972973,37,1000,700,300,0.7,13,7,6,358.9211265075216,0.42736486486486486,0.1364026659034221,0.20741151580895303,130810.0357851473,1990.0970804988485,132800.13286564616,1696,0,273.5405405405405,34,3,18,35.07675821405017,0.6326593137254901,44.25595238095237,1022.9761904761897,30.087535014005578,0
1721,4,1,1,36,0.02702702702702703,0.02702702702702703,0.972972972972973,37,850,600,250,0.7058823529411765,11,6,5,358.5979692092226,0.4280530530530531,0.14213399066819288,0.2077161821645872,130901.38888888872,1988.194444444425,132889.58333333314,1697,0,274.3783783783784,34,3,19,34.99253528773074,0.633578431372549,44.16666666666666,1023.3333333333319,30.09803921568623,0
1722,4,0,1,35,0.0,0.027777777777777776,0.9722222222222222,36,1100,600,500,0.5454545454545454,16,6,10,368.38241089094555,0.4239252645502645,0.14839330165195785,0.21279501617347543,130794.81336805546,2436.5017361111,133231.31510416657,1698,1,282.9166666666667,33,3,20,34.85022063815342,0.6347853535353536,44.27083333333333,1022.9166666666658,30.997474747474723,0
1723,4,0,0,35,0.0,0.0,1.0,35,700,400,300,0.5714285714285714,10,4,6,374.82578875171464,0.42419467787114845,0.14535449735449735,0.21624564735675855,130746.38429752078,2801.423324150615,133547.80762167138,1699,2,283.42857142857144,32,3,20,34.73456790123458,0.63671875,44.31818181818183,1022.7272727272737,31.960227272727302,0
1724,4,0,0,35,0.0,0.0,1.0,35,1400,1000,400,0.7142857142857143,18,10,8,373.69594203161705,0.4238795518207283,0.14536093380823023,0.21595467349073902,130810.95838434855,2776.7048642995605,133587.6632486481,1700,3,284.42857142857144,32,3,21,34.69796552291614,0.6373697916666667,44.255050505050505,1022.9797979797981,31.968118686868692,0
1725,4,0,0,35,0.0,0.0,1.0,35,950,600,350,0.631578947368421,13,6,7,375.29291294493055,0.4237044817927171,0.1514222269218568,0.21760546154017216,130940.15438475671,2828.1823921028545,133768.33677685956,1701,4,285.42857142857144,32,3,21,34.526122625215905,0.638671875,44.12878787878788,1023.4848484848488,31.983901515151526,0
1726,4,0,0,35,0.0,0.0,1.0,35,1050,900,150,0.8571428571428571,12,9,3,377.05187825054855,0.4228641456582633,0.1574792609683504,0.2195454260222684,131101.73906042744,2886.431390929488,133988.17045135694,1702,5,286.42857142857144,32,3,22,34.3173365388567,0.6402994791666667,43.97095959595959,1024.116161616161,32.00363005050503,0
1727,4,1,0,36,0.027777777777777776,0.0,1.0,36,1150,800,350,0.6956521739130435,15,8,7,368.65044699532206,0.4255787037037037,0.14243164129289965,0.21683907175546696,131489.9488094326,2494.9609733700477,133984.90978280263,1703,0,279.44444444444446,32,4,23,34.139685666215264,0.6442057291666667,43.59217171717171,1025.6313131313123,32.05097853535351,0
1728,4,0,1,35,0.0,0.027777777777777776,0.9722222222222222,36,1300,800,500,0.6153846153846154,18,8,10,370.03788555463836,0.42496693121693124,0.13605881629137428,0.21839490892538452,131619.47959710742,2540.838785583094,134160.31838269052,1704,1,280.44444444444446,32,4,19,33.97317583364095,0.6455078125,43.465909090909086,1026.1363636363633,32.06676136363635,0
1729,4,0,0,35,0.0,0.0,1.0,35,1100,700,400,0.6363636363636364,15,7,8,381.4269885851218,0.42083333333333334,0.14532269760696126,0.22497340344691327,131595.18771701396,3038.7912326388932,134633.97894965287,1705,8,289.42857142857144,31,4,19,33.70558375634517,0.6478494623655914,43.489583333333336,1026.0416666666672,33.09811827956991,0
1730,4,1,0,36,0.027777777777777776,0.0,1.0,36,1000,700,300,0.7,13,7,6,371.6613080219729,0.4220568783068783,0.14204229271007263,0.2216750874162349,132019.90370290264,2613.338019031131,134633.24172193377,1706,0,282.3611111111111,33,3,20,33.52710867318548,0.6470959595959596,43.07598039215686,1027.6960784313717,31.142305407011264,0
1731,4,0,0,36,0.0,0.0,1.0,36,1150,800,350,0.6956521739130435,15,8,7,370.5324044029191,0.42094907407407406,0.13922647179527914,0.22229295712320934,132240.39619677523,2599.8703923971507,134840.2665891724,1707,1,283.3611111111111,33,3,21,33.33370566742127,0.6493055555555556,42.861519607843135,1028.5539215686272,31.168300653594763,0
1732,4,0,0,36,0.0,0.0,1.0,36,1000,700,300,0.7,13,7,6,351.7248954341084,0.42071759259259256,0.08098831271984586,0.19934093269844352,130055.90284475735,1948.7797657321655,132004.68261048952,1708,2,284.3611111111111,35,1,18,36.025024584893536,0.6229166666666667,44.99421296296296,1020.0231481481479,29.143518518518512,8
1733,4,0,0,36,0.0,0.0,1.0,36,600,400,200,0.6666666666666666,8,4,4,350.604111937148,0.42076719576719573,0.08129112775130487,0.19885615460836698,130085.41907793212,1921.6965663580265,132007.11564429014,1709,3,285.3611111111111,35,1,18,36.02365554799184,0.6232142857142857,44.96527777777778,1020.138888888889,29.146825396825403,0
1734,4,0,0,36,0.0,0.0,1.0,36,1200,800,400,0.6666666666666666,16,8,8,350.19728315204975,0.4198247354497355,0.08575235287447569,0.1993795894201374,130233.05047850228,1921.4520908350544,132154.50256933735,1710,4,286.3611111111111,35,1,18,35.88428865706618,0.624702380952381,44.820601851851855,1020.717592592593,29.1633597883598,0
1735,4,0,1,35,0.0,0.027777777777777776,0.9722222222222222,36,1050,800,250,0.7619047619047619,13,8,5,350.5522316537195,0.41865079365079366,0.08952855847688146,0.20034150855650384,130380.7656035665,1941.0536694101474,132321.81927297666,1711,5,287.3611111111111,35,1,19,35.72548352976731,0.6261904761904762,44.675925925925924,1021.2962962962961,29.179894179894173,0
1736,4,0,0,35,0.0,0.0,1.0,35,1050,800,250,0.7619047619047619,13,8,5,351.59578956358575,0.41715686274509806,0.08225775131076496,0.20155114482255396,130498.99798525359,2176.5796467763885,132675.57763202998,1712,6,288.0857142857143,35,0,14,35.57902884760611,0.6273809523809524,44.560185185185176,1021.7592592592578,29.19312169312165,0
1737,4,0,0,35,0.0,0.0,1.0,35,850,600,250,0.7058823529411765,11,6,5,351.06253903800126,0.4175420168067227,0.08154020385050997,0.20155281012389784,130558.1342699759,2166.8140217763957,132724.94829175228,1713,7,289.0857142857143,35,0,14,35.532748206870515,0.6279761904761905,44.50231481481481,1021.99074074074,29.199735449735428,0
1738,4,2,0,37,0.05405405405405406,0.0,1.0,37,650,400,250,0.6153846153846154,9,4,5,336.66072108176047,0.4219844844844845,0.08752821343827777,0.196035606914192,131103.4404816865,1427.4757617728367,132530.91624345933,1714,0,274.4054054054054,37,0,17,35.34975017844397,0.6295045045045045,43.96929824561403,1024.1228070175425,27.678994784257906,0
1739,4,0,0,37,0.0,0.0,1.0,37,1100,800,300,0.7272727272727273,14,8,6,339.5243900825067,0.4211398898898899,0.08549401102364951,0.19857290048254733,131271.93583602642,1514.0047899353608,132785.94062596178,1715,1,275.4054054054054,37,0,18,35.10637349311648,0.6311936936936937,43.80482456140351,1024.7807017543855,27.696775723091502,0
1740,4,1,1,37,0.02631578947368421,0.02631578947368421,0.9736842105263158,38,900,400,500,0.4444444444444444,14,4,10,334.8765267014496,0.4230233522996681,0.09711170221739818,0.1977356096781619,131637.3803117305,1216.465763504149,132853.84607523464,1716,0,269.13157894736844,37,1,13,34.857156213270635,0.6348536036036037,43.4484649122807,1026.206140350877,27.735301090564242,0
1741,4,0,0,37,0.0,0.0,1.0,37,750,500,250,0.6666666666666666,10,5,5,341.4322568051657,0.4207957957957958,0.10040051027976404,0.20119326387419553,131559.08230866017,1583.7028751724893,133142.78518383266,1717,1,277.13513513513516,36,1,13,34.76788327844861,0.6359953703703703,43.524774774774784,1025.9009009009021,28.49724724724728,0
1742,4,0,0,37,0.0,0.0,1.0,37,1050,900,150,0.8571428571428571,12,9,3,371.81096200292,0.4201076076076076,0.013466164131896496,0.20971313943801073,129867.92091836738,2333.2134275063845,132201.13434587375,1718,2,278.13513513513516,34,3,19,35.70403137896128,0.6231617647058824,45.17857142857143,1019.2857142857147,29.978991596638668,8
1743,4,0,1,36,0.0,0.02702702702702703,0.972972972972973,37,1500,1200,300,0.8,18,12,6,367.8576381111961,0.41863738738738737,0.018500570475150857,0.2083265750023047,130026.38996056246,2166.240140603574,132192.63010116603,1719,3,279.13513513513516,35,2,19,35.6436298986231,0.6226190476190476,45.02314814814815,1019.9074074074078,29.140211640211653,0
1744,4,0,1,35,0.0,0.027777777777777776,0.9722222222222222,36,1150,700,450,0.6086956521739131,16,7,9,375.35522176627165,0.4169808201058201,0.018577990579625947,0.21187651707215463,129898.25857426305,2551.597930839004,132449.85650510204,1720,4,287.27777777777777,34,2,19,35.582837011950645,0.623468137254902,45.148809523809526,1019.4047619047619,29.98249299719888,0
1745,4,0,0,35,0.0,0.0,1.0,35,750,600,150,0.8,9,6,3,375.35522176627165,0.4172619047619048,0.022101733371148624,0.21187651707215466,129898.25857426305,2751.597930839004,132649.85650510204,1721,5,294.9428571428571,34,1,19,35.582837011950645,0.623468137254902,45.148809523809526,1019.4047619047619,29.98249299719888,0
1746,4,0,0,35,0.0,0.0,1.0,35,950,600,350,0.631578947368421,13,6,7,375.0633792597054,0.4162464985994398,0.01869632643532526,0.2123706523541238,130019.64462868466,2753.1214569160857,132772.76608560074,1722,6,295.9428571428571,34,1,19,35.46676199369675,0.6246936274509804,45.0297619047619,1019.8809523809513,29.996498599439743,0
1747,4,1,1,35,0.027777777777777776,0.027777777777777776,0.9722222222222222,36,650,400,250,0.6153846153846154,9,4,5,368.3454451127924,0.4190145502645503,0.027857790579825847,0.21020919511505398,130325.14537677825,2401.388251378989,132726.53362815725,1723,0,288.69444444444446,33,3,20,35.327652424387885,0.630050505050505,44.73039215686275,1021.0784313725497,30.941770647653023,0
1748,4,0,0,35,0.0,0.0,1.0,35,1050,700,350,0.6666666666666666,14,7,7,371.4926785219182,0.41610644257703083,0.05100841344094342,0.21286147497163102,130481.60750973185,2694.5923743271833,133176.19988405902,1724,1,296.6,33,2,20,35.08843608812123,0.6316287878787878,44.57720588235294,1021.6911764705883,30.960338680926917,0
1749,4,1,0,36,0.027777777777777776,0.0,1.0,36,1050,900,150,0.8571428571428571,12,9,3,369.93353480074376,0.4163525132275132,0.07565712956501525,0.21462135844917643,130962.30867346934,2489.46995464852,133451.77862811784,1725,0,289.3333333333333,34,2,18,34.64080793983095,0.6341911764705883,44.107142857142854,1023.5714285714282,30.105042016806713,0
1750,4,0,0,36,0.0,0.0,1.0,36,1250,1000,250,0.8,15,10,5,373.39426035177803,0.4159722222222222,0.07953620829943042,0.21748888434707836,131114.67013888893,2591.493055555561,133706.1631944445,1726,1,290.3333333333333,34,2,18,34.39788445890967,0.6357230392156863,43.958333333333336,1024.166666666667,30.122549019607852,0
1751,4,0,0,36,0.0,0.0,1.0,36,1350,900,450,0.6666666666666666,18,9,9,370.73647868368016,0.41574074074074074,0.07840309237103305,0.21697283106647205,131297.62081916112,2535.363520408179,133832.9843395693,1727,2,291.3333333333333,34,2,19,34.280743020869636,0.6375612745098039,43.77976190476191,1024.8809523809534,30.14355742296922,0
1752,4,0,2,34,0.0,0.05555555555555555,0.9444444444444444,36,1300,900,400,0.6923076923076923,17,9,8,371.28391350459407,0.41436838624338623,0.0758330014602413,0.2185405313666282,131516.61169982704,2566.0039996390788,134082.6156994661,1728,3,292.3333333333333,33,3,19,34.04520111509359,0.6420454545454546,43.56617647058824,1025.7352941176475,31.082887700534773,0
1753,4,0,1,33,0.0,0.029411764705882353,0.9705882352941176,34,1250,1000,250,0.8,15,10,5,383.2218508875741,0.4097964943553179,0.08654841628959287,0.2257924248340493,131554.70623214473,3282.927603050717,134837.63383519545,1729,4,303.1470588235294,32,2,15,33.70051282051283,0.6448567708333333,43.52904040404041,1025.8838383838388,32.05886994949496,0
1754,4,0,0,33,0.0,0.0,1.0,33,700,400,300,0.5714285714285714,10,4,6,397.2297899024691,0.4075520833333333,0.1034230983979727,0.2118831889644715,127650.62332153312,3603.6004737376684,131254.22379527078,1730,5,311.54545454545456,31,2,18,37.32779817892881,0.6078629032258065,47.36328124999999,1010.5468749999993,32.598286290322555,8
1755,4,2,0,35,0.05714285714285714,0.0,1.0,35,1000,600,400,0.6,14,6,8,382.5239138019641,0.4152310924369748,0.11074633243127785,0.20738999218560542,128304.38220589732,2816.8525621849903,131121.2347680823,1731,0,294.6857142857143,32,3,20,37.02849783981391,0.6119791666666667,46.717171717171716,1013.1313131313128,31.660353535353526,0
1756,4,1,0,36,0.027777777777777776,0.0,1.0,36,1350,900,450,0.6666666666666666,18,9,9,376.0003932847445,0.41908068783068786,0.12262872628726273,0.2062275004757785,128765.68657487512,2483.189758746643,131248.87633362177,1732,0,287.47222222222223,33,3,18,36.72170570715608,0.6142676767676767,46.26225490196079,1014.9509803921574,30.75609031491386,0
1757,4,1,0,37,0.02702702702702703,0.0,1.0,37,850,500,350,0.5882352941176471,12,5,7,366.05453588045214,0.4219844844844845,0.12188125332455235,0.20237315532872652,129080.38548752829,2050.0921201813985,131130.47760770968,1733,0,280.6756756756757,34,3,19,36.652852624179936,0.6151960784313726,45.95238095238095,1016.1904761904758,29.88795518207282,0
1758,4,2,0,39,0.05128205128205128,0.0,1.0,39,800,500,300,0.625,11,5,6,352.08668546292813,0.4266756635177688,0.12968805992326038,0.19774823986976578,129701.9692670825,1333.3239807947325,131035.29324787724,1734,0,267.2307692307692,35,4,17,36.37524618414574,0.6193452380952381,45.34143518518518,1018.6342592592595,29.103835978835985,0
1759,4,2,0,41,0.04878048780487805,0.0,1.0,41,1800,1500,300,0.8333333333333334,21,15,6,338.4905333840439,0.430030487804878,0.13422836841666475,0.19343230291492744,130377.57087746548,627.5236832216863,131005.09456068717,1735,0,255.14634146341464,36,5,19,36.03668173631786,0.6241319444444444,44.67905405405406,1021.2837837837852,28.368993993994035,0
1760,4,0,1,40,0.0,0.024390243902439025,0.975609756097561,41,1100,800,300,0.7272727272727273,14,8,6,338.74273918751743,0.4297002032520325,0.12661963313848013,0.19443961784482763,130550.14209733397,644.5825470741203,131194.7246444081,1736,1,256.1463414634146,36,5,14,35.85560146923784,0.6258680555555556,44.510135135135144,1021.9594594594607,28.387762762762797,0
1761,4,0,2,38,0.0,0.05,0.95,40,800,500,300,0.625,11,5,6,346.17202268431004,0.4290598290598291,0.12846467391304373,0.1990489130434783,130617.28395061726,1043.2098765432079,131660.49382716048,1737,2,261.8,35,5,14,35.59782608695653,0.6285714285714286,44.44444444444444,1022.2222222222221,29.206349206349202,0
1762,4,0,1,37,0.0,0.02631578947368421,0.9736842105263158,38,1100,800,300,0.7272727272727273,14,8,6,364.3343141621981,0.42466808914177334,0.13635387520763986,0.20808758327029442,130356.43029423774,1898.6641255766936,132255.09441981444,1738,3,276.36842105263156,33,5,18,35.39829093163726,0.6303661616161615,44.69975490196078,1021.2009803921565,30.94548425430777,0
1763,4,0,0,37,0.0,0.0,1.0,37,900,700,200,0.7777777777777778,11,7,4,371.34527280299886,0.4225788288288288,0.13921676778819658,0.21158044613194132,130262.5868055556,2274.4791666666765,132537.06597222228,1739,4,284.43243243243245,32,5,19,35.314625850340136,0.6318359375,44.79166666666667,1020.8333333333338,31.901041666666682,0
1764,4,0,0,37,0.0,0.0,1.0,37,1100,800,300,0.7272727272727273,14,8,6,373.7532838709404,0.42270395395395394,0.15017687320245754,0.21401541541399696,130455.99819214873,2351.671544995408,132807.66973714414,1740,5,285.43243243243245,32,5,19,35.056698801137074,0.6337890625,44.60227272727273,1021.5909090909089,31.924715909090903,0
1765,4,0,0,37,0.0,0.0,1.0,37,1050,900,150,0.8571428571428571,12,9,3,376.776984765535,0.4224537037037037,0.15539288825691222,0.21682752278937723,130649.55305899907,2445.1489325068897,133094.70199150595,1741,6,286.43243243243245,32,5,15,34.782944300358174,0.6357421875,44.41287878787879,1022.3484848484848,31.94839015151515,0
1766,4,0,0,37,0.0,0.0,1.0,37,1150,800,350,0.6956521739130435,15,8,7,379.00470555587805,0.42214089089089085,0.15158752927205188,0.21902254810368937,130810.95838434853,2515.593753188451,133326.552137537,1742,7,287.43243243243245,32,5,16,34.562196576976866,0.6373697916666667,44.255050505050505,1022.979797979798,31.96811868686869,0
1767,4,0,1,36,0.0,0.02702702702702703,0.972972972972973,37,1050,800,250,0.7619047619047619,13,8,5,378.7194844467931,0.4214214214214214,0.1527130578854714,0.21965730097913996,130951.55709342561,2518.7812379853895,133470.338331411,1743,8,288.43243243243245,33,4,16,34.426883780332055,0.6363636363636364,44.11764705882353,1023.529411764706,31.016042780748666,0
1768,4,1,2,35,0.02702702702702703,0.05405405405405406,0.9459459459459459,37,550,300,250,0.5454545454545454,8,3,5,374.73821573302376,0.42201576576576577,0.15881328044944887,0.21895081912954673,131233.93233672154,2435.6739294982876,133669.60626621984,1744,0,287.7027027027027,33,4,17,34.24268927161824,0.6392045454545454,43.84191176470589,1024.6323529411773,31.049465240641734,0
1769,4,0,1,34,0.0,0.02857142857142857,0.9714285714285714,35,950,600,350,0.631578947368421,13,6,7,396.0803116468965,0.41638655462184876,0.16735784251367547,0.2297850427938194,130961.35669284392,3374.2429945203944,134335.59968736433,1745,1,303.22857142857146,31,4,17,33.972697493957526,0.6414650537634409,44.108072916666664,1023.5677083333329,33.018313172042994,0
1770,4,0,0,34,0.0,0.0,1.0,34,1200,900,300,0.75,15,9,6,404.2905262232117,0.4123960190136661,0.1727511490479321,0.23447618866639433,130949.53399598224,3788.3312015840083,134737.86519756625,1746,2,312.79411764705884,30,4,19,33.77462245567959,0.6440972222222222,44.11962365591398,1023.5215053763445,34.11738351254482,0
1771,4,2,1,35,0.05555555555555555,0.027777777777777776,0.9722222222222222,36,750,400,350,0.5333333333333333,11,4,7,379.60091193499204,0.4166997354497355,0.1681534801689839,0.224038969593005,131619.47959710742,2792.574896694205,134412.05449380164,1747,0,296.3611111111111,32,4,18,33.72785160575859,0.6455078125,43.465909090909086,1026.1363636363633,32.06676136363635,0
1772,4,0,0,35,0.0,0.0,1.0,35,1050,700,350,0.6666666666666666,14,7,7,385.85316144831427,0.41425070028011207,0.17305334929097316,0.22718618878100305,131528.3966064453,3150.1295301649297,134678.52613661025,1748,1,305.8285714285714,31,4,21,33.659664043327396,0.6471774193548387,43.5546875,1025.78125,33.08971774193548,0
1773,4,0,0,35,0.0,0.0,1.0,35,850,500,350,0.5882352941176471,12,5,7,377.9183773172218,0.41372549019607846,0.1377245508982039,0.2035882871354067,128048.66850321402,2678.389003673106,130727.05750688713,1749,2,306.8285714285714,32,3,20,37.40721681636726,0.609375,46.969696969696976,1012.1212121212126,31.628787878787893,8
1774,4,3,2,36,0.07894736842105263,0.05263157894736842,0.9473684210526316,38,950,700,250,0.7368421052631579,12,7,5,350.943982276195,0.4251570649596965,0.13355340285061978,0.19313239798812537,128898.98667800451,1447.3006092933017,130346.28728729782,1750,0,283.5263157894737,34,4,18,37.22157092614303,0.6133578431372548,46.13095238095238,1015.4761904761903,29.86694677871148,0
1775,4,1,0,37,0.02702702702702703,0.0,1.0,37,850,700,150,0.8235294117647058,10,7,3,356.81449071632574,0.4221721721721721,0.1469250111702154,0.19647320163230478,128921.21006644063,1800.1911824778797,130721.40124891851,1751,0,292.0810810810811,33,4,20,37.04987228993203,0.6158459595959596,46.109068627450974,1015.5637254901948,30.77465834818772,0
1776,4,0,0,37,0.0,0.0,1.0,37,1100,900,200,0.8181818181818182,13,9,4,357.11198837089194,0.42185935935935936,0.1463176083200215,0.19710109078526575,129014.5692161667,1814.5298683198596,130829.09908448656,1752,1,293.0810810810811,33,4,20,36.94712505026136,0.6167929292929293,46.01715686274509,1015.9313725490183,30.78579916815207,0
1777,4,1,0,38,0.02631578947368421,0.0,1.0,38,1100,700,400,0.6363636363636364,15,7,8,347.16543170319113,0.4235715979137032,0.1539687569314614,0.19389434500975125,129481.87183114664,1390.4611507593186,130872.33298190596,1753,0,286.3421052631579,33,5,16,36.72423740718442,0.6215277777777778,45.557598039215684,1017.769607843137,30.84150326797385,0
1778,4,1,0,39,0.02564102564102564,0.0,1.0,39,750,600,150,0.8,9,6,3,338.3671951154739,0.4259165542060279,0.15461307785177403,0.1904066287306601,129776.92920918361,982.4511054421697,130759.38031462579,1754,0,279.97435897435895,34,5,17,36.64855707442458,0.6222426470588236,45.26785714285714,1018.9285714285709,29.968487394957968,0
1779,4,0,0,39,0.0,0.0,1.0,39,1250,700,550,0.56,18,7,11,336.3210284732424,0.42571974808816915,0.15034352687592634,0.19013792797843707,129958.94451530614,941.5851757369643,130900.5296910431,1755,1,280.97435897435895,34,5,19,36.51610235454369,0.6240808823529411,45.089285714285715,1019.6428571428573,29.989495798319332,0
1780,4,0,2,37,0.0,0.05128205128205128,0.9487179487179487,39,1350,900,450,0.6666666666666666,18,9,9,337.79745087814155,0.4252980206927575,0.1486401579750476,0.1917168313924285,130110.72137188194,990.2140022675582,131100.9353741495,1756,2,281.97435897435895,34,5,19,36.32463049397121,0.6256127450980392,44.94047619047618,1020.238095238094,30.007002801120414,0
1781,4,0,0,37,0.0,0.0,1.0,37,1050,800,250,0.7619047619047619,13,8,5,353.4676924078414,0.41854354354354356,0.15713236679815212,0.1994670465026066,129887.55076172613,1782.2105680507298,131669.76132977687,1757,3,297.9189189189189,33,4,20,36.15151879458201,0.6256313131313131,45.159313725490186,1019.3627450980382,30.889780154486004,0
1782,4,0,0,37,0.0,0.0,1.0,37,1400,1000,400,0.7142857142857143,18,10,8,355.0152038341314,0.41910660660660665,0.15906426671775709,0.2011430593268532,130043.7500750912,1833.5016880526603,131877.25176314387,1758,4,298.9189189189189,33,4,20,35.95345728703594,0.627209595959596,45.00612745098039,1019.9754901960775,30.908348187759927,0
1783,4,0,0,37,0.0,0.0,1.0,37,850,600,250,0.7058823529411765,11,6,5,355.0152038341314,0.41910660660660665,0.15906426671775709,0.2011430593268532,130043.7500750912,1833.5016880526603,131877.25176314387,1759,5,299.9189189189189,33,4,20,35.95345728703594,0.627209595959596,45.00612745098039,1019.9754901960775,30.908348187759927,0
1784,4,0,1,36,0.0,0.02702702702702703,0.972972972972973,37,1550,1200,350,0.7741935483870968,19,12,7,356.9296600802825,0.419044044044044,0.163114128824416,0.20320816105765874,130232.20663265292,1896.7474489795713,132128.9540816325,1760,6,300.9189189189189,34,3,21,35.71334849545137,0.6268382352941176,44.82142857142856,1020.7142857142845,30.02100840336131,0
1785,4,0,0,36,0.0,0.0,1.0,36,1000,700,300,0.7,13,7,6,356.6920235685441,0.41848544973544977,0.1642026434068209,0.20339502042091287,130293.86421388388,2094.9599600869533,132388.82417397082,1761,7,306.47222222222223,33,3,21,35.65685892049774,0.6297348484848485,44.761029411764696,1020.9558823529395,30.938057040998167,0
1786,4,0,0,36,0.0,0.0,1.0,36,850,600,250,0.7058823529411765,11,6,5,355.0115843587302,0.41848544973544977,0.15995639825593022,0.20276295630303615,130356.43029423773,2055.608570021136,132412.03886425885,1762,8,307.47222222222223,33,3,21,35.63630045201807,0.6303661616161615,44.69975490196078,1021.2009803921563,30.945484254307768,0
1787,4,0,0,36,0.0,0.0,1.0,36,1000,500,500,0.5,15,5,10,355.52618812458036,0.41805555555555557,0.1616655338317805,0.20371284057695027,130481.60750973185,2077.9257076605163,132559.53321739237,1763,9,308.47222222222223,33,3,21,35.49625664707529,0.6316287878787878,44.57720588235294,1021.6911764705883,30.960338680926917,0
1788,4,1,0,37,0.02702702702702703,0.0,1.0,37,1300,700,600,0.5384615384615384,19,7,12,348.8714301273344,0.4202327327327327,0.16616243891086802,0.20176319451644073,130840.48327664385,1729.3013038548556,132569.7845804987,1764,0,301.1081081081081,34,3,19,35.30297300442167,0.6329656862745099,44.22619047619047,1023.095238095237,30.091036414565796,0
1789,4,0,0,37,0.0,0.0,1.0,37,1300,1000,300,0.7692307692307693,16,10,6,351.2294591058294,0.42020145145145144,0.1711261208877206,0.20393127068541714,130992.77388038546,1801.704223356,132794.47810374145,1765,1,302.1081081081081,34,3,20,35.08862464627669,0.6344975490196079,44.07738095238095,1023.690476190476,30.108543417366942,0
1790,4,0,0,37,0.0,0.0,1.0,37,1250,800,450,0.64,17,8,9,349.2831450140799,0.4191378878878879,0.16755751801069074,0.20393017272667371,131206.12953514737,1765.6179138322007,132971.74744897956,1766,2,303.1081081081081,34,3,21,34.92282516074058,0.6366421568627452,43.86904761904762,1024.5238095238092,30.133053221288506,0
1791,4,1,0,38,0.02631578947368421,0.0,1.0,38,1200,900,300,0.75,15,9,6,341.3458691544512,0.4187114746325273,0.17349493222615675,0.20153434192543618,131633.36167800458,1386.5575396825457,133019.91921768713,1767,0,296.10526315789474,34,4,14,34.69523395204951,0.6409313725490196,43.452380952380956,1026.1904761904766,30.182072829131666,0
1792,4,0,0,38,0.0,0.0,1.0,38,1100,800,300,0.7272727272727273,14,8,6,342.55831150112704,0.41888928402086295,0.17688617345288304,0.20273715305931514,131725.00177154213,1424.6988378684994,133149.70060941062,1768,1,297.10526315789474,34,4,14,34.57178476168386,0.6418504901960784,43.36309523809525,1026.5476190476204,30.192577030812366,0
1793,4,0,0,38,0.0,0.0,1.0,38,1200,800,400,0.6666666666666666,16,8,8,344.3404297684828,0.4187559269796112,0.18070216115293958,0.20428339389153602,131816.67375283453,1477.9620181405912,133294.63577097512,1769,2,298.10526315789474,34,4,15,34.43368884766982,0.6427696078431373,43.273809523809526,1026.9047619047624,30.203081232493012,0
1794,4,0,0,38,0.0,0.0,1.0,38,1100,600,500,0.5454545454545454,16,6,10,348.4271740438827,0.41847439544807963,0.1857045289623085,0.207541403669617,131969.53124999994,1596.3541666666652,133565.8854166666,1770,3,299.10526315789474,34,4,16,34.174776966747785,0.6443014705882353,43.125,1027.4999999999995,30.220588235294105,0
1795,4,0,0,38,0.0,0.0,1.0,38,1150,800,350,0.6956521739130435,15,8,7,349.96334698551755,0.4181335941204362,0.181955583725409,0.20929940890352705,132122.4773242631,1647.6048752834558,133770.08219954657,1771,4,300.10526315789474,34,4,17,33.981299212598444,0.6458333333333333,42.97619047619048,1028.0952380952385,30.23809523809525,0
1796,4,0,1,37,0.0,0.02631578947368421,0.9736842105263158,38,1250,800,450,0.64,17,8,9,347.86522633744863,0.4175408961593172,0.17772295321637444,0.20871913580246926,132244.8979591837,1600.680272108851,133845.57823129254,1772,5,301.10526315789474,34,4,18,33.912037037037024,0.6470588235294117,42.85714285714286,1028.571428571429,30.252100840336144,0
1797,4,0,0,37,0.0,0.0,1.0,37,1150,900,250,0.782608695652174,14,9,5,358.4251183194778,0.4150713213213213,0.18355453380471265,0.21520890151457048,132271.9101427335,2081.915008650514,134353.82515138402,1773,6,309.7567567567568,33,4,18,33.6132952108649,0.6496212121212122,42.830882352941174,1028.676470588235,31.172014260249544,0
1798,4,0,2,35,0.0,0.05405405405405406,0.9459459459459459,37,1200,1000,200,0.8333333333333334,14,10,4,357.8030149213106,0.4142892892892893,0.17175146333379487,0.21573492622570603,132429.53619100817,2076.737462754698,134506.27365376288,1774,7,310.7567567567568,33,4,19,33.47062646346786,0.651199494949495,42.67769607843137,1029.2892156862738,31.19058229352345,0
1799,4,0,0,35,0.0,0.0,1.0,35,1000,500,500,0.5,15,5,10,376.15475586746174,0.4128151260504202,0.1780365472975347,0.2256374551764611,132235.62168401177,2948.2115983062877,135183.83328231805,1775,8,310.85714285714283,32,3,19,33.193949995908014,0.6516927083333333,42.86616161616161,1028.535353535353,32.14172979797978,0
1800,4,0,0,35,0.0,0.0,1.0,35,1050,800,250,0.7619047619047619,13,8,5,377.96816595486325,0.4122899159663866,0.18480795189593846,0.22731089183514241,132333.0388002499,3003.5351941128397,135336.57399436273,1776,9,311.85714285714283,32,3,19,33.049044872581504,0.6526692708333333,42.77146464646464,1028.9141414141409,32.1535669191919,0
1801,4,1,2,34,0.027777777777777776,0.05555555555555555,0.9444444444444444,36,1300,900,400,0.6923076923076923,17,9,8,367.92437263183433,0.414021164021164,0.18510463042383174,0.22357638161194346,132723.06596584534,2566.4260981022367,135289.49206394757,1777,0,304.1666666666667,32,4,18,32.9146754891149,0.6565755208333333,42.39267676767677,1030.429292929293,32.20091540404041,0
1802,4,0,1,33,0.0,0.029411764705882353,0.9705882352941176,34,900,700,200,0.7777777777777778,11,7,4,388.6223038088516,0.40987076648841353,0.20012059493501289,0.2337057416055971,132331.0089111328,3485.3563096788203,135816.36522081163,1778,11,322.0882352941176,31,3,21,32.77703956804185,0.655241935483871,42.7734375,1028.90625,33.190524193548384,0
1803,4,0,0,33,0.0,0.0,1.0,33,1150,1000,150,0.8695652173913043,13,10,3,396.4224724818174,0.40948547979797983,0.19332826699597883,0.23860145041830144,132363.4235171696,3894.367123366864,136257.79064053646,1779,12,323.6969696969697,30,3,23,32.5436476837339,0.6583333333333333,42.74193548387097,1029.032258064516,34.3010752688172,0
1804,4,0,0,33,0.0,0.0,1.0,33,800,700,100,0.875,9,7,2,390.79710087372825,0.40952493686868685,0.10766585886203184,0.21574949380311853,129024.94454089501,3502.4450331846315,132527.38957407966,1780,13,324.6969696969697,29,4,21,36.08096946912737,0.6275143678160919,46.00694444444444,1015.9722222222218,35.033524904214545,8
1805,4,3,1,35,0.08333333333333333,0.027777777777777776,0.9722222222222222,36,800,500,300,0.625,11,5,6,358.82229579076807,0.4221064814814815,0.0997332879355346,0.20305608530587418,129996.88042534735,2129.2763792438345,132126.15680459118,1781,0,298.55555555555554,31,5,22,35.903983656792626,0.6317204301075269,45.052083333333336,1019.7916666666677,32.896505376344116,0
1806,4,0,0,35,0.0,0.0,1.0,35,700,300,400,0.42857142857142855,11,3,8,371.2272756102119,0.4177170868347339,0.11074442435201903,0.20947824838004822,129885.53590010402,2643.4107266735964,132528.94662677762,1782,1,308.0857142857143,30,5,22,35.70098233122362,0.6333333333333333,45.16129032258064,1019.3548387096771,33.978494623655905,0
1807,4,0,0,35,0.0,0.0,1.0,35,1100,800,300,0.7272727272727273,14,8,6,370.4418658166618,0.41785714285714287,0.10762524849081712,0.20980991575863447,130030.07888793957,2633.7170071072214,132663.7958950468,1783,2,309.0857142857143,31,4,22,35.573987190944294,0.6320564516129032,45.01953125000001,1019.9218750000009,32.90070564516132,0
1808,4,0,0,35,0.0,0.0,1.0,35,1150,900,250,0.782608695652174,14,9,5,380.0337774441734,0.4168417366946779,0.02622309197651651,0.20703332651809456,128496.33487654332,2766.5895061728556,131262.92438271618,1784,3,310.0857142857143,32,3,16,36.89497716894977,0.6139322916666667,46.527777777777786,1013.8888888888897,31.684027777777803,8
1809,4,1,2,34,0.027777777777777776,0.05555555555555555,0.9444444444444444,36,1050,700,350,0.6666666666666666,14,7,7,383.24455451917726,0.4189484126984127,0.05917932642070545,0.21219161116035107,129139.10064638611,2698.371419646298,131837.4720660324,1785,0,302.44444444444446,33,3,18,36.156157061329466,0.6180555555555556,45.89460784313726,1016.4215686274518,30.80065359477127,0
1810,4,0,0,34,0.0,0.0,1.0,34,1200,900,300,0.75,15,9,6,396.66433166732435,0.4104092394533571,0.09060149809347307,0.2196001257443356,129135.20812988268,3444.6662055121396,132579.87433539482,1786,1,321.0,31,3,18,35.81913485353148,0.622983870967742,45.89843749999999,1016.406249999999,32.78729838709674,0
1811,4,1,1,34,0.02857142857142857,0.02857142857142857,0.9714285714285714,35,550,300,250,0.5454545454545454,8,3,5,388.3252993291611,0.41621148459383756,0.08359066172690688,0.21657533476081023,129426.12879106712,3051.888040761132,132478.01683182825,1787,0,312.8,32,3,15,35.73385862596683,0.6233723958333333,45.61237373737373,1017.5505050505042,31.798453282828255,0
1812,4,1,0,35,0.02857142857142857,0.0,1.0,35,1200,900,300,0.75,15,9,6,393.0549796241124,0.4132352941176471,0.09622494510942747,0.22083339663003754,129715.36705438221,3197.054190898893,132912.4212452811,1788,0,313.77142857142854,32,3,16,35.31828416790614,0.6263020833333333,45.32828282828283,1018.6868686868687,31.833964646464647,0
1813,4,1,0,36,0.027777777777777776,0.0,1.0,36,1000,800,200,0.8,12,8,4,378.8473157842528,0.4157738095238095,0.08919919919919961,0.2149900411659103,130106.25608239618,2658.081176710882,132764.33725910707,1789,0,306.02777777777777,33,3,17,35.28215715715717,0.6278409090909092,44.94485294117647,1020.220588235294,30.915775401069517,0
1814,4,0,0,36,0.0,0.0,1.0,36,1100,800,300,0.7272727272727273,14,8,6,378.60881872000084,0.41593915343915344,0.09079900724550671,0.21519970194412585,130168.77710796318,2656.609387014595,132825.38649497778,1790,1,307.02777777777777,33,3,17,35.22464573075536,0.6284722222222222,44.88357843137254,1020.4656862745089,30.923202614379058,0
1815,4,2,2,36,0.05263157894736842,0.05263157894736842,0.9473684210526316,38,1250,800,450,0.64,17,8,9,360.18625536573154,0.4209044570886676,0.09406919471361408,0.2079011063792925,130765.21675936632,1819.9667513288634,132585.18351069518,1791,0,291.8157894736842,35,3,16,35.089797631171976,0.6300595238095238,44.29976851851851,1022.8009259259251,29.222883597883573,0
1816,4,0,0,36,0.0,0.0,1.0,36,900,400,500,0.4444444444444444,14,4,10,378.81065328736486,0.4156084656084656,0.10581011021817122,0.21705459906919314,130481.60750973182,2685.5645965494073,133167.17210628124,1792,3,309.02777777777777,33,3,19,34.90151833193395,0.6316287878787878,44.57720588235294,1021.6911764705881,30.96033868092691,0
1817,4,1,2,35,0.02702702702702703,0.05405405405405406,0.9459459459459459,37,900,500,400,0.5555555555555556,13,5,8,374.24192029597805,0.41816816816816815,0.10308494118682576,0.21712091975066228,130962.30867346919,2402.317176870727,133364.62585033991,1793,0,301.64864864864865,34,3,18,34.53055943242615,0.6341911764705883,44.10714285714285,1023.571428571427,30.105042016806674,0
1818,4,1,0,36,0.027777777777777776,0.0,1.0,36,900,500,400,0.5555555555555556,13,5,8,381.371016279855,0.4170965608465609,0.09682311621966821,0.2211951894423158,130951.5570934256,2788.2256824298343,133739.78277585542,1794,0,309.1666666666667,33,3,19,34.35903575989783,0.6363636363636364,44.11764705882353,1023.5294117647059,31.016042780748663,0
1819,4,0,0,36,0.0,0.0,1.0,36,1200,1100,100,0.9166666666666666,13,11,2,384.07546791062447,0.41628637566137566,0.09774746024147651,0.22349126809618225,131077.01965590153,2868.693531334096,133945.71318723564,1795,1,310.1666666666667,33,3,19,34.162577788415504,0.6376262626262627,43.995098039215684,1024.019607843137,31.030897207367786,0
1820,4,0,0,36,0.0,0.0,1.0,36,850,700,150,0.8235294117647058,10,7,3,385.3419196109368,0.4162698412698413,0.09551808445613763,0.2253307085165491,131265.326136582,2916.4065503652328,134181.73268694725,1796,2,311.1666666666667,33,3,20,33.93924898349676,0.639520202020202,43.811274509803916,1024.7549019607836,31.053178847296472,0
1821,4,0,0,36,0.0,0.0,1.0,36,1250,1200,50,0.96,13,12,1,388.5825499958437,0.41603835978835974,0.1027661495526555,0.228369570988874,131457.57607642058,3016.4390438718165,134474.0151202924,1797,3,312.1666666666667,32,4,22,33.66140318476566,0.6438802083333333,43.62373737373736,1025.505050505049,32.04703282828278,0
1822,4,0,0,36,0.0,0.0,1.0,36,1200,800,400,0.6666666666666666,16,8,8,393.4508122099869,0.41506283068783073,0.10418973791066799,0.23221312642197267,131619.47959710742,3157.158230027538,134776.63782713495,1798,4,313.1666666666667,32,4,17,33.37255444813584,0.6455078125,43.465909090909086,1026.1363636363633,32.06676136363635,0
1823,4,0,1,35,0.0,0.027777777777777776,0.9722222222222222,36,950,600,350,0.631578947368421,13,6,7,395.0589704479413,0.41405423280423276,0.10227785295444347,0.2335588633288228,131684.26890432095,3204.6103395061737,134888.87924382713,1799,5,314.1666666666667,32,4,17,33.265674334686516,0.6461588541666667,43.40277777777778,1026.3888888888887,32.07465277777777,0
1824,4,0,1,34,0.0,0.02857142857142857,0.9714285714285714,35,700,300,400,0.42857142857142855,11,3,8,381.59487173436185,0.4117997198879552,0.039235896378753354,0.2149961350503355,129825.09731833899,2908.118271818513,132733.2155901575,1800,6,322.22857142857146,33,2,21,35.49833654000321,0.625,45.22058823529411,1019.1176470588226,30.882352941176443,8
1825,4,0,1,33,0.0,0.029411764705882353,0.9705882352941176,34,1100,800,300,0.7272727272727273,14,8,6,390.2412352789432,0.40792112299465244,0.06925620316221082,0.22088146162214617,130004.92814827577,3346.656750586685,133351.58489886246,1801,8,332.52941176470586,32,2,23,35.09476497049235,0.6292317708333333,45.044191919191924,1019.8232323232329,31.869476010101028,0
1826,4,0,0,33,0.0,0.0,1.0,33,900,700,200,0.7777777777777778,11,7,4,397.94805869054625,0.40522411616161613,0.08068941232011073,0.22500586625311694,129963.68620130759,3743.759324815547,133707.44552612313,1802,9,342.4848484848485,31,2,23,34.940327970033614,0.6313844086021505,45.08463541666667,1019.661458333334,32.8923051075269,0
1827,4,1,0,34,0.029411764705882353,0.0,1.0,34,1150,900,250,0.782608695652174,14,9,5,384.1844154158074,0.4088309566250743,0.07386887926960117,0.21908290918366177,130295.81917656807,3211.867947048629,133507.6871236167,1803,0,333.38235294117646,31,3,24,34.9531575479318,0.634744623655914,44.75911458333334,1020.9635416666678,32.93430779569896,0
1828,4,0,0,34,0.0,0.0,1.0,34,700,300,400,0.42857142857142855,11,3,8,384.8403602322507,0.4085153000594177,0.07826761968334495,0.21983269812829903,130362.29663425036,3233.7346394856995,133596.03127373607,1804,1,334.38235294117646,31,3,24,34.868805516596545,0.6354166666666667,44.69401041666668,1021.2239583333345,32.94270833333337,0
1829,4,0,0,34,0.0,0.0,1.0,34,1250,1000,250,0.8,15,10,5,384.12161050565004,0.4082553475935829,0.0747459978255165,0.21979825196329883,130428.7910461427,3220.1034545898574,133648.89450073254,1805,2,335.38235294117646,31,3,24,34.819550669216056,0.6360887096774194,44.62890625000001,1021.4843750000009,32.95110887096777,0
1830,4,0,0,34,0.0,0.0,1.0,34,1800,1400,400,0.7777777777777778,22,14,8,381.489527524003,0.4080696672608437,0.07266237706084566,0.21979730444944928,130694.93823581266,3171.750047471778,133866.68828328443,1806,3,336.38235294117646,31,3,19,34.61641517042319,0.6387768817204301,44.36848958333333,1022.5260416666662,32.98471102150536,0
1831,4,0,1,33,0.0,0.029411764705882353,0.9705882352941176,34,1350,1000,350,0.7407407407407407,17,10,7,379.57054544548447,0.4069741532976827,0.08056331070410083,0.2198264492745809,130894.7266472711,3136.7565578884587,134031.48320515957,1807,4,337.38235294117646,31,3,19,34.46274441192687,0.6407930107526882,44.173177083333336,1023.3072916666671,33.009912634408614,0
1832,4,0,0,33,0.0,0.0,1.0,33,1300,1200,100,0.9230769230769231,14,12,2,366.17939348184933,0.402935606060606,0.06071924423518049,0.1998065820955311,128560.3509845936,2815.230269870448,131375.58125446405,1808,15,348.4848484848485,32,1,18,37.180704266268265,0.6145833333333333,46.46464646464648,1014.1414141414158,31.691919191919244,8
1833,4,0,0,33,0.0,0.0,1.0,33,1050,800,250,0.7619047619047619,13,8,5,365.8123173603162,0.40258049242424243,0.05316321105794786,0.20041128797715474,128720.46100206606,2817.5060261707945,131537.96702823686,1809,16,349.4848484848485,32,1,19,37.026409107876106,0.6162109375,46.30681818181818,1014.7727272727269,31.711647727272716,0
1834,4,1,0,34,0.029411764705882353,0.0,1.0,34,950,600,350,0.631578947368421,13,6,7,358.26789152052373,0.40673276886512183,0.05861070911722166,0.1980504904325454,129076.82742214529,2448.8165609380962,131525.6439830834,1810,0,340.1764705882353,33,1,20,36.85429731468084,0.6174242424242424,45.955882352941174,1016.1764705882349,30.793226381461665,0
1835,4,1,0,35,0.02857142857142857,0.0,1.0,35,1150,900,250,0.782608695652174,14,9,5,353.61354882776385,0.4098039215686275,0.08406758684703619,0.19843904147923988,129669.02941476827,2170.6052059303997,131839.63462069866,1811,0,331.42857142857144,33,2,20,36.36984618778326,0.6234217171717171,45.373774509803916,1018.5049019607836,30.863784907902534,0
1836,4,0,0,35,0.0,0.0,1.0,35,850,500,350,0.5882352941176471,12,5,7,357.01590408203367,0.40924369747899164,0.09126497224656704,0.20066755988059143,129731.44531250003,2263.2378472222235,131994.68315972225,1812,1,332.42857142857144,33,2,20,36.21975119291069,0.6240530303030303,45.3125,1018.7500000000002,30.871212121212128,0
1837,4,0,0,35,0.0,0.0,1.0,35,800,500,300,0.625,11,5,6,358.70245869837294,0.4094537815126051,0.09331844343269502,0.20193709844800056,129793.87622849371,2311.476505430588,132105.3527339243,1813,2,333.42857142857144,33,2,20,36.11332431348968,0.6246843434343434,45.25122549019607,1018.9950980392146,30.878639334521655,0
1838,4,0,0,35,0.0,0.0,1.0,35,1000,600,400,0.6,14,6,8,357.9310544387953,0.40780812324929977,0.09979743880248582,0.2026328051047383,130012.50270328713,2307.1024365628505,132319.60513984997,1814,3,334.42857142857144,33,2,22,35.910838740687346,0.6268939393939394,45.03676470588235,1019.85294117647,30.904634581105153,0
1839,4,0,0,35,0.0,0.0,1.0,35,950,700,250,0.7368421052631579,12,7,5,382.6740344106557,0.40717787114845944,0.06126988093750563,0.20403333093860632,127633.67776566178,2894.001588024717,130527.6793536865,1815,4,335.42857142857144,32,3,20,37.71294098046566,0.6051432291666667,47.38005050505051,1010.479797979799,31.577493686868717,8
1840,4,0,2,33,0.0,0.05714285714285714,0.9428571428571428,35,1150,700,450,0.6086956521739131,16,7,9,352.13937882899603,0.4066526610644258,-0.0005833672500337173,0.1791317709695324,125715.30612244873,1853.861961451215,127569.16808389995,1816,5,336.42857142857144,34,1,19,40.457077002215854,0.5808823529411764,49.28571428571427,1002.8571428571408,29.495798319327672,8
1841,4,4,2,35,0.10810810810810811,0.05405405405405406,0.9459459459459459,37,750,500,250,0.6666666666666666,10,5,5,329.4049154536701,0.4207645145145145,-0.0032066989756707187,0.1709003202475658,126524.89271365936,935.5843174255119,127460.47703108487,1817,0,302.13513513513516,36,1,18,40.19452839340349,0.5850694444444444,48.47972972972972,1006.081081081079,27.946696696696637,0
1842,4,1,1,35,0.027777777777777776,0.027777777777777776,0.9722222222222222,36,1000,700,300,0.7,13,7,6,344.08472416517475,0.41712962962962963,0.026372601619785385,0.1792125108256697,126683.87372470825,1517.9971493483934,128201.87087405664,1818,0,311.5,35,1,19,39.66189545489385,0.5886904761904762,48.321759259259245,1006.7129629629608,28.763227513227452,0
1843,4,0,0,35,0.0,0.0,1.0,35,1100,800,300,0.7272727272727273,14,8,6,349.6189788654844,0.41320028011204485,0.028355234266797646,0.18231056246882024,126732.14994331055,1861.5929705215299,128593.74291383207,1819,1,321.1714285714286,34,1,19,39.47298415701109,0.5912990196078431,48.27380952380952,1006.904761904761,29.614845938375325,0
1844,4,1,0,36,0.027777777777777776,0.0,1.0,36,1350,1000,350,0.7407407407407407,17,10,7,337.0590102317989,0.4177248677248677,0.01834429656825254,0.1778333131465107,127208.74592764056,1375.3707990397766,128584.11672668034,1820,0,313.22222222222223,35,1,20,39.300328897047564,0.594047619047619,47.800925925925924,1008.796296296296,28.822751322751312,0
1845,4,1,2,35,0.02702702702702703,0.05405405405405406,0.9459459459459459,37,750,500,250,0.6666666666666666,10,5,5,329.44920227813657,0.4203265765765766,0.0269908624056705,0.17502964727667844,127489.7532667804,1000.2795024754611,128490.03276925586,1821,0,305.72972972972974,36,1,15,39.204672167707415,0.5949074074074074,47.52252252252253,1009.9099099099109,28.05305305305308,0
1846,4,1,3,33,0.027777777777777776,0.08333333333333333,0.9166666666666666,36,1000,600,400,0.6,14,6,8,365.07069189263046,0.41909722222222223,0.0061983471074382734,0.19205892921307943,127092.01388888883,2081.1910305575793,129173.2049194464,1822,0,308.1388888888889,34,2,18,38.71384297520662,0.5949754901960784,47.916666666666664,1008.3333333333328,29.656862745098024,8
1847,4,0,1,32,0.0,0.030303030303030304,0.9696969696969697,33,750,400,350,0.5333333333333333,11,4,7,384.3188321882942,0.41169507575757575,0.032578009060758584,0.20137057835512556,126927.95011732297,3156.1603122287083,130084.11042955167,1823,1,335.93939393939394,31,2,18,38.3976450445794,0.6004704301075269,48.07942708333332,1007.6822916666653,32.50588037634404,0
1848,4,0,0,32,0.0,0.0,1.0,32,850,600,250,0.7058823529411765,11,6,5,396.7160649329314,0.40603998655913975,0.03730242096838721,0.20783929691140374,126922.65950182105,3670.451605676958,130593.11110749801,1824,2,347.25,30,2,18,38.09079187230448,0.603125,48.08467741935484,1007.661290322581,33.58870967741937,0
1849,4,6,5,33,0.15789473684210525,0.13157894736842105,0.868421052631579,38,900,700,200,0.7777777777777778,11,7,4,343.0151656054755,0.42669807965860596,0.026327815425688295,0.18590784795942586,128291.05748724712,1207.0089437735205,129498.06643102063,1825,0,293.2631578947368,35,3,19,38.0427900910164,0.6050595238095238,46.730324074074076,1013.078703703704,28.94510582010583,0
1850,4,0,0,33,0.0,0.0,1.0,33,1100,700,400,0.6363636363636364,15,7,8,387.4372641878023,0.40948547979797983,0.039523312578903846,0.20531791587478015,127387.59570651593,3270.9403143988807,130658.5360209148,1826,1,338.6969696969697,31,2,19,37.84569951416654,0.6051747311827957,47.62369791666667,1009.5052083333342,32.56468413978497,0
1851,4,1,0,34,0.029411764705882353,0.0,1.0,34,750,500,250,0.6666666666666666,10,5,5,379.13100664736294,0.41325014854426617,0.04527627007851476,0.2031077078420556,127825.12825540765,2892.493910060203,130717.62216546785,1827,0,329.70588235294116,32,2,20,37.60587047904439,0.6070963541666667,47.19065656565657,1011.2373737373741,31.60116792929294,0
1852,4,0,0,34,0.0,0.0,1.0,34,1100,900,200,0.8181818181818182,13,9,4,376.8810089907576,0.41306446821152704,0.048750403806056,0.20238409142318706,127920.90730537703,2842.1921232527347,130763.09942862976,1828,1,330.70588235294116,32,2,20,37.56448660342819,0.6080729166666667,47.0959595959596,1011.6161616161618,31.613005050505055,0
1853,4,1,0,35,0.02857142857142857,0.0,1.0,35,700,300,400,0.42857142857142855,11,3,8,364.9535434731371,0.4166666666666667,0.05208376529131242,0.1979944814590484,128330.7201557093,2366.950211457125,130697.67036716643,1829,0,322.22857142857146,33,2,21,37.446581196581185,0.6098484848484849,46.69117647058823,1013.2352941176467,30.70409982174687,0
1854,4,0,0,35,0.0,0.0,1.0,35,1100,800,300,0.7272727272727273,14,8,6,366.95149084396064,0.416421568627451,0.0529023792258021,0.20001031852720225,128517.04422577853,2431.9041955017296,130948.94842128026,1830,1,323.22857142857146,33,2,18,37.20540246555476,0.6117424242424243,46.50735294117647,1013.970588235294,30.726381461675576,0
1855,4,0,0,35,0.0,0.0,1.0,35,1400,1000,400,0.7142857142857143,18,10,8,364.8142487085497,0.4167717086834734,0.043668242846788496,0.19946713017234963,128641.33536380235,2386.0384227220256,131027.37378652437,1831,2,324.22857142857146,33,2,19,37.132560199726186,0.6130050505050505,46.384803921568626,1014.4607843137252,30.741235888294703,0
1856,4,1,0,36,0.027777777777777776,0.0,1.0,36,950,700,250,0.7368421052631579,12,7,5,357.53966624965284,0.41906415343915343,0.04582535776137142,0.19721305572774955,128989.6701388888,2023.7847222222165,131013.45486111102,1832,0,316.19444444444446,34,2,20,36.961648892534875,0.6142769607843137,46.041666666666664,1015.8333333333326,29.877450980392133,0
1857,4,1,0,37,0.02702702702702703,0.0,1.0,37,1200,1000,200,0.8333333333333334,14,10,4,345.9803033251972,0.4231106106106106,0.041780544589533175,0.1924515437246409,129322.44897959176,1548.7776360544083,130871.22661564617,1833,0,308.6216216216216,34,3,21,36.91650085830211,0.6176470588235294,45.71428571428571,1017.1428571428565,29.915966386554604,0
1858,4,1,1,37,0.02631578947368421,0.02631578947368421,0.9736842105263158,38,800,600,200,0.75,10,6,4,334.66011987925856,0.4257942152678995,0.04099449100077179,0.1876784190450982,129643.02722318648,1077.2702064042937,130720.29742959078,1834,0,301.4736842105263,35,3,17,36.87883566314355,0.61875,45.39930555555554,1018.4027777777758,29.097222222222165,0
1859,4,0,0,37,0.0,0.0,1.0,37,1050,600,450,0.5714285714285714,15,6,9,342.0739171626727,0.4215465465465465,0.037211536334650575,0.19160171666616516,129595.04145408174,1466.2166950113478,131061.25814909309,1835,1,310.5945945945946,34,3,17,36.73881484079659,0.6204044117647058,45.44642857142858,1018.2142857142867,29.947478991596668,0
1860,4,0,0,37,0.0,0.0,1.0,37,950,800,150,0.8421052631578947,11,8,3,339.37051931282383,0.42214089089089085,0.03564447728485609,0.19097122122277838,129776.9292091837,1408.4927721088493,131185.42198129254,1836,2,311.5945945945946,34,3,18,36.62299918214745,0.6222426470588236,45.267857142857146,1018.9285714285716,29.968487394957986,0
1861,4,0,0,37,0.0,0.0,1.0,37,1650,1000,650,0.6060606060606061,23,10,13,340.3391822057538,0.42073323323323325,0.036469613768138176,0.1924511036734718,129967.3742391118,1446.5979723936919,131413.9722115055,1837,3,312.5945945945946,35,2,19,36.40512674990541,0.6220238095238095,45.08101851851852,1019.675925925926,29.133597883597886,0
1862,4,0,0,37,0.0,0.0,1.0,37,1000,600,400,0.6,14,6,8,345.2282059234911,0.42095220220220225,0.08004342203987824,0.18095088316670918,126942.00857426312,1365.1272732601415,128307.13584752326,1838,4,313.5945945945946,34,3,19,39.3679858239811,0.5934436274509804,48.0654761904762,1007.738095238096,29.639355742296942,8
1863,4,1,0,38,0.02631578947368421,0.0,1.0,38,900,700,200,0.7777777777777778,11,7,4,336.1798236516687,0.4238827643432907,0.08241307064840053,0.1774972454737492,127237.93730977815,954.9654653206733,128192.90277509882,1839,0,306.3157894736842,35,3,20,39.29259397346183,0.5943452380952381,47.771990740740755,1008.9120370370387,28.82605820105825,0
1864,4,0,0,38,0.0,0.0,1.0,38,1350,700,650,0.5185185185185185,20,7,13,337.521671004098,0.4234826932195353,0.08617568798759434,0.1789788167883741,127413.15593117745,1000.9402595593651,128414.09619073682,1840,1,307.3157894736842,35,3,17,39.07927796247469,0.5961309523809524,47.59837962962965,1009.6064814814841,28.845899470899546,0
1865,4,4,2,40,0.09523809523809523,0.047619047619047616,0.9523809523809523,42,1050,700,350,0.6666666666666666,14,7,7,309.9075799851907,0.43331397599690286,0.12481749627466598,0.16894502249508642,128523.41666895003,-431.83068138519036,128091.58598756483,1841,0,278.95238095238096,38,4,15,38.64494433322797,0.6016995614035088,46.5010683760684,1013.9957264957307,26.684098065677123,0
1866,4,0,0,40,0.0,0.0,1.0,40,800,500,300,0.625,11,5,6,325.0681445100545,0.42859241452991453,0.12694530902623402,0.17616343542243704,128287.09621783973,340.40966642321433,128627.50588426295,1842,1,293.6,36,4,21,38.5013709796947,0.6030092592592593,46.73423423423425,1013.0630630630652,28.1406406406407,0
1867,4,0,0,40,0.0,0.0,1.0,40,1250,1000,250,0.8,15,10,5,326.7913580246916,0.4292334401709402,0.12397777777777819,0.1776039989264629,128401.20525931344,392.08084773964623,128793.28610705309,1843,2,294.6,36,4,17,38.34143518518521,0.6041666666666667,46.62162162162163,1013.5135135135141,28.15315315315317,0
1868,4,0,0,40,0.0,0.0,1.0,40,1550,1000,550,0.6451612903225806,21,10,11,330.6081779615524,0.42835202991452986,0.12240728403286716,0.1804519545891964,128572.4639335281,501.42160741822687,129073.88554094633,1844,3,295.6,36,4,17,38.07022170404915,0.6059027777777778,46.4527027027027,1014.189189189189,28.171921921921918,0
1869,4,1,1,40,0.024390243902439025,0.024390243902439025,0.975609756097561,41,1850,1300,550,0.7027027027027027,24,13,11,327.6401750409241,0.42797256097560976,0.13199735752618147,0.18105196792511852,129062.08070031132,257.1845423591534,129319.26524267047,1845,0,289.3658536585366,37,4,21,37.647364303442316,0.6089527027027026,45.97039473684209,1016.118421052629,27.46266002844943,0
1870,4,3,0,43,0.06976744186046512,0.0,1.0,43,1300,900,400,0.6923076923076923,17,9,8,320.63011747953027,0.4336471022517534,0.1595729120959486,0.18078081091930934,129853.92011834297,-272.9093241423199,129581.01079420064,1846,0,275.0232558139535,38,5,17,37.02240566037736,0.6151315789473684,45.19230769230768,1019.2307692307674,26.821862348178087,0
1871,4,0,0,43,0.0,0.0,1.0,43,1700,1200,500,0.7058823529411765,22,12,10,325.5475634288356,0.43323181985972686,0.1638456759291973,0.18419392370647503,129990.07100819984,-136.40982266785392,129853.661185532,1847,1,276.0232558139535,38,5,18,36.759210756067745,0.6165021929824561,45.058760683760674,1019.7649572649559,26.835919928025156,0
1872,4,1,0,44,0.022727272727272728,0.0,1.0,44,1500,1000,500,0.6666666666666666,20,10,10,316.9144259473471,0.43531976744186046,0.16509541603673994,0.1813296724406095,130426.23325525958,-532.9236750310612,129893.30958022851,1848,0,270.72727272727275,38,6,19,36.5384112540529,0.6208881578947368,44.63141025641025,1021.474358974358,26.880904183535737,0
1873,4,0,1,43,0.0,0.022727272727272728,0.9772727272727273,44,1300,1000,300,0.7692307692307693,16,10,6,320.58391345647203,0.434526955602537,0.1592571656580437,0.1844658729924823,130644.58832137109,-423.48932080503164,130221.09900056606,1849,1,271.72727272727275,38,6,12,36.22417877172814,0.6230811403508771,44.41773504273504,1022.3290598290592,26.903396311291033,0
1874,4,0,1,42,0.0,0.023255813953488372,0.9767441860465116,43,1200,900,300,0.75,15,9,6,327.902723909581,0.4317783314876338,0.15535811857695658,0.18831677692921783,130570.5857210873,-37.10985591720123,130533.4758651701,1850,4,279.0232558139535,37,6,12,36.11189339484317,0.6241554054054055,44.49013157894737,1022.0394736842109,27.622688477951645,0
1875,4,0,0,42,0.0,0.0,1.0,42,1300,900,400,0.6923076923076923,17,9,8,338.8334906095653,0.4276035617499032,0.15890776992088873,0.19391536866368286,130435.08193582128,439.15482205181985,130874.23675787309,1851,5,286.45238095238096,36,6,22,35.96971116745674,0.6247106481481481,44.622747747747766,1021.5090090090116,28.37525025025032,0
1876,4,0,0,42,0.0,0.0,1.0,42,1050,700,350,0.6666666666666666,14,7,7,336.18722207182896,0.4268897599690282,0.15885128879065702,0.1930352320731763,130562.68376981527,378.70119256337904,130941.38496237865,1852,6,287.45238095238096,38,4,12,35.90820788905149,0.6222587719298245,44.49786324786325,1022.0085470085477,26.894961763382835,0
1877,4,0,1,41,0.0,0.023809523809523808,0.9761904761904762,42,950,700,250,0.7368421052631579,12,7,5,335.3172258979205,0.4268655632984901,0.15663819875776408,0.19280740489130443,130617.28395061739,359.6450617284068,130976.9290123458,1853,7,288.45238095238096,38,4,12,35.87522644927535,0.6228070175438596,44.44444444444445,1022.2222222222231,26.90058479532166,0
1878,4,1,0,42,0.023809523809523808,0.0,1.0,42,800,500,300,0.625,11,5,6,327.4701050002307,0.4280512001548587,0.15605703546818606,0.18963172102129458,130890.45606874145,172.54227847177745,131062.99834721323,1854,0,288.0,38,4,14,35.79992343565114,0.6255482456140351,44.17735042735043,1023.2905982905993,26.92869995501577,0
1879,4,0,3,39,0.0,0.07142857142857142,0.9285714285714286,42,600,400,200,0.6666666666666666,8,4,4,313.6497723445538,0.42831736353077815,0.07369020159961681,0.17659926379116594,129799.47973738018,-257.6845459858464,129541.79519139434,1855,1,289.0,38,4,15,37.25536450688475,0.6145833333333333,45.24572649572649,1019.0170940170925,26.816239316239276,8
1880,4,2,0,41,0.04878048780487805,0.0,1.0,41,1350,1000,350,0.7407407407407407,17,10,7,318.84417726563316,0.427515243902439,0.11664534530126058,0.1808857454438689,130094.74068944286,95.99011234225685,130190.73080178512,1856,0,296.3658536585366,37,4,18,36.82421539122957,0.6193693693693694,44.95614035087719,1020.175438596491,27.572309151256512,0
1881,4,0,0,41,0.0,0.0,1.0,41,950,400,550,0.42105263157894735,15,4,11,320.784446111851,0.4277439024390244,0.11951953210980304,0.18250987924261067,130206.62607725458,153.65208525700777,130360.27816251159,1857,1,297.3658536585366,37,4,19,36.66156352958029,0.6204954954954955,44.84649122807018,1020.6140350877197,27.58416311047891,0
1882,4,0,1,40,0.0,0.024390243902439025,0.975609756097561,41,1200,900,300,0.75,15,9,6,318.91377640793127,0.42792174796747967,0.1200025144581347,0.18196844889158417,130318.55955678663,112.07679285934003,130430.63634964597,1858,2,298.3658536585366,37,4,20,36.596148339060726,0.6216216216216216,44.73684210526316,1021.0526315789467,27.59601706970126,0
1883,4,0,0,40,0.0,0.0,1.0,40,800,400,400,0.5,12,4,8,325.36443148688045,0.4277911324786325,0.12030612244897965,0.18538205980066458,130262.58680555562,476.56250000000927,130739.14930555563,1859,3,303.725,36,4,20,36.48809523809524,0.622974537037037,44.79166666666667,1020.8333333333339,28.3564814814815,0
1884,4,0,0,40,0.0,0.0,1.0,40,1350,1200,150,0.8888888888888888,15,12,3,327.7857889885557,0.4277911324786325,0.12106815925885028,0.1870379955166292,130320.07250071033,543.413557138233,130863.48605784857,1860,4,304.725,36,4,20,36.36814822984448,0.6235532407407407,44.73536036036037,1021.0585585585599,28.362737737737774,0
1885,4,0,0,40,0.0,0.0,1.0,40,1350,900,450,0.6666666666666666,18,9,9,326.5001103203843,0.42673611111111115,0.12212884382233025,0.18713427043189174,130492.6056757771,521.1700298271232,131013.77570560422,1861,5,305.725,36,4,12,36.22653293655169,0.6252893518518519,44.56644144144144,1021.734234234234,28.3815065065065,0
1886,4,0,0,40,0.0,0.0,1.0,40,1500,1100,400,0.7333333333333333,19,11,8,323.8891146542844,0.4264022435897436,0.12379942724969695,0.18646729688942612,130665.2529852489,464.2106210940791,131129.46360634296,1862,6,306.725,36,4,12,36.118836509160325,0.627025462962963,44.39752252252253,1022.409909909911,28.400275275275305,0
1887,4,0,1,39,0.0,0.025,0.975,40,1000,600,400,0.6,14,6,8,322.85288465194594,0.4254674145299145,0.1269486953649679,0.1864254768781708,130780.41459956582,444.56682188946337,131224.98142145528,1863,7,307.725,36,4,13,36.02907446144813,0.6281828703703703,44.28490990990991,1022.8603603603607,28.412787787787796,0
1888,4,0,0,39,0.0,0.0,1.0,39,600,300,300,0.5,9,3,6,330.9786029045751,0.42226158344579395,0.1271488433100023,0.19089601405122877,130735.62349965704,854.1388031550027,131589.76230281204,1864,8,316.1794871794872,35,4,15,35.866530858608705,0.6297619047619047,44.3287037037037,1022.685185185185,29.219576719576715,0
1889,4,0,0,39,0.0,0.0,1.0,39,1100,800,300,0.7272727272727273,14,8,6,329.9525914685482,0.4221210076473234,0.12301542406757959,0.1907423777626225,130824.4133257245,833.1708408350551,131657.58416655957,1865,9,317.1794871794872,35,4,16,35.80309329863861,0.6306547619047619,44.24189814814815,1023.0324074074077,29.229497354497365,0
1890,4,0,2,37,0.0,0.05128205128205128,0.9487179487179487,39,950,600,350,0.631578947368421,13,6,7,330.2138447673146,0.4218398560503824,0.12506884177695832,0.19192323724123955,131031.70680084026,853.6967378257928,131885.40353866605,1866,10,318.1794871794872,35,4,18,35.58717687843845,0.6327380952380952,44.039351851851855,1023.8425925925931,29.252645502645517,0
1891,4,1,1,37,0.02631578947368421,0.02631578947368421,0.9736842105263158,38,1100,900,200,0.8181818181818182,13,9,4,340.80360995947774,0.41800023707918443,0.1361739619917035,0.19834862333365538,131084.1907596372,1334.793083900231,132418.98384353743,1867,0,326.60526315789474,34,4,22,35.26311710454933,0.6354166666666667,43.98809523809524,1024.047619047619,30.11904761904762,0
1892,4,1,0,38,0.02631578947368421,0.0,1.0,38,1300,1000,300,0.7692307692307693,16,10,6,340.9853683769661,0.41854848269321954,0.13052130267590223,0.1995610493784705,131297.62081916098,1354.1135204081627,132651.73433956914,1868,0,326.10526315789474,34,4,23,35.04302667750804,0.6375612745098039,43.779761904761905,1024.8809523809523,30.143557422969185,0
1893,4,0,0,38,0.0,0.0,1.0,38,900,500,400,0.5555555555555556,13,5,8,341.2951491917979,0.4184892128971076,0.13024696638275524,0.20054000103261577,131450.17715419494,1372.6615646258467,132822.8387188208,1869,1,327.10526315789474,34,4,23,34.88120114542218,0.639093137254902,43.63095238095238,1025.4761904761901,30.1610644257703,0
1894,4,0,0,38,0.0,0.0,1.0,38,900,600,300,0.6666666666666666,12,6,6,341.02087282928534,0.41842994310099574,0.1325746469237159,0.20069916941920216,131511.22448979577,1369.6145124716363,132880.8390022674,1870,2,328.10526315789474,34,4,23,34.826679046734746,0.6397058823529411,43.57142857142856,1025.7142857142844,30.168067226890717,0
1895,4,0,0,38,0.0,0.0,1.0,38,600,300,300,0.5,9,3,6,341.03424860478816,0.4183706733048838,0.1347000726837404,0.20086754068540372,131541.75347222204,1372.0486111110918,132913.80208333314,1871,3,329.10526315789474,34,4,23,34.7955591659897,0.6400122549019608,43.54166666666666,1025.833333333332,30.171568627450938,0
1896,4,0,0,38,0.0,0.0,1.0,38,850,500,350,0.5882352941176471,12,5,7,342.0053186621521,0.4182076813655761,0.13765417022835535,0.20192368814162653,131633.36167800432,1403.8619614512254,133037.22363945554,1872,4,330.10526315789474,34,4,14,34.67831593194123,0.6409313725490196,43.45238095238094,1026.1904761904746,30.182072829131606,0
1897,4,0,0,38,0.0,0.0,1.0,38,850,500,350,0.5882352941176471,12,5,7,340.62604437268664,0.41773352299668093,0.1350645228241092,0.20143194475866258,131694.4515306121,1371.7120181405664,133066.16354875267,1873,5,331.10526315789474,34,4,14,34.65214953993658,0.6415441176470589,43.39285714285713,1026.4285714285702,30.189075630252063,0
1898,4,1,1,38,0.02564102564102564,0.02564102564102564,0.9743589743589743,39,1350,900,450,0.6666666666666666,18,9,9,343.60101103900706,0.4180443094916779,0.12040035491655465,0.1970818947008819,130521.37230135551,1169.4550969888883,131690.8273983444,1874,0,323.5897435897436,36,3,16,35.76059804569833,0.6255787037037037,44.53828828828829,1021.8468468468477,28.384634634634658,8
1899,4,0,0,38,0.0,0.0,1.0,38,1050,800,250,0.7619047619047619,13,8,5,343.84899388368433,0.41594061166429586,0.14230126881770278,0.1975173081321722,130578.91506371237,1379.8857134161178,131958.8007771285,1875,1,332.92105263157896,36,2,16,35.696020640517105,0.6261574074074074,44.48198198198198,1022.0720720720722,28.390890890890894,0
1900,4,0,0,38,0.0,0.0,1.0,38,950,500,450,0.5263157894736842,14,5,9,350.1303636941619,0.4156294452347084,0.14976434919217874,0.201574735065269,130665.25298524859,1549.9745099829388,132215.22749523152,1876,2,333.92105263157896,36,2,16,35.44810368249074,0.627025462962963,44.397522522522515,1022.4099099099085,28.400275275275234,0
1901,4,0,0,38,0.0,0.0,1.0,38,1150,900,250,0.782608695652174,14,9,5,352.08522328378234,0.41595542911332384,0.012759523117184868,0.1984041887122186,129831.84831791249,1600.979907272132,131432.8282251846,1877,3,334.92105263157896,36,2,17,36.243324125230195,0.6186342592592593,45.21396396396396,1019.1441441441441,28.30955955955956,8
1902,4,1,0,39,0.02564102564102564,0.0,1.0,39,1400,1000,400,0.7142857142857143,18,10,8,345.6436321830815,0.41877530364372473,0.024711718433005014,0.19626547114395837,130129.69970703124,1195.7004123263882,131325.40011935763,1878,0,327.3076923076923,39,0,18,36.10526203845499,0.6161858974358974,44.921875,1020.3124999999999,26.16185897435897,0
1903,4,0,1,38,0.0,0.02564102564102564,0.9743589743589743,39,1100,700,400,0.6363636363636364,15,7,8,344.48732563891724,0.4187190733243365,0.029522381262709896,0.19587593321442115,130182.84640842024,1169.268120659731,131352.11452907996,1879,1,328.3076923076923,39,0,18,36.08087935082168,0.6167200854700854,44.86979166666667,1020.5208333333342,26.167200854700877,0
1904,4,0,0,38,0.0,0.0,1.0,38,1100,700,400,0.6363636363636364,15,7,8,347.3880456106606,0.4187559269796112,0.03838590463704872,0.1985013654489384,130374.54433094813,1458.1360445642106,131832.68037551234,1880,2,334.63157894736844,37,1,18,35.812576050390106,0.6221846846846847,44.68201754385966,1021.2719298245627,27.601944049312504,0
1905,4,0,0,38,0.0,0.0,1.0,38,1350,900,450,0.6666666666666666,18,9,9,342.03714710861306,0.4191115457562826,0.02859675470590206,0.19657646642086876,130598.60365689448,1333.9147622345388,131932.51841912902,1881,3,335.63157894736844,37,1,16,35.722395051133525,0.6244369369369369,44.46271929824562,1022.149122807018,27.625651967757243,0
1906,4,0,0,38,0.0,0.0,1.0,38,850,500,350,0.5882352941176471,12,5,7,343.3530975358516,0.41881519677572304,0.030549346338819783,0.19761878280396794,130654.64854570635,1372.1356571252638,132026.78420283162,1882,4,336.63157894736844,37,1,16,35.63206063206063,0.625,44.4078947368421,1022.3684210526314,27.631578947368418,0
1907,4,0,2,36,0.0,0.05263157894736842,0.9473684210526316,38,1150,600,550,0.5217391304347826,17,6,11,341.64354527078774,0.41854848269321954,0.028426470422248773,0.19692012998735278,130710.70545744845,1331.2937634656807,132041.99922091412,1883,5,337.63157894736844,37,1,17,35.619057831153036,0.6255630630630631,44.353070175438596,1022.5877192982457,27.637505926979614,0
1908,4,0,0,36,0.0,0.0,1.0,36,1200,700,500,0.5833333333333334,17,7,10,349.550565992343,0.4138392857142857,0.0481443765557823,0.20191685635557685,130794.81336805546,1943.8802083333235,132738.6935763888,1884,6,350.6666666666667,35,1,18,35.33180583842498,0.6303571428571428,44.27083333333333,1022.9166666666658,29.226190476190453,0
1909,4,0,0,36,0.0,0.0,1.0,36,1350,1100,250,0.8148148148148148,16,11,5,346.1342673166446,0.41435185185185186,0.04602609056290796,0.20040426046800622,130883.62328800153,1860.661410108027,132744.28469810955,1885,7,351.6666666666667,35,1,18,35.32936036647438,0.63125,44.18402777777778,1023.2638888888888,29.236111111111107,0
1910,4,1,0,37,0.02702702702702703,0.0,1.0,37,850,400,450,0.47058823529411764,13,4,9,336.8590788918649,0.41807432432432434,0.05556908854336862,0.19671013477266935,131212.7224352732,1440.039363688019,132652.76179896123,1886,0,343.13513513513516,36,1,19,35.23439217410418,0.6325231481481481,43.862612612612615,1024.5495495495502,28.459709709709728,0
1911,4,0,0,37,0.0,0.0,1.0,37,1150,700,450,0.6086956521739131,16,7,9,336.33715734814615,0.41766766766766766,0.05755865755865752,0.19670103675245063,131270.41737683644,1430.223804885979,132700.64118172243,1887,1,344.13513513513516,36,1,19,35.189560439560424,0.6331018518518519,43.80630630630631,1024.7747747747758,28.465965965965992,0
1912,4,0,0,37,0.0,0.0,1.0,37,1100,800,300,0.7272727272727273,14,8,6,334.04810133529696,0.41747997997998,0.05670777861881615,0.1960998041687866,131414.71021274658,1379.7668868192527,132794.47709956582,1888,2,345.13513513513516,36,1,20,35.102736591616306,0.6345486111111112,43.66554054054054,1025.3378378378382,28.481606606606615,0
1913,4,0,0,37,0.0,0.0,1.0,37,1150,800,350,0.6956521739130435,15,8,7,335.2933667127971,0.4170733233233233,0.06266852957666291,0.19772542809840093,131587.9662390431,1424.1144438357283,133012.08068287882,1889,3,346.13513513513516,36,1,18,34.896233490652314,0.6362847222222222,43.49662162162162,1026.0135135135135,28.500375375375377,0
1914,4,0,0,37,0.0,0.0,1.0,37,900,400,500,0.4444444444444444,14,4,10,332.1780547382948,0.4167292292292292,0.060060718902316346,0.19663215240222703,131732.4334469605,1351.7246976706479,133084.15814463113,1890,4,347.13513513513516,36,1,18,34.83070059967822,0.6377314814814814,43.35585585585586,1026.5765765765768,28.516016016016025,0
1915,4,0,0,37,0.0,0.0,1.0,37,1200,900,300,0.75,15,9,6,328.87092029932046,0.4156969469469469,0.06710832735827243,0.1955645720319688,131905.89871966562,1276.002860969081,133181.9015806347,1891,5,348.13513513513516,36,1,18,34.74110209749325,0.6394675925925926,43.18693693693694,1027.2522522522524,28.53478478478479,0
1916,4,0,1,36,0.0,0.02702702702702703,0.972972972972973,37,1050,800,250,0.7619047619047619,13,8,5,328.30710941118207,0.4146021021021021,0.027487880714731405,0.18129282930893997,129034.22807979376,1072.5708871960533,130106.79896698981,1892,6,349.13513513513516,37,0,20,37.6587344413267,0.6086711711711712,45.997807017543856,1016.0087719298243,27.4596965386439,8
1917,4,0,0,36,0.0,0.0,1.0,36,1450,1000,450,0.6896551724137931,19,10,9,336.0096820065125,0.40963955026455023,0.03998115925967016,0.1856592382574873,129058.31665702889,1472.9687880448319,130531.28544507372,1893,15,359.6666666666667,36,0,20,37.43858288078614,0.6108217592592593,45.974099099099114,1016.1036036036055,28.225100100100153,0
1918,4,1,0,37,0.02702702702702703,0.0,1.0,37,1050,700,350,0.6666666666666666,14,7,7,329.9295092043517,0.4125375375375375,0.036524626452684616,0.18389346796183348,129401.82317029889,1138.7752617482633,130540.59843204715,1894,0,350.9189189189189,36,1,21,37.244050913115665,0.6142939814814814,45.636261261261275,1017.4549549549566,28.262637637637685,0
1919,4,0,0,37,0.0,0.0,1.0,37,1000,700,300,0.7,13,7,6,329.1758992859074,0.4117555055055055,0.037836043810156816,0.18400871698486826,129516.42679419297,1126.7372524551815,130643.16404664815,1895,1,351.9189189189189,36,1,19,37.14690046834091,0.6154513888888888,45.52364864864866,1017.9054054054064,28.27515015015018,0
1920,4,1,0,38,0.02631578947368421,0.0,1.0,38,1200,700,500,0.5833333333333334,17,7,10,323.22609864205697,0.4121621621621621,0.04581958984655077,0.18249842800251517,129908.37191358021,797.9552469135745,130706.32716049379,1896,0,343.63157894736844,38,0,20,36.90111262488646,0.6156798245614035,45.138888888888886,1019.4444444444441,26.82748538011695,0
1921,4,0,0,38,0.0,0.0,1.0,38,1050,700,350,0.6666666666666666,14,7,7,321.5408471520169,0.4118213608345187,0.049783573653883195,0.1819269345623001,129990.07100819999,759.4235106654935,130749.49451886548,1897,1,344.63157894736844,38,0,20,36.86135847738779,0.6165021929824561,45.05876068376068,1019.764957264957,26.835919928025184,0
1922,4,1,0,39,0.02564102564102564,0.0,1.0,39,950,600,350,0.631578947368421,13,6,7,312.2555557666862,0.41512033288349076,0.0675983361894883,0.17866399573221334,130426.23325525962,345.5485471911735,130771.78180245079,1898,0,336.7692307692308,38,1,21,36.65738416483634,0.6208881578947368,44.631410256410255,1021.4743589743583,26.880904183535744,0
1923,4,0,0,39,0.0,0.0,1.0,39,1200,900,300,0.75,15,9,6,312.53859432168935,0.4151484480431849,0.06487753339876323,0.17895173885652668,130453.51765103375,354.3518061947634,130807.86945722852,1899,1,337.7692307692308,38,1,21,36.62261207557694,0.6211622807017544,44.60470085470086,1021.5811965811972,26.88371569950519,0
1924,4,0,0,39,0.0,0.0,1.0,39,1150,800,350,0.6956521739130435,15,8,7,313.41062547917295,0.41531713900134953,0.060274104816137486,0.17970379029273445,130508.09500328731,380.52473701512105,130888.61974030243,1900,2,338.7692307692308,38,1,15,36.54524780426601,0.6217105263157895,44.55128205128205,1021.7948717948717,26.889338731443992,0
1925,4,1,0,40,0.025,0.0,1.0,40,1250,1100,150,0.88,14,11,3,309.82733346886204,0.4177483974358975,0.07562059378413277,0.17963564049308633,130937.79047070198,113.62129436843395,131051.41176507041,1901,0,331.275,40,0,18,36.20357958494689,0.62265625,44.13109756097561,1023.4756097560977,25.58689024390244,0
1926,4,0,0,40,0.0,0.0,1.0,40,1400,800,600,0.5714285714285714,20,8,12,311.1960454259419,0.4173076923076923,0.07995732433505398,0.18103991649606188,131067.83743142315,157.55853823782786,131225.39596966098,1902,1,332.275,40,0,18,36.03757278020379,0.6239583333333334,44.00406504065041,1023.9837398373987,25.59959349593497,0
1927,4,1,1,40,0.024390243902439025,0.024390243902439025,0.975609756097561,41,1100,600,500,0.5454545454545454,16,6,10,304.7084895538728,0.41981707317073175,0.09102301757775266,0.17859975304028175,131355.5035635365,-194.19799437470976,131161.3055691618,1903,0,325.1463414634146,38,3,20,35.914321695327416,0.6302083333333333,43.7232905982906,1025.1068376068383,26.976495726495745,0
1928,4,1,1,40,0.024390243902439025,0.024390243902439025,0.975609756097561,41,1200,1000,200,0.8333333333333334,14,10,4,297.51388493512604,0.420020325203252,0.07604431586592497,0.16906264395209977,130158.8642363178,-451.0655754631261,129707.79866085466,1904,0,325.9024390243902,40,1,14,37.303513926235766,0.61484375,44.893292682926834,1020.4268292682937,25.510670731707343,8
1929,4,0,0,40,0.0,0.0,1.0,40,1200,1000,200,0.8333333333333334,14,10,4,302.6176485226364,0.41701388888888885,0.07492343032159265,0.1718341952045927,130129.69970703125,-124.09125434027806,130005.60845269097,1905,1,335.025,39,1,16,37.20276076229368,0.6161858974358974,44.921875,1020.3125,26.161858974358974,0
1930,4,0,0,40,0.0,0.0,1.0,40,1250,800,450,0.64,17,8,9,303.94247294256195,0.4171607905982906,0.010615887380593492,0.1622494843485654,127681.91599122524,-238.40854071652626,127443.50745050871,1906,2,336.025,40,0,14,39.65267303502597,0.58984375,47.33231707317072,1010.6707317073152,25.26676829268288,8
1931,4,1,0,41,0.024390243902439025,0.0,1.0,41,1000,600,400,0.6,14,6,8,299.1121836739217,0.4221544715447154,0.012856353683647015,0.16081418878704895,127968.81028163541,-544.5939429012708,127424.21633873414,1907,0,328.8048780487805,41,0,15,39.48252688172042,0.5912093495934959,47.04861111111109,1011.8055555555524,24.67818428184274,0
1932,4,1,1,41,0.023809523809523808,0.023809523809523808,0.9761904761904762,42,800,600,200,0.75,10,6,4,293.5928537878073,0.42468786295005806,0.021649785165238855,0.15873455328175734,128193.59117728776,-872.6555457905372,127320.93563149722,1908,0,321.95238095238096,42,0,16,39.39355883009602,0.5920138888888888,46.82655038759689,1012.6937984496102,24.1117571059431,0
1933,4,4,4,41,0.08888888888888889,0.08888888888888889,0.9111111111111111,45,1800,1200,600,0.6666666666666666,24,12,12,280.55840928316076,0.4304082491582492,0.04212905144216483,0.15432089146536918,128879.27710171147,-1768.3670053560493,127110.91009635542,1909,0,301.31111111111113,45,0,13,39.02839726434731,0.5949074074074074,46.150362318840564,1015.3985507246348,22.564412238325218,0
1934,4,0,0,41,0.0,0.0,1.0,41,1200,800,400,0.6666666666666666,16,8,8,302.4459279633712,0.42411077235772354,0.02847478019656413,0.16445396732313788,128420.90778730469,-431.9238748740272,127988.98391243066,1910,1,330.9512195121951,41,0,14,38.93826873511469,0.5957825203252032,46.60218253968254,1013.5912698412694,24.721738288811448,0
1935,4,1,1,41,0.023809523809523808,0.023809523809523808,0.9761904761904762,42,1050,800,250,0.7619047619047619,13,8,5,304.50872346363946,0.42664779326364694,0.04955335833617491,0.16708899310013756,128783.04268260638,-556.8880137912206,128226.15466881516,1911,0,324.04761904761904,42,0,16,38.51809864757361,0.5979662698412698,46.2451550387597,1015.0193798449625,24.167128091546726,0
1936,4,0,0,41,0.0,0.0,1.0,41,1050,600,450,0.5714285714285714,15,6,9,307.3334588457131,0.4219766260162601,0.04606701654072953,0.16838317892516347,128722.74900990506,-287.8384629314496,128434.91054697361,1912,1,332.8536585365854,41,0,17,38.50765389252778,0.5988313008130082,46.3045634920635,1014.7817460317474,24.750774293457255,0
1937,4,0,0,41,0.0,0.0,1.0,41,650,500,150,0.7692307692307693,8,5,3,308.61954187479074,0.4216717479674797,0.049457464863937206,0.1694096111836301,128798.2646762411,-250.06771227006845,128548.19696397103,1913,2,333.8536585365854,41,0,17,38.39832551472506,0.5995934959349594,46.23015873015874,1015.079365079367,24.758033294618706,0
1938,4,0,0,41,0.0,0.0,1.0,41,900,800,100,0.8888888888888888,10,8,2,309.83017792191254,0.4215193089430895,0.05024366413669057,0.17039827356425458,128873.80248685139,-214.2013692050739,128659.60111764632,1914,3,334.8536585365854,41,0,17,38.290893177006986,0.6003556910569106,46.155753968253975,1015.3769841269855,24.76529229578013,0
1939,4,1,0,42,0.023809523809523808,0.0,1.0,42,750,500,250,0.6666666666666666,10,5,5,303.56279210942137,0.4231997677119628,0.05406963548050281,0.16812955064560922,129152.13647767593,-558.8433687879071,128593.29310888803,1915,0,327.85714285714283,42,0,18,38.1676993962504,0.6016865079365079,45.88178294573645,1016.4728682170568,24.20173495754897,0
1940,4,0,0,42,0.0,0.0,1.0,42,1250,800,450,0.64,17,8,9,302.22061224762314,0.42317557104142467,0.053985900972443046,0.16823942225771601,129352.72285997732,-581.3787908123384,128771.34406916499,1916,1,328.85714285714283,41,1,21,37.99858591769066,0.6051829268292683,45.68452380952381,1017.2619047619047,24.811265969802555,0
1941,4,1,1,42,0.023255813953488372,0.023255813953488372,0.9767441860465116,43,1200,900,300,0.75,15,9,6,296.9530174243913,0.4258720930232558,0.06322218042617211,0.16654088650642213,129645.08311549778,-900.3002749233918,128744.7828405744,1917,0,322.1860465116279,42,1,15,37.8367824294323,0.6066468253968254,45.39728682170542,1018.4108527131776,24.247877445551847,0
1942,4,1,3,40,0.023255813953488372,0.06976744186046512,0.9302325581395349,43,1050,800,250,0.7619047619047619,13,8,5,299.6088410841939,0.4273255813953489,0.07036453864321923,0.16866630475596273,129793.15020131003,-822.5649375037563,128970.58526380626,1918,0,322.6744186046512,42,1,16,37.61946082160515,0.6081349206349207,45.251937984496124,1018.9922480620156,24.261720191952755,0
1943,4,1,0,41,0.024390243902439025,0.0,1.0,41,1600,1300,300,0.8125,19,13,6,310.9736747594771,0.42634654471544714,0.09525106316759535,0.17554175191402982,129899.73855054847,-120.92019052813782,129778.81836002033,1919,0,335.9024390243902,40,1,19,37.22211145449108,0.6122395833333334,45.14735772357723,1019.4105691056899,25.485264227642247,0
1944,4,0,0,41,0.0,0.0,1.0,41,1150,800,350,0.6956521739130435,15,8,7,309.68207557615233,0.4266514227642277,0.0964041645199234,0.17539330194595165,130029.26911891061,-146.4532107211416,129882.81590818947,1920,1,336.9024390243902,40,1,20,37.1240617111731,0.6135416666666667,45.02032520325203,1019.9186991869911,25.497967479674777,0
1945,4,0,0,41,0.0,0.0,1.0,41,1100,700,400,0.6363636363636364,15,7,8,309.0341819971116,0.42654979674796745,0.09840151588766943,0.17549226172234145,130132.94004891251,-156.89466422104226,129976.04538469148,1921,2,337.9024390243902,40,1,21,37.0358150730412,0.6145833333333333,44.918699186991866,1020.3252032520311,25.508130081300777,0
1946,4,1,0,42,0.023809523809523808,0.0,1.0,42,1550,1200,350,0.7741935483870968,19,12,7,301.30705924101176,0.428462543554007,0.10121653118071738,0.17247941682748563,130444.20070725087,-539.1837489259129,129905.01695832495,1922,0,330.8333333333333,40,2,22,36.91885528584691,0.6177083333333333,44.61382113821138,1021.5447154471537,25.538617886178844,0
1947,4,0,1,41,0.0,0.023809523809523808,0.9761904761904762,42,800,400,400,0.5,12,4,8,300.8007979499369,0.4285835269066976,0.10096791302041908,0.1726514169055118,130548.03688280791,-546.2092669707115,130001.8276158372,1923,1,331.8333333333333,40,2,14,36.82710156457173,0.61875,44.51219512195122,1021.9512195121955,25.548780487804887,0
1948,4,0,1,40,0.0,0.024390243902439025,0.975609756097561,41,1900,1600,300,0.8421052631578947,22,16,6,309.4973101316578,0.42609247967479674,0.10022570670060627,0.17779786926298735,130581.7925347221,-117.05729166667197,130464.73524305543,1924,5,340.9024390243902,39,2,14,36.570865606740064,0.6207264957264957,44.479166666666664,1022.0833333333323,26.207264957264933,0
1949,4,1,0,41,0.024390243902439025,0.0,1.0,41,1050,800,250,0.7619047619047619,13,8,5,310.7521282973016,0.42568597560975613,0.10448875508433075,0.17908292754452756,130703.86860499716,-76.69893086124614,130627.16967413592,1925,0,341.4878048780488,40,1,15,36.41568111044856,0.6203125,44.35975609756098,1022.5609756097572,25.56402439024393,0
1950,4,0,2,39,0.0,0.04878048780487805,0.9512195121951219,41,1350,1100,250,0.8148148148148148,16,11,5,311.7944594597145,0.425635162601626,0.04717924029701548,0.17919531141081746,130598.60365689447,-51.55416333886336,130547.0494935556,1926,1,342.4878048780488,37,4,15,36.49520846742473,0.6244369369369369,44.46271929824562,1022.1491228070179,27.62565196775724,6
1951,4,0,0,39,0.0,0.0,1.0,39,1050,800,250,0.7619047619047619,13,8,5,327.46860790603387,0.41930949167791276,0.05755721731248631,0.1874343666263718,130439.87509645049,742.99286265431,131182.8679591048,1927,8,360.79487179487177,35,4,23,36.25509857239972,0.6267857142857143,44.61805555555555,1021.5277777777767,29.186507936507905,0
1952,4,0,1,38,0.0,0.02564102564102564,0.9743589743589743,39,1150,900,250,0.782608695652174,14,9,5,329.0553129231131,0.41908457040035985,0.05776418620455326,0.18877383741378578,130528.56445312488,790.2235243055405,131318.78797743042,1928,9,361.79487179487177,35,4,16,36.12491505266735,0.6276785714285714,44.53124999999999,1021.8749999999991,29.196428571428545,0
1953,4,0,0,38,0.0,0.0,1.0,38,600,400,200,0.6666666666666666,8,4,4,331.767950342604,0.4185188477951636,0.04853583165742892,0.1903673854104888,130536.16780045342,1061.543367346927,131597.71116780036,1929,10,363.2105263157895,34,4,17,36.04792831624728,0.6299019607843137,44.52380952380952,1021.9047619047611,30.056022408963564,0
1954,4,0,0,38,0.0,0.0,1.0,38,800,400,400,0.5,12,4,8,333.4121185691752,0.41825213371266007,0.049462405139332866,0.1916115428403573,130597.00255102034,1108.524659863932,131705.52721088426,1930,11,364.2105263157895,34,4,17,35.944415327276936,0.6305147058823529,44.46428571428571,1022.1428571428567,30.06302521008402,0
1955,4,2,1,39,0.05,0.025,0.975,40,750,400,350,0.5333333333333333,11,4,7,316.1432274022178,0.4226896367521367,0.05340167005673946,0.18422294991666333,131131.51552641182,291.2681065327645,131422.7836329446,1931,0,346.95,37,3,20,35.8467821075545,0.6297860360360361,43.941885964912274,1024.2324561403498,27.681958274063508,0
1956,4,0,1,38,0.0,0.02564102564102564,0.9743589743589743,39,600,400,200,0.6666666666666666,8,4,4,324.33445764818504,0.4201248313090418,0.04944289300724947,0.18826310472681992,130982.06948502547,696.3996936125175,131678.46917863798,1932,1,356.0,36,3,20,35.7877246057939,0.6302083333333333,44.08783783783783,1023.6486486486478,28.43468468468466,0
1957,4,1,0,39,0.02564102564102564,0.0,1.0,39,1200,700,500,0.5833333333333334,17,7,10,321.97389882890656,0.4194781826360774,0.0543540141253922,0.18801787750612275,131212.72243527308,649.414363688002,131862.1367989611,1933,0,356.38461538461536,36,3,22,35.61565728731587,0.6325231481481481,43.86261261261261,1024.5495495495493,28.459709709709703,0
1958,4,0,0,39,0.0,0.0,1.0,39,1300,900,400,0.6923076923076923,17,9,8,322.0412182073405,0.41930949167791276,0.054536032632453546,0.18877028919009992,131357.7852393045,660.5749622988278,132018.36020160333,1934,1,357.38461538461536,35,4,22,35.4678267660231,0.6360119047619048,43.7210648148148,1025.115740740739,29.289021164021115,0
1959,4,0,0,39,0.0,0.0,1.0,39,1350,900,450,0.6666666666666666,18,9,9,319.6581361358492,0.4196749887539361,0.048062146415604134,0.18836258862856292,131559.0823086599,610.7862085057914,132169.8685171657,1935,2,358.38461538461536,36,3,17,35.326335528723035,0.6359953703703703,43.52477477477477,1025.9009009009,28.497247247247223,0
1960,4,0,0,39,0.0,0.0,1.0,39,1000,900,100,0.9,11,9,2,318.9252602093083,0.4192251461988304,0.044967470340604665,0.18821547739813577,131616.85333982625,595.1878398668864,132212.04117969313,1936,3,359.38461538461536,36,3,17,35.28702992390987,0.6365740740740741,43.468468468468465,1026.1261261261257,28.50350350350349,0
1961,4,0,0,39,0.0,0.0,1.0,39,1300,800,500,0.6153846153846154,18,8,10,320.31689071729375,0.4183816914080072,0.05127080028352515,0.1896109594661591,131732.4334469605,639.2246976706456,132371.65814463113,1937,4,360.38461538461536,36,3,17,35.13511042855052,0.6377314814814814,43.35585585585586,1026.5765765765768,28.516016016016025,0
1962,4,0,1,38,0.0,0.02564102564102564,0.9743589743589743,39,1050,700,350,0.6666666666666666,14,7,7,319.65770247074886,0.4176506972559604,0.05093912153767466,0.19008589060874653,131905.89871966562,632.9473054135235,132538.84602507914,1938,5,361.38461538461536,36,3,17,34.97770956661551,0.6394675925925926,43.18693693693694,1027.2522522522524,28.53478478478479,0
1963,4,0,0,38,0.0,0.0,1.0,38,650,300,350,0.46153846153846156,10,3,7,328.55053076171805,0.41573316737790417,0.05283318706861806,0.195456736664947,131921.96609224967,1068.6063957476017,132990.57248799727,1939,6,370.05263157894734,35,3,18,34.7331756046267,0.6416666666666666,43.1712962962963,1027.314814814815,29.35185185185186,0
1964,4,0,0,38,0.0,0.0,1.0,38,800,500,300,0.625,11,5,6,329.206524466852,0.41534791370317686,0.05165670058492666,0.19661621679825933,132070.63567654768,1095.7029910408314,133166.3386675885,1940,7,371.05263157894734,35,3,19,34.566889051533224,0.643154761904762,43.02662037037038,1027.89351851852,29.368386243386286,0
1965,4,0,2,36,0.0,0.05263157894736842,0.9473684210526316,38,1300,1000,300,0.7692307692307693,16,10,6,332.7672782542351,0.4149033902323376,0.046664850491254795,0.1996828360462789,132249.1496940373,1201.6379190243508,133450.78761306166,1941,8,372.05263157894734,35,3,20,34.29599883725288,0.6449404761904762,42.85300925925926,1028.5879629629637,29.388227513227534,0
1966,4,0,0,36,0.0,0.0,1.0,36,900,500,400,0.5555555555555556,13,5,8,349.9070625556237,0.4094907407407407,0.05760003711214501,0.20818104367663526,131925.46323829764,2032.3302636005185,133957.79350189815,1942,9,393.1666666666667,33,3,20,34.181155314326595,0.6461489898989898,43.167892156862735,1027.328431372548,31.13116458704691,0
1967,4,2,1,37,0.05263157894736842,0.02631578947368421,0.9736842105263158,38,1450,1200,250,0.8275862068965517,17,12,5,338.68326626673195,0.4141328828828829,0.0878513403256509,0.2056588292159921,132695.96220207453,1388.3803798010686,134084.3425818756,1943,0,373.42105263157896,35,3,18,33.69514341346513,0.6494047619047619,42.41898148148147,1030.3240740740723,29.437830687830637,0
1968,4,0,1,36,0.0,0.02702702702702703,0.972972972972973,37,1050,600,450,0.5714285714285714,15,6,9,344.24688573032574,0.41203703703703703,0.09179944909087512,0.20891392350001645,132673.81660997713,1734.5096371881802,134408.3262471653,1944,1,383.8378378378378,34,3,19,33.574069794314745,0.6513480392156863,42.440476190476176,1030.2380952380936,30.301120448179223,0
1969,4,0,0,36,0.0,0.0,1.0,36,1050,600,450,0.5714285714285714,15,6,9,351.0260718576213,0.41124338624338624,0.0845623215984781,0.2132534112846009,132713.49961553232,2117.1796905036335,134830.67930603595,1945,2,392.19444444444446,33,3,20,33.35959800190295,0.654040404040404,42.401960784313715,1030.3921568627436,31.224004753416473,0
1970,4,0,0,36,0.0,0.0,1.0,36,950,800,150,0.8421052631578947,11,8,3,352.66169340044166,0.40987103174603173,0.09123776694797736,0.2151517640738154,132871.3884833957,2171.729773404448,135043.11825680017,1946,3,393.19444444444446,33,3,21,33.15887614406276,0.6556186868686869,42.248774509803916,1031.0049019607836,31.242572786690413,0
1971,4,0,0,36,0.0,0.0,1.0,36,1200,800,400,0.6666666666666666,16,8,8,352.66169340044166,0.40987103174603173,0.09123776694797736,0.2151517640738154,132871.3884833957,2171.729773404448,135043.11825680017,1947,4,394.19444444444446,33,3,21,33.15887614406276,0.6556186868686869,42.248774509803916,1031.0049019607836,31.242572786690413,0
1972,4,0,0,36,0.0,0.0,1.0,36,1100,700,400,0.6363636363636364,15,7,8,370.8809277448053,0.4094907407407407,0.12699176558656844,0.20829474806856899,129700.23548635133,2422.024131343703,132122.25961769503,1948,5,395.19444444444446,33,3,16,35.89839990375361,0.6237373737373737,45.343137254901954,1018.6274509803916,30.867498514557322,8
1973,4,0,0,36,0.0,0.0,1.0,36,600,500,100,0.8333333333333334,7,5,2,369.060015640617,0.40962301587301586,0.1271870029538742,0.20743718120489857,129731.44531250003,2375.737847222224,132107.18315972225,1949,6,396.19444444444446,33,3,16,35.913002726653026,0.6240530303030303,45.3125,1018.7500000000002,30.871212121212128,0
1974,4,0,0,36,0.0,0.0,1.0,36,950,500,450,0.5263157894736842,14,5,9,365.83148530685264,0.4096891534391534,0.13202292217680545,0.20644411769215731,129887.55076172623,2303.391123606301,132190.94188533255,1950,7,397.19444444444446,33,3,17,35.836439047848046,0.6256313131313131,45.15931372549019,1019.362745098039,30.88978015448603,0
1975,4,0,0,36,0.0,0.0,1.0,36,1450,1100,350,0.7586206896551724,18,11,7,368.7743920475891,0.40925925925925927,0.13999679641198148,0.2091061334743957,130075.00120146081,2393.6658977316147,132468.66709919242,1951,8,398.19444444444446,33,3,18,35.57083934006085,0.6275252525252526,44.97549019607842,1020.0980392156849,30.912061794414694,0
1976,4,1,0,37,0.02702702702702703,0.0,1.0,37,750,600,150,0.8,9,6,3,364.4113996076647,0.41169294294294295,0.14230204645540168,0.19910857270333968,128613.7099194099,1979.6677129759887,130593.37763238589,1952,0,388.4054054054054,35,2,18,37.171002586338055,0.6083333333333334,46.412037037037024,1014.3518518518498,28.981481481481424,8
1977,4,1,1,37,0.02631578947368421,0.02631578947368421,0.9736842105263158,38,1150,900,250,0.782608695652174,14,9,5,358.7485092406058,0.41288821716453294,0.13941123600751726,0.19750879464784984,128915.32368517148,1649.6360380650744,130564.95972323655,1953,0,379.1578947368421,36,2,19,37.00677349005693,0.609375,46.114864864864856,1015.540540540539,28.209459459459417,0
1978,4,0,0,37,0.0,0.0,1.0,37,650,400,250,0.6153846153846154,9,4,5,361.9829059829062,0.41369494494494496,0.14103950103950158,0.19939736346515996,128936.76757812487,1934.5811631944296,130871.34874131929,1954,1,387.13513513513516,35,2,19,36.90277777777778,0.6116071428571428,46.09374999999999,1015.624999999999,29.017857142857114,0
1979,4,0,0,37,0.0,0.0,1.0,37,900,700,200,0.7777777777777778,11,7,4,363.467060849129,0.4132882882882883,0.14103199701923685,0.20051228114851058,128995.54887099187,1977.126602151913,130972.67547314378,1955,2,388.13513513513516,35,2,19,36.80512039041435,0.6122023809523809,46.035879629629626,1015.8564814814808,29.02447089947088,0
1980,4,1,0,38,0.02631578947368421,0.0,1.0,38,1000,700,300,0.7,13,7,6,351.9502894871036,0.41500711237553345,0.14302606134264084,0.1961949901636733,129407.39300679433,1509.1579861110977,130916.55099290542,1956,0,378.89473684210526,35,3,20,36.67825522314487,0.6163690476190475,45.63078703703703,1017.4768518518512,29.070767195767175,0
1981,4,0,0,38,0.0,0.0,1.0,38,1550,1200,350,0.7741935483870968,19,12,7,354.5995078991144,0.41500711237553345,0.14232668082941813,0.19826463267467953,129525.18332315236,1585.913253386476,131111.09657653884,1957,1,379.89473684210526,35,3,15,36.49102236119005,0.6175595238095238,45.51504629629629,1017.9398148148143,29.083994708994695,0
1982,4,0,0,38,0.0,0.0,1.0,38,750,300,450,0.4,12,3,9,352.68296082366805,0.4145329540066382,0.14165415243234847,0.1974889883109998,129584.09857521,1540.4207122342198,131124.51928744421,1958,2,380.89473684210526,35,3,16,36.47988424083969,0.6181547619047619,45.457175925925924,1018.1712962962958,29.090608465608454,0
1983,4,0,0,38,0.0,0.0,1.0,38,750,400,350,0.5333333333333333,11,4,7,353.3853015117772,0.414695945945946,0.14476376209904163,0.19803082055417914,129613.56122470836,1560.7054826817398,131174.2667073901,1959,3,381.89473684210526,35,3,16,36.43204895051906,0.618452380952381,45.42824074074073,1018.2870370370359,29.093915343915313,0
1984,4,0,0,38,0.0,0.0,1.0,38,1000,700,300,0.7,13,7,6,353.3006035310615,0.4138365339023234,0.1416438552661463,0.19917830439785683,129849.38298396753,1575.173075274319,131424.55605924185,1960,4,382.89473684210526,35,3,17,36.194545385721845,0.6208333333333333,45.196759259259245,1019.212962962961,29.120370370370313,0
1985,4,1,2,37,0.02564102564102564,0.05128205128205128,0.9487179487179487,39,1300,900,400,0.6923076923076923,17,9,8,346.80128909728114,0.4161043634727845,0.13544141942200172,0.19745018117950736,130233.84871357847,1233.0533235938635,131466.90203717232,1961,0,374.05128205128204,36,3,19,35.970138275963514,0.6226851851851851,44.81981981981982,1020.7207207207209,28.35335335335336,0
1986,4,0,0,37,0.0,0.0,1.0,37,850,600,250,0.7058823529411765,11,6,5,362.37997013506254,0.41266266266266266,0.14941252262478244,0.2049144760519831,129967.37423911164,2019.514639060342,131986.88887817197,1962,1,394.2972972972973,35,2,19,35.84326522890655,0.6220238095238095,45.08101851851851,1019.6759259259246,29.133597883597847,0
1987,4,0,0,37,0.0,0.0,1.0,37,1000,700,300,0.7,13,7,6,360.0679957525893,0.4125375375375375,0.14862564822850755,0.2040694049239594,130055.90284475726,1965.7936546210385,132021.6964993783,1963,2,395.2972972972973,35,2,20,35.81227069858919,0.6229166666666667,44.994212962962955,1020.0231481481472,29.143518518518494,0
1988,4,0,0,37,0.0,0.0,1.0,37,800,400,400,0.5,12,4,8,360.341369099575,0.41197447447447444,0.1458527493010251,0.20468875708645937,130144.4615912207,1979.286694101488,132123.7482853222,1964,3,396.2972972972973,35,2,20,35.71536600120992,0.6238095238095238,44.9074074074074,1020.3703703703691,29.153439153439116,0
1989,4,0,0,37,0.0,0.0,1.0,37,800,500,300,0.625,11,5,6,358.36459177682536,0.41225600600600604,0.1465062249820699,0.20387477227664805,130203.51750042858,1932.0660793895613,132135.58357981814,1965,4,397.2972972972973,35,2,20,35.70584788689802,0.6244047619047619,44.84953703703703,1020.6018518518512,29.16005291005289,0
1990,4,1,1,37,0.02631578947368421,0.02631578947368421,0.9736842105263158,38,1100,600,500,0.5454545454545454,16,6,10,347.86686592527883,0.41642958748221903,0.14281671006453078,0.20017641867869634,130646.8638144076,1489.5564075360085,132136.4202219436,1966,0,387.8157894736842,35,3,17,35.524571681950256,0.6288690476190476,44.41550925925926,1022.3379629629632,29.20965608465609,0
1991,4,0,1,36,0.0,0.02702702702702703,0.972972972972973,37,900,500,400,0.5555555555555556,13,5,8,358.35756654565046,0.41025400400400397,0.13864534307166854,0.2057859336986228,130566.58340419513,1957.9046201814235,132524.48802437657,1967,6,399.2972972972973,34,3,17,35.337798485730936,0.6302083333333333,44.49404761904763,1022.0238095238104,30.059523809523835,0
1992,4,1,0,37,0.02702702702702703,0.0,1.0,37,1250,1100,150,0.88,14,11,3,360.72526177605044,0.415477977977978,0.13903282311833354,0.20885213093399235,130883.62328800156,2042.6058545524718,132926.22914255402,1968,0,396.4864864864865,35,2,19,34.95609942314218,0.63125,44.18402777777778,1023.263888888889,29.236111111111114,0
1993,4,0,1,36,0.0,0.02702702702702703,0.972972972972973,37,1350,1100,250,0.8148148148148148,16,11,5,361.34629854943404,0.415477977977978,0.14384279182561488,0.21050384436233954,131120.59709630033,2075.988484867944,133196.58558116827,1969,1,397.4864864864865,35,2,19,34.70036633141221,0.6336309523809525,43.95254629629628,1024.189814814813,29.262566137566086,0
1994,4,1,0,37,0.02702702702702703,0.0,1.0,37,850,600,250,0.7058823529411765,11,6,5,359.60328903131466,0.4157282282282282,0.14613890890438586,0.20997416322593634,131209.51753257873,2036.6748113854442,133246.19234396418,1970,0,398.2432432432432,35,2,20,34.65506853441783,0.6345238095238095,43.86574074074073,1024.537037037036,29.272486772486744,0
1995,4,0,0,37,0.0,0.0,1.0,37,1250,1000,250,0.8,15,10,5,358.6157779063716,0.4157595095095095,0.14700944450210307,0.2097215388099745,131268.81456832995,2015.0136102537797,133283.82817858373,1971,1,399.2432432432432,35,2,20,34.62041638430842,0.6351190476190476,43.807870370370374,1024.768518518519,29.279100529100543,0
1996,4,0,0,37,0.0,0.0,1.0,37,750,500,250,0.6666666666666666,10,5,5,360.23530967016995,0.4154466966966967,0.15007690617446734,0.21099496709252807,131328.125,2061.805555555556,133389.93055555556,1972,2,400.2432432432432,35,2,20,34.518970189701896,0.6357142857142857,43.75,1025.0,29.285714285714285,0
1997,4,0,0,37,0.0,0.0,1.0,37,1150,700,450,0.6086956521739131,16,7,9,357.41328618235036,0.41516516516516516,0.14698310048197216,0.20999215620527975,131446.78605109712,1996.1655521261719,133442.9516032233,1973,3,401.2432432432432,35,2,20,34.47140707298722,0.6369047619047619,43.634259259259245,1025.4629629629608,29.298941798941737,0
1998,4,1,1,37,0.02631578947368421,0.02631578947368421,0.9736842105263158,38,1300,1000,300,0.7692307692307693,16,10,6,367.8141331550481,0.41745199146514933,0.182588220190125,0.20264603951896024,128943.91593874285,1885.4789333252234,130829.39487206808,1974,0,391.6578947368421,36,2,17,36.747422108881246,0.6096643518518519,46.086711711711715,1015.6531531531535,28.2125875875876,8
1999,4,1,0,38,0.02631578947368421,0.0,1.0,38,750,600,150,0.8,9,6,3,370.30532910457083,0.4181632290184922,0.19781299376723593,0.20520234535463264,129172.76810171679,1966.6728806509452,131139.44098236773,1975,0,392.5263157894737,36,2,18,36.45060189800968,0.6119791666666667,45.8614864864865,1016.5540540540558,28.23761261261266,0
2000,4,0,0,38,0.0,0.0,1.0,38,750,400,350,0.5333333333333333,11,4,7,371.2039774254229,0.41751126126126126,0.19434857635892966,0.20584947839046205,129201.38888888907,1992.0138888889087,131193.40277777798,1976,1,393.5263157894737,36,2,18,36.39856557377048,0.6122685185185186,45.83333333333334,1016.6666666666681,28.24074074074078,0
2001,4,3,1,40,0.07317073170731707,0.024390243902439025,0.975609756097561,41,900,500,400,0.5555555555555556,13,5,8,358.3183663291325,0.4229420731707317,0.2177503370511087,0.20372958542713587,130180.80210387938,1129.2344674556598,131310.03657133505,1977,0,365.6585365853659,38,3,18,35.73008270519264,0.618421052631579,44.87179487179489,1020.5128205128234,26.855600539811142,0
2002,4,0,0,40,0.0,0.0,1.0,40,1100,700,400,0.6363636363636364,15,7,8,368.2085489621084,0.4203525641025641,0.2235384202041908,0.20904091202516317,130122.70752779728,1582.4586651662341,131705.16619296352,1978,1,375.8,37,3,19,35.536785778255435,0.6196509009009009,44.92872807017545,1020.2850877193003,27.57527264106217,0
2003,4,2,1,41,0.047619047619047616,0.023809523809523808,0.9761904761904762,42,1350,1000,350,0.7407407407407407,17,10,7,354.26721061426605,0.4258009097948123,0.21877441649493146,0.20426035171988272,130722.82745160718,862.3877189181669,131585.21517052536,1979,0,358.85714285714283,36,6,18,35.284063796204535,0.6276041666666667,44.341216216216225,1022.6351351351365,28.40653153153157,0
2004,4,0,0,41,0.0,0.0,1.0,41,1200,800,400,0.6666666666666666,16,8,8,364.47758910323216,0.4242378048780488,0.2294168486799777,0.20973488889569059,130646.8638144076,1323.5707893947192,131970.4346038023,1980,1,368.609756097561,35,6,18,35.100027359523004,0.6288690476190476,44.41550925925926,1022.3379629629632,29.20965608465609,0
2005,4,1,0,42,0.023809523809523808,0.0,1.0,42,800,700,100,0.875,9,7,2,355.5428008912175,0.427204316686024,0.2275631212622209,0.20582663882858848,130878.94833025569,906.613573407227,131785.56190366292,1981,0,360.8095238095238,37,5,19,35.093406200885845,0.6272522522522522,44.18859649122808,1023.2456140350896,27.65528686581323,0
2006,4,0,0,42,0.0,0.0,1.0,42,1150,900,250,0.782608695652174,14,9,5,351.3043703194802,0.42702284165698795,0.21766436123698218,0.2043022503120088,131054.49631090685,808.0034608079778,131862.49977171482,1982,1,361.8095238095238,38,4,19,35.02430265720644,0.6271929824561404,44.01709401709403,1023.9316239316262,26.94556905083227,0
2007,4,0,0,42,0.0,0.0,1.0,42,1000,500,500,0.5,15,5,10,356.5931033443633,0.42627274487030586,0.22788477292699993,0.2084146529052889,131246.00643080223,960.284146942814,132206.29057774504,1983,2,362.8095238095238,38,4,20,34.69528724846211,0.6291118421052632,43.83012820512821,1024.6794871794882,26.96524966261811,0
2008,4,1,1,42,0.023255813953488372,0.023255813953488372,0.9767441860465116,43,1100,800,300,0.7272727272727273,14,8,6,350.0475207927243,0.4275793650793651,0.23020162594715043,0.20632064825179786,131568.46923828125,611.0432942708335,132179.5125325521,1984,0,355.3488372093023,39,4,16,34.537453040917846,0.6306089743589743,43.515625,1025.9375,26.306089743589745,0
2009,4,0,0,42,0.0,0.0,1.0,42,1100,800,300,0.7272727272727273,14,8,6,356.8174952750499,0.4249903213317847,0.2353813790571453,0.20959206362606664,131437.65637555695,979.8510665497832,132417.50744210673,1985,4,364.8095238095238,38,4,20,34.495901924011946,0.6310307017543859,43.64316239316239,1025.42735042735,26.984930274403943,0
2010,4,2,1,43,0.045454545454545456,0.022727272727272728,0.9772727272727273,44,1250,600,650,0.48,19,6,13,346.29246439511604,0.42932963354474984,0.24643916913946629,0.20618473586776317,131953.86860499685,338.9260691387267,132292.79467413557,1986,0,349.1818181818182,40,4,20,34.24538410814376,0.6328125,43.14024390243902,1027.4390243902426,25.685975609756063,0
2011,4,0,0,43,0.0,0.0,1.0,43,1200,900,300,0.75,15,9,6,346.1412277360033,0.4295404208194906,0.23875686160822673,0.20661678730012983,132049.81689453128,541.577148437501,132591.39404296878,1987,1,342.5581395348837,39,4,20,34.15266798418972,0.6354166666666667,43.046875,1027.8125000000002,26.35416666666667,0
2012,4,0,0,43,0.0,0.0,1.0,43,1100,900,200,0.8181818181818182,13,9,4,350.1483937672579,0.42861757105943155,0.2445476151778756,0.20989769834026295,132210.461425781,658.6561414930268,132869.11756727402,1988,2,343.5581395348837,39,4,20,33.887981532124634,0.6370192307692308,42.890624999999986,1028.437499999998,26.370192307692257,0
2013,4,0,1,42,0.0,0.023255813953488372,0.9767441860465116,43,1050,600,450,0.5714285714285714,15,6,9,349.6644768466597,0.4282945736434109,0.24440388578157224,0.20990496710399742,132264.03130425315,649.6066623263557,132913.6379665795,1989,3,344.5581395348837,39,4,20,33.84651898734176,0.6375534188034189,42.83854166666665,1028.6458333333308,26.375534188034123,0
2014,4,0,0,42,0.0,0.0,1.0,42,800,400,400,0.5,12,4,8,354.6872376415579,0.4255589430894309,0.24296401852511695,0.21228295864815544,132150.72320841497,974.4349934253198,133125.1582018403,1990,4,353.57142857142856,38,4,20,33.83143703241895,0.638157894736842,42.94871794871792,1028.2051282051239,27.05802968960852,0
2015,4,0,0,42,0.0,0.0,1.0,42,1200,1000,200,0.8333333333333334,14,10,4,351.9317553206982,0.42567992644212155,0.23637442515947216,0.21155448213098083,132315.5510355025,913.2088264299264,133228.75986193243,1991,5,354.57142857142856,38,4,22,33.736370716510876,0.6398026315789473,42.78846153846151,1028.84615384615,27.074898785425,0
2016,4,0,0,42,0.0,0.0,1.0,42,1050,700,350,0.6666666666666666,14,7,7,352.57093215755106,0.4255710414247,0.24011952959321436,0.2124024883973534,132398.00347222187,935.9631821169896,133333.96665433887,1992,6,355.57142857142856,37,5,22,33.636977058029686,0.642454954954955,42.708333333333314,1029.1666666666638,27.81531531531524,0
2017,4,0,0,42,0.0,0.0,1.0,42,1050,600,450,0.5714285714285714,15,6,9,350.4370344618224,0.425038714672861,0.2073468415243147,0.19871626395394515,130076.56385633703,721.06933593752,130797.63319227454,1993,7,356.57142857142856,39,3,16,36.036901358112935,0.6156517094017093,44.97395833333334,1020.1041666666684,26.15651709401714,8
2018,4,0,0,42,0.0,0.0,1.0,42,1300,800,500,0.6153846153846154,18,8,10,336.3935653670516,0.42538956639566394,0.16735887337391087,0.18306196478648884,128453.40617563952,242.44569940697474,128695.8518750465,1994,8,357.57142857142856,40,2,16,38.04490392648287,0.59765625,46.57012195121951,1013.7195121951221,25.342987804878053,8
2019,4,0,0,42,0.0,0.0,1.0,42,1050,700,350,0.6666666666666666,14,7,7,336.7642339935723,0.42563153310104535,0.1661368767212208,0.18350064241146236,128504.9214773781,255.17228914669428,128760.09376652479,1995,9,358.57142857142856,40,2,16,37.982985867495245,0.5981770833333333,46.51930894308944,1013.922764227644,25.348069105691103,0
2020,4,2,1,43,0.045454545454545456,0.022727272727272728,0.9772727272727273,44,1400,800,600,0.5714285714285714,20,8,12,326.07876583172873,0.43056289640591966,0.18746425166825587,0.1806001189849438,129152.1364776757,-377.2461465657004,128774.89033111,1996,0,343.22727272727275,42,2,18,37.5955274864951,0.6016865079365079,45.88178294573644,1016.4728682170548,24.201734957548926,0
2021,4,2,0,45,0.044444444444444446,0.0,1.0,45,1350,900,450,0.6666666666666666,18,9,9,317.3837583721429,0.43493265993265995,0.19051899555018936,0.16867164656162326,127502.23597891458,-856.7728815872915,126645.46309732729,1997,0,336.0888888888889,40,5,16,39.49654524719933,0.5880208333333333,47.510162601626014,1009.9593495934953,25.24898373983738,8
2022,4,0,1,44,0.0,0.022222222222222223,0.9777777777777777,45,1200,800,400,0.6666666666666666,16,8,8,317.3736584496919,0.4349537037037037,0.1891526939414261,0.16888084395021097,127553.5602154804,-903.571989225971,126649.98822625443,1998,1,337.0888888888889,40,5,16,39.444374580818234,0.5885416666666667,47.45934959349594,1010.1626016260178,25.254065040650445,0
2023,4,1,2,43,0.022222222222222223,0.044444444444444446,0.9555555555555556,45,1400,1100,300,0.7857142857142857,17,11,6,325.18466596964436,0.4378577441077441,0.1673739267739074,0.16786022517933774,126317.93986402405,-783.3027260790863,125534.63713794497,1999,0,331.8,41,4,15,40.513154215599194,0.5744410569105691,48.68551587301586,1005.2579365079343,24.51848625629108,8
2024,4,3,0,46,0.06521739130434782,0.0,1.0,46,1200,900,300,0.75,15,9,6,320.9522423386813,0.4377616747181965,0.2065123300617655,0.16793862423730585,126872.2688408899,-1056.0121649840814,125816.25667590581,2000,0,325.17391304347825,42,4,19,40.05101631880993,0.5786210317460317,48.13468992248062,1007.461240310077,23.987172388335164,0
2025,4,1,3,44,0.02127659574468085,0.06382978723404255,0.9361702127659575,47,1100,900,200,0.8181818181818182,13,9,4,315.3735985166645,0.43954286154794947,0.21251069688226432,0.16642626483217215,127217.08598080419,-1375.4376871653815,125841.6482936388,2001,0,319.2340425531915,41,6,21,39.83870505129969,0.5835873983739837,47.79265873015872,1008.8293650793637,24.605594270228384,0
2026,4,2,2,44,0.043478260869565216,0.043478260869565216,0.9565217391304348,46,1450,1100,350,0.7586206896551724,18,11,7,292.29059599906583,0.4397644927536232,0.13114021906097695,0.15470014471170043,127336.39805300137,-1637.396381137009,125699.00167186436,2002,0,315.89130434782606,42,4,12,40.299179147465445,0.5833333333333333,47.67441860465115,1009.3023255813932,24.031007751937935,8
2027,4,1,2,43,0.022222222222222223,0.044444444444444446,0.9555555555555556,45,900,500,400,0.5555555555555556,13,5,8,299.17091269134943,0.4390782828282828,0.15083857442348036,0.15856058372641496,127392.29024943284,-1377.5864512471924,126014.70379818566,2003,0,323.84444444444443,41,4,14,40.06854363207548,0.5853658536585367,47.619047619047606,1009.5238095238074,24.622531939605057,0
2028,4,0,0,43,0.0,0.0,1.0,43,1300,1100,200,0.8461538461538461,15,11,4,314.5923799778752,0.43429309708379477,0.16531385865977288,0.16625512192284042,127275.89111328076,-591.9949001736543,126683.8962131071,2004,2,339.74418604651163,39,4,20,39.7982906644644,0.5873397435897436,47.73437499999998,1009.0624999999959,25.87339743589733,0
2029,4,0,0,43,0.0,0.0,1.0,43,1000,700,300,0.7,13,7,6,313.0600235370914,0.4338547434477667,0.1647694674650435,0.16563660595348154,127322.68248273157,-628.071605030105,126694.61087770147,2005,3,340.74418604651163,40,3,15,39.789128318732566,0.5861979166666667,47.688008130081286,1009.2479674796726,25.231199186991816,0
2030,4,1,1,43,0.022727272727272728,0.022727272727272728,0.9772727272727273,44,1100,500,600,0.45454545454545453,17,5,12,309.53342544372464,0.434736169837914,0.17286785379568936,0.16497111136286358,127617.7300347217,-899.6093750000557,126718.12065972164,2006,0,333.97727272727275,41,3,17,39.576890034364276,0.5876524390243902,47.39583333333331,1010.4166666666624,24.644308943089328,0
2031,4,2,0,45,0.044444444444444446,0.0,1.0,45,850,500,350,0.5882352941176471,12,5,7,307.7105454791784,0.43760521885521886,0.19515317786922726,0.1661636945587562,128144.53124999985,-1110.460069444461,127034.07118055539,2007,0,313.3333333333333,39,6,19,39.08607681755831,0.5961538461538461,46.87499999999999,1012.4999999999989,25.96153846153843,0
2032,4,3,1,47,0.0625,0.020833333333333332,0.9791666666666666,48,1300,900,400,0.6923076923076923,17,9,8,287.1072023013352,0.4411384456264775,0.11904288654008033,0.1549451337609073,128120.56220048496,-2065.1813769800274,126055.38082350494,2008,0,294.6875,43,5,17,39.6319528887226,0.5898740310077519,46.89867424242424,1012.405303030303,23.544309372797745,8
2033,4,1,2,46,0.020833333333333332,0.041666666666666664,0.9583333333333334,48,1550,1200,350,0.7741935483870968,19,12,7,290.5885593198072,0.44047355200945626,0.14664049505919197,0.15840563545641329,128521.48216057254,-2130.6210477045524,126390.86111286799,2009,0,295.625,41,7,14,39.13664269640936,0.5967987804878049,46.50297619047619,1013.9880952380952,24.731416957026713,0
2034,4,1,3,44,0.02127659574468085,0.06382978723404255,0.9361702127659575,47,1200,700,500,0.5833333333333334,17,7,10,294.84782552609624,0.44156645081714463,0.1637486741124352,0.1616448689781333,128747.91843820874,-1807.7912414965806,126940.12719671216,1533,0,256.4255319148936,41,6,15,38.79887585532747,0.5990853658536586,46.27976190476191,1014.8809523809534,24.75319396051106,0
2035,4,0,0,44,0.0,0.0,1.0,44,1200,900,300,0.75,15,9,6,317.5175224063519,0.43646494009866105,0.1654611601622038,0.172156584618607,128306.84222961873,-652.0658694937492,127654.77636012499,1534,1,274.6363636363636,38,6,17,38.672492881999354,0.5995065789473684,46.71474358974359,1013.1410256410261,26.66160593792174,0
2036,4,0,0,44,0.0,0.0,1.0,44,800,500,300,0.625,11,5,6,319.1748192387241,0.43600246652572233,0.16842241478470954,0.17317242480892792,128333.90404704504,-607.809874716927,127726.09417232811,1535,2,275.6363636363636,38,6,17,38.60295409813018,0.5997807017543859,46.68803418803419,1013.2478632478629,26.66441745389113,0
2037,4,0,0,44,0.0,0.0,1.0,44,1600,900,700,0.5625,23,9,14,341.9043829740848,0.43559504933051446,0.18677998511694516,0.17654998395307073,126331.65283203125,-95.05670789787905,126236.59612413337,1536,3,276.6363636363636,39,5,15,40.07885624978413,0.577724358974359,48.671875,1005.3125,25.77724358974359,8
2038,4,3,1,46,0.06382978723404255,0.02127659574468085,0.9787234042553191,47,1100,900,200,0.8181818181818182,13,9,4,330.0934813318924,0.44226025285229725,0.21130988899523118,0.17344912019075803,127043.16522444566,-1012.7758623279849,126030.38936211768,1537,0,259.9148936170213,42,5,18,39.6456090606177,0.5803571428571428,47.96511627906977,1008.1395348837211,24.00332225913622,0
2039,4,0,1,45,0.0,0.021739130434782608,0.9782608695652174,46,1650,1000,650,0.6060606060606061,23,10,13,335.09816359511217,0.4414049919484702,0.2177708016149964,0.17640485708343012,127118.27392578125,-680.5611906985204,126437.71273508274,1538,1,265.7608695652174,39,7,18,39.44248614123885,0.5857371794871795,47.890625,1008.4375,25.857371794871796,0
2040,4,1,0,46,0.021739130434782608,0.0,1.0,46,1200,700,500,0.5833333333333334,17,7,10,328.9227385139366,0.442914653784219,0.22700673101735003,0.17513770452956878,127579.22620670585,-807.2583077202507,126771.9678989856,1539,0,265.17391304347825,40,6,15,39.12647117996178,0.5888020833333334,47.433943089430905,1010.2642276422779,25.256605691056947,0
2041,4,1,4,43,0.02127659574468085,0.0851063829787234,0.9148936170212766,47,1100,700,400,0.6363636363636364,15,7,8,319.73015056327887,0.44495837187789083,0.22491089538659237,0.17157729553385212,127893.53820231791,-1221.7159549004919,126671.82224741743,1540,0,260.51063829787233,41,6,17,39.03777625212499,0.5904471544715447,47.123015873015866,1011.507936507936,24.670925280681367,0
2042,4,1,1,43,0.022727272727272728,0.022727272727272728,0.9772727272727273,44,1550,1400,150,0.9032258064516129,17,14,3,334.5109570880392,0.4446353065539112,0.22498126477200708,0.17882162011113154,127739.20323800134,-253.9673734385188,127485.23586456283,1541,0,271.52272727272725,38,6,18,38.82173430564364,0.59375,47.27564102564103,1010.8974358974361,26.60256410256411,0
2043,4,2,1,44,0.044444444444444446,0.022222222222222223,0.9777777777777777,45,1050,600,450,0.5714285714285714,15,6,9,329.8953518656022,0.4460016835016835,0.2295030984884865,0.17790915812596705,128091.8023003474,-548.621961805537,127543.18033854186,1542,0,266.0444444444444,39,6,20,38.57832544419291,0.5956196581196581,46.92708333333334,1012.2916666666681,25.956196581196618,0
2044,4,0,1,43,0.0,0.022727272727272728,0.9772727272727273,44,850,400,450,0.47058823529411764,13,4,9,336.62672021948015,0.44508676885130377,0.22987849355036838,0.18116638033630236,128009.35057345335,-181.72643180653915,127827.62414164681,1543,1,272.84090909090907,38,6,21,38.492178702139626,0.5964912280701755,47.00854700854702,1011.9658119658137,26.630679262258255,0
2045,4,2,2,43,0.044444444444444446,0.044444444444444446,0.9555555555555556,45,1450,1300,150,0.896551724137931,16,13,3,334.6172281431215,0.4468434343434344,0.23865776408149264,0.18249292526461022,128540.34423828142,-397.6372612847099,128142.70697699672,1544,0,266.31111111111113,39,6,16,38.00130542715289,0.6001602564102564,46.48437500000001,1014.0625000000014,26.001602564102598,0
2046,4,1,2,42,0.022727272727272728,0.045454545454545456,0.9545454545454546,44,1200,700,500,0.5833333333333334,17,7,10,348.1703884406079,0.44339103241719524,0.25249066002490617,0.18967491310570436,128496.33487654325,147.72376543209901,128644.05864197534,1545,0,273.25,38,6,16,37.702625570776256,0.6014254385964912,46.52777777777778,1013.8888888888891,26.681286549707607,0
2047,4,0,0,42,0.0,0.0,1.0,42,1200,900,300,0.75,15,9,6,361.11415943928733,0.4390122919086334,0.2557969058469223,0.1958374980394978,128315.61872260776,867.3173595893182,129182.93608219708,1546,2,286.6666666666667,36,6,21,37.55927901893224,0.6032986111111112,46.70608108108108,1013.1756756756758,28.143768768768773,0
2048,4,0,1,41,0.0,0.023809523809523808,0.9761904761904762,42,1150,800,350,0.6956521739130435,15,8,7,360.54336008442715,0.4388792102206736,0.25420433181385027,0.19618736692057262,128450.01737313399,862.3601733225537,129312.37754645654,1547,3,287.6666666666667,37,5,17,37.43633946277267,0.602759009009009,46.5734649122807,1013.7061403508768,27.3974632527264,0
2049,4,3,2,42,0.06818181818181818,0.045454545454545456,0.9545454545454546,44,850,500,350,0.5882352941176471,12,5,7,351.4082782700507,0.44409575405214935,0.2632313600477243,0.1939606642879347,129016.12548828126,267.4669053819453,129283.59239366322,1548,0,275.1363636363636,39,5,20,37.09040380737551,0.6049679487179487,46.015625,1015.9375000000001,26.04967948717949,0
2050,4,1,0,43,0.023255813953488372,0.0,1.0,43,1650,1000,650,0.6060606060606061,23,10,13,363.2224879063324,0.4426910299003322,0.2789670495760441,0.2004574949217245,129011.3768924866,771.9666566220992,129783.3435491087,1549,0,282.2325581395349,38,5,22,36.79518526308409,0.6066337719298245,46.02029914529914,1015.9188034188029,26.73470535312639,0
2051,4,2,1,44,0.044444444444444446,0.022222222222222223,0.9777777777777777,45,1200,900,300,0.75,15,9,6,343.5251514376698,0.4469276094276094,0.2651846911933604,0.18629872136737285,128315.61872260776,-171.7155774404132,128143.90314516735,1550,0,270.64444444444445,36,9,21,38.00479789559481,0.6032986111111112,46.70608108108108,1013.1756756756758,28.143768768768773,8
2052,4,0,0,44,0.0,0.0,1.0,44,1900,1200,700,0.631578947368421,26,12,14,349.8678079999661,0.4446022727272727,0.27985144352050795,0.19017954032623863,128408.33875868062,185.18880208333803,128593.52756076396,1551,1,277.75,35,9,17,37.74944330250085,0.60625,46.614583333333336,1013.5416666666672,28.95833333333335,0
2053,4,1,1,44,0.022222222222222223,0.022222222222222223,0.9777777777777777,45,1100,700,400,0.6363636363636364,15,7,8,348.32250184238484,0.4458754208754209,0.28378494941653387,0.19163050635221401,128886.7346020008,-21.170029827109772,128865.5645721737,1552,0,272.55555555555554,36,9,18,37.30060811060589,0.6090856481481481,46.143018018018026,1015.4279279279292,28.206331331331366,0
2054,4,1,0,45,0.022222222222222223,0.0,1.0,45,1250,800,450,0.64,17,8,9,347.3823734252898,0.44522306397306394,0.2927184596020458,0.1929437037940466,129263.69214965402,-18.06350942029411,129245.62864023373,1553,0,273.2888888888889,33,12,20,36.940628263838676,0.6193181818181819,45.77205882352941,1016.9117647058827,30.815508021390382,0
2055,4,0,0,45,0.0,0.0,1.0,45,1300,800,500,0.6153846153846154,18,8,10,341.0582601471514,0.4446338383838384,0.2792675992266578,0.190407954379295,129466.2814670136,-168.89105902781318,129297.39040798579,1554,1,274.2888888888889,35,10,17,36.895470829068564,0.6169642857142856,45.57291666666665,1017.708333333331,29.077380952380885,0
2056,4,0,1,44,0.0,0.022222222222222223,0.9777777777777777,45,1650,1200,450,0.7272727272727273,21,12,9,340.32823064912463,0.4436447811447812,0.28407485224913054,0.19079901982393274,129631.08114448913,-176.5767033925784,129454.50444109655,1555,2,275.2888888888889,36,9,18,36.74665487117106,0.6166087962962963,45.41103603603604,1018.3558558558561,28.28766266266267,0
2057,4,0,1,43,0.0,0.022727272727272728,0.9772727272727273,44,900,500,400,0.5555555555555556,13,5,8,350.5784108431551,0.4428845137420719,0.29263269419608284,0.19601634604993953,129525.18332315244,281.7465867198233,129806.92990987225,1556,4,282.5,35,9,18,36.59335323100247,0.6175595238095238,45.5150462962963,1017.9398148148149,29.083994708994712,0
2058,4,1,0,44,0.022727272727272728,0.0,1.0,44,1200,800,400,0.6666666666666666,16,8,8,347.17014752503934,0.44498766737138834,0.30047064651969335,0.19601760637182988,129908.37191358028,220.06172839506917,130128.43364197535,1557,0,282.1363636363636,35,9,20,36.2908719346049,0.6214285714285714,45.13888888888889,1019.4444444444447,29.126984126984134,0
2059,4,1,0,45,0.022222222222222223,0.0,1.0,45,1300,1000,300,0.7692307692307693,16,10,6,339.6633339926947,0.4465277777777778,0.2998847445989359,0.19310094935017594,130176.3820408248,-156.77121378132517,130019.61082704348,1558,0,276.84444444444443,36,9,21,36.21050356801297,0.6221064814814814,44.87612612612614,1020.495495495497,28.34709709709714,0
2060,4,0,1,44,0.0,0.022222222222222223,0.9777777777777777,45,1550,1200,350,0.7741935483870968,19,12,7,337.1111197258537,0.4461489898989899,0.2939254684264059,0.19235912665540084,130320.0725007103,-213.53088730621323,130106.54161340409,1559,1,277.84444444444443,36,9,21,36.1301055108268,0.6235532407407407,44.73536036036037,1021.0585585585596,28.362737737737767,0
2061,4,1,0,45,0.022222222222222223,0.0,1.0,45,1700,1200,500,0.7058823529411765,22,12,10,338.16798287754085,0.44412878787878785,0.2942025257536225,0.19353449669919084,130435.08193582103,-178.20628905931983,130256.8756467617,1560,0,278.5777777777778,36,9,22,35.98670672105244,0.6247106481481481,44.62274774774775,1021.5090090090096,28.375250250250264,0
2062,4,0,1,44,0.0,0.022222222222222223,0.9777777777777777,45,1100,600,500,0.5454545454545454,16,6,10,336.7479756240088,0.4438762626262626,0.29375451484542436,0.19329461598911318,130550.14209733381,-207.50078625922816,130342.64131107458,1561,1,279.5777777777778,36,9,17,35.90656565656566,0.6258680555555556,44.51013513513514,1021.9594594594594,28.387762762762762,0
2063,4,0,1,43,0.0,0.022727272727272728,0.9772727272727273,44,1500,1200,300,0.8,18,12,6,342.8050891999202,0.4426752995066949,0.3033914618955955,0.19696237753575108,130587.70743580666,153.2261391889501,130740.93357499561,1562,4,286.90909090909093,35,9,18,35.71379704072775,0.6282738095238095,44.473379629629626,1022.1064814814807,29.203042328042308,0
2064,4,0,0,43,0.0,0.0,1.0,43,1150,900,250,0.782608695652174,14,9,5,343.5137051039695,0.4422526762643042,0.29044489383215333,0.19752038043478254,130617.28395061729,373.7654320987616,130991.04938271605,1563,5,277.74418604651163,35,8,18,35.66576086956519,0.6285714285714286,44.44444444444444,1022.2222222222223,29.20634920634921,0
2065,4,0,0,43,0.0,0.0,1.0,43,1500,1100,400,0.7333333333333333,19,11,8,342.9302038391448,0.44199889258028796,0.2937244043921803,0.19778924811505746,130735.623499657,366.63880315500296,131102.262302812,1564,6,278.74418604651163,35,8,18,35.560962728233,0.6297619047619047,44.3287037037037,1022.6851851851847,29.219576719576704,0
2066,4,0,0,43,0.0,0.0,1.0,43,1600,1200,400,0.75,20,12,8,343.191171351938,0.4419066076042821,0.29131853099021376,0.1985477719077964,130854.01663237296,381.58864883400196,131235.60528120695,1565,7,279.74418604651163,35,8,19,35.43457767722475,0.6309523809523809,44.212962962962955,1023.148148148147,29.2328042328042,0
2067,4,0,1,42,0.0,0.023255813953488372,0.9767441860465116,43,1250,800,450,0.64,17,8,9,342.55824112334756,0.44139904023624954,0.2881722691837456,0.19894469092160255,131002.08340031284,375.1686546210432,131377.2520549339,1566,8,280.74418604651163,35,8,19,35.301135293009224,0.6324404761904762,44.06828703703703,1023.7268518518512,29.249338624338606,0
2068,4,0,0,42,0.0,0.0,1.0,42,1450,1200,250,0.8275862068965517,17,12,5,351.75083529021197,0.438939701897019,0.3000221612787062,0.20358911981948627,130870.93431122445,806.7920918367302,131677.72640306118,1567,9,288.2142857142857,34,8,19,35.198516579406636,0.6332720588235294,44.19642857142857,1023.2142857142853,30.09453781512604,0
2069,4,0,0,42,0.0,0.0,1.0,42,1300,1200,100,0.9230769230769231,14,12,2,352.9824409114792,0.43879452187379014,0.30189334582640037,0.204683522949522,130942.84664619766,844.1051258144672,131786.95177201214,1568,10,289.2142857142857,35,7,19,35.09426005503411,0.6318452380952381,44.126157407407405,1023.49537037037,29.242724867724856,0
2070,4,0,0,42,0.0,0.0,1.0,42,1200,900,300,0.75,15,9,6,356.94290217522934,0.4389155052264808,0.30346848810734905,0.2076182679516274,131061.33355034715,956.2825520833279,132017.61610243047,1569,11,290.2142857142857,35,7,19,34.8730501865039,0.6330357142857144,44.010416666666664,1023.9583333333327,29.255952380952362,0
2071,4,0,0,42,0.0,0.0,1.0,42,1600,1400,200,0.875,18,14,4,358.28012959611556,0.43818960511033683,0.30872764831192256,0.20920156379847088,131209.517532579,1001.9525891632509,132211.47012174223,1570,12,291.2142857142857,35,7,20,34.68895918059948,0.6345238095238095,43.86574074074075,1024.537037037038,29.272486772486804,0
2072,4,0,0,42,0.0,0.0,1.0,42,1100,600,500,0.5454545454545454,16,6,10,357.58834897205287,0.4379718350754936,0.3126376910596871,0.20961643581998787,131359.53006355753,994.6346627870131,132354.16472634455,1571,13,292.2142857142857,33,9,21,34.555065750149424,0.6404671717171717,43.71936274509805,1025.1225490196098,31.064319667260904,0
2073,4,0,0,42,0.0,0.0,1.0,42,950,600,350,0.631578947368421,13,6,7,361.15114850710506,0.43754839334107626,0.3198465810798503,0.21222702322383838,131453.76778162268,1094.935841983877,132548.70362360656,1572,14,293.2142857142857,33,9,21,34.36852692797959,0.6414141414141414,43.62745098039217,1025.4901960784332,31.07546048722525,0
2074,4,1,0,43,0.023255813953488372,0.0,1.0,43,850,500,350,0.5882352941176471,12,5,7,355.44862811054054,0.43800756736803254,0.31524607708087937,0.21104303611215647,131847.2381660998,772.9839852607736,132620.22215136056,1573,0,287.3720930232558,34,9,19,34.11769251574515,0.6430759803921569,43.24404761904762,1027.0238095238096,30.206582633053223,0
2075,4,0,0,43,0.0,0.0,1.0,43,1050,600,450,0.5714285714285714,15,6,9,355.4592094998585,0.4377768549280177,0.30970923495647984,0.21155951572301918,131938.95266439908,779.7831632653058,132718.73582766438,1574,1,288.3720930232558,34,9,19,34.02496137504829,0.6439950980392157,43.154761904761905,1027.3809523809523,30.21708683473389,0
2076,4,0,0,43,0.0,0.0,1.0,43,1200,700,500,0.5833333333333334,17,7,10,356.8619334470502,0.4371308600959764,0.3080722125876536,0.21342518401999472,132122.4773242629,829.8965419500955,132952.373866213,1575,2,289.3720930232558,34,9,19,33.80398911533116,0.6458333333333333,42.97619047619047,1028.0952380952372,30.238095238095212,0
2077,4,0,1,42,0.0,0.023255813953488372,0.9767441860465116,43,1400,1000,400,0.7142857142857143,18,10,8,369.2065554717486,0.4371539313399779,0.3235873393790645,0.20427196137798562,129110.63102324268,955.8106575963793,130066.44168083905,1576,3,290.3720930232558,34,9,19,36.54191558314786,0.6155024509803921,45.92261904761905,1016.3095238095241,29.89145658263306,8
2078,4,0,0,42,0.0,0.0,1.0,42,1450,1200,250,0.8275862068965517,17,12,5,368.8524590163935,0.43693137824235384,0.3019125683060111,0.20454545454545447,129201.38888888882,1131.2818877550917,130332.6707766439,1577,4,276.5238095238095,33,9,19,36.458333333333336,0.6186868686868687,45.83333333333333,1016.6666666666661,30.80808080808079,0
2079,4,1,0,43,0.023255813953488372,0.0,1.0,43,1100,700,400,0.6363636363636364,15,7,8,358.84936789057394,0.43920727205610927,0.299540975047317,0.20084291846859847,129564.7392290248,698.8449546485094,130263.5841836733,1578,0,271.06976744186045,34,9,17,36.342619660118494,0.6200980392156863,45.47619047619047,1018.0952380952369,29.94397759103638,0
2080,4,0,0,43,0.0,0.0,1.0,43,1400,900,500,0.6428571428571429,19,9,10,359.10256186070404,0.43844592100406055,0.2994101136570504,0.20207487356776888,129776.92920918354,720.6455498865978,130497.57475907014,1579,1,272.06976744186045,34,9,19,36.120360634030426,0.6222426470588236,45.26785714285713,1018.9285714285703,29.96848739495795,0
2081,4,0,0,43,0.0,0.0,1.0,43,1750,1300,450,0.7428571428571429,22,13,9,359.8660618164815,0.43724621631598376,0.3010582345858952,0.203185914902536,129908.37191357993,749.9228395061383,130658.29475308607,1580,2,273.06976744186045,35,8,19,35.96730245231608,0.6214285714285714,45.13888888888887,1019.4444444444418,29.126984126984052,0
2082,4,0,0,43,0.0,0.0,1.0,43,1050,700,350,0.6666666666666666,14,7,7,360.95075231547946,0.43710778885197493,0.30615008195358384,0.2042605702409559,129996.88042534699,784.4943576388648,130781.37478298585,1581,3,274.06976744186045,35,8,19,35.8497191011236,0.6223214285714286,45.05208333333332,1019.7916666666647,29.136904761904706,0
2083,4,2,0,45,0.044444444444444446,0.0,1.0,45,1300,1100,200,0.8461538461538461,15,11,4,346.3830172260087,0.440446127946128,0.29798803697661813,0.19844185940144216,130475.34722222202,39.70269097219784,130515.04991319422,1582,0,262.84444444444443,34,11,21,35.73613376835237,0.6292892156862745,44.58333333333332,1021.6666666666649,30.049019607843086,0
2084,4,1,2,44,0.021739130434782608,0.043478260869565216,0.9565217391304348,46,900,400,500,0.4444444444444444,14,4,10,336.91962697945075,0.442481884057971,0.28784241774349795,0.1947699530981925,130824.41332572431,-384.53749249830764,130439.875833226,1583,0,258.10869565217394,35,11,17,35.62490572085831,0.6306547619047619,44.24189814814814,1023.0324074074063,29.229497354497322,0
2085,4,0,0,44,0.0,0.0,1.0,44,1450,1200,250,0.8275862068965517,17,12,5,353.3712856023007,0.4393058491895701,0.29886959284163783,0.20292257437429737,130566.58340419478,427.69628684804485,130994.27969104283,1584,1,270.79545454545456,34,10,17,35.4652009318579,0.6302083333333333,44.494047619047606,1022.0238095238076,30.059523809523753,0
2086,4,0,1,43,0.0,0.022727272727272728,0.9772727272727273,44,1250,900,350,0.72,16,9,7,353.54797970598224,0.4383368569415081,0.3024653574331073,0.2040694641843085,130765.21675936627,446.35564021775014,131211.57239958402,1585,2,271.79545454545456,35,9,17,35.25953849345555,0.6300595238095238,44.29976851851851,1022.8009259259247,29.222883597883563,0
2087,4,0,0,43,0.0,0.0,1.0,43,1500,1200,300,0.8,18,12,6,353.53263011187136,0.43798449612403095,0.2861743949225599,0.20421708398226907,130794.81336805546,648.0468749999902,131442.86024305545,1586,3,262.5813953488372,35,8,18,35.22997284453496,0.6303571428571428,44.27083333333333,1022.9166666666658,29.226190476190453,0
2088,4,0,0,43,0.0,0.0,1.0,43,1500,1000,500,0.6666666666666666,20,10,10,352.31951385758623,0.4375692137320044,0.2855865498660093,0.20429911219951694,130942.84664619763,626.744014703356,131569.59066090098,1587,4,263.5813953488372,35,8,18,35.11122262429794,0.6318452380952381,44.126157407407405,1023.4953703703698,29.24272486772485,0
2089,4,0,0,43,0.0,0.0,1.0,43,1350,800,550,0.5925925925925926,19,8,11,348.02564397332526,0.4374077150239941,0.2757910444624265,0.20321391823561197,131209.51753257896,532.8553669410301,131742.37289951998,1588,5,264.5813953488372,35,8,18,34.95161168850731,0.6345238095238095,43.86574074074075,1024.5370370370379,29.272486772486797,0
2090,4,0,0,43,0.0,0.0,1.0,43,1400,900,500,0.6428571428571429,19,9,10,349.91756787015163,0.43692321889996305,0.27905402036097504,0.2057478147908041,131476.45968632135,601.184601123133,132077.64428744448,1589,6,265.5813953488372,35,8,19,34.633623932588506,0.637202380952381,43.60532407407408,1025.5787037037053,29.302248677248723,0
2091,4,0,0,43,0.0,0.0,1.0,43,1350,900,450,0.6666666666666666,18,9,9,349.16719884267997,0.43646179401993357,0.2799513055159095,0.20578577463706904,131565.5006858712,587.6714677640787,132153.17215363527,1590,7,266.5813953488372,35,8,18,34.56302647412757,0.638095238095238,43.518518518518526,1025.925925925927,29.312169312169342,0
2092,4,1,2,42,0.022727272727272728,0.045454545454545456,0.9545454545454546,44,1600,1100,500,0.6875,21,11,10,342.33472645735566,0.43678426708949963,0.28116683776699136,0.20341596351905833,131876.9799148813,229.21396903662665,132106.1938839179,1591,0,261.5,36,8,19,34.42445090085153,0.6391782407407407,43.2150900900901,1027.139639639641,28.531656656656693,0
2093,4,0,1,41,0.0,0.023809523809523808,0.9761904761904762,42,800,600,200,0.75,10,6,4,349.8262744476625,0.43465689121176926,0.2748238894197883,0.20755145066286507,131819.15181651257,822.7605561642902,132641.91237267686,1592,1,264.5238095238095,36,6,19,34.29035530211647,0.638599537037037,43.271396396396405,1026.9144144144154,28.52540040040043,0
2094,4,0,1,40,0.0,0.024390243902439025,0.975609756097561,41,1150,900,250,0.782608695652174,14,9,5,350.279602176768,0.4328760162601626,0.2571653859004335,0.20877213389046467,131992.67415642017,1046.8682787517423,133039.5424351719,1593,2,263.3170731707317,36,5,20,34.10388127853881,0.6403356481481481,43.102477477477485,1027.5900900900917,28.544169169169216,0
2095,4,0,0,40,0.0,0.0,1.0,40,1100,800,300,0.7272727272727273,14,8,6,351.56256330495427,0.43062232905982906,0.2560890763668233,0.2098568682331146,132050.54029959036,1284.8052867056476,133335.345586296,1594,3,267.725,36,4,20,34.01263649976261,0.6409143518518519,43.04617117117118,1027.815315315317,28.550425425425473,0
2096,4,0,0,40,0.0,0.0,1.0,40,1150,1000,150,0.8695652173913043,13,10,3,353.0304427238227,0.43015491452991456,0.25821103931661415,0.21137842442696575,132166.3106307322,1331.7462310283431,133498.05686176053,1595,4,268.725,36,4,20,33.858330595407594,0.6420717592592593,42.933558558558566,1028.2657657657667,28.562937937937964,0
2097,4,0,0,40,0.0,0.0,1.0,40,1400,1000,400,0.7142857142857143,18,10,8,353.3594393315351,0.42853899572649573,0.25635123614663247,0.21255929350558506,132341.5858725763,1352.8297168359663,133694.41558941227,1596,5,269.725,37,3,20,33.6734512645638,0.6418918918918919,42.76315789473685,1028.9473684210539,27.80938833570416,0
2098,4,0,0,40,0.0,0.0,1.0,40,1150,600,550,0.5217391304347826,17,6,11,357.45238095238057,0.42824519230769226,0.2622976190476185,0.2157040229885057,132461.07266435993,1469.7532531968882,133930.82591755682,1597,6,270.725,33,7,20,33.44791666666664,0.6515151515151515,42.64705882352941,1029.411764705883,31.19429590017827,0
2099,4,0,0,40,0.0,0.0,1.0,40,950,400,550,0.42105263157894735,15,4,11,356.39432716879014,0.4280582264957265,0.2631575815282079,0.21542626883972463,132524.1568747596,1446.1715445982172,133970.3284193578,1598,7,271.725,33,7,20,33.41168769340633,0.6521464646464646,42.58578431372548,1029.656862745097,31.201723113487787,0
2100,4,0,0,40,0.0,0.0,1.0,40,1150,700,450,0.6086956521739131,16,7,9,358.89847335905176,0.4277377136752137,0.26624226558781516,0.21730423415774303,132587.25610342188,1517.072760476753,134104.32886389864,1599,8,272.725,33,7,20,33.28375376804696,0.6527777777777778,42.524509803921575,1029.9019607843145,31.20915032679741,0
2101,4,0,0,40,0.0,0.0,1.0,40,850,600,250,0.7058823529411765,11,6,5,358.8750598632446,0.4272836538461538,0.2709919124643194,0.21802178492269964,132713.49961553258,1525.5130238369939,134239.01263936958,1600,9,273.725,33,7,18,33.15740960989534,0.654040404040404,42.40196078431373,1030.3921568627457,31.224004753416533,0
2102,4,0,0,40,0.0,0.0,1.0,40,950,500,450,0.5263157894736842,14,5,9,380.13553781406875,0.42755074786324787,0.3072758877576367,0.21114562907272458,129265.58036169763,1957.7463330395858,131223.32669473722,1601,10,274.725,32,8,21,36.10602392186079,0.6217447916666667,45.770202020202014,1016.9191919191908,31.778724747474712,8
2103,4,0,0,40,0.0,0.0,1.0,40,1550,1300,250,0.8387096774193549,18,13,5,380.35057908508435,0.4268963675213675,0.30723359422034924,0.21242848414940327,129481.87183114675,1849.7009863994706,131331.57281754623,1602,11,275.725,33,7,19,35.87986654625727,0.6215277777777778,45.55759803921569,1017.7696078431379,30.841503267973877,0
2104,4,0,0,40,0.0,0.0,1.0,40,800,600,200,0.75,10,6,4,382.1916186170329,0.4265625,0.31170398459130877,0.213795675141528,129544.24267409161,1902.1447580257511,131446.38743211736,1603,12,276.725,33,7,19,35.769406323983794,0.6221590909090908,45.49632352941176,1018.0147058823524,30.848930481283404,0
2105,4,1,0,41,0.024390243902439025,0.0,1.0,41,850,600,250,0.7058823529411765,11,6,5,375.48723981024443,0.42812500000000003,0.3151759618507184,0.2117866763672803,129867.92091836738,1552.749433106579,131420.67035147396,1604,0,270.9512195121951,34,7,20,35.61035194269251,0.6231617647058824,45.17857142857143,1019.2857142857146,29.978991596638664,0
2106,4,1,1,41,0.023809523809523808,0.023809523809523808,0.9761904761904762,42,1350,1000,350,0.7407407407407407,17,10,7,370.6828333251276,0.42891018195896247,0.3143251539002343,0.21137294212400012,130293.86421388428,1260.7373126947075,131554.601526579,1605,0,265.4761904761905,33,9,22,35.2997589325011,0.6297348484848485,44.76102941176472,1020.9558823529428,30.938057040998267,0
2107,4,0,2,39,0.0,0.04878048780487805,0.9512195121951219,41,1200,900,300,0.75,15,9,6,366.63026173515686,0.42865853658536585,0.30615725737676946,0.2097125097125098,130414.54081632658,1362.7834467120244,131777.3242630386,1606,1,270.9756097560976,34,7,23,35.28069153069152,0.6286764705882353,44.642857142857146,1021.4285714285718,30.0420168067227,0
2108,4,1,0,40,0.025,0.0,1.0,40,1600,1200,400,0.75,20,12,8,375.04510054209175,0.43004807692307695,0.3178314552865025,0.21576732611876762,130638.16350682435,1799.040633410237,132437.2041402346,1607,0,276.175,33,7,19,34.838767681611145,0.6332070707070707,44.42401960784314,1022.3039215686279,30.978906714200843,0
2109,4,0,1,39,0.0,0.025,0.975,40,1300,900,400,0.6923076923076923,17,9,8,348.90600430642917,0.4293402777777778,0.21180398370303322,0.20123586514697164,130735.62349965693,1134.6631207251564,131870.28662038207,1608,1,277.175,35,5,17,35.40817866304511,0.6297619047619047,44.328703703703695,1022.6851851851841,29.21957671957669,8
2110,4,1,0,40,0.025,0.0,1.0,40,900,600,300,0.6666666666666666,12,6,6,347.5031223766918,0.42896634615384616,0.2202714932126697,0.20104238231740532,130854.01663237298,1094.435871056226,131948.4525034292,1609,0,278.125,35,5,18,35.32428355957767,0.6309523809523809,44.212962962962955,1023.1481481481471,29.232804232804202,0
2111,4,2,1,41,0.047619047619047616,0.023809523809523808,0.9761904761904762,42,1000,700,300,0.7,13,7,6,334.62998537572184,0.43278164924506385,0.22329356121681232,0.1966062115669026,131446.78605109715,398.92189643344267,131845.70794753058,1610,0,265.8333333333333,35,7,20,35.05549285176825,0.6369047619047619,43.634259259259245,1025.462962962961,29.298941798941744,0
2112,4,0,0,41,0.0,0.0,1.0,41,1400,1000,400,0.7142857142857143,18,10,8,330.90195431956715,0.4303607723577236,0.13667505418670145,0.18725607703980113,129996.8804253471,403.24435763887914,130400.12478298598,1611,1,273.1707317073171,35,6,18,36.61580694586314,0.6223214285714286,45.05208333333333,1019.7916666666656,29.13690476190473,8
2113,4,0,0,41,0.0,0.0,1.0,41,1650,1000,650,0.6060606060606061,23,10,13,327.363598500625,0.4291920731707317,0.13081134892981638,0.1865211200759374,130262.58680555546,328.6458333333287,130591.23263888879,1612,2,274.1707317073171,35,6,19,36.43707482993198,0.625,44.791666666666664,1020.8333333333326,29.166666666666647,0
2114,4,1,2,40,0.023809523809523808,0.047619047619047616,0.9523809523809523,42,1150,700,450,0.6086956521739131,16,7,9,319.9171056575091,0.4314266356949284,0.1327362588931562,0.1837701044903516,130578.91506371248,-45.114286583867894,130533.80077712862,1613,0,268.6190476190476,36,6,16,36.307523505215215,0.6261574074074074,44.48198198198199,1022.0720720720731,28.39089089089092,0
2115,4,0,0,40,0.0,0.0,1.0,40,700,300,400,0.42857142857142855,11,3,8,335.8503887090004,0.4273771367521368,0.15088900547977224,0.19165594038304015,130323.35778061204,753.8300736961252,131077.18785430817,1614,4,282.85,34,6,19,36.15896195250867,0.6277573529411764,44.73214285714285,1021.0714285714268,30.031512605041968,0
2116,4,0,0,40,0.0,0.0,1.0,40,1400,1100,300,0.7857142857142857,17,11,6,336.3448905406945,0.42752403846153847,0.14941724941724877,0.1923892773892771,130414.54081632642,772.8528911564404,131187.39370748287,1615,5,283.85,34,6,20,36.0540501165501,0.6286764705882353,44.64285714285713,1021.4285714285705,30.042016806722664,0
2117,4,0,1,39,0.0,0.025,0.975,40,950,700,250,0.7368421052631579,12,7,5,338.74486150180707,0.4270833333333333,0.14873325567850926,0.1945233870229437,130566.58340419478,845.751842403602,131412.33524659838,1616,6,284.85,34,6,16,35.83891477383033,0.6302083333333333,44.494047619047606,1022.0238095238076,30.059523809523753,0
2118,4,1,2,38,0.025,0.05,0.95,40,850,600,250,0.7058823529411765,11,6,5,357.66207594613957,0.4295940170940171,0.0694317663167503,0.1954208499745615,128613.70991941018,1200.0492969821703,129813.75921639234,1617,0,285.2,35,5,14,37.34215731020844,0.6083333333333334,46.41203703703704,1014.3518518518521,28.981481481481488,8
2119,4,1,0,39,0.02564102564102564,0.0,1.0,39,1150,700,450,0.6086956521739131,16,7,9,362.48975431120095,0.42782838506522713,0.09538593910293991,0.1984264724466517,128687.5159438776,1529.581207482996,130217.0971513606,1618,0,293.1025641025641,34,5,15,37.14434471430248,0.6112132352941176,46.339285714285715,1014.6428571428576,29.84243697478993,0
2120,4,1,1,39,0.025,0.025,0.975,40,950,800,150,0.8421052631578947,11,8,3,351.9207799571945,0.4308092948717949,0.09342455129625482,0.19487343312230923,129144.15048494456,1089.70203311421,130233.85251805877,1619,0,286.75,36,4,16,36.946968018317435,0.6116898148148149,45.88963963963965,1016.4414414414427,28.234484484484522,0
2121,4,0,0,39,0.0,0.0,1.0,39,1250,1000,250,0.8,15,10,5,351.0379960020555,0.4288686459739091,0.09287291616608928,0.1859754489457702,127376.05003652327,1142.7666686957564,128518.81670521903,1620,1,294.87179487179486,36,3,16,38.77616949278597,0.59375,47.63513513513515,1009.4594594594616,28.0405405405406,8
2122,4,0,1,38,0.0,0.02564102564102564,0.9743589743589743,39,1150,900,250,0.782608695652174,14,9,5,346.5835873445782,0.42968398560503823,0.09268963466755875,0.18426248932386038,127518.18700034512,1039.1421404512855,128557.3291407964,1621,2,295.87179487179486,36,3,17,38.74293864050249,0.5951967592592593,47.49436936936938,1010.022522522524,28.056181181181223,0
2123,4,3,0,41,0.07317073170731707,0.0,1.0,41,600,400,200,0.6666666666666666,8,4,4,333.3492430134108,0.4346290650406504,0.11184911722454727,0.17964452379459947,128063.41428336647,337.9684418146245,128401.38272518109,1622,0,282.3170731707317,38,3,20,38.51989655900359,0.5970394736842105,46.95512820512822,1012.1794871794893,26.636302294197087,0
2124,4,3,4,40,0.06818181818181818,0.09090909090909091,0.9090909090909091,44,1500,1000,500,0.6666666666666666,20,10,10,313.1159610835763,0.43974630021141653,0.11690244676284478,0.17156218745085555,128725.26584201437,-738.7615697936731,127986.5042722207,1623,0,264.0,39,5,15,38.35839663313489,0.6020299145299146,46.30208333333336,1014.7916666666706,26.020299145299248,0
2125,4,1,0,41,0.024390243902439025,0.0,1.0,41,1400,1100,300,0.7857142857142857,17,11,6,338.032755418674,0.4332063008130081,0.14364859410006936,0.18410822123619613,128486.82032962017,486.5507822011192,128973.37111182128,1624,0,284.2682926829268,36,5,17,37.96928801510608,0.6050347222222222,46.53716216216216,1013.8513513513514,28.16253753753754,0
2126,4,1,0,42,0.023809523809523808,0.0,1.0,42,1200,1100,100,0.9166666666666666,13,11,2,329.8682938483592,0.4344875145180023,0.1505501628111543,0.18100716041222642,128783.68975309705,96.33120287010422,128880.02095596715,1625,0,278.4761904761905,37,5,19,37.87392873861222,0.6061373873873874,46.244517543859644,1015.0219298245609,27.43302513039354,0
2127,4,0,0,42,0.0,0.0,1.0,42,1350,1100,250,0.8148148148148148,16,11,5,328.268506835381,0.4334470576848626,0.14320667818077193,0.1810166337692243,128978.5318559556,67.91801323483105,129046.44986919043,1626,1,279.4761904761905,37,5,19,37.71633923431201,0.6081081081081081,46.05263157894736,1015.78947368421,27.4537695590327,0
2128,4,0,0,42,0.0,0.0,1.0,42,1150,600,550,0.5217391304347826,17,6,11,329.6542099648522,0.432987320944638,0.14635098752491915,0.18229327076099347,129089.93632656203,111.00819482917592,129200.94452139121,1627,2,280.4761904761905,37,5,19,37.56788591569557,0.6092342342342343,45.94298245614035,1016.2280701754387,27.4656235182551,0
2129,4,0,0,42,0.0,0.0,1.0,42,1000,700,300,0.7,13,7,6,331.17870873218425,0.4324670925280681,0.14593571711009412,0.18378337319410812,129229.25954380205,159.59586122653917,129388.85540502859,1628,3,281.4761904761905,37,5,19,37.38755436931592,0.6106418918918919,45.80592105263158,1016.7763157894746,27.480440967283094,0
2130,4,0,0,42,0.0,0.0,1.0,42,1600,1100,500,0.6875,21,11,10,332.46924046925704,0.4314992257065428,0.15377294113421702,0.18554702470205478,129452.33298947738,207.7837651969648,129660.11675467434,1629,4,282.4761904761905,37,5,14,37.12816057896059,0.6128941441441442,45.586622807017534,1017.6535087719286,27.5041488857278,0
2131,4,0,0,42,0.0,0.0,1.0,42,1150,700,450,0.6086956521739131,16,7,9,330.7541050133213,0.43113627564847073,0.15451084431254425,0.18532730011063872,129609.02829142008,173.74363083497562,129782.77192225505,1630,5,283.4761904761905,38,4,14,37.01277410555032,0.6126644736842105,45.43269230769231,1018.2692307692305,26.796558704453435,0
2132,4,1,0,43,0.023255813953488372,0.0,1.0,43,1450,1000,450,0.6896551724137931,19,10,9,337.3616063051233,0.43323181985972686,0.15361580121057683,0.18378654671846234,128496.33487654294,156.36631145442556,128652.70118799737,1631,0,277.86046511627904,38,5,17,37.976598173516,0.6014254385964912,46.527777777777764,1013.8888888888868,26.681286549707547,8
2133,4,0,1,42,0.0,0.023255813953488372,0.9767441860465116,43,1800,1300,500,0.7222222222222222,23,13,10,334.0458032983051,0.43235511258767073,0.06552676455940754,0.18189561232603813,128477.80687326864,165.78610726376903,128643.59298053241,1632,1,278.86046511627904,37,6,15,38.079529886797886,0.6030405405405406,46.546052631578945,1013.8157894736838,27.400426742531995,8
2134,4,0,0,42,0.0,0.0,1.0,42,1650,1500,150,0.9090909090909091,18,15,3,330.7419314505852,0.43037408052651954,0.07865892487351922,0.18104069873119344,128685.96734832712,112.36907827452741,128798.33642660164,1633,2,286.26190476190476,38,4,15,37.951238987750514,0.6033442982456141,46.340811965811966,1014.6367521367521,26.700967161493477,0
2135,4,0,0,42,0.0,0.0,1.0,42,1100,600,500,0.5454545454545454,16,6,10,334.02835409325326,0.43015631049167635,0.018419859171739494,0.18177484081179507,128453.4061756396,181.41596850421206,128634.8221441438,1634,3,287.26190476190476,40,2,18,38.104845446950726,0.59765625,46.57012195121952,1013.7195121951227,25.342987804878067,8
2136,4,1,1,42,0.023255813953488372,0.023255813953488372,0.9767441860465116,43,1150,800,350,0.6956521739130435,15,8,7,323.1654354537717,0.4322166851236619,0.02766146081975074,0.1771694750638844,128747.9184382086,-278.62457482993045,128469.29386337867,1635,0,281.5581395348837,41,2,19,38.08040078201368,0.5990853658536586,46.279761904761905,1014.8809523809522,24.75319396051103,0
2137,4,0,0,42,0.0,0.0,1.0,42,900,600,300,0.6666666666666666,12,6,6,328.238638722,0.43111207897793263,0.036164685837185795,0.1798367989013037,128722.74900990495,50.35598151298012,128773.10499141793,1636,1,289.0238095238095,41,1,20,37.9772990191286,0.5988313008130082,46.304563492063494,1014.7817460317465,24.75077429345723,0
2138,4,0,0,42,0.0,0.0,1.0,42,1450,1000,450,0.6896551724137931,19,10,9,327.1863029219059,0.4314750290360046,0.03463563120488189,0.17948756381737377,128773.09032698724,26.55826798311736,128799.64859497035,1637,2,290.0238095238095,41,1,20,37.95277017561008,0.599339430894309,46.254960317460316,1014.9801587301583,24.755613627564838,0
2139,4,0,0,42,0.0,0.0,1.0,42,1550,1000,550,0.6451612903225806,21,10,11,327.0664361787623,0.43090640727835855,0.00280126562908789,0.16845754991011885,126226.95448133704,-41.740388646754354,126185.2140926903,1638,3,291.0238095238095,39,3,19,40.55934919318613,0.576655982905983,48.77604166666668,1004.8958333333353,25.76655982905988,8
2140,4,3,0,45,0.06666666666666667,0.0,1.0,45,750,400,350,0.5333333333333333,11,4,7,317.40108618091006,0.44002525252525254,0.09750387982608899,0.160653253496533,125507.99370160351,-917.1762498059511,124590.81745179756,1639,0,272.55555555555554,38,7,17,41.541386786082384,0.5709978070175439,49.49252136752137,1002.0299145299148,26.36920827710302,8
2141,4,2,1,46,0.0425531914893617,0.02127659574468085,0.9787234042553191,47,1900,1500,400,0.7894736842105263,23,15,8,307.42204307771925,0.44416820844896704,0.13025637777606813,0.15835770740356114,126231.65155416752,-1636.4387007816615,124595.21285338586,1640,0,261.9148936170213,38,9,20,41.04804557374724,0.5783991228070176,48.771367521367516,1004.9145299145295,26.44511920827709,0
2142,4,0,1,45,0.0,0.021739130434782608,0.9782608695652174,46,1000,600,400,0.6,14,6,8,305.4867921224756,0.44107286634460546,0.14163209038937152,0.15774494546677448,126331.6528320314,-1481.4697265624864,124850.18310546891,1641,1,268.10869565217394,39,7,12,40.994132732359354,0.577724358974359,48.67187500000001,1005.3125000000011,25.77724358974362,0
2143,4,2,1,46,0.0425531914893617,0.02127659574468085,0.9787234042553191,47,1450,1200,250,0.8275862068965517,17,12,5,297.58979078165135,0.4436285846438483,0.1647459970841032,0.15528263490549682,126759.19514054141,-1855.55152769515,124903.64361284627,1642,0,263.3404255319149,40,7,14,40.75503750798937,0.58046875,48.2469512195122,1007.0121951219518,25.175304878048795,0
2144,4,1,0,47,0.02127659574468085,0.0,1.0,47,1350,1000,350,0.7407407407407407,17,10,7,296.2713155159764,0.44675069380203514,0.174703673709784,0.15567710942566765,127043.1652244457,-1872.1508623279851,125171.01436211771,1643,0,258.51063829787233,42,5,15,40.49804562347813,0.5803571428571428,47.96511627906977,1008.1395348837214,24.003322259136223,0
2145,4,2,0,49,0.04081632653061224,0.0,1.0,49,1450,1100,350,0.7586206896551724,18,11,7,293.3350803054214,0.4496350623582766,0.2089073965730197,0.15670964200100396,127713.4313662186,-2307.4246813621235,125406.00668485647,1644,0,248.91836734693877,43,6,14,39.88859221785023,0.5857558139534884,47.301136363636346,1010.7954545454513,23.50687103594073,0
2146,4,0,1,48,0.0,0.02040816326530612,0.9795918367346939,49,1500,1100,400,0.7333333333333333,19,11,8,292.17928273317085,0.4495819160997732,0.20190644394875146,0.15637083718005299,127785.23090457093,-2332.760578081991,125452.47032648894,1645,1,249.91836734693877,43,6,15,39.84470122693639,0.5864825581395349,47.23011363636362,1011.0795454545427,23.513477801268433,0
2147,4,0,0,48,0.0,0.0,1.0,48,1600,1200,400,0.75,20,12,8,292.7300089609199,0.44898788416075647,0.2034946365290684,0.1573028318868222,127948.38543544513,-2109.133596989411,125839.25183845572,1646,2,254.72916666666666,42,6,15,39.66474315997829,0.5895337301587302,47.06879844961238,1011.7248062015467,24.08868586194159,0
2148,4,1,1,48,0.02040816326530612,0.02040816326530612,0.9795918367346939,49,1650,1100,550,0.6666666666666666,22,11,11,284.8948308403748,0.45002480158730157,0.0919188870080887,0.1529269639717027,127904.94163940541,-2467.9007336458335,125437.04090575958,1647,0,250.51020408163265,43,6,11,39.907086687886135,0.5876937984496124,47.11174242424242,1011.5530303030304,23.52448907681466,8
2149,4,1,1,48,0.02040816326530612,0.02040816326530612,0.9795918367346939,49,1300,900,400,0.6923076923076923,17,9,8,283.21457842082395,0.449812216553288,0.10956351918757967,0.15302959382097236,128169.06003996133,-2539.906550936085,125629.15348902525,1648,0,251.16326530612244,42,7,13,39.6812200956938,0.591765873015873,46.85077519379844,1012.5968992248045,24.109449981542962,0
2150,4,1,3,46,0.02040816326530612,0.061224489795918366,0.9387755102040817,49,1300,900,400,0.6923076923076923,17,9,8,283.7413089782293,0.4499716553287982,0.12303831457999181,0.15406887898724397,128365.3748647916,-2515.4881016765967,125849.886763115,1649,0,252.0204081632653,42,7,14,39.46858864027538,0.59375,46.65697674418604,1013.3720930232545,24.127906976744153,0
2151,4,0,0,46,0.0,0.0,1.0,46,1400,1000,400,0.7142857142857143,18,10,8,298.3574097924371,0.4464774557165862,0.12908903730135468,0.16152788177084312,128247.44824715784,-1547.2847056976673,126700.16354146018,1650,1,267.19565217391306,40,6,16,39.21816996087086,0.5955729166666667,46.77337398373984,1012.9065040650412,25.32266260162603,0
2152,4,1,2,45,0.02127659574468085,0.0425531914893617,0.9574468085106383,47,1300,1100,200,0.8461538461538461,15,11,4,292.71925487434777,0.4472132284921369,0.13871516251423088,0.1597687636188177,128571.78411005597,-1872.9126314877878,126698.87147856818,1651,0,262.48936170212767,41,6,12,39.03157504320321,0.5973069105691057,46.45337301587301,1014.1865079365073,24.736256291134325,0
2153,4,0,1,44,0.0,0.022222222222222223,0.9777777777777777,45,1450,1100,350,0.7586206896551724,18,11,7,307.25684707177254,0.4435185185185185,0.14005815702396474,0.16699032892898014,128401.9012017482,-1109.5273357459253,127292.37386600228,1652,1,274.7111111111111,40,5,12,38.835689695511206,0.5971354166666667,46.62093495934959,1013.5162601626009,25.337906504065025,0
2154,4,0,0,44,0.0,0.0,1.0,44,1100,600,500,0.5454545454545454,16,6,10,315.03137283459904,0.441232822410148,0.14156631997301838,0.17121568835310372,128401.9012017482,-709.8745579681479,127692.02664378006,1653,2,281.65909090909093,40,4,13,38.63869948861927,0.5971354166666667,46.62093495934959,1013.5162601626009,25.337906504065025,0
2155,4,3,1,46,0.06382978723404255,0.02127659574468085,0.9787234042553191,47,1100,900,200,0.8181818181818182,13,9,4,298.59162758863846,0.4455943570767808,0.15485713152624347,0.16497879320422737,129057.01636392351,-1692.9310864324914,127364.08527749102,1654,0,264.6170212765957,43,4,17,38.39041627834731,0.5993217054263567,45.975378787878796,1016.0984848484864,23.63019732205782,0
2156,4,1,0,47,0.02127659574468085,0.0,1.0,47,1300,1000,300,0.7692307692307693,16,10,6,300.4917052179917,0.4449005550416281,0.16179263986315195,0.16674279841793166,129226.60506621633,-1633.5340015348793,127593.07106468146,1655,0,265.4468085106383,41,6,19,38.17028897128175,0.6039126016260163,45.80853174603175,1016.7658730158732,24.799167634533493,0
2157,4,1,0,48,0.020833333333333332,0.0,1.0,48,1500,1200,300,0.8,18,12,6,293.1000492817913,0.44569111997635935,0.16435097068899895,0.16417352440581368,129595.74619914664,-2003.0960804639183,127592.65011868272,1656,0,260.8958333333333,42,6,12,37.984749714503224,0.6061507936507937,45.445736434108525,1018.2170542635656,24.243263196751563,0
2158,4,0,0,48,0.0,0.0,1.0,48,1250,800,450,0.64,17,8,9,291.0934444394425,0.4451832151300236,0.15680680797000357,0.16351395205405136,129707.32829896982,-2048.6094072830565,127658.71889168676,1657,1,261.8958333333333,43,5,14,37.92307722103436,0.6058624031007752,45.33617424242424,1018.6553030303031,23.68965821000705,0
2159,4,0,3,45,0.0,0.0625,0.9375,48,1450,1000,450,0.6896551724137931,19,10,9,291.1043685728839,0.44427822104018916,0.1575616423504631,0.16392329200485645,129803.80980436482,-2042.7087817091221,127761.1010226557,1658,2,262.8958333333333,43,5,14,37.82534538301893,0.6068313953488372,45.24147727272728,1019.0340909090921,23.698467230444002,0
2160,4,0,0,45,0.0,0.0,1.0,45,1000,500,500,0.5,15,5,10,311.15955928620093,0.4402146464646464,0.15208229301907572,0.17357329621909323,129433.9629705365,-945.0770250842961,128488.8859454522,1659,3,280.84444444444443,40,5,14,37.68892106927661,0.6075520833333333,45.60467479674796,1017.5813008130064,25.43953252032516,0
2161,4,0,0,45,0.0,0.0,1.0,45,1150,500,650,0.43478260869565216,18,5,13,315.7719600823532,0.4400042087542087,0.1532692474235744,0.17691503265749284,129605.14298311896,-814.8659926933894,128790.27699042557,1660,4,281.84444444444443,41,4,17,37.39810665107822,0.6077235772357723,45.43650793650793,1018.2539682539665,24.835462640340648,0
2162,4,0,0,45,0.0,0.0,1.0,45,1550,1200,350,0.7741935483870968,19,12,7,319.18960724771534,0.4393518518518518,0.16104025357262675,0.17963816197486462,129781.98346757665,-714.9879338309624,129066.99553374568,1661,5,282.84444444444443,41,4,17,37.13195323402459,0.6095020325203252,45.262896825396815,1018.9484126984111,24.852400309717343,0
2163,4,1,0,46,0.021739130434782608,0.0,1.0,46,1650,1100,550,0.6666666666666666,22,11,11,320.9116008321036,0.44090177133655395,0.17388278580390604,0.18250471357084838,130190.0945265867,-844.0976705980465,129345.99685598866,1662,0,277.67391304347825,43,3,19,36.67503711608053,0.6107073643410852,44.862689393939384,1020.5492424242409,23.73370331219165,0
2164,4,0,1,45,0.0,0.021739130434782608,0.9782608695652174,46,1000,600,400,0.6,14,6,8,316.80026062000786,0.44022745571658617,0.1675371394860503,0.18096249033464798,130361.52354313104,-940.2668964318254,129421.25664669921,1663,1,278.67391304347825,42,4,19,36.60669102065345,0.6138392857142857,44.69476744186045,1021.2209302325551,24.314784053156075,0
2165,4,1,0,46,0.021739130434782608,0.0,1.0,46,1300,700,600,0.5384615384615384,19,7,12,320.3814722634588,0.44118357487922705,0.18238775947634833,0.18406229681018307,130584.26852352606,-832.6439591971823,129751.62456432887,1664,0,279.3478260869565,42,4,17,36.29025249652383,0.6160714285714286,44.4767441860465,1022.0930232558126,24.33554817275744,0
2166,4,0,0,46,0.0,0.0,1.0,46,1400,1200,200,0.8571428571428571,16,12,4,318.2011072108327,0.4406803542673108,0.1809369618772192,0.18351335986355877,130732.87080854509,-880.1311519740482,129852.73965657105,1665,1,280.3478260869565,42,4,17,36.19599204093233,0.6175595238095238,44.331395348837205,1022.6744186046506,24.349390919158346,0
2167,4,1,1,46,0.02127659574468085,0.02127659574468085,0.9787234042553191,47,1300,900,400,0.6923076923076923,17,9,8,322.94041121226263,0.44106537156953435,0.10776701788755849,0.17565864401936976,128434.73442925328,-1043.2796482168683,127391.45478103642,1666,0,275.36170212765956,39,8,15,38.40486161066009,0.5990918803418803,46.58854166666666,1013.6458333333318,25.990918803418765,8
2168,4,0,1,45,0.0,0.021739130434782608,0.9782608695652174,46,1450,1100,350,0.7586206896551724,18,11,7,324.9978823074381,0.43868760064412243,0.1180261639091964,0.1772919482104712,128550.50131492417,-844.2718606180363,127706.22945430613,1667,1,282.30434782608694,38,8,15,38.234829329962075,0.6019736842105263,46.474358974358964,1014.1025641025623,26.686909581646375,0
2169,4,1,1,45,0.021739130434782608,0.021739130434782608,0.9782608695652174,46,1250,800,450,0.64,17,8,9,316.6728097082173,0.44090177133655395,0.114868601809067,0.17420578719163088,128883.87586805545,-1037.1961805555645,127846.67968749988,1668,0,278.2173913043478,39,7,17,38.106962111886205,0.6036324786324787,46.14583333333333,1015.4166666666657,26.036324786324762,0
2170,4,0,0,45,0.0,0.0,1.0,45,1500,900,600,0.6,21,9,12,325.2765292599371,0.4388678451178451,0.1180961731771748,0.17914708500260473,128929.98598327102,-612.420328365865,128317.56565490515,1669,1,285.1111111111111,38,7,17,37.84167017322393,0.6058114035087719,46.10042735042734,1015.5982905982888,26.726270805218128,0
2171,4,0,1,44,0.0,0.022222222222222223,0.9777777777777777,45,1600,1300,300,0.8125,19,13,6,330.4793987533468,0.43813131313131315,0.12062090472686537,0.18288833742528132,129119.9380547336,-465.70410092045836,128654.23395381315,1670,2,286.1111111111111,38,7,17,37.516424892252715,0.6077302631578947,45.91346153846153,1016.3461538461529,26.745951417004022,0
2172,4,1,0,45,0.022222222222222223,0.0,1.0,45,1750,1400,350,0.8,21,14,7,330.76179636562813,0.44063552188552185,0.13425741188000995,0.18430922099414138,129391.54071015041,-440.4443120388736,128951.09639811153,1671,0,282.02222222222224,38,7,18,37.233321082292,0.6104714912280702,45.646367521367516,1017.4145299145293,26.77406657669814,0
2173,4,1,1,45,0.021739130434782608,0.021739130434782608,0.9782608695652174,46,1600,1000,600,0.625,22,10,12,327.0477354482342,0.4418679549114332,0.15005356436391737,0.18394789536625533,129757.97661675354,-712.5895182291617,129045.38709852438,1672,0,276.8695652173913,39,7,16,36.95610963432504,0.6124465811965811,45.286458333333336,1018.8541666666672,26.124465811965827,0
2174,4,1,0,46,0.021739130434782608,0.0,1.0,46,1850,1300,550,0.7027027027027027,24,13,11,331.30163762959967,0.44064009661835746,0.17190447655192287,0.18812171249750329,130129.69970703138,-577.5634765624848,129552.1362304689,1673,0,277.82608695652175,39,7,17,36.47109494640123,0.6161858974358974,44.92187500000001,1020.312500000001,26.161858974359,0
2175,4,0,2,44,0.0,0.043478260869565216,0.9565217391304348,46,1400,900,500,0.6428571428571429,19,9,10,332.4943392378565,0.4401771336553945,0.16330182863276077,0.18983354732374552,130342.35161675357,-532.3811848958247,129809.97043185774,1674,1,278.82608695652175,39,7,17,36.225411438675245,0.6183226495726496,44.71354166666667,1021.1458333333342,26.18322649572652,0
2176,4,0,0,44,0.0,0.0,1.0,44,800,500,300,0.625,11,5,6,347.81948040809726,0.43702651515151514,0.1752126942574992,0.19774929164069405,130178.65022170285,255.73409606802483,130434.38431777088,1675,2,291.77272727272725,37,7,17,36.00012087675943,0.6202139639639639,44.87390350877193,1020.5043859649124,27.58119962067331,0
2177,4,0,0,44,0.0,0.0,1.0,44,1150,700,450,0.6086956521739131,16,7,9,353.2180698739979,0.43646494009866105,0.18662136832239962,0.2015420751633987,130318.55955678668,406.17401508156354,130724.73357186824,1676,3,292.77272727272725,37,7,17,35.72048611111113,0.6216216216216216,44.73684210526316,1021.0526315789472,27.596017069701276,0
2178,4,0,0,44,0.0,0.0,1.0,44,1500,1000,500,0.6666666666666666,20,10,10,354.315791412625,0.43614561310782246,0.18913382754584473,0.20333886551512736,130542.57079101275,450.65885657126887,130993.22964758403,1677,4,293.77272727272725,37,7,16,35.465396995708154,0.6238738738738738,44.51754385964913,1021.9298245614045,27.619724988146068,0
2179,4,1,0,45,0.022222222222222223,0.0,1.0,45,1500,1000,500,0.6666666666666666,20,10,10,347.23072267884817,0.43764730639730637,0.1929483832793839,0.20093224357071499,130863.1260158706,87.93956370079815,130951.0655795714,1678,0,288.22222222222223,38,7,17,35.32203891267271,0.6252741228070176,44.20405982905984,1023.1837606837622,26.925888439046375,0
2180,4,0,0,45,0.0,0.0,1.0,45,1050,700,350,0.6666666666666666,14,7,7,344.9581809702711,0.4378156565656566,0.1959081419624218,0.20004233496944313,130945.12473518898,34.11840711521958,130979.2431423042,1679,1,289.22222222222223,38,7,17,35.297277313848305,0.6260964912280702,44.12393162393163,1023.5042735042747,26.934322986954598,0
2181,4,0,0,45,0.0,0.0,1.0,45,1650,1200,450,0.7272727272727273,21,12,9,342.2787637796758,0.4373316498316498,0.19000313054367046,0.19891190984236742,131027.14913662452,-30.43787438817543,130996.71126223633,1680,2,290.22222222222223,38,7,17,35.28296636404744,0.6269188596491229,44.04380341880343,1023.8247863247881,26.942757534862846,0
2182,4,1,0,46,0.021739130434782608,0.0,1.0,46,1600,1200,400,0.75,20,12,8,334.42728585847806,0.4375805152979066,0.1909627199739019,0.19615918307444719,131382.8849806415,-412.0503917378853,130970.83458890363,1681,0,284.89130434782606,38,8,18,35.125095525913565,0.6304824561403508,43.6965811965812,1025.213675213676,26.979307242465158,0
2183,4,0,0,46,0.0,0.0,1.0,46,1300,800,500,0.6153846153846154,18,8,10,336.67433754192984,0.4372081320450885,0.19351857723982357,0.19776011577279345,131437.65637555713,-349.66282233909135,131087.99355321802,1682,1,285.89130434782606,38,8,18,35.01228554559979,0.6310307017543859,43.6431623931624,1025.4273504273513,26.98493027440398,0
2184,4,0,1,45,0.0,0.021739130434782608,0.9782608695652174,46,1250,1000,250,0.8,15,10,5,349.6712772026298,0.4367351046698873,0.15115454505163273,0.2006008906057191,130528.5644531249,82.84739200953845,130611.41184513444,1683,2,286.89130434782606,35,11,14,35.59824159021407,0.6276785714285714,44.53124999999999,1021.8749999999992,29.196428571428548,8
2185,4,0,0,45,0.0,0.0,1.0,45,1450,800,650,0.5517241379310345,21,8,13,358.316681577911,0.4343855218855219,0.15725450220863024,0.20556062258943306,130528.5644531249,354.1124131944299,130882.67686631932,1684,6,294.22222222222223,35,10,16,35.37737852531431,0.6276785714285714,44.53124999999999,1021.8749999999992,29.196428571428548,0
2186,4,0,2,43,0.0,0.044444444444444446,0.9555555555555556,45,950,700,250,0.7368421052631579,12,7,5,357.53500076386285,0.43470117845117845,0.1533144689681194,0.20605490748523966,130706.03358892728,346.39636381170635,131052.429952739,1685,7,295.22222222222223,35,10,17,35.2175297113752,0.6294642857142857,44.35763888888888,1022.569444444443,29.2162698412698,0
2187,4,0,0,43,0.0,0.0,1.0,43,1300,1000,300,0.7692307692307693,16,10,6,368.02426083085163,0.4329318936877076,0.1588055006316631,0.21121502484986057,130544.21864487228,1008.6879145040504,131552.90655937634,1686,8,308.06976744186045,33,10,17,35.1134978214814,0.632260101010101,44.515931372549026,1021.9362745098049,30.96776589423651,0
2188,4,0,0,43,0.0,0.0,1.0,43,1450,1200,250,0.8275862068965517,17,12,5,370.50764216431577,0.4323781838316722,0.16550103295995178,0.21343327555662686,130688.28124999987,1084.2013888888732,131772.48263888873,1687,9,309.06976744186045,34,9,17,34.90389839717467,0.6314338235294117,44.37499999999999,1022.499999999999,30.073529411764675,0
2189,4,0,1,42,0.0,0.023255813953488372,0.9767441860465116,43,1550,1300,250,0.8387096774193549,18,13,5,371.6207576057065,0.4324473975636766,0.1571012515698753,0.21458101810135954,130779.5918367347,1120.0821995464821,131899.67403628118,1688,10,310.06976744186045,34,9,17,34.78284062693978,0.6323529411764706,44.285714285714285,1022.8571428571429,30.084033613445378,0
2190,4,0,0,42,0.0,0.0,1.0,42,1050,600,450,0.5714285714285714,15,6,9,370.7052816273368,0.4324186991869919,0.15793812433323628,0.2141368156223793,130794.81336805559,1297.2656250000043,132092.0789930556,1689,11,315.1666666666667,33,9,17,34.79081805838425,0.6347853535353536,44.270833333333336,1022.916666666667,30.997474747474758,0
2191,4,1,0,43,0.023255813953488372,0.0,1.0,43,1450,1200,250,0.8275862068965517,17,12,5,357.1055974983125,0.43452380952380953,0.15510182019647822,0.2083317739981681,131175.63952664405,768.7110260771005,131944.35055272115,1690,0,308.8139534883721,34,9,19,34.753292659306595,0.6363357843137255,43.898809523809526,1024.4047619047624,30.129551820728306,0
2192,4,0,0,43,0.0,0.0,1.0,43,1250,700,550,0.56,18,7,11,357.3292327102391,0.43486987818383166,0.15776234055028238,0.20879380216816232,131236.6230867348,778.9363662131678,132015.55945294796,1691,1,309.8139534883721,34,9,19,34.68591456566362,0.6369485294117647,43.83928571428572,1024.642857142858,30.136554621848767,0
2193,4,0,0,43,0.0,0.0,1.0,43,900,500,400,0.5555555555555556,13,5,8,356.63193530428003,0.43468530823181983,0.15927632235594436,0.20856137088402227,131268.81456832998,762.9302769204455,132031.74484525042,1692,2,310.8139534883721,35,8,19,34.671240870416376,0.6351190476190476,43.807870370370374,1024.7685185185192,29.279100529100546,0
2194,4,0,1,42,0.0,0.023255813953488372,0.9767441860465116,43,1700,1500,200,0.8823529411764706,19,15,4,354.21746871446874,0.43438538205980065,0.14909511316643642,0.208152512514233,131453.76778162256,712.6709671553305,132166.4387487779,1693,3,311.8139534883721,33,10,19,34.546287444231986,0.6414141414141414,43.62745098039216,1025.4901960784323,31.07546048722522,0
2195,4,0,1,41,0.0,0.023809523809523808,0.9761904761904762,42,1250,800,450,0.64,17,8,9,352.3393451518256,0.4318742740998838,0.15787318271790318,0.20773133785993572,131579.47063629387,872.1249038831419,132451.59554017702,1694,4,318.95238095238096,33,9,16,34.46757047300527,0.6426767676767677,43.50490196078432,1025.980392156864,31.09031491384436,0
2196,4,0,0,41,0.0,0.0,1.0,41,1000,700,300,0.7,13,7,6,361.77692781065093,0.43066565040650406,0.16294784240150073,0.21315718190439,131554.70623214464,1318.6914919395924,132873.39772408424,1695,5,325.9756097560976,32,9,17,34.250512820512824,0.6448567708333333,43.5290404040404,1025.883838383838,32.05886994949494,0
2197,4,0,1,40,0.0,0.024390243902439025,0.975609756097561,41,1400,1000,400,0.7142857142857143,18,10,8,365.8610313040398,0.4302845528455284,0.17001170011700095,0.21648109057509807,131716.66953627198,1437.9993112947875,133154.66884756676,1696,6,326.9756097560976,32,9,17,33.98216482164822,0.646484375,43.37121212121213,1026.5151515151529,32.07859848484853,0
2198,4,0,0,40,0.0,0.0,1.0,40,1550,1200,350,0.7741935483870968,19,12,7,364.5764150352298,0.4292067307692307,0.17186157517899758,0.21637042195433617,131831.05656478286,1612.4987985390349,133443.5553633219,1697,7,332.45,33,7,17,33.89966189339697,0.6452020202020202,43.25980392156863,1026.9607843137262,31.120023767082614,0
2199,4,0,0,40,0.0,0.0,1.0,40,1200,900,300,0.75,15,9,6,363.0668504274707,0.42913995726495724,0.16687641655731889,0.21601060377100678,131925.4632382978,1579.5524858227686,133505.01572412055,1698,8,333.45,33,7,18,33.84316970853712,0.6461489898989898,43.16789215686275,1027.3284313725492,31.131164587046946,0
2200,4,0,0,40,0.0,0.0,1.0,40,900,700,200,0.7777777777777778,11,7,4,347.8015346896385,0.42907318376068376,0.14158130601792607,0.20066910574336344,130749.15143140573,1095.7958826912945,131844.94731409702,1699,9,334.45,34,6,19,35.42272921274205,0.632046568627451,44.31547619047618,1022.7380952380938,30.080532212885114,7
2201,4,0,2,38,0.0,0.05,0.95,40,1150,900,250,0.782608695652174,14,9,5,349.7820159314961,0.4288194444444444,0.13970987444859206,0.20251622808450265,130883.62328800141,1156.1475212191224,132039.77080922053,1700,10,335.45,35,5,19,35.23604513064132,0.63125,44.18402777777777,1023.2638888888879,29.236111111111082,0
2202,4,0,0,38,0.0,0.0,1.0,38,1200,900,300,0.75,15,9,6,367.7358955940197,0.42595720720720726,0.14404598165276528,0.21156226489967683,130638.16350682438,2008.0684111880144,132646.2319180124,1701,23,349.7368421052632,33,5,20,35.025573403660204,0.6332070707070707,44.42401960784314,1022.3039215686281,30.97890671420085,0
2203,4,0,0,38,0.0,0.0,1.0,38,1100,800,300,0.7272727272727273,14,8,6,367.0253855507021,0.4258238501659554,0.14876541263284015,0.21166736989776178,130732.14215986658,1996.402976018861,132728.54513588545,1702,24,350.7368421052632,33,5,20,34.94844717395647,0.6341540404040404,44.332107843137265,1022.6715686274524,30.990047534165225,0
2204,4,0,0,38,0.0,0.0,1.0,38,1050,800,250,0.7619047619047619,13,8,5,366.5715008593129,0.42370495495495497,0.15804910936505578,0.21278469400123973,130982.91710219627,2002.9209018166066,132985.83800401288,1703,25,351.7368421052632,33,5,22,34.70596891336445,0.6366792929292929,44.08700980392157,1023.6519607843137,31.019756387403447,0
2205,4,0,0,38,0.0,0.0,1.0,38,1100,800,300,0.7272727272727273,14,8,6,367.56956912562237,0.42336415362731156,0.15360052851794714,0.21426616346591165,131145.15306122456,2040.9934807256286,133186.14654195018,1704,26,352.7368421052632,34,4,22,34.516164962033145,0.6360294117647058,43.92857142857143,1024.285714285715,30.126050420168085,0
2206,4,0,0,38,0.0,0.0,1.0,38,1100,800,300,0.7272727272727273,14,8,6,368.3376577161732,0.4228603603603604,0.1453360399139112,0.21539745636010996,131267.1201814059,2070.12471655329,133337.24489795917,1705,27,353.7368421052632,34,4,22,34.37306381660472,0.6372549019607843,43.80952380952381,1024.7619047619046,30.14005602240896,0
2207,4,0,0,38,0.0,0.0,1.0,38,950,500,450,0.5263157894736842,14,5,9,366.84513186595285,0.42317152678994785,0.13992297817715027,0.21486643437862962,131328.1250000001,2035.4308390022813,133363.55583900237,1706,28,354.7368421052632,34,4,23,34.34959349593497,0.6378676470588236,43.75000000000001,1025.0000000000007,30.14705882352943,0
2208,4,0,0,38,0.0,0.0,1.0,38,750,500,250,0.6666666666666666,10,5,5,366.84513186595285,0.42317152678994785,0.13992297817715027,0.21486643437862962,131328.1250000001,2035.4166666666804,133363.54166666677,1707,29,355.7368421052632,34,4,23,34.34959349593497,0.6378676470588236,43.75000000000001,1025.0000000000007,30.14705882352943,0
2209,4,0,1,37,0.0,0.02631578947368421,0.9736842105263158,38,850,600,250,0.7058823529411765,11,6,5,364.3593500999322,0.42243065433854904,0.1384794313742006,0.21431506161200234,131489.9488094328,1981.9184585756675,133471.86726800847,1708,30,356.7368421052632,32,6,23,34.24971274980508,0.6442057291666667,43.59217171717172,1025.6313131313138,32.05097853535356,0
2210,4,0,1,36,0.0,0.02702702702702703,0.972972972972973,37,950,800,150,0.8421052631578947,11,8,3,370.4318924023219,0.42282907907907913,0.1419570916777615,0.21772549138512617,131461.6224500869,2339.5155164930634,133801.13796657996,1709,31,363.0810810810811,31,6,24,34.12265109192483,0.646505376344086,43.61979166666667,1025.5208333333342,33.0813172043011,0
2211,4,0,0,36,0.0,0.0,1.0,36,850,600,250,0.7058823529411765,11,6,5,372.4004541636534,0.42146164021164023,0.128207368574341,0.2189072007140736,131465.929948549,2591.594403977341,134057.52435252632,1710,32,349.55555555555554,30,6,24,34.06782437745741,0.6493055555555556,43.615591397849464,1025.5376344086023,34.18458781362008,0
2212,4,0,0,36,0.0,0.0,1.0,36,800,600,200,0.75,10,6,4,370.3697026703376,0.4204034391534392,0.12552510643096793,0.21883463241736154,131661.9957817926,2552.7228461371615,134214.71862792975,1711,33,350.55555555555554,31,5,19,33.9216992303138,0.648521505376344,43.42447916666667,1026.302083333334,33.10651881720432,0
2213,4,0,0,36,0.0,0.0,1.0,36,1150,800,350,0.6956521739130435,15,8,7,371.2135825444101,0.4202546296296296,0.13556372756220547,0.2201045347327232,131795.66277398012,2584.8680284288234,134380.53080240893,1712,34,351.55555555555554,31,5,19,33.76500549496998,0.6498655913978495,43.294270833333336,1026.8229166666672,33.123319892473134,0
2214,4,0,0,36,0.0,0.0,1.0,36,800,500,300,0.625,11,5,6,371.86282282514185,0.4196924603174603,0.1413952604232671,0.22146185169156168,131962.84188164596,2614.4149780273383,134577.2568596733,1713,35,352.55555555555554,31,5,19,33.57952625353778,0.6515456989247312,43.131510416666664,1027.4739583333328,33.14432123655912,0
2215,4,1,0,37,0.02702702702702703,0.0,1.0,37,950,600,350,0.631578947368421,13,6,7,360.0718268954699,0.42201576576576577,0.1369599405445221,0.21599006641314414,132235.6216840118,2122.8643760840646,134358.48606009586,1714,0,344.0,32,5,20,33.60749652181029,0.6516927083333333,42.86616161616161,1028.5353535353531,32.141729797979785,0
2216,4,0,1,36,0.0,0.02702702702702703,0.972972972972973,37,850,600,250,0.7058823529411765,11,6,5,357.4407193401871,0.42173423423423423,0.13698330210124388,0.21461783963816372,132271.9101427335,2055.873341983847,134327.78348471737,1715,1,345.0,33,4,20,33.63861091255658,0.6496212121212122,42.830882352941174,1028.676470588235,31.172014260249544,0
2217,4,0,0,36,0.0,0.0,1.0,36,1050,800,250,0.7619047619047619,13,8,5,365.4449860140557,0.4196097883597884,0.1386902397033507,0.21869354013251968,132145.87688629373,2458.4096261053432,134604.28651239906,1716,2,354.1111111111111,33,3,20,33.559793404847056,0.6483585858585859,42.95343137254902,1028.1862745098038,31.157159833630416,0
2218,4,0,0,36,0.0,0.0,1.0,36,850,500,350,0.5882352941176471,12,5,7,363.6399694167362,0.4193121693121693,0.14143730886850192,0.2181579888001907,132240.39619677534,2417.578725730499,134657.97492250585,1717,3,355.1111111111111,33,3,20,33.51093669327615,0.6493055555555556,42.86151960784314,1028.553921568628,31.16830065359479,0
2219,4,0,1,35,0.0,0.027777777777777776,0.9722222222222222,36,850,400,450,0.47058823529411764,13,4,9,360.42001517537335,0.41886574074074073,0.13614254516577318,0.21658740353595277,132303.42784325735,2336.960694204146,134640.3885374615,1718,4,356.1111111111111,33,3,20,33.53025114155251,0.6499368686868687,42.80024509803921,1028.7990196078429,31.175727866904328,0
2220,4,0,0,35,0.0,0.0,1.0,35,750,400,350,0.5333333333333333,11,4,7,366.4888163079831,0.4193627450980392,0.13776274038882974,0.22040718554197433,132333.0388002499,2699.7157496683944,135032.7545499183,1719,5,361.9714285714286,32,3,20,33.344326502229315,0.6526692708333333,42.77146464646464,1028.9141414141409,32.1535669191919,0
2221,4,0,0,35,0.0,0.0,1.0,35,1000,700,300,0.7,13,7,6,365.3342918938304,0.41911764705882354,0.14046474648549023,0.2204834283750094,132465.01498752166,2678.818432485161,135143.83342000682,1720,6,362.9714285714286,31,4,20,33.24110380301879,0.6565860215053764,42.643229166666664,1029.427083333333,33.20732526881719,0
2222,4,0,0,35,0.0,0.0,1.0,35,1350,900,450,0.6666666666666666,18,9,9,364.8408506644424,0.41845238095238096,0.1399222498511543,0.22112716639825544,132625.50536934994,2677.4404397510307,135302.94580910096,1721,7,363.9714285714286,32,3,19,33.092261175124634,0.6555989583333333,42.48737373737373,1030.050505050504,32.18907828282825,0
2223,4,0,0,35,0.0,0.0,1.0,35,850,600,250,0.7058823529411765,11,6,5,365.63524946975616,0.41810224089635856,0.13779123706828678,0.22218535152067617,132723.06596584534,2705.646266962556,135428.71223280788,1722,8,364.9714285714286,32,3,19,32.9736449781481,0.6565755208333333,42.39267676767677,1030.429292929293,32.20091540404041,0
2224,4,0,0,35,0.0,0.0,1.0,35,550,300,250,0.5454545454545454,8,3,5,364.37589676213787,0.417436974789916,0.14051235388814987,0.22199737471388764,132820.6624324049,2679.329596469751,135499.99202887467,1723,9,365.9714285714286,32,3,20,32.90793932712724,0.6575520833333333,42.2979797979798,1030.808080808081,32.21275252525253,0
2225,4,1,0,36,0.027777777777777776,0.0,1.0,36,600,300,300,0.5,9,3,6,355.83231516617167,0.41904761904761906,0.13785336446502328,0.21893174511648383,133187.44781153876,2278.4795811706945,135465.92739270945,1724,0,356.77777777777777,33,3,21,32.759878705132785,0.6587752525252526,41.94240196078431,1032.230392156862,31.279708853238244,0
2226,4,0,0,36,0.0,0.0,1.0,36,900,500,400,0.5555555555555556,13,5,8,354.4108682629392,0.41917989417989415,0.12797819179093728,0.21880002834079007,133313.97667063135,2249.5844446847227,135563.5611153161,1725,1,357.77777777777777,33,3,22,32.66966793243938,0.6600378787878788,41.819852941176464,1032.720588235293,31.294563279857364,0
2227,4,0,0,36,0.0,0.0,1.0,36,1100,800,300,0.7272727272727273,14,8,6,356.4150515936843,0.41879960317460313,0.12892447607750124,0.22060050550181773,133408.91273788922,2309.7889033064175,135718.70164119563,1726,2,358.77777777777777,33,3,23,32.52273625939106,0.6609848484848485,41.72794117647059,1033.0882352941173,31.30570409982174,0
2228,4,0,0,36,0.0,0.0,1.0,36,1300,900,400,0.6923076923076923,17,9,8,356.52033299330765,0.4186177248677249,0.12593316502429652,0.221432127912232,133537.46588358344,2321.7793790417395,135859.2452626252,1727,3,359.77777777777777,32,4,23,32.391175991530254,0.6647135416666667,41.603535353535364,1033.5858585858596,32.29955808080811,0
2229,4,0,0,36,0.0,0.0,1.0,36,1100,700,400,0.6363636363636364,15,7,8,359.1992666714235,0.41808862433862437,0.13000054279976125,0.22348963491684048,133602.72548719545,2398.000204060842,136000.7256912563,1728,4,360.77777777777777,32,4,23,32.25655430711611,0.6653645833333333,41.540404040404056,1033.8383838383859,32.30744949494956,0
2230,4,0,0,36,0.0,0.0,1.0,36,1400,1100,300,0.7857142857142857,17,11,6,356.5935176658205,0.41722883597883603,0.13550552922590842,0.22260719593931413,133725.61034217622,2337.1371587850977,136062.74750096133,1729,5,361.77777777777777,33,3,19,32.200829383886266,0.6641414141414141,41.42156862745099,1034.3137254901972,31.342840166369612,0
2231,4,0,1,35,0.0,0.027777777777777776,0.9722222222222222,36,550,300,250,0.5454545454545454,8,3,5,357.0301828477898,0.41693121693121693,0.13919160809708098,0.2232628743408182,133788.99491782027,2353.3418637062946,136142.33678152657,1730,6,362.77777777777777,33,3,19,32.12607596935956,0.6647727272727273,41.36029411764707,1034.5588235294133,31.35026737967919,0
2232,4,0,0,35,0.0,0.0,1.0,35,1200,1000,200,0.8333333333333334,14,10,4,357.2336155214315,0.41526610644257705,0.13175411583560348,0.22358216574110085,133820.6928374906,2561.0499867839562,136381.74282427458,1731,7,368.2,33,2,19,32.08908267203602,0.6650883838383839,41.32965686274511,1034.6813725490213,31.353980986333976,0
2233,4,0,0,35,0.0,0.0,1.0,35,1300,900,400,0.6923076923076923,17,9,8,360.5131796817123,0.41372549019607846,0.12727795343489556,0.2268038611415328,134010.9592013888,2662.5434027777687,136673.50260416657,1732,8,369.2,33,2,19,31.813799463447346,0.6669823232323233,41.14583333333333,1035.4166666666658,31.3762626262626,0
2234,4,0,0,35,0.0,0.0,1.0,35,800,500,300,0.625,11,5,6,359.93033230661297,0.4127450980392157,0.1236179749454085,0.2271032502828021,134118.83680555562,2654.68750000001,136773.52430555562,1733,9,370.2,34,1,19,31.720970769643333,0.6657475490196079,41.04166666666667,1035.833333333334,30.46568627450982,0
2235,4,0,1,34,0.0,0.02857142857142857,0.9714285714285714,35,1050,700,350,0.6666666666666666,14,7,7,358.79590519571803,0.4121498599439776,0.12068014705882346,0.22695927026333798,134211.33786848077,2630.895691609985,136842.23356009077,1734,10,371.2,34,1,19,31.657858455882366,0.6666666666666667,40.952380952380956,1036.1904761904766,30.47619047619049,0
2236,4,0,1,33,0.0,0.029411764705882353,0.9705882352941176,34,550,300,250,0.5454545454545454,8,3,5,364.96428801095004,0.40847816399286985,0.12273340848049674,0.23059851202126838,134169.61775519027,2993.4238033448664,137163.04155853513,1735,11,382.52941176470586,33,1,21,31.539803643245804,0.6685606060606061,40.99264705882353,1036.0294117647056,31.394830659536535,0
2237,4,0,0,33,0.0,0.0,1.0,33,800,400,400,0.5,12,4,8,375.19721979812203,0.40502683080808083,0.13733877044457254,0.23677830701721475,134125.3762371186,3464.6936537087927,137590.06989082738,1736,58,394.7878787878788,32,1,21,31.31907199739964,0.6705729166666667,41.03535353535353,1035.8585858585852,32.37058080808079,0
2238,4,1,0,34,0.029411764705882353,0.0,1.0,34,800,500,300,0.625,11,5,6,376.7647590584807,0.4065470885323827,0.11310625694187348,0.21791040989656468,130843.25140610668,3060.7723382818285,133904.0237443885,1737,0,384.1470588235294,32,2,18,34.586727138097,0.6376953125,44.22348484848486,1023.1060606060619,31.972064393939434,8
2239,4,0,0,34,0.0,0.0,1.0,34,850,600,250,0.7058823529411765,11,6,5,377.6132053401238,0.40717840166369573,0.1197152436103972,0.2189508327959262,130940.15438475687,3088.9462809917577,134029.1006657486,1738,1,385.1470588235294,32,2,18,34.4667530224525,0.638671875,44.12878787878789,1023.4848484848501,31.983901515151565,0
2240,4,0,0,34,0.0,0.0,1.0,34,600,200,400,0.3333333333333333,10,2,8,377.6132053401238,0.40689988116458703,0.1197152436103972,0.2189508327959262,130940.15438475687,3088.9462809917577,134029.1006657486,1739,2,386.1470588235294,32,2,18,34.4667530224525,0.638671875,44.12878787878789,1023.4848484848501,31.983901515151565,0
2241,4,1,0,35,0.02857142857142857,0.0,1.0,35,1050,800,250,0.7619047619047619,13,8,5,366.1790634917854,0.4105742296918768,0.12141063956963549,0.21465226812255006,131359.5300635575,2620.2219398789202,133979.7520034364,1740,0,376.0857142857143,33,2,20,34.334902370990235,0.6404671717171717,43.71936274509805,1025.1225490196096,31.064319667260897,0
2242,4,0,0,35,0.0,0.0,1.0,35,700,500,200,0.7142857142857143,9,5,4,366.4691241146971,0.4106792717086835,0.12590278133483634,0.21517523940124014,131422.35145436856,2632.446805315275,134054.79825968383,1741,1,377.0857142857143,33,2,20,34.26394864746425,0.6410984848484849,43.65808823529412,1025.367647058824,31.071746880570426,0
2243,4,0,0,35,0.0,0.0,1.0,35,900,600,300,0.6666666666666666,12,6,6,364.68356435982747,0.41011904761904766,0.12613756613756633,0.21465551573078456,131516.61169982704,2592.389345444069,134109.0010452711,1742,2,378.0857142857143,33,2,20,34.21445639187575,0.6420454545454546,43.56617647058824,1025.7352941176475,31.082887700534773,0
2244,4,0,0,35,0.0,0.0,1.0,35,950,700,250,0.7368421052631579,12,7,5,362.6122521719759,0.4094887955182073,0.12853901918976596,0.2143174038066548,131673.7872002355,2549.30570573818,134223.09290597367,1743,3,379.0857142857143,33,2,18,34.10883084577115,0.6436237373737373,43.41299019607843,1026.3480392156864,31.101455733808677,0
2245,4,0,0,35,0.0,0.0,1.0,35,1200,800,400,0.6666666666666666,16,8,8,360.9226520070613,0.4090336134453782,0.12830883606725108,0.21384794756118514,131768.1375552671,2511.6211312956407,134279.75868656274,1744,4,380.0857142857143,33,2,19,34.05695472268639,0.6445707070707071,43.32107843137254,1026.715686274509,31.112596553773,0
2246,4,0,0,35,0.0,0.0,1.0,35,1100,700,400,0.6363636363636364,15,7,8,359.38113926215607,0.40735294117647064,0.1303211517165006,0.21417276849418476,131988.41979346887,2486.8297349577133,134475.2495284266,1745,5,381.0857142857143,33,2,19,33.874354005167966,0.646780303030303,43.106617647058826,1027.5735294117649,31.13859180035651,0
2247,4,0,0,35,0.0,0.0,1.0,35,800,500,300,0.625,11,5,6,359.1684527077684,0.40728291316526616,0.13024428469217408,0.21422380116695197,132019.90370290267,2483.47690792002,134503.3806108227,1746,6,382.0857142857143,33,2,20,33.848080133555925,0.6470959595959596,43.07598039215686,1027.696078431372,31.14230540701127,0
2248,4,0,0,35,0.0,0.0,1.0,35,1050,600,450,0.5714285714285714,15,6,9,360.11388139885014,0.40682773109243703,0.13464570951756571,0.2153239737031328,132114.37795859764,2515.244287053057,134629.6222456507,1747,7,383.0857142857143,33,2,21,33.72856816466007,0.6480429292929293,42.98406862745098,1028.063725490196,31.153446226975635,0
2249,4,0,0,35,0.0,0.0,1.0,35,800,400,400,0.5,12,4,8,358.01380587622145,0.4072478991596639,0.13047800626446948,0.2146037042080893,132208.88600538252,2466.521289888502,134675.40729527103,1748,8,384.0857142857143,33,2,21,33.68734111852558,0.648989898989899,42.8921568627451,1028.4313725490194,31.16458704693998,0
2250,4,0,0,35,0.0,0.0,1.0,35,850,600,250,0.7058823529411765,11,6,5,358.45849977802953,0.4070728291316527,0.13202251968771805,0.216130146420364,132429.5361910083,2494.0985738658255,134923.63476487412,1749,9,385.0857142857143,33,2,23,33.453759376116196,0.651199494949495,42.677696078431374,1029.2892156862747,31.190582293523477,0
2251,4,0,0,35,0.0,0.0,1.0,35,950,900,50,0.9473684210526315,10,9,1,360.5352361616518,0.40700280112044823,0.13163799551234145,0.21829525394110408,132587.25610342188,2560.47553825453,135147.73164167642,1750,10,386.0857142857143,33,2,23,33.24161113755354,0.6527777777777778,42.524509803921575,1029.9019607843145,31.20915032679741,0
2252,4,0,0,35,0.0,0.0,1.0,35,850,300,550,0.35294117647058826,14,3,11,363.0132227416444,0.40633753501400566,0.1361058729592448,0.22072148879497375,132745.06987997395,2637.6431240388247,135382.71300401277,1751,11,387.0857142857143,33,2,20,33.01906191778651,0.6543560606060606,42.37132352941176,1030.5147058823522,31.22771836007128,0
2253,4,0,0,35,0.0,0.0,1.0,35,1000,500,500,0.5,15,5,10,360.16732986429963,0.4064775910364146,0.13633477633477664,0.2201022571392941,132934.57031249988,2575.7378472222085,135510.3081597221,1752,12,388.0857142857143,33,2,20,32.90193602693602,0.65625,42.18749999999999,1031.249999999999,31.24999999999997,0
2254,4,0,0,35,0.0,0.0,1.0,35,1100,900,200,0.8181818181818182,13,9,4,394.1196559101654,0.40668767507002807,0.16422997292562513,0.22234297569271602,129876.19447314051,3379.496312557396,133255.6907856979,1753,13,389.0857142857143,32,3,18,35.12712126842561,0.6279296875,45.17045454545455,1019.318181818182,31.853693181818187,8
2255,4,0,0,35,0.0,0.0,1.0,35,600,400,200,0.6666666666666666,8,4,4,394.87252825197197,0.4062675070028012,0.16990712074303405,0.22313475616757705,129940.55333958282,3261.9909639322664,133202.54430351508,1754,14,390.0857142857143,32,3,19,35.0423116615067,0.6285807291666667,45.10732323232324,1019.5707070707081,31.861584595959627,0
2256,4,0,0,35,0.0,0.0,1.0,35,1200,1000,200,0.8333333333333334,14,10,4,395.24980457786273,0.4053571428571428,0.16584796562516613,0.2240858365743546,130069.31889921949,3281.974575298446,133351.29347451794,1755,15,391.0857142857143,32,3,21,34.90144201014978,0.6298828125,44.98106060606061,1020.0757575757578,31.877367424242433,0
2257,4,0,0,35,0.0,0.0,1.0,35,1000,800,200,0.8,12,8,4,397.660066942338,0.40444677871148454,0.17063272901908988,0.22639170865090444,130231.31315179258,3357.5585411860798,133588.87169297866,1756,16,392.0857142857143,33,2,22,34.674905951094566,0.6291035353535354,44.822303921568626,1020.7107843137254,30.930629827688648,0
2258,4,0,0,35,0.0,0.0,1.0,35,1200,900,300,0.75,15,9,6,397.1676021289986,0.4047619047619047,0.16310480665618532,0.22666862374151112,130327.04132550256,3352.339453728909,133679.38077923146,1757,17,393.0857142857143,32,3,22,34.58997980297597,0.6324869791666667,44.72853535353536,1021.0858585858591,31.908933080808097,0
2259,4,0,0,35,0.0,0.0,1.0,35,1250,1000,250,0.8,15,10,5,398.8363298552596,0.4042366946778711,0.16531167225852061,0.22818853667107838,130423.75299714308,3403.546194265885,133827.29919140897,1758,18,394.0857142857143,32,3,22,34.4489081170169,0.6334635416666667,44.63383838383838,1021.464646464646,31.920770202020186,0
2260,4,0,0,35,0.0,0.0,1.0,35,900,600,300,0.6666666666666666,12,6,6,395.90471408317575,0.4043067226890756,0.16809006211180133,0.22764521059782608,130617.28395061727,3342.399691358022,133959.6836419753,1759,19,395.0857142857143,32,3,18,34.32687952898551,0.6354166666666667,44.44444444444444,1022.2222222222222,31.944444444444443,0
2261,4,0,0,35,0.0,0.0,1.0,35,700,700,0,1.0,7,7,0,396.071330589849,0.40420168067226886,0.17056084656084636,0.22850269072491286,130746.3842975206,3356.978879706143,134103.36317722674,1760,20,396.0857142857143,32,3,19,34.19135802469137,0.63671875,44.31818181818181,1022.7272727272723,31.96022727272726,0
2262,4,0,0,35,0.0,0.0,1.0,35,1200,900,300,0.75,15,9,6,396.3359930454817,0.4043067226890756,0.17741577193631985,0.22922987520681923,130843.25140610647,3371.57799586776,134214.82940197425,1761,21,397.0857142857143,32,3,19,34.086140935455994,0.6376953125,44.223484848484844,1023.1060606060602,31.97206439393938,0
2263,4,0,0,35,0.0,0.0,1.0,35,800,600,200,0.75,10,6,4,368.92390177408936,0.40427170868347334,0.10836319383408788,0.19153223696527047,126552.40929705213,2363.7910002155054,128916.20029726764,1762,22,398.0857142857143,34,1,19,39.17218804227795,0.5894607843137255,48.45238095238095,1006.190476190476,29.593837535014,8
2264,4,3,0,38,0.07894736842105263,0.0,1.0,38,600,400,200,0.6666666666666666,8,4,4,348.4955413988636,0.41657776197249885,0.13049301382755374,0.18493157561822904,127442.37075617281,1284.9155171327754,128727.28627330558,1763,0,367.57894736842104,35,3,18,38.772352132049505,0.5964285714285714,47.56944444444444,1009.7222222222221,28.849206349206344,0
2265,4,0,0,38,0.0,0.0,1.0,38,1100,800,300,0.7272727272727273,14,8,6,348.0497396110107,0.41678520625889043,0.1321215409658163,0.1854990370454287,127617.73003472216,1283.463541666656,128901.19357638882,1764,1,368.57894736842104,35,3,19,38.60395189003436,0.5982142857142857,47.39583333333333,1010.4166666666661,28.869047619047603,0
2266,4,1,2,37,0.02564102564102564,0.05128205128205128,0.9487179487179487,39,800,500,300,0.625,11,5,6,343.6808386830457,0.4197593342330184,0.14955597790448283,0.18481857688619713,127978.0557479223,996.7211064942919,128974.7768544166,1765,0,360.1025641025641,37,2,20,38.34570510041903,0.597972972972973,47.03947368421052,1011.8421052631568,27.347083926031264,0
2267,4,1,0,38,0.02631578947368421,0.0,1.0,38,800,400,400,0.5,12,4,8,345.74467060703097,0.4225640113798008,0.12789103680025216,0.1774113842020823,126072.89422850241,1123.7335620569856,127196.62779055939,1766,0,347.9736842105263,35,3,20,40.24876589451039,0.5824404761904762,48.92939814814816,1004.2824074074089,28.69378306878311,8
2268,4,3,0,41,0.07317073170731707,0.0,1.0,41,1250,900,350,0.72,16,9,7,325.2555808328149,0.43119918699186993,0.15096086697876498,0.17020866410951435,126876.64936262708,53.46765651254407,126930.11701913962,1767,0,323.4390243902439,38,3,22,39.93814068575468,0.5849780701754386,48.13034188034189,1007.4786324786337,26.512595591542993,0
2269,4,2,0,43,0.046511627906976744,0.0,1.0,43,1500,1300,200,0.8666666666666667,17,13,4,310.34508758626544,0.4368770764119601,0.15863453333685062,0.16508043413735726,127538.80343967043,-683.6091467858201,126855.19429288461,1768,0,309.3488372093023,39,4,18,39.63693668144791,0.5900106837606838,47.47395833333335,1010.104166666669,25.9001068376069,0
2270,4,2,1,44,0.044444444444444446,0.022222222222222223,0.9777777777777777,45,1400,900,500,0.6428571428571429,19,9,10,305.67795722163925,0.4396675084175084,0.1924004358676934,0.1657372251762612,128306.84222961882,-1151.5803009173464,127155.26192870148,1769,0,296.55555555555554,38,7,21,38.97237161235896,0.5995065789473684,46.7147435897436,1013.1410256410269,26.66160593792176,0
2271,4,3,2,45,0.06382978723404255,0.0425531914893617,0.9574468085106383,47,1150,800,350,0.6956521739130435,15,8,7,293.37844640608097,0.4433009559050262,0.20013388829059542,0.1612478528743199,128848.62075617306,-1839.7183641975125,127008.90239197554,1770,0,284.82978723404256,41,6,16,38.734040127678966,0.6001016260162602,46.180555555555564,1015.2777777777795,24.76287262872633,0
2272,4,1,3,43,0.021739130434782608,0.06521739130434782,0.9347826086956522,46,1250,900,350,0.72,16,9,7,305.0635673196858,0.4381541867954912,0.2204614587911724,0.1677429885025307,128865.81776926779,-1337.546785147715,127528.27098412007,1771,0,292.0,40,6,17,38.419994661862354,0.6018229166666667,46.16361788617887,1015.3455284552858,25.383638211382145,0
2273,4,0,1,42,0.0,0.023255813953488372,0.9767441860465116,43,900,600,300,0.6666666666666666,12,6,6,328.5221625409128,0.43133997785160577,0.14875655045727143,0.1750329065436288,127604.23657909637,-192.09749318527764,127412.13908591108,1772,1,313.06976744186045,38,5,16,39.11102005569067,0.5923793859649122,47.409188034188034,1010.363247863248,26.588506522717054,8
2274,4,2,2,42,0.045454545454545456,0.045454545454545456,0.9545454545454546,44,1300,600,700,0.46153846153846156,20,6,14,325.72122726447486,0.4363548273431994,0.1703586201733207,0.17519689931600835,127986.37695312512,-462.4240451388734,127523.95290798624,1773,0,306.8863636363636,39,5,18,38.79152082904402,0.594551282051282,47.03125000000001,1011.8750000000009,25.945512820512842,0
2275,4,1,0,43,0.023255813953488372,0.0,1.0,43,1350,1000,350,0.7407407407407407,17,10,7,330.40356314247475,0.43343946105574016,0.19733945832137012,0.17841792409693663,128144.53125000026,-132.11805555552553,128012.41319444474,1774,0,314.83720930232556,40,3,19,38.51165980795614,0.59453125,46.875000000000014,1012.500000000002,25.31250000000005,0
2276,4,1,1,43,0.022727272727272728,0.022727272727272728,0.9772727272727273,44,950,800,150,0.8421052631578947,11,8,3,340.63337630023386,0.43675123326286114,0.18281010165368183,0.17673523441428676,126527.07151955967,-180.1312869822341,126346.94023257744,1775,0,308.65909090909093,38,6,15,39.909870447063795,0.5814144736842105,48.47756410256411,1006.089743589745,26.476045883940657,8
2277,4,2,2,43,0.044444444444444446,0.044444444444444446,0.9555555555555556,45,1450,900,550,0.6206896551724138,20,9,11,342.91084638035045,0.43796296296296294,0.2163229755178906,0.18064053514679176,127145.88355613998,-278.80106746292495,126867.08248867706,1776,0,302.73333333333335,38,7,17,39.217205155367225,0.5877192982456141,47.863247863247864,1008.5470085470087,26.54071075123707,0
2278,4,0,0,43,0.0,0.0,1.0,43,1050,600,450,0.5714285714285714,15,6,9,340.5806607645452,0.433577888519749,0.16760159845193479,0.17476158447391815,126072.89422850209,105.61010548182435,126178.50433398392,1777,1,317.6744186046512,35,8,21,40.37841900042256,0.5824404761904762,48.92939814814814,1004.2824074074063,28.693783068783034,8
2279,4,2,1,44,0.044444444444444446,0.022222222222222223,0.9777777777777777,45,1000,700,300,0.7,13,7,6,329.07833084238706,0.43869949494949495,0.18924809211083393,0.17206844766357443,126843.3691736878,-651.7191587796488,126191.65001490814,1778,0,304.5111111111111,37,8,21,39.875979645150764,0.5864301801801801,48.163377192982445,1007.346491228068,27.225580844001836,0
2280,4,2,0,46,0.043478260869565216,0.0,1.0,46,1300,900,400,0.6923076923076923,17,9,8,327.38033296186205,0.4399255233494364,0.22848513844865725,0.1737266438418058,127442.37075617303,-854.8444526734485,126587.52630349957,1779,0,298.7826086956522,35,11,19,39.305364511691884,0.5964285714285714,47.56944444444446,1009.7222222222238,28.849206349206394,0
2281,4,0,1,45,0.0,0.021739130434782608,0.9782608695652174,46,1600,1200,400,0.75,20,12,8,326.63350498891106,0.439200885668277,0.22333464466941821,0.1742111870530352,127646.9683025765,-861.2446684241891,126785.72363415231,1780,1,299.7826086956522,35,11,20,39.115054594739064,0.5985119047619047,47.36689814814816,1010.532407407409,28.872354497354543,0
2282,4,2,1,46,0.0425531914893617,0.02127659574468085,0.9787234042553191,47,1650,1300,350,0.7878787878787878,20,13,7,322.7888128187497,0.43983194572926304,0.24882114186910176,0.17443355919402354,128173.82979948989,-1124.4164737654319,127049.41332572445,1781,0,294.06382978723406,35,12,22,38.67453899493276,0.6038690476190476,46.84606481481482,1012.6157407407408,28.931878306878307,0
2283,4,0,1,45,0.0,0.021739130434782608,0.9782608695652174,46,1350,800,550,0.5925925925925926,19,8,11,347.6215778880344,0.4378321256038647,0.2211279180256298,0.182205365747505,126942.00857426279,-297.7587971274204,126644.24977713537,1782,1,301.3478260869565,34,12,19,39.307688521362465,0.5934436274509804,48.065476190476176,1007.7380952380931,29.639355742296857,7
2284,4,2,2,45,0.0425531914893617,0.0425531914893617,0.9574468085106383,47,1250,800,450,0.64,17,8,9,337.82952972212615,0.4393886833179155,0.24757289836032048,0.17992153538404113,127588.49511584766,-779.367739411894,126809.12737643576,1783,0,295.8723404255319,35,12,15,38.89203135143392,0.5979166666666667,47.424768518518505,1010.3009259259239,28.865740740740684,0
2285,4,1,0,46,0.021739130434782608,0.0,1.0,46,1400,1100,300,0.7857142857142857,17,11,6,346.16406583838295,0.4382648953301127,0.2609848310203333,0.1844252621952512,127602.69451530596,-365.7064909297226,127236.98802437625,1784,0,303.19565217391306,34,12,17,38.6669808727073,0.6001838235294117,47.41071428571428,1010.3571428571415,29.71638655462181,0
2286,4,0,0,46,0.0,0.0,1.0,46,1250,1000,250,0.8,15,10,5,348.93354420271214,0.4382145732689211,0.26526040359869585,0.18645655908277067,127723.00347222213,-286.6319444444497,127436.37152777768,1785,1,304.19565217391306,34,12,18,38.473825226710645,0.6014093137254901,47.291666666666664,1010.8333333333326,29.730392156862724,0
2287,4,0,0,46,0.0,0.0,1.0,46,1550,1200,350,0.7741935483870968,19,12,7,404.999158132051,0.43800322061191627,0.33803083149178637,0.20324635071593056,125153.23320657897,996.0713727892755,126149.30457936824,1786,2,305.19565217391306,33,13,17,39.71563074096752,0.5773358585858586,49.84681372549018,1000.6127450980372,30.321598336304156,8
2288,4,2,1,47,0.041666666666666664,0.020833333333333332,0.9791666666666666,48,1150,800,350,0.6956521739130435,15,8,7,385.529309920288,0.4421634899527187,0.3260298869143785,0.19629829610864918,125753.44676997575,96.32791066526283,125849.77468064101,1787,0,293.4375,35,13,18,39.58044849603815,0.5791666666666666,49.24768518518517,1003.0092592592572,28.657407407407348,0
2289,4,1,1,47,0.020833333333333332,0.020833333333333332,0.9791666666666666,48,1150,900,250,0.782608695652174,14,9,5,380.1319548696808,0.44352098108747046,0.3416512501401514,0.19518692604966473,126100.38406227142,-13.042899318269235,126087.34116295315,1788,0,294.0,36,12,19,39.356990694024,0.5807291666666667,48.90202702702701,1004.3918918918893,27.899774774774702,0
2290,4,1,0,48,0.020833333333333332,0.0,1.0,48,1100,700,400,0.6363636363636364,15,7,8,380.8544765889219,0.4432624113475177,0.3406387706326093,0.19650329815217973,126298.39932838212,20.262154045899365,126318.66148242801,1789,0,294.4583333333333,36,12,15,39.13427066995294,0.5827546296296297,48.704954954954935,1005.1801801801776,27.9216716716716,0
2291,4,2,2,48,0.04,0.04,0.96,50,1500,900,600,0.6,21,9,12,367.0104968898579,0.4461904761904762,0.3339713831478546,0.19269582850060088,127011.23078977603,-677.1090154504091,126334.12177432563,1790,0,283.64,38,12,17,38.74801271860093,0.5863486842105263,47.99679487179485,1008.012820512817,26.52665317138992,0
2292,4,1,0,49,0.02040816326530612,0.0,1.0,49,1750,1500,250,0.8571428571428571,20,15,5,378.0479475445664,0.4438775510204082,0.3439028503963564,0.1988860941430111,127092.01388888898,-190.59931788296268,126901.41457100601,1791,0,290.2857142857143,36,13,21,38.386707988980696,0.5908564814814814,47.91666666666667,1008.3333333333342,28.00925925925928,0
2293,4,0,1,48,0.0,0.02040816326530612,0.9795918367346939,49,1350,1000,350,0.7407407407407407,17,10,7,374.99841941104677,0.44394841269841273,0.3361494704088852,0.19786653836171947,127212.08191609997,-259.1340702947625,126952.9478458052,1792,1,291.2857142857143,34,15,21,38.34006962473447,0.5962009803921569,47.79761904761906,1008.8095238095254,29.670868347338985,0
2294,4,0,0,48,0.0,0.0,1.0,48,850,500,350,0.5882352941176471,12,5,7,382.8290417321219,0.442505171394799,0.3446969696969693,0.20140136543298598,127092.01388888898,130.90277777778581,127222.91666666676,1793,2,298.1875,36,12,21,38.26618457300274,0.5908564814814814,47.91666666666667,1008.3333333333342,28.00925925925928,0
2295,4,3,2,49,0.058823529411764705,0.0392156862745098,0.9607843137254902,51,950,700,250,0.7368421052631579,12,7,5,358.2639594652561,0.4485294117647059,0.35000892424590146,0.19266082855159575,127978.05574792247,-1030.015004616802,126948.04074330567,1794,0,281.5882352941176,37,14,18,37.976809709579534,0.597972972972973,47.03947368421053,1011.8421052631581,27.347083926031303,0
2296,4,1,2,48,0.02,0.04,0.96,50,1500,1000,500,0.6666666666666666,20,10,10,357.11152108381293,0.44747448979591836,0.3402955145118729,0.19258006045925632,128090.45041867575,-851.4848829351813,127238.96553574057,1795,0,281.82,38,12,19,37.89094107299912,0.5973135964912281,46.928418803418815,1012.2863247863263,26.63911381016648,0
2297,4,2,2,48,0.04,0.04,0.96,50,1450,1000,450,0.6896551724137931,19,10,9,354.9949015147239,0.4476785714285714,0.3469720460418133,0.19300297519133852,128415.88010204087,-882.5578009529395,127533.32230108793,1796,0,282.14,34,16,15,37.61182562054656,0.6084558823529411,46.60714285714286,1013.571428571429,29.810924369747912,0
2298,4,2,1,49,0.04,0.02,0.98,50,1200,900,300,0.75,15,9,6,357.50009597314323,0.4494642857142857,0.35974653837127457,0.1955465865136793,128657.32001133777,-800.9991496598758,127856.32086167789,1797,0,282.96,34,16,18,37.30173863725258,0.610906862745098,46.36904761904761,1014.5238095238087,29.83893557422967,0
2299,4,1,0,50,0.02,0.0,1.0,50,1650,1200,450,0.7272727272727273,21,12,9,359.18529123896906,0.4497534013605442,0.36817733990147805,0.19706652465273136,128778.12499999977,-748.9583333333635,128029.16666666641,1798,0,283.9,34,16,20,37.135673234811144,0.6121323529411764,46.249999999999986,1014.9999999999982,29.852941176470534,0
2300,4,0,0,50,0.0,0.0,1.0,50,1500,1200,300,0.8,18,12,6,357.054143332043,0.44926020408163264,0.36416793714084683,0.19604640567883638,128808.33510487516,-801.6900510204223,128006.64505385474,1799,1,284.9,34,16,20,37.15892654704664,0.6124387254901961,46.22023809523809,1015.1190476190466,29.85644257703078,0
2301,4,0,1,49,0.0,0.02,0.98,50,1350,800,550,0.5925925925925926,19,8,11,357.8664425621927,0.4490731292517007,0.36569921462900035,0.19709222863125012,128929.21095521528,-772.1123866213319,128157.09856859395,1800,2,285.9,34,16,20,37.01500410268432,0.6136642156862745,46.10119047619047,1015.595238095237,29.870448179271676,0
2302,4,2,1,50,0.0392156862745098,0.0196078431372549,0.9803921568627451,51,1200,800,400,0.6666666666666666,16,8,8,339.4378501788027,0.4512418300653595,0.3482567088268764,0.18907849829351517,129377.95380015402,-1416.558110512755,127961.39568964127,1801,0,277.80392156862746,35,16,22,37.026450511945384,0.6160714285714286,45.65972222222221,1017.3611111111087,29.06746031746025,0
2303,4,1,2,49,0.0196078431372549,0.0392156862745098,0.9607843137254902,51,1400,800,600,0.5714285714285714,20,8,12,330.7810801651717,0.4511437908496732,0.34324672931638167,0.18571786903128332,129688.42734203774,-1620.3043837756904,128068.12295826206,1802,0,275.84313725490193,36,15,15,36.931545973834545,0.6171875,45.35472972972972,1018.5810810810791,28.293918918918862,0
2304,4,0,0,49,0.0,0.0,1.0,49,1750,1200,550,0.6857142857142857,23,12,11,348.3810796180753,0.4488555839002268,0.35526205801220456,0.19393591696002951,129352.72285997722,-787.1917517006926,128565.53110827653,1803,1,288.0612244897959,34,15,21,36.8246537936415,0.617953431372549,45.6845238095238,1017.2619047619039,29.919467787114822,0
2305,4,0,0,49,0.0,0.0,1.0,49,1300,900,400,0.6923076923076923,17,9,8,343.79492561038313,0.44841269841269843,0.345570910549271,0.1919727510805462,129473.85381235812,-897.5092120181564,128576.34460033997,1804,2,289.0612244897959,34,15,15,36.81814637189536,0.6191789215686274,45.56547619047618,1017.7380952380939,29.933473389355704,0
2306,4,0,1,48,0.0,0.02040816326530612,0.9795918367346939,49,1350,1100,250,0.8148148148148148,16,11,5,340.9329094067936,0.44821782879818595,0.34027916917117507,0.1914056412653886,129685.96938775484,-957.1570294784929,128728.81235827635,1805,3,290.0612244897959,34,15,15,36.675529842605584,0.6213235294117647,45.35714285714284,1018.5714285714264,29.957983193277247,0
2307,4,0,0,48,0.0,0.0,1.0,48,1400,900,500,0.6428571428571429,19,9,10,347.15339183966364,0.4472055998817967,0.3381749709150723,0.19450421664165624,129606.62853529873,-601.3238598135576,129005.30467548518,1806,4,296.75,33,15,16,36.597740401973766,0.622790404040404,45.43504901960783,1018.2598039215671,30.856357694592944,0
2308,4,0,1,47,0.0,0.020833333333333332,0.9791666666666666,48,1100,900,200,0.8181818181818182,13,9,4,348.12546490526853,0.4474918735224586,0.34073227462303546,0.19551478812787745,129700.23548635117,-569.6090445982593,129130.62644175292,1807,5,297.75,33,15,16,36.47788338145654,0.6237373737373737,45.34313725490195,1018.6274509803902,30.86749851455728,0
2309,4,0,1,46,0.0,0.02127659574468085,0.9787234042553191,47,800,500,300,0.625,11,5,6,364.86238730216894,0.44463074313906875,0.26227573687729167,0.19048244773165776,126779.94030770638,-148.55366346075223,126631.38664424562,1808,6,304.8723404255319,36,11,17,39.04007790077902,0.5876736111111112,48.226351351351354,1007.0945945945948,27.974849849849857,8
2310,4,1,0,47,0.02127659574468085,0.0,1.0,47,1300,1000,300,0.7692307692307693,16,10,6,366.43671880336007,0.4443416589577552,0.2859152452962894,0.19277757815307228,127092.0138888891,-85.76388888886558,127006.25000000023,1809,0,305.63829787234044,36,11,18,38.67940771349862,0.5908564814814814,47.91666666666668,1008.3333333333351,28.00925925925931,0
2311,4,1,1,47,0.020833333333333332,0.020833333333333332,0.9791666666666666,48,1500,1000,500,0.6666666666666666,20,10,10,359.0784207015565,0.44650376773049644,0.28805833061859776,0.19059096116660706,127451.59718615339,-446.9763533010253,127004.62083285236,1810,0,300.25,37,11,17,38.49574238969124,0.5926238738738738,47.560307017543856,1009.7587719298242,27.290777619724977,0
2312,4,1,2,46,0.020833333333333332,0.041666666666666664,0.9583333333333334,48,1200,900,300,0.75,15,9,6,361.07296369075334,0.445063164893617,0.30298058147103446,0.19283722939173623,127700.83703639593,-378.1360610957112,127322.70097530022,1811,0,301.2291666666667,37,11,18,38.18977363130106,0.5951576576576576,47.313596491228076,1010.7456140350887,27.31744902797537,0
2313,4,2,0,48,0.041666666666666664,0.0,1.0,48,1500,1200,300,0.8,18,12,6,349.48948827824876,0.4454233156028369,0.3084922532339971,0.18899332339664993,128201.54772593529,-637.4424026997463,127564.10532323555,1812,0,282.3333333333333,36,12,20,37.970273175432744,0.6021412037037037,46.81869369369369,1012.7252252252244,28.131256256256236,0
2314,4,1,0,49,0.02040816326530612,0.0,1.0,49,1100,600,500,0.5454545454545454,16,6,10,342.33883680810357,0.4465171485260771,0.3111124843578619,0.1865413803161184,128505.59937913569,-1001.5085170437236,127504.09086209197,1813,0,277.55102040816325,37,12,16,37.84098896939549,0.603322072072072,46.518640350877185,1013.9254385964896,27.403390232337557,0
2315,4,0,1,48,0.0,0.02040816326530612,0.9795918367346939,49,1400,900,500,0.6428571428571429,19,9,10,343.80199212369297,0.44628684807256236,0.31148698130354635,0.18799385526763607,128644.60699445962,-954.3455678670573,127690.26142659257,1814,1,278.55102040816325,37,12,16,37.66212710765239,0.6047297297297297,46.38157894736841,1014.4736842105247,27.41820768136553,0
2316,4,0,0,48,0.0,0.0,1.0,48,800,500,300,0.625,11,5,6,351.8825330404078,0.4451832151300236,0.31673469954459654,0.1916514485760913,128486.82032962001,-557.5464400211181,127929.27388959889,1815,2,285.3125,36,12,16,37.61824762116332,0.6050347222222222,46.537162162162154,1013.8513513513501,28.162537537537503,0
2317,4,0,1,47,0.0,0.020833333333333332,0.9791666666666666,48,1650,900,750,0.5454545454545454,24,9,15,351.42437747368757,0.4454417848699764,0.3135539401145828,0.19202757920904195,128616.79945992985,-560.184263427216,128056.61519650264,1816,3,286.3125,37,11,17,37.4971849890102,0.6044481981981982,46.40899122807017,1014.3640350877183,27.415244191559953,0
2318,4,0,0,47,0.0,0.0,1.0,47,1400,1100,300,0.7857142857142857,17,11,6,353.249676799787,0.44339731729879744,0.32198471371869375,0.1935035159661326,128715.26668137734,-306.27472912100967,128408.99195225633,1817,4,292.97872340425533,36,11,18,37.35041430843783,0.607349537037037,46.31193693693694,1014.7522522522524,28.18756256256257,0
2319,4,1,0,48,0.020833333333333332,0.0,1.0,48,1250,1100,150,0.88,14,11,3,346.1345282011772,0.4459589243498818,0.32983937693359255,0.19113721920811136,129034.22807979374,-667.3596683595019,128366.86841143425,1818,0,287.8541666666667,37,11,19,37.205914094539175,0.6086711711711712,45.997807017543856,1016.0087719298242,27.459696538643897,0
2320,4,1,3,46,0.02040816326530612,0.061224489795918366,0.9387755102040817,49,1700,1300,400,0.7647058823529411,21,13,8,346.94617831956083,0.44660572562358275,0.28779925690592845,0.1870981809662968,128090.45041867539,-911.6851368595089,127178.76528181588,1819,0,282.9591836734694,38,11,19,38.14819700967458,0.5973135964912281,46.92841880341879,1012.2863247863232,26.6391138101664,8
2321,4,0,1,45,0.0,0.021739130434782608,0.9782608695652174,46,1300,1100,200,0.8461538461538461,15,11,4,360.4643780169545,0.44453502415458934,0.3119108847361016,0.19365821316817408,127939.53517500393,23.528994127187048,127963.06416913112,1820,1,277.04347826086956,35,11,19,37.96059280021355,0.6014880952380952,47.077546296296276,1011.6898148148119,28.905423280423197,0
2322,4,1,0,46,0.021739130434782608,0.0,1.0,46,1350,900,450,0.6666666666666666,18,9,9,377.0015255061843,0.445048309178744,0.33167178106684214,0.19074822947440284,125492.38207572425,268.3561599793992,125760.73823570365,1821,0,277.8478260869565,35,11,16,40.064519078972694,0.5764880952380953,49.50810185185184,1001.967592592591,28.627645502645457,7
2323,4,4,2,48,0.08,0.04,0.96,50,850,500,350,0.5882352941176471,12,5,7,346.43027001788806,0.45247448979591837,0.32594288205799016,0.17955657046011853,126484.64551592768,-1233.9600567684515,125250.68545915923,1822,0,256.54,37,13,17,39.80769929510936,0.5827702702702703,48.519736842105246,1005.9210526315766,27.187055476529096,0
2324,4,0,0,48,0.0,0.0,1.0,48,1750,1100,650,0.6285714285714286,24,11,13,366.7518805000634,0.4475103427895981,0.338908721019499,0.18912549467117282,126276.38996056249,-337.57930384087234,125938.81065672162,1823,1,268.2291666666667,35,13,18,39.5113618916014,0.5845238095238094,48.726851851851855,1005.0925925925932,28.716931216931233,0
2325,4,2,0,50,0.04,0.0,1.0,50,1900,1500,400,0.7894736842105263,23,15,8,353.5196455943423,0.4483673469387755,0.3551079880128136,0.18562179112406144,127013.25005425357,-1019.6641710069364,125993.58588324663,1824,0,258.46,39,11,20,39.08591247287383,0.5846688034188035,47.99479166666667,1008.0208333333342,25.846688034188055,0
2326,4,2,1,51,0.038461538461538464,0.019230769230769232,0.9807692307692307,52,1200,800,400,0.6666666666666666,16,8,8,341.44732552743505,0.451263197586727,0.36064250331459813,0.18191928774720872,127604.23657909645,-1685.9016966319778,125918.33488246448,1825,0,249.48076923076923,38,14,19,38.78454231433506,0.5923793859649122,47.40918803418804,1010.3632478632487,26.588506522717072,0
2327,4,2,0,53,0.03773584905660377,0.0,1.0,53,1600,1000,600,0.625,22,10,12,337.42312877041104,0.45159046927914853,0.3792787860463971,0.18246135932807472,128200.04712988618,-1946.1849429369693,126253.8621869492,1826,0,245.73584905660377,37,16,21,38.27730258409124,0.6002252252252251,46.82017543859649,1012.7192982456145,27.370791844476067,0
2328,4,0,1,52,0.0,0.018867924528301886,0.9811320754716981,53,1700,1500,200,0.8823529411764706,19,15,4,340.41245991136316,0.45159046927914853,0.38523969267395364,0.18471823499946582,128338.8894299206,-1862.368589373667,126476.52084054693,1827,1,246.73584905660377,37,16,21,38.059891606247525,0.6016328828828829,46.68311403508771,1013.267543859648,27.385609293504,0
2329,4,1,2,51,0.018867924528301886,0.03773584905660377,0.9622641509433962,53,1550,1100,450,0.7096774193548387,20,11,9,335.8021100209215,0.4508950169327528,0.3783841805214325,0.1831858407079645,128550.50131492419,-1966.4940828402612,126584.00723208392,1828,0,247.62264150943398,38,15,17,37.96091445427729,0.6019736842105263,46.474358974358964,1014.1025641025624,26.68690958164638,0
2330,4,1,0,52,0.019230769230769232,0.0,1.0,52,950,600,350,0.631578947368421,13,6,7,338.9901144028013,0.44987273755656104,0.36981563087291836,0.18542915474475774,128658.86843450923,-1677.1830940901696,126981.68534041906,1829,0,242.21153846153845,38,14,19,37.769631072732366,0.6030701754385965,46.367521367521356,1014.5299145299127,26.698155645524018,0
2331,4,2,0,54,0.037037037037037035,0.0,1.0,54,1600,900,700,0.5625,23,9,14,325.86218658792427,0.4515635918937806,0.3668347868726134,0.18082976266806267,129228.54487407765,-2375.5779047045216,126852.96696937313,1830,0,234.2037037037037,38,16,22,37.52342299744314,0.6088267543859649,45.806623931623925,1016.7735042735037,26.757197480881675,0
2332,4,0,1,53,0.0,0.018518518518518517,0.9814814814814815,54,1500,1200,300,0.8,18,12,6,329.1924122590215,0.4513816095970184,0.3698879551820733,0.18305559373282027,129310.02995105545,-2286.423862225156,127023.60608883029,1831,1,235.2037037037037,38,16,22,37.35600490196079,0.6096491228070176,45.72649572649572,1017.094017094016,26.765632028789895,0
2333,4,0,0,53,0.0,0.0,1.0,53,1550,1000,550,0.6451612903225806,21,10,11,328.9686899373803,0.45159046927914853,0.36000594265339547,0.1835633726803481,129445.89548405631,-2083.2706689678034,127362.62481508851,1832,2,238.9245283018868,38,15,17,37.223753280839915,0.6110197368421053,45.59294871794871,1017.6282051282033,26.77968960863693,0
2334,4,0,0,53,0.0,0.0,1.0,53,1700,1400,300,0.8235294117647058,20,14,6,332.3628739275403,0.4513788098693759,0.3539546647351479,0.18661646878829055,129690.63321827764,-1979.1296844181315,127711.5035338595,1833,3,239.9245283018868,38,15,19,36.88902873924899,0.6134868421052632,45.35256410256411,1018.5897435897451,26.804993252361715,0
2335,4,1,2,52,0.018518518518518517,0.037037037037037035,0.962962962962963,54,1700,1300,400,0.7647058823529411,21,13,8,326.49267870279243,0.45185476356860005,0.35671270289797485,0.18488662910231599,130023.4388563369,-2309.6598307291574,127713.77902560774,1834,0,236.46296296296296,39,15,20,36.70132860109625,0.6151175213675213,45.02604166666667,1019.8958333333342,26.151175213675234,0
2336,4,0,1,51,0.0,0.019230769230769232,0.9807692307692307,52,1650,900,750,0.5454545454545454,24,9,15,334.69809198972064,0.4511689291101056,0.3497751070055375,0.18910739442616367,129935.60209155167,-1702.160379684415,128233.44171186726,1835,1,243.3846153846154,38,14,20,36.58113276747354,0.615953947368421,45.11217948717949,1019.5512820512826,26.830296896086384,0
2337,4,0,0,51,0.0,0.0,1.0,51,1900,1500,400,0.7894736842105263,23,15,8,339.26304301019394,0.4501143790849673,0.35091093658171757,0.19155313351498632,129908.37191358018,-1385.37808641976,128522.99382716042,1836,2,249.0392156862745,38,13,20,36.49239327883742,0.6156798245614035,45.138888888888886,1019.4444444444439,26.827485380116944,0
2338,4,0,0,51,0.0,0.0,1.0,51,2000,1400,600,0.7,26,14,12,339.53724861616286,0.4497222222222222,0.3525567874689184,0.1926667330791832,130103.13042534734,-1365.0282118055457,128738.10221354179,1837,3,250.0392156862745,39,12,20,36.28794840378464,0.6159188034188035,44.94791666666667,1020.2083333333343,26.15918803418806,0
2339,4,0,1,50,0.0,0.0196078431372549,0.9803921568627451,51,1350,800,550,0.5925925925925926,19,8,11,361.7565780415459,0.4493954248366013,0.34346935807796863,0.19724629156822598,128530.68300118942,-900.4406763294319,127630.24232485998,1838,4,251.0392156862745,40,11,13,37.323152602391936,0.5984375,46.493902439024374,1014.0243902438996,25.35060975609749,8
2340,4,2,0,52,0.038461538461538464,0.0,1.0,52,1600,1100,500,0.6875,21,11,10,363.0198985023048,0.45024195575666165,0.3722441565335679,0.20159560112038144,129257.13320444737,-1008.4360999902439,128248.69710445713,1839,0,246.3846153846154,37,15,17,36.54976277765795,0.6109234234234234,45.778508771929815,1016.8859649122794,27.483404457088632,0
2341,4,0,1,51,0.0,0.019230769230769232,0.9807692307692307,52,1500,900,600,0.6,21,9,12,360.76099881093927,0.4504462041226747,0.36036140583554377,0.2011936339522545,129424.43828870417,-1061.7420744844658,128362.6962142197,1840,1,247.3846153846154,37,15,17,36.4367816091954,0.6126126126126126,45.614035087719294,1017.5438596491224,27.501185395922228,0
2342,4,0,1,50,0.0,0.0196078431372549,0.9803921568627451,51,1800,1200,600,0.6666666666666666,24,12,12,363.69255863841323,0.4506699346405229,0.3540981806742298,0.20383903392123975,129619.76431450054,-771.6512532702454,128848.1130612303,1841,2,247.33333333333334,37,14,14,36.16334212698756,0.6145833333333333,45.422149122807014,1018.3114035087714,27.52192982456139,0
2343,4,0,0,50,0.0,0.0,1.0,50,1650,1300,350,0.7878787878787878,20,13,7,367.15808438289264,0.4484778911564626,0.3547339699863574,0.20544036324630555,129554.63927469128,-486.5933641975379,129068.04591049373,1842,3,253.24,38,12,14,36.14142792178263,0.6121162280701755,45.48611111111111,1018.055555555555,26.790935672514603,0
2344,4,0,1,49,0.0,0.02,0.98,50,1600,1000,600,0.625,22,10,12,373.19854328070767,0.4480952380952381,0.36300335570469744,0.20983616207103972,129745.05077069197,-315.86721089924504,129429.18355979273,1843,4,254.24,38,12,14,35.79374650447428,0.6140350877192983,45.29914529914531,1018.8034188034203,26.810616284300533,0
2345,4,0,1,48,0.0,0.02040816326530612,0.9795918367346939,49,1100,700,400,0.6363636363636364,15,7,8,380.036131970456,0.44816468253968256,0.3582102664569915,0.2137588219291453,129759.37307633132,62.65004616806823,129822.02312249939,1844,5,259.3469387755102,37,12,15,35.60500071746307,0.615990990990991,45.285087719298254,1018.8596491228082,27.53674727358941,0
2346,4,0,1,47,0.0,0.020833333333333332,0.9791666666666666,48,1550,1100,450,0.7096774193548387,20,11,9,385.38745319632653,0.4484615100472813,0.3607856142678165,0.2165350870567687,129717.10519641289,398.2689615291299,130115.37415794202,1845,6,265.2916666666667,36,12,15,35.5117823715823,0.6174768518518519,45.32657657657659,1018.6936936936958,28.297047047047105,0
2347,4,0,1,46,0.0,0.02127659574468085,0.9787234042553191,47,1250,900,350,0.72,16,9,7,383.15661611788505,0.4475601295097132,0.34549485895937715,0.21575508520539813,129803.15778193761,546.9877394286495,130350.14552136626,1846,7,268.1276595744681,36,11,15,35.48090028364091,0.6183449074074074,45.24211711711713,1019.0315315315337,28.30643143143149,0
2348,4,0,1,45,0.0,0.021739130434782608,0.9782608695652174,46,1750,1400,350,0.8,21,14,7,384.13791645207925,0.4475342190016103,0.3378613446556993,0.2169935812376328,129927.00277970158,781.9776277316245,130708.9804074332,1847,8,268.5652173913044,37,9,16,35.329730407973045,0.6176801801801801,45.120614035087726,1019.5175438596502,27.55452821242298,0
2349,4,1,0,46,0.021739130434782608,0.0,1.0,46,1300,700,600,0.5384615384615384,19,7,12,382.7852590495646,0.4461755233494364,0.3420993628669122,0.21778515838834653,130206.62607725456,768.2354185903405,130974.8614958449,1848,0,268.80434782608694,37,9,17,35.07959103280332,0.6204954954954955,44.84649122807018,1020.6140350877196,27.584163110478908,0
2350,4,0,2,44,0.0,0.043478260869565216,0.9565217391304348,46,1850,1400,450,0.7567567567567568,23,14,9,384.33110411444034,0.4459541062801932,0.34518566448892707,0.21933196982750125,130325.14537677822,817.6494950269589,131142.79487180518,1849,1,269.80434782608694,33,13,18,34.91958713394143,0.630050505050505,44.73039215686275,1021.0784313725495,30.941770647653016,0
2351,4,1,0,45,0.022222222222222223,0.0,1.0,45,700,500,200,0.7142857142857143,9,5,4,388.17579975183014,0.4453282828282828,0.3536814915570945,0.22153688726838747,130327.04132550256,1117.9606991633573,131445.0020246659,1850,0,274.75555555555553,32,13,19,34.819514859239106,0.6324869791666667,44.72853535353536,1021.0858585858591,31.908933080808097,0
2352,4,0,2,43,0.0,0.044444444444444446,0.9555555555555556,45,1750,1400,350,0.8,21,14,7,383.46090736912845,0.44509680134680135,0.3474030558552792,0.22043056019062052,130606.84479827482,1016.5238429930906,131623.3686412679,1851,1,275.75555555555553,33,12,15,34.65549194740838,0.6328914141414141,44.454656862745104,1022.1813725490206,30.97519310754608,0
2353,4,0,1,42,0.0,0.023255813953488372,0.9767441860465116,43,1550,1000,550,0.6451612903225806,21,10,11,380.27236230867305,0.44379844961240306,0.31684186317085317,0.2200970339422928,130870.93431122461,1353.3198696145218,132224.25418083914,1852,2,264.48837209302326,34,9,15,34.46892573201474,0.6332720588235294,44.19642857142858,1023.2142857142867,30.094537815126078,0
2354,4,0,0,42,0.0,0.0,1.0,42,1250,700,550,0.56,18,7,11,387.4579876934564,0.4423514324428959,0.3237958336185458,0.22399579510145232,130826.15460399838,1737.9277201076402,132564.082324106,1853,5,271.73809523809524,33,9,17,34.330578182398966,0.6351010101010102,44.24019607843137,1023.0392156862739,31.00118835412951,0
2355,4,0,0,42,0.0,0.0,1.0,42,1500,1200,300,0.8,18,12,6,386.4227473197318,0.4421094657375145,0.3220815511833477,0.22376074480719557,130888.84833958093,1715.6856737793178,132604.53401336024,1854,6,272.73809523809524,33,9,17,34.293413173652695,0.6357323232323233,44.17892156862745,1023.2843137254903,31.0086155674391,0
2356,4,1,0,43,0.023255813953488372,0.0,1.0,43,1400,1200,200,0.8571428571428571,16,12,4,380.04739625473576,0.44345238095238093,0.31760426743915815,0.2218919872570051,131206.12953514743,1372.9095804988688,132579.0391156463,1855,0,267.3720930232558,34,9,19,34.13485746378496,0.6366421568627452,43.86904761904762,1024.5238095238096,30.13305322128852,0
2357,4,0,0,43,0.0,0.0,1.0,43,1250,1000,250,0.8,15,10,5,379.2011612083667,0.44296788482835,0.31604500399904967,0.22193631949564926,131299.26960321813,1357.7670998701449,132657.03670308826,1856,1,268.3720930232558,36,7,19,34.06219096802549,0.6333912037037037,43.778153153153156,1024.8873873873877,28.469094094094103,0
2358,4,1,2,42,0.022727272727272728,0.045454545454545456,0.9545454545454546,44,850,500,350,0.5882352941176471,12,5,7,372.36299823060995,0.444481148696265,0.3158112626438423,0.21967123078368395,131602.82206632636,1000.8137912457219,132603.63585757208,1857,0,263.25,34,10,17,33.93036701860231,0.640625,43.48214285714285,1026.071428571427,30.178571428571384,0
2359,4,1,2,41,0.023255813953488372,0.046511627906976744,0.9534883720930233,43,1000,800,200,0.8,12,8,4,362.5739204185527,0.4430370985603544,0.2847848463974312,0.2162050933107002,132011.15779588887,972.7606042095056,132983.91840009837,1858,0,247.30232558139534,35,8,18,33.76940439989488,0.6425595238095239,43.084490740740726,1027.6620370370354,29.361772486772438,0
2360,4,1,1,41,0.023809523809523808,0.023809523809523808,0.9761904761904762,42,1200,1000,200,0.8333333333333334,14,10,4,355.00611307190786,0.4417949090205188,0.27491594338885017,0.21321373063194463,132282.1316882761,992.1930799042249,133274.32476818032,1859,0,243.9047619047619,36,6,19,33.69093231162196,0.6432291666666667,42.820945945945944,1028.716216216216,28.575450450450447,0
2361,4,0,0,41,0.0,0.0,1.0,41,1300,1000,300,0.7692307692307693,16,10,6,362.2637661433267,0.4396849593495935,0.2779636822817304,0.2170406987311837,132189.63162562138,1377.5027595593076,133567.1343851807,1860,1,250.7560975609756,35,6,20,33.5974723316451,0.6443452380952381,42.91087962962962,1028.35648148148,29.381613756613714,0
2362,4,0,0,41,0.0,0.0,1.0,41,1200,800,400,0.6666666666666666,16,8,8,363.2888985646259,0.4396087398373984,0.284542782414434,0.2179978691116695,132249.14969403695,1408.9295856909876,133658.07927972794,1861,2,251.7560975609756,35,6,20,33.5111445557181,0.6449404761904762,42.853009259259245,1028.587962962961,29.388227513227456,0
2363,4,0,1,40,0.0,0.024390243902439025,0.975609756097561,41,1050,900,150,0.8571428571428571,12,9,3,363.1147343927342,0.4395071138211382,0.28393645916211696,0.21840933618074465,132338.45191400888,1410.8083633401893,133749.26027734907,1862,3,252.7560975609756,35,6,20,33.42566554180728,0.6458333333333333,42.7662037037037,1028.935185185185,29.39814814814814,0
2364,4,0,0,40,0.0,0.0,1.0,40,1100,800,300,0.7272727272727273,14,8,6,361.67819507716166,0.4391025641025641,0.2658046661111777,0.21843698898944877,132492.61289227687,1583.9646102252802,134076.57750250216,1863,4,254.625,33,7,20,33.307418759671464,0.6518308080808081,42.616421568627445,1029.5343137254893,31.198009506833007,0
2365,4,0,1,39,0.0,0.025,0.975,40,1100,900,200,0.8181818181818182,13,9,4,338.532830721267,0.4388621794871795,0.19791643043428975,0.19273860775538126,130233.05047850238,817.6326463906241,131050.68312489301,1864,5,255.625,35,5,22,36.18194145216767,0.624702380952381,44.82060185185186,1020.7175925925937,29.16335978835982,8
2366,4,0,0,39,0.0,0.0,1.0,39,1200,900,300,0.75,15,9,6,348.6880466472301,0.43671277552856497,0.2011512297226581,0.19867109634551505,130262.58680555565,1284.2013888888987,131546.78819444455,1865,6,262.4102564102564,34,5,22,35.89285714285714,0.6271446078431373,44.79166666666667,1020.8333333333342,30.024509803921593,0
2367,4,0,0,39,0.0,0.0,1.0,39,1050,800,250,0.7619047619047619,13,8,5,351.6135444929388,0.4354757085020243,0.20343653704185272,0.20096552952730976,130384.14292800444,1368.9661281179074,131753.10905612234,1866,7,263.4102564102564,34,5,22,35.69496250534251,0.6283700980392157,44.672619047619044,1021.3095238095231,30.038515406162443,0
2368,4,0,1,38,0.0,0.02564102564102564,0.9743589743589743,39,1150,700,450,0.6086956521739131,16,7,9,352.71419274685627,0.4349696356275304,0.20802002766350935,0.20222751612199505,130505.75573979582,1406.2464569160893,131912.0021967119,1867,8,264.4102564102564,34,5,16,35.54361334420755,0.6295955882352942,44.55357142857142,1021.7857142857134,30.052521008403335,0
2369,4,0,0,38,0.0,0.0,1.0,38,1250,1000,250,0.8,15,10,5,358.3824661300111,0.4337067330488383,0.22259705505519434,0.205681444257272,130544.21864487212,1756.9518033929269,132301.17044826504,1868,9,272.13157894736844,33,5,16,35.35983031538556,0.632260101010101,44.51593137254902,1021.9362745098035,30.96776589423647,0
2370,4,0,0,38,0.0,0.0,1.0,38,950,700,250,0.7368421052631579,12,7,5,360.64443562619437,0.433291844476055,0.2213043395976455,0.2076505539288711,130669.48596993955,1825.044604238765,132494.53057417832,1869,10,273.13157894736844,33,5,16,35.17507191657676,0.6335227272727273,44.39338235294118,1022.4264705882362,30.98262032085564,0
2371,4,1,0,39,0.02564102564102564,0.0,1.0,39,1300,900,400,0.6923076923076923,17,9,8,350.937979845175,0.4326360773729195,0.19796738304235184,0.18799173083429105,127822.46823827556,1171.5517564728673,128994.01999474842,1870,0,267.1025641025641,35,4,17,38.32133932318491,0.600297619047619,47.19328703703702,1011.2268518518491,28.892195767195687,8
2372,4,1,0,40,0.025,0.0,1.0,40,1200,600,600,0.5,18,6,12,339.54851055902736,0.43482905982905984,0.19454732510288109,0.18335619570187447,128144.53124999977,702.6621709961989,128847.19342099597,1871,0,261.4,35,5,18,38.28017832647461,0.6035714285714286,46.874999999999986,1012.4999999999982,28.928571428571377,0
2373,4,0,1,39,0.0,0.025,0.975,40,1000,600,400,0.6,14,6,8,340.9852761356458,0.43513621794871793,0.19083457100422674,0.1848076855737032,128291.05748724703,749.0723326045859,129040.12981985162,1872,1,262.4,35,5,19,38.0942010358353,0.6050595238095238,46.73032407407407,1013.0787037037032,28.945105820105805,0
2374,4,1,0,40,0.025,0.0,1.0,40,1100,500,600,0.45454545454545453,17,5,12,340.0063690864355,0.43543002136752135,0.19698379180458847,0.18536377097487602,128525.67361379009,739.9095239625963,129265.58313775268,1873,0,263.0,35,5,19,37.87964178366246,0.6074404761904761,46.49884259259258,1014.004629629628,28.9715608465608,0
2375,4,1,0,41,0.024390243902439025,0.0,1.0,41,1400,1100,300,0.7857142857142857,17,11,6,331.2648044502881,0.4368902439024391,0.20236819446894727,0.1825405046771572,128950.68825263517,343.36490554783296,129294.053158183,1874,0,257.5609756097561,37,4,20,37.66856939796321,0.6078265765765766,46.08004385964911,1015.6798245614013,27.450806069227063,0
2376,4,1,0,42,0.023809523809523808,0.0,1.0,42,1050,800,250,0.7619047619047619,13,8,5,322.8367299391589,0.4384678668215254,0.20443544454539442,0.17966144832906847,129340.7722207792,-48.566145352445915,129292.20607542674,1875,0,252.4047619047619,37,5,21,37.4864135316733,0.6117680180180181,45.69627192982455,1017.2149122806995,27.492294926505394,0
2377,4,0,0,42,0.0,0.0,1.0,42,1350,1000,350,0.7407407407407407,17,10,7,329.9264275366563,0.4380081300813008,0.09651562918546897,0.17940234683228562,128422.23087873212,112.96192097570568,128535.19279970783,1876,1,253.4047619047619,37,5,13,38.24057046011827,0.6024774774774775,46.600877192982466,1013.5964912280718,27.394499762920862,8
2378,4,1,1,42,0.023255813953488372,0.023255813953488372,0.9767441860465116,43,1550,1300,250,0.8387096774193549,18,13,5,328.74849901894066,0.43996862310815804,0.13686876154400363,0.17154127839803518,126759.19514054155,-265.6209721395807,126493.57416840196,1877,0,248.48837209302326,40,3,14,39.97060752850943,0.58046875,48.246951219512205,1007.0121951219528,25.17530487804882,8
2379,4,2,1,43,0.045454545454545456,0.022727272727272728,0.9772727272727273,44,1600,1100,500,0.6875,21,11,10,326.0096223060102,0.4424660852713178,0.15487255567869007,0.17235810177217947,127292.15876165268,-500.3062799193895,126791.8524817333,1878,0,243.75,41,3,18,39.49362629440292,0.584349593495935,47.71825396825396,1009.1269841269832,24.612853271389834,0
2380,4,0,0,43,0.0,0.0,1.0,43,1700,1300,400,0.7647058823529411,21,13,8,340.0902425998475,0.4418835363602805,0.1595808193969359,0.18016620691969532,127373.97057183231,63.72891053606298,127437.69948236838,1879,1,249.72093023255815,40,3,16,39.05458236853587,0.58671875,47.63719512195122,1009.4512195121956,25.23628048780489,0
2381,4,1,0,44,0.022727272727272728,0.0,1.0,44,900,600,300,0.6666666666666666,12,6,6,335.0465949067156,0.44506474630021137,0.1675018071160208,0.1787909723580259,127667.85483001085,-245.06399203198498,127422.79083797887,1880,0,245.02272727272728,41,3,17,38.8811516311639,0.588160569105691,47.346230158730165,1010.6150793650806,24.64914827719709,0
2382,4,1,1,44,0.022222222222222223,0.022222222222222223,0.9777777777777777,45,1400,1100,300,0.7857142857142857,17,11,6,326.7295627028992,0.4465698653198653,0.17253550343066837,0.17600259321463585,128046.43956380352,-632.6885591310331,127413.7510046725,1881,0,240.55555555555554,42,3,18,38.70472315302379,0.5905257936507937,46.971899224806215,1012.1124031007773,24.09791435954232,0
2383,4,0,0,44,0.0,0.0,1.0,44,1500,1200,300,0.8,18,12,6,336.320039868631,0.4438535059901339,0.17505010912654195,0.18149899560335175,128119.42087309468,-182.17425280296942,127937.24662029171,1882,1,246.8409090909091,41,3,19,38.38753470520985,0.5927337398373984,46.89980158730159,1012.4007936507943,24.692702284165716,0
2384,4,0,1,43,0.0,0.022727272727272728,0.9772727272727273,44,1550,1200,350,0.7741935483870968,19,12,7,360.5484110957596,0.4441508104298802,0.14447047797563273,0.1921604169026849,127617.73003472213,442.15895849079476,128059.88899321292,1883,2,247.8409090909091,41,3,13,38.28823024054983,0.5876524390243902,47.39583333333333,1010.4166666666658,24.64430894308941,8
2385,4,0,1,42,0.0,0.023255813953488372,0.9767441860465116,43,1350,1100,250,0.8148148148148148,16,11,5,364.71994011984026,0.4426910299003322,0.16092013150080198,0.1948176436322198,127707.59489226,715.5012723907826,128423.09616465078,1884,3,254.32558139534885,40,3,14,38.090689724512366,0.5901041666666667,47.306910569105696,1010.772357723578,25.26930894308945,0
2386,4,1,1,42,0.023255813953488372,0.023255813953488372,0.9767441860465116,43,1000,600,400,0.6,14,6,8,366.0858594968165,0.44061461794019935,0.16893696050833373,0.19667483709070743,127938.82118985063,767.3186636591979,128706.13985350983,1885,0,255.1627906976744,40,3,16,37.81914448350912,0.5924479166666667,47.078252032520325,1011.6869918699188,25.292174796747968,0
2387,4,4,4,42,0.08695652173913043,0.08695652173913043,0.9130434782608696,46,950,700,250,0.7368421052631579,12,7,5,356.70465260054834,0.44514895330112725,0.211663837750794,0.19601097246861826,128840.02267995253,-7.937157115461446,128832.08552283706,1886,0,239.34782608695653,40,6,13,37.135468802135485,0.6015625,46.18902439024391,1015.2439024390253,25.381097560975633,0
2388,4,1,0,43,0.023255813953488372,0.0,1.0,43,1200,1000,200,0.8333333333333334,14,10,4,383.7705171480836,0.4398301956441491,0.2167394640538307,0.20433186994100716,127577.25180802133,1199.888014969717,128777.13982299106,1887,0,256.86046511627904,38,5,15,37.743231810490705,0.5921052631578947,47.43589743589745,1010.2564102564127,26.585695006747702,8
2389,4,0,0,43,0.0,0.0,1.0,43,1000,700,300,0.7,13,7,6,386.15698317080984,0.439922480620155,0.22189615254162254,0.206430360156057,127739.20323800152,1265.477071005939,129004.68030900745,1888,1,257.86046511627904,38,5,15,37.5165134221095,0.59375,47.275641025641036,1010.8974358974376,26.60256410256415,0
2390,4,0,0,43,0.0,0.0,1.0,43,1650,1100,550,0.6666666666666666,22,11,11,380.5755740631502,0.439484126984127,0.22467522899732262,0.20454317175811793,127955.29827781445,1139.3322193001836,129094.63049711463,1889,2,258.86046511627904,38,5,16,37.435762055614234,0.5959429824561404,47.06196581196582,1011.752136752138,26.62505623031942,0
2391,4,1,0,44,0.022727272727272728,0.0,1.0,44,800,400,400,0.5,12,4,8,374.27364532392625,0.4420806906272023,0.2260321390671587,0.20268461406915805,128258.57688347128,801.180497425294,129059.75738089657,1890,0,253.95454545454547,36,8,17,37.284370946822314,0.6027199074074074,46.762387387387385,1012.9504504504501,28.137512512512505,0
2392,4,0,1,43,0.0,0.022727272727272728,0.9772727272727273,44,1500,1300,200,0.8666666666666667,17,13,4,373.1103453716201,0.4421687808315715,0.22280104288774805,0.20219883535922256,128287.09621783948,773.0485553120732,129060.14477315155,1891,1,254.95454545454547,36,8,17,37.28462650066696,0.6030092592592593,46.734234234234236,1013.0630630630633,28.140640640640648,0
2393,4,1,1,43,0.022727272727272728,0.022727272727272728,0.9772727272727273,44,1450,900,550,0.6206896551724138,20,9,11,366.06513824037916,0.4432919309372798,0.2238515461153201,0.19983072785025408,128577.5888144678,613.5545647965548,129191.14337926435,1892,0,245.3181818181818,38,6,14,37.16598195161348,0.6022478070175439,46.447649572649574,1014.2094017094015,26.68972109761583,0
2394,4,1,0,44,0.022727272727272728,0.0,1.0,44,1500,900,600,0.6,21,9,12,373.0689227710726,0.44226788231148695,0.24809770699092648,0.2053669637546691,128910.32036675357,818.4868706597316,129728.8072374133,1893,0,246.25,39,5,16,36.64831008308545,0.6038995726495726,46.11979166666667,1015.5208333333342,26.03899572649575,0
2395,4,2,1,45,0.043478260869565216,0.021739130434782608,0.9782608695652174,46,1250,800,450,0.64,17,8,9,361.82665749698975,0.44307568438003225,0.26523237089465557,0.20293756007439848,129647.68005540152,183.3102793647837,129830.9903347663,1894,0,236.5,37,9,14,36.182439707149,0.6148648648648649,45.39473684210525,1018.4210526315778,27.524893314366967,0
2396,4,0,0,45,0.0,0.0,1.0,45,1600,1400,200,0.875,18,14,4,355.74990813514455,0.4426346801346801,0.24747609746067623,0.19299382913723118,128329.16802300366,130.6179470486323,128459.7859700523,1895,1,239.9777777777778,39,6,15,37.68130375929544,0.5980235042735043,46.69270833333334,1013.2291666666682,25.98023504273508,8
2397,4,1,0,46,0.021739130434782608,0.0,1.0,46,1500,1000,500,0.6666666666666666,20,10,10,347.0113532843079,0.4435587761674718,0.24844876009666672,0.1900662842865506,128711.08596280332,-267.15837547093963,128443.92758733238,1896,0,235.7391304347826,40,6,15,37.51293607077283,0.6002604166666667,46.31605691056911,1014.7357723577243,25.368394308943106,0
2398,4,1,0,47,0.02127659574468085,0.0,1.0,47,1500,900,600,0.6,21,9,12,342.1831398950319,0.44459219858156024,0.2507073502100232,0.18903126854395477,129050.14349489808,-568.2433390022599,128481.90015589581,1897,0,231.70212765957447,41,6,16,37.290080062487775,0.6021341463414633,45.98214285714286,1016.0714285714295,24.782229965156816,0
2399,4,1,1,47,0.020833333333333332,0.020833333333333332,0.9791666666666666,48,1350,1100,250,0.8148148148148148,16,11,5,331.51311107696625,0.4451647458628842,0.18334547860756567,0.17741925455108848,127784.64708713388,-1101.7668838802706,126682.88020325362,1898,0,227.85416666666666,40,8,17,38.85105705766075,0.5908854166666666,47.230691056910565,1011.0772357723569,25.276930894308922,8
2400,4,1,0,48,0.020833333333333332,0.0,1.0,48,1350,1000,350,0.7407407407407407,17,10,7,329.65791128927486,0.4461528516548463,0.18202282921604085,0.17744505300641059,128015.943097693,-1159.7063173375816,126856.23678035542,1899,0,228.41666666666666,40,8,18,38.661754368347054,0.5932291666666667,47.002032520325194,1011.9918699186978,25.299796747967445,0
2401,4,1,0,49,0.02040816326530612,0.0,1.0,49,1000,600,400,0.6,14,6,8,308.8981958063571,0.44811153628117917,0.1934300679294001,0.16214241145911043,127000.69575719387,-1934.3999740620702,125066.2957831318,1900,0,224.73469387755102,45,4,16,40.22323568176371,0.575925925925926,48.007246376811594,1007.9710144927536,22.39935587761675,8
2402,4,1,1,49,0.02,0.02,0.98,50,1200,500,700,0.4166666666666667,19,5,14,304.39928244289615,0.44918367346938776,0.20401982378854622,0.1606945049175289,127232.09876543212,-2254.0624489486313,124978.03631648349,1901,0,221.22,44,6,17,40.100151431718054,0.5795454545454546,47.77777777777778,1008.888888888889,22.92929292929293,0
2403,4,3,0,52,0.057692307692307696,0.0,1.0,52,1450,1100,350,0.7586206896551724,18,11,7,298.28012659552553,0.45274792609351433,0.2290418152524889,0.1601729188038376,127920.22789503829,-2768.787645867884,125151.44024917041,1902,0,211.0,46,6,16,39.55302631963311,0.5840126811594203,47.09663120567377,1011.6134751773075,21.991597286463207,0
2404,4,0,1,51,0.0,0.019230769230769232,0.9807692307692307,52,1450,900,550,0.6206896551724138,20,9,11,299.09320427951207,0.4529207516339869,0.2332170895245791,0.16096883200615933,128009.9256592353,-2742.6202309994114,125267.3054282359,1903,1,212.0,46,6,16,39.4411592933275,0.5849184782608696,47.00797872340427,1011.9680851063858,21.99930619796491,0
2405,4,0,0,51,0.0,0.0,1.0,51,1450,800,650,0.5517241379310345,21,8,13,304.8629933774282,0.45218954248366017,0.23327171319776863,0.1637813743642379,127938.2624202509,-2399.2716702110474,125538.99075003985,1904,2,217.05882352941177,45,6,16,39.36817306831409,0.5854166666666667,47.07880434782611,1011.6847826086992,22.481884057971094,0
2406,4,3,2,52,0.05555555555555555,0.037037037037037035,0.962962962962963,54,1600,1100,500,0.6875,21,11,10,316.86287650532626,0.4539293617516888,0.2662908379138542,0.1671887183462728,127211.39955126579,-2572.7359935942427,124638.66355767155,1905,0,205.94444444444446,43,11,15,39.80695969836353,0.5806686046511628,47.79829545454547,1008.8068181818205,23.46062367864699,6
2407,4,0,0,52,0.0,0.0,1.0,52,1700,1200,500,0.7058823529411765,22,12,10,318.87699798962194,0.451993778280543,0.2710585785182551,0.16877148430182473,127336.398053002,-2279.07033080941,125057.3277221926,1906,1,214.32692307692307,42,10,13,39.62833621351766,0.5833333333333333,47.67441860465118,1009.3023255813985,24.03100775193806,0
2408,4,2,2,52,0.037037037037037035,0.037037037037037035,0.962962962962963,54,1750,1300,450,0.7428571428571429,22,13,9,315.91065801978556,0.4526991614255765,0.2961284547387255,0.16940069305597086,127863.435570988,-2721.3155864197242,125142.11998456829,1907,0,207.35185185185185,44,10,15,39.165064542708045,0.5859375,47.15277777777779,1011.3888888888918,22.986111111111175,0
2409,4,0,0,52,0.0,0.0,1.0,52,1150,700,450,0.6086956521739131,16,7,9,319.39853473019576,0.4509254022121669,0.2974808016482482,0.17103999768550848,127809.16856778045,-2235.5877668732396,125573.5808009072,1908,1,215.96153846153845,43,9,15,39.13225010925893,0.5867248062015504,47.20643939393941,1011.1742424242454,23.5156800563778,0
2410,4,1,1,52,0.018867924528301886,0.018867924528301886,0.9811320754716981,53,1700,1300,400,0.7647058823529411,21,13,8,315.1670949577935,0.4507589501693275,0.3023377890814458,0.17040390388395943,128194.7593852355,-2518.1277942861484,125676.63159094936,1909,0,212.8679245283019,41,12,16,38.846166405433635,0.5934959349593496,46.82539682539682,1012.6984126984121,24.699961285327124,0
2411,4,0,1,51,0.0,0.019230769230769232,0.9807692307692307,52,1550,1000,550,0.6451612903225806,21,10,11,323.96822977527154,0.44868652589240826,0.3052389996834439,0.17494284407864638,128144.53124999988,-2097.0486111111245,126047.48263888876,1910,1,217.82692307692307,40,12,16,38.67455418381343,0.59453125,46.87499999999999,1012.4999999999991,25.31249999999998,0
2412,4,0,0,51,0.0,0.0,1.0,51,1400,1000,400,0.7142857142857143,18,10,8,324.9938903492555,0.4486274509803922,0.2970736410117907,0.17603555076223412,128267.1986734572,-1862.7888197824518,126404.40985367475,1911,2,222.7843137254902,42,9,16,38.52353166252155,0.5927579365079365,46.753875968992254,1012.9844961240316,24.118678479143608,0
2413,4,1,0,52,0.019230769230769232,0.0,1.0,52,1150,1100,50,0.9565217391304348,12,11,1,322.4960877504498,0.4491264454499749,0.3089327129511954,0.17636041797195356,128648.39916386887,-2102.2789148588045,126546.12024901007,1912,0,219.48076923076923,43,9,14,38.19862550172687,0.595203488372093,46.377840909090914,1014.4886363636369,23.59275898520086,0
2414,4,0,1,51,0.0,0.019230769230769232,0.9807692307692307,52,1250,800,450,0.64,17,8,9,320.75196449344514,0.44913430115636,0.3054885577281996,0.17572484925929235,128720.46100206608,-2142.531852617083,126577.92914944899,1913,1,220.48076923076923,43,9,14,38.169559537140735,0.5959302325581395,46.30681818181818,1014.772727272727,23.599365750528534,0
2415,4,0,1,50,0.0,0.0196078431372549,0.9803921568627451,51,1750,1300,450,0.7428571428571429,22,13,9,320.6869070574725,0.4472875816993464,0.2914549921505012,0.17640304981917349,128881.416052596,-1933.8834617811408,126947.53259081487,1914,2,225.72549019607843,42,9,14,38.007562744536706,0.5989583333333333,46.14825581395349,1015.4069767441861,24.176356589147286,0
2416,4,1,1,50,0.0196078431372549,0.0196078431372549,0.9803921568627451,51,1700,1000,700,0.5882352941176471,24,10,14,317.6899644654856,0.44733660130718955,0.2907966925087795,0.17551617320258617,129053.65982362849,-2000.1894792981097,127053.47034433039,1915,0,224.94117647058823,42,9,16,37.90867982707101,0.6006944444444444,45.97868217054264,1016.0852713178303,24.19250645994834,0
2417,4,2,1,51,0.038461538461538464,0.019230769230769232,0.9807692307692307,52,1800,1200,600,0.6666666666666666,24,12,12,318.68419379639977,0.44923642533936653,0.3087157539148604,0.1780258687590284,129490.37606175404,-2146.6927800734516,127343.68328168058,1916,0,221.42307692307693,43,9,14,37.44029897035108,0.6036821705426356,45.54924242424243,1017.8030303030314,23.669837914023987,0
2418,4,1,2,50,0.019230769230769232,0.038461538461538464,0.9615384615384616,52,1800,1000,800,0.5555555555555556,26,10,16,317.5197677018635,0.4505561840120664,0.3078870994259897,0.17879802303714043,129803.80980436472,-2156.944892820246,127646.86491154447,1917,0,220.0,43,9,15,37.152390577083914,0.6068313953488372,45.24147727272727,1019.0340909090913,23.698467230443985,0
2419,4,0,0,50,0.0,0.0,1.0,50,1100,800,300,0.7272727272727273,14,8,6,330.92032903843653,0.45092687074829935,0.3073619631901834,0.18600004701125916,129731.44531250003,-1413.84548611111,128317.59982638892,1918,1,215.8,41,9,15,36.884372869802306,0.6089939024390244,45.3125,1018.7500000000002,24.847560975609763,0
2420,4,0,0,50,0.0,0.0,1.0,50,1550,1000,550,0.6451612903225806,21,10,11,329.067693395898,0.45013605442176874,0.30195455841810115,0.1856012368274235,129867.21543364268,-1452.9789939006168,128414.23643974206,1919,2,216.8,42,8,17,36.793936369109865,0.6088789682539683,45.17926356589147,1019.282945736433,24.268641565153168,0
2421,4,0,0,50,0.0,0.0,1.0,50,1650,1400,250,0.8484848484848485,19,14,5,330.0004102641755,0.449625850340136,0.306287180461845,0.18659829753949064,129966.00193986249,-1422.233207890146,128543.76873197233,1920,3,217.8,42,8,18,36.67007190598372,0.6098710317460317,45.082364341085274,1019.6705426356597,24.277870062753802,0
2422,4,0,0,50,0.0,0.0,1.0,50,1200,1000,200,0.8333333333333334,14,10,4,332.09555926354403,0.4491326530612245,0.31335561125034794,0.18839733859642774,130093.469540935,-1359.307295253665,128734.16224568133,1921,4,218.8,43,7,18,36.48753442247593,0.6097383720930232,44.95738636363637,1020.1704545454552,23.724894291754772,0
2423,4,1,0,51,0.0196078431372549,0.0,1.0,51,2250,1500,750,0.6666666666666666,30,15,15,329.53756244697905,0.4489052287581699,0.32657148296211713,0.18898869115834552,130515.89269967253,-1597.692615616122,128918.20008405641,1922,0,215.49019607843138,41,10,13,36.12540453074436,0.6168699186991871,44.5436507936508,1021.8253968253973,24.922570654277983,0
2424,4,0,0,51,0.0,0.0,1.0,51,1500,1000,500,0.6666666666666666,20,10,10,333.14137157313286,0.44841503267973853,0.3320261437908496,0.19168184444785796,130642.63791454092,-1495.5064838435296,129147.13143069738,1923,1,216.49019607843138,41,10,14,35.90520378457059,0.618140243902439,44.41964285714286,1022.3214285714294,24.934668989547056,0
2425,4,0,0,51,0.0,0.0,1.0,51,1050,400,650,0.38095238095238093,17,4,13,336.2038682510457,0.4476797385620915,0.33795477453833134,0.19407961263540222,130769.4446412825,-1406.9613725119589,129362.48326877055,1924,2,217.49019607843138,41,10,14,35.69875525379891,0.619410569105691,44.295634920634924,1022.8174603174609,24.946767324816122,0
2426,4,0,1,50,0.0,0.0196078431372549,0.9803921568627451,51,1800,1300,500,0.7222222222222222,23,13,10,338.6758952201553,0.44766339869281047,0.34289016110515624,0.19627980534219788,130921.6939090451,-1331.995622322999,129589.69828672211,1925,3,218.49019607843138,41,10,14,35.481695101460524,0.6209349593495934,44.1468253968254,1023.4126984126984,24.961285327138985,0
2427,4,0,0,50,0.0,0.0,1.0,50,1350,900,450,0.6666666666666666,18,9,9,344.07508907360483,0.44787414965986394,0.33966236345580936,0.199357660930449,130911.78882444324,-991.3029198889413,129920.4859045543,1926,4,221.74,40,10,14,35.353566699768294,0.6223958333333333,44.15650406504066,1023.3739837398383,25.584349593495958,0
2428,4,0,3,47,0.0,0.06,0.94,50,1300,800,500,0.6153846153846154,18,8,10,344.7890695712672,0.44761054421768703,0.33747890818858517,0.20044719422565052,131041.8228753556,-963.6423631766461,130078.18051217895,1927,5,222.74,40,10,15,35.20388751033913,0.6236979166666667,44.02947154471546,1023.8821138211408,25.59705284552852,0
2429,4,0,1,46,0.0,0.02127659574468085,0.9787234042553191,47,1500,900,600,0.6,21,9,12,363.2295604914929,0.4438791242676534,0.34140841813135925,0.20885699728260881,130617.28395061755,88.81172839508883,130706.09567901264,1928,6,237.04255319148936,38,9,15,35.161911231884055,0.6228070175438596,44.44444444444446,1022.2222222222243,26.90058479532169,0
2430,4,0,0,46,0.0,0.0,1.0,46,1200,700,500,0.5833333333333334,17,7,10,359.54853459244,0.4440619967793881,0.328574970227949,0.2078355596369842,130821.45317925386,207.3323567708727,131028.78553602473,1929,7,239.93478260869566,39,7,15,35.049150629603226,0.6231303418803419,44.244791666666686,1023.0208333333364,26.2313034188035,0
2431,4,0,0,46,0.0,0.0,1.0,46,1400,1000,400,0.7142857142857143,18,10,8,355.4918890133465,0.44383051529790657,0.3206532801175226,0.20620208391057537,130954.69292534742,110.66623263890921,131065.35915798633,1930,8,240.93478260869566,39,7,15,35.01806431915327,0.624465811965812,44.11458333333334,1023.5416666666682,26.24465811965816,0
2432,4,0,0,46,0.0,0.0,1.0,46,950,500,450,0.5263157894736842,14,5,9,354.9473077839414,0.44371980676328504,0.3215661728602577,0.2063144345480996,131034.669325087,102.0806206597432,131136.74994574673,1931,9,241.93478260869566,39,7,15,34.951101332790735,0.625267094017094,44.03645833333334,1023.8541666666682,26.25267094017098,0
2433,4,0,0,46,0.0,0.0,1.0,46,1000,700,300,0.7,13,7,6,355.40354328102376,0.44306561996779387,0.3207206546543182,0.20717827141292292,131145.89659139732,121.9432670698697,131267.8398584672,1932,10,242.93478260869566,40,6,15,34.82695042497604,0.6247395833333333,43.927845528455286,1024.288617886179,25.607215447154477,0
2434,4,0,0,46,0.0,0.0,1.0,46,1150,800,350,0.6956521739130435,15,8,7,359.4628391565276,0.4429347826086956,0.32817418904116624,0.20997128298818768,131223.97898902796,234.02881056252625,131458.0077995905,1933,11,243.93478260869566,40,6,16,34.64404384050784,0.6255208333333333,43.85162601626018,1024.5934959349615,25.61483739837404,0
2435,4,0,0,46,0.0,0.0,1.0,46,1150,800,350,0.6956521739130435,15,8,7,357.7167186352604,0.44269323671497585,0.32783746960315896,0.20923523148016068,131276.04683059047,191.9273415295354,131467.97417212,1934,12,244.93478260869566,40,6,17,34.636139759354755,0.6260416666666666,43.80081300813009,1024.7967479674815,25.619918699187036,0
2436,4,0,3,43,0.0,0.06521739130434782,0.9347826086956522,46,1350,700,650,0.5185185185185185,20,7,13,364.94498661861155,0.44194847020933975,0.3330367668811065,0.2148005548854437,131515.040418837,399.1612610069238,131914.2016798439,1935,13,245.93478260869566,39,7,18,34.20934040824617,0.6300747863247863,43.56770833333334,1025.7291666666683,26.300747863247906,0
2437,4,0,0,43,0.0,0.0,1.0,43,1450,1000,450,0.6896551724137931,19,10,9,371.58899988657606,0.4419066076042821,0.2982543715963517,0.20591761015830495,129173.52123970822,1002.8460154205984,130176.36725512882,1936,14,253.97674418604652,37,6,17,36.41721047711503,0.6100788288288288,45.86074561403508,1016.5570175438584,27.47451398767185,8
2438,4,0,1,42,0.0,0.023255813953488372,0.9767441860465116,43,1650,900,750,0.5454545454545454,24,9,15,371.1891287967095,0.4412375415282392,0.2954541358687395,0.20658973508445358,129344.54038075257,1002.260457441022,130346.8008381936,1937,15,254.97674418604652,36,7,17,36.25295213845529,0.6137152777777778,45.69256756756758,1017.2297297297314,28.256381381381427,0
2439,4,1,0,43,0.023255813953488372,0.0,1.0,43,1050,600,450,0.5714285714285714,15,6,9,362.6728343500194,0.4433831672203765,0.29029901801926883,0.20317768080501114,129602.41280131502,800.6548778508463,130403.06767916586,1938,0,254.3953488372093,36,7,16,36.2069601120696,0.6163194444444444,45.4391891891892,1018.2432432432447,28.284534534534576,0
2440,4,0,0,43,0.0,0.0,1.0,43,1150,800,350,0.6956521739130435,15,8,7,360.2927802277584,0.44329088224437063,0.2878209050383309,0.20243530993418052,129717.10519641278,747.2272948624469,130464.33249127523,1939,1,255.3953488372093,36,7,16,36.15087699904193,0.6174768518518519,45.326576576576585,1018.693693693695,28.297047047047084,0
2441,4,0,0,43,0.0,0.0,1.0,43,1200,900,300,0.75,15,9,6,339.293960662214,0.4431755260243632,0.19870338428596868,0.1900629493107821,129598.82948133702,221.8408211051188,129820.67030244213,1940,2,256.3953488372093,39,4,14,36.80573316283034,0.610844017094017,45.44270833333334,1018.2291666666683,26.108440170940213,8
2442,4,0,1,42,0.0,0.023255813953488372,0.9767441860465116,43,600,300,300,0.5,9,3,6,343.9881698451201,0.44329088224437063,0.20364473468300615,0.19321426266027747,129704.91672092023,323.3913845486201,130028.30810546885,1941,3,257.3953488372093,39,4,14,36.57848876844941,0.6119123931623931,45.33854166666667,1018.645833333334,26.11912393162395,0
2443,4,0,0,42,0.0,0.0,1.0,42,1550,1100,450,0.7096774193548387,20,11,9,343.0092589572493,0.4412383855981417,0.20567173818071316,0.19324139600130877,129822.05119307294,506.03311520920596,130328.08430828215,1942,4,261.8809523809524,40,2,14,36.48451003855871,0.6114583333333333,45.22357723577236,1019.1056910569108,25.47764227642277,0
2444,4,0,0,42,0.0,0.0,1.0,42,1150,800,350,0.6956521739130435,15,8,7,342.4867445474302,0.4415408439798684,0.2014254675505771,0.1937491055147516,129984.23450688156,503.5754637503281,130487.80997063189,1943,5,262.8809523809524,41,1,14,36.33328063689725,0.6115345528455285,45.064484126984134,1019.7420634920643,24.87175764614791,0
2445,4,0,0,42,0.0,0.0,1.0,42,1250,900,350,0.72,16,9,7,342.6697974011707,0.4411415989159892,0.20149903243428446,0.1947348914954941,130161.33334120692,520.471545099528,130681.80488630645,1944,6,263.8809523809524,41,1,16,36.149053729988985,0.6133130081300813,44.89087301587302,1020.4365079365084,24.888695315524597,0
2446,4,1,0,43,0.023255813953488372,0.0,1.0,43,1200,900,300,0.75,15,9,6,342.01901035972077,0.44160668143226284,0.22096459608634977,0.19661584936496457,130608.41064453148,334.22997345642557,130942.64061798791,1945,0,258.72093023255815,39,4,14,35.71293607119809,0.6209935897435898,44.453125000000014,1022.1875000000018,26.209935897435944,0
2447,4,0,2,41,0.0,0.046511627906976744,0.9534883720930233,43,1100,500,600,0.45454545454545453,17,5,12,341.6876474749909,0.44146825396825395,0.22322807341994544,0.19664632343240335,130651.91436975352,328.4290518210123,130980.34342157454,1946,1,259.72093023255815,40,3,14,35.67739396951624,0.6197916666666667,44.41056910569106,1022.3577235772362,25.558943089430905,0
2448,4,0,0,41,0.0,0.0,1.0,41,1350,1100,250,0.8148148148148148,16,11,5,357.19373995738863,0.4398882113821138,0.22065130692054935,0.2058218714709314,130699.20562358478,1136.987613229615,131836.1932368144,1947,2,257.609756097561,38,3,14,35.23316964441194,0.6236293859649122,44.364316239316246,1022.5427350427364,26.909019343229904,0
2449,4,0,0,41,0.0,0.0,1.0,41,1250,800,450,0.64,17,8,9,362.6193021428263,0.4399390243902439,0.2295962800930993,0.20998595380435264,130890.45606874143,1292.6811673606658,132183.1372361021,1948,3,258.609756097561,38,3,16,34.90072736131413,0.6255482456140351,44.17735042735043,1023.2905982905992,26.92869995501577,0
2450,4,0,1,40,0.0,0.024390243902439025,0.975609756097561,41,1450,900,550,0.6206896551724138,20,9,11,360.2462611586923,0.4392530487804878,0.22729956431450793,0.20950243731461826,131054.49631090669,1242.3784608079627,132296.87477171465,1949,4,259.609756097561,38,3,18,34.795405537006125,0.6271929824561404,44.017094017094024,1023.9316239316249,26.945569050832233,0
2451,4,0,0,40,0.0,0.0,1.0,40,1300,1000,300,0.7692307692307693,16,10,6,345.75643270380164,0.4391426282051282,0.19562129572859188,0.19513105250515592,129890.673828125,988.9586229705416,130879.63245109555,1950,5,264.025,39,1,15,36.344863410314055,0.6137820512820513,45.15625,1019.375,26.137820512820515,8
2452,4,0,0,40,0.0,0.0,1.0,40,1050,800,250,0.7619047619047619,13,8,5,346.0515566425057,0.43876869658119655,0.19512257405515832,0.19582917569538333,129996.88042534729,997.124565972226,130994.00499131951,1951,6,265.025,39,1,15,36.229570990806955,0.6148504273504274,45.052083333333336,1019.7916666666672,26.148504273504287,0
2453,4,1,2,39,0.024390243902439025,0.04878048780487805,0.9512195121951219,41,1200,900,300,0.75,15,9,6,345.9362583123925,0.4402184959349593,0.21662263175899454,0.19815938488971419,130470.15587819759,826.8715091876627,131297.02738738526,1952,0,259.5365853658537,40,1,17,35.75280181703639,0.61796875,44.588414634146346,1021.6463414634154,25.541158536585385,0
2454,4,0,0,39,0.0,0.0,1.0,39,900,700,200,0.7777777777777778,11,7,4,352.72923133269353,0.43988978857399913,0.20804006896237381,0.20210602991219606,130480.80490037637,1404.878803236194,131885.68370361257,1953,1,248.0,38,1,17,35.56851057896756,0.6214364035087719,44.57799145299146,1021.6880341880354,26.886527215474615,0
2455,4,1,1,39,0.025,0.025,0.975,40,1250,1100,150,0.88,14,11,3,348.8024527487256,0.4406784188034188,0.22015373650987557,0.20176311489387425,130848.09570312513,1128.027343750014,131976.12304687515,1954,0,242.775,39,1,14,35.29703726328649,0.6233974358974359,44.21875000000001,1023.125000000001,26.233974358974386,0
2456,4,0,0,39,0.0,0.0,1.0,39,950,600,350,0.631578947368421,13,6,7,352.39453583834273,0.4409581646423752,0.21388406914722702,0.2037759707239113,130835.7988165681,1421.1641190006626,132256.96293556876,1955,1,247.56410256410257,38,1,15,35.21760129490392,0.625,44.23076923076923,1023.0769230769234,26.923076923076934,0
2457,4,0,1,38,0.0,0.02564102564102564,0.9743589743589743,39,950,700,250,0.7368421052631579,12,7,5,352.46515313162024,0.4400865946918579,0.2153107358243591,0.20425067766774319,130917.78897518099,1428.7917077580762,132346.58068293906,1956,2,248.56410256410257,38,1,15,35.132842676688604,0.6258223684210527,44.150641025641036,1023.3974358974374,26.931511470985196,0
2458,4,0,0,38,0.0,0.0,1.0,38,900,600,300,0.6666666666666666,12,6,6,357.66538271234026,0.43846313418681837,0.2174562719204267,0.20735706100850826,130935.05333371807,1766.1871922129894,132701.24052593106,1957,3,254.60526315789474,37,1,16,34.982322691236334,0.6278153153153153,44.13377192982456,1023.4649122807017,27.66121384542437,0
2459,4,0,0,38,0.0,0.0,1.0,38,1150,900,250,0.782608695652174,14,9,5,361.42666030062315,0.43792970602181125,0.21421277717083975,0.21063813934967032,131136.55495516487,1879.2494201548852,133015.80437531977,1958,4,255.60526315789474,38,0,16,34.68216508466328,0.628015350877193,43.93696581196582,1024.2521367521379,26.95400359874047,0
2460,4,0,0,38,0.0,0.0,1.0,38,1400,1200,200,0.8571428571428571,16,12,4,363.87791188236474,0.4366702228544334,0.2180600061454716,0.21282420309607608,131273.37643363306,1953.4964204836238,133226.8728541167,1959,5,256.60526315789474,38,0,16,34.480991103697534,0.6293859649122807,43.803418803418815,1024.7863247863265,26.96806117858754,0
2461,4,1,0,39,0.02564102564102564,0.0,1.0,39,1300,1000,300,0.7692307692307693,16,10,6,362.0716341958917,0.4362910481331534,0.23544840992785465,0.21474356265006514,131806.21831957914,1744.6814013785772,133550.89972095774,1960,0,251.0,37,2,14,33.98903274604022,0.6365427927927928,43.28399122807018,1026.8640350877197,27.75308202939783,0
2462,4,0,0,39,0.0,0.0,1.0,39,950,500,450,0.5263157894736842,14,5,9,359.96856600932335,0.4359817813765183,0.2337338118271184,0.21381265426818838,131862.52170138885,1693.2725694444391,133555.79427083328,1961,1,252.0,37,2,14,33.986223799864774,0.6371058558558558,43.229166666666664,1027.083333333333,27.759009009009002,0
2463,4,0,0,39,0.0,0.0,1.0,39,1450,1100,350,0.7586206896551724,18,11,7,363.2251571220665,0.4357849752586595,0.2429918816643819,0.21638798139802198,131975.1645337989,1787.3399747999422,133762.50450859885,1962,2,253.0,37,2,15,33.78897218368726,0.6382319819819819,43.11951754385965,1027.5219298245618,27.7708629682314,0
2464,4,0,0,39,0.0,0.0,1.0,39,1300,800,500,0.6153846153846154,18,8,10,363.0481635555557,0.43586932073774176,0.24164102564102574,0.21692648396005948,132087.85545792934,1790.8506703985809,133878.70612832793,1963,3,254.0,37,2,15,33.67988888888889,0.6393581081081081,43.00986842105263,1027.9605263157891,27.78271692745376,0
2465,4,0,0,39,0.0,0.0,1.0,39,1200,700,500,0.5833333333333334,17,7,10,365.0074331358742,0.43536324786324787,0.2449401344923734,0.218911107596835,132228.78674207442,1852.8980070790942,134081.6847491535,1964,4,255.0,37,2,15,33.487473347547976,0.6407657657657657,42.872807017543856,1028.508771929824,27.797534376481728,0
2466,4,0,0,39,0.0,0.0,1.0,39,1000,600,400,0.6,14,6,8,359.04640405510185,0.4341824111560954,0.23759536511214407,0.2164655488031623,132426.21678064385,1709.4313875422993,134135.64816818616,1965,5,256.0,37,2,16,33.44197205354923,0.6427364864864865,42.68092105263157,1029.2763157894722,27.81827880512087,0
2467,4,0,2,37,0.0,0.05128205128205128,0.9487179487179487,39,850,600,250,0.7058823529411765,11,6,5,360.14648009542395,0.43373256860098963,0.23674267243262181,0.21794431321238505,132567.3284087409,1748.7313404124086,134316.0597491533,1966,6,257.0,37,2,16,33.27166737649062,0.6441441441441442,42.543859649122794,1029.8245614035068,27.83309625414883,0
2468,4,0,1,36,0.0,0.02702702702702703,0.972972972972973,37,1350,800,550,0.5925925925925926,19,8,11,368.1573103886949,0.43105605605605607,0.23933579248539916,0.22264751628268686,132542.91453615774,2359.328585342094,134902.24312149984,1967,7,266.0810810810811,36,1,17,33.0900043744532,0.6458333333333333,42.567567567567565,1029.7297297297293,28.60360360360359,0
2469,4,0,0,36,0.0,0.0,1.0,36,1250,1000,250,0.8,15,10,5,371.84290013727156,0.4312169312169312,0.2302577358207838,0.22507878404227502,132576.73852237655,2659.5437885802457,135236.2823109568,1968,8,268.0833333333333,35,1,17,32.96105866486851,0.6482142857142856,42.53472222222222,1029.861111111111,29.424603174603174,0
2470,4,0,0,36,0.0,0.0,1.0,36,1100,700,400,0.6363636363636364,15,7,8,372.0911646965656,0.43105158730158727,0.2231206948188078,0.22630462639741947,132755.59413580256,2679.4367283950687,135435.03086419762,1969,9,269.0833333333333,35,1,16,32.77459568733154,0.65,42.361111111111114,1030.555555555556,29.44444444444446,0
2471,4,0,0,36,0.0,0.0,1.0,36,1250,900,350,0.72,16,9,7,368.4765226697937,0.43048941798941803,0.21664670957441468,0.22482115506455644,132874.89819101515,2592.256087105631,135467.15427812078,1970,10,270.0833333333333,35,1,16,32.74771740757372,0.6511904761904762,42.245370370370374,1031.018518518519,29.45767195767197,0
2472,4,0,0,36,0.0,0.0,1.0,36,900,600,300,0.6666666666666666,12,6,6,372.3293541475359,0.4303571428571429,0.21980920314253627,0.22753460531238315,132934.57031250012,2699.0885416666806,135633.6588541668,1971,11,271.0833333333333,35,1,16,32.58838383838384,0.6517857142857143,42.18750000000001,1031.250000000001,29.46428571428574,0
2473,4,0,1,35,0.0,0.027777777777777776,0.9722222222222222,36,1500,1200,300,0.8,18,12,6,374.7694107099013,0.42958002645502646,0.22253076031265184,0.2295752410761071,133024.10361207597,2770.6729841821398,135794.7765962581,1972,12,272.0833333333333,35,1,17,32.4354173678896,0.6526785714285714,42.100694444444464,1031.597222222225,29.474206349206426,0
2474,4,0,0,35,0.0,0.0,1.0,35,1150,900,250,0.782608695652174,14,9,5,379.1878609775002,0.42906162464986,0.22935610431571662,0.23239335242086417,133042.01388888902,3089.583333333352,136131.59722222236,1973,13,279.0,34,1,17,32.3034464189553,0.6550245098039216,42.08333333333334,1031.6666666666679,30.343137254901997,0
2475,4,0,0,35,0.0,0.0,1.0,35,1350,1100,250,0.8148148148148148,16,11,5,378.7118939552034,0.4286764705882353,0.2239638778570603,0.23267564909267618,133134.14292800464,3083.896683673487,136218.03961167813,1974,14,280.0,34,1,17,32.22305533125697,0.6559436274509804,41.99404761904763,1032.0238095238105,30.353641456582665,0
2476,4,1,0,36,0.027777777777777776,0.0,1.0,36,1550,1300,250,0.8387096774193549,18,13,5,372.87049077746656,0.4278935185185185,0.22156899340549963,0.23155309336876068,133532.02830289793,2758.0305855624315,136290.05888846036,1975,0,273.19444444444446,35,1,19,31.974150802538276,0.6577380952380952,41.608796296296305,1033.564814814816,29.53042328042331,0
2477,4,0,1,35,0.0,0.027777777777777776,0.9722222222222222,36,850,500,350,0.5882352941176471,12,5,7,375.716763258512,0.4275793650793651,0.22629886687314205,0.233886957922529,133621.76254125955,2840.7872245799185,136462.54976583947,1976,1,274.19444444444446,35,1,19,31.810538639501473,0.6586309523809524,41.52199074074075,1033.912037037038,29.540343915343946,0
2478,4,0,0,35,0.0,0.0,1.0,35,1250,700,550,0.56,18,7,11,379.58393097505893,0.4264705882352941,0.21655347070335007,0.23671540620102932,133687.5868055556,3149.13194444445,136836.71875000003,1977,2,277.51428571428573,34,1,19,31.644507117915648,0.6614583333333333,41.458333333333336,1034.166666666667,30.416666666666675,0
2479,4,0,0,35,0.0,0.0,1.0,35,750,500,250,0.6666666666666666,10,5,5,380.5911924729129,0.4257002801120448,0.211099242411793,0.23853491248500586,133872.32320011334,3190.125425170068,137062.4486252834,1978,3,278.51428571428573,34,1,16,31.433097511407645,0.663296568627451,41.279761904761905,1034.8809523809523,30.437675070028007,0
2480,4,0,1,34,0.0,0.02857142857142857,0.9714285714285714,35,900,600,300,0.6666666666666666,12,6,6,383.44592979947373,0.42478991596638654,0.21735573843197176,0.24113009771988594,133995.55165816325,3276.0097789115625,137271.56143707482,1979,4,279.51428571428573,34,1,16,31.2356272277797,0.6645220588235294,41.160714285714285,1035.3571428571427,30.451680672268903,0
2481,4,0,0,34,0.0,0.0,1.0,34,750,500,250,0.6666666666666666,10,5,5,410.10164602458696,0.424520944741533,0.21898395721925112,0.2394168827350244,131202.54229142654,3961.275711264918,135163.81800269146,1980,20,288.61764705882354,33,1,17,33.368720095693774,0.6388888888888888,43.87254901960785,1024.50980392157,31.04575163398697,8
2482,4,0,0,34,0.0,0.0,1.0,34,1000,800,200,0.8,12,8,4,409.4839089331276,0.4247994652406417,0.220695500488848,0.23964408190397127,131296.72369100837,3952.779129421391,135249.50282042977,1981,21,289.61764705882354,33,1,17,33.28886663478018,0.6398358585858586,43.78063725490197,1024.8774509803932,31.05689245395131,0
2483,4,1,0,35,0.02857142857142857,0.0,1.0,35,1100,700,400,0.6363636363636364,15,7,8,400.9917216148066,0.42678571428571427,0.22339068238932858,0.2370663058186739,131684.26890432113,3560.867848637293,135245.1367529584,1982,0,282.3142857142857,32,3,15,33.113441587731174,0.6461588541666667,43.402777777777786,1026.38888888889,32.074652777777814,0
2484,4,1,1,35,0.027777777777777776,0.027777777777777776,0.9722222222222222,36,1450,1200,250,0.8275862068965517,17,12,5,393.69133752225036,0.4261904761904762,0.2322540060919085,0.23559702723335807,132145.87688629376,3204.937403883121,135350.81429017687,1983,0,275.44444444444446,33,3,17,32.8337306317044,0.6483585858585859,42.95343137254902,1028.186274509804,31.157159833630423,0
2485,4,0,0,35,0.0,0.0,1.0,35,1100,800,300,0.7272727272727273,14,8,6,404.7931802684065,0.42503501400560223,0.23152086916540338,0.24203920094594905,132114.3779585978,3695.799842608627,135810.17780120642,1984,1,279.77142857142854,33,2,17,32.5802390034569,0.6480429292929293,42.98406862745099,1028.0637254901972,31.15344622697567,0
2486,4,0,0,35,0.0,0.0,1.0,35,1100,900,200,0.8181818181818182,13,9,4,404.1681446685271,0.42394957983193277,0.24092306675042163,0.24289437456365848,132306.12953514734,3694.784580498859,136000.91411564618,1985,2,280.77142857142854,34,1,17,32.40231813623389,0.647671568627451,42.797619047619044,1028.8095238095234,30.25910364145657,0
2487,4,0,0,35,0.0,0.0,1.0,35,1000,700,300,0.7,13,7,6,399.1214410988541,0.4237394957983193,0.23620589936379366,0.24044633158882198,132398.0034722223,3568.608276643996,135966.6117488663,1986,3,281.77142857142854,33,2,17,32.439271255060724,0.6508838383838385,42.708333333333336,1029.1666666666672,31.186868686868703,0
2488,4,0,0,35,0.0,0.0,1.0,35,950,600,350,0.631578947368421,13,6,7,403.228031819993,0.42314425770308123,0.2366919440949431,0.24373539016917872,132524.15687475982,3687.4909890426907,136211.6478638025,1987,4,282.77142857142854,33,2,17,32.20612155835912,0.6521464646464646,42.5857843137255,1029.656862745099,31.201723113487848,0
2489,4,0,0,35,0.0,0.0,1.0,35,1350,900,450,0.6666666666666666,18,9,9,398.2318370550213,0.42237394957983193,0.2371832996312595,0.24172816275245967,132681.93310565656,3567.633992935419,136249.56709859197,1988,5,283.77142857142854,33,2,17,32.17544407438246,0.6537247474747474,42.43259803921569,1030.269607843138,31.220291146761756,0
2490,4,0,0,35,0.0,0.0,1.0,35,1100,800,300,0.7272727272727273,14,8,6,397.2129888969165,0.4218487394957983,0.22980805163920515,0.24171933694812364,132776.6438989812,3548.121515763173,136324.76541474435,1989,6,284.77142857142854,33,2,17,32.106123662306786,0.6546717171717171,42.34068627450981,1030.6372549019611,31.231431966726095,0
2491,4,0,0,35,0.0,0.0,1.0,35,1000,600,400,0.6,14,6,8,395.75553514947467,0.42083333333333334,0.2365367965367966,0.24185060481356774,132934.5703125,3521.918402777778,136456.48871527778,1990,7,285.77142857142854,33,2,17,31.984427609427605,0.65625,42.1875,1031.25,31.25,0
2492,4,0,1,34,0.0,0.02857142857142857,0.9714285714285714,35,1150,800,350,0.6956521739130435,15,8,7,395.4818332978564,0.42023809523809524,0.23286155517089235,0.24229738520388316,133029.37121539787,3522.139922145325,136551.5111375432,1991,8,286.77142857142854,33,2,17,31.895937277263005,0.6571969696969697,42.095588235294116,1031.6176470588232,31.26114081996434,0
2493,4,0,0,34,0.0,0.0,1.0,34,650,500,150,0.7692307692307693,8,5,3,402.7465790310689,0.4199903446226976,0.2239571684186985,0.24633104717481652,132966.16685890043,3910.333765859284,136876.5006247597,1992,9,286.0,33,1,17,31.772318599493033,0.6565656565656566,42.15686274509804,1031.3725490196077,31.25371360665478,0
2494,4,0,0,34,0.0,0.0,1.0,34,1100,700,400,0.6363636363636364,15,7,8,400.8804288177063,0.4196561200237671,0.22074939100106605,0.24629570782570476,133134.14292800444,3874.174461451236,137008.31738945568,1993,10,287.0,34,0,17,31.65109393624793,0.6559436274509804,41.99404761904761,1032.0238095238087,30.353641456582608,0
2495,4,0,0,34,0.0,0.0,1.0,34,500,200,300,0.4,8,2,6,401.0235616059301,0.419229055258467,0.22202998846597466,0.2465868283066251,133164.85969387757,3880.449263038551,137045.30895691612,1994,11,288.0,34,0,17,31.61644559784699,0.65625,41.964285714285715,1032.1428571428573,30.35714285714286,0
2496,4,0,0,34,0.0,0.0,1.0,34,1150,700,450,0.6086956521739131,16,7,9,405.0815837407014,0.41889483065953653,0.2233517340530864,0.2499059500260913,133287.7621882086,3998.483560090702,137286.24574829932,1995,12,289.0,34,0,18,31.387864114979635,0.6574754901960784,41.845238095238095,1032.6190476190475,30.37114845938375,0
2497,4,0,0,34,0.0,0.0,1.0,34,1000,900,100,0.9,11,9,2,402.9818085045553,0.418560606060606,0.2218764407561089,0.24902209192204577,133349.23469387757,3947.463151927436,137296.697845805,1996,13,290.0,34,0,18,31.380148301828807,0.6580882352941176,41.785714285714285,1032.857142857143,30.378151260504204,0
2498,4,0,0,34,0.0,0.0,1.0,34,500,400,100,0.8,6,4,2,403.77367069209055,0.4178550207961973,0.21850385694725016,0.2499249582215377,133410.72137188193,3973.5473356008883,137384.2687074828,1997,14,291.0,34,0,18,31.297774064684642,0.6587009803921569,41.72619047619047,1033.095238095237,30.385154061624615,0
2499,4,0,1,33,0.0,0.029411764705882353,0.9705882352941176,34,750,400,350,0.5333333333333333,11,4,7,401.87817488210874,0.4179849970291147,0.21480178659780558,0.2489579357460257,133441.47002551015,3925.4428854875246,137366.91291099766,1998,15,292.0,34,0,18,31.31577178630411,0.6590073529411764,41.69642857142857,1033.2142857142853,30.38865546218486,0
2500,4,0,0,33,0.0,0.0,1.0,33,850,500,350,0.5882352941176471,12,5,7,406.19628062651293,0.4183238636363636,0.20412932264871997,0.25119797867944815,133377.26362757114,4235.469681132256,137612.7333087034,1999,16,296.1212121212121,33,0,18,31.26890793688456,0.6606691919191919,41.75857843137255,1032.9656862745098,31.301990493166965,0
2501,4,1,1,33,0.029411764705882353,0.029411764705882353,0.9705882352941176,34,1050,900,150,0.8571428571428571,12,9,3,391.8661168603973,0.4196561200237671,0.188539070859695,0.244461185316338,133700.6447843334,3678.618080853554,137379.26286518693,2000,0,288.38235294117646,32,2,17,31.31384039392829,0.6663411458333333,41.44570707070708,1034.217171717173,32.319286616161655,0
2502,4,0,0,33,0.0,0.0,1.0,33,900,700,200,0.7777777777777778,11,7,4,400.8890772979124,0.417416351010101,0.19357597135374927,0.24900293392729492,133539.5050048828,4106.905788845486,137646.4107937283,2001,18,298.1212121212121,31,2,18,31.242651381540266,0.6673387096774194,41.6015625,1033.59375,33.341733870967744,0
2503,4,0,0,33,0.0,0.0,1.0,33,1200,1000,200,0.8333333333333334,14,10,4,403.38559346230255,0.4171006944444444,0.19775589649645076,0.2510095307281098,133606.80474175338,4179.012044270825,137785.8167860242,2002,19,299.1212121212121,31,2,18,31.110411418975648,0.668010752688172,41.53645833333333,1033.8541666666658,33.35013440860212,0
2504,4,0,0,33,0.0,0.0,1.0,33,1100,900,200,0.8181818181818182,13,9,4,400.4749828925655,0.4166666666666667,0.19269619269619276,0.24961111947413303,133668.00103305772,4106.138085399433,137774.13911845715,2003,20,300.1212121212121,32,1,18,31.12408424908425,0.666015625,41.47727272727272,1034.090909090908,32.31534090909088,0
2505,4,0,0,33,0.0,0.0,1.0,33,800,600,200,0.75,10,6,4,400.06472287925794,0.416824494949495,0.1865148926413267,0.2502389571963846,133798.5999515355,4105.619962248743,137904.21991378424,2004,21,301.1212121212121,32,1,17,31.00337645431616,0.6673177083333333,41.3510101010101,1034.5959595959591,32.33112373737372,0
2506,4,0,0,33,0.0,0.0,1.0,33,800,500,300,0.625,11,5,6,397.6241915395159,0.41548295454545453,0.18190688443158232,0.24981768171896504,133961.93827479353,4053.3014807162745,138015.2397555098,2005,22,302.1212121212121,32,1,17,30.90239663373584,0.6689453125,41.19318181818183,1035.2272727272739,32.35085227272731,0
2507,4,0,0,33,0.0,0.0,1.0,33,750,300,450,0.4,12,3,9,401.06118649722885,0.4145754419191919,0.18305202457341951,0.2528750893802282,134092.6806735283,4155.873922303857,138248.55459583213,2006,23,303.1212121212121,32,1,17,30.682118330692035,0.6702473958333333,41.0669191919192,1035.7323232323238,32.36663510101012,0
2508,4,0,0,33,0.0,0.0,1.0,33,1000,800,200,0.8,12,8,4,399.9014077436225,0.41449652777777773,0.1781763698016361,0.2526731316191768,134169.6177551904,4130.923803344882,138300.5415585353,2007,24,304.1212121212121,33,0,17,30.63490655311096,0.6685606060606061,40.992647058823536,1036.0294117647068,31.39483065953657,0
2509,4,0,0,33,0.0,0.0,1.0,33,1000,800,200,0.8,12,8,4,399.45065529073906,0.41398358585858586,0.17762585055951519,0.2530452578122683,134264.85794225783,4126.437097510585,138391.29503976842,2008,25,305.1212121212121,33,0,18,30.550998186906316,0.6695075757575757,40.90073529411765,1036.39705882353,31.40597147950091,0
2510,4,0,0,33,0.0,0.0,1.0,33,750,600,150,0.8,9,6,3,401.83551214865804,0.4133128156565657,0.17729833496291314,0.25544179325994,134391.89742226567,4200.687385861228,138592.5848081269,2009,26,306.1212121212121,33,0,20,30.361733246661146,0.670770202020202,40.778186274509814,1036.8872549019625,31.420825906120076,0
2511,4,0,0,33,0.0,0.0,1.0,33,1150,1000,150,0.8695652173913043,13,10,3,404.99346784729244,0.4122080176767677,0.17695022514299574,0.2585727525486562,134550.78125000015,4298.4375000000155,138849.21875000017,2010,27,307.1212121212121,33,0,20,30.12048192771084,0.6723484848484849,40.62500000000001,1037.5000000000011,31.439393939393973,0
2512,4,0,0,33,0.0,0.0,1.0,33,800,400,400,0.5,12,4,8,403.49358815536743,0.4110243055555556,0.1728905648136887,0.2585440988484238,134681.81060924914,4268.649404397519,138950.46001364666,2011,28,308.1212121212121,32,1,21,30.028027814945464,0.6761067708333333,40.49873737373738,1038.005050505051,32.437657828282845,0
2513,4,0,0,33,0.0,0.0,1.0,33,750,500,250,0.6666666666666666,10,5,5,402.3454059675391,0.410195707070707,0.17161154345006446,0.25850692333414405,134780.12447709424,4245.632779818395,139025.75725691265,2012,29,309.1212121212121,32,1,16,29.95931622892348,0.6770833333333333,40.40404040404041,1038.383838383839,32.44949494949497,0
2514,4,0,0,33,0.0,0.0,1.0,33,1100,600,500,0.5454545454545454,16,6,10,404.1079241614001,0.4088541666666667,0.17169016366877354,0.26057993730407525,134911.26543209876,4303.742283950619,139215.00771604938,2013,30,310.1212121212121,32,1,16,29.78219696969696,0.6783854166666667,40.27777777777778,1038.888888888889,32.46527777777778,0
2515,4,0,1,32,0.0,0.030303030303030304,0.9696969696969697,33,450,300,150,0.6666666666666666,6,3,3,381.5316258225983,0.40893308080808083,0.1620107128141739,0.21828789624503675,130423.75299714312,3352.157305376997,133775.91030252012,2014,31,311.1212121212121,32,1,21,34.89081170168932,0.6334635416666667,44.63383838383838,1021.4646464646463,31.920770202020197,8
2516,4,1,0,33,0.030303030303030304,0.0,1.0,33,550,400,150,0.7272727272727273,7,4,3,376.58906996612524,0.4114977904040404,0.1466934497424559,0.21744462265114614,130778.66934815323,3249.9634922456844,134028.6328403989,2015,0,272.030303030303,32,1,18,34.65672962185737,0.6370442708333333,44.28661616161616,1022.8535353535352,31.964172979797976,0
2517,4,0,0,33,0.0,0.0,1.0,33,850,500,350,0.5882352941176471,12,5,7,376.950264655783,0.4110637626262626,0.1434403247874747,0.21856644100856784,130940.15438475674,3271.5851698806327,134211.73955463737,2016,1,273.030303030303,32,1,19,34.483715766099195,0.638671875,44.12878787878788,1023.4848484848491,31.983901515151533,0
2518,4,1,0,34,0.029411764705882353,0.0,1.0,34,850,500,350,0.5882352941176471,12,5,7,381.3117611249747,0.41456847890671417,0.15628647565353382,0.2049263005965408,127952.84162649226,3006.4810032139676,130959.32262970622,2017,0,265.97058823529414,32,2,19,37.41966179957569,0.6083984375,47.064393939393945,1011.7424242424247,31.616950757575772,8
2519,4,0,0,34,0.0,0.0,1.0,34,1000,700,300,0.7,13,7,6,382.7754906860371,0.4140857100415924,0.1603847496136126,0.2062193592678394,128051.48748378026,3002.994190936181,131054.48167471644,2018,1,266.97058823529414,33,1,19,37.2814253137991,0.6070075757575757,46.966911764705884,1012.1323529411764,30.67067736185383,0
2520,4,2,0,36,0.05555555555555555,0.0,1.0,36,1100,800,300,0.7272727272727273,14,8,6,405.55612950915287,0.4197916666666666,0.18515614528883506,0.22383890237222923,129014.56921616718,3305.957744617496,132320.5269607847,2019,0,253.08333333333334,33,3,18,35.71672698029756,0.6167929292929293,46.01715686274512,1015.9313725490222,30.785799168152188,8
2521,4,1,0,37,0.02702702702702703,0.0,1.0,37,1150,800,350,0.6956521739130435,15,8,7,396.7404586480658,0.4224537037037037,0.179450600274895,0.2203582547430828,129263.69214965432,2856.9624663591385,132120.65461601346,2020,0,247.21621621621622,33,4,19,35.68580782517878,0.6193181818181819,45.772058823529434,1016.9117647058852,30.81550802139046,0
2522,4,1,1,37,0.02631578947368421,0.02631578947368421,0.9736842105263158,38,900,700,200,0.7777777777777778,11,7,4,386.3184756042599,0.42475699383594123,0.18119491900940332,0.21621698974919085,129564.73922902528,2410.650510204122,131975.3897392294,2021,0,241.68421052631578,34,4,16,35.64346546616778,0.6200980392156863,45.476190476190496,1018.0952380952407,29.94397759103649,0
2523,4,0,2,35,0.0,0.05405405405405406,0.9459459459459459,37,500,300,200,0.6,7,3,4,389.29633862264063,0.4241741741741742,0.16819766100720157,0.21805183917743626,129595.04145408193,2690.175028344711,132285.21648242665,2022,1,245.24324324324326,34,3,16,35.5367512373826,0.6204044117647058,45.44642857142859,1018.2142857142882,29.94747899159671,0
2524,4,0,0,35,0.0,0.0,1.0,35,1050,800,250,0.7619047619047619,13,8,5,406.90289518636916,0.4183823529411765,0.18321455164344225,0.2267512814254334,129394.01113406813,3530.159550045936,132924.17068411407,2023,2,260.0571428571429,32,3,20,35.294117647058826,0.623046875,45.643939393939405,1017.4242424242439,31.79450757575762,0
2525,4,0,0,35,0.0,0.0,1.0,35,850,600,250,0.7058823529411765,11,6,5,407.6313504793452,0.4182072829131653,0.18752924494859946,0.22752830227586732,129458.25043362938,3554.2482909907335,133012.49872462012,2024,3,261.0571428571429,32,3,16,35.20988420181968,0.6236979166666667,45.58080808080809,1017.6767676767689,31.80239898989903,0
2526,4,0,1,34,0.0,0.02857142857142857,0.9714285714285714,35,1200,900,300,0.75,15,9,6,402.7436127452925,0.41768207282913167,0.17952306449117117,0.225650484039153,129606.6285352991,3439.648362408709,133046.2768977078,2025,4,262.0571428571429,33,2,16,35.1826082159907,0.622790404040404,45.43504901960785,1018.25980392157,30.85635769459303,0
2527,4,1,0,35,0.02857142857142857,0.0,1.0,35,700,400,300,0.5714285714285714,10,4,6,398.65897505250257,0.4200980392156863,0.1938956981494837,0.2256897952644168,130012.50270328723,3366.1302143406447,133378.63291762787,2026,0,259.48571428571427,33,2,17,34.87242650004006,0.6268939393939394,45.036764705882355,1019.8529411764708,30.904634581105178,0
2528,4,0,0,35,0.0,0.0,1.0,35,1200,600,600,0.5,18,6,12,400.4735183270712,0.4203781512605042,0.18780805931214428,0.22708048818491422,130075.001201461,3418.318675509423,133493.31987697043,2027,1,260.48571428571427,33,2,17,34.76243392599711,0.6275252525252526,44.97549019607843,1020.0980392156864,30.91206179441474,0
2529,4,1,1,35,0.027777777777777776,0.027777777777777776,0.9722222222222222,36,650,500,150,0.7692307692307693,8,5,3,388.95022339066253,0.42223875661375665,0.18328283416851154,0.22265389372350075,130444.94224773253,2947.317885487535,133392.26013322006,2028,0,254.22222222222223,34,2,18,34.67981587227595,0.6289828431372548,44.61309523809524,1021.5476190476198,30.045518207282935,0
2530,4,0,0,35,0.0,0.0,1.0,35,1250,1000,250,0.8,15,10,5,396.93124046116634,0.4220238095238095,0.18632109431245514,0.22688785720187649,130387.71896626291,3350.991806036131,133738.71077229903,2029,1,258.65714285714284,33,2,18,34.53423726101913,0.6306818181818181,44.66911764705882,1021.3235294117642,30.949197860962553,0
2531,4,1,0,36,0.027777777777777776,0.0,1.0,36,900,500,400,0.5555555555555556,13,5,8,390.11033218752186,0.4234126984126984,0.19064936576283054,0.22543497541946012,130810.03578514725,3006.069302721072,133816.10508786832,2030,0,252.44444444444446,34,2,18,34.279112843787566,0.6326593137254901,44.25595238095237,1022.9761904761893,30.087535014005567,0
2532,4,0,0,36,0.0,0.0,1.0,36,700,200,500,0.2857142857142857,12,2,10,389.2267952098187,0.4226686507936508,0.18949970913321756,0.22527975116689483,130870.93431122434,2987.6948696144946,133858.62918083882,2031,1,253.44444444444446,34,2,18,34.239868140391714,0.6332720588235294,44.19642857142856,1023.2142857142844,30.094537815126014,0
2533,4,1,0,37,0.02702702702702703,0.0,1.0,37,800,600,200,0.75,10,6,4,381.5893962283807,0.4246746746746746,0.19253283336437743,0.2226399305219115,131179.874038173,2611.369786308295,133791.2438244813,2032,0,247.56756756756758,35,2,20,34.12196832749595,0.6342261904761906,43.894675925925924,1024.4212962962963,29.269179894179896,0
2534,4,0,0,37,0.0,0.0,1.0,37,800,500,300,0.625,11,5,6,385.57135804839515,0.4241428928928929,0.1938325991189429,0.22531110447540853,131239.1643759644,2720.4125675154214,133959.57694347983,2033,1,248.56756756756758,35,2,20,33.9598864791596,0.6348214285714286,43.83680555555555,1024.652777777777,29.275793650793627,0
2535,4,1,0,38,0.02631578947368421,0.0,1.0,38,1400,1100,300,0.7857142857142857,17,11,6,376.6488127184665,0.42706851588430533,0.19755541572179935,0.22232812074313718,131624.8780971363,2315.3009527177433,133940.17904985405,2034,0,243.0,35,3,19,33.79812391909165,0.6386904761904761,43.46064814814814,1026.157407407406,29.31878306878303,0
2536,4,0,0,38,0.0,0.0,1.0,38,1250,800,450,0.64,17,8,9,373.8622565801226,0.4258238501659554,0.19655606281852211,0.22181196602173966,131819.1518165125,2256.441111719831,134075.5929282323,2035,1,244.0,36,2,19,33.67328288920568,0.638599537037037,43.2713963963964,1026.9144144144148,28.52540040040041,0
2537,4,0,1,37,0.0,0.02631578947368421,0.9736842105263158,38,850,500,350,0.5882352941176471,12,5,7,376.26483265971035,0.42512743006164055,0.1940515471053783,0.2240887945944647,131963.7458404351,2330.663349159978,134294.40918959506,2036,2,245.0,36,2,19,33.46553960251351,0.6400462962962963,43.130630630630634,1027.477477477478,28.541041041041055,0
2538,4,0,0,37,0.0,0.0,1.0,37,1100,800,300,0.7272727272727273,14,8,6,383.256051248925,0.4217655155155155,0.1964804561153446,0.22764485935628934,131862.52170138896,2707.4218750000095,134569.94357638896,2037,3,252.51351351351352,35,2,19,33.38826910074375,0.6410714285714285,43.22916666666667,1027.083333333334,29.345238095238113,0
2539,4,0,0,37,0.0,0.0,1.0,37,850,500,350,0.5882352941176471,12,5,7,346.059108150267,0.4219844844844845,0.1438125241806223,0.1945090849258397,129731.4453125,1580.0347222222217,131311.48003472222,2038,4,253.51351351351352,35,2,16,36.49880708929788,0.6196428571428572,45.3125,1018.75,29.107142857142858,8
2540,4,0,0,37,0.0,0.0,1.0,37,1150,700,450,0.6086956521739131,16,7,9,345.6127434430999,0.42189064064064064,0.14271596147589816,0.1948441625326463,129849.38298396765,1575.5202974965573,131424.9032814642,2039,5,254.51351351351352,35,2,17,36.39043455219925,0.6208333333333333,45.19675925925925,1019.2129629629619,29.120370370370342,0
2541,4,1,2,36,0.02631578947368421,0.05263157894736842,0.9473684210526316,38,550,300,250,0.5454545454545454,8,3,5,335.69346105789253,0.42447546230440963,0.15349087003222328,0.1912672045562412,130262.58680555562,1145.659722222232,131408.24652777784,2040,0,248.78947368421052,36,2,19,36.22448979591837,0.622974537037037,44.79166666666667,1020.8333333333339,28.3564814814815,0
2542,4,0,0,36,0.0,0.0,1.0,36,700,500,200,0.7142857142857143,9,5,4,355.1919133666541,0.4217261904761905,0.17392883079157628,0.2012754175744371,130049.99999999985,2038.5416666666533,132088.5416666665,2041,1,248.44444444444446,34,2,19,35.94260620915033,0.625,44.99999999999999,1019.9999999999989,29.999999999999968,0
2543,4,0,0,36,0.0,0.0,1.0,36,1150,1000,150,0.8695652173913043,13,10,3,355.4981637246128,0.4214451058201058,0.16519239991186851,0.20223528584015282,130201.83000283432,2057.3022959183504,132259.13229875267,2042,2,249.44444444444446,34,2,19,35.78069714996695,0.626531862745098,44.85119047619047,1020.5952380952369,30.017507002801086,0
2544,4,0,0,36,0.0,0.0,1.0,36,1000,800,200,0.8,12,8,4,356.0257945325159,0.42162698412698413,0.16727016898064795,0.20301511938743252,130293.86421388394,2077.609478227546,132371.47369211147,2043,3,250.44444444444446,33,3,20,35.673863681830916,0.6297348484848485,44.761029411764696,1020.95588235294,30.93805704099818,0
2545,4,0,0,36,0.0,0.0,1.0,36,1150,800,350,0.6956521739130435,15,8,7,357.2859513280309,0.4212466931216931,0.1726288075718192,0.20439110530673557,130419.01139285372,2119.3761113514074,132538.38750420514,2044,4,251.44444444444446,33,3,20,35.514772045590895,0.6309974747474747,44.638480392156865,1021.4460784313726,30.95291146761735,0
2546,4,1,0,37,0.02702702702702703,0.0,1.0,37,1100,800,300,0.7272727272727273,14,8,6,364.993912721352,0.421265015015015,0.12146580222546777,0.2121377235172849,131031.70680084007,2165.155071159112,133196.8618719992,2045,0,245.6216216216216,35,2,19,34.696944004823294,0.6327380952380952,44.03935185185185,1023.8425925925916,29.252645502645475,8
2547,4,0,0,37,0.0,0.0,1.0,37,1300,1000,300,0.7692307692307693,16,10,6,362.06838427693094,0.42085835835835833,0.12346749641970511,0.21125031438596656,131179.87403817283,2099.2170085305006,133279.09104670334,2046,1,246.6216216216216,35,2,20,34.62191183670396,0.6342261904761906,43.89467592592592,1024.421296296295,29.269179894179857,0
2548,4,0,1,36,0.0,0.02702702702702703,0.972972972972973,37,1100,700,400,0.6363636363636364,15,7,8,364.5316940974284,0.4204517017017017,0.13425620742693867,0.213511420828494,131328.12500000015,2174.736502271961,133502.8615022721,2047,2,247.6216216216216,34,3,20,34.408875338753376,0.6378676470588236,43.75000000000001,1025.0000000000011,30.147058823529445,0
2549,4,0,0,36,0.0,0.0,1.0,36,750,400,350,0.5333333333333333,11,4,7,362.1758200848489,0.4194609788359788,0.11135346533338608,0.21265439204560954,131422.35145436873,2319.599583093066,133741.9510374618,2048,3,235.88888888888889,33,3,20,34.374004023744064,0.6410984848484849,43.65808823529413,1025.3676470588255,31.07174688057047,0
2550,4,0,0,36,0.0,0.0,1.0,36,1150,700,450,0.6086956521739131,16,7,9,361.9052793318979,0.4183531746031746,0.10942559855603351,0.21337119708215876,131579.470636294,2323.861014994266,133903.33165128826,2049,4,236.88888888888889,33,3,14,34.22220895046983,0.6426767676767677,43.50490196078433,1025.9803921568648,31.090314913844388,0
2551,4,0,1,35,0.0,0.027777777777777776,0.9722222222222222,36,850,600,250,0.7058823529411765,11,6,5,361.0594961312573,0.4184193121693122,0.10773473543132539,0.2135154304282376,131694.45153061242,2309.9064625850538,134004.35799319748,2050,5,237.88888888888889,34,2,14,34.127812572488985,0.6415441176470589,43.39285714285715,1026.428571428573,30.189075630252145,0
2552,4,0,0,35,0.0,0.0,1.0,35,1250,1000,250,0.8,15,10,5,369.86396970372016,0.4151960784313726,0.11659872068230293,0.21860344010364546,131673.7872002355,2740.277927960402,134414.0651281959,2051,6,245.4,33,2,16,33.92276119402986,0.6436237373737373,43.41299019607843,1026.3480392156864,31.101455733808677,0
2553,4,0,0,35,0.0,0.0,1.0,35,1050,900,150,0.8571428571428571,12,9,3,370.9402648944885,0.4147058823529412,0.11571138661982672,0.2196018797894791,131736.68368235772,2773.2880682910427,134509.97175064875,2052,7,246.4,33,2,17,33.83159742946958,0.6442550505050505,43.35171568627451,1026.5931372549019,31.10888294711824,0
2554,4,1,0,36,0.027777777777777776,0.0,1.0,36,400,200,200,0.5,6,2,4,361.91145236201817,0.41588955026455027,0.11320627196539634,0.21557334336346284,131969.53125,2352.256944444445,134321.78819444444,2053,0,240.52777777777777,34,2,18,33.82839956745067,0.6443014705882353,43.125,1027.5,30.220588235294116,0
2555,4,0,1,35,0.0,0.027777777777777776,0.9722222222222222,36,900,600,300,0.6666666666666666,12,6,6,366.56475092111424,0.4151951058201058,0.11981277745608976,0.2190509774535516,132091.8810232426,2484.0454931972768,134575.92651643988,2054,1,241.52777777777777,34,2,18,33.58545647558387,0.6455269607843137,43.00595238095238,1027.9761904761904,30.234593837535012,0
2556,4,0,0,35,0.0,0.0,1.0,35,800,500,300,0.625,11,5,6,377.1152512763768,0.4135854341736695,0.1261257578854149,0.22530218858306597,132082.88278546702,2962.093906189915,135044.97669165695,2055,2,249.17142857142858,33,2,18,33.32339850580195,0.6477272727272727,43.014705882352935,1027.9411764705874,31.14973262032083,0
2557,4,0,1,34,0.0,0.02857142857142857,0.9714285714285714,35,1200,800,400,0.6666666666666666,16,8,8,374.7040092854198,0.4132352941176471,0.12062584061153991,0.22442122354846206,132177.3795685551,2905.4788122356485,135082.85838079074,2056,3,250.17142857142858,33,2,18,33.29000814364596,0.6486742424242424,42.922794117647044,1028.30882352941,31.160873440285147,0
2558,4,0,0,34,0.0,0.0,1.0,34,1000,600,400,0.6,14,6,8,388.0449580737781,0.4107248960190137,0.11322554076899749,0.2319722502670115,132105.78799357184,3452.5969926537828,135558.38498622563,2057,4,243.14705882352942,32,2,18,33.01937484647505,0.650390625,42.99242424242423,1028.0303030303012,32.12594696969691,0
2559,4,0,0,34,0.0,0.0,1.0,34,1050,700,350,0.6666666666666666,14,7,7,385.7653656516995,0.40916518122400475,0.10548538433778432,0.23219998006361517,132365.51914345467,3412.4065784103514,135777.92572186503,2058,5,244.14705882352942,32,2,19,32.81569529652351,0.6529947916666667,42.73989898989898,1029.0404040404032,32.1575126262626,0
2560,4,0,1,33,0.0,0.029411764705882353,0.9705882352941176,34,850,600,250,0.7058823529411765,11,6,5,384.1430052973379,0.4087566844919786,0.1030099911470852,0.2320411568285751,132498.52710300006,3379.6804653261297,135878.20756832618,2059,6,245.14705882352942,31,3,20,32.7232462796678,0.6569220430107527,42.61067708333332,1029.5572916666654,33.211525537634365,0
2561,4,0,0,33,0.0,0.0,1.0,33,1150,800,350,0.6956521739130435,15,8,7,393.28696663536215,0.40936710858585856,0.1023528573802801,0.23714894413335452,132432.58794369284,3816.8021592091536,136249.390102902,2060,7,237.75757575757575,30,3,22,32.55446374162097,0.6590277777777778,42.674731182795696,1029.3010752688167,34.31003584229389,0
2562,4,0,0,33,0.0,0.0,1.0,33,1200,1000,200,0.8333333333333334,14,10,4,395.41807883232815,0.409051452020202,0.10276851774959561,0.23953270656854792,132605.57804731766,3886.92858278414,136492.5066301018,2061,8,238.75757575757575,30,3,22,32.32497063813128,0.6607638888888889,42.50672043010753,1029.9731182795701,34.33243727598567,0
2563,4,0,0,33,0.0,0.0,1.0,33,850,600,250,0.7058823529411765,11,6,5,396.0726831734518,0.40916982323232326,0.10182197760485856,0.24015039903808044,132640.18961729686,3907.0311596716474,136547.2207769685,2062,9,239.75757575757575,30,3,16,32.27318197633959,0.6611111111111111,42.473118279569896,1030.107526881721,34.33691756272403,0
2564,4,0,0,33,0.0,0.0,1.0,33,1050,600,450,0.5714285714285714,15,6,9,399.36057633915283,0.4086963383838384,0.10573470330998691,0.2437147956322705,132882.5970668574,4013.614110012712,136896.2111768701,2063,10,240.75757575757575,30,3,17,31.943901273193415,0.6635416666666667,42.23790322580645,1031.048387096774,34.368279569892465,0
2565,4,0,0,33,0.0,0.0,1.0,33,700,500,200,0.7142857142857143,9,5,4,396.00717248989383,0.4078282828282828,0.10244200967327988,0.2425662449209845,133021.21497066141,3935.4710443403983,136956.68601500182,2064,11,241.75757575757575,30,3,18,31.890608034744847,0.6649305555555556,42.10349462365592,1031.586021505377,34.3862007168459,0
2566,4,0,0,33,0.0,0.0,1.0,33,1100,900,200,0.8181818181818182,13,9,4,400.14768704486863,0.4077493686868687,0.10817210921404707,0.24578671529044027,133125.22582090425,4053.9502399121384,137179.1760608164,2065,12,242.75757575757575,30,3,18,31.67898541286793,0.6659722222222222,42.002688172043015,1031.9892473118286,34.399641577060954,0
2567,4,0,0,33,0.0,0.0,1.0,33,550,300,250,0.5454545454545454,8,3,5,399.57636888982853,0.4067629419191919,0.11544957774465936,0.2463950703962942,133270.47559950096,4050.3465440538293,137320.8221435548,2066,13,243.75757575757575,31,2,18,31.547393862967628,0.6646505376344086,41.86197916666667,1032.5520833333342,33.30813172043013,0
2568,4,0,0,33,0.0,0.0,1.0,33,1000,800,200,0.8,12,8,4,396.24771050544973,0.40632891414141414,0.11397911057646382,0.24545086517257952,133438.5871887207,3974.9469333224833,137413.53412204317,2067,14,244.75757575757575,31,2,18,31.464109430791844,0.6663306451612903,41.69921875,1033.203125,33.32913306451613,0
2569,4,0,0,33,0.0,0.0,1.0,33,1050,800,250,0.7619047619047619,13,8,5,396.7814416136036,0.40581597222222227,0.11505151018943671,0.2466756354714487,133573.15275404195,3999.8696221245764,137573.0223761665,2068,15,245.75757575757575,31,2,19,31.31494835621614,0.6676747311827957,41.56901041666667,1033.723958333334,33.345934139784966,0
2570,4,0,0,33,0.0,0.0,1.0,33,550,300,250,0.5454545454545454,8,3,5,398.1879207405667,0.40577651515151514,0.11763987481871618,0.24777524221630892,133606.8047417536,4040.123155381965,137646.92789713558,2069,16,246.75757575757575,31,2,19,31.244752308984044,0.668010752688172,41.53645833333334,1033.8541666666679,33.35013440860219,0
2571,4,0,0,33,0.0,0.0,1.0,33,750,500,250,0.6666666666666666,10,5,5,399.09417548541455,0.40455334595959597,0.11758781316882794,0.2490184631485193,133707.78613620347,4072.399732801669,137780.18586900513,2070,17,247.75757575757575,31,2,17,31.11977527382601,0.669018817204301,41.43880208333334,1034.2447916666679,33.3627352150538,0
2572,4,0,0,33,0.0,0.0,1.0,33,650,400,250,0.6153846153846154,9,4,5,399.5370944279047,0.4046717171717172,0.11983141674771636,0.24974997759478404,133775.12825859923,4089.6252102322155,137864.75346883145,2071,18,248.75757575757575,31,2,17,31.040617788965804,0.6696908602150538,41.37369791666667,1034.505208333334,33.37113575268819,0
2573,4,0,0,33,0.0,0.0,1.0,33,1050,500,550,0.47619047619047616,16,5,11,398.6632791048204,0.4042376893939394,0.11904652971588048,0.24988767683951998,133876.17323133687,4074.302842881955,137950.47607421884,2072,19,249.75757575757575,31,2,17,30.961667505452102,0.6706989247311828,41.27604166666667,1034.895833333334,33.383736559139805,0
2574,4,0,0,33,0.0,0.0,1.0,33,950,600,350,0.631578947368421,13,6,7,397.2371223713495,0.40404040404040403,0.14443156081015207,0.23752118457400243,132114.37795859773,3896.14706483085,136010.52502342858,2073,20,250.75757575757575,33,0,19,32.77444172924864,0.6480429292929293,42.98406862745099,1028.0637254901967,31.153446226975657,7
2575,4,0,0,33,0.0,0.0,1.0,33,1100,600,500,0.5454545454545454,16,6,10,397.1695498729967,0.40297506313131315,0.1450474251808218,0.23887074074023507,132334.9492983469,3911.882449058063,136246.83174740497,2074,21,251.75757575757575,33,0,20,32.55319993647768,0.6502525252525253,42.76960784313726,1028.9215686274517,31.179441473559145,0
2576,4,1,1,33,0.029411764705882353,0.029411764705882353,0.9705882352941176,34,1000,900,100,0.9,11,9,2,388.70149491332995,0.4043931966726084,0.14284500628674368,0.2360850132263066,132704.48022959172,3516.4859693877384,136220.96619897947,2075,0,245.3235294117647,34,0,18,32.39818024263431,0.6516544117647058,42.41071428571428,1030.357142857142,30.30462184873947,0
2577,4,0,1,32,0.0,0.030303030303030304,0.9696969696969697,33,600,500,100,0.8333333333333334,7,5,2,393.54557331594026,0.4014362373737374,0.06992262263827786,0.23445635985689037,131976.01807213554,3800.4706412715136,135776.48871340704,2076,23,253.75757575757575,32,1,16,33.009236503645454,0.6490885416666667,43.11868686868687,1027.5252525252529,32.11016414141415,7
2578,4,0,0,32,0.0,0.0,1.0,32,400,200,200,0.5,6,2,4,402.51142773679373,0.40112567204301075,0.08728448275862077,0.23908208900510763,131862.52170138896,4215.23437500001,136077.75607638896,2077,47,261.96875,31,1,16,32.89384719405003,0.6505376344086021,43.22916666666667,1027.083333333334,33.13172043010755,0
2579,4,0,0,32,0.0,0.0,1.0,32,1400,1100,300,0.7857142857142857,17,11,6,401.9659012444406,0.39969758064516125,0.08150969090448457,0.24002411682478156,132063.20020887582,4216.980658637148,136280.18086751297,2078,48,262.96875,31,1,17,32.70469132674605,0.6525537634408602,43.033854166666664,1027.864583333333,33.156922043010745,0
2580,4,0,0,32,0.0,0.0,1.0,32,1050,700,350,0.6666666666666666,14,7,7,399.8536658879565,0.39980258736559143,0.08130380427902262,0.23982111669316386,132230.54885864258,4174.573940700955,136405.12279934355,2079,49,263.96875,31,1,18,32.58970017301769,0.654233870967742,42.87109375,1028.515625,33.177923387096776,0
2581,4,0,0,32,0.0,0.0,1.0,32,900,600,300,0.6666666666666666,12,6,6,398.13391084572396,0.39919354838709675,0.07677644900025316,0.23942573542640117,132331.0089111328,4137.092420789932,136468.10133192275,2080,50,264.96875,31,1,19,32.532375769847285,0.655241935483871,42.7734375,1028.90625,33.190524193548384,0
2582,4,1,1,32,0.030303030303030304,0.030303030303030304,0.9696969696969697,33,600,200,400,0.3333333333333333,10,2,8,388.2365801727679,0.4018308080808081,0.07099057742518955,0.2355109485226477,132658.02158261903,3700.539326344242,136358.56090896326,2081,0,257.90909090909093,32,1,14,32.457000449401484,0.6559244791666667,42.455808080808076,1030.176767676767,32.19302398989897,0
2583,4,0,0,32,0.0,0.0,1.0,32,850,600,250,0.7058823529411765,11,6,5,396.0543723738521,0.3979334677419355,0.07279021244309591,0.23944938660033818,132532.04345703125,4097.979058159723,136630.02251519097,2082,52,266.96875,31,1,21,32.38281908615748,0.657258064516129,42.578125,1029.6875,33.215725806451616,0
2584,4,0,0,32,0.0,0.0,1.0,32,1000,600,400,0.6,14,6,8,399.1601911603567,0.39721942204301075,0.07639152135456118,0.24262317610161768,132733.2305908203,4196.364339192709,136929.59493001303,2083,53,267.96875,31,1,15,32.09975991913066,0.6592741935483871,42.3828125,1030.46875,33.24092741935484,0
2585,4,0,0,32,0.0,0.0,1.0,32,800,500,300,0.625,11,5,6,397.93016159314027,0.3970094086021505,0.07540108640727672,0.24230885839779226,132800.32687717018,4169.051106770838,136969.37798394103,2084,54,268.96875,31,1,16,32.0637527370726,0.6599462365591398,42.317708333333336,1030.729166666667,33.249327956989255,0
2586,4,0,0,32,0.0,0.0,1.0,32,1000,600,400,0.6,14,6,8,395.3001496986429,0.3966313844086022,0.07293770512496867,0.24200678407362042,133001.71746148006,4115.119764539933,137116.83722602,2085,55,269.96875,31,1,16,31.928490280232275,0.6619623655913979,42.122395833333336,1031.5104166666667,33.27452956989247,0
2587,4,0,1,31,0.0,0.03125,0.96875,32,1100,800,300,0.7272727272727273,14,8,6,392.3908032437215,0.39577032930107525,0.07425176611580664,0.2413096894734664,133169.65950859923,4050.9099324544363,137220.56944105367,2086,56,270.96875,31,1,18,31.834368823850976,0.6636424731182795,41.95963541666667,1032.161458333334,33.29553091397852,0
2588,4,0,0,31,0.0,0.0,1.0,31,1150,800,350,0.6956521739130435,15,8,7,401.93927994453725,0.39453405017921145,0.08042041764510688,0.24711703208119304,133159.90513715456,4504.439277662156,137664.34441481673,2087,57,278.5483870967742,30,1,18,31.59781004471069,0.6663194444444445,41.969086021505376,1032.1236559139784,34.40412186379928,0
2589,4,0,1,30,0.0,0.03225806451612903,0.967741935483871,31,1100,700,400,0.6363636363636364,15,7,8,401.57778190938444,0.39408602150537636,0.07445267123316457,0.2473551678304719,133229.2773189098,4500.383534223618,137729.66085313342,2088,58,279.5483870967742,30,1,19,31.537234735060533,0.6670138888888889,41.90188172043011,1032.3924731182801,34.413082437276,0
2590,4,0,0,30,0.0,0.0,1.0,30,750,400,350,0.5333333333333333,11,4,7,411.5997965334206,0.3902777777777778,0.08781844277000328,0.2532292787944026,133185.33950617284,4963.811728395059,138149.1512345679,2089,59,287.8,29,1,19,31.322883028345892,0.6695402298850575,41.94444444444444,1032.2222222222222,35.593869731800766,0
2591,4,0,0,30,0.0,0.0,1.0,30,1000,700,300,0.7,13,7,6,409.7818203770892,0.38917624521072797,0.08867823046927525,0.25332896077675926,133364.60503472228,4930.0781250000055,138294.68315972228,2090,60,288.8,29,1,20,31.189071534220798,0.6713362068965517,41.770833333333336,1032.916666666667,35.61781609195403,0
2592,4,0,0,30,0.0,0.0,1.0,30,700,500,200,0.7142857142857143,9,5,4,410.7339235397219,0.38893678160919537,0.08923690460187306,0.25440879743646877,133436.34500385798,4961.366705246907,138397.7117091049,2091,61,289.8,29,1,20,31.092188690236142,0.6720545977011494,41.701388888888886,1033.1944444444441,35.62739463601532,0
2593,4,0,0,30,0.0,0.0,1.0,30,1000,700,300,0.7,13,7,6,401.5378784141083,0.388338122605364,0.10713125192113448,0.22797861144663395,130125.41415553818,4450.056545554391,134575.47070109256,2092,62,290.8,30,0,19,34.6838910112853,0.6357638888888889,44.9260752688172,1020.2956989247309,34.009856630824366,8
2594,4,0,0,30,0.0,0.0,1.0,30,750,600,150,0.8,9,6,3,399.00041649312794,0.3888170498084291,0.10217687074829973,0.22733744660654948,130262.5868055554,4394.965277777758,134657.55208333317,2093,63,291.8,30,0,20,34.60884353741496,0.6371527777777778,44.79166666666666,1020.8333333333321,34.027777777777736,0
2595,4,0,0,30,0.0,0.0,1.0,30,650,400,250,0.6153846153846154,9,4,5,399.8974252447672,0.38797892720306515,0.10526454330086854,0.22845267947441644,130365.51371545838,4426.56665510463,134792.080370563,2094,64,292.8,30,0,21,34.48111345090813,0.6381944444444445,44.69086021505376,1021.2365591397845,34.04121863799282,0
2596,4,0,0,30,0.0,0.0,1.0,30,1250,1000,250,0.8,15,10,5,401.94908629090264,0.38838601532567046,0.10701846734219433,0.2298277732674619,130399.83171826221,4482.8186423285915,134882.6503605908,2095,65,293.8,30,0,21,34.39377988331798,0.6385416666666667,44.65725806451613,1021.3709677419354,34.04569892473118,0
2597,4,0,0,30,0.0,0.0,1.0,30,500,400,100,0.8,6,4,2,401.04685892142226,0.38812260536398463,0.10765588003157034,0.22992143450382,130502.81282518218,4467.54863278993,134970.36145797212,2096,66,294.8,30,0,17,34.31196834166447,0.6395833333333334,44.55645161290323,1021.7741935483878,34.05913978494626,0
2598,4,0,0,30,0.0,0.0,1.0,30,1350,1200,150,0.8888888888888888,15,12,3,402.3867303257717,0.38838601532567046,0.10560305142706805,0.23089406118240313,130537.14889365823,4505.283305873512,135042.43219953176,2097,67,295.8,30,0,17,34.24278793458722,0.6399305555555556,44.52284946236559,1021.9086021505377,34.06362007168459,0
2599,4,0,0,30,0.0,0.0,1.0,30,650,500,150,0.7692307692307693,8,5,3,401.0199540075514,0.3882662835249042,0.10678411780173547,0.23072297807726452,130640.18419759518,4477.864131691538,135118.0483292867,2098,68,296.8,30,0,18,34.17285695503549,0.6409722222222223,44.422043010752695,1022.31182795699,34.077060931899666,0
2600,4,0,0,30,0.0,0.0,1.0,30,550,300,250,0.5454545454545454,8,3,5,397.89587283639685,0.3869971264367816,0.10633460375870651,0.22953674726399884,130743.2601492948,4404.440722915957,135147.70087221076,2099,69,297.8,30,0,18,34.14788408463662,0.6420138888888889,44.32123655913979,1022.7150537634415,34.090501792114715,0
2601,4,1,0,31,0.03225806451612903,0.0,1.0,31,1000,1000,0,1.0,10,10,0,383.94621144330216,0.3936827956989248,0.07544917379504623,0.2036867189521248,127431.06139438094,3586.6398933402807,131017.70128772123,2100,0,289.16129032258067,30,1,19,37.88909966276179,0.6083333333333334,47.58064516129033,1009.6774193548395,33.655913978494645,8
2602,4,0,0,31,0.0,0.0,1.0,31,700,500,200,0.7142857142857143,9,5,4,382.93588029087095,0.3937724014336918,0.0734273388706459,0.20366335034578162,127532.863716181,3567.381886634288,131100.2456028153,2101,1,290.16129032258067,30,1,19,37.80993568418719,0.609375,47.479838709677416,1010.0806451612898,33.66935483870966,0
2603,4,1,0,32,0.03125,0.0,1.0,32,800,700,100,0.875,9,7,2,371.75152610497867,0.3995925739247312,0.0696657332303332,0.1992680540550291,127848.0720520021,3105.5431789822205,130953.61523098432,2102,0,282.0625,31,1,21,37.76889940345908,0.6098790322580645,47.16796875000001,1011.3281250000011,32.62348790322584,0
2604,4,3,1,34,0.08571428571428572,0.02857142857142857,0.9714285714285714,35,1100,800,300,0.7272727272727273,14,8,6,345.6642835345079,0.40966386554621853,0.07766240038638017,0.1895888474326353,128765.686574875,1902.283081500534,130667.96965637553,2103,0,258.8,33,2,20,37.491447315463255,0.6142676767676767,46.26225490196078,1014.9509803921565,30.75609031491383,0
2605,4,1,1,34,0.02857142857142857,0.02857142857142857,0.9714285714285714,35,1050,700,350,0.6666666666666666,14,7,7,344.35802387933103,0.41036414565826335,0.0855315554482925,0.1896142819859147,128921.21006644082,1879.0106269223393,130800.22069336315,2104,0,259.77142857142854,33,2,22,37.3661306866176,0.6158459595959596,46.10906862745098,1015.5637254901964,30.774658348187767,0
2606,4,1,0,35,0.02857142857142857,0.0,1.0,35,950,600,350,0.631578947368421,13,6,7,345.82644242505074,0.41036414565826335,0.08355041003376762,0.19117285737256795,129076.82742214529,1927.6360053825415,131004.46342752784,2105,0,260.6857142857143,33,2,23,37.17036501045187,0.6174242424242424,45.955882352941174,1016.1764705882349,30.793226381461665,0
2607,4,0,1,34,0.0,0.02857142857142857,0.9714285714285714,35,1100,900,200,0.8181818181818182,13,9,4,351.31343348764085,0.41060924369747903,0.03888518024032073,0.19784493359567148,129807.2562358277,2120.606575963725,131927.86281179142,2106,1,261.6857142857143,34,1,18,36.28796728971963,0.6225490196078431,45.23809523809524,1019.0476190476194,29.971988795518218,8
2608,4,0,2,32,0.0,0.058823529411764705,0.9411764705882353,34,1000,700,300,0.7,13,7,6,377.8122310006513,0.40591577540106955,-0.04265417653308523,0.19890909936647083,127122.02558106573,2805.6512188208562,129927.67679988658,2107,3,270.3529411764706,34,0,19,38.36176366426633,0.595281862745098,47.88690476190476,1008.4523809523806,29.660364145658253,8
2609,4,1,0,33,0.030303030303030304,0.0,1.0,33,750,500,250,0.6666666666666666,10,5,5,384.5427040904164,0.40301452020202017,0.007506761605122314,0.20338530303048022,127308.35383326115,3191.099727268346,130499.4535605295,2108,0,279.3030303030303,33,0,21,38.00027828374823,0.5994318181818181,47.702205882352935,1009.1911764705874,30.581550802139013,0
2610,4,1,0,34,0.029411764705882353,0.0,1.0,34,1000,700,300,0.7,13,7,6,381.21640458647715,0.40977792632204396,0.021943649677513388,0.20370726817770773,127723.00347222206,2938.0208333333153,130661.02430555537,2109,0,272.05882352941177,34,0,17,37.65801044242924,0.6014093137254901,47.29166666666666,1010.833333333332,29.730392156862706,0
2611,4,1,0,35,0.02857142857142857,0.0,1.0,35,750,500,250,0.6666666666666666,10,5,5,384.51373994019355,0.4132352941176471,0.04719768132136748,0.19540940498078646,125674.92821270655,2765.094554978842,128440.0227676854,2110,0,265.25714285714287,33,2,18,39.68721991363155,0.5827020202020202,49.32598039215686,1002.6960784313717,30.384729649435506,8
2612,4,1,1,35,0.027777777777777776,0.027777777777777776,0.9722222222222222,36,900,600,300,0.6666666666666666,12,6,6,375.96668649613326,0.4175429894179894,0.06406504065040686,0.19365118274298326,126228.49384851988,2292.082372164564,128520.57622068444,2111,0,258.8611111111111,33,3,19,39.32926829268294,0.5883838383838385,48.774509803921575,1004.9019607843144,30.45157456922165,0
2613,4,1,0,36,0.027777777777777776,0.0,1.0,36,850,500,350,0.5882352941176471,12,5,7,372.9572810393162,0.4194113756613757,0.0717564383784226,0.19296894377103585,126413.28605584393,2229.3510909265715,128642.6371467705,2112,0,259.6111111111111,33,3,20,39.21419286700789,0.5902777777777778,48.59068627450981,1005.637254901961,30.473856209150334,0
2614,4,2,0,38,0.05263157894736842,0.0,1.0,38,1050,700,350,0.6666666666666666,14,7,7,364.2541090754101,0.4253793266951162,0.10527558272451643,0.1919129858262982,127152.04081632658,1664.9478786612758,128816.98869498786,2113,0,246.89473684210526,34,4,22,38.67273567831287,0.5955882352941176,47.85714285714286,1008.571428571429,29.6638655462185,0
2615,4,0,1,37,0.0,0.02631578947368421,0.9736842105263158,38,1450,1000,450,0.6896551724137931,19,10,9,363.8669637903851,0.4257349454717876,0.09943245324259209,0.19227782949422104,127272.13718820867,1662.025226757375,128934.16241496605,2114,1,247.89473684210526,34,4,22,38.559117901525866,0.5968137254901961,47.73809523809524,1009.0476190476195,29.677871148459396,0
2616,4,0,0,37,0.0,0.0,1.0,37,1250,1000,250,0.8,15,10,5,362.30705030315255,0.4259259259259259,0.0745832496805261,0.1921654842789892,127422.33737244896,1833.2022392290278,129255.53961167799,2115,2,246.1081081081081,34,3,17,38.444267578508835,0.5983455882352942,47.589285714285715,1009.6428571428571,29.695378151260503,0
2617,4,1,0,38,0.02631578947368421,0.0,1.0,38,1200,700,500,0.5833333333333334,17,7,10,356.8108744109211,0.4265499051683262,0.0800500105443922,0.19085995027430452,127763.95486379013,1517.5136906292687,129281.4685544194,2116,0,240.60526315789474,35,3,18,38.2328038542263,0.5997023809523809,47.2511574074074,1010.995370370369,28.88558201058197,0
2618,4,0,0,38,0.0,0.0,1.0,38,1400,900,500,0.6428571428571429,19,9,10,359.2017552587071,0.42643136557610245,0.08581235697940515,0.192839271557807,127910.26341735241,1589.1182270233044,129499.38164437572,2117,1,241.60526315789474,35,3,18,38.022501906941265,0.6011904761904762,47.106481481481474,1011.574074074073,28.90211640211637,0
2619,4,1,1,38,0.02564102564102564,0.02564102564102564,0.9743589743589743,39,1100,800,300,0.7272727272727273,14,8,6,348.3454693877553,0.429880791722897,0.08901391941391923,0.18838212961327902,128203.13169795937,1132.010352366234,129335.14205032561,2118,0,236.3846153846154,35,4,19,37.99761904761905,0.6041666666666667,46.81712962962962,1012.7314814814802,28.935185185185148,0
2620,4,0,0,38,0.0,0.0,1.0,38,1100,700,400,0.6363636363636364,15,7,8,381.06206793447404,0.42635727833096254,0.11174358525264871,0.19245235531816718,125417.01388888895,2012.3724708504835,127429.38635973944,2119,1,243.44736842105263,34,4,17,40.04090404880754,0.5778186274509804,49.583333333333336,1001.6666666666672,29.460784313725505,8
2621,4,4,2,40,0.09523809523809523,0.047619047619047616,0.9523809523809523,42,1000,500,500,0.5,15,5,10,353.1165035091244,0.439847077042199,0.1302191213343511,0.18289879653806865,126457.07242853563,532.378351992912,126989.45078052854,2120,0,221.16666666666666,37,5,18,39.66793397289146,0.5824887387387387,48.547149122807014,1005.8114035087713,27.184091986723548,0
2622,4,1,0,41,0.024390243902439025,0.0,1.0,41,1350,900,450,0.6666666666666666,18,9,9,359.93524936167194,0.435010162601626,0.13087301457299283,0.18673992553990604,126524.89271365979,908.1537618699995,127433.04647552979,2121,0,227.53658536585365,36,5,20,39.426628609805256,0.5850694444444444,48.47972972972974,1006.0810810810826,27.94669669669674,0
2623,4,1,1,41,0.023809523809523808,0.023809523809523808,0.9761904761904762,42,1000,600,400,0.6,14,6,8,358.44169401056666,0.4379718350754936,0.12027482898857,0.18085107745034584,125376.4403961976,627.611182546872,126004.05157874447,2122,0,223.0952380952381,35,7,17,40.64931719249588,0.5752976190476191,49.62384259259259,1001.5046296296288,28.614417989417966,8
2624,4,2,1,42,0.046511627906976744,0.023255813953488372,0.9767441860465116,43,1150,800,350,0.6956521739130435,15,8,7,354.15907885143633,0.44084533038021406,0.14920003353837474,0.18099486592558298,125906.24188452186,318.1677294936567,126224.40961401552,2123,0,218.8372093023256,37,6,20,40.209380348883776,0.5768581081081081,49.09539473684209,1003.6184210526291,27.124822190611596,0
2625,4,2,3,41,0.045454545454545456,0.06818181818181818,0.9318181818181819,44,1200,700,500,0.5833333333333334,17,7,10,343.37942829573126,0.4448885658914729,0.15582471420794808,0.17707285957958008,126276.38996056234,-127.631651678682,126148.75830888367,2124,0,214.75,35,9,16,40.098648856133885,0.5845238095238094,48.72685185185185,1005.092592592592,28.7169312169312,0
2626,4,3,2,42,0.06818181818181818,0.045454545454545456,0.9545454545454546,44,1050,800,250,0.7619047619047619,13,8,5,341.2404195098033,0.4426532769556026,0.19041556118040526,0.1781502085041547,126779.9403077063,-147.511996794099,126632.4283109122,2125,0,215.13636363636363,36,8,19,39.63481680271346,0.5876736111111112,48.22635135135135,1007.0945945945942,27.97484984984984,0
2627,4,3,0,45,0.06666666666666667,0.0,1.0,45,1050,500,550,0.47619047619047616,16,5,11,324.1202733172655,0.4439183501683502,0.11891056789016008,0.1663121172291929,126072.10884871344,-732.7346349728247,125339.37421374062,2126,0,211.24444444444444,36,9,20,40.792498318008505,0.5804398148148149,48.93018018018017,1004.2792792792782,27.896646646646616,8
2628,4,3,2,46,0.0625,0.041666666666666664,0.9583333333333334,48,1400,900,500,0.6428571428571429,19,9,10,304.41133631163177,0.4470670803782506,0.13974302610254785,0.15880973492307318,126750.8802625869,-1883.119032118051,124867.76123046885,2127,0,198.97916666666666,39,9,17,40.59181148925897,0.5819978632478633,48.255208333333336,1006.9791666666674,25.81997863247865,0
2629,4,1,3,44,0.02127659574468085,0.06382978723404255,0.9361702127659575,47,1450,900,550,0.6206896551724138,20,9,11,327.41041057049404,0.44617252543940794,0.19418764099615204,0.16577306050990254,125521.37586805536,-1098.9529079861322,124422.42296006922,2128,0,204.19148936170214,39,8,12,41.27685377685377,0.5694444444444444,49.47916666666666,1002.0833333333317,25.6944444444444,8
2630,4,0,1,43,0.0,0.022727272727272728,0.9772727272727273,44,1150,800,350,0.6956521739130435,15,8,7,346.5261383505433,0.44225687103594086,0.2142232697007187,0.17455886096740403,125309.87649389257,-115.37048027757126,125194.506013615,2129,1,218.5,36,8,12,41.016430472762714,0.5726273148148149,49.69031531531532,1001.238738738739,27.812187187187195,0
2631,4,1,2,42,0.022727272727272728,0.045454545454545456,0.9545454545454546,44,700,300,400,0.42857142857142855,11,3,8,337.67965684079513,0.4436442917547569,0.20989421776823391,0.171541265675124,125658.76038781165,-313.5185826408071,125345.24180517084,2130,0,217.02272727272728,37,7,13,40.877898075240616,0.5743243243243243,49.3421052631579,1002.6315789473686,27.098150782361312,0
2632,4,2,0,44,0.045454545454545456,0.0,1.0,44,1150,900,250,0.782608695652174,14,9,5,341.0938682398321,0.4465953136011276,0.2200561044635314,0.1745508308404507,125961.27083573793,-207.07657644659926,125754.19425929133,2131,0,217.5,37,7,17,40.48049790642637,0.5774211711711712,49.040570175438596,1003.8377192982457,27.130749170222856,0
2633,4,4,6,42,0.08333333333333333,0.125,0.875,48,750,400,350,0.5333333333333333,11,4,7,316.45449283802355,0.45246010638297873,0.22459728948076374,0.16543760195203025,126835.96073765632,-1572.4110226354883,125263.54971502084,2132,0,200.29166666666666,40,8,13,40.20148136938391,0.58125,48.17073170731708,1007.3170731707331,25.18292682926833,0
2634,4,2,2,42,0.045454545454545456,0.045454545454545456,0.9545454545454546,44,900,400,500,0.4444444444444444,14,4,10,343.53827329425167,0.4479717230443974,0.22920463454117868,0.17761744309463642,126383.31056986029,-116.49914272381562,126266.81142713648,2133,0,219.13636363636363,36,8,14,39.98464740359129,0.5836226851851851,48.62049549549549,1005.5180180180172,27.931056056056033,0
2635,4,2,1,43,0.045454545454545456,0.022727272727272728,0.9772727272727273,44,1150,700,450,0.6086956521739131,16,7,9,351.2715222423502,0.44967847075405215,0.21615302477999876,0.1795630203760585,125916.30725758479,48.14408518262405,125964.45134276741,2134,0,220.0909090909091,40,4,19,40.27144930471176,0.571875,49.08536585365854,1003.658536585366,25.091463414634152,8
2636,4,3,1,45,0.06521739130434782,0.021739130434782608,0.9782608695652174,46,1000,600,400,0.6,14,6,8,341.66247095776146,0.45171095008051526,0.23775918666980633,0.17726917294816733,126527.07151955937,-553.8314241360744,125973.24009542329,2135,0,211.3695652173913,38,8,16,39.883986407560805,0.5814144736842105,48.477564102564095,1006.0897435897425,26.476045883940593,0
2637,4,1,2,44,0.021739130434782608,0.043478260869565216,0.9565217391304348,46,1450,1000,450,0.6896551724137931,19,10,9,339.03331935858847,0.4511775362318841,0.24334293922214778,0.1773278113313631,126855.79562716995,-598.3317057291856,126257.46392144077,2136,0,212.34782608695653,39,7,19,39.61252283459139,0.5830662393162394,48.15104166666666,1007.3958333333318,25.830662393162353,0
2638,4,2,0,46,0.043478260869565216,0.0,1.0,46,1400,900,500,0.6428571428571429,19,9,10,340.03445472716834,0.4504126409017713,0.26761428748947247,0.17996109209005928,127334.51727892831,-540.1556432599846,126794.36163566832,2137,0,213.02173913043478,38,8,17,39.09640626653965,0.5896381578947368,47.67628205128205,1009.2948717948716,26.560391363022937,0
2639,4,1,0,47,0.02127659574468085,0.0,1.0,47,1450,1100,350,0.7586206896551724,18,11,7,331.5313543453958,0.4511255010792476,0.2688202872254839,0.17686415169584874,127656.239672153,-935.5907941701189,126720.64887798288,2138,0,209.46808510638297,40,7,18,38.981839970501476,0.5895833333333333,47.35772357723578,1010.5691056910583,25.26422764227646,0
2640,4,1,2,46,0.020833333333333332,0.041666666666666664,0.9583333333333334,48,1150,700,450,0.6086956521739131,16,7,9,301.9280529262197,0.4514997044917258,0.13978584640898095,0.1633412013035634,128218.12466197932,-1830.1995737102666,126387.92508826905,2139,0,206.08333333333334,42,6,15,39.157577497129736,0.5922619047619048,46.802325581395344,1012.7906976744176,24.114064230343278,8
2641,4,0,1,45,0.0,0.021739130434782608,0.9782608695652174,46,1250,700,550,0.56,18,7,11,306.48440805669674,0.45023148148148145,0.13858243241517032,0.1660218721839217,128270.12004165062,-1337.4416375346727,126932.67840411594,2140,1,211.2826086956522,41,5,16,38.98930483465544,0.5942581300813008,46.75099206349205,1012.9960317460293,24.70722028648852,0
2642,4,2,2,45,0.0425531914893617,0.0425531914893617,0.9574468085106383,47,1300,1000,300,0.7692307692307693,16,10,6,302.6576662260614,0.4503353376503238,0.15358750320185766,0.16515198825453364,128561.83992097818,-1617.954712757658,126943.88520822053,2141,0,207.70212765957447,42,5,12,38.7896920185999,0.595734126984127,46.46317829457364,1014.1472868217045,24.146363971945345,0
2643,4,0,0,45,0.0,0.0,1.0,45,1550,1000,550,0.6451612903225806,21,10,11,309.11098655877197,0.44625420875420874,0.15566866788479938,0.16797222546193685,128395.77034517501,-1062.2913517258914,127333.47899344913,2142,1,217.77777777777777,41,4,12,38.79494583659617,0.5955284552845528,46.62698412698412,1013.4920634920627,24.719318621757626,0
2644,4,1,0,46,0.021739130434782608,0.0,1.0,46,1500,1300,200,0.8666666666666667,17,13,4,300.1253063042992,0.446719001610306,0.15932835820895508,0.1648229141179351,128816.57483930238,-1467.7772038567227,127348.79763544566,2143,0,214.02173913043478,43,3,16,38.59530472636817,0.5968992248062015,46.212121212121225,1015.1515151515173,23.60817477096552,0
2645,4,0,0,46,0.0,0.0,1.0,46,1050,400,650,0.38095238095238093,17,4,13,297.9217032953653,0.4465780998389694,0.15410375752071714,0.16400987403180212,128912.72454660267,-1518.8203053259579,127393.9042412767,2144,1,215.02173913043478,43,3,17,38.55371130175307,0.5978682170542635,46.117424242424256,1015.5303030303053,23.616983791402447,0
2646,4,0,0,46,0.0,0.0,1.0,46,1600,1200,400,0.75,20,12,8,299.2361704825052,0.44582326892109503,0.16025695567089215,0.16543551496382128,129081.0728467204,-1474.8548159147972,127606.21803080561,2145,2,216.02173913043478,43,3,17,38.349660640511914,0.5995639534883721,45.95170454545456,1016.1931818181847,23.632399577167085,0
2647,4,0,0,46,0.0,0.0,1.0,46,1000,400,600,0.4,16,4,12,297.02987823913,0.44565217391304346,0.16127457929162992,0.1646161973617485,129177.32119669746,-1526.0952027375693,127651.22599395989,2146,3,217.02173913043478,43,3,17,38.308201366247495,0.6005329457364341,45.85700757575759,1016.5719696969727,23.641208597604017,0
2648,4,2,1,47,0.041666666666666664,0.020833333333333332,0.9791666666666666,48,1250,700,550,0.56,18,7,11,289.4910845811081,0.4478520242316785,0.1812435617766468,0.16266501085604487,129719.65449245574,-2089.4610640194387,127630.1934284363,2147,0,208.9375,44,4,12,37.951433072774655,0.6046401515151515,45.32407407407409,1018.7037037037062,23.15235690235696,0
2649,4,0,0,47,0.0,0.0,1.0,47,1200,900,300,0.75,15,9,6,299.05612139135684,0.4483502929386371,0.19009728703630446,0.16829727333530356,129779.68606519765,-1637.7180899908024,128141.96797520685,2148,1,206.53191489361703,43,4,13,37.647149938042105,0.6065891472868217,45.26515151515152,1018.9393939393957,23.696264975334785,0
2650,4,0,1,46,0.0,0.02127659574468085,0.9787234042553191,47,1050,600,450,0.5714285714285714,15,6,9,299.67815137779615,0.4478299414122726,0.18494530145961585,0.16916808073319245,129900.32717982402,-1614.3420174758776,128285.98516234814,2149,2,207.53191489361703,43,4,14,37.50938612788356,0.6078003875968992,45.14678030303031,1019.4128787878805,23.70727625088094,0
2651,4,0,1,45,0.0,0.021739130434782608,0.9782608695652174,46,1250,1000,250,0.8,15,10,5,305.92289026504875,0.4456924315619968,0.1923925437509295,0.1730931450080308,129990.70443482965,-1246.5735983414447,128744.1308364882,2150,3,212.47826086956522,42,4,14,37.25888445458001,0.6101190476190477,45.05813953488372,1019.7674418604652,24.28017718715393,0
2652,4,0,1,44,0.0,0.022222222222222223,0.9777777777777777,45,1000,600,400,0.6,14,6,8,309.91723750245785,0.44457070707070706,0.1887883798592882,0.17555146659849946,130034.82187145668,-939.9934452948052,129094.82842616187,2151,4,217.2888888888889,41,4,15,37.112452582433626,0.6120426829268293,45.01488095238094,1019.9404761904742,24.876596980255467,0
2653,4,1,0,45,0.022222222222222223,0.0,1.0,45,1750,1500,250,0.8571428571428571,20,15,5,309.1816060175332,0.4435395622895623,0.1819902141861902,0.17581819685474623,130186.64301658138,-949.736926020433,129236.90609056095,2152,0,217.9111111111111,41,4,18,36.97779965004375,0.6135670731707317,44.866071428571416,1020.5357142857123,24.891114982578348,0
2654,4,0,1,44,0.0,0.022222222222222223,0.9777777777777777,45,1300,900,400,0.6923076923076923,17,9,8,308.9144799674434,0.4433291245791246,0.18098935005474237,0.17624439410749024,130314.46358194518,-948.7729057950402,129365.69067615015,2153,1,218.9111111111111,40,5,20,36.85552901363591,0.61640625,44.74085365853658,1021.0365853658529,25.525914634146325,0
2655,4,0,0,44,0.0,0.0,1.0,44,1650,1000,650,0.6060606060606061,23,10,13,312.250188846157,0.4437103594080338,0.16800938201101445,0.17864208587079433,130422.14084201379,-655.1323784722274,129767.00846354156,2154,2,220.1590909090909,39,5,20,36.661652729621345,0.6191239316239316,44.635416666666664,1021.4583333333325,26.191239316239294,0
2656,4,0,0,44,0.0,0.0,1.0,44,850,500,350,0.5882352941176471,12,5,7,310.89165084620015,0.4433139534883721,0.1675238624779909,0.17835363127492534,130528.56445312499,-683.9518229166675,129844.61263020831,2155,3,221.1590909090909,39,5,12,36.588939857288494,0.6201923076923077,44.53125,1021.8749999999999,26.201923076923073,0
2657,4,0,0,44,0.0,0.0,1.0,44,1350,1100,250,0.8148148148148148,16,11,5,311.44093191357814,0.4429395701198027,0.16613430799396456,0.17935931402303978,130677.89019639413,-660.3112193469688,130017.57897704716,2156,4,222.1590909090909,40,4,13,36.4242702845973,0.6200520833333334,44.38516260162601,1022.4593495934943,25.561483739837357,0
2658,4,0,1,43,0.0,0.022727272727272728,0.9772727272727273,44,550,300,250,0.5454545454545454,8,3,5,311.44093191357814,0.44297260394644117,0.16613430799396456,0.17935931402303978,130677.89019639413,-660.3112193469688,130017.57897704716,2157,5,223.1590909090909,40,4,13,36.4242702845973,0.6200520833333334,44.38516260162601,1022.4593495934943,25.561483739837357,0
2659,4,1,1,43,0.022727272727272728,0.022727272727272728,0.9772727272727273,44,1400,900,500,0.6428571428571429,19,9,10,313.47357305973406,0.4426092318534179,0.1684201261949254,0.18174970375846725,130937.7904707017,-590.8925945204833,130346.89787618122,2158,0,223.6590909090909,40,4,18,36.11028365273226,0.62265625,44.1310975609756,1023.4756097560955,25.58689024390239,0
2660,4,0,1,42,0.0,0.023255813953488372,0.9767441860465116,43,1150,700,450,0.6086956521739131,16,7,9,318.81735197159526,0.44137596899224807,0.1649948270433177,0.18454583667748856,130874.74093967018,-254.9723307291634,130619.76860894103,2159,1,229.72093023255815,39,4,19,36.0371279989141,0.6236645299145299,44.192708333333336,1023.2291666666671,26.23664529914531,0
2661,4,0,0,42,0.0,0.0,1.0,42,1250,1000,250,0.8,15,10,5,324.8605536397384,0.4396535036778939,0.16574173529060743,0.18785414623515317,130835.7988165681,100.67800788955122,130936.47682445766,2160,2,235.9047619047619,38,4,19,35.921835839599,0.625,44.23076923076923,1023.0769230769234,26.923076923076934,0
2662,4,0,1,41,0.0,0.023809523809523808,0.9761904761904762,42,850,500,350,0.5882352941176471,12,5,7,314.4868491840731,0.4393873403019744,-0.005904910106427019,0.17825544560698137,130060.11924445722,-219.56057886115377,129840.55866559607,2161,3,236.9047619047619,41,1,16,36.9703527199637,0.6122967479674797,44.990079365079374,1020.039682539684,24.879016647309367,8
2663,4,0,1,40,0.0,0.024390243902439025,0.975609756097561,41,1050,700,350,0.6666666666666666,14,7,7,324.6545192925411,0.4372713414634146,-0.03619228887628689,0.18205724330333267,129640.87106095908,238.52439480594938,129879.39545576503,2162,4,242.390243902439,40,1,14,37.13576489372316,0.6096354166666667,45.40142276422764,1018.3943089430894,25.459857723577237,8
2664,4,0,0,40,0.0,0.0,1.0,40,1450,1000,450,0.6896551724137931,19,10,9,327.59923853814036,0.4356570512820513,-0.026073400122673784,0.1843829546248611,129784.51063368047,503.4613715277735,130287.97200520824,2163,5,248.175,39,1,16,36.915167314114356,0.6127136752136753,45.260416666666664,1018.9583333333327,26.127136752136735,0
2665,4,0,1,39,0.0,0.025,0.975,40,850,500,350,0.5882352941176471,12,5,7,327.80758800427,0.4354834401709402,-0.02308340999693348,0.1846253099277936,129811.04736328126,510.6092664930562,130321.65662977433,2164,6,249.175,39,1,17,36.88296449623496,0.6129807692307692,45.234375,1019.0625000000001,26.129807692307697,0
2666,4,0,1,38,0.0,0.02564102564102564,0.9743589743589743,39,1600,1400,200,0.875,18,14,4,335.56265999712474,0.4341824111560954,-0.021035481243093512,0.18880596391696608,129772.26382725168,909.3452087442339,130681.6090359959,2165,18,256.4102564102564,38,1,18,36.72472999895145,0.6143092105263157,45.27243589743589,1018.9102564102553,26.813427800269878,0
2667,4,1,2,37,0.02564102564102564,0.05128205128205128,0.9487179487179487,39,1300,1100,200,0.8461538461538461,15,11,4,334.4607336661069,0.4346603688708952,-0.0010258558645654947,0.1896336748838471,130071.79578493666,900.7816494995793,130972.57743443624,2166,0,256.61538461538464,38,1,20,36.44916911045943,0.6173245614035088,44.97863247863247,1020.085470085469,26.844354475933393,0
2668,4,0,0,37,0.0,0.0,1.0,37,1250,1000,250,0.8,15,10,5,386.52598862339164,0.4301488988988989,0.11930405965202961,0.2002304155658516,126462.58680555566,2382.393253707366,128844.98005926303,2167,1,269.6216216216216,34,3,17,38.82214857774095,0.5885416666666667,48.54166666666667,1005.8333333333343,29.58333333333336,8
2669,4,4,1,40,0.0975609756097561,0.024390243902439025,0.975609756097561,41,700,500,200,0.7142857142857143,9,5,4,363.3300334048431,0.43978658536585363,0.1477825908454895,0.19406490408100868,127705.45488522366,1084.53293788579,128789.98782310945,2168,0,244.21951219512195,35,6,16,38.128005839917556,0.5991071428571428,47.30902777777777,1010.763888888888,28.878968253968228,0
2670,4,0,1,39,0.0,0.025,0.975,40,1050,600,450,0.5714285714285714,15,6,9,372.536475329036,0.4380876068376069,0.1507358836330317,0.1986937059314484,127646.96830257615,1510.6303315757677,129157.59863415192,2169,1,251.325,35,5,17,37.955393616615105,0.5985119047619047,47.36689814814814,1010.5324074074061,28.87235449735446,0
2671,4,1,0,40,0.025,0.0,1.0,40,1200,600,600,0.5,18,6,12,374.94826064581827,0.4373263888888889,0.16726959038290312,0.20146741469150897,127945.07345183013,1594.5565497930277,129539.63000162315,2170,0,251.2,36,4,19,37.58858340753931,0.599537037037037,47.07207207207207,1011.7117117117111,28.103103103103088,0
2672,4,0,0,40,0.0,0.0,1.0,40,1150,900,250,0.782608695652174,14,9,5,377.0003760173576,0.43745993589743587,0.1630020024474359,0.20329072465627018,128087.52745566495,1657.809202783846,129745.3366584488,2171,1,252.2,36,4,20,37.39060703823191,0.6009837962962963,46.9313063063063,1012.2747747747733,28.118743743743703,0
2673,4,1,1,40,0.024390243902439025,0.024390243902439025,0.975609756097561,41,1300,800,500,0.6153846153846154,18,8,10,367.50799683746936,0.43762703252032525,0.16776706815805698,0.19995722639431643,128446.04768990933,1241.0279824432896,129687.07567235263,2172,0,247.02439024390245,34,7,16,37.2638970444314,0.6087622549019608,46.577380952380956,1013.6904761904765,29.814425770308134,0
2674,4,0,0,40,0.0,0.0,1.0,40,900,600,300,0.6666666666666666,12,6,6,377.38010816912225,0.4371260683760683,0.17215840386940684,0.2050547631116063,128392.81316080384,1690.5787437524377,130083.39190455628,2173,3,254.2,33,7,16,37.06821846029826,0.610479797979798,46.62990196078433,1013.4803921568653,30.711527035056523,0
2675,4,1,1,40,0.024390243902439025,0.024390243902439025,0.975609756097561,41,1250,900,350,0.72,16,9,7,368.04981037314775,0.4384908536585366,0.17171876117588147,0.20177650375762615,128747.91843820873,1277.1293934240525,130025.04783163278,2174,0,248.97560975609755,34,7,18,36.94159335288368,0.6118259803921569,46.27976190476191,1014.8809523809533,29.84943977591039,0
2676,4,1,0,41,0.024390243902439025,0.0,1.0,41,1100,800,300,0.7272727272727273,14,8,6,350.6077479331012,0.43899898373983737,0.17896002171468495,0.1840837007094494,127011.23078977627,706.2243178829524,127717.45510765922,2175,0,249.29268292682926,38,3,18,39.16136724960255,0.5863486842105263,47.99679487179486,1008.012820512819,26.526653171389974,8
2677,4,2,3,40,0.046511627906976744,0.06976744186046512,0.9302325581395349,43,900,600,300,0.6666666666666666,12,6,6,344.9566829724088,0.4436138796603913,0.2050692017469422,0.18409074467537448,127670.36132812488,208.17455364479022,127878.53588176967,2176,0,238.65116279069767,39,4,15,38.62820380677524,0.5913461538461539,47.34374999999999,1010.6249999999991,25.913461538461515,0
2678,4,0,0,40,0.0,0.0,1.0,40,1300,1100,200,0.8461538461538461,15,11,4,360.9196068323074,0.43635149572649573,0.22317603748326675,0.1912106002154139,127376.050036523,1194.5027798068368,128570.55281632983,2177,1,257.3,36,4,15,38.52679235460362,0.59375,47.63513513513514,1009.4594594594594,28.040540540540537,0
2679,4,2,0,42,0.047619047619047616,0.0,1.0,42,750,400,350,0.5333333333333333,11,4,7,343.08280363232745,0.4410932055749129,0.2205323193916353,0.18414444358224913,127901.25739644966,376.1443951347751,128277.40179158443,2178,0,246.0,38,4,17,38.43934833122094,0.5953947368421053,47.11538461538461,1011.5384615384611,26.619433198380555,0
2680,4,3,2,43,0.06666666666666667,0.044444444444444446,0.9555555555555556,45,750,300,450,0.4,12,3,9,325.1902069037747,0.4465909090909091,0.22586842075973568,0.17788349783673363,128659.52934967639,-632.0050670740206,128027.52428260238,2179,0,230.53333333333333,40,5,14,38.118968913820176,0.5997395833333333,46.3668699186992,1014.5325203252054,25.363313008130135,0
2681,4,0,3,40,0.0,0.06976744186046512,0.9302325581395349,43,1100,700,400,0.6363636363636364,15,7,8,337.7851650531954,0.4442368032484312,0.21727469782137399,0.18464422234773162,128631.77237426072,89.98089250496776,128721.75326676569,2180,1,213.46511627906978,38,5,14,37.82780410742496,0.602796052631579,46.39423076923079,1014.4230769230799,26.695344129554734,0
2682,4,0,0,40,0.0,0.0,1.0,40,900,600,300,0.6666666666666666,12,6,6,351.59331059938074,0.441025641025641,0.2084475668265937,0.19069689225445974,128320.37278163583,1023.3169367284031,129343.68971836423,2181,2,225.45,35,5,19,37.79557916381084,0.6053571428571429,46.70138888888889,1013.1944444444447,28.948412698412707,0
2683,4,0,0,40,0.0,0.0,1.0,40,1400,800,600,0.5714285714285714,20,8,12,350.0219192938548,0.44066506410256406,0.20864539330973875,0.1905433182781152,128466.99948827586,993.2531453617946,129460.25263363766,2182,3,226.45,35,5,14,37.68564238687826,0.606845238095238,46.55671296296296,1013.7731481481479,28.964947089947085,0
2684,4,1,1,40,0.024390243902439025,0.024390243902439025,0.975609756097561,41,850,200,650,0.23529411764705882,15,2,13,346.3019939330889,0.44098069105691057,0.22122440809635924,0.19051891880992472,128886.73460200083,726.746636839558,129613.48123884038,2183,0,221.90243902439025,36,5,15,37.35190011459834,0.6090856481481481,46.143018018018026,1015.4279279279294,28.206331331331373,0
2685,4,0,0,40,0.0,0.0,1.0,40,1250,700,550,0.56,18,7,11,351.70277332856386,0.4415998931623932,0.22114157072837148,0.19344755049601817,128877.99968117705,1065.3499817815446,129943.3496629586,2184,1,224.25,35,5,18,37.22370245830008,0.6110119047619047,46.15162037037037,1015.393518518518,29.011243386243372,0
2686,4,1,1,40,0.024390243902439025,0.024390243902439025,0.975609756097561,41,1600,1300,300,0.8125,19,13,6,345.811832403406,0.44143800813008127,0.2230916507117291,0.19262902451368413,129377.9538001542,748.4906817986823,130126.44448195287,2185,0,219.7560975609756,35,6,21,36.864334470989746,0.6160714285714286,45.659722222222214,1017.3611111111102,29.06746031746029,0
2687,4,0,0,40,0.0,0.0,1.0,40,900,500,400,0.5555555555555556,13,5,8,346.3531798362282,0.43932959401709404,0.22894407819959106,0.1940901449808366,129613.56122470839,978.4138160150746,130591.97504072347,2186,1,224.525,35,5,16,36.61106690914601,0.618452380952381,45.42824074074073,1018.2870370370362,29.09391534391532,0
2688,4,0,0,40,0.0,0.0,1.0,40,1350,1100,250,0.8148148148148148,16,11,5,348.028579797585,0.4385817307692308,0.2248182644252612,0.19591071716994476,129790.40745027429,1034.1542352537654,130824.56168552805,2187,2,225.525,35,5,17,36.38876268362865,0.6202380952380953,45.254629629629626,1018.981481481481,29.1137566137566,0
2689,4,1,0,41,0.024390243902439025,0.0,1.0,41,800,600,200,0.75,10,6,4,343.3309006285981,0.4404725609756098,0.23309343223646284,0.19518598629211784,130176.38204082473,738.7148973297715,130915.0969381545,2188,0,221.0,36,5,20,36.116935187228705,0.6221064814814814,44.87612612612613,1020.4954954954965,28.347097097097123,0
2690,4,0,1,40,0.0,0.024390243902439025,0.975609756097561,41,1250,800,450,0.64,17,8,9,348.4347356211441,0.43953252032520324,0.23644037477101354,0.1988205001810522,130320.07250071042,881.6080015826917,131201.6805022931,2189,1,222.0,36,5,20,35.84105363773391,0.6235532407407407,44.735360360360374,1021.0585585585605,28.362737737737792,0
2691,4,1,0,41,0.024390243902439025,0.0,1.0,41,1250,800,450,0.64,17,8,9,352.6071035532461,0.4383130081300813,0.2558491194426311,0.20330318142012888,130722.82745160708,1018.7595112003914,131741.5869628075,2190,0,222.73170731707316,36,5,16,35.32650589142165,0.6276041666666667,44.34121621621622,1022.6351351351357,28.406531531531545,0
2692,4,1,1,41,0.023809523809523808,0.023809523809523808,0.9761904761904762,42,950,800,150,0.8421052631578947,11,8,3,349.240906235528,0.4411657955865273,0.25867237687366207,0.20336097657355534,131103.4404816865,757.3368728839487,131860.77735457045,2191,0,218.4047619047619,37,5,17,35.02765881513206,0.6295045045045045,43.96929824561403,1024.1228070175425,27.678994784257906,0
2693,4,0,0,41,0.0,0.0,1.0,41,750,600,150,0.8,9,6,3,358.46497741083226,0.4396341463414634,0.26294775819045313,0.20807449838214986,130982.0694850256,1190.4969158347558,132172.56640086035,2192,1,224.21951219512195,36,5,17,34.914283094976156,0.6302083333333333,44.08783783783784,1023.6486486486489,28.43468468468469,0
2694,4,1,0,42,0.023809523809523808,0.0,1.0,42,1400,1200,200,0.8571428571428571,16,12,4,355.93892524291084,0.43979868370112274,0.27622919086333697,0.20847851335656198,131328.1249999999,949.4148709520184,132277.53987095194,2193,0,219.85714285714286,36,6,18,34.629065040650396,0.6336805555555556,43.74999999999999,1024.9999999999993,28.472222222222204,0
2695,4,0,0,42,0.0,0.0,1.0,42,1200,800,400,0.6666666666666666,16,8,8,404.558437809186,0.4397744870305846,0.3352774239681795,0.2216231442085796,128717.71541950102,2058.170351473908,130775.88577097493,2194,1,220.85714285714286,34,8,18,36.04626153605506,0.6115196078431373,46.3095238095238,1014.7619047619038,29.845938375350112,8
2696,4,0,0,42,0.0,0.0,1.0,42,1000,700,300,0.7,13,7,6,401.86932893120803,0.4393873403019744,0.33281118240658514,0.22065291486132715,128808.33510487528,1952.8238378684787,130761.15894274376,2195,2,221.85714285714286,34,8,18,36.02160783393924,0.6124387254901961,46.220238095238095,1015.1190476190476,29.856442577030812,0
2697,4,2,1,43,0.045454545454545456,0.022727272727272728,0.9772727272727273,44,700,300,400,0.42857142857142855,11,3,8,385.30716841812557,0.4423669837914024,0.33669584541280795,0.2148920740679357,129426.12879106711,1176.1581654776835,130602.28695654479,2196,0,212.72727272727272,32,12,17,35.81063614178764,0.6233723958333333,45.61237373737373,1017.5505050505041,31.798453282828252,0
2698,4,0,0,43,0.0,0.0,1.0,43,1300,700,600,0.5384615384615384,19,7,12,395.72822664388053,0.4392764857881137,0.34298861458164964,0.22016482001678866,129329.78777675741,1635.8895138251173,130965.67729058253,2197,1,218.67441860465115,32,11,19,35.643981711353874,0.6223958333333333,45.707070707070706,1017.1717171717166,31.786616161616145,0
2699,4,0,0,43,0.0,0.0,1.0,43,1600,1300,300,0.8125,19,13,6,380.9505789138447,0.4395302694721299,0.28014980398796197,0.1974647535593106,126487.98791258554,1143.7960731047942,127631.78398569033,2198,2,219.67441860465115,32,11,17,38.93613237939835,0.5934244791666667,48.516414141414145,1005.9343434343441,31.435448232323253,8
2700,4,5,0,48,0.10416666666666667,0.0,1.0,48,1300,800,500,0.6153846153846154,18,8,10,346.0726173201918,0.4481937056737589,0.2843105201976168,0.17961325432862407,126539.80070790989,-634.1116296008303,125905.68907830906,2199,0,197.6875,37,11,18,39.75997166521357,0.5833333333333333,48.46491228070174,1006.140350877191,27.1929824561403,8
2701,4,1,0,49,0.02040816326530612,0.0,1.0,49,1550,800,750,0.5161290322580645,23,8,15,340.7455414438793,0.4486961451247165,0.28751468777522615,0.17843260418418788,126903.55994091959,-1151.6355513551205,125751.92438956446,2200,0,194.6326530612245,38,11,19,39.520376064751,0.5852521929824561,48.10363247863247,1007.5854700854691,26.515407107512345,0
2702,4,1,2,48,0.02,0.04,0.96,50,1400,1000,400,0.7142857142857143,18,10,8,336.5530661135576,0.44977040816326536,0.29740207566119836,0.17792637318251253,127290.80590303132,-1431.5583224756929,125859.24758055562,2201,0,191.72,36,14,22,39.22902019863853,0.5928819444444444,47.71959459459459,1009.1216216216209,28.031156156156136,0
2703,4,1,0,49,0.02040816326530612,0.0,1.0,49,1550,1100,450,0.7096774193548387,20,11,9,333.51138841574516,0.4502551020408163,0.3136501061242687,0.17756265077018688,127575.06397867462,-1290.4526570489447,126284.61132162568,2202,0,196.0612244897959,36,13,17,39.01483483818229,0.595775462962963,47.43806306306306,1010.2477477477477,28.062437437437435,0
2704,4,1,0,50,0.02,0.0,1.0,50,2000,1600,400,0.8,24,16,8,326.31220630669793,0.4518622448979592,0.3105035526722275,0.17516958736563523,127907.3364257812,-1652.454969618058,126254.88145616314,2203,0,193.12,39,11,20,38.85724522019705,0.59375,47.109375,1011.5624999999997,25.937499999999993,0
2705,4,0,1,49,0.0,0.02,0.98,50,1350,800,550,0.5925925925925926,19,8,11,328.46821783550956,0.45193027210884357,0.3130414700271118,0.17691806281362024,128041.6555642309,-1588.4771176217866,126453.1784466091,2204,1,194.12,40,10,21,38.665612343943515,0.5934895833333333,46.97662601626016,1012.0934959349589,25.30233739837397,0
2706,4,0,1,48,0.0,0.02040816326530612,0.9795918367346939,49,1750,1300,450,0.7428571428571429,22,13,9,330.7422648986437,0.45128259637188206,0.31057361216091395,0.1786008230452675,128144.53124999997,-1323.396188611278,126821.13506138869,2205,2,198.9795918367347,38,11,22,38.5030864197531,0.5978618421052632,46.875,1012.4999999999998,26.644736842105257,0
2707,4,1,1,48,0.02040816326530612,0.02040816326530612,0.9795918367346939,49,1600,1300,300,0.8125,19,13,6,326.3398527687966,0.45103458049886624,0.3168855578000547,0.177273055700035,128381.9458007814,-1420.7709418402642,126961.17485894113,2206,0,199.51020408163265,39,10,16,38.37249888649056,0.5985576923076923,46.64062500000001,1013.4375000000011,25.98557692307695,0
2708,4,1,0,49,0.02040816326530612,0.0,1.0,49,1050,700,350,0.6666666666666666,14,7,7,324.9358436311499,0.4522923752834467,0.32384360557850367,0.17739932819687523,128582.2137946991,-1443.805976931702,127138.4078177674,2207,0,200.48979591836735,40,9,17,38.20411656646627,0.5989583333333333,46.44308943089432,1014.2276422764241,25.355691056910604,0
2709,4,0,1,48,0.0,0.02040816326530612,0.9795918367346939,49,1400,1200,200,0.8571428571428571,16,12,4,312.1568854327412,0.45153061224489793,0.2978707587329412,0.16682482729684198,127727.9009674899,-1733.0271825407692,125994.87378494913,2208,1,201.48979591836735,42,7,15,39.398205841002046,0.5873015873015873,47.286821705426355,1010.8527131782943,24.06792174234034,8
2710,4,0,0,48,0.0,0.0,1.0,48,1450,1100,350,0.7586206896551724,18,11,7,318.3672923679836,0.45069629137115835,0.3022356626427194,0.17010195815088522,127717.98946719871,-1467.7539013290748,126250.23556586963,2209,2,206.54166666666666,41,7,15,39.251378120194985,0.5886686991869918,47.29662698412697,1010.8134920634905,24.653987611304647,0
2711,4,1,0,49,0.02040816326530612,0.0,1.0,49,1500,1100,400,0.7333333333333333,19,11,8,304.98936450155753,0.4519912131519275,0.22070550074334427,0.15880480703356914,126672.22222222178,-2072.5528116339524,124599.66941058783,2210,0,203.30612244897958,44,5,13,40.65776766004416,0.5738636363636364,48.333333333333314,1006.6666666666631,22.878787878787797,8
2712,4,3,3,49,0.057692307692307696,0.057692307692307696,0.9423076923076923,52,1650,1000,650,0.6060606060606061,23,10,13,300.3956987241483,0.45579594017094016,0.2539380184269544,0.15926006597162945,127405.07582616564,-2744.91820079473,124660.15762537092,2211,0,192.51923076923077,46,6,13,40.02458728486127,0.5788043478260869,47.6063829787234,1009.574468085106,21.947271045328392,0
2713,4,2,3,48,0.0392156862745098,0.058823529411764705,0.9411764705882353,51,900,600,300,0.6666666666666666,12,6,6,306.50638966086586,0.4527777777777778,0.2535910173097333,0.16225181472641448,127343.30797265528,-2393.6924851659433,124949.61548748934,2212,0,197.07843137254903,45,6,13,39.933422327918855,0.5793981481481482,47.66757246376811,1009.3297101449264,22.429549114331696,0
2714,4,0,1,47,0.0,0.020833333333333332,0.9791666666666666,48,1550,1200,350,0.7741935483870968,19,12,7,319.4530517638613,0.44998522458628837,0.24780217629560042,0.16776407183158865,127020.40939401109,-1484.5885165576274,125535.82087745346,2213,2,210.20833333333334,43,5,15,39.937079223422586,0.5787306201550387,47.98768939393939,1008.049242424242,23.44300563777307,0
2715,4,1,1,47,0.020833333333333332,0.020833333333333332,0.9791666666666666,48,2250,1700,550,0.7555555555555555,28,17,11,331.6619268237017,0.45177674349881797,0.22032853035352584,0.17864915403671594,128044.1045052278,-1028.540870896223,127015.56363433159,2214,0,209.20833333333334,41,7,16,38.5823041233745,0.5919715447154472,46.97420634920634,1012.1031746031729,24.685443283004215,7
2716,4,0,1,46,0.0,0.02127659574468085,0.9787234042553191,47,1700,1300,400,0.7647058823529411,21,13,8,339.8872123151959,0.45054733271662045,0.22660012258120998,0.18353909465020565,128144.53124999988,-688.9837648022335,127455.54748519765,2215,1,214.5744680851064,38,9,16,38.27160493827159,0.5978618421052632,46.87499999999999,1012.4999999999991,26.64473684210524,0
2717,4,1,0,47,0.02127659574468085,0.0,1.0,47,1300,800,500,0.6153846153846154,18,8,10,333.3919532581274,0.4517036694418748,0.21112189661655778,0.18146367388747744,128461.1328125,-834.4184027777774,127626.71440972222,2216,0,209.19148936170214,39,8,14,38.113097684614324,0.5993589743589743,46.5625,1013.75,25.993589743589745,0
2718,4,1,0,48,0.020833333333333332,0.0,1.0,48,1200,900,300,0.75,15,9,6,331.4369739104803,0.4521738327423168,0.21742940116162623,0.18165365650219858,128736.8681423096,-1066.3683984400695,127670.49974386953,2217,0,205.8125,40,8,15,37.88178449829762,0.6005208333333334,46.29065040650407,1014.8373983739848,25.37093495934962,0
2719,4,2,0,50,0.04,0.0,1.0,50,650,200,450,0.3076923076923077,11,2,9,320.3662451739427,0.4539795918367347,0.23114931041375142,0.17789038008937166,129253.05394441166,-1716.6637748694288,127536.39016954222,2218,0,198.54,40,10,17,37.63825038310346,0.6057291666666667,45.782520325203265,1016.8699186991892,25.421747967479728,0
2720,4,0,1,49,0.0,0.02,0.98,50,1250,900,350,0.72,16,9,7,322.46852030891426,0.4532908163265306,0.23477133105802017,0.1796260008564866,129377.95380015447,-1655.9365354938154,127722.01726466065,2219,1,199.54,41,9,17,37.45804891922638,0.6054369918699187,45.65972222222223,1017.3611111111123,24.8136856368564,0
2721,4,0,2,47,0.0,0.04081632653061224,0.9591836734693877,49,1400,900,500,0.6428571428571429,19,9,10,329.37148506717955,0.4525758219954648,0.24631595675107376,0.18421631300491015,129537.39636005365,-1266.8150778306435,128270.58128222301,2220,2,204.22448979591837,40,9,12,37.12064490366377,0.60859375,45.50304878048781,1017.9878048780497,25.449695121951244,0
2722,4,0,3,44,0.0,0.06382978723404255,0.9361702127659575,47,1350,900,450,0.6666666666666666,18,9,9,355.84132328847966,0.45081714461917977,0.29283309036184546,0.18922990434265394,127527.89680621668,-133.69800961727617,127394.1987965994,2221,3,212.61702127659575,40,7,13,38.49922024348526,0.58828125,47.48475609756098,1010.0609756097573,25.251524390243933,7
2723,4,3,0,47,0.06382978723404255,0.0,1.0,47,1400,1100,300,0.7857142857142857,17,11,6,356.0949414870187,0.45286000616712924,0.32671413795166826,0.19142987243222234,127964.52591050303,-286.49592669706936,127678.02998380596,2222,0,213.29787234042553,40,7,17,38.04552531137004,0.5927083333333334,47.052845528455286,1011.788617886179,25.294715447154477,0
2724,4,1,1,47,0.020833333333333332,0.020833333333333332,0.9791666666666666,48,1350,1000,350,0.7407407407407407,17,10,7,379.0497966471479,0.45380836288416077,0.34120781762403474,0.20141414995533966,127496.3146162066,158.83609048965474,127655.15070669625,2223,0,209.83333333333334,38,10,18,37.94562572728236,0.591282894736842,47.51602564102565,1009.9358974358986,26.577260458839437,8
2725,4,1,0,48,0.020833333333333332,0.0,1.0,48,1350,900,450,0.6666666666666666,18,9,9,377.5123820360736,0.4527556146572104,0.34416067716590915,0.20167389307980219,127712.2041990834,42.587684454697154,127754.7918835381,2224,0,210.79166666666666,38,10,19,37.76270126484164,0.5934758771929824,47.30235042735044,1010.7905982905999,26.599752586594732,0
2726,4,3,1,50,0.058823529411764705,0.0196078431372549,0.9803921568627451,51,1250,900,350,0.72,16,9,7,358.79509124237654,0.4563562091503268,0.3409979059976329,0.1949032631321661,128381.94580078182,-985.9765814048336,127395.96921937699,2225,0,199.33333333333334,39,12,16,37.55021499297632,0.5985576923076923,46.64062500000003,1013.4375000000045,25.98557692307704,0
2727,4,1,1,50,0.0196078431372549,0.0196078431372549,0.9803921568627451,51,1500,1000,500,0.6666666666666666,20,10,10,360.3826186720625,0.45591503267973854,0.3442744815998935,0.1962845007014658,128487.53390842056,-939.0652126735624,127548.468695747,2226,0,200.31372549019608,39,12,17,37.40207284496048,0.5996260683760684,46.53645833333336,1013.8541666666702,25.996260683760774,0
2728,4,0,0,50,0.0,0.0,1.0,50,1550,1200,350,0.7741935483870968,19,12,7,362.58928973753586,0.4565221088435374,0.34545780212833144,0.19766427047093402,128523.4166689499,-679.7571270727922,127843.6595418771,2227,1,204.66,38,12,17,37.30946861939383,0.6016995614035088,46.501068376068396,1013.9957264957295,26.68409806567709,0
2729,4,0,0,50,0.0,0.0,1.0,50,2050,1700,350,0.8292682926829268,24,17,7,366.8305378302651,0.45564625850340135,0.3463135727071698,0.20079479064980035,128685.96734832742,-558.8114772809992,128127.15587104643,2228,2,205.66,38,12,17,37.03581832859499,0.6033442982456141,46.34081196581198,1014.6367521367546,26.70096716149354,0
2730,4,0,2,48,0.0,0.04,0.96,50,1250,900,350,0.72,16,9,7,365.6506732740352,0.45541666666666664,0.345963360707517,0.200285472592664,128713.06911571369,-587.1959237343465,128125.87319197935,2229,3,206.66,38,12,17,37.03806064434619,0.6036184210526316,46.31410256410258,1014.7435897435926,26.703778677462964,0
2731,4,2,2,48,0.04,0.04,0.96,50,1550,1100,450,0.7096774193548387,20,11,9,361.03149949671837,0.4545323129251701,0.3599285113540791,0.199658815303069,129092.79348381916,-678.6870388633129,128414.10644495585,2230,0,206.92,38,12,19,36.76781083543595,0.6074561403508771,45.940170940170944,1016.2393162393166,26.74313990103465,0
2732,4,0,3,45,0.0,0.0625,0.9375,48,1100,700,400,0.6363636363636364,15,7,8,351.498266559134,0.4526725029550827,0.28010840448685714,0.1888378436911054,127938.82118985077,-595.3470716026782,127343.4741182481,681,1,169.9375,40,8,18,38.188096433952786,0.5924479166666667,47.07825203252033,1011.68699186992,25.292174796748,8
2733,4,2,0,47,0.0425531914893617,0.0,1.0,47,1600,1300,300,0.8125,19,13,6,351.0770112958247,0.45311054579093435,0.28511266853138095,0.18970968717570286,128171.57594601512,-400.05074564964104,127771.52520036548,682,0,172.27659574468086,38,9,20,37.96071604417247,0.5981359649122807,46.8482905982906,1012.6068376068381,26.647548358074687,0
2734,4,1,1,47,0.020833333333333332,0.020833333333333332,0.9791666666666666,48,1100,700,400,0.6363636363636364,15,7,8,344.59592441018583,0.4536975472813239,0.282036951382465,0.1871900473806088,128381.94580078148,-752.02094184025,127629.92485894123,683,0,169.66666666666666,39,9,14,37.90996419638883,0.5985576923076923,46.640625000000014,1013.4375000000018,25.98557692307697,0
2735,4,0,1,46,0.0,0.02127659574468085,0.9787234042553191,47,350,200,150,0.5714285714285714,5,2,3,351.4192944329072,0.4530334566759174,0.28426106533367146,0.1900230172235898,128198.62349559883,-389.70603678133796,127808.9174588175,684,2,174.27659574468086,38,9,20,37.92440306642755,0.5984100877192983,46.82158119658121,1012.7136752136767,26.650359874044124,0
2736,4,3,1,48,0.061224489795918366,0.02040816326530612,0.9795918367346939,49,1300,1200,100,0.9230769230769231,14,12,2,338.5810814368769,0.45629606009070295,0.2885757207239421,0.18544882600917295,128711.0859628036,-1084.172264359803,127626.9136984438,685,0,167.91836734693877,40,9,16,37.72679853113002,0.6002604166666667,46.316056910569124,1014.7357723577267,25.368394308943166,0
2737,4,3,4,47,0.058823529411764705,0.0784313725490196,0.9215686274509804,51,1450,1100,350,0.7586206896551724,18,11,7,330.1404133322907,0.45808823529411763,0.3059281253199544,0.18394075396557247,129386.78521050357,-1654.042385549369,127732.7428249542,686,0,162.27450980392157,39,12,20,37.25395464318623,0.6087072649572649,45.65104166666667,1017.3958333333342,26.087072649572672,0
2738,4,0,0,47,0.0,0.0,1.0,47,1150,900,250,0.782608695652174,14,9,5,345.35283367315833,0.4550185013876041,0.31113612614558317,0.1906183467353885,129016.12548828126,-488.78309461805503,128527.3423936632,687,1,175.59574468085106,39,8,20,37.24420263850438,0.6049679487179487,46.015625,1015.9375000000001,26.04967948717949,0
2739,4,1,0,48,0.020833333333333332,0.0,1.0,48,1550,1100,450,0.7096774193548387,20,11,9,336.7996717608222,0.4558307476359338,0.3072233014806265,0.18767368485537178,129391.54071015022,-883.9284700249989,128507.61224012522,688,0,172.91666666666666,38,10,22,37.07974552836993,0.6104714912280702,45.64636752136751,1017.4145299145277,26.7740665766981,0
2740,4,0,2,46,0.0,0.041666666666666664,0.9583333333333334,48,1200,900,300,0.75,15,9,6,337.0552957749052,0.45508274231678486,0.18939044001916105,0.184679004017949,128725.2658420142,-824.6132344514408,127900.65260756275,689,1,173.91666666666666,39,9,12,37.751060699377284,0.6020299145299146,46.30208333333335,1014.7916666666691,26.02029914529921,8
2741,4,0,1,45,0.0,0.021739130434782608,0.9782608695652174,46,1300,1100,200,0.8461538461538461,15,11,4,353.48510294719506,0.4526167471819646,0.1983551688314127,0.19288399511260262,128561.19340806815,-111.10666262692973,128450.08674544122,690,2,182.32608695652175,37,9,13,37.50168937182397,0.6038851351351351,46.4638157894737,1014.1447368421076,27.409317211948853,0
2742,4,0,1,44,0.0,0.022222222222222223,0.9777777777777777,45,1100,600,500,0.5454545454545454,16,6,10,358.19350171664496,0.45031565656565653,0.21648474981808308,0.19592988809746562,128658.1360710375,216.90165672431914,128875.03772776182,691,3,187.26666666666668,36,9,14,37.28331853331854,0.6067708333333333,46.368243243243256,1014.527027027029,28.18130630630636,0
2743,4,1,0,45,0.022222222222222223,0.0,1.0,45,1500,900,600,0.6,21,9,12,349.83455851608187,0.4511784511784512,0.20504113005731806,0.19318039447020355,129034.22807979386,28.12644275162353,129062.35452254549,692,0,183.55555555555554,37,8,16,37.11193251313045,0.6086711711711712,45.99780701754386,1016.0087719298251,27.45969653864392,0
2744,4,3,1,47,0.0625,0.020833333333333332,0.9791666666666666,48,1650,1200,450,0.7272727272727273,21,12,9,328.70390408587247,0.45366060874704495,0.2467447916666663,0.17843926221804518,128355.55555555565,-1161.6973491843535,127193.8582063713,693,0,173.02083333333334,39,9,18,38.33950109649123,0.5982905982905983,46.66666666666667,1013.3333333333342,25.982905982906004,8
2745,4,3,1,49,0.06,0.02,0.98,50,1200,900,300,0.75,15,9,6,321.44457334226007,0.4556377551020408,0.25980861244019127,0.17746166445272693,129024.94454089504,-1705.1263503086457,127319.81819058639,694,0,167.02,41,9,19,37.842475506949185,0.6018800813008129,46.00694444444444,1015.9722222222221,24.779810298102976,0
2746,4,0,0,49,0.0,0.0,1.0,49,1350,1000,350,0.7407407407407407,17,10,7,330.0123570836899,0.45337301587301587,0.2659390286726935,0.1820531744706712,128994.83194527058,-1286.022291625364,127708.8096536452,695,1,171.26530612244898,40,9,20,37.655478858209946,0.603125,46.036585365853654,1015.8536585365846,25.396341463414615,0
2747,4,2,1,50,0.0392156862745098,0.0196078431372549,0.9803921568627451,51,1350,1200,150,0.8888888888888888,15,12,3,321.3250146413757,0.4543464052287582,0.27023599859105296,0.18007140082251605,129614.99851279009,-1869.9612499173725,127745.03726287272,696,0,165.50980392156862,40,11,17,37.24675648702594,0.609375,45.426829268292686,1018.2926829268299,25.45731707317075,0
2748,4,1,1,50,0.0196078431372549,0.0196078431372549,0.9803921568627451,51,1450,1000,450,0.6896551724137931,19,10,9,322.76145854808993,0.45359477124183006,0.278339063532854,0.18159407314271345,129770.27253123155,-1823.031512327304,127947.24101890424,697,0,166.1764705882353,40,11,18,37.05282931045946,0.6109375,45.274390243902445,1018.9024390243914,25.472560975609785,0
2749,4,0,3,47,0.0,0.06,0.94,50,1700,1200,500,0.7058823529411765,22,12,10,330.01299032110734,0.4538690476190476,0.27517579721995045,0.18599349638834795,129837.58680555577,-1430.3819444444262,128407.20486111134,698,1,165.2,39,11,19,36.79987735077677,0.6132478632478633,45.20833333333334,1019.1666666666683,26.132478632478676,0
2750,4,0,1,46,0.0,0.02127659574468085,0.9787234042553191,47,1700,1200,500,0.7058823529411765,22,12,10,344.7811145302218,0.45206984273820533,0.2721589190279321,0.19282818477702288,129536.03512619266,-467.6842874730674,129068.35083871959,699,2,174.14893617021278,37,10,19,36.72985781990521,0.6137387387387387,45.50438596491228,1017.9824561403507,27.513039355144613,0
2751,4,0,0,46,0.0,0.0,1.0,46,1050,800,250,0.7619047619047619,13,8,5,344.11539138976985,0.45271739130434785,0.2597130790624502,0.19272952499670704,129591.85157933214,-281.0898545706324,129310.76172476151,700,3,173.93478260869566,37,9,19,36.69008902290186,0.6143018018018018,45.449561403508774,1018.2017543859652,27.518966334755817,0
2752,4,0,1,45,0.0,0.021739130434782608,0.9782608695652174,46,1600,1100,500,0.6875,21,11,10,348.92887368431394,0.4522745571658615,0.25909150461359953,0.19626193064616487,129759.37307633106,-144.64162049862773,129614.73145583243,701,4,174.93478260869566,37,9,19,36.39734897402784,0.615990990990991,45.28508771929824,1018.8596491228061,27.536747273589356,0
2753,4,1,0,46,0.021739130434782608,0.0,1.0,46,1400,900,500,0.6428571428571429,19,9,10,341.9092678380534,0.45264694041867953,0.26041884816754,0.19412803257154584,130126.2932372705,-301.7228705530258,129824.57036671747,702,0,174.2608695652174,38,8,21,36.20397033158814,0.6178728070175439,44.92521367521366,1020.2991452991429,26.849977507872183,0
2754,4,0,2,44,0.0,0.043478260869565216,0.9565217391304348,46,1700,1400,300,0.8235294117647058,20,14,6,343.95566088085354,0.45176127214170697,0.25904792660683995,0.19652553271727902,130371.67302441738,-231.5850089487985,130140.08801546859,703,1,175.2608695652174,38,8,22,35.9031192244656,0.6203399122807017,44.684829059829056,1021.2606837606834,26.87528115159693,0
2755,4,0,1,43,0.0,0.022727272727272728,0.9772727272727273,44,1400,1100,300,0.7857142857142857,17,11,6,357.07257634225516,0.4491499295278365,0.262719850779793,0.20330205585137934,130234.60493853867,500.6411828639501,130735.24612140263,704,2,183.5,37,7,23,35.70726805600316,0.620777027027027,44.81907894736842,1020.7236842105254,27.58712660028447,0
2756,4,0,0,43,0.0,0.0,1.0,43,1350,800,550,0.5925925925925926,19,8,11,361.2961166877328,0.44765134736064965,0.2716042873788045,0.20616780992362077,130321.66950660142,816.9456283319722,131138.61513493338,705,3,187.48837209302326,35,8,23,35.51112748431949,0.6255952380952381,44.73379629629629,1021.0648148148142,29.173280423280406,0
2757,4,0,0,43,0.0,0.0,1.0,43,1050,800,250,0.7619047619047619,13,8,5,360.4100301269825,0.44700535252860835,0.2756549096485539,0.20628916510380976,130439.87509645053,802.3678626543083,131242.24295910483,706,4,188.48837209302326,35,8,23,35.41383412644459,0.6267857142857143,44.61805555555555,1021.527777777777,29.186507936507915,0
2758,4,0,0,43,0.0,0.0,1.0,43,1100,1000,100,0.9090909090909091,12,10,2,359.09561410540675,0.4467284976005906,0.26893491806766323,0.20581645652421665,130492.60567577688,771.8644742715383,131264.4701500484,707,5,189.48837209302326,36,7,16,35.39393438406993,0.6252893518518519,44.56644144144143,1021.7342342342323,28.381506506506454,0
2759,4,0,2,41,0.0,0.046511627906976744,0.9534883720930233,43,1100,800,300,0.7272727272727273,14,8,6,356.2546763530689,0.44638242894056845,0.26757124446915426,0.20479567430378734,130607.69120049082,705.920151570468,131313.6113520613,708,6,190.48837209302326,36,7,18,35.3498769784437,0.6264467592592593,44.45382882882882,1022.184684684683,28.394019019018973,0
2760,4,1,1,41,0.023809523809523808,0.023809523809523808,0.9761904761904762,42,1400,1100,300,0.7857142857142857,17,11,6,353.83800935967525,0.44584785133565624,0.25591636148353136,0.20523507766879917,130953.25213304497,867.247610786438,131820.4997438314,709,0,185.88095238095238,36,6,20,35.0618421535189,0.6299189814814814,44.11599099099098,1023.5360360360341,28.431556556556504,0
2761,4,0,1,40,0.0,0.024390243902439025,0.975609756097561,41,1300,1000,300,0.7692307692307693,16,10,6,350.5415144747211,0.44458841463414633,0.2326335288669339,0.20405206053107436,131090.96364883392,990.5649862825632,132081.52863511647,710,1,179.6341463414634,35,6,22,35.00696955997588,0.6333333333333333,43.981481481481474,1024.0740740740732,29.259259259259235,0
2762,4,0,1,39,0.0,0.025,0.975,40,1550,1200,350,0.7741935483870968,19,12,7,362.49492360993986,0.4422809829059829,0.24450226770554728,0.21047223822564998,130992.77388038566,1496.8431122449197,132489.6169926306,711,2,184.925,34,6,22,34.80031592820871,0.6344975490196079,44.07738095238096,1023.6904761904776,30.108543417366988,0
2763,4,0,0,39,0.0,0.0,1.0,39,1350,800,550,0.5925925925925926,19,8,11,375.6867069622598,0.43907444894287,0.23639402186888137,0.20884447374610107,129297.68207644639,1946.2561315848734,131243.93820803126,712,3,190.28205128205127,32,7,22,36.18637492240841,0.6220703125,45.73863636363637,1017.0454545454554,31.78267045454548,8
2764,4,1,0,40,0.025,0.0,1.0,40,1750,1400,350,0.8,21,14,7,365.12250704480317,0.43946314102564105,0.2337977567472831,0.20546242852047786,129776.92920918354,1476.895549886598,131253.82475907012,713,0,186.5,34,6,19,35.96701328036761,0.6222426470588236,45.26785714285713,1018.9285714285703,29.96848739495795,0
2765,4,0,0,40,0.0,0.0,1.0,40,1100,700,400,0.6363636363636364,15,7,8,363.940788504102,0.438928952991453,0.233771431815601,0.20533161591003352,129878.87577428395,1453.64409186383,131332.51986614778,714,1,187.5,35,5,19,35.89344176980431,0.6211309523809524,45.16782407407406,1019.3287037037023,29.12367724867721,0
2766,4,0,0,40,0.0,0.0,1.0,40,1400,1000,400,0.7142857142857143,18,10,8,358.1378730243749,0.43855502136752134,0.2196039548653781,0.18801713204933598,127006.86486740115,1105.2345890411443,128112.09945644229,715,2,188.5,36,4,18,38.97609205675343,0.5899884259259259,48.001126126126124,1007.9954954954951,27.999874874874862,8
2767,4,1,1,40,0.024390243902439025,0.024390243902439025,0.975609756097561,41,1800,1400,400,0.7777777777777778,22,14,8,346.22977406376384,0.43948170731707314,0.22239117188329804,0.18399518931062123,127500.81045310338,628.9724264272786,128129.78287953066,716,0,184.8780487804878,35,6,16,38.76967300786919,0.5970238095238095,47.51157407407406,1009.9537037037022,28.85582010582006,0
2768,4,0,0,40,0.0,0.0,1.0,40,1350,900,450,0.6666666666666666,18,9,9,349.7059754151004,0.43863514957264954,0.22230016505541172,0.1856199050983027,127452.38803854852,914.1723356008797,128366.5603741494,717,1,188.05,34,6,16,38.73152951347953,0.5986519607843137,47.559523809523796,1009.7619047619029,29.698879551820674,0
2769,4,0,1,39,0.0,0.025,0.975,40,1350,1100,250,0.8148148148148148,16,11,5,339.9487532869556,0.4384748931623932,0.18527643555455664,0.17218007714858388,125535.4821671334,535.1261311987735,126070.60829833218,718,2,189.05,36,4,17,40.94818706221673,0.5749421296296297,49.465090090090094,1002.1396396396401,27.837212212212226,8
2770,4,3,1,41,0.07142857142857142,0.023809523809523808,0.9761904761904762,42,800,600,200,0.75,10,6,4,325.4385241357144,0.44594463801780876,0.18750844585815196,0.16732142301523067,126153.96684556772,-187.9006335404582,125966.06621202726,719,0,178.0,37,5,20,40.675252855999425,0.5793918918918919,48.84868421052631,1004.6052631578934,27.151493598861986,0
2771,4,3,1,43,0.06818181818181818,0.022727272727272728,0.9772727272727273,44,1300,1100,200,0.8461538461538461,15,11,4,315.0833340274198,0.448489252995067,0.2118446903112401,0.1648010234385709,126855.79562717007,-805.9705946180597,126049.825032552,720,0,170.77272727272728,39,5,17,40.21570072036675,0.5830662393162394,48.151041666666664,1007.3958333333327,25.830662393162378,0
2772,4,2,0,45,0.044444444444444446,0.0,1.0,45,1100,600,500,0.5454545454545454,16,6,10,314.2583790968304,0.4486742424242424,0.23971021470247722,0.16672722871294887,127433.60595703125,-990.3645833333344,126443.24137369792,721,0,167.9111111111111,39,6,11,39.64555607139174,0.5889423076923077,47.578125,1009.6875,25.889423076923077,0
2773,4,3,2,46,0.0625,0.041666666666666664,0.9583333333333334,48,1250,900,350,0.72,16,9,7,316.9354692233645,0.4538822399527187,0.229693840058788,0.16948168889837845,127752.38985224752,-1443.5291114918427,126308.86074075568,722,0,158.35416666666666,42,6,14,39.25245215502094,0.5875496031746033,47.26259689922481,1010.9496124031012,24.070228866740507,8
2774,4,3,1,48,0.061224489795918366,0.02040816326530612,0.9795918367346939,49,1250,1000,250,0.8,15,10,5,328.0173279646857,0.453922193877551,0.2703598881968927,0.178659307782119,128488.14791967125,-1370.1312834264775,127118.01663624476,723,0,155.9591836734694,42,7,13,38.22178948039123,0.5949900793650793,46.53585271317829,1013.8565891472864,24.139442598744914,0
2775,4,0,2,46,0.0,0.041666666666666664,0.9583333333333334,48,1750,1000,750,0.5714285714285714,25,10,15,337.8677284263166,0.45204454787234044,0.2715426572742399,0.1841784561197535,128521.48216057236,-915.347753684822,127606.13440688753,724,1,160.20833333333334,41,7,13,37.93812983074065,0.5967987804878049,46.50297619047618,1013.9880952380936,24.731416957026674,0
2776,4,0,0,46,0.0,0.0,1.0,46,1300,900,400,0.6923076923076923,17,9,8,347.82333748077065,0.451700885668277,0.257844971138006,0.19019940952977143,128645.997450087,-250.78396267358937,128395.2134874134,725,2,165.56521739130434,39,7,15,37.55872009446554,0.6012286324786325,46.38020833333334,1014.4791666666682,26.012286324786366,0
2777,4,0,0,46,0.0,0.0,1.0,46,1050,800,250,0.7619047619047619,13,8,5,357.7471511251373,0.4517814009661836,0.27146477038517514,0.19653910568577154,128830.99500868047,17.784288194439398,128848.77929687491,726,3,166.56521739130434,39,7,15,37.11821944045421,0.6030982905982907,46.197916666666664,1015.2083333333327,26.03098290598289,0
2778,4,1,0,47,0.02127659574468085,0.0,1.0,47,1450,900,550,0.6206896551724138,20,9,11,348.4504058996239,0.4523781991982732,0.2707883955123871,0.19297901217098767,129149.73416121355,-399.54454193932395,128750.18961927423,727,0,164.0,40,7,17,37.02946910617875,0.6046875,45.88414634146341,1016.4634146341461,25.411585365853654,0
2779,4,1,2,46,0.020833333333333332,0.041666666666666664,0.9583333333333334,48,1150,900,250,0.782608695652174,14,9,5,345.6431252473411,0.45303265366430256,0.2671333300841545,0.1930295493692143,129478.90216561132,-649.3015203766986,128829.60064523462,728,0,161.5625,41,7,15,36.765990025018695,0.6064532520325203,45.56051587301586,1017.7579365079341,24.823364305071564,0
2780,4,2,0,48,0.041666666666666664,0.0,1.0,48,850,600,250,0.7058823529411765,11,6,5,336.14249225478716,0.4533281619385343,0.2791674773810686,0.1901600813366512,129984.23450688117,-861.3550918052713,129122.8794150759,729,0,160.47916666666666,41,7,17,36.495018160002594,0.6115345528455285,45.06448412698411,1019.7420634920611,24.87175764614783,0
2781,4,1,1,48,0.02040816326530612,0.02040816326530612,0.9795918367346939,49,1300,900,400,0.6923076923076923,17,9,8,332.4865329797762,0.45365646258503406,0.28262225718082923,0.189319629103187,130237.8584895738,-1139.5331936181879,129098.32529595561,730,0,158.18367346938774,42,7,18,36.33136352129612,0.6125992063492063,44.81589147286821,1020.7364341085259,24.303248431155378,0
2782,4,1,1,48,0.02040816326530612,0.02040816326530612,0.9795918367346939,49,2050,1600,450,0.7804878048780488,25,16,9,329.67390849706004,0.4534970238095238,0.28641661558197984,0.1889704376299569,130496.11363110592,-1195.7625403814795,129300.35109072445,731,0,158.9795918367347,40,9,13,36.14191698163253,0.6182291666666666,44.56300813008131,1021.7479674796756,25.54369918699189,0
2783,4,0,1,47,0.0,0.020833333333333332,0.9791666666666666,48,1800,1400,400,0.7777777777777778,22,14,8,336.62165475729046,0.4527279107565012,0.2906864451739115,0.19282378890456087,130470.15587819759,-816.1840463678923,129653.9718318297,732,1,163.0625,40,8,21,35.99070758314269,0.61796875,44.588414634146346,1021.6463414634154,25.541158536585385,0
2784,4,0,2,45,0.0,0.0425531914893617,0.9574468085106383,47,1000,700,300,0.7,13,7,6,334.71232537725064,0.4529178230033919,0.2773489734084862,0.19211570456584687,130548.03688280808,-660.7926003040303,129887.24428250405,733,2,162.12765957446808,40,7,14,35.96070339432511,0.61875,44.51219512195123,1021.951219512197,25.548780487804926,0
2785,4,0,0,45,0.0,0.0,1.0,45,1550,1100,450,0.7096774193548387,20,11,9,343.0239742564942,0.4510311447811448,0.2713294440024745,0.19688636330612505,130548.03688280807,-43.77871141514163,130504.25817139292,734,3,162.7111111111111,40,5,15,35.748350901617606,0.61875,44.51219512195123,1021.9512195121969,25.548780487804923,0
2786,4,0,1,44,0.0,0.022222222222222223,0.9777777777777777,45,1700,1300,400,0.7647058823529411,21,13,8,346.90769428561464,0.45035774410774415,0.2667682489206884,0.20005341705422053,130729.84959556178,70.23813950032894,130800.08773506212,735,4,163.7111111111111,40,5,16,35.46511146444072,0.6205729166666667,44.33434959349595,1022.6626016260185,25.566565040650463,0
2787,4,0,1,43,0.0,0.022727272727272728,0.9772727272727273,44,1700,1300,400,0.7647058823529411,21,13,8,333.92122714502847,0.4494252114164905,0.17529465701350566,0.18542953558730324,129255.70371283496,-145.23807132701793,129110.46564150794,736,5,168.3181818181818,38,6,18,37.290966239406025,0.6091008771929824,45.77991452991452,1016.8803418803406,26.760008996851067,8
2788,4,2,2,43,0.044444444444444446,0.044444444444444446,0.9555555555555556,45,1600,1100,500,0.6875,21,11,10,320.8989012007373,0.4518518518518519,0.18605856086171046,0.18024528172556034,129704.91672091997,-675.5669487847415,129029.34977213522,737,0,165.37777777777777,39,6,15,37.16648345093226,0.6119123931623931,45.33854166666666,1018.6458333333319,26.119123931623896,0
2789,4,0,0,43,0.0,0.0,1.0,43,1000,800,200,0.8,12,8,4,366.69621712511463,0.44963547434477663,0.2051935245295422,0.1958019423517124,127692.92091836745,812.7619114051968,128505.68282977265,738,7,174.06976744186048,34,9,16,38.055800942285025,0.6011029411764706,47.32142857142858,1010.7142857142866,29.726890756302545,8
2790,4,0,0,43,0.0,0.0,1.0,43,1550,1100,450,0.7096774193548387,20,11,9,366.81550377069806,0.44933554817275745,0.20781033987160757,0.19659922426069887,127843.36911848064,778.9859693877472,128622.35508786839,739,8,175.06976744186048,34,9,17,37.89851873651169,0.6026348039215687,47.172619047619044,1011.3095238095231,29.74439775910362,0
2791,4,1,0,44,0.022727272727272728,0.0,1.0,44,1300,1200,100,0.9230769230769231,14,12,2,362.4169145118504,0.45076858703312195,0.22158701476727538,0.19656738969248677,128320.37278163571,501.0947145061662,128821.46749614188,740,0,172.0681818181818,35,9,19,37.5214187799863,0.6053571428571429,46.701388888888886,1013.1944444444438,28.948412698412678,0
2792,4,0,0,44,0.0,0.0,1.0,44,750,400,350,0.5333333333333333,11,4,7,339.17389043915585,0.45048229386892175,0.15160892310729412,0.18014945391837492,127479.27847991664,-51.07772209828822,127428.20075781835,741,1,173.0681818181818,37,7,18,38.96986970684036,0.5929054054054055,47.53289473684209,1009.8684210526294,27.293741109530526,8
2793,4,2,0,46,0.043478260869565216,0.0,1.0,46,1500,1200,300,0.8,18,12,6,327.07770844039464,0.45274758454106284,0.1675707853300028,0.1759265149385376,127986.37695312477,-827.7018229166979,127158.67513020807,742,0,166.5,39,7,20,38.757206094296876,0.594551282051282,47.031249999999986,1011.8749999999982,25.945512820512775,0
2794,4,1,1,46,0.02127659574468085,0.02127659574468085,0.9787234042553191,47,1100,700,400,0.6363636363636364,15,7,8,320.6956729425236,0.4528985507246377,0.1735777629780224,0.17226749865142663,127933.68055555575,-1162.9014756944252,126770.77907986133,743,0,163.93617021276594,39,8,19,38.97240527182866,0.594017094017094,47.08333333333334,1011.6666666666682,25.94017094017098,8
2795,4,1,0,47,0.02127659574468085,0.0,1.0,47,1250,900,350,0.72,16,9,7,325.0332087489585,0.4534189022510022,0.18213895063688645,0.16751711527830904,126253.12499999974,-1115.9722222222522,125137.15277777749,744,0,164.89361702127658,39,8,19,40.5835406301824,0.5769230769230769,48.749999999999986,1004.999999999998,25.769230769230717,8
2796,4,1,1,47,0.020833333333333332,0.020833333333333332,0.9791666666666666,48,1450,900,550,0.6206896551724138,20,9,11,320.9606027577638,0.4546764184397163,0.18319952198209188,0.1667445901630311,126580.1657826027,-1474.5507386476513,125105.61504395504,745,0,162.4375,40,8,17,40.35022386049958,0.5786458333333333,48.42479674796747,1006.300813008128,25.1575203252032,0
2797,4,1,1,47,0.020833333333333332,0.020833333333333332,0.9791666666666666,48,1700,1300,400,0.7647058823529411,21,13,8,318.3869339435888,0.455221261820331,0.20709127744712363,0.1665524895083265,126861.55443395095,-1521.7877296913596,125339.76670425959,746,0,163.08333333333334,40,8,19,40.12660143246242,0.5815104166666667,48.145325203252014,1007.4186991869886,25.185467479674717,0
2798,4,0,0,47,0.0,0.0,1.0,47,1550,1200,350,0.7741935483870968,19,12,7,325.8620302452499,0.45457523897625657,0.20735329710224715,0.17032896391738145,126829.5627170135,-1134.2122395833735,125695.35047743013,747,1,167.48936170212767,39,8,20,39.9711306446053,0.5827991452991452,48.177083333333314,1007.2916666666634,25.82799145299137,0
2799,4,1,1,47,0.020833333333333332,0.020833333333333332,0.9791666666666666,48,1000,600,400,0.6,14,6,8,319.9925036410427,0.4564864066193854,0.20933219178082196,0.16898327532703533,127245.7697137944,-1456.461514310292,125789.30819948412,748,0,164.97916666666666,40,8,22,39.692872011818416,0.5854166666666667,47.76422764227641,1008.943089430892,25.2235772357723,0
2800,4,0,0,47,0.0,0.0,1.0,47,1450,600,850,0.41379310344827586,23,6,17,321.7736068686918,0.45476796176379897,0.22209148145871604,0.17060338062206545,127407.31336805534,-1200.7378472222424,126206.5755208331,749,1,168.95744680851064,39,8,16,39.482734901637095,0.5886752136752137,47.60416666666666,1009.5833333333317,25.886752136752094,0
2801,4,3,1,49,0.06,0.02,0.98,50,1600,1200,400,0.75,20,12,8,305.80684603472565,0.4567857142857143,0.2426535527900442,0.1652418337250545,128170.25662634676,-2156.678140904879,126013.57848544187,750,0,159.76,40,10,19,39.1080807573933,0.5947916666666666,46.84959349593496,1012.6016260162602,25.315040650406505,0
2802,4,1,1,49,0.02,0.02,0.98,50,1700,1100,600,0.6470588235294118,23,11,12,305.3348485442849,0.4571853741496599,0.27067361668003165,0.16626749176188788,128479.16253552784,-2154.1668732236053,126324.99566230424,751,0,160.3,40,10,11,38.80584235498529,0.5979166666666667,46.54471544715447,1013.8211382113825,25.345528455284562,0
2803,4,1,1,49,0.02,0.02,0.98,50,1650,900,750,0.5454545454545454,24,9,15,307.55768103833213,0.4566071428571428,0.2786279419128683,0.1684565795484234,128711.08596280373,-2082.7833754708995,126628.30258733283,752,0,161.16,40,10,14,38.513812385244535,0.6002604166666667,46.31605691056913,1014.7357723577277,25.36839430894319,0
2804,4,0,1,48,0.0,0.02040816326530612,0.9795918367346939,49,1550,1200,350,0.7741935483870968,19,12,7,316.45804360506895,0.4550559807256236,0.28507678602077524,0.1736693922817274,128788.4402472078,-1648.772432084028,127139.66781512377,753,1,165.40816326530611,40,9,17,38.20939293819253,0.6010416666666667,46.23983739837401,1015.0406504065077,25.376016260162693,0
2805,4,1,2,47,0.02040816326530612,0.04081632653061224,0.9591836734693877,49,1050,700,350,0.6666666666666666,14,7,7,315.94967472928016,0.45592403628117917,0.2839783767004247,0.17395510190466684,128917.41569378383,-1653.7168889218997,127263.69880486192,754,0,165.9387755102041,40,9,19,38.0912472063778,0.60234375,46.1128048780488,1015.5487804878078,25.388719512195195,0
2806,4,0,0,47,0.0,0.0,1.0,47,1000,500,500,0.5,15,5,10,321.21870815085,0.45509559050262105,0.2669209935334331,0.17682445995271856,128910.32036675389,-1118.3186848957937,127792.00168185809,649,1,157.2127659574468,39,8,19,37.96468441207644,0.6038995726495726,46.119791666666686,1015.5208333333367,26.038995726495813,0
2807,4,1,2,46,0.020833333333333332,0.041666666666666664,0.9583333333333334,48,1300,800,500,0.6153846153846154,18,8,10,315.45277500552936,0.4561354905437352,0.2627039994396587,0.175173833868298,129255.70371283506,-1444.5294486848509,127811.1742641502,650,0,154.91666666666666,38,10,20,37.7604713875464,0.6091008771929824,45.77991452991453,1016.8803418803413,26.760008996851088,0
2808,4,0,0,46,0.0,0.0,1.0,46,1950,1500,450,0.7692307692307693,24,15,9,323.7502823494129,0.4540962157809984,0.24435082523407403,0.18029742614873046,129368.65790435497,-823.3720952601063,128545.28580909487,486,1,148.17391304347825,37,9,22,37.43488179923835,0.6120495495495495,45.668859649122794,1017.324561403507,27.495258416311,0
2809,4,1,2,45,0.02127659574468085,0.0425531914893617,0.9574468085106383,47,1500,1100,400,0.7333333333333333,19,11,8,316.3248387078762,0.45528831329016345,0.24413432496218945,0.17810544932678385,129799.47973738024,-1188.2401015414002,128611.23963583884,487,0,146.0,38,9,17,37.18721604808833,0.6145833333333333,45.24572649572649,1019.017094017093,26.81623931623929,0
2810,4,1,0,46,0.021739130434782608,0.0,1.0,46,1000,700,300,0.7,13,7,6,318.77152205973806,0.4557165861513688,0.24766299792266455,0.18023432503188014,129962.83512309141,-914.3098473226835,129048.52527576873,488,0,147.7391304347826,38,8,19,36.959520815870334,0.6162280701754386,45.08547008547008,1019.6581196581187,26.833108412055754,0
2811,4,2,3,45,0.041666666666666664,0.0625,0.9375,48,1350,1000,350,0.7407407407407407,17,10,7,309.5337055342407,0.45605237884160754,0.2635540889477803,0.1776966170272927,130555.17713758668,-1517.4091669891295,129037.76797059755,489,0,142.54166666666666,39,9,11,36.59678337240512,0.6204594017094017,44.50520833333333,1021.9791666666656,26.20459401709399,0
2812,4,0,3,42,0.0,0.06666666666666667,0.9333333333333333,45,1700,1400,300,0.8235294117647058,20,14,6,353.77940135766016,0.45412457912457915,0.29398977902540846,0.19481003658588864,128922.84765504759,169.47524568856113,129092.32290073615,490,1,152.73333333333332,37,8,15,37.12526092276684,0.607545045045045,46.10745614035087,1015.5701754385956,27.4478425794215,8
2813,4,0,0,42,0.0,0.0,1.0,42,1300,900,400,0.6923076923076923,17,9,8,369.7631382470525,0.45083236546651184,0.29860873531759613,0.20278004748520348,128760.50407503861,1122.177613811734,129882.68168885034,491,2,161.0,35,7,15,36.88526342798497,0.6098214285714285,46.267361111111114,1014.9305555555558,28.99801587301588,0
2814,4,1,0,43,0.023255813953488372,0.0,1.0,43,1050,800,250,0.7619047619047619,13,8,5,358.05802595130456,0.45182724252491696,0.29516459447271726,0.19812836813062704,129115.53603857254,646.1707907231748,129761.70682929571,492,0,158.2325581395349,36,7,16,36.82017543859649,0.611400462962963,45.9177927927928,1016.3288288288303,28.231356356356397,0
2815,4,0,0,43,0.0,0.0,1.0,43,1200,900,300,0.75,15,9,6,355.41521096479437,0.4520810262089332,0.2939382386580254,0.19709388971684072,129201.38888888902,584.0277777777953,129785.41666666682,493,1,159.2325581395349,36,7,16,36.79986338797815,0.6122685185185186,45.83333333333334,1016.6666666666678,28.240740740740772,0
2816,4,0,0,43,0.0,0.0,1.0,43,1100,700,400,0.6363636363636364,15,7,8,359.6133112510134,0.4515273163528977,0.2990585506362542,0.1997280172110637,129261.91184807272,696.8608276644164,129958.77267573714,494,2,160.2325581395349,34,9,16,36.631497307422144,0.6170343137254901,45.77380952380953,1016.9047619047631,29.908963585434208,0
2817,4,2,1,44,0.044444444444444446,0.022222222222222223,0.9777777777777777,45,900,600,300,0.6666666666666666,12,6,6,328.70771787493226,0.45265151515151514,0.2548594998711009,0.1781032331937205,128279.78326576088,-529.1004615466524,127750.68280421423,495,0,154.06666666666666,38,7,18,38.416649089502926,0.5992324561403508,46.741452991452995,1013.0341880341884,26.658794421952326,8
2818,4,1,3,42,0.022222222222222223,0.06666666666666667,0.9333333333333333,45,1650,1000,650,0.6060606060606061,23,10,13,330.06236404813296,0.45252525252525255,0.2690827363393735,0.18005471031867137,128550.5013149246,-514.0635272846597,128036.43778763994,496,0,154.9777777777778,38,7,15,38.10643173198484,0.6019736842105263,46.474358974358985,1014.1025641025657,26.686909581646464,0
2819,4,2,0,44,0.045454545454545456,0.0,1.0,44,950,600,350,0.631578947368421,13,6,7,331.33031789370824,0.4539948907681466,0.2744372590473816,0.1821071145716549,128848.62075617304,-261.7091049382518,128586.91165123478,497,0,155.88636363636363,38,6,17,37.770747834017314,0.6049890350877193,46.180555555555564,1015.2777777777794,26.717836257309983,0
2820,4,0,0,44,0.0,0.0,1.0,44,1500,1100,400,0.7333333333333333,19,11,8,328.46254008233115,0.45434725158562367,0.26733035176743747,0.18177220150105972,129119.93805473378,-317.78743425377695,128802.15062048,498,1,156.88636363636363,38,6,18,37.567670556081154,0.6077302631578947,45.91346153846154,1016.3461538461543,26.74595141700406,0
2821,4,0,0,44,0.0,0.0,1.0,44,1250,900,350,0.72,16,9,7,326.81624589389367,0.45356545102184637,0.2678743638464258,0.18185958370284974,129337.19735051852,-346.10054149318785,128991.09680902533,499,2,157.88636363636363,38,6,18,37.38884220845149,0.6099232456140351,45.69978632478632,1017.2008547008535,26.768443544759304,0
2822,4,0,0,44,0.0,0.0,1.0,44,1850,1400,450,0.7567567567567568,23,14,9,330.5736636273847,0.4531029774489077,0.2699120111465274,0.18458644312511505,129473.0771513622,-239.92210899264657,129233.15504236956,500,3,158.88636363636363,38,6,13,37.155329274266904,0.6112938596491229,45.566239316239304,1017.7350427350411,26.782501124606345,0
2823,4,0,0,44,0.0,0.0,1.0,44,1050,600,450,0.5714285714285714,15,6,9,332.6515152925152,0.45322410147991543,0.27046384720327477,0.18613248909115518,129554.63927469113,-180.6905864197754,129373.94868827135,501,4,159.88636363636363,38,6,13,37.01966803092316,0.6121162280701755,45.4861111111111,1018.0555555555536,26.790935672514568,0
2824,4,2,1,45,0.043478260869565216,0.021739130434782608,0.9782608695652174,46,1300,1000,300,0.7692307692307693,16,10,6,318.36067717000014,0.4538546698872786,0.26794409690332244,0.1803085641127607,130029.26911891058,-920.758766276697,129108.51035263388,502,0,153.8913043478261,40,6,15,36.902775009964145,0.6135416666666667,45.02032520325203,1019.9186991869909,25.497967479674774,0
2825,4,0,2,43,0.0,0.044444444444444446,0.9555555555555556,45,1200,800,400,0.6666666666666666,16,8,8,346.23533677305056,0.45315656565656565,0.26429642528902475,0.18116231630243665,126870.98434133573,-109.44473728612255,126761.53960404961,503,1,155.88888888888889,37,8,18,39.415542011319104,0.5867117117117118,48.1359649122807,1007.4561403508767,27.228544333807477,8
2826,4,4,0,47,0.0851063829787234,0.0,1.0,47,1250,600,650,0.48,19,6,13,349.991988921393,0.4582755164970706,0.311260172353343,0.1876933782448214,127867.13219452133,-449.120883348729,127418.0113111726,504,0,141.38297872340425,37,10,17,38.29954466608847,0.5968468468468469,47.14912280701754,1011.4035087719293,27.3352299668089,0
2827,4,1,1,47,0.020833333333333332,0.020833333333333332,0.9791666666666666,48,1050,900,150,0.8571428571428571,12,9,3,345.765425940279,0.4595246010638298,0.31775408651173165,0.18697946334822196,128201.54772593542,-733.8663023611653,127467.68142357426,505,0,139.41666666666666,36,12,18,38.064559472182076,0.6021412037037037,46.818693693693696,1012.7252252252255,28.131256256256265,0
2828,4,1,3,45,0.020833333333333332,0.0625,0.9375,48,1600,1100,500,0.6875,21,11,10,343.8656146358404,0.4580747635933806,0.32358347750865124,0.18750408043350525,128533.39489073545,-760.3570329332244,127773.03785780222,506,0,140.22916666666666,37,11,16,37.77393310265282,0.6036036036036037,46.49122807017543,1014.0350877192969,27.40635372214316,0
2829,4,1,0,46,0.021739130434782608,0.0,1.0,46,1750,1200,550,0.6857142857142857,23,12,11,358.72134052359144,0.4597322866344606,0.3297676303310675,0.196783654421128,128772.40997331798,38.68230561643418,128811.0922789344,507,0,143.5,36,10,17,37.15327859758126,0.6079282407407407,46.255630630630634,1014.977477477478,28.193818818818833,0
2830,4,1,1,46,0.02127659574468085,0.02127659574468085,0.9787234042553191,47,1350,1100,250,0.8148148148148148,16,11,5,362.0990474415846,0.46045328399629976,0.35342493618958626,0.20110001459050342,129260.23046339171,-37.572055366791346,129222.65840802492,508,0,141.4255319148936,35,12,18,36.57001669322409,0.6148809523809524,45.77546296296297,1016.8981481481487,29.05423280423282,0
2831,4,0,0,46,0.0,0.0,1.0,46,1300,900,400,0.6923076923076923,17,9,8,363.0183717147661,0.4601851851851852,0.3487880391507121,0.20236490207638008,129407.39300679466,195.4522194359006,129602.84522623057,509,1,143.69565217391303,35,11,19,36.3967172866189,0.6163690476190475,45.63078703703705,1017.476851851854,29.070767195767257,0
2832,4,1,0,47,0.02127659574468085,0.0,1.0,47,1350,1000,350,0.7407407407407407,17,10,7,356.71643421693346,0.459431853222325,0.3622425005638674,0.20190150176678473,130004.05811216655,-125.08319129936808,129878.97492086717,510,0,141.61702127659575,36,11,17,35.95038280329801,0.6203703703703703,45.045045045045065,1019.8198198198224,28.3283283283284,0
2833,4,0,1,46,0.0,0.02127659574468085,0.9787234042553191,47,1550,1300,250,0.8387096774193549,18,13,5,357.29337995550907,0.4591620413197657,0.3660429478115026,0.20252587206739728,130061.4867401188,-105.97836011684149,129955.50838000195,511,1,142.61702127659575,36,11,17,35.877355192463384,0.6209490740740741,44.98873873873875,1020.0450450450475,28.33458458458465,0
2834,4,0,0,46,0.0,0.0,1.0,46,1850,1600,250,0.8648648648648649,21,16,5,366.3982901053827,0.45957125603864735,0.37159605930250406,0.20738143219964675,130004.05811216631,326.6529198117172,130330.71103197803,512,2,143.6304347826087,36,10,17,35.70353909010601,0.6203703703703703,45.04504504504505,1019.8198198198205,28.328328328328347,0
2835,4,0,0,46,0.0,0.0,1.0,46,1350,900,450,0.6666666666666666,18,9,9,363.87236412680204,0.4598228663446055,0.3617807163049318,0.20657915486271464,130122.70752779701,269.61144294398264,130392.31897074099,513,3,144.6304347826087,37,9,17,35.647389396381875,0.6196509009009009,44.92872807017544,1020.2850877192983,27.575272641062117,0
2836,4,0,0,46,0.0,0.0,1.0,46,1050,800,250,0.7619047619047619,13,8,5,363.8231287005421,0.4597826086956522,0.3626232709367889,0.20684800603640477,130178.65022170286,272.4007627346913,130451.05098443755,514,4,145.6304347826087,37,9,19,35.59182604491244,0.6202139639639639,44.87390350877193,1020.5043859649126,27.581199620673313,0
2837,4,0,1,45,0.0,0.021739130434782608,0.9782608695652174,46,1200,700,500,0.5833333333333334,17,7,10,365.75026871554536,0.4592491948470209,0.3568218440932549,0.2088682602509548,130351.21588059391,335.25255033063445,130686.46843092455,515,5,146.6304347826087,35,11,20,35.36743454607277,0.6258928571428571,44.7048611111111,1021.1805555555537,29.17658730158725,0
2838,4,2,0,47,0.0425531914893617,0.0,1.0,47,1300,900,400,0.6923076923076923,17,9,8,356.77998624257134,0.45787079864323155,0.3486223492078362,0.20632375397923364,130838.01442912515,-63.923002394274874,130774.09142673087,516,0,143.6595744680851,36,11,20,35.103192074848664,0.6287615740740741,44.22860360360361,1023.0855855855862,28.41904404404406,0
2839,4,0,0,47,0.0,0.0,1.0,47,1400,1100,300,0.7857142857142857,17,11,6,354.8199704458894,0.45721554116558744,0.3450366313227069,0.20595871847721184,130982.0694850257,-104.98919527634206,130877.08028974936,517,1,144.6595744680851,36,11,20,35.00756325632563,0.6302083333333333,44.087837837837846,1023.6486486486497,28.43468468468471,0
2840,4,1,0,48,0.020833333333333332,0.0,1.0,48,1500,1200,300,0.8,18,12,6,346.0993332534834,0.45695737293144206,0.3435624359537406,0.2036351891003055,131501.32395909433,-497.03935354271675,131004.28460555161,518,0,142.625,36,12,21,34.70643939393939,0.6354166666666667,43.58108108108109,1025.6756756756765,28.490990990991016,0
2841,4,0,0,48,0.0,0.0,1.0,48,1700,1200,500,0.7058823529411765,22,12,10,330.1480624909615,0.45654181442080377,0.3036283178302499,0.18594349426304405,129811.04736328124,-1025.580090093262,128785.46727318797,519,1,143.625,39,9,15,36.82333725169513,0.6129807692307692,45.234375,1019.0624999999999,26.12980769230769,7
2842,4,0,1,47,0.0,0.020833333333333332,0.9791666666666666,48,1650,1200,450,0.7272727272727273,21,12,9,332.54943168461034,0.4562832446808511,0.30701339939387795,0.1880604498417475,129970.32470703122,-955.6884765625,129014.63623046872,520,2,144.625,39,9,15,36.60071253447748,0.6145833333333333,45.078125,1019.6874999999998,26.14583333333333,0
2843,4,1,0,48,0.020833333333333332,0.0,1.0,48,1150,800,350,0.6956521739130435,15,8,7,335.1992231582775,0.4561816637115839,0.3153914374574791,0.19086136176400204,130237.26974875595,-868.9136707923949,129368.35607796356,521,0,145.52083333333334,41,7,17,36.262736093562694,0.6140752032520325,44.81646825396825,1020.7341269841268,24.89595431668602,0
2844,4,0,0,48,0.0,0.0,1.0,48,1400,1000,400,0.7142857142857143,18,10,8,335.5452706844828,0.45605237884160754,0.32097270378679665,0.19196948216639703,130422.14084201424,-847.4885686334342,129574.65227338081,522,1,146.52083333333334,39,9,17,36.06677884288531,0.6191239316239316,44.635416666666686,1021.4583333333362,26.19123931623939,0
2845,4,0,1,47,0.0,0.020833333333333332,0.9791666666666666,48,1150,800,350,0.6956521739130435,15,8,7,336.1628328662526,0.45596003250591016,0.32418025823989094,0.19285130938116632,130528.56445312526,-824.2296006944146,129704.33485243085,523,2,147.52083333333334,39,9,16,35.94334012911995,0.6201923076923077,44.531250000000014,1021.875000000002,26.20192307692313,0
2846,4,0,0,47,0.0,0.0,1.0,47,1350,1000,350,0.7407407407407407,17,10,7,334.03469865586385,0.4554039469626889,0.26839126245583933,0.1799272437004814,128044.10450522784,-840.8824148872692,127203.22209034057,524,3,149.51063829787233,41,6,17,38.52226687577598,0.5919715447154472,46.97420634920634,1012.1031746031731,24.685443283004222,8
2847,4,2,0,49,0.04081632653061224,0.0,1.0,49,1750,1200,550,0.6857142857142857,23,12,11,320.98553035334976,0.4577841553287982,0.2779401365994023,0.17592543941320263,128736.86814230957,-1535.3475178656195,127201.52062444395,525,0,144.3673469387755,40,9,15,38.14694739301691,0.6005208333333334,46.29065040650407,1014.8373983739846,25.370934959349615,0
2848,4,1,0,50,0.02,0.0,1.0,50,1200,900,300,0.75,15,9,6,317.744276804607,0.45796768707482993,0.2800136705399865,0.1754188214962794,129024.94454089513,-1800.6124614197413,127224.33207947538,526,0,142.46,41,9,16,37.93646046935522,0.6018800813008129,46.00694444444445,1015.9722222222229,24.779810298102998,0
2849,4,0,3,47,0.0,0.06,0.94,50,1450,1000,450,0.6896551724137931,19,10,9,321.8861955327133,0.45710034013605444,0.2825837516647882,0.1786203044113029,129227.86593967023,-1680.4256486303927,127547.44029103983,527,1,143.46,39,11,17,37.625179284909336,0.6071047008547008,45.80729166666667,1016.770833333334,26.071047008547026,0
2850,4,0,2,45,0.0,0.0425531914893617,0.9574468085106383,47,1550,1200,350,0.7741935483870968,19,12,7,337.16032017632875,0.45727335800185015,0.27511944598536187,0.1864574979951884,129092.79348381922,-695.0064833077594,128397.78700051145,528,2,142.10638297872342,38,9,17,37.374281609195386,0.6074561403508771,45.940170940170944,1016.2393162393171,26.74313990103466,0
2851,4,0,1,44,0.0,0.022222222222222223,0.9777777777777777,45,1650,1300,350,0.7878787878787878,20,13,7,349.909384891225,0.45608164983164984,0.2730076442140381,0.19227364953755796,128839.34389667968,16.41911453523403,128855.76301121492,529,3,148.0,37,8,17,37.308632141699974,0.6067004504504505,46.18969298245614,1015.2412280701749,27.438952110004728,0
2852,4,0,1,43,0.0,0.022727272727272728,0.9772727272727273,44,1950,1500,450,0.7692307692307693,24,15,9,347.7033130314902,0.45543736786469347,0.265990159901599,0.1923012200643548,129095.50781249999,177.38715277777564,129272.89496527777,530,4,149.95454545454547,39,5,18,37.103662703293686,0.6057692307692308,45.9375,1016.2499999999999,26.057692307692303,0
2853,4,2,1,44,0.044444444444444446,0.022222222222222223,0.9777777777777777,45,1200,800,400,0.6666666666666666,16,8,8,338.23032350246285,0.45625,0.269457909918968,0.18903022836082825,129508.1314082216,-239.15435518622834,129268.97705303537,531,0,147.37777777777777,37,8,15,36.92491202556645,0.6134572072072072,45.53179824561403,1017.8728070175425,27.510075865338987,0
2854,4,1,0,45,0.022222222222222223,0.0,1.0,45,1450,1100,350,0.7586206896551724,18,11,7,337.3249297830523,0.4564604377104377,0.2732618338773509,0.18987041626129048,129787.30384589493,-243.90136869036166,129543.40247720457,532,0,148.35555555555555,37,8,17,36.664581764051796,0.6162725225225225,45.25767543859649,1018.9692982456144,27.539710763394982,0
2855,4,0,0,45,0.0,0.0,1.0,45,1000,600,400,0.6,14,6,8,334.13009400643716,0.45650252525252527,0.2681014102877637,0.18852366806123103,129881.14458917745,-320.5601897508976,129560.58439942655,533,1,149.35555555555555,38,7,18,36.650814030674624,0.6154057017543859,45.16559829059829,1019.3376068376069,26.824673864147552,0
2856,4,0,1,44,0.0,0.022222222222222223,0.9777777777777777,45,1400,1000,400,0.7142857142857143,18,10,8,346.9058947771195,0.4559974747474747,0.25633664063049744,0.18695030984746464,128063.41428336619,-90.09743224487033,127973.31685112132,534,2,150.35555555555555,38,7,18,38.17685243825207,0.5970394736842105,46.955128205128204,1012.1794871794871,26.636302294197026,8
2857,4,0,1,43,0.0,0.022727272727272728,0.9772727272727273,44,1550,1100,450,0.7096774193548387,20,11,9,352.50871844954247,0.45491983791402396,0.26268590564365235,0.18982820719307308,128033.53555901795,226.5875076946519,128260.12306671261,535,3,154.5909090909091,37,7,18,38.065637414228966,0.5985360360360361,46.98464912280701,1012.0614035087702,27.35301090564244,0
2858,4,2,3,42,0.044444444444444446,0.06666666666666667,0.9333333333333333,45,1300,1100,200,0.8461538461538461,15,11,4,342.2256186803766,0.4574284511784512,0.2699471877174373,0.18738728226900206,128698.84033203112,-191.19194878473604,128507.64838324639,536,0,150.6888888888889,39,6,17,37.646823563631386,0.6017628205128205,46.32812499999999,1014.687499999999,26.01762820512818,0
2859,4,1,0,43,0.023255813953488372,0.0,1.0,43,1350,1100,250,0.8148148148148148,16,11,5,339.7215709096418,0.4557262827611665,0.2633929857929165,0.17918647563665427,127197.07031249999,43.29698350694355,127240.36729600692,537,0,147.8372093023256,39,4,20,39.24514663362247,0.5865384615384616,47.8125,1008.7499999999999,25.865384615384613,8
2860,4,1,1,43,0.022727272727272728,0.022727272727272728,0.9772727272727273,44,1350,900,450,0.6666666666666666,18,9,9,334.74027567760874,0.4570450140944327,0.2630889334028479,0.17800875334188088,127527.89680621654,-262.25533330028475,127265.64147291625,538,0,145.45454545454547,40,4,14,39.032053861890866,0.58828125,47.484756097560975,1010.0609756097562,25.251524390243905,0
2861,4,0,1,42,0.0,0.023255813953488372,0.9767441860465116,43,1900,1300,600,0.6842105263157895,25,13,12,370.0199186208416,0.4563953488372093,0.27080577802309924,0.1917063754710767,126468.2503449397,811.4700500458836,127279.72039498559,539,1,148.88372093023256,36,7,14,39.231368487834004,0.5844907407407407,48.536036036036045,1005.8558558558573,27.94044044044048,8
2862,4,2,0,44,0.045454545454545456,0.0,1.0,44,1050,300,750,0.2857142857142857,18,3,15,369.88267910456796,0.456098044397463,0.30691334223144984,0.19445804656183557,127064.37467538095,599.7822647353105,127664.15694011627,540,0,146.4318181818182,37,7,16,38.62096701105673,0.5886824324324325,47.944078947368425,1008.2236842105269,27.249288762446675,0
2863,4,4,4,44,0.08333333333333333,0.08333333333333333,0.9166666666666666,48,1400,1200,200,0.8571428571428571,16,12,4,346.5979518398427,0.46061428782505914,0.30040093076201946,0.18632447130223947,127964.52591050306,-729.548476520092,127234.97743398296,541,0,135.14583333333334,40,8,15,38.285748962099916,0.5927083333333334,47.052845528455286,1011.7886178861793,25.29471544715448,0
2864,4,1,0,45,0.022222222222222223,0.0,1.0,45,1300,1000,300,0.7692307692307693,16,10,6,361.0047090894511,0.45896464646464646,0.31625878128426677,0.19319932806232318,127783.97108966218,226.1230619036649,128010.09415156585,542,0,143.24444444444444,37,8,16,38.10629270144237,0.5960022522522522,47.23135964912281,1011.0745614035086,27.326339497392123,0
2865,4,2,1,46,0.0425531914893617,0.02127659574468085,0.9787234042553191,47,1300,900,400,0.6923076923076923,17,9,8,347.02665225430343,0.4594511255010792,0.3174056324599923,0.1880457032362174,128283.34349270914,-495.43621595107993,127787.90727675807,543,0,138.10638297872342,37,10,18,37.949070065302855,0.6010698198198199,46.73793859649122,1013.0482456140339,27.379682313892808,0
2866,4,0,0,46,0.0,0.0,1.0,46,1300,700,600,0.5384615384615384,19,7,12,410.1120261626827,0.45856481481481487,0.3992208552187597,0.2182762621049564,127562.3403956025,1296.5470144659896,128858.88741006849,544,1,141.7173913043478,37,9,16,37.093305655052646,0.59375,47.45065789473684,1010.1973684210527,27.30263157894737,8
2867,4,1,2,45,0.02127659574468085,0.0425531914893617,0.9574468085106383,47,1450,1100,350,0.7586206896551724,18,11,7,404.6589630567938,0.4591620413197657,0.40481700330270276,0.21748696822632427,127955.29827781419,955.6516637445991,128910.94994155879,545,0,139.68085106382978,38,9,17,36.82660154875043,0.5959429824561404,47.061965811965806,1011.7521367521359,26.625056230319366,0
2868,4,1,2,44,0.021739130434782608,0.043478260869565216,0.9565217391304348,46,1450,1200,250,0.8275862068965517,17,12,5,390.423222491541,0.4605374396135266,0.28531217893176875,0.2035920756467816,126732.93856042255,888.5694027997456,127621.5079632223,546,0,136.67391304347825,37,9,15,38.44502069040618,0.5853040540540541,48.27302631578948,1006.9078947368431,27.213726884779543,8
2869,4,2,0,46,0.043478260869565216,0.0,1.0,46,1400,600,800,0.42857142857142855,22,6,16,381.9803755620965,0.46235909822866345,0.28941217546479914,0.2026530205496901,127432.8953108516,536.8969483551783,127969.79225920678,547,0,126.08695652173913,36,10,14,37.93683545244999,0.5943287037037037,47.57882882882884,1009.6846846846864,28.046796796796844,0
2870,4,1,1,46,0.02127659574468085,0.02127659574468085,0.9787234042553191,47,800,600,200,0.75,10,6,4,376.8326854001886,0.46120490286771504,0.2901721962727162,0.20131078693230875,127712.20419908331,225.2265733435712,127937.43077242689,548,0,124.38297872340425,38,9,15,37.77987703907268,0.5934758771929824,47.30235042735043,1010.7905982905992,26.599752586594715,0
2871,4,2,1,47,0.041666666666666664,0.020833333333333332,0.9791666666666666,48,1100,700,400,0.6363636363636364,15,7,8,374.4347914443935,0.46388334810874704,0.3046124828532233,0.20219478737997262,128144.53125000013,-3.6458333333190183,128140.88541666682,549,0,122.64583333333333,39,9,18,37.3971193415638,0.5961538461538461,46.87500000000001,1012.500000000001,25.96153846153849,0
2872,4,0,2,45,0.0,0.0425531914893617,0.9574468085106383,47,1450,1200,250,0.8275862068965517,17,12,5,378.2552850344114,0.4631128584643848,0.30764266525256256,0.20441165530512728,128174.66695011339,296.5490362811775,128471.21598639457,550,1,126.17021276595744,34,13,20,37.26952543302767,0.6060049019607843,46.845238095238095,1012.6190476190477,29.78291316526611,0
2873,4,1,2,44,0.021739130434782608,0.043478260869565216,0.9565217391304348,46,1250,800,450,0.64,17,8,9,375.274065311268,0.4629227053140097,0.2928680127871226,0.2040283136692296,128415.88010204078,438.22987528344015,128854.10997732423,551,0,126.28260869565217,34,12,13,37.09796609505911,0.6084558823529411,46.607142857142854,1013.5714285714283,29.81092436974789,0
2874,4,0,0,44,0.0,0.0,1.0,44,1550,1300,250,0.8387096774193549,18,13,5,383.8029970947277,0.461493569415081,0.2898592942728371,0.20854472969601834,128392.81316080358,1055.5092993079656,129448.32246011154,552,3,131.25,33,11,16,36.905481660620715,0.610479797979798,46.629901960784316,1013.480392156863,30.711527035056456,0
2875,4,1,1,44,0.022222222222222223,0.022222222222222223,0.9777777777777777,45,1250,700,550,0.56,18,7,11,371.5432634881639,0.46228956228956225,0.2863531527305423,0.20400189361001766,128808.3351048753,571.5738378684795,129379.90894274377,553,0,129.3111111111111,34,11,17,36.79122200070364,0.6124387254901961,46.220238095238095,1015.1190476190477,29.856442577030815,0
2876,4,2,1,45,0.043478260869565216,0.021739130434782608,0.9782608695652174,46,1150,600,550,0.5217391304347826,17,6,11,366.4618902555995,0.46329508856682766,0.28963266289292977,0.20277857508012193,129115.53603857242,263.18467961204976,129378.72071818447,554,0,127.3695652173913,36,10,19,36.606648199445985,0.611400462962963,45.917792792792795,1016.3288288288294,28.231356356356372,0
2877,4,0,1,44,0.0,0.022222222222222223,0.9777777777777777,45,1300,900,400,0.6923076923076923,17,9,8,373.37541257024236,0.46332070707070705,0.2866492047223177,0.20659165077374253,129113.15164448286,641.5352527005983,129754.68689718346,555,1,131.06666666666666,35,10,19,36.43342159207379,0.6133928571428571,45.92013888888888,1016.3194444444431,29.037698412698376,0
2878,4,0,0,44,0.0,0.0,1.0,44,1500,1200,300,0.8,18,12,6,382.2554252859941,0.46144952431289643,0.2881841617487273,0.21100697279370442,129019.90504535133,1063.7117346938578,130083.6167800452,556,2,134.86363636363637,34,10,20,36.30307202562298,0.6145833333333333,46.01190476190475,1015.9523809523798,29.880952380952348,0
2879,4,1,0,45,0.022222222222222223,0.0,1.0,45,1100,800,300,0.7272727272727273,14,8,6,372.8296419328372,0.46142676767676766,0.2803682896379531,0.20738648832514034,129322.4489795916,643.1760204081377,129965.62499999974,557,0,132.84444444444443,34,11,21,36.233760533707866,0.6176470588235294,45.7142857142857,1017.1428571428552,29.915966386554565,0
2880,4,0,0,45,0.0,0.0,1.0,45,1450,900,550,0.6206896551724138,20,9,11,366.93976794503317,0.4607744107744108,0.26711141434816654,0.20501069372989947,129495.73072059316,503.42667609737896,129999.15739669054,558,1,133.84444444444443,35,10,13,36.20697824274125,0.6172619047619048,45.543981481481474,1017.8240740740731,29.080687830687804,0
2881,4,0,2,43,0.0,0.044444444444444446,0.9555555555555556,45,1150,900,250,0.782608695652174,14,9,5,368.7600363000559,0.4604166666666667,0.2673537695931696,0.20649153655834424,129584.09857520991,557.0873789008742,130141.18595411078,559,2,134.84444444444443,35,10,14,36.070653821378485,0.6181547619047619,45.45717592592592,1018.1712962962952,29.090608465608433,0
2882,4,1,0,44,0.022727272727272728,0.0,1.0,44,1500,1300,200,0.8666666666666667,17,13,4,381.0195723433735,0.46158165961945036,0.2809634855036287,0.21407645965477665,129716.28578514743,1084.888747165542,130801.17453231297,560,0,136.38636363636363,34,10,15,35.62385571267189,0.6216299019607843,45.327380952380956,1018.6904761904765,29.961484593837543,0
2883,4,1,2,43,0.022222222222222223,0.044444444444444446,0.9555555555555556,45,1150,600,550,0.5217391304347826,17,6,11,374.49224929532477,0.46138468013468015,0.2879636982416336,0.2125659483282864,130114.93866008663,745.4072091478115,130860.34586923444,561,0,134.33333333333334,35,10,17,35.38440631499338,0.6235119047619048,44.936342592592595,1020.25462962963,29.150132275132286,0
2884,4,1,2,42,0.022727272727272728,0.045454545454545456,0.9545454545454546,44,1350,900,450,0.6666666666666666,18,9,9,383.3978341403466,0.45762861169837915,0.3033131124591695,0.21793675293441966,130171.45691609965,1181.4909297051988,131352.94784580485,562,0,138.04545454545453,34,10,18,35.099743350443305,0.6262254901960784,44.88095238095237,1020.4761904761895,30.014005602240868,0
2885,4,0,2,40,0.0,0.047619047619047616,0.9523809523809523,42,1550,1300,250,0.8387096774193549,18,13,5,402.80924342134875,0.45449816105303914,0.3148554952975906,0.2284049143214787,130075.001201461,2079.0825643983103,132154.0837658593,563,1,143.45238095238096,33,9,18,34.702867211276626,0.6275252525252526,44.97549019607843,1020.0980392156864,30.91206179441474,0
2886,4,0,0,40,0.0,0.0,1.0,40,1000,600,400,0.6,14,6,8,403.5333351369386,0.45337873931623934,0.3193363363363364,0.22899897852863083,130106.25608239621,2500.442287821993,132606.69837021822,564,2,149.075,33,7,18,34.652527527527525,0.6278409090909092,44.94485294117647,1020.2205882352943,30.915775401069524,0
2887,4,0,0,40,0.0,0.0,1.0,40,1350,800,550,0.5925925925925926,19,8,11,409.32467498058753,0.45268429487179485,0.32884800096049926,0.23303248242743108,130231.31315179267,2661.3779856305364,132892.69113742321,565,3,150.075,33,7,18,34.37725117060873,0.6291035353535354,44.82230392156863,1020.7107843137261,30.93062982768867,0
2888,4,2,3,39,0.047619047619047616,0.07142857142857142,0.9285714285714286,42,850,500,350,0.5882352941176471,12,5,7,386.75274059923186,0.455744289585753,0.30551423828924973,0.223064439682429,130735.62349965703,1712.4721364883349,132448.09563614536,566,0,143.88095238095238,35,7,16,34.44054625018862,0.6297619047619047,44.3287037037037,1022.6851851851849,29.21957671957671,0
2889,4,0,0,39,0.0,0.0,1.0,39,1550,1100,450,0.7096774193548387,20,11,9,403.6837476074561,0.45209176788124156,0.31251422280445995,0.23149347232124978,130512.91120001934,2737.188220876599,133250.09942089595,567,5,152.76923076923077,33,6,17,34.23432877588551,0.6319444444444444,44.54656862745099,1021.813725490197,30.96405228758173,0
2890,4,0,0,39,0.0,0.0,1.0,39,1300,1000,300,0.7692307692307693,16,10,6,404.614156922928,0.4515294646873594,0.3088603237248646,0.2327787101414529,130638.16350682439,2771.610077854681,133409.77358467906,568,6,153.76923076923077,33,6,17,34.083053624230786,0.6332070707070707,44.42401960784314,1022.3039215686282,30.978906714200853,0
2891,4,1,1,39,0.025,0.025,0.975,40,1200,800,400,0.6666666666666666,16,8,8,392.3152708267028,0.45220352564102567,0.2977759041749042,0.2277865640674421,130992.77388038555,2278.0931122449047,133270.86699263044,569,0,150.9,34,6,18,34.037145792146376,0.6344975490196079,44.077380952380956,1023.6904761904767,30.108543417366963,0
2892,4,0,0,39,0.0,0.0,1.0,39,1350,1000,350,0.7407407407407407,17,10,7,401.6250523325239,0.4513326585695007,0.2993335051736201,0.23370326861354948,131077.01965590162,2728.762975778556,133805.78263168017,570,1,154.92307692307693,33,6,18,33.71329982447743,0.6376262626262627,43.99509803921569,1024.0196078431377,31.030897207367808,0
2893,4,1,1,39,0.025,0.025,0.975,40,1200,700,500,0.5833333333333334,17,7,10,390.8318693185756,0.4506543803418803,0.2943583942452719,0.23056672701278608,131602.8220663266,2286.91539115647,133889.73745748308,571,0,152.025,34,6,15,33.456607495069036,0.640625,43.48214285714286,1026.0714285714291,30.178571428571445,0
2894,4,0,0,39,0.0,0.0,1.0,39,1000,800,200,0.8,12,8,4,394.69752071320187,0.4498144399460189,0.2880221442437827,0.23308864869198534,131642.34459102261,2591.7814061899157,134234.12599721254,572,1,155.2051282051282,33,6,16,33.317411034153324,0.6433080808080809,43.44362745098039,1026.2254901960778,31.09774212715387,0
2895,4,0,1,38,0.0,0.02564102564102564,0.9743589743589743,39,1650,1100,550,0.6666666666666666,22,11,11,351.8564012991435,0.449055330634278,0.20000623938241402,0.1969742244052979,129573.74762854094,1320.4331384421728,130894.1807669831,573,2,156.2051282051282,36,3,14,36.5114478486893,0.6160300925925926,45.467342342342356,1018.1306306306326,28.28140640640646,8
2896,4,0,0,38,0.0,0.0,1.0,38,1400,900,500,0.6428571428571429,19,9,10,357.48395822399345,0.44714615931721197,0.20374077608882857,0.20056358053212148,129659.75265806357,1670.2563205097106,131330.00897857329,574,3,161.21052631578948,36,2,16,36.280729397021965,0.6168981481481481,45.38288288288289,1018.4684684684693,28.290790790790812,0
2897,4,2,1,39,0.05,0.025,0.975,40,950,500,450,0.5263157894736842,14,5,9,341.8599181225979,0.4493856837606838,0.20024348099277467,0.19396437065672525,130099.04308431943,895.12964332675,130994.17272764619,575,0,154.1,38,2,18,36.232851607498155,0.6175986842105263,44.95192307692307,1020.1923076923069,26.847165991902813,0
2898,4,2,1,40,0.04878048780487805,0.024390243902439025,0.975609756097561,41,1350,1100,250,0.8148148148148148,16,11,5,334.40461896077363,0.45121951219512196,0.19582375338462454,0.19108249208592895,130374.54433094787,519.7754207712402,130894.31975171911,576,0,147.65853658536585,37,4,21,36.14406628015174,0.6221846846846847,44.682017543859644,1021.2719298245605,27.601944049312447,0
2899,4,0,1,39,0.0,0.025,0.975,40,1050,700,350,0.6666666666666666,14,7,7,345.12611248325413,0.4499065170940171,0.20952000440868512,0.1978098053417917,130492.60567577701,1007.2811409382197,131499.88681671524,577,1,151.525,36,4,12,35.75076233513353,0.6252893518518519,44.566441441441434,1021.7342342342333,28.381506506506483,0
2900,4,0,0,39,0.0,0.0,1.0,39,1400,1000,400,0.7142857142857143,18,10,8,349.4995786037536,0.4496176338281601,0.2024273654947959,0.20076317565871332,130578.91506371247,1327.4551578605772,131906.37022157304,578,2,154.53846153846155,36,3,13,35.55163801968561,0.6261574074074074,44.48198198198199,1022.072072072073,28.390890890890915,0
2901,4,0,2,37,0.0,0.05128205128205128,0.9487179487179487,39,750,500,250,0.6666666666666666,10,5,5,348.4808487087522,0.4491115609536662,0.2016855709080907,0.20071549809815406,130682.67549871115,1308.0819338642636,131990.75743257542,579,3,155.53846153846155,37,2,13,35.472631814119744,0.6252815315315315,44.38048245614035,1022.4780701754387,27.63454243717402,0
2902,4,0,0,37,0.0,0.0,1.0,37,950,700,250,0.7368421052631579,12,7,5,365.5323937271549,0.44666541541541543,0.21148709906642815,0.20890270999018204,130380.76560356638,2131.6786694101324,132512.4442729765,580,5,164.78378378378378,35,2,19,35.34300392867935,0.6261904761904762,44.67592592592592,1021.2962962962952,29.17989417989415,0
2903,4,0,0,37,0.0,0.0,1.0,37,1450,1100,350,0.7586206896551724,18,11,7,370.6765133277501,0.4453828828828829,0.22126044504300468,0.21281362891313602,130558.1342699759,2278.966799554173,132837.10106953006,581,6,165.78378378378378,35,2,14,35.03161570403926,0.6279761904761905,44.50231481481481,1021.99074074074,29.199735449735428,0
2904,4,1,2,36,0.02631578947368421,0.05263157894736842,0.9473684210526316,38,800,500,300,0.625,11,5,6,364.07802661162896,0.446509009009009,0.2257596385018681,0.21054416752174704,130838.01442912495,1927.0492198279198,132765.06364895287,582,0,162.39473684210526,36,2,15,34.916529077233534,0.6287615740740741,44.228603603603595,1023.0855855855846,28.419044044044014,0
2905,4,0,0,36,0.0,0.0,1.0,36,1100,700,400,0.6363636363636364,15,7,8,379.31490477526427,0.4439649470899471,0.2386675468572026,0.2176496753068761,130536.16780045342,2702.8628117913727,133239.0306122448,583,1,172.02777777777777,34,2,15,34.83321683752718,0.6299019607843137,44.52380952380952,1021.9047619047611,30.056022408963564,0
2906,4,0,0,36,0.0,0.0,1.0,36,750,400,350,0.5333333333333333,11,4,7,376.2067997524303,0.44313822751322757,0.23721083682657973,0.2165458442542809,130657.8514739229,2630.8744331065773,133288.72590702947,584,2,173.02777777777777,34,2,15,34.78909524918492,0.6311274509803921,44.404761904761905,1022.3809523809523,30.070028011204478,0
2907,4,0,1,35,0.0,0.027777777777777776,0.9722222222222222,36,1600,1200,400,0.75,20,12,8,382.92552761271634,0.44206349206349205,0.2465419171352854,0.22163265386069333,130870.93431122448,2822.7643140589535,133693.69862528343,585,3,174.02777777777777,34,2,17,34.40105681597828,0.6332720588235294,44.19642857142857,1023.2142857142856,30.094537815126046,0
2908,4,0,0,35,0.0,0.0,1.0,35,650,400,250,0.6153846153846154,9,4,5,390.445487632343,0.4420518207282913,0.242798945602684,0.22535671091144782,130763.47588667825,3211.2018214148457,133974.6777080931,586,4,174.31428571428572,33,2,17,34.31783688793035,0.634469696969697,44.3014705882353,1022.7941176470592,30.993761140819977,0
2909,4,0,0,35,0.0,0.0,1.0,35,1050,800,250,0.7619047619047619,13,8,5,393.910544116694,0.441281512605042,0.2467840459935322,0.22791123581637426,130857.49959450706,3309.229773404477,134166.72936791152,587,5,175.31428571428572,33,2,17,34.133703637162135,0.6354166666666667,44.20955882352942,1023.1617647058835,31.00490196078435,0
2910,4,0,0,35,0.0,0.0,1.0,35,850,700,150,0.8235294117647058,10,7,3,393.7431951269014,0.4407563025210084,0.24271177164748337,0.22855711667095255,130982.91710219628,3314.726457372164,134297.64355956845,588,6,176.31428571428572,33,2,17,34.010609960493234,0.6366792929292929,44.08700980392157,1023.6519607843138,31.019756387403447,0
2911,4,1,0,36,0.027777777777777776,0.0,1.0,36,1000,500,500,0.5,15,5,10,381.77565227415533,0.4409391534391534,0.24694713229535825,0.22490105455221354,131548.03929077752,2844.822003556317,134392.86129433385,589,0,172.38888888888889,33,3,19,33.74435053557918,0.6423611111111112,43.53553921568627,1025.8578431372546,31.086601307189532,0
2912,4,0,0,36,0.0,0.0,1.0,36,1350,1000,350,0.7407407407407407,17,10,7,381.61176381511194,0.4400297619047619,0.2410325798577948,0.225733060290634,131705.23356401385,2852.05329680892,134557.28686082276,590,1,173.38888888888889,33,3,17,33.589521649156325,0.6439393939393939,43.38235294117647,1026.4705882352941,31.10516934046346,0
2913,4,0,0,36,0.0,0.0,1.0,36,850,400,450,0.47058823529411764,13,4,9,382.29976734827915,0.43905423280423284,0.23967529458907855,0.22689938700209233,131832.8045294282,2879.930100094314,134712.7346295225,591,2,174.38888888888889,35,1,17,33.442865058792606,0.6407738095238096,43.258101851851855,1026.9675925925928,29.341931216931226,0
2914,4,0,0,36,0.0,0.0,1.0,36,1100,700,400,0.6363636363636364,15,7,8,381.06350249770094,0.43831018518518516,0.238448349227804,0.22705246813252283,131981.42387902955,2858.660729595346,134840.0846086249,592,3,175.38888888888889,35,1,17,33.32441615979576,0.6422619047619047,43.11342592592593,1027.5462962962968,29.35846560846562,0
2915,4,0,1,35,0.0,0.027777777777777776,0.9722222222222222,36,1350,1000,350,0.7407407407407407,17,10,7,376.31047590305167,0.4377314814814815,0.23024316109422482,0.22510208467655288,132130.12695312512,2744.390190972237,134874.51714409736,593,4,176.38888888888889,35,1,17,33.296394799054376,0.64375,42.96875000000001,1028.125000000001,29.375000000000025,0
2916,4,0,0,35,0.0,0.0,1.0,35,1100,900,200,0.8181818181818182,13,9,4,373.65966900292284,0.4357843137254902,0.20417892683571948,0.2245595868931335,132306.12953514743,2887.4929138322063,135193.62244897964,594,5,165.6,34,1,18,33.18700339427602,0.647671568627451,42.79761904761905,1028.809523809524,30.25910364145659,0
2917,4,0,0,35,0.0,0.0,1.0,35,1000,400,600,0.4,16,4,12,376.8828127972276,0.434733893557423,0.20446779683420901,0.2272335285526381,132428.6352040817,2982.0153061224537,135410.65051020414,595,6,166.6,34,1,18,32.980569049271345,0.6488970588235294,42.67857142857143,1029.2857142857147,30.27310924369749,0
2918,4,0,0,35,0.0,0.0,1.0,35,1200,700,500,0.5833333333333334,17,7,10,374.3793644959739,0.43375350140056024,0.2036003303055327,0.22646024495735467,132551.19756235817,2924.886621315179,135476.08418367335,596,7,167.6,34,1,18,32.921483622350664,0.6501225490196079,42.5595238095238,1029.761904761904,30.28711484593835,0
2919,4,0,1,34,0.0,0.02857142857142857,0.9714285714285714,35,1100,800,300,0.7272727272727273,14,8,6,370.99825620727,0.43308823529411766,0.20472669659360965,0.22551691753722822,132735.1473922902,2848.9016439909274,135584.04903628113,597,8,168.6,34,1,15,32.82333063770794,0.6519607843137255,42.38095238095238,1030.4761904761904,30.308123249299715,0
2920,4,0,1,33,0.0,0.029411764705882353,0.9705882352941176,34,550,400,150,0.7272727272727273,7,4,3,374.4810432267121,0.432449494949495,0.20164961341431975,0.22800681239499807,132796.49234693873,3145.9537981859366,135942.44614512468,598,9,171.55882352941177,34,0,15,32.671854546854554,0.6525735294117647,42.32142857142857,1030.7142857142853,30.315126050420158,0
2921,4,0,0,33,0.0,0.0,1.0,33,1450,1200,250,0.8275862068965517,17,12,5,385.57369650819913,0.4312657828282828,0.20485987235898007,0.2344388441024909,132745.0698799742,3636.601457372186,136381.6713373464,599,10,176.0,33,0,16,32.437839418083804,0.6543560606060606,42.371323529411775,1030.5147058823543,31.227718360071343,0
2922,4,0,0,33,0.0,0.0,1.0,33,1150,800,350,0.6956521739130435,15,8,7,385.30762167125795,0.4302004419191919,0.20422405876951322,0.23546576879910228,132934.5703125002,3644.140625000028,136578.71093750023,600,11,177.0,33,0,17,32.25378787878789,0.65625,42.187500000000014,1031.2500000000016,31.25000000000005,0
2923,4,0,0,33,0.0,0.0,1.0,33,1150,900,250,0.782608695652174,14,9,5,384.4980078248508,0.4288194444444444,0.19972140936626004,0.23576756940112317,133060.97902549518,3632.336270905445,136693.31529640063,601,12,178.0,33,0,18,32.147399730767724,0.6575126262626263,42.06495098039217,1031.7401960784327,31.264854426619173,0
2924,4,0,0,33,0.0,0.0,1.0,33,900,800,100,0.8888888888888888,10,8,2,389.65525544844974,0.4280697601010101,0.20870303605995844,0.23953843513772588,133155.82498317957,3776.973399653986,136932.79838283354,602,13,179.0,33,0,18,31.918883083986383,0.658459595959596,41.97303921568628,1032.1078431372553,31.27599524658349,0
2925,4,1,1,33,0.029411764705882353,0.029411764705882353,0.9705882352941176,34,500,100,400,0.2,9,1,8,381.71223829801824,0.4289401366607249,0.20365249452701928,0.2364654187143828,133441.4700255104,3387.248441043109,136828.71846655352,603,0,174.7058823529412,34,0,19,31.836665130391374,0.6590073529411764,41.696428571428584,1033.2142857142871,30.388655462184914,0
2926,4,0,0,33,0.0,0.0,1.0,33,700,300,400,0.42857142857142855,11,3,8,386.9968772256506,0.4273595328282828,0.20144019384735956,0.2393247746247256,133377.26362757114,3723.3169033544773,137100.58053092562,604,1,178.0909090909091,33,0,19,31.764716059635376,0.6606691919191919,41.75857843137255,1032.9656862745098,31.301990493166965,0
2927,4,0,0,33,0.0,0.0,1.0,33,1300,900,400,0.6923076923076923,17,9,8,384.12123551632124,0.42578125,0.1922125127055787,0.23917570952407405,133630.5616379518,3666.0672878219943,137296.62892577378,605,2,179.0909090909091,33,0,20,31.584464264549013,0.6631944444444444,41.513480392156865,1033.9460784313728,31.331699346405237,0
2928,4,0,0,33,0.0,0.0,1.0,33,900,700,200,0.7777777777777778,11,7,4,382.41937721099487,0.42530776515151514,0.19096870578264236,0.2383201406873248,133662.24078479444,3623.0061755094366,137285.2469603039,606,3,180.0909090909091,33,0,20,31.5966461246741,0.663510101010101,41.48284313725491,1034.0686274509815,31.335412953060043,0
2929,4,0,0,33,0.0,0.0,1.0,33,1100,900,200,0.8181818181818182,13,9,4,383.04354645906346,0.4237689393939394,0.19229720224509417,0.23994211471070714,133852.39451172634,3654.2591791618715,137506.6536908882,607,4,181.0909090909091,33,0,17,31.389645507658297,0.6654040404040404,41.29901960784314,1034.803921568628,31.35769459298873,0
2930,4,0,0,33,0.0,0.0,1.0,33,950,600,350,0.631578947368421,13,6,7,383.18441838151665,0.42309816919191917,0.19340284129016538,0.2410666530830554,134010.9592013889,3670.1822916666715,137681.14149305556,608,5,182.0909090909091,33,0,18,31.226945003353457,0.6669823232323233,41.145833333333336,1035.4166666666667,31.37626262626263,0
2931,4,0,2,31,0.0,0.06060606060606061,0.9393939393939394,33,800,500,300,0.625,11,5,6,383.96022548230104,0.4227825126262626,0.19362381208535062,0.24176333124630747,134042.6834030182,3693.41178873512,137736.09519175332,609,6,183.0909090909091,33,0,18,31.17504930966471,0.6672979797979798,41.11519607843138,1035.5392156862754,31.379976232917436,0
2932,4,0,1,30,0.0,0.03225806451612903,0.967741935483871,31,1200,700,500,0.5833333333333334,17,7,10,404.15338759080083,0.41877240143369177,0.19717726713671624,0.2530974760586363,133842.48733520508,4618.578932020399,138461.06626722548,610,21,185.48387096774192,31,0,18,30.85349293234345,0.6703629032258065,41.30859375,1034.765625,33.379536290322584,0
2933,4,0,0,30,0.0,0.0,1.0,30,950,600,350,0.631578947368421,13,6,7,409.9251184184377,0.4184626436781609,0.18631210330488068,0.23774408048411286,130949.53399598216,4735.900646028439,135685.4346420106,611,22,185.8,30,0,19,33.6304442985336,0.6440972222222222,44.119623655913976,1023.5215053763438,34.1173835125448,8
2934,4,0,0,30,0.0,0.0,1.0,30,850,700,150,0.8235294117647058,10,7,3,412.4399070289884,0.4180076628352491,0.18615196078431406,0.23941633627536382,130983.92877789329,4804.5998814891755,135788.52865938246,612,23,186.8,30,0,19,33.53110775560225,0.6444444444444444,44.08602150537634,1023.6559139784937,34.121863799283126,0
2935,4,0,0,30,0.0,0.0,1.0,30,1400,1200,200,0.8571428571428571,16,12,4,409.6460584503541,0.4172174329501916,0.18268801680010527,0.2384334086580019,131087.14022213538,4739.866061105315,135827.00628324068,613,24,187.8,30,0,19,33.49767029793937,0.6454861111111111,43.98521505376343,1024.0591397849453,34.135304659498175,0
2936,4,0,0,30,0.0,0.0,1.0,30,600,300,300,0.5,9,3,6,411.2606343417311,0.41712164750957853,0.18670778113108533,0.2398023943625348,131155.9704337206,4787.857519655445,135943.82795337605,614,25,188.8,30,0,19,33.38636661855399,0.6461805555555555,43.91801075268817,1024.3279569892468,34.144265232974895,0
2937,4,0,0,30,0.0,0.0,1.0,30,600,400,200,0.6666666666666666,8,4,4,411.9433137086287,0.41704980842911876,0.18161944735921653,0.2408478392419159,131259.24962423395,4814.274049023001,136073.52367325695,615,26,189.8,30,0,20,33.263925323539695,0.6472222222222221,43.817204301075265,1024.7311827956985,34.15770609318995,0
2938,4,0,1,29,0.0,0.03333333333333333,0.9666666666666667,30,900,700,200,0.7777777777777778,11,7,4,413.77486945601163,0.41719348659003835,0.18211382113821095,0.2423538521099497,131328.125,4868.055555555556,136196.18055555556,616,27,190.8,30,0,20,33.14701897018969,0.6479166666666667,43.75,1025.0,34.166666666666664,0
2939,4,0,0,29,0.0,0.0,1.0,29,1200,900,300,0.75,15,9,6,421.376164981162,0.41430623973727426,0.16148023549200974,0.24680603948896632,131328.125,5267.708333333334,136595.83333333334,552,28,177.13793103448276,29,0,20,32.95223577235772,0.6508620689655172,43.75,1025.0,35.3448275862069,0
2940,4,0,0,29,0.0,0.0,1.0,29,650,500,150,0.7692307692307693,8,5,3,421.9839261345908,0.4150246305418719,0.1653602892403705,0.24762204632158566,131399.31520061722,5289.679783950606,136688.99498456783,553,29,178.13793103448276,29,0,20,32.86428700442517,0.6515804597701149,43.68055555555555,1025.2777777777771,35.354406130268174,0
2941,4,0,0,29,0.0,0.0,1.0,29,450,100,350,0.2222222222222222,8,1,7,418.84843153586314,0.4146654351395731,0.16305185254359955,0.24646977425437042,131506.13667052463,5216.227816358019,136722.36448688264,554,30,179.13793103448276,29,0,20,32.836126156623784,0.6526580459770115,43.576388888888886,1025.6944444444441,35.36877394636014,0
2942,4,1,1,29,0.03333333333333333,0.03333333333333333,0.9666666666666667,30,750,600,150,0.8,9,6,3,408.4391299864086,0.41683429118773946,0.15241024298739236,0.24249288206885375,131845.26616155045,4770.153160770025,136615.41932232046,555,0,174.13333333333333,30,0,19,32.75912838633686,0.653125,43.24596774193548,1027.0161290322578,34.23387096774193,0
2943,4,0,0,29,0.0,0.0,1.0,29,850,700,150,0.8235294117647058,10,7,3,413.6348118773688,0.4161535303776683,0.13740863911342038,0.2452287220697183,131791.2061149691,5102.686149691352,136893.89226466045,556,1,176.27586206896552,29,0,19,32.68054804093962,0.6555316091954023,43.29861111111111,1026.8055555555552,35.40708812260535,0
2944,4,0,0,29,0.0,0.0,1.0,29,500,300,200,0.6,7,3,4,411.16392539579675,0.41589696223316913,0.13487170399112025,0.24399246102540303,131826.86149691354,5040.489969135796,136867.35146604932,557,2,177.27586206896552,29,0,19,32.70782616535929,0.6558908045977012,43.263888888888886,1026.9444444444441,35.411877394636,0
2945,4,0,0,29,0.0,0.0,1.0,29,1100,900,200,0.8181818181818182,13,9,4,412.79764412592084,0.4144601806239738,0.13533981758951574,0.2461152110304343,132005.21074459885,5098.2880015432265,137103.49874614208,558,3,178.27586206896552,29,0,20,32.48510496913998,0.6576867816091954,43.090277777777786,1027.6388888888896,35.4358237547893,0
2946,4,0,0,29,0.0,0.0,1.0,29,600,500,100,0.8333333333333334,7,5,2,394.62933356164024,0.4144088669950739,0.03415345533236147,0.22081168053487207,129554.63927469144,4425.212191358044,133979.85146604947,559,4,179.27586206896552,29,0,19,35.442246475670785,0.6329022988505747,45.48611111111112,1018.0555555555562,35.105363984674355,8
2947,4,1,0,30,0.03333333333333333,0.0,1.0,30,600,400,200,0.6666666666666666,8,4,4,383.67609196426565,0.41580459770114947,0.03977502416732648,0.21688277448889115,129954.04996242344,3972.0524049023147,133926.10236732574,560,0,174.26666666666668,30,0,21,35.313955532120595,0.6340277777777779,45.09408602150538,1019.6236559139787,33.987455197132626,0
2948,4,0,0,30,0.0,0.0,1.0,30,1150,800,350,0.6956521739130435,15,8,7,381.19158817075987,0.41525383141762456,0.03416765467878591,0.2164267274348724,130125.4141555385,3920.5426566655447,134045.95681220404,561,1,175.26666666666668,30,0,21,35.202871821894334,0.6357638888888889,44.92607526881722,1020.2956989247335,34.00985663082445,0
2949,4,0,0,30,0.0,0.0,1.0,30,1000,700,300,0.7,13,7,6,383.67438757606993,0.4136494252873563,0.03832131682764239,0.21880453243380074,130298.03481867291,3998.4760049732863,134296.51082364618,562,2,176.26666666666668,29,1,22,34.96392214211218,0.6404454022988506,44.75694444444445,1020.9722222222229,35.20593869731803,0
2950,4,0,0,30,0.0,0.0,1.0,30,500,400,100,0.8,6,4,2,382.60977229178343,0.4136733716475096,0.045118302964372914,0.21879566605239337,130404.40779321003,3978.800154321002,134383.20794753105,563,3,177.26666666666668,29,1,22,34.88294352279939,0.6415229885057472,44.652777777777786,1021.38888888889,35.22030651341,0
2951,4,0,0,30,0.0,0.0,1.0,30,500,300,200,0.6,7,3,4,382.56507756346235,0.41360153256704985,0.0416723317471106,0.21897012805286123,130439.87509645073,3980.34818672841,134420.22328317913,564,4,178.26666666666668,29,1,22,34.848034217085875,0.641882183908046,44.618055555555564,1021.5277777777787,35.225095785440644,0
2952,4,0,0,30,0.0,0.0,1.0,30,600,400,200,0.6666666666666666,8,4,4,413.03576560752634,0.41305076628352494,0.04037940379403793,0.2159428600055459,126838.6082416767,4541.5543034178345,131380.16254509453,565,5,179.26666666666668,28,2,21,37.76654542861218,0.6082589285714286,48.16810344827587,1007.3275862068976,35.97598522167492,8
2953,4,0,0,30,0.0,0.0,1.0,30,750,600,150,0.8,9,6,3,412.70827713163226,0.4128352490421456,0.037953983647081024,0.2159634656154482,126874.79356586079,4472.455492799583,131347.24905866038,566,6,180.26666666666668,28,2,21,37.737390663624275,0.6086309523809523,48.13218390804598,1007.4712643678165,35.98111658456487,0
2954,4,3,0,33,0.09090909090909091,0.0,1.0,33,700,400,300,0.5714285714285714,10,4,6,378.4577327693303,0.42250631313131315,0.057766492314053064,0.20319544753869578,127913.92220391172,3082.002597384988,130995.9248012967,567,0,164.78787878787878,31,2,20,37.53177693396833,0.6105510752688172,47.102864583333336,1011.588541666667,32.63188844086022,0
2955,4,0,0,33,0.0,0.0,1.0,33,1300,900,400,0.6923076923076923,17,9,8,379.3004621540304,0.42230902777777773,0.04997369190295231,0.20465378856680005,128111.57438490143,3118.555874294724,131230.13025919616,568,1,165.78787878787878,31,2,21,37.307743837084665,0.6125672043010753,46.90755208333334,1012.369791666668,32.65709005376348,0
2956,4,0,0,33,0.0,0.0,1.0,33,900,700,200,0.7777777777777778,11,7,4,378.81861333116956,0.4215198863636364,0.052700572605030915,0.20508455963101246,128246.61810613945,3116.4454456284775,131363.06355176793,569,2,166.78787878787878,30,3,21,37.181528662420384,0.6166666666666667,46.774193548387096,1012.9032258064517,33.763440860215056,0
2957,4,0,0,33,0.0,0.0,1.0,33,1100,700,400,0.6363636363636364,15,7,8,375.99257702631036,0.42163825757575757,0.047293467906281306,0.2040754527142803,128348.74561004159,3051.635124002773,131400.38073404436,570,3,167.78787878787878,30,3,22,37.14849449529117,0.6177083333333333,46.67338709677419,1013.306451612903,33.7768817204301,0
2958,4,0,0,33,0.0,0.0,1.0,33,1000,600,400,0.6,14,6,8,378.1543332918136,0.4215198863636364,0.042913558225768034,0.20595076794369307,128484.97884509762,3117.430302636129,131602.40914773374,571,4,168.78787878787878,30,3,18,36.95424013434088,0.6190972222222222,46.53897849462365,1013.8440860215047,33.79480286738349,0
2959,4,1,0,34,0.029411764705882353,0.0,1.0,34,800,400,400,0.5,12,4,8,370.68777080371456,0.42485516934046347,0.045841316778057806,0.20385213235030777,128870.65463595907,2754.1551378038002,131624.80977376289,572,0,164.7941176470588,31,3,19,36.74927331794477,0.6202956989247312,46.15885416666666,1015.3645833333322,32.7536962365591,0
2960,4,0,0,34,0.0,0.0,1.0,34,1150,900,250,0.782608695652174,14,9,5,369.20693626869297,0.4243352644087938,0.045540918585098344,0.20354652366304385,128969.83040703653,2723.3111911349624,131693.1415981715,573,1,165.7941176470588,31,3,19,36.685601204973715,0.6213037634408602,46.06119791666666,1015.7552083333321,32.76629704301072,0
2961,4,1,0,35,0.02857142857142857,0.0,1.0,35,1050,700,350,0.6666666666666666,14,7,7,359.8207296138243,0.42724089635854345,0.049052523354545796,0.20067787266144016,129426.12879106724,2314.0408185389233,131740.16960960615,574,0,162.02857142857144,32,3,16,36.458979608719034,0.6233723958333333,45.61237373737374,1017.5505050505051,31.798453282828284,0
2962,4,0,0,35,0.0,0.0,1.0,35,1200,900,300,0.75,15,9,6,383.3575905325111,0.42724089635854345,0.08438696954757474,0.20718910237244892,128178.55568562837,3006.7755685633606,131185.33125419173,575,1,163.02857142857144,30,5,19,37.136370675161466,0.6159722222222221,46.84139784946236,1012.6344086021503,33.75448028673834,8
2963,4,3,0,38,0.07894736842105263,0.0,1.0,38,1000,700,300,0.7,13,7,6,356.4481441804936,0.4331288525367473,0.10751481016351416,0.1979790294785635,129263.69214965415,1615.1606353325824,130878.85278498672,576,0,151.07894736842104,33,5,21,36.71015104041133,0.6193181818181819,45.77205882352942,1016.9117647058837,30.815508021390414,0
2964,4,0,0,38,0.0,0.0,1.0,38,1150,900,250,0.782608695652174,14,9,5,356.3763518596725,0.4321953532479848,0.11309259658420867,0.19856620625093982,129388.34372597092,1622.1891820453816,131010.53290801629,577,1,152.07894736842104,33,5,21,36.585059824941794,0.6205808080808081,45.649509803921575,1017.4019607843148,30.83036244800954,0
2965,4,0,0,38,0.0,0.0,1.0,38,850,400,450,0.47058823529411764,13,4,9,355.2103159169833,0.4321212660028449,0.10870750023764986,0.198387469649667,129481.87183114678,1598.6593197328052,131080.5311508796,578,2,153.07894736842104,33,5,18,36.51954144089905,0.6215277777777778,45.55759803921569,1017.7696078431381,30.841503267973884,0
2966,4,0,1,37,0.0,0.02631578947368421,0.9736842105263158,38,1300,1000,300,0.7692307692307693,16,10,6,357.63018514935857,0.43235834518729255,0.10597559353805042,0.20069307689239163,129669.0294147684,1674.7117995482536,131343.74121431666,579,3,154.07894736842104,33,5,19,36.2675720932098,0.6234217171717171,45.37377450980392,1018.5049019607847,30.863784907902566,0
2967,4,1,0,38,0.02631578947368421,0.0,1.0,38,1000,800,200,0.8,12,8,4,352.8557392455894,0.43349928876244664,0.09614723082215315,0.1999515855725006,130050.0,1577.777777777778,131627.77777777778,580,0,146.1315789473684,34,4,20,36.00217864923748,0.625,45.0,1020.0,30.0,0
2968,4,0,0,38,0.0,0.0,1.0,38,900,600,300,0.6666666666666666,12,6,6,351.603217776103,0.43324739212897106,0.09543503490964045,0.19970783164738096,130141.08737244896,1551.6050170068015,131692.69238945577,581,1,147.1315789473684,34,4,20,35.94169291797924,0.6259191176470589,44.910714285714285,1020.3571428571427,30.010504201680668,0
2969,4,1,1,38,0.02564102564102564,0.02564102564102564,0.9743589743589743,39,1400,800,600,0.5714285714285714,20,8,12,343.8643464034164,0.435138326585695,0.09967669127066414,0.19696888940317683,130469.43486636227,1172.7573891889504,131642.19225555123,582,0,144.33333333333334,35,4,21,35.80645085155393,0.6270833333333333,44.58912037037037,1021.6435185185182,29.189814814814806,0
2970,4,0,0,38,0.0,0.0,1.0,38,950,700,250,0.7368421052631579,12,7,5,350.37483134585364,0.4359293504030346,0.09607624280930738,0.20072875851869926,130475.34722222213,1543.0555555555454,132018.40277777766,583,1,146.47368421052633,34,4,21,35.63417618270799,0.6292892156862745,44.58333333333333,1021.6666666666658,30.049019607843114,0
2971,4,1,1,38,0.02564102564102564,0.02564102564102564,0.9743589743589743,39,1250,900,350,0.72,16,9,7,341.89608091580965,0.4371907332433648,0.10298183168417352,0.1976467926236,130824.41332572453,1145.6708408350562,131970.0841665596,584,0,143.69230769230768,35,4,18,35.497628879586685,0.6306547619047619,44.24189814814815,1023.032407407408,29.22949735449737,0
2972,4,0,0,38,0.0,0.0,1.0,38,700,700,0,1.0,7,7,0,348.92054553582176,0.4346995021337126,0.10331145712692491,0.20099789172415647,130688.28124999999,1519.9652777777771,132208.24652777775,585,1,148.42105263157896,34,4,19,35.455718554740564,0.6314338235294117,44.375,1022.4999999999999,30.073529411764703,0
2973,4,0,2,36,0.0,0.05263157894736842,0.9473684210526316,38,1000,900,100,0.9,11,9,2,355.8121839578225,0.4341660739687056,0.016147714720721407,0.20196293635468146,130114.93866008647,1659.2960980366838,131774.23475812314,586,2,149.42105263157896,35,3,19,35.86086689355267,0.6235119047619048,44.93634259259259,1020.2546296296287,29.150132275132247,8
2974,4,1,0,37,0.02702702702702703,0.0,1.0,37,1250,900,350,0.72,16,9,7,353.0138565437015,0.4319944944944945,0.056097379030296546,0.20162196481005246,130356.43029423783,1803.6089611819882,132160.0392554198,587,0,154.1081081081081,33,4,21,35.68730249209968,0.6303661616161615,44.69975490196079,1021.2009803921571,30.945484254307793,0
2975,4,0,2,35,0.0,0.05405405405405406,0.9459459459459459,37,1000,600,400,0.6,14,6,8,353.1977416083019,0.4311186186186186,0.04669512981855517,0.20237866472772592,130481.60750973187,1817.161818771629,132298.7693285035,588,1,155.1081081081081,33,4,21,35.555730478589425,0.6316287878787878,44.57720588235294,1021.6911764705884,30.96033868092692,0
2976,4,0,1,34,0.0,0.02857142857142857,0.9714285714285714,35,750,600,150,0.8,9,6,3,379.0313305795165,0.42888655462184877,0.12469267182855726,0.20637328250993806,128474.33302137582,2739.1594780815935,131213.4924994574,589,2,159.0,31,4,20,36.942910351913696,0.616263440860215,46.549479166666664,1013.8020833333329,32.703293010752674,8
2977,4,0,0,34,0.0,0.0,1.0,34,700,400,300,0.5714285714285714,10,4,6,388.8427653761569,0.42699049316696375,0.13987266215678473,0.21105007978191825,128348.7456100415,3181.49623511387,131530.24184515537,590,14,164.61764705882354,30,4,20,36.822965026307656,0.6177083333333333,46.673387096774185,1013.3064516129022,33.77688172043007,0
2978,4,1,0,35,0.02857142857142857,0.0,1.0,35,650,300,350,0.46153846153846156,10,3,7,379.43407443637255,0.4300420168067227,0.13669697858609586,0.20762291488821707,128672.41753472209,2764.539930555537,131436.95746527764,591,0,160.88571428571427,31,4,21,36.72997946611909,0.6182795698924731,46.35416666666666,1014.5833333333322,32.72849462365588,0
2979,4,0,0,35,0.0,0.0,1.0,35,1000,600,400,0.6,14,6,8,375.6649671573665,0.42955182072829134,0.130697500932488,0.20680857842893208,128912.72454660227,2685.5988865931913,131598.32343319547,592,1,161.88571428571427,32,3,21,36.5799452940445,0.6181640625,46.117424242424235,1015.5303030303022,31.735321969696944,0
2980,4,1,0,36,0.027777777777777776,0.0,1.0,36,1200,800,400,0.6666666666666666,16,8,8,369.6444486057796,0.4318948412698413,0.12670184150631103,0.20548557857277805,129297.68207644632,2359.1569100091915,131656.83898645552,593,0,158.36111111111111,32,4,22,36.34000620732464,0.6220703125,45.73863636363637,1017.0454545454548,31.782670454545464,0
2981,4,0,1,35,0.0,0.027777777777777776,0.9722222222222222,36,800,700,100,0.875,9,7,2,348.21403686837647,0.43176256613756614,0.061764474357460575,0.183055535582761,127062.0057397959,1648.9547902494287,128710.96053004533,594,1,159.36111111111111,34,2,21,39.16956941000512,0.5946691176470589,47.94642857142857,1008.2142857142856,29.65336134453781,8
2982,4,3,0,38,0.07894736842105263,0.0,1.0,38,1150,700,450,0.6086956521739131,16,7,9,362.86325802615903,0.43609234234234234,0.050417422867513384,0.18926321012155808,126742.13927469157,1598.0166603678736,128340.15593505945,595,0,151.8684210526316,35,3,18,39.12931034482759,0.5892857142857143,48.2638888888889,1006.9444444444462,28.76984126984132,8
2983,4,1,1,38,0.02564102564102564,0.02564102564102564,0.9743589743589743,39,1200,1000,200,0.8333333333333334,14,10,4,349.36138241923334,0.43868083670715247,0.04534859080313591,0.18379446640316202,127092.013888889,1080.2083333333426,128172.22222222235,596,0,148.94871794871796,37,2,19,39.10984848484846,0.5889639639639639,47.91666666666667,1008.3333333333344,27.25225225225228,0
2984,4,1,0,39,0.02564102564102564,0.0,1.0,39,1200,800,400,0.6666666666666666,16,8,8,353.02995344297403,0.43868083670715247,0.0698707939394978,0.1872938794419946,127432.89531085161,1197.5258197386795,128630.4211305903,597,0,149.7948717948718,36,3,17,38.667605398170856,0.5943287037037037,47.57882882882884,1009.6846846846865,28.046796796796848,0
2985,4,1,1,39,0.025,0.025,0.975,40,1000,600,400,0.6,14,6,8,342.23817881526963,0.4423076923076923,0.07494577006507552,0.18302993089772562,127756.25673284105,744.6137273007229,128500.87046014177,598,0,147.025,37,3,18,38.609002169197396,0.5957207207207207,47.25877192982457,1010.9649122807032,27.32337600758657,0
2986,4,1,2,38,0.025,0.05,0.95,40,1400,1100,300,0.7857142857142857,17,11,6,351.77773480004976,0.4405849358974359,0.0970296761615943,0.18982839423780598,128116.77781865571,1013.725978185593,129130.50379684131,599,0,147.95,37,3,20,37.99900267157659,0.5993806306306306,46.90241228070175,1012.3903508771928,27.361901375059265,0
2987,4,1,0,39,0.02564102564102564,0.0,1.0,39,750,500,250,0.6666666666666666,10,5,5,349.2097112533554,0.43851214574898784,0.07959627251605128,0.1889660282863061,128227.80957842803,1155.679271506623,129383.48884993466,600,0,148.51282051282053,37,2,21,37.95052055140558,0.6005067567567568,46.79276315789474,1012.8289473684215,27.37375533428166,0
2988,4,2,2,39,0.04878048780487805,0.04878048780487805,0.9512195121951219,41,700,600,100,0.8571428571428571,8,6,2,338.5440212171001,0.4420223577235773,0.09626963907644392,0.1859892914758659,128830.99500868063,522.992621527787,129353.98763020842,601,0,142.21951219512195,39,2,17,37.605598878172245,0.6030982905982907,46.19791666666667,1015.208333333334,26.030982905982924,0
2989,4,2,2,39,0.04878048780487805,0.04878048780487805,0.9512195121951219,41,750,400,350,0.5333333333333333,11,4,7,336.50422012814744,0.4419461382113821,0.11188758735357718,0.1859829273286163,129069.04432508674,486.4556206597175,129555.49994574646,602,0,142.3170731707317,39,2,19,37.41510763710918,0.6055021367521367,45.963541666666664,1016.1458333333328,26.055021367521356,0
2990,4,0,0,39,0.0,0.0,1.0,39,1450,1200,250,0.8275862068965517,17,12,5,346.1345282011776,0.4387370670265407,0.09689684371316187,0.19113721920811125,129034.22807979358,1132.6403316404821,130166.86841143406,603,1,135.35897435897436,37,2,20,37.20591409453917,0.6086711711711712,45.99780701754385,1016.0087719298228,27.45969653864386,0
2991,4,1,1,39,0.025,0.025,0.975,40,1000,700,300,0.7,13,7,6,339.9350563085278,0.44090544871794873,0.09437769903665161,0.18892021498598827,129287.27027280637,790.0715127748222,130077.3417855812,604,0,132.95,36,4,22,37.105986786254746,0.6131365740740741,45.74887387387386,1017.0045045045027,28.250125125125077,0
2992,4,0,1,38,0.0,0.02564102564102564,0.9743589743589743,39,1450,1200,250,0.8275862068965517,17,12,5,360.72658448426944,0.43868083670715247,0.10935178810826507,0.19290240273554243,127753.08956916095,1464.733092683135,129217.82266184408,605,1,136.64102564102564,34,5,18,38.144969775474955,0.6017156862745099,47.26190476190476,1010.9523809523805,29.733893557422956,8
2993,4,2,1,39,0.05,0.025,0.975,40,1100,600,500,0.5454545454545454,16,6,10,354.0501789718891,0.4408787393162393,0.13002742230347364,0.1917479682154688,128261.74554183826,1082.2187928669557,129343.96433470522,606,0,134.1,35,5,20,37.793266301035956,0.6047619047619048,46.75925925925927,1012.962962962964,28.94179894179897,0
2994,4,0,2,37,0.0,0.05128205128205128,0.9487179487179487,39,650,400,250,0.6153846153846154,9,4,5,360.9855567851608,0.4389901034637877,0.1341978814351259,0.19507898005175225,128174.66695011347,1453.8407029478587,129628.50765306133,607,1,138.43589743589743,34,5,20,37.70671682733757,0.6060049019607843,46.8452380952381,1012.6190476190484,29.78291316526613,0
2995,4,0,0,37,0.0,0.0,1.0,37,1000,800,200,0.8,12,8,4,367.77508872663134,0.43678053053053056,0.12726192027615002,0.19830003674334495,128084.2704790251,2021.2407879818743,130105.51126700698,608,2,141.8108108108108,34,3,21,37.62740601356383,0.6050857843137255,46.93452380952382,1012.2619047619061,29.772408963585473,0
2996,4,1,0,38,0.02631578947368421,0.0,1.0,38,700,100,600,0.14285714285714285,13,1,12,363.78956550937926,0.44041903745851113,0.1404847840597261,0.19808388362390528,128476.21882086188,1747.675736961473,130223.89455782335,609,0,139.05263157894737,34,4,15,37.3272858932206,0.6090686274509804,46.54761904761906,1013.8095238095254,29.817927170868394,0
2997,4,0,0,38,0.0,0.0,1.0,38,1150,900,250,0.782608695652174,14,9,5,364.5844836570543,0.4402264106211475,0.14317123482256466,0.19942162835208066,128657.3200113379,1781.2925170068056,130438.6125283447,610,1,140.05263157894737,34,4,17,37.12205663772196,0.610906862745098,46.36904761904762,1014.5238095238097,29.838935574229698,0
2998,4,0,1,37,0.0,0.02631578947368421,0.9736842105263158,38,1000,700,300,0.7,13,7,6,363.7408909560566,0.44012268847795166,0.14161058514885339,0.19918278519748583,128701.77636584791,1762.8197605881332,130464.59612643604,611,2,141.05263157894737,35,3,17,37.09804285008173,0.6092261904761904,46.32523148148148,1014.699074074074,28.991402116402114,0
2999,4,2,0,39,0.05128205128205128,0.0,1.0,39,1450,1000,450,0.6896551724137931,19,10,9,359.0105121821155,0.4413517768780926,0.15553894776650234,0.19954631135795797,129292.17864229028,1485.3859654072562,130777.56460769754,612,0,138.25641025641025,34,5,21,36.615991650083885,0.6173406862745099,45.74404761904762,1017.0238095238097,29.912464985994404,0
3000,4,0,0,39,0.0,0.0,1.0,39,1250,1100,150,0.88,14,11,3,360.3415084155307,0.4408175888439046,0.14737278062867176,0.2014302346671604,129516.42679419291,1534.0289191218326,131050.45571331475,613,1,139.25641025641025,36,3,16,36.353809418446,0.6154513888888888,45.52364864864865,1017.905405405406,28.275150150150168,0
3001,4,1,1,39,0.025,0.025,0.975,40,1100,900,200,0.8181818181818182,13,9,4,351.95027713509575,0.4431891025641026,0.1484724612736663,0.1985272922480489,129871.11418898105,1141.6349261310986,131012.74911511215,614,0,136.75,37,3,17,36.20688109581181,0.6171171171171171,45.17543859649122,1019.2982456140338,27.548601232811723,0
3002,4,0,0,39,0.0,0.0,1.0,39,1300,1000,300,0.7692307692307693,16,10,6,358.10262202008465,0.44157669815564554,0.15622042782263756,0.2017950640897738,129831.8483179125,1498.6250608716794,131330.47337878417,615,1,141.2051282051282,36,3,18,36.09000920810312,0.6186342592592593,45.21396396396396,1019.1441441441442,28.30955955955956,0
3003,4,0,0,39,0.0,0.0,1.0,39,1350,800,550,0.5925925925925926,19,8,11,358.43989153950446,0.441436122357175,0.15276432572655274,0.2025789499374953,129946.6421658145,1515.6120647674766,131462.25423058198,616,2,142.2051282051282,36,3,18,35.96476695383257,0.6197916666666667,45.101351351351354,1019.5945945945949,28.322072072072082,0
3004,4,1,1,39,0.025,0.025,0.975,40,1150,900,250,0.782608695652174,14,9,5,352.9567849927106,0.44264155982905984,0.15313339061325348,0.2012480480751454,130290.57167830468,1197.3882588873328,131487.959937192,617,0,139.625,37,3,19,35.755535567250206,0.6213400900900901,44.764254385964904,1020.9429824561389,27.593053579895646,0
3005,4,1,0,40,0.025,0.0,1.0,40,1350,900,450,0.6666666666666666,18,9,9,381.35658659046635,0.4420138888888889,0.23715359323626073,0.20764914906677853,128476.21882086188,1811.39499702815,130287.61381789003,618,0,140.275,34,6,16,36.88204556129638,0.6090686274509804,46.54761904761906,1013.8095238095254,29.817927170868394,7
3006,4,0,0,40,0.0,0.0,1.0,40,1450,1200,250,0.8275862068965517,17,12,5,383.6433867242275,0.4418135683760684,0.237325390304026,0.20936950746340163,128566.75347222241,1864.7569444444662,130431.51041666688,619,1,141.275,34,6,17,36.731374965762804,0.6099877450980392,46.45833333333334,1014.1666666666682,29.828431372549066,0
3007,4,2,0,42,0.047619047619047616,0.0,1.0,42,1400,1000,400,0.7142857142857143,18,10,8,371.7669338997713,0.44386372435152927,0.24861066983272262,0.20663662435300895,129292.1786422902,1216.4363662131418,130508.61500850333,620,0,135.5,34,8,19,36.29165203480432,0.6173406862745099,45.74404761904761,1017.0238095238091,29.912464985994383,0
3008,4,1,1,42,0.023255813953488372,0.023255813953488372,0.9767441860465116,43,1200,900,300,0.75,15,9,6,359.525093990072,0.4442368032484312,0.24264041470490327,0.20207789765648868,129731.44531250001,728.3420138888893,130459.7873263889,621,0,133.32558139534885,37,6,15,36.155845262440344,0.6157094594594594,45.3125,1018.7500000000001,27.533783783783786,0
3009,4,0,0,42,0.0,0.0,1.0,42,1500,1100,400,0.7333333333333333,19,11,8,365.40308452180756,0.4413472706155633,0.24683171234895385,0.20560740726077828,129774.47041636227,1083.9983564645656,130858.46877282683,622,1,137.47619047619048,36,6,15,35.9623673740053,0.6180555555555556,45.27027027027027,1018.9189189189185,28.30330330330329,0
3010,4,0,0,42,0.0,0.0,1.0,42,1250,700,550,0.56,18,7,11,363.79832699440493,0.4411657955865273,0.24891248888818773,0.2054564101235402,129917.93894823888,1052.7857671861163,130970.72471542499,623,2,138.47619047619048,36,6,17,35.85735851835488,0.6195023148148149,45.12950450450451,1019.4819819819827,28.318943943943964,0
3011,4,0,2,40,0.0,0.047619047619047616,0.9523809523809523,42,1750,1300,450,0.7428571428571429,22,13,9,400.3904933595217,0.44140776229190865,0.2389751091888228,0.21513804978121664,127945.07345183012,1869.0464958201358,129814.11994765025,624,3,139.47619047619048,36,6,16,36.94507828732563,0.599537037037037,47.07207207207207,1011.711711711711,28.103103103103084,8
3012,4,1,1,40,0.024390243902439025,0.024390243902439025,0.975609756097561,41,1250,900,350,0.72,16,9,7,398.14391437619634,0.4429623983739837,0.23747867108300724,0.2149977137631457,128144.53124999977,2004.3037547682527,130148.83500476801,625,0,141.17073170731706,34,7,17,36.796982167352525,0.6056985294117647,46.874999999999986,1012.4999999999982,29.779411764705827,0
3013,4,1,0,41,0.024390243902439025,0.0,1.0,41,1750,1300,450,0.7428571428571429,22,13,9,399.5546772096346,0.44087906504065044,0.2483643747023283,0.21718810107540448,128408.33875868039,2061.2304687499754,130469.56922743036,626,0,141.8780487804878,35,6,15,36.490450496745446,0.60625,46.61458333333332,1013.5416666666653,28.958333333333293,0
3014,4,2,1,42,0.046511627906976744,0.023255813953488372,0.9767441860465116,43,1500,1100,400,0.7333333333333333,19,11,8,388.7243105422908,0.4444444444444444,0.25570144113647286,0.21438461395801006,128984.243735846,1427.8622434070821,130412.10597925309,627,0,136.2325581395349,38,5,17,36.17523839573691,0.606359649122807,46.04700854700853,1015.8119658119634,26.73189383715693,0
3015,4,1,1,42,0.023255813953488372,0.023255813953488372,0.9767441860465116,43,1350,1100,250,0.8148148148148148,16,11,5,393.9804512347208,0.44469822812846066,0.2640532399710529,0.2178803518688754,129092.79348381881,1572.0074055810867,130664.80088939989,628,0,137.1627906976744,38,5,18,35.9307103308102,0.6074561403508771,45.94017094017092,1016.2393162393137,26.74313990103457,0
3016,4,0,0,42,0.0,0.0,1.0,42,1050,800,250,0.7619047619047619,13,8,5,394.7037279383685,0.4442871660859466,0.258185931509455,0.21858039974421617,129147.08547921662,1794.9672182043678,130942.052697421,629,1,138.95238095238096,38,4,19,35.85680751173709,0.6080043859649122,45.88675213675212,1016.4529914529893,26.748762932973403,0
3017,4,0,0,42,0.0,0.0,1.0,42,1300,900,400,0.6923076923076923,17,9,8,386.6378655421908,0.4439363143631436,0.24226982862777602,0.21520963902788554,129348.51794249384,1602.2412204890077,130950.75916298285,630,2,139.95238095238096,35,7,19,35.85601793909052,0.6157738095238094,45.6886574074074,1017.2453703703691,29.0641534391534,0
3018,4,0,1,41,0.0,0.023809523809523808,0.9761904761904762,42,1400,1200,200,0.8571428571428571,16,12,4,382.46821501066324,0.4441298877274487,0.2350917960634653,0.2137539096895835,129508.1314082216,1506.5487698137729,131014.68017803537,631,3,140.95238095238096,37,5,16,35.79919835541672,0.6134572072072072,45.53179824561403,1017.8728070175425,27.510075865338987,0
3019,4,0,0,41,0.0,0.0,1.0,41,1000,700,300,0.7,13,7,6,384.1182202529536,0.4432926829268293,0.23006195389831618,0.2152870194018817,129619.76431450053,1757.862635618644,131377.6269501192,632,4,142.34146341463415,37,4,16,35.64335002333011,0.6145833333333333,45.422149122807014,1018.3114035087713,27.521929824561386,0
3020,4,0,0,41,0.0,0.0,1.0,41,1050,800,250,0.7619047619047619,13,8,5,383.6133171072389,0.4431910569105691,0.22504863085440707,0.215617140305103,129731.44531249985,1753.3420138888755,131484.78732638873,633,5,143.34146341463415,37,4,16,35.542348329925005,0.6157094594594594,45.31249999999999,1018.7499999999989,27.533783783783754,0
3021,4,1,2,40,0.023809523809523808,0.047619047619047616,0.9523809523809523,42,950,700,250,0.7368421052631579,12,7,5,374.77636372527246,0.4456542779713511,0.22291470269892777,0.2123436168833934,130044.5513391227,1347.5248146321896,131392.0761537549,634,0,140.9047619047619,38,4,17,35.44874480639643,0.6170504385964912,45.00534188034188,1019.9786324786329,26.841542959964023,0
3022,4,1,1,40,0.024390243902439025,0.024390243902439025,0.975609756097561,41,1500,1000,500,0.6666666666666666,20,10,10,383.2184195458635,0.4431910569105691,0.2318396875532429,0.2175623791259464,130122.70752779713,1773.0836651662194,131895.79119296334,635,0,145.0,37,4,20,35.15392710012539,0.6196509009009009,44.928728070175445,1020.2850877192992,27.575272641062142,0
3023,4,0,2,38,0.0,0.05,0.95,40,1050,800,250,0.7619047619047619,13,8,5,389.4520131288884,0.4432024572649573,0.2139342501074344,0.22157819915670524,130206.62607725472,2141.8465297014677,132348.4726069562,636,1,144.5,37,3,20,34.90948646325742,0.6204954954954955,44.846491228070185,1020.6140350877208,27.58416311047894,0
3024,4,0,0,38,0.0,0.0,1.0,38,1300,900,400,0.6923076923076923,17,9,8,388.3381924198249,0.44117472735893787,0.21364124597207268,0.22126245847176093,130262.58680555565,2517.1875000000095,132779.77430555565,637,2,150.55263157894737,36,2,20,34.88095238095238,0.622974537037037,44.79166666666667,1020.8333333333342,28.356481481481506,0
3025,4,1,0,39,0.02564102564102564,0.0,1.0,39,1150,900,250,0.782608695652174,14,9,5,415.5418905833403,0.44317926225820964,0.25221258787867185,0.22138257046923357,127601.7833001734,2900.263365983058,130502.04666615646,638,0,147.66666666666666,32,7,19,36.915510705656914,0.6048177083333333,47.41161616161616,1010.3535353535349,31.573547979797965,8
3026,4,0,1,38,0.0,0.02564102564102564,0.9743589743589743,39,1350,1000,350,0.7407407407407407,17,10,7,417.38254224256644,0.44222334682861003,0.24893602713010754,0.22324529163234688,127761.29548324167,2865.066861799839,130626.36234504152,639,1,148.66666666666666,32,7,19,36.70460222305484,0.6064453125,47.25378787878789,1010.9848484848497,31.593276515151555,0
3027,4,2,0,40,0.05,0.0,1.0,40,1100,800,300,0.7272727272727273,14,8,6,413.0592455229067,0.44185363247863246,0.2598699334543255,0.2235713598066027,128237.60880730968,2593.9459883217964,130831.55479563147,640,0,145.775,33,7,22,36.32372958257712,0.6089015151515151,46.783088235294116,1012.8676470588234,30.692959001782526,0
3028,4,1,1,40,0.024390243902439025,0.024390243902439025,0.975609756097561,41,1050,700,350,0.6666666666666666,14,7,7,400.4133681009363,0.44273373983739833,0.2531307157925471,0.21885325911405248,128627.1276218821,2100.804280045356,130727.93190192746,641,0,143.1951219512195,34,7,21,36.244278840511676,0.6106004901960784,46.398809523809526,1014.404761904762,29.835434173669473,0
3029,4,0,0,40,0.0,0.0,1.0,40,850,400,450,0.47058823529411764,13,4,9,406.5033794467239,0.44305555555555554,0.25087268993839906,0.22243499527028585,128672.41753472216,2461.154513888885,131133.57204861104,642,1,145.75,33,7,22,36.04337782340863,0.6133207070707071,46.354166666666664,1014.5833333333328,30.74494949494948,0
3030,4,0,1,39,0.0,0.025,0.975,40,1200,600,600,0.5,18,6,12,406.6827697262482,0.44274839743589745,0.25419082125603865,0.22270723104056434,128703.50346020756,2468.2994521337896,131171.80291234134,643,2,146.75,33,7,22,36.006944444444436,0.6136363636363636,46.3235294117647,1014.7058823529408,30.748663101604265,0
3031,4,1,0,40,0.025,0.0,1.0,40,1000,700,300,0.7,13,7,6,401.10185434023145,0.4416132478632479,0.24959016393442668,0.2224292101341281,129201.38888888879,2367.4668396770367,131568.85572856583,644,0,142.65,31,9,23,35.6386612021858,0.6236559139784946,45.83333333333333,1016.6666666666658,32.795698924731155,0
3032,4,2,0,42,0.047619047619047616,0.0,1.0,42,1600,1100,500,0.6875,21,11,10,388.0658228322188,0.4442750677506775,0.2513887963024688,0.22059020114839378,130171.45691609965,1703.0187074829769,131874.47562358264,645,0,136.8095238095238,34,8,20,34.98065406750661,0.6262254901960784,44.88095238095237,1020.4761904761895,30.014005602240868,0
3033,4,0,0,42,0.0,0.0,1.0,42,1100,700,400,0.6363636363636364,15,7,8,388.4998120110192,0.4441782810685249,0.24809062782934288,0.22100921621569103,130201.83000283432,1716.6772959183504,131918.50729875267,646,1,137.8095238095238,34,8,20,34.93866402270694,0.626531862745098,44.85119047619047,1020.5952380952369,30.017507002801086,0
3034,4,1,0,43,0.023255813953488372,0.0,1.0,43,1100,700,400,0.6363636363636364,15,7,8,380.8023773146091,0.4457364341085271,0.24812707193103267,0.2189023176554894,130606.84479827459,1347.10774321982,131953.9525414944,647,0,135.58139534883722,33,10,16,34.72342944491067,0.6328914141414141,44.45465686274509,1022.1813725490186,30.97519310754602,0
3035,4,1,0,44,0.022727272727272728,0.0,1.0,44,1050,500,550,0.47619047619047616,16,5,11,383.34471600004446,0.44687059548978153,0.2964933336022746,0.21044270828406855,128800.9863748886,1169.9546801942724,129970.94105508288,648,0,133.47727272727272,36,8,18,36.49924191997631,0.6082175925925926,46.227477477477485,1015.0900900900917,28.196946946946994,8
3036,4,2,1,45,0.043478260869565216,0.021739130434782608,0.9782608695652174,46,1700,1400,300,0.8235294117647058,20,14,6,366.37638217048925,0.4487218196457327,0.29518358146983803,0.20500296803890733,129554.6392746914,295.0162014492037,129849.65547614062,649,0,128.6304347826087,35,11,17,36.16132332878581,0.6178571428571429,45.486111111111114,1018.055555555556,29.0873015873016,0
3037,4,0,0,45,0.0,0.0,1.0,45,950,600,350,0.631578947368421,13,6,7,374.88859618698484,0.4474537037037037,0.3014368376568488,0.20869205566239665,129352.72285997748,698.5721371882254,130051.2949971657,650,1,132.48888888888888,34,11,19,36.15052662375658,0.617953431372549,45.68452380952382,1017.2619047619061,29.919467787114883,0
3038,4,0,0,45,0.0,0.0,1.0,45,1350,1100,250,0.8148148148148148,16,11,5,374.59385645817434,0.44703282828282825,0.29325953643072444,0.2096548861538162,129564.73922902516,706.8310657596627,130271.57029478482,651,2,133.48888888888888,34,11,17,35.941884939195525,0.6200980392156863,45.47619047619049,1018.0952380952398,29.943977591036465,0
3039,4,0,0,45,0.0,0.0,1.0,45,1300,700,600,0.5384615384615384,19,7,12,372.83471074380117,0.44667508417508417,0.29088888888888853,0.2092439703153991,129672.49657064505,669.2815500686224,130341.77812071367,652,3,134.48888888888888,35,10,17,35.87689393939392,0.6190476190476191,45.37037037037039,1018.5185185185211,29.100529100529172,0
3040,4,1,0,46,0.021739130434782608,0.0,1.0,46,1500,700,800,0.4666666666666667,23,7,16,367.88696177422327,0.44669887278582926,0.2895154959063886,0.20870855441142563,130094.74068944326,372.03177900896833,130466.77246845223,653,0,132.54347826086956,37,9,19,35.57340928632848,0.6193693693693694,44.95614035087721,1020.1754385964941,27.572309151256597,0
3041,4,0,4,42,0.0,0.08695652173913043,0.9130434782608696,46,1300,800,500,0.6153846153846154,18,8,10,369.2891593690491,0.4461755233494364,0.28387036361664997,0.21072891099312754,130321.66950660152,425.4923686751688,130747.1618752767,654,1,133.54347826086956,35,11,20,35.30709211818938,0.6255952380952381,44.7337962962963,1021.064814814815,29.173280423280428,0
3042,4,0,1,41,0.0,0.023809523809523808,0.9761904761904762,42,1050,900,150,0.8571428571428571,12,9,3,393.65144382950575,0.44321041424699964,0.2949096485506002,0.22285491942511193,130012.50270328713,1835.9218810072941,131848.42458429444,655,2,143.28571428571428,33,9,20,35.00010013618522,0.6268939393939394,45.03676470588235,1019.85294117647,30.904634581105153,0
3043,4,0,0,41,0.0,0.0,1.0,41,1150,800,350,0.6956521739130435,15,8,7,398.5876069119241,0.44131097560975613,0.3025634366780714,0.22560561324650397,130004.92814827572,2163.6706394755734,132168.59878775128,656,3,146.8780487804878,32,9,20,34.88196937806943,0.6292317708333333,45.044191919191924,1019.8232323232326,31.869476010101017,0
3044,4,3,2,42,0.06818181818181818,0.045454545454545456,0.9545454545454546,44,1400,700,700,0.5,21,7,14,373.3078033855611,0.4440296863988724,0.28400497117774637,0.21606603165649116,130870.93431122434,971.2832789604797,131842.21759018482,657,0,137.79545454545453,34,10,17,34.64708163661044,0.6332720588235294,44.19642857142856,1023.2142857142844,30.094537815126014,0
3045,4,0,0,42,0.0,0.0,1.0,42,1450,1100,350,0.7586206896551724,18,11,7,387.54914848937057,0.44146825396825395,0.2963162731231772,0.22314165257742,130669.48596993931,1728.169604238734,132397.65557417806,658,1,145.35714285714286,33,9,17,34.48736965120459,0.6335227272727273,44.39338235294117,1022.4264705882342,30.98262032085558,0
3046,4,1,0,43,0.023255813953488372,0.0,1.0,43,1200,900,300,0.75,15,9,6,383.0245818586701,0.4412375415282392,0.3063033362337795,0.22363022737284352,131206.12953514734,1451.0345804988551,132657.16411564618,659,0,142.95348837209303,34,9,18,34.05860252536989,0.6366421568627452,43.86904761904761,1024.523809523809,30.1330532212885,0
3047,4,2,0,45,0.044444444444444446,0.0,1.0,45,1200,900,300,0.75,15,9,6,365.01435776194853,0.4438552188552189,0.29826026443980536,0.21585416959009057,131694.45153061222,614.1865079365009,132308.63803854873,660,0,137.55555555555554,34,11,19,34.02632799814428,0.6415441176470589,43.39285714285714,1026.428571428571,30.18907563025209,0
3048,4,0,0,45,0.0,0.0,1.0,45,1250,700,550,0.56,18,7,11,364.66594501972577,0.44356060606060604,0.29151887485027617,0.2165156990836321,131847.23816609982,616.0395408163299,132463.27770691615,661,1,138.55555555555554,34,11,19,33.881032417603656,0.6430759803921569,43.24404761904762,1027.0238095238099,30.20658263305323,0
3049,4,0,1,44,0.0,0.022222222222222223,0.9777777777777777,45,1050,800,250,0.7619047619047619,13,8,5,365.5546549933168,0.44347643097643097,0.29283984958532994,0.21721801400016094,131877.80612244896,641.7091836734728,132519.51530612243,662,2,139.55555555555554,34,11,19,33.82736439499305,0.6433823529411764,43.214285714285715,1027.142857142857,30.210084033613445,0
3050,4,0,1,43,0.0,0.022727272727272728,0.9772727272727273,44,1200,900,300,0.75,15,9,6,369.57511016669815,0.44191552149400987,0.29488534721092896,0.22024785350019635,131988.41979346878,955.9269571799215,132944.3467506487,663,3,142.77272727272728,33,11,19,33.61247763864042,0.646780303030303,43.10661764705882,1027.5735294117642,31.13859180035649,0
3051,4,1,0,44,0.022727272727272728,0.0,1.0,44,1100,800,300,0.7272727272727273,14,8,6,369.8759820232827,0.44308271670190275,0.2943009867530302,0.22189915061625526,132240.39619677523,982.5092812860405,133222.90547806126,664,0,142.9090909090909,33,11,20,33.35058481274078,0.6493055555555556,42.861519607843135,1028.5539215686272,31.168300653594763,0
3052,4,0,1,43,0.0,0.022727272727272728,0.9772727272727273,44,1150,500,650,0.43478260869565216,18,5,13,388.91712452831564,0.44219080338266387,0.28396559329510374,0.2220844134271259,130348.82010388748,1338.9776600925052,131687.79776398,665,1,143.9090909090909,36,8,18,34.778433318629624,0.6238425925925926,44.7072072072072,1021.1711711711697,28.365865865865825,8
3053,4,0,0,43,0.0,0.0,1.0,43,1250,1000,250,0.8,15,10,5,395.38441670662075,0.4416989664082687,0.28697721863311765,0.22579137272508185,130351.2158805941,1707.7678915894985,132058.9837721836,666,2,147.62790697674419,35,8,18,34.61088915334919,0.6258928571428571,44.70486111111111,1021.1805555555553,29.176587301587293,0
3054,4,0,1,42,0.0,0.023255813953488372,0.9767441860465116,43,1100,700,400,0.6363636363636364,15,7,8,380.9974900831269,0.44174510889627167,0.26612244002260343,0.2016290087968007,127332.20663265295,1113.5913436555074,128445.79797630846,667,3,148.62790697674419,34,9,14,38.06518833058113,0.5974264705882353,47.67857142857142,1009.2857142857133,29.684873949579803,8
3055,4,2,2,42,0.045454545454545456,0.045454545454545456,0.9545454545454546,44,1100,700,400,0.6363636363636364,15,7,8,364.1502059513766,0.44296159267089497,0.273253577862796,0.1953881212577817,127888.11404309717,514.0966135053986,128402.21065660258,668,0,145.70454545454547,36,8,17,37.92005306910116,0.5989583333333333,47.12837837837838,1011.4864864864867,28.09684684684685,0
3056,4,2,1,43,0.045454545454545456,0.022727272727272728,0.9772727272727273,44,1450,1000,450,0.6896551724137931,19,10,9,359.04561888344494,0.4475753171247357,0.27300267825559654,0.19443800974452655,128258.57688347127,410.1360228471641,128668.71290631843,669,0,145.25,36,8,20,37.67000185288123,0.6027199074074074,46.762387387387385,1012.95045045045,28.1375125125125,0
3057,4,0,1,42,0.0,0.023255813953488372,0.9767441860465116,43,1450,1200,250,0.8275862068965517,17,12,5,361.2698765432098,0.4480435585086748,0.2563410852713177,0.19634232420826625,128401.20525931347,677.4975144063112,129078.70277371978,670,1,145.62790697674419,36,7,13,37.46782407407407,0.6041666666666667,46.62162162162163,1013.5135135135143,28.153153153153177,0
3058,4,3,5,40,0.06666666666666667,0.1111111111111111,0.8888888888888888,45,1300,1000,300,0.7692307692307693,16,10,6,348.01161647303593,0.45,0.2755181876569164,0.19285559293773646,129174.23575726854,-9.173081488792832,129165.06267577974,671,0,139.86666666666667,38,7,16,37.01567700122613,0.6082785087719298,45.86004273504273,1016.5598290598285,26.751574448942858,0
3059,4,1,0,41,0.024390243902439025,0.0,1.0,41,1450,1000,450,0.6896551724137931,19,10,9,376.9259313633363,0.44225101626016255,0.29261993253884166,0.20554770059877722,128536.57171201818,1489.7534013605496,130026.32511337873,672,0,153.70731707317074,34,7,17,36.9325741566878,0.6096813725490196,46.48809523809524,1014.0476190476194,29.824929971988805,0
3060,4,1,0,42,0.023809523809523808,0.0,1.0,42,1750,1300,450,0.7428571428571429,22,13,9,371.81847680198223,0.44294425087108014,0.28674902333438945,0.2050001626377678,128972.51136271418,1190.8725448421546,130163.38390755634,673,0,151.02380952380952,36,6,18,36.61654656319292,0.6099537037037037,46.058558558558566,1015.7657657657667,28.215715715715742,0
3061,4,1,0,43,0.023255813953488372,0.0,1.0,43,1150,800,350,0.6956521739130435,15,8,7,362.9065299956022,0.44502122554448137,0.28065773698460506,0.201698904432091,129289.65627411274,784.4179157691073,130074.07418988185,674,0,148.48837209302326,35,8,19,36.5195032434278,0.6151785714285714,45.746527777777786,1017.0138888888896,29.0575396825397,0
3062,4,0,0,43,0.0,0.0,1.0,43,1350,1000,350,0.7407407407407407,17,10,7,365.26925182588013,0.44442137320044295,0.2868164140011109,0.20346747297525283,129377.95380015443,851.557677469148,130229.51147762357,675,1,149.48837209302326,35,8,19,36.369453924914666,0.6160714285714286,45.65972222222223,1017.361111111112,29.06746031746034,0
3063,4,0,0,43,0.0,0.0,1.0,43,1500,900,600,0.6,21,9,12,360.90047867938193,0.44395994832041347,0.2750673289381962,0.2020372277238575,129573.7476285409,752.645508684388,130326.3931372253,676,2,150.48837209302326,36,7,16,36.28124654352396,0.6160300925925926,45.467342342342356,1018.1306306306324,28.281406406406454,0
3064,4,0,1,42,0.0,0.023255813953488372,0.9767441860465116,43,900,600,300,0.6666666666666666,12,6,6,363.00772609192165,0.44398301956441494,0.2772488078887667,0.2033652948775193,129602.41280131502,809.3354334064012,130411.74823472142,677,3,151.48837209302326,36,7,16,36.19843508073435,0.6163194444444444,45.4391891891892,1018.2432432432447,28.284534534534576,0
3065,4,1,1,42,0.023255813953488372,0.023255813953488372,0.9767441860465116,43,1000,700,300,0.7,13,7,6,359.4542720700983,0.443936877076412,0.2835508346758542,0.2027053343617736,129860.54202428812,735.7853207938019,130596.32734508193,678,0,152.3953488372093,36,7,18,36.02640592199758,0.6189236111111112,45.18581081081083,1019.2567567567594,28.31268768768776,0
3066,4,0,0,42,0.0,0.0,1.0,42,1100,700,400,0.6363636363636364,15,7,8,368.0929799164028,0.44145615563298485,0.2868284978689346,0.2072052810219953,129790.40745027427,1154.987568587099,130945.39501886137,679,1,156.9047619047619,35,7,18,35.87763137967591,0.6202380952380953,45.254629629629626,1018.9814814814808,29.113756613756596,0
3067,4,0,1,41,0.0,0.023809523809523808,0.9761904761904762,42,1550,900,650,0.5806451612903226,22,9,13,368.43536386174276,0.4413230739450252,0.27853856064789206,0.20838115051643247,129975.34855379043,1177.5029674945379,131152.85152128496,680,2,157.9047619047619,36,6,19,35.680793300202446,0.6200810185185186,45.073198198198206,1019.7072072072085,28.325200200200236,0
3068,4,0,0,41,0.0,0.0,1.0,41,850,500,350,0.5882352941176471,12,5,7,379.31301717389385,0.439989837398374,0.286662217138806,0.21400446779311227,129878.87577428416,1652.9496474194136,131531.82542170357,681,3,162.5609756097561,35,6,19,35.501707921728936,0.6211309523809524,45.167824074074076,1019.3287037037039,29.123677248677254,0
3069,4,0,0,41,0.0,0.0,1.0,41,1100,900,200,0.8181818181818182,13,9,4,379.24403626131334,0.440015243902439,0.28603708380408066,0.21412701739677217,129908.37191358018,1653.395061728388,131561.76697530856,682,4,163.5609756097561,35,6,20,35.47343324250681,0.6214285714285714,45.138888888888886,1019.4444444444439,29.126984126984112,0
3070,4,0,0,41,0.0,0.0,1.0,41,1500,1100,400,0.7333333333333333,19,11,8,382.01866924021977,0.4398628048780488,0.2834314550042052,0.21700235747563015,130144.46159122093,1743.522805212628,131887.98439643355,683,5,164.5609756097561,35,6,20,35.16239413188141,0.6238095238095238,44.90740740740741,1020.370370370371,29.153439153439173,0
3071,4,2,3,40,0.046511627906976744,0.06976744186046512,0.9302325581395349,43,1350,900,450,0.6666666666666666,18,9,9,364.8948430373563,0.44183739387227755,0.2732897612416767,0.20976253896453986,130607.69120049107,931.6681796912094,131539.3593801823,684,0,157.86046511627907,36,7,16,35.12908082699866,0.6264467592592593,44.45382882882883,1022.184684684685,28.394019019019026,0
3072,4,0,0,40,0.0,0.0,1.0,40,1400,700,700,0.5,21,7,14,409.3210723297599,0.43814102564102564,0.2542181069958849,0.2210333790580704,128144.53125,2504.61990706923,130649.15115706922,685,7,169.625,32,8,20,36.51406035665294,0.6103515625,46.875,1012.5,31.640625,8
3073,4,0,0,40,0.0,0.0,1.0,40,1050,400,650,0.38095238095238093,17,4,13,405.8028326434781,0.4379941239316239,0.25574429622241635,0.21948378426387982,128208.4596756709,2405.4712210488838,130613.93089671979,686,8,170.625,32,8,20,36.537422599010945,0.6110026041666667,46.81186868686869,1012.7525252525257,31.64851641414143,0
3074,4,0,0,40,0.0,0.0,1.0,40,950,700,250,0.7368421052631579,12,7,5,405.72140152352154,0.4378205128205128,0.25157068062827226,0.21961518778823821,128240.42986685035,2405.97738751148,130646.40725436182,687,9,171.625,32,8,20,36.50663799551234,0.611328125,46.78030303030303,1012.8787878787881,31.652462121212128,0
3075,4,1,0,41,0.024390243902439025,0.0,1.0,41,1450,1000,450,0.6896551724137931,19,10,9,399.67832741912764,0.4397611788617886,0.26353239030278064,0.2197302549878878,128858.98940611765,2100.4290717512235,130959.41847786887,688,0,168.41463414634146,33,8,19,36.02532186682758,0.6152146464646464,46.17034313725489,1015.3186274509789,30.76723113487815,0
3076,4,1,0,42,0.023809523809523808,0.0,1.0,42,1400,1000,400,0.7142857142857143,18,10,8,387.63904719481553,0.44093592721641506,0.2656384964752434,0.21578994516480093,129352.7228599771,1628.4332482992925,130981.1561082764,689,0,165.38095238095238,34,8,21,35.82626292178661,0.617953431372549,45.684523809523796,1017.261904761903,29.919467787114794,0
3077,4,1,0,43,0.023255813953488372,0.0,1.0,43,1500,1000,500,0.6666666666666666,20,10,10,385.1060310126566,0.4412606127722407,0.2691335525533858,0.2169455280272832,129819.89354263103,1398.8847897376374,131218.77833236867,690,0,162.51162790697674,35,8,15,35.414182282793874,0.6205357142857143,45.225694444444436,1019.097222222221,29.11706349206346,0
3078,4,0,1,42,0.0,0.023255813953488372,0.9767441860465116,43,1550,1300,250,0.8387096774193549,18,13,5,380.15019130974184,0.4412375415282392,0.263283349001598,0.21484892834696626,129946.64216581438,1279.8481758785736,131226.49034169296,691,1,163.51162790697674,36,7,15,35.41137434651352,0.6197916666666667,45.10135135135135,1019.594594594594,28.322072072072057,0
3079,4,0,1,41,0.0,0.023809523809523808,0.9761904761904762,42,1250,1100,150,0.88,14,11,3,384.4207580643709,0.4388913085559427,0.2763039835684562,0.2173778484304945,129967.37423911168,1592.4313057270103,131559.8055448387,692,2,167.92857142857142,35,7,18,35.28140370790769,0.6220238095238095,45.08101851851851,1019.675925925925,29.133597883597854,0
3080,4,1,0,42,0.023809523809523808,0.0,1.0,42,650,500,150,0.7692307692307693,8,5,3,380.008329862557,0.43880662020905925,0.2790087463556852,0.21651637399145712,130262.58680555565,1500.508509087801,131763.09531464346,693,0,168.23809523809524,34,8,21,35.093537414965986,0.6271446078431373,44.79166666666667,1020.8333333333342,30.024509803921593,0
3081,4,0,0,42,0.0,0.0,1.0,42,1350,900,450,0.6666666666666666,18,9,9,361.6480910983117,0.4386251451800232,0.261992016229305,0.1930263527793674,127676.20991940987,839.1117969821369,128515.321716392,694,1,169.23809523809524,35,7,17,38.20048862421745,0.5988095238095238,47.33796296296295,1010.6481481481458,28.87566137566131,8
3082,4,3,2,43,0.06666666666666667,0.044444444444444446,0.9555555555555556,45,1250,900,350,0.72,16,9,7,338.3749296303247,0.4435185185185185,0.25077625570776263,0.1843385810672664,128496.3348765431,-304.0123456790251,128192.32253086407,695,0,158.88888888888889,38,7,17,37.95091324200913,0.6014254385964912,46.52777777777777,1013.888888888888,26.68128654970758,0
3083,4,2,2,43,0.044444444444444446,0.044444444444444446,0.9555555555555556,45,700,500,200,0.7142857142857143,9,5,4,337.936809412688,0.4437289562289562,0.26185364484669926,0.1856113042219282,128821.50472094366,-293.2943421725689,128528.2103787711,696,0,158.62222222222223,38,7,20,37.630674244018785,0.6047149122807017,46.20726495726495,1015.1709401709388,26.715024741340496,0
3084,4,0,0,43,0.0,0.0,1.0,43,1550,1400,150,0.9032258064516129,17,14,3,343.2613838880478,0.4424141749723145,0.2748095540185773,0.18898236629440895,128915.32368517178,250.33048250954988,129165.65416768134,697,1,164.7674418604651,36,7,20,37.39996858135579,0.609375,46.11486486486487,1015.5405405405415,28.209459459459488,0
3085,4,1,0,44,0.022727272727272728,0.0,1.0,44,1050,700,350,0.6666666666666666,14,7,7,333.8655787448116,0.4440296863988724,0.272523847337824,0.18527441721727328,129229.25954380186,-170.95969432903183,129058.29984947282,698,0,162.0,37,7,21,37.319255724504835,0.6106418918918919,45.805921052631575,1016.776315789473,27.48044096728305,0
3086,4,2,2,44,0.043478260869565216,0.043478260869565216,0.9565217391304348,46,1750,1300,450,0.7428571428571429,22,13,9,322.79228553278864,0.44655797101449274,0.25924074148145193,0.1818006292093995,129811.0473632811,-819.5990668402917,128991.44829644081,699,0,155.91304347826087,39,7,17,37.01073716310608,0.6129807692307692,45.23437499999999,1019.0624999999989,26.12980769230766,0
3087,4,0,1,43,0.0,0.022727272727272728,0.9772727272727273,44,2000,1600,400,0.8,24,16,8,336.56995878959765,0.4444481148696265,0.2704244447272339,0.18863761057809247,129619.76431450053,-74.77625327024617,129544.98806123028,700,2,164.0,37,7,17,36.853823444958905,0.6145833333333333,45.422149122807014,1018.3114035087713,27.521929824561386,0
3088,4,1,0,44,0.022727272727272728,0.0,1.0,44,1200,900,300,0.75,15,9,6,336.5010542897744,0.44350114517265676,0.2708469851826494,0.18967721647201055,129843.17440221997,-61.526984264381724,129781.6474179556,701,0,164.86363636363637,37,7,21,36.62889994620764,0.6168355855855856,45.202850877192986,1019.1885964912285,27.545637743006175,0
3089,4,0,1,43,0.0,0.022727272727272728,0.9772727272727273,44,1100,500,600,0.45454545454545453,17,5,12,334.78737426292076,0.44326990838618746,0.2690909090909095,0.1893870182874187,129982.9033933518,-96.67301477377424,129886.23037857802,702,1,165.86363636363637,37,7,21,36.53091397849464,0.6182432432432432,45.06578947368421,1019.7368421052631,27.560455192034137,0
3090,4,1,0,44,0.022727272727272728,0.0,1.0,44,950,600,350,0.631578947368421,13,6,7,339.44580027402804,0.4448885658914729,0.2848984575438165,0.19384662108852735,130351.21588059407,50.03570476278202,130401.25158535685,703,0,164.54545454545453,35,9,22,36.0389748384903,0.6258928571428571,44.70486111111111,1021.1805555555551,29.17658730158729,0
3091,4,0,0,44,0.0,0.0,1.0,44,1200,800,400,0.6666666666666666,16,8,8,344.74617443621764,0.44495463354474984,0.2926644702975394,0.19792644475109233,130558.13426997588,201.88346622083918,130760.01773619672,704,1,165.54545454545453,35,9,19,35.69412986032465,0.6279761904761905,44.50231481481481,1021.9907407407399,29.199735449735424,0
3092,4,0,0,44,0.0,0.0,1.0,44,1400,1000,400,0.7142857142857143,18,10,8,347.24101452492073,0.44483350951374206,0.2934943664145704,0.20012226766651495,130706.0335889274,277.29914158949845,130983.3327305169,705,2,166.54545454545453,35,9,19,35.48068760611205,0.6294642857142857,44.357638888888886,1022.5694444444439,29.216269841269824,0
3093,4,0,0,44,0.0,0.0,1.0,44,1200,900,300,0.75,15,9,6,347.2042984479263,0.4445912614517266,0.29234333377901667,0.20071542145070095,130824.41332572428,284.55972972391584,131108.9730554482,706,3,167.54545454545453,35,9,20,35.36186691556361,0.6306547619047619,44.24189814814814,1023.032407407406,29.229497354497315,0
3094,4,0,0,44,0.0,0.0,1.0,44,1600,1000,600,0.625,22,10,12,347.4425450495663,0.4439856412966878,0.29357497775511576,0.20213020231194537,131068.54056336735,307.75746185373174,131376.29802522107,707,4,168.54545454545453,36,8,21,35.10896660434764,0.6310763888888888,44.00337837837837,1023.986486486486,28.444069069069055,0
3095,4,0,1,43,0.0,0.022727272727272728,0.9772727272727273,44,1650,1100,550,0.6666666666666666,22,11,11,351.8439187497566,0.4440627202255109,0.18492190628754512,0.1930888494765146,128788.44024720724,262.68590124924594,129051.12614845649,708,5,169.54545454545453,40,4,14,37.311440395140835,0.6010416666666667,46.23983739837398,1015.0406504065032,25.37601626016258,8
3096,4,1,0,44,0.022727272727272728,0.0,1.0,44,1650,1100,550,0.6666666666666666,22,11,11,350.5472048600559,0.4455932875264271,0.18470512284275054,0.1936337543751845,129046.45568940452,247.37486780356835,129293.83055720809,709,0,170.22727272727272,40,4,15,37.081374608255,0.6036458333333333,45.98577235772358,1016.0569105691063,25.401422764227657,0
3097,4,0,1,43,0.0,0.022727272727272728,0.9772727272727273,44,1300,1000,300,0.7692307692307693,16,10,6,350.12755405360156,0.4457144115574348,0.18238397841541443,0.193543256134433,129075.34490937587,238.56696034895992,129313.91186972483,710,1,171.22727272727272,41,3,15,37.06260779719482,0.6023882113821138,45.95734126984127,1016.1706349206355,24.784649632210623,0
3098,4,1,0,44,0.022727272727272728,0.0,1.0,44,850,400,450,0.47058823529411764,13,4,9,342.63948424745536,0.44679351656095845,0.17812938715869686,0.19040194107130937,129282.86540516112,59.66740051132888,129342.53280567245,711,0,169.63636363636363,38,6,16,37.04170606156111,0.609375,45.75320512820513,1016.9871794871799,26.762820512820525,0
3099,4,0,0,44,0.0,0.0,1.0,44,1400,1100,300,0.7857142857142857,17,11,6,340.212883937371,0.4467714940098661,0.17394820462417826,0.19010018447339194,129500.26167223687,11.531498831179618,129511.79317106804,712,1,170.63636363636363,38,6,12,36.88245687694623,0.6115679824561404,45.539529914529915,1017.8418803418806,26.785312640575807,0
3100,4,0,1,43,0.0,0.022727272727272728,0.9772727272727273,44,1800,1300,500,0.7222222222222222,23,13,10,342.3479433369218,0.4466173361522199,0.17215217640102276,0.1919565056404433,129636.22708013727,76.13914456862602,129712.3662247059,713,2,171.63636363636363,38,6,12,36.69000909218073,0.6129385964912281,45.4059829059829,1018.3760683760678,26.799370220422837,0
3101,4,0,1,42,0.0,0.023255813953488372,0.9767441860465116,43,1150,800,350,0.6956521739130435,15,8,7,349.2916278081368,0.4454595791805094,0.17415261475389876,0.19557868466577796,129581.83235627135,452.3698316166143,130034.20218788796,714,5,176.58139534883722,38,5,12,36.56851171738371,0.612390350877193,45.4594017094017,1018.1623931623923,26.79374718848401,0
3102,4,0,1,41,0.0,0.023809523809523808,0.9761904761904762,42,1250,1000,250,0.8,15,10,5,350.9154995545739,0.44582365466511803,0.16806531696912508,0.19689684857291037,129663.42872242289,700.1813728175664,130363.61009524045,715,6,180.33333333333334,38,4,12,36.44423756075386,0.6132127192982456,45.37927350427349,1018.4829059829042,26.802181736392214,0
3103,4,1,2,40,0.023809523809523808,0.047619047619047616,0.9523809523809523,42,1000,900,100,0.9,11,9,2,355.26988139741286,0.4465737514518002,0.17459911915711634,0.200364022448051,129864.12896050343,827.362738715273,130691.49169921869,716,0,164.73809523809524,39,3,13,36.129385964912274,0.6135149572649572,45.182291666666664,1019.2708333333329,26.135149572649564,0
3104,4,0,0,40,0.0,0.0,1.0,40,1150,800,350,0.6956521739130435,15,8,7,372.0637314312579,0.44274839743589745,0.18513244320017286,0.20853083124937166,129619.7643145004,1645.362635618629,131265.12695011904,717,1,173.225,37,3,14,35.95023060909515,0.6145833333333333,45.42214912280701,1018.3114035087702,27.521929824561358,0
3105,4,1,0,41,0.024390243902439025,0.0,1.0,41,1550,1400,150,0.9032258064516129,17,14,3,365.61472619701954,0.4425558943089431,0.18785470620552158,0.20686381514822466,129990.07100819996,1305.2568439988265,131295.3278521988,718,0,169.97560975609755,38,3,16,35.73773354286712,0.6165021929824561,45.05876068376068,1019.7649572649568,26.83591992802518,0
3106,4,0,3,38,0.0,0.07317073170731707,0.926829268292683,41,1000,400,600,0.4,16,4,12,362.2917120255325,0.4422002032520325,0.18628109430502748,0.20584462472075293,130153.54624379048,1230.7102189714194,131384.2564627619,719,1,170.97560975609755,38,3,18,35.65638851080166,0.6181469298245614,44.898504273504265,1020.4059829059817,26.852789023841623,0
3107,4,0,0,38,0.0,0.0,1.0,38,950,500,450,0.5263157894736842,14,5,9,371.02850959905754,0.4388039355144618,0.17965458528733214,0.21015667363593904,130032.77084094236,2049.173032830133,132081.94387377248,720,2,177.23684210526315,36,2,18,35.55629163446321,0.6206597222222222,45.016891891891895,1019.9324324324331,28.331456456456475,0
3108,4,0,0,38,0.0,0.0,1.0,38,1500,1000,500,0.6666666666666666,20,10,10,371.46312307731876,0.4377667140825035,0.17655153992660377,0.21149131580231245,130233.8487135783,2075.4144347049605,132309.26314828327,721,3,178.23684210526315,36,2,18,35.340817152103554,0.6226851851851851,44.81981981981981,1020.7207207207197,28.353353353353324,0
3109,4,0,0,38,0.0,0.0,1.0,38,1150,800,350,0.6956521739130435,15,8,7,370.4864582959095,0.437485182550972,0.17301780158686375,0.2114213142251503,130323.35778061193,2056.614192274147,132379.97197288607,722,4,179.23684210526315,34,4,18,35.274814426178544,0.6277573529411764,44.73214285714284,1021.0714285714259,30.03151260504194,0
3110,4,0,0,38,0.0,0.0,1.0,38,1150,900,250,0.782608695652174,14,9,5,366.45206148858824,0.4369517543859649,0.1680862668190708,0.2097215551900934,130435.08193582078,1959.6409331628713,132394.72286898366,723,5,180.23684210526315,36,2,18,35.26439569323483,0.6247106481481481,44.62274774774774,1021.5090090090075,28.375250250250208,0
3111,4,0,1,37,0.0,0.02631578947368421,0.9736842105263158,38,1050,600,450,0.5714285714285714,15,6,9,362.33308535397197,0.4355589141773352,0.17014529052306893,0.2084448510040149,130636.47050766976,1866.7830837594238,132503.25359142918,724,6,181.23684210526315,36,2,14,35.16537232870677,0.6267361111111112,44.42567567567567,1022.2972972972967,28.39714714714713,0
3112,4,0,0,37,0.0,0.0,1.0,37,1150,800,350,0.6956521739130435,15,8,7,375.0444900372004,0.4348098098098098,0.17887233853715623,0.21548587452950635,130587.70743580656,2395.240028077825,132982.9474638844,725,7,186.51351351351352,35,2,14,34.88999452685616,0.6282738095238095,44.47337962962962,1022.1064814814799,29.203042328042283,0
3113,4,0,0,37,0.0,0.0,1.0,37,1200,700,500,0.5833333333333334,17,7,10,372.46905915251506,0.4340903403403404,0.1750117788152652,0.21449750120947297,130676.44702717745,2334.586655521238,133011.03368269867,726,8,187.51351351351352,35,2,14,34.86576484793599,0.6291666666666667,44.38657407407406,1022.4537037037022,29.21296296296292,0
3114,4,1,1,37,0.02631578947368421,0.02631578947368421,0.9736842105263158,38,950,700,250,0.7368421052631579,12,7,5,362.4181226013064,0.43542555713608344,0.17796953609411315,0.21052671901395986,131010.89000740589,1896.1441593620466,132907.03416676793,727,0,183.55263157894737,36,2,15,34.7839438272284,0.6304976851851851,44.059684684684676,1023.76126126126,28.437812812812776,0
3115,4,0,1,36,0.0,0.02702702702702703,0.972972972972973,37,750,700,50,0.9333333333333333,8,7,1,362.74941397544575,0.4341841841841842,0.160217857280887,0.2107191643738513,131010.89000740589,2104.824714917602,133115.7147223235,728,1,183.24324324324326,36,1,15,34.77546474535255,0.6304976851851851,44.059684684684676,1023.76126126126,28.437812812812776,0
3116,4,0,1,35,0.0,0.027777777777777776,0.9722222222222222,36,1350,800,550,0.5925925925925926,19,8,11,371.87586194743625,0.4333829365079365,0.16878698782464507,0.21563922932466711,130942.84664619753,2538.896792481119,133481.74343867865,729,2,187.75,35,1,15,34.61082683101511,0.6318452380952381,44.1261574074074,1023.495370370369,29.242724867724828,0
3117,4,0,0,35,0.0,0.0,1.0,35,750,500,250,0.6666666666666666,10,5,5,393.5372564639463,0.43186274509803924,0.12817608718880225,0.21301996432886472,128240.42986685026,3125.7146667467205,131366.144533597,730,3,193.8,32,3,19,36.81516454749438,0.611328125,46.780303030303024,1012.8787878787874,31.652462121212107,8
3118,4,0,0,35,0.0,0.0,1.0,35,1250,1100,150,0.88,14,11,3,395.14705788296214,0.4309873949579832,0.1300772489409423,0.21457715064740515,128368.35048719493,3144.875204060776,131513.2256912557,731,4,194.8,32,3,17,36.643149347952495,0.6126302083333333,46.65404040404039,1013.3838383838363,31.668244949494884,0
3119,4,1,1,35,0.027777777777777776,0.027777777777777776,0.9722222222222222,36,600,500,100,0.8333333333333334,7,5,2,393.1908554765459,0.4330687830687831,0.13181866967184575,0.21565607053355942,128765.68657487475,2925.898092079932,131691.58466695467,732,0,190.36111111111111,33,3,18,36.28551879578201,0.6142676767676767,46.262254901960766,1014.9509803921545,30.756090314913774,0
3120,4,0,0,35,0.0,0.0,1.0,35,1000,700,300,0.7,13,7,6,408.0773727282389,0.4301120448179272,0.13985272459499254,0.21749178656395154,127617.73003472226,3432.8826352845113,131050.61267000677,733,1,195.54285714285714,31,4,17,37.087628865979376,0.6075268817204301,47.395833333333336,1010.416666666667,32.59408602150538,8
3121,4,2,0,37,0.05405405405405406,0.0,1.0,37,800,200,600,0.25,14,2,12,388.3215634473063,0.4344657157157157,0.12879546212879545,0.2096936442615456,128144.53125000012,2553.342013888903,130697.87326388902,734,0,185.9189189189189,32,5,20,37.045610425240056,0.6103515625,46.87500000000001,1012.5000000000009,31.64062500000003,0
3122,4,2,3,36,0.05128205128205128,0.07692307692307693,0.9230769230769231,39,750,600,150,0.8,9,6,3,383.5419025937133,0.4369376968061178,0.09682191620618119,0.21049202038465983,128789.8729531035,2096.623692558295,130886.4966456618,735,0,177.33333333333334,35,4,14,36.505606233371346,0.6101190476190477,46.238425925925924,1015.0462962962958,29.00132275132274,8
3123,4,0,0,36,0.0,0.0,1.0,36,1100,800,300,0.7272727272727273,14,8,6,409.06714392004665,0.42989417989417994,0.13278525161933197,0.22249261730285458,128432.33471074376,3307.489669421479,131739.82438016523,736,1,193.05555555555554,32,4,14,36.224775784753355,0.61328125,46.590909090909086,1013.6363636363633,31.676136363636353,0
3124,4,2,0,38,0.05263157894736842,0.0,1.0,38,1100,700,400,0.6363636363636364,15,7,8,390.13346264682934,0.4347884068278805,0.1310239570807512,0.21552033033596668,129050.14349489778,2469.3558673469197,131519.4993622447,737,0,183.8421052631579,34,4,18,36.07205623901581,0.6148897058823529,45.98214285714285,1016.0714285714271,29.884453781512562,0
3125,4,1,0,39,0.02564102564102564,0.0,1.0,39,1000,500,500,0.5,15,5,10,382.6059744285665,0.4383434547908232,0.12912034328067112,0.21298814667700977,129352.72285997724,2098.3134920634793,131451.0363520407,738,0,180.10256410256412,34,5,19,35.9542617515116,0.617953431372549,45.6845238095238,1017.261904761904,29.919467787114826,0
3126,4,0,0,39,0.0,0.0,1.0,39,1250,1100,150,0.88,14,11,3,383.01616488359997,0.43820287899235266,0.1336308640086865,0.21387362466295837,129473.85381235814,2118.115787981844,131591.96960033997,739,1,181.10256410256412,34,5,14,35.82022263812533,0.6191789215686274,45.56547619047618,1017.738095238094,29.933473389355708,0
3127,4,0,1,38,0.0,0.02564102564102564,0.9743589743589743,39,1100,900,200,0.8181818181818182,13,9,4,382.2632120222204,0.43845591542959966,0.12932334433562098,0.21411245922894884,129595.04145408161,2107.883361678001,131702.92481575962,740,2,182.10256410256412,34,5,14,35.71578198682724,0.6204044117647058,45.44642857142857,1018.2142857142854,29.94747899159663,0
3128,4,0,0,38,0.0,0.0,1.0,38,550,300,250,0.5454545454545454,8,3,5,391.48438341111,0.4342549786628734,0.13315079606530755,0.21847354300039354,129450.69204152247,2535.58487120338,131986.27691272585,741,4,187.8421052631579,33,5,14,35.62841201027617,0.6212121212121212,45.588235294117645,1017.6470588235293,30.837789661319068,0
3129,4,0,1,37,0.0,0.02631578947368421,0.9736842105263158,38,1100,900,200,0.8181818181818182,13,9,4,381.6810782343648,0.4343735182550972,0.09281393879209188,0.20565625564753656,128056.65569540887,2175.3604841820875,130232.01617959097,742,5,188.8421052631579,35,3,17,37.30381646655229,0.6026785714285714,46.96180555555555,1012.1527777777771,28.918650793650777,8
3130,4,0,0,37,0.0,0.0,1.0,37,850,600,250,0.7058823529411765,11,6,5,390.4221453287196,0.4314627127127127,0.09440381558028621,0.2100372300819062,127993.90589569166,2594.331065759641,130588.2369614513,743,6,194.8108108108108,34,3,18,37.14705882352941,0.6041666666666667,47.023809523809526,1011.9047619047623,29.761904761904773,0
3131,4,1,0,38,0.02631578947368421,0.0,1.0,38,1300,800,500,0.6153846153846154,18,8,10,382.1626307372517,0.4337067330488383,0.0981439873719856,0.20749197594000882,128361.76478097368,2211.191097149652,130572.95587812334,744,0,190.6578947368421,33,5,19,36.97885173539728,0.6101641414141414,46.66053921568628,1013.357843137255,30.707813428401668,0
3132,4,1,0,39,0.02564102564102564,0.0,1.0,39,1150,800,350,0.6956521739130435,15,8,7,380.5859874967842,0.43679712100764734,0.12296236549712702,0.2094894262419564,128907.38195516118,2012.0686514060324,130919.45060656722,745,0,186.74358974358975,35,4,18,36.46047032900235,0.6113095238095239,46.12268518518518,1015.5092592592592,29.014550264550262,0
3133,4,0,0,39,0.0,0.0,1.0,39,1400,900,500,0.6428571428571429,19,9,10,381.5183269800674,0.4363753936122357,0.11521811521811509,0.2106269103289957,129024.94454089506,2045.0761959876522,131070.02073688271,746,1,187.74358974358975,35,4,18,36.316643882433354,0.6125,46.00694444444444,1015.9722222222222,29.027777777777775,0
3134,4,0,1,38,0.0,0.02564102564102564,0.9743589743589743,39,800,300,500,0.375,13,3,10,381.7932878806002,0.43536324786324787,0.12520107316873808,0.21156406608550857,129171.97312510718,2063.3984642918394,131235.37158939903,747,2,188.74358974358975,35,4,18,36.15946051083533,0.6139880952380952,45.86226851851852,1016.5509259259261,29.044312169312175,0
3135,4,0,1,37,0.0,0.02631578947368421,0.9736842105263158,38,1000,800,200,0.8,12,8,4,383.29750067186205,0.43588489805595065,0.11842105263157854,0.21255588673621453,129201.38888888896,2304.5172378686607,131505.90612675762,748,3,187.78947368421052,33,5,18,36.09118852459015,0.6186868686868687,45.833333333333336,1016.6666666666673,30.808080808080827,0
3136,4,1,1,37,0.02631578947368421,0.02631578947368421,0.9736842105263158,38,1150,800,350,0.6956521739130435,15,8,7,371.54606672634105,0.43576635846372686,0.11969638230968527,0.20810959454553984,129595.0414540816,2030.1055839002224,131625.14703798183,749,0,186.05263157894737,34,4,17,35.98859074788573,0.6204044117647058,45.44642857142857,1018.2142857142853,29.947478991596626,0
3137,4,0,2,35,0.0,0.05405405405405406,0.9459459459459459,37,1550,1300,250,0.8387096774193549,18,13,5,371.7439702281881,0.4356231231231231,0.12033609075100338,0.2092790191230455,129793.87622849375,2250.0181720972537,132043.894400591,750,1,189.64864864864865,33,4,18,35.78109340549207,0.6246843434343434,45.25122549019607,1018.9950980392149,30.878639334521665,0
3138,4,0,1,34,0.0,0.02857142857142857,0.9714285714285714,35,1050,800,250,0.7619047619047619,13,8,5,386.06037042970553,0.4332983193277311,0.12290168303457283,0.2173603207901351,129797.77865939678,3021.955702039935,132819.7343614367,751,2,193.31428571428572,31,4,18,35.41240736008177,0.6297043010752688,45.247395833333336,1019.0104166666673,32.87130376344088,0
3139,4,0,0,34,0.0,0.0,1.0,34,1100,900,200,0.8181818181818182,13,9,4,394.7300730491974,0.43049985145573383,0.11377018597329935,0.22250427022717345,129844.02101826352,3450.667980308144,133294.68899857166,752,3,198.44117647058823,32,2,20,35.14437768417576,0.6276041666666667,45.20202020202021,1019.1919191919199,31.849747474747495,0
3140,4,0,0,34,0.0,0.0,1.0,34,900,700,200,0.7777777777777778,11,7,4,395.2490582587315,0.4296642899584076,0.11917281460064544,0.22371595259676083,130004.92814827577,3476.8650839200172,133481.79323219578,753,4,199.44117647058823,32,2,21,34.96708761503859,0.6292317708333333,45.044191919191924,1019.8232323232329,31.869476010101028,0
3141,4,0,0,34,0.0,0.0,1.0,34,1400,1000,400,0.7142857142857143,18,10,8,398.64245105340046,0.42923722519310753,0.11865005368141501,0.22676873855004914,130200.04325259513,3580.652873894653,133780.69612648978,754,5,200.44117647058823,33,1,21,34.6816962856228,0.6287878787878788,44.85294117647059,1020.5882352941175,30.926916221033864,0
3142,4,0,0,34,0.0,0.0,1.0,34,1150,700,450,0.6086956521739131,16,7,9,403.6254125253772,0.4277332144979204,0.11982181959984439,0.23076076791902744,130395.54172092004,3726.220900239681,134121.76262115972,755,6,201.44117647058823,31,3,21,34.355345911949684,0.635752688172043,44.66145833333333,1021.3541666666658,32.94690860215051,0
3143,4,0,0,34,0.0,0.0,1.0,34,1050,700,350,0.6666666666666666,14,7,7,403.4141034393539,0.427361853832442,0.11395934520597262,0.23143230144678723,130528.56445312499,3731.412760416666,134259.97721354166,756,7,202.44117647058823,31,3,19,34.22528032619776,0.6370967741935484,44.53125,1021.8749999999999,32.96370967741935,0
3144,4,0,0,34,0.0,0.0,1.0,34,1200,1000,200,0.8333333333333334,14,10,4,404.0282672124058,0.42710190136660725,0.11050013484762244,0.23258284121347572,130661.65500217008,3758.200412326384,134419.85541449647,757,8,203.44117647058823,31,3,19,34.07412124299542,0.6384408602150538,44.401041666666664,1022.3958333333328,32.980510752688154,0
3145,4,1,0,35,0.02857142857142857,0.0,1.0,35,1650,1600,50,0.9696969696969697,17,16,1,394.47589696632167,0.4272759103641457,0.11234222339582756,0.23046593980429805,131231.07854109272,3353.499483471072,134584.5780245638,758,0,198.6,32,3,20,33.73998767714109,0.6416015625,43.84469696969697,1024.621212121212,32.019412878787875,0
3146,4,1,1,35,0.027777777777777776,0.027777777777777776,0.9722222222222222,36,650,400,250,0.6153846153846154,9,4,5,382.82673265007304,0.4293650793650794,0.10818212578775976,0.22599681498241408,131628.58963012707,2878.2603184163327,134506.84994854341,759,0,194.05555555555554,31,5,20,33.63588059890877,0.6481854838709677,43.45703125000001,1026.171875000001,33.102318548387125,0
3147,4,0,0,35,0.0,0.0,1.0,35,1300,1000,300,0.7692307692307693,16,10,6,419.27528436303817,0.4285714285714286,0.08609665146037226,0.22912893346038016,128621.28434284314,3819.8689118825405,132441.15325472568,760,1,200.31428571428572,30,5,18,35.77194028532309,0.6204861111111111,46.40456989247312,1014.3817204301077,33.81272401433692,8
3148,4,2,0,37,0.05405405405405406,0.0,1.0,37,800,500,300,0.625,11,5,6,398.4144047299111,0.43177552552552556,0.0928223305272482,0.22093889716840534,129201.38888888895,2896.444133714884,132097.83302260382,761,0,190.43243243243242,31,6,20,35.70696721311475,0.6236559139784946,45.833333333333336,1016.6666666666672,32.7956989247312,0
3149,4,1,1,37,0.02631578947368421,0.02631578947368421,0.9736842105263158,38,1150,700,450,0.6086956521739131,16,7,9,344.73259045129,0.43404753437648175,0.0732136918472166,0.1920524588003078,129383.00028344663,1337.8684807256113,130720.86876417224,762,0,186.39473684210526,34,4,22,36.886652625009745,0.6182598039215687,45.6547619047619,1017.3809523809517,29.92296918767505,8
3150,4,0,0,37,0.0,0.0,1.0,37,950,800,150,0.8421052631578947,11,8,3,354.06085405373585,0.43227602602602605,0.07635029319163777,0.19711999661301546,129357.17520004323,1760.0623858612075,131117.23758590443,763,1,192.40540540540542,33,4,22,36.6756766253062,0.6202651515151515,45.68014705882353,1017.2794117647057,30.826648841354718,0
3151,4,0,0,37,0.0,0.0,1.0,37,1300,900,400,0.6923076923076923,17,9,8,355.60896900442185,0.43180680680680683,0.07696714055095621,0.19845274721859646,129450.69204152233,1806.7654267589219,131257.45746828124,764,2,193.40540540540542,33,4,16,36.54112475915221,0.6212121212121212,45.58823529411764,1017.647058823528,30.837789661319032,0
3152,4,0,2,35,0.0,0.05405405405405406,0.9459459459459459,37,1500,1100,400,0.7333333333333333,19,11,8,356.08092550839086,0.43105605605605607,0.0819592155332225,0.19966481045713413,129637.82709775082,1832.3114907727695,131470.13858852358,765,3,194.40540540540542,33,4,18,36.3387484957882,0.6231060606060606,45.40441176470588,1018.3823529411761,30.86007130124776,0
3153,4,0,0,35,0.0,0.0,1.0,35,1100,800,300,0.7272727272727273,14,8,6,368.9751282148893,0.42895658263305325,0.08849648112603958,0.20582017323335902,129433.15505981447,2551.5229966905395,131984.678056505,766,4,204.17142857142858,31,4,18,36.21894327148645,0.626008064516129,45.60546875,1017.5781250000001,32.825100806451616,0
3154,4,0,1,34,0.0,0.02857142857142857,0.9714285714285714,35,950,700,250,0.7368421052631579,12,7,5,365.55671532614735,0.42885154061624653,0.07563067247909738,0.19383232730423586,127410.50020406095,2317.801885854951,129728.3020899159,767,5,205.17142857142858,32,3,16,38.37439553109889,0.6028645833333333,47.60101010101011,1009.5959595959607,31.549873737373773,8
3155,4,0,0,34,0.0,0.0,1.0,34,1400,1100,300,0.7857142857142857,17,11,6,372.7865485188751,0.4276960784313726,0.09671777907603163,0.1975539378446235,127387.59570651599,2697.6764255100065,130085.272132026,768,6,211.94117647058823,31,3,16,38.21544885850639,0.6051747311827957,47.62369791666668,1009.5052083333346,32.56468413978499,0
3156,4,2,0,36,0.05555555555555555,0.0,1.0,36,1150,1000,150,0.8695652173913043,13,10,3,351.1828303499381,0.43412698412698414,0.09530825327628434,0.18905266056256786,128020.48040417163,1791.7189302191655,129812.1993343908,769,0,201.11111111111111,33,3,18,38.112537337531286,0.6066919191919191,46.99754901960785,1012.0098039215699,30.666963755199088,0
3157,4,2,0,38,0.05263157894736842,0.0,1.0,38,650,400,250,0.6153846153846154,9,4,5,337.0993049479684,0.43792970602181125,0.10928842009209117,0.18459397916794762,128701.77636584805,1077.0558716992587,129778.8322375473,770,0,191.47368421052633,35,3,14,37.773872666438535,0.6092261904761904,46.32523148148149,1014.6990740740753,28.99140211640215,0
3158,4,1,1,38,0.02564102564102564,0.02564102564102564,0.9743589743589743,39,1400,1100,300,0.7857142857142857,17,11,6,324.27255731421013,0.4401990553306343,0.11121052796027908,0.179693577340416,129172.76810171663,577.4367695398191,129750.20487125646,771,0,187.53846153846155,36,3,16,37.62047191758061,0.6119791666666667,45.86148648648649,1016.5540540540544,28.237612612612622,0
3159,4,1,0,39,0.02564102564102564,0.0,1.0,39,1150,900,250,0.782608695652174,14,9,5,328.0819087550052,0.43865272154745844,0.12339708111237924,0.18273070059757826,129373.18019032561,688.9999797094579,130062.18017003508,772,0,188.46153846153845,36,3,18,37.320123976090336,0.6140046296296297,45.66441441441442,1017.3423423423435,28.25950950950954,0
3160,4,0,0,39,0.0,0.0,1.0,39,1050,700,350,0.6666666666666666,14,7,7,330.71889772674757,0.43772492127755286,0.12768311573356916,0.18473655115292653,129487.77113261938,764.8105876146703,130252.58172023405,773,1,189.46153846153845,36,3,12,37.13671903813527,0.615162037037037,45.551801801801815,1017.792792792795,28.272022022022085,0
3161,4,0,1,38,0.0,0.02564102564102564,0.9743589743589743,39,950,600,350,0.631578947368421,13,6,7,333.2023610626141,0.43735942420152946,0.13112597054202912,0.18666764242429756,129602.41280131512,836.7659889619736,130439.17879027709,774,2,190.46153846153845,36,3,12,36.95716286957164,0.6163194444444444,45.43918918918921,1018.2432432432456,28.2845345345346,0
3162,4,2,0,40,0.05,0.0,1.0,40,850,500,350,0.5882352941176471,12,5,7,327.4741432935666,0.43675213675213675,0.1499059240941829,0.18538265409455057,130010.858208776,515.0388821560693,130525.89709093206,775,0,186.35,37,3,14,36.6890432928359,0.6185247747747749,45.038377192982466,1019.846491228072,27.56341868183978,0
3163,4,0,2,38,0.0,0.05,0.95,40,850,600,250,0.7058823529411765,11,6,5,329.8499908036247,0.4358974358974359,0.15630037614185954,0.18726382943427264,130122.70752779712,584.1947762773303,130706.90230407445,776,1,187.35,37,3,14,36.5152024001433,0.6196509009009009,44.928728070175445,1020.2850877192991,27.57527264106214,0
3164,4,0,2,36,0.0,0.05263157894736842,0.9473684210526316,38,1900,1400,500,0.7368421052631579,24,14,10,343.8240553827375,0.43243243243243246,0.16428554363666792,0.19471578252138058,130026.38996056236,1341.240140603561,131367.6301011659,777,2,196.97368421052633,35,3,16,36.256430624905434,0.6226190476190476,45.023148148148145,1019.9074074074069,29.14021164021163,0
3165,4,0,0,36,0.0,0.0,1.0,36,800,500,300,0.625,11,5,6,360.1985636617675,0.43009259259259264,0.1678825289936403,0.20294114196553203,129825.09731833884,2152.5627162629435,131977.66003460178,778,3,205.11111111111111,33,3,16,36.04347041847041,0.625,45.2205882352941,1019.1176470588214,30.882352941176407,0
3166,4,0,0,36,0.0,0.0,1.0,36,1000,700,300,0.7,13,7,6,356.87027030887197,0.4305886243386243,0.16631644485952224,0.201912201814121,129989.29280045332,2077.8628117913563,132067.15561224468,779,4,206.11111111111111,34,2,18,35.96145614444705,0.6243872549019608,45.059523809523796,1019.7619047619031,29.992997198879504,0
3167,4,0,0,36,0.0,0.0,1.0,36,850,700,150,0.8235294117647058,10,7,3,357.34155097007545,0.43014219576719576,0.17085813202629652,0.20265120782677512,130080.35891439884,2096.6234410430543,132176.9823554419,780,5,207.11111111111111,34,2,18,35.85696502898043,0.6253063725490196,44.97023809523808,1020.1190476190455,30.003501400560165,0
3168,4,0,0,36,0.0,0.0,1.0,36,1100,600,500,0.5454545454545454,16,6,10,358.92929345362495,0.4295634920634921,0.182049088977011,0.20434659774710343,130232.2066326529,2148.830782312907,132381.0374149658,781,6,208.11111111111111,34,2,19,35.66232213669233,0.6268382352941176,44.82142857142856,1020.7142857142844,30.021008403361307,0
3169,4,1,0,37,0.02702702702702703,0.0,1.0,37,750,600,150,0.8,9,6,3,350.04218016919987,0.43399649649649646,0.17494819452405141,0.20053818359226114,130475.34722222213,1734.3785430838907,132209.72576530604,782,0,203.45945945945945,34,3,20,35.64267264817835,0.6292892156862745,44.58333333333333,1021.6666666666658,30.049019607843114,0
3170,4,0,1,36,0.0,0.02702702702702703,0.972972972972973,37,1300,900,400,0.6923076923076923,17,9,8,349.63187767118654,0.43358983983983984,0.17430984780775205,0.2012492336085891,130657.85147392288,1736.4299886621318,132394.28146258503,783,1,204.45945945945945,34,3,18,35.46833760285671,0.6311274509803921,44.404761904761905,1022.3809523809522,30.070028011204474,0
3171,4,0,0,36,0.0,0.0,1.0,36,1150,900,250,0.782608695652174,14,9,5,360.9578524230972,0.4286210317460317,0.17735145217159576,0.20732703093723365,130575.52984429068,2226.452566320643,132801.98241061132,784,9,211.11111111111111,33,3,18,35.2622901678657,0.6325757575757576,44.48529411764706,1022.0588235294119,30.97147950089127,0
3172,4,0,0,36,0.0,0.0,1.0,36,1050,600,450,0.5714285714285714,15,6,9,360.97659257512254,0.4279596560846561,0.1816725931253078,0.20784180206033473,130669.48596993953,2233.7251597943186,132903.21112973386,785,10,212.11111111111111,33,3,18,35.166581765152415,0.6335227272727273,44.39338235294118,1022.426470588236,30.982620320855638,0
3173,4,0,0,36,0.0,0.0,1.0,36,1100,800,300,0.7272727272727273,14,8,6,363.90308591139274,0.42751322751322757,0.18569983495714193,0.21037832141193266,130826.15460399851,2321.6082756632086,133147.76287966172,786,11,213.11111111111111,33,3,18,34.93301788851619,0.6351010101010102,44.240196078431374,1023.0392156862749,31.001188354129543,0
3174,4,0,0,36,0.0,0.0,1.0,36,800,600,200,0.75,10,6,4,365.00461196852535,0.426901455026455,0.18300203568434958,0.21153043126642312,130920.2008392206,2357.2954212322325,133277.49626045284,787,12,214.11111111111111,33,3,18,34.80957869317049,0.6360479797979798,44.1482843137255,1023.4068627450989,31.012329174093907,0
3175,4,1,0,37,0.02702702702702703,0.0,1.0,37,1600,1400,200,0.875,18,14,4,358.2127702111438,0.4280217717717718,0.19350149719457743,0.21032745602502748,131422.35145436853,2016.0674380046244,133438.41889237316,788,0,209.2972972972973,33,4,19,34.47559360184854,0.6410984848484849,43.65808823529412,1025.3676470588239,31.07174688057042,0
3176,4,0,0,37,0.0,0.0,1.0,37,1150,900,250,0.782608695652174,14,9,5,359.0732675867757,0.4273961461461462,0.19671284187413196,0.21135325244031744,131516.61169982707,2044.8199009996235,133561.4316008267,789,1,210.2972972972973,33,4,19,34.35832337714058,0.6420454545454546,43.56617647058824,1025.7352941176478,31.08288770053478,0
3177,4,1,0,38,0.02631578947368421,0.0,1.0,38,1000,700,300,0.7,13,7,6,348.4271740438825,0.4292170459933618,0.1958637469586375,0.20754140366961707,131969.53125000012,1596.3541666666817,133565.8854166668,790,0,205.73684210526315,34,4,19,34.17477696674778,0.6443014705882353,43.12500000000001,1027.500000000001,30.220588235294144,0
3178,4,0,0,38,0.0,0.0,1.0,38,1050,700,350,0.6666666666666666,14,7,7,349.96988971474195,0.42869843527738266,0.20142521000207259,0.20896542377573174,132061.2882653061,1643.4948979591818,133704.78316326527,791,1,206.73684210526315,34,4,19,34.0427380125087,0.6452205882352942,43.035714285714285,1027.8571428571427,30.231092436974784,0
3179,4,0,0,38,0.0,0.0,1.0,38,1100,800,300,0.7272727272727273,14,8,6,359.54032889778057,0.42677216690374586,0.19933673712840538,0.20547822941671084,130380.7656035665,1775.4286694101468,132156.19427297666,792,2,207.73684210526315,35,3,18,35.49599576911453,0.6261904761904762,44.675925925925924,1021.2962962962961,29.179894179894173,8
3180,4,1,1,38,0.02564102564102564,0.02564102564102564,0.9743589743589743,39,1150,900,250,0.782608695652174,14,9,5,352.337054241807,0.4276315789473684,0.1970310391363026,0.20329892799390686,130751.61944038642,1413.7280861943148,132165.34752658074,793,0,203.3846153846154,36,3,15,35.304264846215965,0.6278935185185186,44.31306306306307,1022.7477477477485,28.40965965965968,0
3181,4,0,0,38,0.0,0.0,1.0,38,950,500,450,0.5263157894736842,14,5,9,359.77559837022176,0.4241346609767662,0.20547749464158094,0.20814242732936905,130854.01663237311,1815.6164266117949,132669.6330589849,794,1,209.6578947368421,35,3,15,35.01036953242835,0.6309523809523809,44.21296296296296,1023.1481481481482,29.232804232804234,0
3182,4,0,0,38,0.0,0.0,1.0,38,1300,800,500,0.6153846153846154,18,8,10,355.3879891911892,0.4237790422000948,0.19843045325273412,0.20655467492675816,131031.70680084023,1713.4189600480177,132745.12576088824,795,2,210.6578947368421,35,3,15,34.942817846107474,0.6327380952380952,44.039351851851855,1023.8425925925928,29.25264550264551,0
3183,4,1,0,39,0.02564102564102564,0.0,1.0,39,1150,800,350,0.6956521739130435,15,8,7,346.61989134300865,0.4268162393162393,0.19950095813721958,0.20333503294810407,131387.4488275892,1308.635545267498,132696.08437285668,796,0,206.23076923076923,35,4,17,34.80798901181608,0.6363095238095238,43.69212962962963,1025.2314814814818,29.29232804232805,0
3184,4,0,0,39,0.0,0.0,1.0,39,1250,800,450,0.64,17,8,9,345.0612769167186,0.4258884390463338,0.2011089532494581,0.2033317097484674,131559.08230866006,1279.1889862835837,132838.27129494364,797,1,207.23076923076923,36,3,16,34.67480790340285,0.6359953703703703,43.52477477477478,1025.9009009009012,28.497247247247255,0
3185,4,0,0,39,0.0,0.0,1.0,39,1350,1000,350,0.7407407407407407,17,10,7,347.07625048982084,0.4247638326585695,0.1985864670958455,0.20560715891589965,131761.3363997443,1346.2461194302387,133107.58251917452,798,2,208.23076923076923,36,3,16,34.419216847647256,0.6380208333333333,43.3277027027027,1026.689189189189,28.519144144144136,0
3186,4,2,0,41,0.04878048780487805,0.0,1.0,41,1000,700,300,0.7,13,7,6,334.2029592836597,0.4265752032520325,0.20514249383848027,0.20075111010245558,132288.07259706708,642.2130679742934,132930.28566504136,799,0,199.02439024390245,38,3,18,34.21997784470521,0.6395285087719298,42.815170940170944,1028.739316239317,27.07208726945571,0
3187,4,0,0,41,0.0,0.0,1.0,41,1350,900,450,0.6666666666666666,18,9,9,327.4063032367974,0.42571138211382115,0.19469605684131785,0.1981314432989689,132567.32840874093,480.72144195379326,133048.04985069472,800,1,200.02439024390245,37,4,22,34.11458333333333,0.6441441441441442,42.543859649122794,1029.824561403507,27.83309625414884,0
3188,4,0,0,41,0.0,0.0,1.0,41,1200,800,400,0.6666666666666666,16,8,8,326.5177558958723,0.42550813008130084,0.18954614833504646,0.19818868439261067,132680.2718144043,464.49292089872023,133144.764735303,801,2,201.02439024390245,37,4,16,34.024230168866175,0.6452702702702703,42.43421052631578,1030.2631578947357,27.844950213371238,0
3189,4,0,0,41,0.0,0.0,1.0,41,750,400,350,0.5333333333333333,11,4,7,326.83847690558787,0.42558434959349595,0.19190383008320389,0.19868227722889473,132736.76155163115,476.6961949830583,133213.4577466142,802,3,202.02439024390245,37,4,16,33.95935305384124,0.6458333333333333,42.379385964912274,1030.48245614035,27.85087719298243,0
3190,4,0,0,41,0.0,0.0,1.0,41,1150,700,450,0.6086956521739131,16,7,9,326.18733388815804,0.42502540650406506,0.18978895488436742,0.1989701499380988,132865.7190536196,467.82293264663923,133333.54198626624,803,4,203.02439024390245,38,3,18,33.846934369602764,0.6452850877192983,42.2542735042735,1030.9829059829053,27.131129104813297,0
3191,4,0,2,39,0.0,0.04878048780487805,0.9512195121951219,41,900,500,400,0.5555555555555556,13,5,8,326.6507447933611,0.4245426829268293,0.19047282154164136,0.1996934540525847,132948.3427044524,485.5350326904713,133433.87773714287,804,5,204.02439024390245,38,3,18,33.752244552643404,0.6461074561403508,42.174145299145295,1031.303418803418,27.139563652721527,0
3192,4,0,1,38,0.0,0.02564102564102564,0.9743589743589743,39,1250,800,450,0.64,17,8,9,335.7986336733287,0.42203666216824115,0.10731085323646927,0.19363039286271697,130726.51855504418,979.5572631309756,131706.07581817516,805,6,214.6153846153846,38,1,18,35.75249860704834,0.6239035087719298,44.337606837606835,1022.6495726495725,26.911830859199277,8
3193,4,0,1,37,0.0,0.02631578947368421,0.9736842105263158,38,1250,1100,150,0.88,14,11,3,340.3153364564947,0.41860775248933146,0.1260031378037636,0.19615456290440436,130710.70545744803,1296.5715412434154,132007.27699869144,806,7,221.02631578947367,37,1,18,35.65301308170706,0.6255630630630631,44.353070175438575,1022.5877192982423,27.63750592697952,0
3194,4,0,0,37,0.0,0.0,1.0,37,1200,900,300,0.75,15,9,6,347.68977804370303,0.41801176176176175,0.14328312016046008,0.20061744372254803,130751.61944038606,1692.200308416493,132443.81974880255,807,8,227.16216216216216,36,1,18,35.42308962783526,0.6278935185185186,44.31306306306305,1022.7477477477456,28.4096596596596,0
3195,4,0,0,37,0.0,0.0,1.0,37,700,400,300,0.5714285714285714,10,4,6,354.1358382478214,0.4169794794794795,0.15592492723721385,0.20571558501667359,131010.89000740593,1879.1302704731584,132890.02027787908,808,9,228.16216216216216,36,1,18,34.99592087412458,0.6304976851851851,44.059684684684676,1023.7612612612603,28.437812812812787,0
3196,4,0,0,37,0.0,0.0,1.0,37,900,500,400,0.5555555555555556,13,5,8,360.100812262314,0.41604104104104106,0.16580458660265185,0.2101242520301648,131183.87972009167,2047.8843285853386,133231.76404867703,809,10,229.16216216216216,36,1,18,34.66825143820307,0.6322337962962963,43.890765765765764,1024.4369369369367,28.456581581581574,0
3197,4,0,0,37,0.0,0.0,1.0,37,1100,800,300,0.7272727272727273,14,8,6,346.4945422243724,0.4153528528528529,0.1579578213646904,0.19358786558584037,129495.7307205931,1573.992047211735,131069.72276780484,810,11,230.16216216216216,35,2,19,36.72721931620045,0.6172619047619048,45.543981481481474,1017.8240740740727,29.08068783068779,8
3198,4,0,0,37,0.0,0.0,1.0,37,1200,700,500,0.5833333333333334,17,7,10,349.45011082484166,0.4151338838838839,0.16432575875300381,0.19605625324440876,129659.75265806356,1661.922987176379,131321.67564523994,811,12,231.16216216216216,36,1,19,36.485284903435065,0.6168981481481481,45.38288288288289,1018.4684684684692,28.29079079079081,0
3199,4,0,0,37,0.0,0.0,1.0,37,800,600,200,0.75,10,6,4,349.9203154007507,0.41472722722722727,0.16653022688839703,0.19660740205684413,129717.10519641262,1678.1300726402108,131395.23526905282,812,13,232.16216216216216,36,1,19,36.41503611172527,0.6174768518518519,45.32657657657658,1018.6936936936936,28.297047047047045,0
3200,4,0,2,35,0.0,0.05405405405405406,0.9459459459459459,37,850,600,250,0.7058823529411765,11,6,5,350.0959422892901,0.4141641641641642,0.1619829972498179,0.1974279360536056,129860.54202428802,1692.729765238233,131553.27178952625,813,14,233.16216216216216,36,1,20,36.26486944352372,0.6189236111111112,45.18581081081082,1019.2567567567586,28.31268768768774,0
3201,4,0,0,35,0.0,0.0,1.0,35,950,600,350,0.631578947368421,13,6,7,362.5367363921948,0.4118697478991597,0.18165125363068801,0.2038495000029174,129746.60572562365,2407.5821995464926,132154.18792517015,814,21,244.9142857142857,34,1,20,36.06372205343929,0.6219362745098039,45.29761904761905,1018.8095238095243,29.964985994397775,0
3202,4,0,0,35,0.0,0.0,1.0,35,1150,800,350,0.6956521739130435,15,8,7,360.5151944389482,0.411764705882353,0.17345032361379875,0.20365779189809724,129928.59977324275,2368.2468820861845,132296.84665532893,815,22,245.9142857142857,34,1,22,35.930202008407306,0.6237745098039216,45.11904761904763,1019.5238095238104,29.98599439775913,0
3203,4,0,0,35,0.0,0.0,1.0,35,800,700,100,0.875,9,7,2,362.04451324013183,0.4118697478991597,0.17705814670913278,0.20499903138983566,130019.64462868497,2414.5797902494487,132434.2244189344,816,23,246.9142857142857,34,1,22,35.79870433057077,0.6246936274509804,45.02976190476191,1019.8809523809538,29.996498599439818,0
3204,4,0,0,35,0.0,0.0,1.0,35,800,600,200,0.75,10,6,4,360.48112258305184,0.41165966386554625,0.17272878813135528,0.2045909417574012,130110.7213718822,2380.4917800453645,132491.21315192757,817,24,247.9142857142857,34,1,22,35.74606184364061,0.6256127450980392,44.9404761904762,1020.2380952380962,30.00700280112048,0
3205,4,0,0,35,0.0,0.0,1.0,35,950,700,250,0.7368421052631579,12,7,5,361.0581739721007,0.4121148459383754,0.17482167855476294,0.2052381079104011,130171.45691609985,2399.893707483004,132571.35062358287,818,25,248.9142857142857,34,1,22,35.669670633068904,0.6262254901960784,44.88095238095239,1020.476190476191,30.014005602240914,0
3206,4,1,0,36,0.027777777777777776,0.0,1.0,36,750,600,150,0.8,9,6,3,385.0430620440214,0.41810515873015874,0.2405362119888519,0.20693159330373842,127952.84162649205,2731.0714110024,130683.91303749445,819,0,242.97222222222223,32,4,19,37.32528391364032,0.6083984375,47.06439393939393,1011.7424242424231,31.616950757575722,8
3207,4,1,0,37,0.02702702702702703,0.0,1.0,37,950,700,250,0.7368421052631579,12,7,5,378.1982858349537,0.42067067067067065,0.23904121907751685,0.20470260854131578,128237.60880730966,2299.848766099574,130537.45757340924,820,0,237.3783783783784,33,4,20,37.20646803791088,0.6089015151515151,46.783088235294116,1012.8676470588233,30.692959001782526,0
3208,4,0,1,36,0.0,0.02702702702702703,0.972972972972973,37,1000,700,300,0.7,13,7,6,386.92918883628306,0.4211086086086086,0.1999704622655445,0.20464751895098174,127308.35383326093,2488.6621131295246,129797.01594639046,821,1,238.3783783783784,33,4,19,37.940067800040474,0.5994318181818181,47.70220588235292,1009.1911764705857,30.58155080213896,8
3209,4,1,0,37,0.02702702702702703,0.0,1.0,37,800,600,200,0.75,10,6,4,385.71580401743057,0.42001376376376376,0.2328225132348849,0.20557380763566313,127617.73003472193,2444.835069444406,130062.56510416634,822,0,239.32432432432432,33,4,18,37.652491408934694,0.6025883838383839,47.395833333333314,1010.4166666666642,30.618686868686794,0
3210,4,2,0,39,0.05128205128205128,0.0,1.0,39,1100,800,300,0.7272727272727273,14,8,6,384.6169789273193,0.4261414754835808,0.20634966797537646,0.19451470540396937,125473.93322428831,1872.4973456152354,127346.43056990355,823,0,228.0,32,7,16,39.89287964713294,0.5830078125,49.52651515151515,1001.8939393939391,31.3091856060606,8
3211,4,2,0,41,0.04878048780487805,0.0,1.0,41,1100,700,400,0.6363636363636364,15,7,8,366.54097163471306,0.43074186991869917,0.21380051913816112,0.18836009248804553,126133.51048752829,1046.6198979591718,127180.13038548746,824,0,217.82926829268294,34,7,18,39.66406928972109,0.585171568627451,48.86904761904761,1004.5238095238091,29.544817927170854,0
3212,4,1,2,40,0.023809523809523808,0.047619047619047616,0.9523809523809523,42,1000,700,300,0.7,13,7,6,357.80936014134375,0.43481416957026714,0.21137216243599255,0.18596248573992713,126596.50051708237,659.4825692300979,127255.98308631247,825,0,213.61904761904762,35,7,17,39.406387770749475,0.5877976190476191,48.40856481481481,1006.3657407407399,28.75330687830685,0
3213,4,0,0,40,0.0,0.0,1.0,40,1600,1400,200,0.875,18,14,4,368.99968488498325,0.4327724358974359,0.22757396449704181,0.1912912476857734,126492.52409297046,1335.1403061224423,127827.6643990929,826,1,225.2,34,6,17,39.23200197238658,0.5888480392156863,48.51190476190476,1005.9523809523804,29.58683473389354,0
3214,4,5,2,43,0.1111111111111111,0.044444444444444446,0.9555555555555556,45,750,200,550,0.26666666666666666,13,2,11,334.69149397532817,0.4434132996632996,0.23324290361601396,0.17879820578772332,127712.20419908321,-449.745081985241,127262.45911709797,827,0,201.06666666666666,38,7,18,38.84477504139801,0.5934758771929824,47.302350427350426,1010.7905982905984,26.599752586594693,0
3215,4,1,0,44,0.022727272727272728,0.0,1.0,44,1450,1000,450,0.6896551724137931,19,10,9,347.7580685374399,0.4414970930232558,0.25717236347862116,0.18611010736992076,127783.97108966221,87.58139523699737,127871.5524848992,828,0,206.61363636363637,37,7,19,38.441126233597245,0.5960022522522522,47.23135964912281,1011.0745614035088,27.32633949739213,0
3216,4,2,1,45,0.043478260869565216,0.021739130434782608,0.9782608695652174,46,1950,1500,450,0.7692307692307693,24,15,9,336.55272711105425,0.44485708534621576,0.25772568015613606,0.1831330171949204,128450.01737313412,-552.943333525694,127897.07403960843,829,0,198.58695652173913,37,9,13,38.04432576167297,0.602759009009009,46.573464912280706,1013.7061403508778,27.39746325272643,0
3217,4,1,1,45,0.021739130434782608,0.021739130434782608,0.9782608695652174,46,1150,700,450,0.6086956521739131,16,7,9,337.5885963287574,0.44481682769726244,0.2611445061168467,0.1844673422703684,128616.79945993004,-516.087041204981,128100.71241872506,830,0,199.56521739130434,37,9,14,37.848047958779226,0.6044481981981982,46.40899122807018,1014.3640350877199,27.41524419156,0
3218,4,1,0,46,0.021739130434782608,0.0,1.0,46,1600,1000,600,0.625,22,10,12,339.92781368764486,0.44706119162640906,0.262801462890194,0.18705118731796064,128895.01006319249,-437.000206794401,128458.00985639809,831,0,192.17391304347825,37,9,16,37.50528650613685,0.6072635135135135,46.13486842105263,1015.4605263157893,27.444879089615927,0
3219,4,2,2,46,0.041666666666666664,0.041666666666666664,0.9583333333333334,48,1100,800,300,0.7272727272727273,14,8,6,327.45181887016025,0.4502714982269504,0.261893509766856,0.18233896019191012,129364.36760355023,-1127.5168126093947,128236.85079094084,832,0,185.125,38,10,19,37.34509556815796,0.6101973684210527,45.67307692307692,1017.3076923076917,26.77125506072873,0
3220,4,1,0,47,0.02127659574468085,0.0,1.0,47,1550,1300,250,0.8387096774193549,18,13,5,353.0082313796676,0.44752158495220473,0.3465217784350494,0.18358428078379416,126622.55603887727,-392.9262592575226,126229.62977961975,833,0,189.82978723404256,37,10,18,39.50037676580599,0.584177927927928,48.382675438596486,1006.4692982456135,27.20187292555712,8
3221,4,1,2,46,0.020833333333333332,0.041666666666666664,0.9583333333333334,48,1200,800,400,0.6666666666666666,16,8,8,370.5177359708258,0.4502160904255319,0.37185742359558094,0.1850331719025885,124949.19215579386,-340.8216422102872,124608.37051358358,834,0,186.85416666666666,40,8,19,40.78975232093245,0.5619791666666667,50.0508130081301,999.7967479674826,24.994918699187064,8
3222,4,2,0,48,0.041666666666666664,0.0,1.0,48,1550,1300,250,0.8387096774193549,18,13,5,373.6439745669246,0.44909869976359335,0.39769257427597315,0.18898865501545925,125479.0617264224,-223.05961893348837,125256.00210748891,835,0,187.52083333333334,36,12,19,40.16241429695404,0.5743634259259259,49.5213963963964,1001.9144144144146,27.83095595595596,0
3223,4,3,0,51,0.058823529411764705,0.0,1.0,51,2050,1600,450,0.7804878048780488,25,16,9,361.9375924561549,0.4537254901960784,0.3312392918332385,0.18248741549712416,125347.46334876533,-1070.7327823318928,124276.73056643344,836,0,177.4313725490196,38,13,14,40.59177068885807,0.5693530701754386,49.65277777777777,1001.3888888888881,26.352339181286528,7
3224,4,3,0,54,0.05555555555555555,0.0,1.0,54,1800,1300,500,0.7222222222222222,23,13,10,340.18336016891624,0.4592286862334032,0.3325200326819431,0.1745426773203133,126069.35046103534,-2220.731936824764,123848.61852421057,837,0,168.5185185185185,40,14,18,40.39204277136882,0.5734375,48.932926829268304,1004.2682926829287,25.10670731707322,0
3225,4,0,1,53,0.0,0.018518518518518517,0.9814814814814815,54,1250,1000,250,0.8,15,10,5,340.41460247535264,0.4592869205683671,0.33099018913725,0.1752045379840612,126196.95746786,-2208.142577995875,123988.81488986412,838,1,169.5185185185185,40,14,19,40.2548801456458,0.5747395833333333,48.8058943089431,1004.7764227642298,25.119410569105746,0
3226,4,2,4,51,0.03636363636363636,0.07272727272727272,0.9272727272727272,55,1150,600,550,0.5217391304347826,17,6,11,334.07216844177333,0.46168630751964085,0.33085353286437535,0.17371410296472545,126617.30092789442,-2540.1367433547416,124077.16418453968,839,0,167.25454545454545,41,14,13,39.9822367340233,0.577489837398374,48.38789682539683,1006.4484126984137,24.54752226093692,0
3227,4,0,3,48,0.0,0.058823529411764705,0.9411764705882353,51,1800,1600,200,0.8888888888888888,20,16,4,359.388832450773,0.456062091503268,0.33023669959316293,0.1847639798542709,126151.14239763655,-1132.537644276455,125018.6047533601,840,1,180.94117647058823,38,13,18,39.825498954234455,0.5775767543859649,48.85149572649571,1004.5940170940152,26.43668466036882,0
3228,4,2,2,48,0.04,0.04,0.96,50,1700,1400,300,0.8235294117647058,20,14,6,366.05691259750273,0.4555952380952381,0.34091613043952496,0.18909159614684504,126346.81013629177,-749.9753529932444,125596.83478329852,841,0,184.94,37,13,17,39.45620660195588,0.5813626126126126,48.65679824561403,1005.3728070175425,27.172238027501148,0
3229,4,1,0,49,0.02040816326530612,0.0,1.0,49,1450,1000,450,0.6896551724137931,19,10,9,367.37900824776864,0.45541028911564624,0.34594086039921224,0.1909986152827403,126609.8800447406,-497.2375669588574,126112.64247778174,842,0,187.3877551020408,36,13,18,39.151840662414685,0.5859375,48.39527027027027,1006.4189189189182,27.95608108108106,0
3230,4,2,2,49,0.0392156862745098,0.0392156862745098,0.9607843137254902,51,1500,900,600,0.6,21,9,12,355.3699013565107,0.4581045751633987,0.34729265116199737,0.18733797837126281,127174.94956380788,-1160.2538980605568,126014.69566574732,843,0,181.0,37,14,20,38.873224444685995,0.5898085585585586,47.83442982456139,1008.6622807017527,27.261142721668993,0
3231,4,2,1,50,0.0392156862745098,0.0196078431372549,0.9803921568627451,51,1900,1400,500,0.7368421052631579,24,14,10,353.2817618350616,0.4572222222222222,0.36120584501257147,0.18759658499241594,127469.34125940541,-1193.4813079845044,126275.8599514209,844,0,181.68627450980392,38,13,17,38.62388030751869,0.5910087719298245,47.542735042735046,1009.8290598290603,26.574448942870006,0
3232,4,1,2,49,0.0196078431372549,0.0392156862745098,0.9607843137254902,51,1500,900,600,0.6,21,9,12,354.71262438202353,0.4571078431372549,0.36352779453750417,0.1889868895087772,127604.23657909635,-1147.4332721528242,126456.80330694353,845,0,182.64705882352942,38,13,18,38.4494730534701,0.5923793859649122,47.409188034188034,1010.3632478632479,26.58850652271705,0
3233,4,0,0,49,0.0,0.0,1.0,49,1400,800,600,0.5714285714285714,20,8,12,373.1249523256591,0.4531958616780045,0.3692998948408268,0.19795493032851275,127432.8953108516,-290.3214024835422,127142.57390836805,846,1,190.44897959183675,36,13,18,38.160365082905784,0.5943287037037037,47.57882882882884,1009.6846846846864,28.046796796796844,0
3234,4,1,1,49,0.02,0.02,0.98,50,1750,1400,350,0.8,21,14,7,367.4073179567685,0.4539710884353742,0.3678021978021977,0.19667097608274076,127793.20987654319,-609.5679012345702,127183.64197530862,847,0,187.62,38,12,19,37.934981684981686,0.5942982456140351,47.22222222222222,1011.111111111111,26.60818713450292,0
3235,4,1,0,50,0.02,0.0,1.0,50,1100,800,300,0.7272727272727273,14,8,6,367.06421785249586,0.45490646258503403,0.3667161931532976,0.19796029637405038,128093.08824319183,-596.3221503404138,127496.76609285141,848,0,183.84,40,10,20,37.636365157447365,0.5940104166666667,46.92581300813008,1012.2967479674793,25.307418699186982,0
3236,4,0,2,48,0.0,0.04,0.96,50,1300,800,500,0.6153846153846154,18,8,10,365.61136326530624,0.4551360544217687,0.36028800000000016,0.19771937135793752,128203.13169795947,-625.4440097695885,127577.68768818988,849,1,184.84,35,15,20,37.560476190476194,0.6041666666666667,46.817129629629626,1012.731481481481,28.93518518518517,0
3237,4,3,0,51,0.058823529411764705,0.0,1.0,51,1150,600,550,0.5217391304347826,17,6,11,360.0156404336121,0.4544934640522876,0.38885747624462885,0.19782699197476633,128839.3438966797,-923.164218798099,127916.17967788159,850,0,181.84313725490196,37,14,18,37.05212495949887,0.6067004504504505,46.18969298245614,1015.241228070175,27.43895211000473,0
3238,4,0,0,51,0.0,0.0,1.0,51,1250,800,450,0.64,17,8,9,356.3865877712032,0.45446078431372544,0.3844343891402715,0.1963146458061712,128936.767578125,-1009.7330729166636,127927.03450520834,851,1,182.84313725490196,39,12,18,37.0448717948718,0.6041666666666667,46.09375,1015.625,26.041666666666668,0
3239,4,1,2,50,0.019230769230769232,0.038461538461538464,0.9615384615384616,52,1800,1100,700,0.6111111111111112,25,11,14,351.3491301096884,0.4551282051282051,0.3778331899525569,0.19526363040126743,129287.27027280662,-1313.9209416341942,127973.34933117243,852,0,180.30769230769232,36,16,19,36.81578267449156,0.6131365740740741,45.748873873873876,1017.0045045045048,28.250125125125134,0
3240,4,0,0,50,0.0,0.0,1.0,50,1400,700,700,0.5,21,7,14,365.2410437340382,0.45195578231292516,0.3814596697865178,0.2015715081176417,129011.3768924866,-575.9500100445686,128435.42688244203,853,1,188.28,38,12,20,36.743918042556174,0.6066337719298245,46.02029914529914,1015.9188034188029,26.73470535312639,0
3241,4,2,1,51,0.038461538461538464,0.019230769230769232,0.9807692307692307,52,1400,1100,300,0.7857142857142857,17,11,6,354.62650507750766,0.4550732151835093,0.4014990200111306,0.19953232914007019,129772.26382725181,-1195.5834748703346,128576.68035238147,854,0,182.0,38,14,17,36.23912131697599,0.6143092105263157,45.2724358974359,1018.9102564102565,26.813427800269906,0
3242,4,1,1,51,0.019230769230769232,0.019230769230769232,0.9807692307692307,52,1650,1400,250,0.8484848484848485,19,14,5,354.53249494978223,0.4550339366515837,0.40102959546836625,0.20076504673529863,130023.43885633661,-1180.4931640625168,128842.9456922741,855,0,182.55769230769232,39,13,18,35.98638630715283,0.6151175213675213,45.02604166666666,1019.8958333333318,26.151175213675174,0
3243,4,0,1,50,0.0,0.0196078431372549,0.9803921568627451,51,1250,700,550,0.56,18,7,11,360.4186322811658,0.4542483660130719,0.40180976508805366,0.20363972811481135,129935.60209155151,-833.7576019066491,129101.84448964486,856,1,187.07843137254903,38,13,19,35.92554752174368,0.615953947368421,45.11217948717948,1019.5512820512812,26.83029689608635,0
3244,4,1,1,50,0.0196078431372549,0.0196078431372549,0.9803921568627451,51,1250,500,750,0.4,20,5,15,351.09967869748465,0.4545588235294118,0.39089012007387103,0.2005017776794762,130351.2158805941,-1045.1023418095785,129306.11353878453,857,0,182.3921568627451,35,16,21,35.74145698741924,0.6258928571428571,44.70486111111111,1021.1805555555553,29.176587301587293,0
3245,4,1,0,51,0.0196078431372549,0.0,1.0,51,1350,800,550,0.5925925925925926,19,8,11,340.89529964194173,0.45441176470588235,0.38256314532674085,0.1967742175160912,130766.7743921207,-1284.4442520775606,129482.33014004314,858,0,181.66666666666666,37,14,19,35.58149299599769,0.6261261261261262,44.29824561403509,1022.8070175438601,27.643432906590814,0
3246,4,0,0,51,0.0,0.0,1.0,51,850,400,450,0.47058823529411764,13,4,9,341.1995197614409,0.4540686274509804,0.383310113242596,0.19737958579628082,130850.9003371231,-1270.7471289242737,129580.15320819883,859,1,182.66666666666666,37,14,19,35.4886712749616,0.6269707207207207,44.21600877192983,1023.1359649122818,27.652323376007615,0
3247,4,0,1,50,0.0,0.0196078431372549,0.9803921568627451,51,1300,900,400,0.6923076923076923,17,9,8,342.7478372292968,0.4536764705882353,0.3839625402399762,0.19890169766771024,130972.46334876568,-1221.8942901234284,129750.56905864226,860,2,183.66666666666666,38,13,20,35.32620985979195,0.6263706140350878,44.097222222222236,1023.6111111111131,26.937134502924028,0
3248,4,1,0,51,0.0196078431372549,0.0,1.0,51,1200,800,400,0.6666666666666666,16,8,8,348.0117809329437,0.4540522875816993,0.4004799251087905,0.2036898727571528,131300.74929003234,-1061.158480349165,130239.59080968317,861,0,184.33333333333334,38,13,21,34.85983703394836,0.6296600877192983,43.77670940170941,1024.893162393164,26.970872694556945,0
3249,4,0,1,50,0.0,0.0196078431372549,0.9803921568627451,51,1900,1600,300,0.8421052631578947,22,16,6,347.3664571958476,0.453218954248366,0.4061226386289112,0.20440647700329345,131506.13667052463,-1063.8272803437112,130442.30939018092,862,1,185.33333333333334,35,16,21,34.66909275558564,0.6375,43.576388888888886,1025.6944444444441,29.305555555555546,0
3250,4,0,2,48,0.0,0.04,0.96,50,1600,1000,600,0.625,22,10,12,354.8327033238205,0.45264455782312923,0.4070907824471788,0.2084944683786762,131450.1771541951,-671.4356575963571,130778.74149659873,863,2,182.3,34,16,21,34.53414015943039,0.639093137254902,43.63095238095239,1025.4761904761913,30.16106442577033,0
3251,4,0,0,48,0.0,0.0,1.0,48,1500,900,600,0.6,21,9,12,361.3510695604207,0.4501145094562648,0.40233588790834496,0.21198606342332038,131389.1439909297,-104.47845804988788,131284.66553287982,864,3,182.4375,34,14,22,34.42870413376685,0.6384803921568627,43.69047619047619,1025.2380952380952,30.15406162464986,0
3252,4,0,0,48,0.0,0.0,1.0,48,1550,1100,450,0.7096774193548387,20,11,9,363.7881652254823,0.4494773197399527,0.40324428588003247,0.21461260753445804,131602.8220663265,-24.89016439909858,131577.9319019274,865,4,183.4375,34,14,19,34.15032679738562,0.640625,43.482142857142854,1026.0714285714282,30.178571428571416,0
3253,4,0,0,48,0.0,0.0,1.0,48,1450,1100,350,0.7586206896551724,18,11,7,363.03692694660293,0.4495234929078014,0.4014826413051886,0.21468480000916396,131694.45153061222,-38.010204081640154,131656.4413265306,866,5,184.4375,34,14,19,34.07707028531663,0.6415441176470589,43.39285714285714,1026.428571428571,30.18907563025209,0
3254,4,0,1,47,0.0,0.020833333333333332,0.9791666666666666,48,1600,1000,600,0.625,22,10,12,360.47447450320976,0.4490340573286052,0.3962052708864672,0.2138550768270073,131816.6737528344,-96.69075963719763,131719.98299319722,867,6,185.4375,34,14,19,34.019485663497946,0.6427696078431373,43.27380952380952,1026.9047619047615,30.203081232492984,0
3255,4,0,0,47,0.0,0.0,1.0,47,2000,1300,700,0.65,27,13,14,371.72541914908584,0.4483695652173913,0.401318864435368,0.21988503607293358,131705.23356401373,391.63663014223977,132096.87019415598,868,7,190.0212765957447,33,14,19,33.84322269977715,0.6439393939393939,43.382352941176464,1026.4705882352932,31.10516934046343,0
3256,4,2,0,49,0.04081632653061224,0.0,1.0,49,1750,1300,450,0.7428571428571429,22,13,9,358.3381738424125,0.4493870464852608,0.396158463385355,0.21570647959599773,132368.22601862552,-313.4823227452117,132054.74369588032,869,0,183.22448979591837,35,14,23,33.518562778840035,0.6461309523809524,42.73726851851851,1029.0509259259247,29.401455026454993,0
3257,4,0,0,49,0.0,0.0,1.0,49,1900,1600,300,0.8421052631578947,22,16,6,358.67131715115056,0.44954648526077096,0.39192354782625105,0.2171354488925543,132581.84700963701,-289.3355115644768,132292.51149807253,870,1,184.22448979591837,34,15,24,33.29504296227795,0.6504289215686274,42.52976190476189,1029.880952380951,30.29061624649856,0
3258,4,0,0,49,0.0,0.0,1.0,49,1150,700,450,0.6086956521739131,16,7,9,358.99812528146987,0.44933390022675734,0.39488805230830226,0.21751062884700784,132612.49999999977,-278.4722222222496,132334.02777777752,871,2,185.22448979591837,34,15,24,33.255798274002146,0.6507352941176471,42.499999999999986,1029.9999999999982,30.29411764705877,0
3259,4,0,1,48,0.0,0.02040816326530612,0.9795918367346939,49,1750,1500,250,0.8571428571428571,20,15,5,358.7250820007465,0.4481292517006803,0.39862735716760467,0.21859257459848436,132827.17013888882,-270.31250000000466,132556.85763888882,872,3,186.22448979591837,34,15,19,33.047022365939114,0.6528799019607843,42.291666666666664,1030.8333333333328,30.318627450980376,0
3260,4,0,1,47,0.0,0.020833333333333332,0.9791666666666666,48,1350,800,550,0.5925925925925926,19,8,11,368.9943208656846,0.4482491134751773,0.39592248108086725,0.22511596964778857,132871.38848339583,205.75755118224055,133077.14603457807,873,4,184.75,33,15,19,32.737900669598645,0.6556186868686869,42.24877450980392,1031.0049019607845,31.24257278669044,0
3261,4,0,0,47,0.0,0.0,1.0,47,1100,800,300,0.7272727272727273,14,8,6,379.04297084764244,0.4467121492445267,0.40790787528645533,0.2303328134838134,132723.06596584557,661.5490447403627,133384.61501058593,874,5,189.59574468085106,32,15,19,32.62825225666789,0.6565755208333333,42.39267676767678,1030.429292929295,32.200915404040465,0
3262,4,0,0,47,0.0,0.0,1.0,47,1600,1000,600,0.625,22,10,12,377.3168733659248,0.4463074313906876,0.40383039426958445,0.22999924193870733,132839.8032006922,624.5398404460001,133464.3430411382,875,6,190.59574468085106,33,14,19,32.55517910920907,0.6553030303030303,42.27941176470589,1030.8823529411777,31.23885918003569,0
3263,4,0,0,47,0.0,0.0,1.0,47,1100,600,500,0.5454545454545454,16,6,10,376.43750930982014,0.44615325316065374,0.3988230506143846,0.23043451024441888,132997.76715986652,613.0696426855186,133610.83680255205,876,7,191.59574468085106,33,14,19,32.4188893509168,0.6568813131313131,42.126225490196084,1031.4950980392166,31.257427213309594,0
3264,4,0,0,47,0.0,0.0,1.0,47,1000,600,400,0.6,14,6,8,376.4294604905695,0.4455750847980265,0.3994167163783384,0.23089272003338762,133072.72002551024,618.4984410430895,133691.2184665533,877,8,192.59574468085106,34,13,19,32.343707934310224,0.6553308823529411,42.05357142857143,1031.7857142857147,30.346638655462197,0
3265,4,0,0,47,0.0,0.0,1.0,47,1650,1100,550,0.6666666666666666,22,11,11,379.2555651631845,0.44505473327166206,0.404636962121935,0.23362980947897827,133233.13185871052,705.881344307265,133939.0132030178,878,9,193.59574468085106,35,12,20,32.10949177877428,0.6547619047619048,41.898148148148145,1032.4074074074072,29.49735449735449,0
3266,4,0,0,47,0.0,0.0,1.0,47,1400,1000,400,0.7142857142857143,18,10,8,380.91068741045723,0.4444572926302806,0.4086517829043368,0.23540491512817985,133352.6502486281,759.0899348422304,134111.74018347033,879,10,194.59574468085106,35,12,21,31.94662333781563,0.655952380952381,41.7824074074074,1032.870370370369,29.510582010581974,0
3267,4,0,0,47,0.0,0.0,1.0,47,1100,900,200,0.8181818181818182,13,9,4,380.344892980766,0.4444765649090348,0.40226518165069414,0.23562379317413581,133442.324205354,750.821303798004,134193.145509152,880,11,195.59574468085106,35,12,21,31.871125984839992,0.6568452380952381,41.69560185185185,1033.217592592592,29.520502645502628,0
3268,4,0,0,47,0.0,0.0,1.0,47,2100,1700,400,0.8095238095238095,25,17,8,378.66400125783326,0.44303114400246685,0.39994958152667137,0.23638492386213855,133725.6103421761,727.4216345223953,134453.0319766985,881,12,196.59574468085106,33,14,17,31.630134281200633,0.6641414141414141,41.42156862745098,1034.3137254901962,31.342840166369584,0
3269,4,0,0,47,0.0,0.0,1.0,47,1450,900,550,0.6206896551724138,20,9,11,377.79256154331745,0.44218316373728034,0.3984031211722543,0.23624628181842114,133788.99491782006,708.8974192618207,134497.8923370819,882,13,197.59574468085106,33,14,17,31.589078417436625,0.6647727272727273,41.36029411764706,1034.5588235294117,31.350267379679142,0
3270,4,0,1,46,0.0,0.02127659574468085,0.9787234042553191,47,1600,1300,300,0.8125,19,13,6,374.79234737641707,0.442240980573543,0.3938576269478353,0.23497560308788729,133884.09994052764,635.7472186178343,134519.84715914546,883,14,198.59574468085106,33,14,17,31.57131932109729,0.665719696969697,41.268382352941174,1034.926470588235,31.36140819964348,0
3271,4,0,1,45,0.0,0.021739130434782608,0.9782608695652174,46,1600,1100,500,0.6875,21,11,10,381.48005633573354,0.4419082125603864,0.3965401998854159,0.23903750319018902,133863.92332415062,1013.2834022038592,134877.2067263545,884,15,194.84782608695653,32,14,17,31.418527330405073,0.66796875,41.28787878787879,1034.848484848485,32.339015151515156,0
3272,4,0,0,45,0.0,0.0,1.0,45,1350,1000,350,0.7407407407407407,17,10,7,377.36762874055313,0.4408670033670034,0.3807640724987549,0.23770608272368365,134057.18714569157,1117.768565759634,135174.9557114512,885,16,195.6,34,11,18,31.331187492815264,0.6651348039215687,41.101190476190474,1035.5952380952378,30.45868347338935,0
3273,4,0,0,45,0.0,0.0,1.0,45,1200,1000,200,0.8333333333333334,14,10,4,375.10379960152846,0.44006734006734005,0.3773310358031783,0.23747480549318586,134242.1786422903,1070.9502551020496,135313.12889739234,886,17,196.6,34,11,19,31.20452804901399,0.6669730392156863,40.92261904761905,1036.309523809524,30.479691876750707,0
3274,4,0,0,45,0.0,0.0,1.0,45,1250,700,550,0.56,18,7,11,380.0837376127243,0.4392676767676768,0.3829040201069138,0.24144050115749202,134365.57716836737,1214.0341553288035,135579.61132369618,887,18,197.6,34,11,20,30.951936693841617,0.6681985294117647,40.80357142857143,1036.7857142857144,30.493697478991603,0
3275,4,0,1,44,0.0,0.022222222222222223,0.9777777777777777,45,1550,1100,450,0.7096774193548387,20,11,9,378.8226259622264,0.43903619528619525,0.38227628592558593,0.2416588845267085,134519.90504535136,1191.8367346938635,135711.74178004524,888,19,198.6,34,11,20,30.83017749215821,0.6697303921568627,40.6547619047619,1037.3809523809516,30.511204481792696,0
3276,4,0,0,44,0.0,0.0,1.0,44,1700,1500,200,0.8823529411764706,19,15,4,380.26788066500455,0.4378083157152925,0.36894386605130425,0.2436360778542046,134677.95589436736,1442.743715133094,136120.69960950044,889,20,198.47727272727272,33,11,20,30.63459268004723,0.6736111111111112,40.50245098039215,1037.99019607843,31.45424836601303,0
3277,4,0,0,44,0.0,0.0,1.0,44,1350,1000,350,0.7407407407407407,17,10,7,382.6836174415467,0.43726876321353064,0.37212925717350465,0.24625995883197474,134837.00867755187,1519.9828491445498,136356.99152669642,890,21,199.47727272727272,33,11,19,30.412856440511284,0.6751893939393939,40.34926470588235,1038.6029411764703,31.472816399286977,0
3278,4,0,1,43,0.0,0.022727272727272728,0.9772727272727273,44,950,800,150,0.8421052631578947,11,8,3,386.77910288358873,0.43643190627202255,0.3811427958833622,0.24999137137597788,134996.1553248749,1642.738369857731,136638.89369473263,891,22,200.47727272727272,33,11,19,30.14740566037736,0.6767676767676767,40.19607843137254,1039.2156862745087,31.49138443256087,0
3279,4,0,0,43,0.0,0.0,1.0,43,1650,1300,350,0.7878787878787878,20,13,7,381.2006781603601,0.43620801033591733,0.3612271526155937,0.24725585271502246,135123.54022491345,1701.8370338331345,136825.3772587466,892,23,201.7674418604651,33,10,19,30.165114725758297,0.678030303030303,40.0735294117647,1039.7058823529408,31.506238859180023,0
3280,4,0,0,43,0.0,0.0,1.0,43,1150,800,350,0.6956521739130435,15,8,7,379.4807201824535,0.4361618678479144,0.35683396455995897,0.24657529796847621,135187.255202326,1660.1913927335568,136847.44659505956,893,24,202.7674418604651,33,10,20,30.146221227119174,0.6786616161616161,40.01225490196078,1039.9509803921565,31.51366607248959,0
3281,4,0,0,43,0.0,0.0,1.0,43,1200,700,500,0.5833333333333334,17,7,10,378.5089616542948,0.43595422665190103,0.3545061133674361,0.24645389768518816,135261.9118480724,1639.5691609977168,136901.48100907012,894,25,203.7674418604651,34,9,20,30.096990157930883,0.6770833333333333,39.94047619047618,1040.238095238094,30.59523809523806,0
3282,4,0,0,43,0.0,0.0,1.0,43,1150,700,450,0.6086956521739131,16,7,9,374.82987354363047,0.4357235142118863,0.3487041973259273,0.244900056391511,135385.77806122444,1549.3268140589532,136935.1048752834,895,26,204.7674418604651,34,9,20,30.069158468695193,0.6783088235294117,39.82142857142857,1040.7142857142853,30.60924369747898,0
3283,4,0,2,41,0.0,0.046511627906976744,0.9534883720930233,43,1400,1000,400,0.7142857142857143,18,10,8,376.1901193772008,0.43503137689184196,0.3511845057751768,0.24666226777822853,135513.14407578853,1595.7411694101263,137108.88524519865,896,27,205.7674418604651,35,8,21,29.906810434267072,0.6773809523809524,39.69907407407406,1041.203703703702,29.748677248677204,0
3284,4,0,0,41,0.0,0.0,1.0,41,1150,800,350,0.6956521739130435,15,8,7,353.5672179259622,0.43470528455284557,0.2394966868743833,0.22184968958981358,133914.18292059316,1269.533019212505,135183.71593980567,878,28,188.390243902439,38,3,15,32.09038673272779,0.6557017543859649,41.23931623931624,1035.0427350427349,27.237966711650916,8
3285,4,0,0,41,0.0,0.0,1.0,41,950,600,350,0.631578947368421,13,6,7,356.46272848393056,0.4342225609756098,0.24260363965868748,0.22400284299671133,133969.47937212363,1351.0252301117737,135320.50460223542,879,29,189.390243902439,38,3,15,31.96013931888544,0.65625,41.18589743589744,1035.2564102564106,27.24358974358975,0
3286,4,0,0,41,0.0,0.0,1.0,41,1400,1000,400,0.7142857142857143,18,10,8,356.928260308169,0.43310467479674797,0.2518002801972956,0.22548099936210497,134163.10683988954,1377.3208643801472,135540.42770426968,880,30,190.390243902439,38,3,16,31.75445154858891,0.6581688596491229,40.99893162393162,1036.0042735042725,27.263270355375592,0
3287,4,0,0,41,0.0,0.0,1.0,41,1100,900,200,0.8181818181818182,13,9,4,354.62383939577404,0.43252032520325207,0.253085859836385,0.2245800495320533,134253.7448459202,1321.9156901041724,135575.6605360244,881,31,191.390243902439,39,2,17,31.723560994404796,0.6573183760683761,40.911458333333336,1036.3541666666672,26.573183760683776,0
3288,4,0,0,41,0.0,0.0,1.0,41,1450,1100,350,0.7586206896551724,18,11,7,353.5320255464215,0.4322916666666667,0.2516820223975529,0.22421906859225244,134307.72705078125,1296.4165581597222,135604.14360894097,882,32,192.390243902439,39,2,17,31.697923994238437,0.6578525641025641,40.859375,1036.5625,26.578525641025642,0
3289,4,0,1,40,0.0,0.024390243902439025,0.975609756097561,41,1250,1000,250,0.8,15,10,5,352.9680992735974,0.4315294715447155,0.25374476100892385,0.22485626132227823,134469.73876953125,1292.7056206597226,135762.44439019097,883,33,193.390243902439,39,2,19,31.550772488366636,0.6594551282051282,40.703125,1037.1875,26.59455128205128,0
3290,4,0,0,40,0.0,0.0,1.0,40,1200,900,300,0.75,15,9,6,358.9215986420197,0.4311832264957265,0.2639895972808739,0.22880957329056903,134495.3649485899,1654.6582794579385,136150.02322804785,884,34,197.925,38,2,19,31.370807154873486,0.6614583333333333,40.67841880341879,1037.2863247863233,27.29700854700851,0
3291,4,0,0,40,0.0,0.0,1.0,40,1300,800,500,0.6153846153846154,18,8,10,359.61365526032506,0.4306891025641026,0.2635722253206918,0.2297887683113907,134580.80317911942,1679.4531546453968,136260.25633376482,885,35,198.925,35,5,19,31.267545082729136,0.6681547619047619,40.59606481481481,1037.61574074074,29.646164021163997,0
3292,4,0,0,40,0.0,0.0,1.0,40,1350,900,450,0.6666666666666666,18,9,9,363.8572275477904,0.42984775641025647,0.2638628762541808,0.23346204085147917,134730.96305941354,1804.5669367283892,136535.52999614194,886,36,199.925,35,5,20,31.007525083612038,0.6696428571428572,40.451388888888886,1038.1944444444441,29.662698412698404,0
3293,4,0,0,40,0.0,0.0,1.0,40,1400,1000,400,0.7142857142857143,18,10,8,357.68914740637933,0.42885950854700855,0.24963414634146353,0.23058577112675394,134901.51627556607,1650.5616680870057,136552.07794365307,887,37,200.925,36,4,17,30.997515808491414,0.6692708333333333,40.28716216216216,1038.8513513513512,28.856981981981978,0
3294,4,0,0,40,0.0,0.0,1.0,40,1350,1000,350,0.7407407407407407,17,10,7,353.86512133027134,0.4275774572649573,0.2425316455696207,0.22914216873025742,135063.19252077542,1558.8306017235864,136622.023122499,888,38,201.925,37,3,17,30.93574191279887,0.6689189189189189,40.13157894736841,1039.4736842105249,28.093883357041214,0
3295,4,0,0,40,0.0,0.0,1.0,40,1100,700,400,0.6363636363636364,15,7,8,354.0465897954512,0.4271367521367522,0.24715016345038476,0.22980313559413165,135148.68907981302,1569.7864968067095,136718.47557661973,889,39,202.925,37,3,17,30.845877710991594,0.6697635135135135,40.04934210526316,1039.8026315789475,28.10277382645804,0
3296,4,0,1,39,0.0,0.025,0.975,40,950,700,250,0.7368421052631579,12,7,5,353.85426945619054,0.42633547008547007,0.25016863406408074,0.23058855141485837,135291.2434595261,1574.6768236380524,136865.92028316416,890,40,203.925,37,3,17,30.708965711073642,0.6711711711711712,39.91228070175439,1040.3508771929833,28.117591275486035,0
3297,4,0,1,38,0.0,0.02564102564102564,0.9743589743589743,39,1150,1000,150,0.8695652173913043,13,10,3,360.5165757763158,0.4256354026090868,0.24693639693639668,0.23525234182013843,135340.57706355015,1958.504281308347,137299.0813448585,891,41,203.35897435897436,36,3,18,30.486562049062037,0.6736111111111112,39.86486486486487,1040.5405405405415,28.90390390390393,0
3298,4,0,0,38,0.0,0.0,1.0,38,1000,700,300,0.7,13,7,6,381.3749156687466,0.4256015884305358,0.16942925495557026,0.22589129620379625,131755.55555555562,2536.4361405324294,134291.99169608805,892,42,207.92105263157896,34,4,16,33.54471049783549,0.642156862745098,43.333333333333336,1026.6666666666672,30.196078431372566,8
3299,4,1,0,39,0.02564102564102564,0.0,1.0,39,1050,600,450,0.5714285714285714,15,6,9,373.0988948069959,0.4268724696356276,0.18131394023346736,0.22353227783952506,132189.63162562152,2063.961092892655,134253.59271851418,893,0,203.56410256410257,35,4,19,33.31891296192083,0.6443452380952381,42.910879629629626,1028.356481481481,29.381613756613746,0
3300,4,0,0,39,0.0,0.0,1.0,39,900,400,500,0.4444444444444444,14,4,10,370.97639752362426,0.42659131803868644,0.18190646189770554,0.2229763399852522,132311.09487866246,2016.8586660985366,134327.953544761,894,1,204.56410256410257,36,3,20,33.251012478108585,0.6435185185185186,42.792792792792795,1028.828828828829,28.578578578578586,0
3301,4,0,0,39,0.0,0.0,1.0,39,1100,700,400,0.6363636363636364,15,7,8,371.3111536082228,0.42535425101214575,0.18923231136971652,0.22387421437215427,132428.6352040815,2034.5029288803312,134463.13813296185,895,2,205.56410256410257,34,5,20,33.123939779474135,0.6488970588235294,42.67857142857142,1029.2857142857133,30.27310924369745,0
3302,4,0,0,39,0.0,0.0,1.0,39,1050,700,350,0.6666666666666666,14,7,7,368.0823326949952,0.4260290148448043,0.19000184467810421,0.22244975758523616,132517.14677640592,1955.4441015089067,134472.59087791483,896,3,206.56410256410257,35,4,20,33.117880695443645,0.6476190476190475,42.59259259259259,1029.6296296296289,29.417989417989396,0
3303,4,0,1,38,0.0,0.02564102564102564,0.9743589743589743,39,750,500,250,0.6666666666666666,10,5,5,369.80399198252655,0.4257759784075574,0.19120245084053078,0.22366730908691634,132546.9409749014,2003.2775795181703,134550.21855441958,897,4,207.56410256410257,35,4,20,33.0435586901952,0.6479166666666667,42.563657407407405,1029.7453703703702,29.42129629629629,0
3304,4,0,0,38,0.0,0.0,1.0,38,1300,900,400,0.6923076923076923,17,9,8,372.74805153477126,0.4235567804646752,0.17722624095784512,0.2256573403658016,132581.84700963713,2283.9250283446722,134865.7720379818,849,5,190.42105263157896,34,4,20,32.93260894694256,0.6504289215686274,42.529761904761905,1029.880952380952,30.29061624649859,0
3305,4,0,0,38,0.0,0.0,1.0,38,1100,700,400,0.6363636363636364,15,7,8,367.3508078049415,0.42262328117591275,0.16727260567961366,0.22348249776299203,132765.81809807254,2154.3261054421732,134920.1442035147,850,6,191.42105263157896,34,4,18,32.88644064533517,0.6522671568627452,42.351190476190474,1030.595238095238,30.311624649859944,0
3306,4,0,1,37,0.0,0.02631578947368421,0.9736842105263158,38,1250,800,450,0.64,17,8,9,366.3010878653148,0.4225491939307729,0.16451773627094735,0.22375881686102658,132919.2247732427,2137.691326530619,135056.9160997733,851,7,192.42105263157896,34,4,18,32.75922612175787,0.6537990196078431,42.202380952380956,1031.1904761904766,30.329131652661076,0
3307,4,0,1,36,0.0,0.02702702702702703,0.972972972972973,37,750,500,250,0.6666666666666666,10,5,5,372.5611623765896,0.4219532032032032,0.16438576253104853,0.2269089020093769,132808.22167255386,2495.8370878988894,135304.05876045275,852,8,196.16216216216216,33,4,18,32.70952225260571,0.6549873737373737,42.310049019607845,1030.7598039215688,31.235145573380873,0
3308,4,0,0,36,0.0,0.0,1.0,36,1550,1100,450,0.7096774193548387,20,11,9,370.9417406387103,0.42086640211640214,0.1717732884399552,0.2266866192792119,132934.5703125,2662.1961805555557,135596.76649305556,853,9,200.22222222222223,33,3,18,32.62415824915825,0.65625,42.1875,1031.25,31.25,0
3309,4,0,0,36,0.0,0.0,1.0,36,1150,900,250,0.782608695652174,14,9,5,367.6276265239524,0.42007275132275135,0.1638052575588631,0.22586561972616145,133134.1429280043,2615.884530895666,135750.02745889995,854,10,201.22222222222223,34,2,18,32.509036028761486,0.6559436274509804,41.994047619047606,1032.0238095238076,30.353641456582576,8
3310,4,0,0,36,0.0,0.0,1.0,36,950,600,350,0.631578947368421,13,6,7,368.3768582093111,0.4194279100529101,0.16668588560885644,0.22688665585164358,133226.3038548751,2615.497448979564,135841.80130385465,855,11,202.22222222222223,34,2,18,32.39713061193112,0.6568627450980392,41.90476190476189,1032.3809523809507,30.364145658263254,0
3311,4,1,0,37,0.02702702702702703,0.0,1.0,37,1050,900,150,0.8571428571428571,12,9,3,361.71554391439196,0.4201076076076076,0.15935321591050133,0.22444462068183466,133502.1235880699,2257.958649476994,135760.08223754689,856,0,197.72972972972974,35,2,19,32.292366633068276,0.6574404761904762,41.63773148148147,1033.449074074072,29.527116402116345,0
3312,4,0,0,37,0.0,0.0,1.0,37,1350,1100,250,0.8148148148148148,16,11,5,361.921119766224,0.41882507507507505,0.1636623194367155,0.22584686635691156,133711.5269204387,2278.605109739337,135990.13203017804,857,1,198.72972972972974,35,2,15,32.077178454192776,0.6595238095238095,41.43518518518517,1034.259259259257,29.550264550264487,0
3313,4,0,0,37,0.0,0.0,1.0,37,850,600,250,0.7058823529411765,11,6,5,362.28422725442664,0.41844969969969975,0.16216216216216206,0.22625675324757558,133741.4550781248,2290.4839409721944,136031.939019097,858,2,199.72972972972974,35,2,15,32.03780631084255,0.6598214285714286,41.406249999999986,1034.3749999999984,29.553571428571384,0
3314,4,0,0,37,0.0,0.0,1.0,37,550,200,350,0.36363636363636365,9,2,7,364.2796740423632,0.4189502002002002,0.16221053809150932,0.2278723587309084,133801.3214404362,2348.2203521518995,136149.5417925881,859,3,200.72972972972974,35,2,15,31.926226833724876,0.6604166666666667,41.34837962962962,1034.6064814814802,29.560185185185148,0
3315,4,0,1,36,0.0,0.02702702702702703,0.972972972972973,37,1200,900,300,0.75,15,9,6,366.8577047455085,0.41823073073073075,0.1649183568002759,0.23023217217818095,133921.0943528162,2425.9970582561523,136347.09141107235,860,4,201.72972972972974,35,2,15,31.739558872861448,0.6616071428571428,41.23263888888888,1035.0694444444432,29.573412698412664,0
3316,4,0,2,34,0.0,0.05555555555555555,0.9444444444444444,36,1000,600,400,0.6,14,6,8,374.43119794928714,0.4162698412698413,0.1767290412464695,0.23467414591010452,133872.32320011323,2825.194869614499,136697.51806972772,861,17,208.22222222222223,34,2,16,31.59246903638943,0.663296568627451,41.2797619047619,1034.8809523809514,30.437675070027982,0
3317,4,0,0,34,0.0,0.0,1.0,34,1400,1000,400,0.7142857142857143,18,10,8,399.4019622268995,0.41295306001188353,0.22585644846756092,0.22737784948184908,130230.36552392616,3632.841368488018,133863.20689241416,862,18,206.41176470588235,32,2,18,34.631422150750446,0.6315104166666667,44.823232323232325,1020.707070707071,31.89709595959597,8
3318,4,0,0,34,0.0,0.0,1.0,34,1150,800,350,0.6956521739130435,15,8,7,392.9649260947113,0.41143048128342247,0.21866659879429573,0.2246426351364045,130391.51178770048,3447.8581586062955,133839.36994630678,863,19,207.41176470588235,32,2,18,34.631649977335485,0.6331380208333333,44.665404040404056,1021.3383838383858,31.916824494949555,0
3319,4,0,0,34,0.0,0.0,1.0,34,1250,1100,150,0.88,14,11,3,399.4291601693026,0.41143048128342247,0.2083406496927127,0.21935863714215806,128816.57483930222,3521.260266809523,132337.83510611174,864,20,208.41176470588235,32,2,16,36.07509328358208,0.6171875,46.21212121212122,1015.151515151516,31.723484848484876,8
3320,4,1,0,35,0.02857142857142857,0.0,1.0,35,650,400,250,0.6153846153846154,9,4,5,375.7792912586852,0.4146358543417367,0.1980449888116833,0.20080188559329726,127723.00347222204,2599.131944444425,130322.13541666647,865,0,203.42857142857142,34,1,18,37.79541082715033,0.6014093137254901,47.29166666666666,1010.8333333333319,29.730392156862703,8
3321,4,2,0,37,0.05405405405405406,0.0,1.0,37,1200,800,400,0.6666666666666666,16,8,8,363.11520997279854,0.4211398898898899,0.21167732618114288,0.19756715737497624,128446.04768990925,1929.5316043083826,130375.57929421763,866,0,193.3783783783784,34,3,18,37.375220199647664,0.6087622549019608,46.57738095238095,1013.6904761904758,29.814425770308112,0
3322,4,0,0,37,0.0,0.0,1.0,37,1050,1000,50,0.9523809523809523,11,10,1,363.6844541426966,0.42073323323323325,0.2115213805354652,0.1986276634163958,128596.93877551022,1953.7414965986432,130550.68027210886,867,1,194.3783783783784,34,3,18,37.20657276995305,0.6102941176470589,46.42857142857143,1014.2857142857144,29.831932773109248,0
3323,4,1,0,38,0.02631578947368421,0.0,1.0,38,1300,1000,300,0.7692307692307693,16,10,6,357.29820418815586,0.4243717401612139,0.2036370831384675,0.1972555746140653,129024.9445408953,1620.0761959876813,130645.02073688299,868,0,190.23684210526315,35,3,19,36.93181818181817,0.6125,46.00694444444446,1015.9722222222242,29.027777777777835,0
3324,4,0,2,36,0.0,0.05263157894736842,0.9473684210526316,38,950,500,450,0.5263157894736842,14,5,9,347.16511833606944,0.4235567804646752,0.09747517763595415,0.19168443681934041,129029.71172185717,1474.7843317698537,130504.49605362702,869,1,191.23684210526315,36,2,17,37.18433643685804,0.6105324074074074,46.00225225225226,1015.9909909909925,28.221971971972014,8
3325,4,0,0,36,0.0,0.0,1.0,36,1300,1000,300,0.7692307692307693,16,10,6,361.2155135951286,0.41722883597883603,0.12280968297376704,0.19912232081098294,128966.1565500686,2116.915294924558,131083.07184499316,870,4,202.72222222222223,35,1,18,36.892281981160735,0.611904761904762,46.06481481481482,1015.7407407407408,29.021164021164022,0
3326,4,0,0,36,0.0,0.0,1.0,36,1050,800,250,0.7619047619047619,13,8,5,360.99850072580955,0.41703042328042333,0.12164881901724023,0.19929841757051286,129024.94454089503,2115.562307098763,131140.5068479938,871,5,203.72222222222223,35,1,20,36.83783321941217,0.6125,46.00694444444444,1015.972222222222,29.02777777777777,0
3327,4,0,0,36,0.0,0.0,1.0,36,1000,800,200,0.8,12,8,4,358.7258264537854,0.41663359788359783,0.11866616046570488,0.19833833477734497,129083.74592764064,2061.134687928674,131144.88061556933,872,6,204.72222222222223,35,1,20,36.835611237661354,0.6130952380952381,45.949074074074076,1016.203703703704,29.034391534391546,0
3328,4,0,0,36,0.0,0.0,1.0,36,800,400,400,0.5,12,4,8,368.5809389018783,0.4164517195767196,0.12693248146395364,0.19135418277633137,126552.40929705209,2207.675588239405,128760.0848852915,873,7,205.72222222222223,34,2,14,39.18081519167061,0.5894607843137255,48.45238095238095,1006.1904761904757,29.59383753501399,7
3329,4,2,0,38,0.05263157894736842,0.0,1.0,38,1300,900,400,0.6923076923076923,17,9,8,352.32836640445686,0.42194167852062586,0.1316671468639199,0.18496722625726056,127006.86486740113,1349.6242441766044,128356.48911157774,874,0,195.8421052631579,36,2,16,39.12249096935166,0.5899884259259259,48.001126126126124,1007.995495495495,27.999874874874862,0
3330,4,2,1,39,0.05,0.025,0.975,40,700,500,200,0.7142857142857143,9,5,4,346.01044559835753,0.4250667735042735,0.16160714285714284,0.18521735617323862,127793.20987654333,843.5570987654462,128636.76697530878,875,0,187.0,38,2,17,38.475847069597066,0.5942982456140351,47.22222222222223,1011.1111111111121,26.608187134502952,0
3331,4,0,0,39,0.0,0.0,1.0,39,1250,800,450,0.64,17,8,9,348.6930703318728,0.4218679712100765,0.1573502419489401,0.1864820248526607,127756.25673284105,1109.544282856279,128865.80101569733,876,1,192.76923076923077,37,2,17,38.44586044830079,0.5957207207207207,47.25877192982457,1010.9649122807032,27.32337600758657,0
3332,4,1,0,40,0.025,0.0,1.0,40,1400,800,600,0.5714285714285714,20,8,12,341.24201933987007,0.4255608974358975,0.15216049382716057,0.18427069044353006,128144.53125000013,745.6597222222373,128890.19097222236,877,0,188.925,38,2,18,38.23731138545954,0.5978618421052632,46.87500000000001,1012.500000000001,26.64473684210529,0
3333,4,1,1,40,0.024390243902439025,0.024390243902439025,0.975609756097561,41,1350,1100,250,0.8148148148148148,16,11,5,331.1828858467148,0.4272865853658536,0.14682459120450408,0.18054318033148611,128523.41666894966,312.95120626051335,128836.36787521017,878,0,185.29268292682926,38,3,15,38.10561760264109,0.6016995614035088,46.50106837606838,1013.9957264957277,26.684098065677045,0
3334,4,2,1,41,0.047619047619047616,0.023809523809523808,0.9761904761904762,42,900,600,300,0.6666666666666666,12,6,6,327.2736627356431,0.42751887340301975,0.1616639063545804,0.17991745012319868,128857.43408203126,34.3288845486114,128891.76296657987,879,0,181.83333333333334,39,3,17,37.86474898259293,0.6033653846153846,46.171875,1015.3125000000001,26.03365384615385,0
3335,4,0,0,41,0.0,0.0,1.0,41,1000,700,300,0.7,13,7,6,335.37252905807134,0.4239583333333334,0.1582196122918822,0.18432881108379692,128848.62075617275,442.45756172838355,129291.07831790113,880,1,187.21951219512195,38,3,17,37.66814865481075,0.6049890350877193,46.18055555555555,1015.277777777777,26.717836257309923,0
3336,4,0,2,39,0.0,0.04878048780487805,0.9512195121951219,41,1400,1100,300,0.7857142857142857,17,11,6,338.05889201803154,0.4238313008130081,0.1534507963376157,0.18669802921553316,129038.51290269566,524.5233399079574,129563.03624260362,881,2,188.21951219512195,38,3,17,37.40667718191376,0.606907894736842,45.993589743589745,1016.0256410256416,26.73751686909583,0
3337,4,0,0,39,0.0,0.0,1.0,39,900,600,300,0.6666666666666666,12,6,6,348.51063099973675,0.4222053531264058,0.15583559276753678,0.19242735084942653,129029.71172185717,1193.645249979729,130223.3569718369,882,3,195.76923076923077,36,3,17,37.15016071824429,0.6105324074074074,46.00225225225226,1015.9909909909925,28.221971971972014,0
3338,4,0,0,39,0.0,0.0,1.0,39,950,700,250,0.7368421052631579,12,7,5,351.58469986673146,0.42175551057130006,0.16382871135807076,0.1946873313495166,129144.15048494453,1281.021477558655,130425.17196250318,883,4,196.76923076923077,36,3,18,36.95550816160722,0.6116898148148149,45.88963963963965,1016.4414414414425,28.234484484484515,0
3339,4,0,0,39,0.0,0.0,1.0,39,1500,1100,400,0.7333333333333333,19,11,8,352.628413512944,0.42085582546108863,0.16817805165552113,0.19613281632606028,129319.08543381348,1320.3294682946266,130639.41490210811,884,5,197.76923076923077,35,4,18,36.750872401759985,0.6154761904761905,45.717592592592595,1017.12962962963,29.06084656084657,0
3340,4,0,0,39,0.0,0.0,1.0,39,1200,800,400,0.6666666666666666,16,8,8,350.5784108431548,0.4204059829059829,0.16625413623708107,0.19601634604993948,129525.18332315248,1281.7465867198246,130806.9299098723,885,6,198.76923076923077,35,4,17,36.59335323100245,0.6175595238095238,45.5150462962963,1017.9398148148152,29.08399470899472,0
3341,4,1,1,39,0.025,0.025,0.975,40,1150,900,250,0.782608695652174,14,9,5,338.06644487098924,0.42143429487179485,0.10392347600518814,0.1848576092166896,128644.60699445962,729.5955383143554,129374.20253277398,886,0,194.775,37,3,17,37.80759115146274,0.6047297297297297,46.38157894736841,1014.4736842105247,27.41820768136553,8
3342,4,0,0,39,0.0,0.0,1.0,39,1000,800,200,0.8,12,8,4,344.96275661026783,0.421221322537112,0.10695336339208472,0.1885573125937678,128629.57552146743,1074.4825906988092,129704.05811216624,887,1,188.28205128205127,36,3,17,37.64801657785672,0.6064814814814814,46.3963963963964,1014.4144144144145,28.178178178178182,0
3343,4,1,2,38,0.025,0.05,0.95,40,950,800,150,0.8421052631578947,11,8,3,351.4551111728303,0.4239850427350427,0.09589680448974924,0.1874498824465477,127646.96830257651,1047.4443838037162,128694.41268638022,888,0,184.55,35,5,22,38.487978658420204,0.5985119047619047,47.36689814814816,1010.5324074074091,28.872354497354547,7
3344,4,2,0,40,0.05,0.0,1.0,40,1500,1100,400,0.7333333333333333,19,11,8,344.66092247399604,0.4277777777777778,0.14044508950169377,0.18698533510597076,128330.72015570903,849.0204435815834,129179.74059929061,889,0,182.725,33,7,25,37.960611191743276,0.6098484848484849,46.69117647058822,1013.2352941176446,30.704099821746805,0
3345,4,1,0,41,0.024390243902439025,0.0,1.0,41,950,600,350,0.631578947368421,13,6,7,336.58428471588184,0.4313770325203252,0.14756641347216104,0.18410598680030424,128657.32001133756,460.80640589565263,129118.12641723322,890,0,179.2439024390244,34,7,23,37.83222835015252,0.610906862745098,46.3690476190476,1014.523809523807,29.83893557422962,0
3346,4,1,0,42,0.023809523809523808,0.0,1.0,42,1000,500,500,0.5,15,5,10,328.70831231578893,0.433168795973674,0.14408971658722236,0.18136254956579373,129001.10995708522,80.7474281713829,129081.8573852566,891,0,175.95238095238096,36,6,24,37.682213723533955,0.6102430555555556,46.03040540540539,1015.8783783783764,28.21884384384379,0
3347,4,0,1,41,0.0,0.023809523809523808,0.9761904761904762,42,1100,800,300,0.7272727272727273,14,8,6,332.092054619864,0.4325880758807588,0.1432369978791428,0.18389342852753945,129144.1504849444,177.54925533642023,129321.69974028082,892,1,176.95238095238096,36,6,24,37.450836472413044,0.6116898148148149,45.88963963963964,1016.4414414414415,28.234484484484486,0
3348,4,1,2,40,0.023809523809523808,0.047619047619047616,0.9523809523809523,42,800,500,300,0.625,11,5,6,343.79400270520557,0.43491095625241966,0.09198770988313076,0.18603545418793113,128227.809578428,416.80306421825344,128644.61264264626,893,0,169.23809523809524,37,5,18,38.087650211107515,0.6005067567567568,46.79276315789474,1012.8289473684213,27.373755334281658,8
3349,4,0,0,40,0.0,0.0,1.0,40,1250,800,450,0.64,17,8,9,354.1747747030572,0.4278846153846154,0.16347175695968597,0.17919877408558543,125492.3820757245,896.6112744300052,126388.9933501545,894,1,178.55,35,5,13,40.6363106926957,0.5764880952380953,49.508101851851855,1001.967592592593,28.627645502645514,7
3350,4,1,0,41,0.024390243902439025,0.0,1.0,41,950,800,150,0.8421052631578947,11,8,3,348.30736596542795,0.43150406504065036,0.17056198844816706,0.17774448056998648,125846.02127465313,566.6192374807347,126412.64051213386,895,0,175.17073170731706,36,5,16,40.41830340441451,0.578125,49.15540540540541,1003.3783783783792,27.871621621621646,0
3351,4,0,0,41,0.0,0.0,1.0,41,1150,800,350,0.6956521739130435,15,8,7,351.20916715448953,0.43117378048780486,0.17330068533439058,0.17984088025171047,125987.30223044017,649.5790976787898,126636.88132811895,896,1,176.17073170731706,36,5,16,40.199803701626465,0.5795717592592593,49.014639639639654,1003.9414414414437,27.887262262262325,0
3352,4,1,1,41,0.023809523809523808,0.023809523809523808,0.9761904761904762,42,1000,700,300,0.7,13,7,6,343.7399919642014,0.43453590785907864,0.1770643278597568,0.1773539403625701,126298.3993283825,282.7748356464627,126581.17416402895,897,0,172.95238095238096,36,6,14,40.06693927851221,0.5827546296296297,48.70495495495496,1005.1801801801806,27.921671671671685,0
3353,4,0,1,40,0.0,0.024390243902439025,0.975609756097561,41,1000,600,400,0.6,14,6,8,349.56625387923094,0.43384146341463414,0.1684286211816517,0.18026326298617826,126276.38996056246,628.3929183813509,126904.7828789438,898,1,173.46341463414635,35,6,15,39.943190541992934,0.5845238095238094,48.726851851851855,1005.092592592593,28.716931216931226,0
3354,4,1,2,39,0.024390243902439025,0.04878048780487805,0.9512195121951219,41,1000,500,500,0.5,15,5,10,328.0044262871731,0.43394308943089427,0.13813000732373104,0.1692379645491095,126299.08954863176,85.33208159825148,126384.42163023,899,0,174.21951219512195,40,1,14,40.46165706197555,0.57578125,48.704268292682926,1005.1829268292681,25.129573170731703,8
3355,4,2,1,40,0.04878048780487805,0.024390243902439025,0.975609756097561,41,1300,900,400,0.6923076923076923,17,9,8,331.16892740051105,0.4342225609756098,0.18903915431406126,0.17313008483090006,126835.96073765618,200.82581466058616,127036.78655231676,900,0,174.70731707317074,40,1,16,39.83092884046275,0.58125,48.170731707317074,1007.3170731707319,25.182926829268297,0
3356,4,3,0,43,0.06976744186046512,0.0,1.0,43,900,400,500,0.4444444444444444,14,4,10,326.1861573143206,0.4347083794758213,0.23012413426858158,0.1740211428108379,127658.21468195255,-270.89871593938074,127387.31596601316,901,0,167.4418604651163,38,5,17,39.11486415054446,0.5929276315789473,47.355769230769226,1010.5769230769222,26.594129554655847,0
3357,4,1,0,44,0.022727272727272728,0.0,1.0,44,1500,1300,200,0.8666666666666667,17,13,4,321.31266344273496,0.4363107822410148,0.23015984427349512,0.1728256485427866,127986.37695312497,-575.2712673611122,127411.10568576386,902,0,164.61363636363637,39,5,18,38.903043716972086,0.594551282051282,47.03125,1011.8749999999998,25.945512820512814,0
3358,4,1,2,43,0.022222222222222223,0.044444444444444446,0.9555555555555556,45,900,600,300,0.6666666666666666,12,6,6,323.14392145667864,0.438047138047138,0.2505208507414458,0.17562475905653688,128401.90120174813,-701.5412246348299,127700.3599771133,903,0,161.93333333333334,40,5,14,38.43314449012331,0.5971354166666667,46.62093495934958,1013.5162601626004,25.33790650406501,0
3359,4,0,0,43,0.0,0.0,1.0,43,1100,900,200,0.8181818181818182,13,9,4,330.3354838916253,0.43773071244001477,0.24543662275754508,0.17922778771328202,128333.90404704482,-121.3515413836243,128212.5525056612,904,1,141.3953488372093,38,5,19,38.32024110783072,0.5997807017543859,46.68803418803417,1013.2478632478612,26.664417453891087,0
3360,4,1,0,44,0.022727272727272728,0.0,1.0,44,750,500,250,0.6666666666666666,10,5,5,324.57986783717087,0.4399114693446089,0.24637931356264398,0.177843479891435,128725.26584201367,-443.67404513891404,128281.59179687475,905,0,139.1590909090909,39,5,16,38.06755970711011,0.6020299145299146,46.30208333333332,1014.7916666666649,26.020299145299102,0
3361,4,0,1,43,0.0,0.022727272727272728,0.9772727272727273,44,1500,1200,300,0.8,18,12,6,327.27366273564314,0.43986742424242425,0.2516042232108715,0.1799174501231986,128857.4340820311,-365.67111545140426,128491.7629665797,906,1,140.1590909090909,39,5,16,37.864748982592914,0.6033653846153846,46.17187499999999,1015.3124999999989,26.03365384615382,0
3362,4,2,0,45,0.044444444444444446,0.0,1.0,45,850,700,150,0.8235294117647058,10,7,3,322.02670445705917,0.44170875420875416,0.2704356138194737,0.17905858441450584,129307.31336805545,-671.4599609375047,128635.85340711795,907,0,137.9111111111111,39,6,19,37.54096681687836,0.607905982905983,45.729166666666664,1017.0833333333325,26.07905982905981,0
3363,4,0,0,45,0.0,0.0,1.0,45,950,500,450,0.5263157894736842,14,5,9,322.38821672109555,0.44116161616161614,0.25669157029304435,0.18010607579084173,129492.7856445311,-650.610351562515,128842.17529296859,908,1,138.9111111111111,39,6,17,37.343606079214,0.609775641025641,45.54687499999999,1017.8124999999989,26.09775641025638,0
3364,4,0,1,44,0.0,0.022222222222222223,0.9777777777777777,45,1000,700,300,0.7,13,7,6,322.48386777063195,0.4410774410774411,0.2519003455173672,0.1807684800072072,129625.34722222203,-639.5833333333544,128985.76388888867,909,2,139.9111111111111,39,6,17,37.20676486633934,0.6111111111111112,45.41666666666666,1018.3333333333318,26.11111111111107,0
3365,4,2,1,45,0.043478260869565216,0.021739130434782608,0.9782608695652174,46,600,300,300,0.5,9,3,6,325.4611166210131,0.44413244766505633,0.2790977059513655,0.1851901413158544,130210.7203570128,-724.2947113160435,129486.42564569676,910,0,135.2391304347826,40,6,19,36.538094526867795,0.6153645833333333,44.842479674796735,1020.6300813008112,25.51575203252028,0
3366,4,1,1,45,0.021739130434782608,0.021739130434782608,0.9782608695652174,46,950,700,250,0.7368421052631579,12,7,5,322.55170504520976,0.44551127214170694,0.28018412549256055,0.1849158196837205,130501.95448133658,-781.2640862153405,129720.69039512124,911,0,133.3913043478261,39,7,16,36.31794355523839,0.6199252136752137,44.55729166666666,1021.7708333333316,26.19925213675209,0
3367,4,0,1,44,0.0,0.022222222222222223,0.9777777777777777,45,1800,1500,300,0.8333333333333334,21,15,6,331.1078092567834,0.4437289562289562,0.28092997316044466,0.1897174343872149,130480.80490037611,-359.35730787494407,130121.44759250116,912,1,136.84444444444443,38,7,22,36.1207692843947,0.6214364035087719,44.57799145299145,1021.6880341880334,26.886527215474562,0
3368,4,0,0,44,0.0,0.0,1.0,44,1250,800,450,0.64,17,8,9,341.41284069212867,0.4421467582804792,0.28466781152731624,0.19550973796733626,130458.54403518382,108.04442232224693,130566.58845750606,913,2,140.5681818181818,37,7,23,35.88008926335374,0.6230292792792793,44.59978070175438,1021.6008771929818,27.610834518729238,0
3369,4,0,0,44,0.0,0.0,1.0,44,1300,1100,200,0.8461538461538461,15,11,4,340.54002579824106,0.44170630725863286,0.2931679229276569,0.19585778288198644,130626.62459843406,96.71882213757146,130723.34342057163,914,3,141.5681818181818,37,7,18,35.73230630340734,0.6247184684684685,44.435307017543856,1022.258771929824,27.62861545756281,0
3370,4,0,1,43,0.0,0.022727272727272728,0.9772727272727273,44,1350,1000,350,0.7407407407407407,17,10,7,343.8824881064115,0.44101259689922484,0.2990702479338845,0.1984985055109284,130766.77439212055,193.68074792242675,130960.45514004298,915,4,142.5681818181818,37,7,18,35.50511006289309,0.6261261261261262,44.29824561403508,1022.8070175438588,27.64343290659078,0
3371,4,0,0,43,0.0,0.0,1.0,43,1300,800,500,0.6153846153846154,18,8,10,346.0836380471208,0.4412375415282392,0.29014681323063907,0.20005950080419052,130822.85534972293,455.1299438288624,131277.98529355178,916,5,143.90697674418604,37,6,19,35.392104322972486,0.6266891891891893,44.243421052631575,1023.0263157894731,27.649359886201974,0
3372,4,0,1,42,0.0,0.023255813953488372,0.9767441860465116,43,1300,800,500,0.6153846153846154,18,8,10,346.49666749639675,0.44056847545219635,0.28992048783404134,0.20117493082999727,130991.17036011058,477.60080024620527,131468.7711603568,917,6,144.90697674418604,37,6,19,35.211368180519855,0.6283783783783784,44.07894736842104,1023.684210526314,27.667140825035514,0
3373,4,0,0,42,0.0,0.0,1.0,42,1800,1400,400,0.7777777777777778,22,14,8,353.2135962840858,0.4378871467286101,0.2852758233914552,0.20567425120282817,131103.4404816868,861.5035395506457,131964.94402123743,918,7,149.11904761904762,37,5,21,34.92594575303353,0.6295045045045045,43.96929824561404,1024.1228070175448,27.678994784257966,0
3374,4,0,0,42,0.0,0.0,1.0,42,1850,1400,450,0.7567567567567568,23,14,9,353.6313012038632,0.4377540650406504,0.28218740847741164,0.20697895499991828,131300.7492900322,886.4109640952643,132187.16025412746,919,8,150.11904761904762,38,4,21,34.71585183640849,0.6296600877192983,43.776709401709404,1024.8931623931628,26.970872694556917,0
3375,4,0,0,42,0.0,0.0,1.0,42,950,500,450,0.5263157894736842,14,5,9,355.1255111670336,0.43754839334107626,0.28335625159154576,0.2083076241789061,131384.3261869036,931.5880528606385,132315.91423976424,920,9,151.11904761904762,37,5,21,34.59313725490195,0.6323198198198199,43.695175438596486,1025.2192982456136,27.70862968231388,0
3376,4,0,1,41,0.0,0.023809523809523808,0.9761904761904762,42,1350,1100,250,0.8148148148148148,16,11,5,356.89886509356444,0.4362901664730933,0.281140719248683,0.21011887243236577,131524.88175448202,988.2162059479688,132513.09796043,921,10,152.11904761904762,37,5,22,34.405732228754665,0.6337274774774775,43.55811403508771,1025.7675438596482,27.723447131341842,0
3377,4,1,0,42,0.023809523809523808,0.0,1.0,42,1100,700,400,0.6363636363636364,15,7,8,349.93544692739715,0.43567315137437085,0.2874652475997339,0.20816160014366877,131918.83710612875,832.6154441751305,132751.4525503039,922,0,151.78571428571428,37,5,18,34.187101967481425,0.6376689189189189,43.17434210526316,1027.302631578947,27.76493598862019,0
3378,4,0,0,42,0.0,0.0,1.0,42,1350,800,550,0.5925925925925926,19,8,11,352.2227253666323,0.43471738288811457,0.2927433772143673,0.21061481333147583,132116.0357032932,906.8540320098332,133022.88973530303,923,1,152.78571428571428,37,5,20,33.929714163822524,0.6396396396396397,42.98245614035087,1028.0701754385955,27.785680417259336,0
3379,4,0,0,42,0.0,0.0,1.0,42,1500,1000,500,0.6666666666666666,20,10,10,352.5343129009238,0.4352255129694154,0.29729921819474137,0.21143042551219063,132228.78674207424,923.0368959679708,133151.8236380422,924,2,153.78571428571428,37,5,21,33.808191186922556,0.6407657657657657,42.87280701754385,1028.5087719298226,27.797534376481693,0
3380,4,1,0,43,0.023255813953488372,0.0,1.0,43,1200,800,400,0.6666666666666666,16,8,8,346.59172122588257,0.4354697305278701,0.2964206398134186,0.2098991642472415,132595.5597515581,591.4128626115637,133186.97261416964,925,0,151.1860465116279,37,6,23,33.59228059902763,0.6444256756756757,42.51644736842105,1029.9342105263152,27.836059743954465,0
3381,4,0,0,43,0.0,0.0,1.0,43,1400,800,600,0.5714285714285714,20,8,12,345.4765565484383,0.43512366186784796,0.2957680258540907,0.21001220429768558,132736.76155163115,571.4878616497261,133308.24941328086,926,1,152.1860465116279,37,6,15,33.479197701638654,0.6458333333333333,42.379385964912274,1030.48245614035,27.85087719298243,0
3382,4,0,0,43,0.0,0.0,1.0,43,1350,1100,250,0.8148148148148148,16,11,5,342.39829687685767,0.43480066445182725,0.21969205854812035,0.20277515835914078,131749.9269606993,517.4237505770856,132267.35071127638,927,2,153.1860465116279,37,6,15,34.55078055466554,0.6359797297297297,43.33881578947368,1026.644736842104,27.747155049786596,8
3383,4,0,0,43,0.0,0.0,1.0,43,950,600,350,0.631578947368421,13,6,7,343.2729913997616,0.43422388335179035,0.21459495958532782,0.20404704209600014,131890.6779008924,454.9015081563383,132345.57940904872,928,3,154.1860465116279,37,6,15,34.386564190150864,0.6373873873873874,43.201754385964904,1027.192982456139,27.761972498814565,0
3384,4,0,0,43,0.0,0.0,1.0,43,1400,800,600,0.5714285714285714,20,8,12,337.78007490640493,0.43281653746770027,0.20746953828144643,0.20212914884475766,132144.21895438954,327.136835372395,132471.35578976193,929,4,155.1860465116279,37,6,18,34.27257740570901,0.6399211711711712,42.95504385964911,1028.1798245614013,27.788643907064902,0
3385,4,1,0,44,0.022727272727272728,0.0,1.0,44,1200,800,400,0.6666666666666666,16,8,8,335.91874922004007,0.43159795630725867,0.2138667337772957,0.20328278947645723,132567.32840874107,106.61369363649123,132673.94210237756,930,0,152.63636363636363,37,7,20,33.89542518455422,0.6441441441441442,42.5438596491228,1029.8245614035081,27.83309625414887,0
3386,4,0,0,44,0.0,0.0,1.0,44,1450,1100,350,0.7586206896551724,18,11,7,340.7405057608519,0.4308271670190275,0.22008563549276672,0.2066660459408136,132652.0314543898,239.9840575946397,132892.01551198444,931,1,153.63636363636363,37,7,15,33.686247117260955,0.6449887387387387,42.46162280701754,1030.1535087719296,27.841986723565665,0
3387,4,0,0,44,0.0,0.0,1.0,44,1250,900,350,0.72,16,9,7,341.8315980081484,0.4303977272727273,0.22296905222437102,0.20810991070444285,132793.2633117884,278.58668051710083,133071.8499923055,932,2,154.63636363636363,37,7,16,33.51640070921986,0.6463963963963963,42.32456140350878,1030.7017543859663,27.856804172593684,0
3388,4,0,1,43,0.0,0.022727272727272728,0.9772727272727273,44,1500,800,700,0.5333333333333333,22,8,14,337.71071469989954,0.4302105355884425,0.2159429256409262,0.2062228286388219,132906.3029008927,176.77650815636764,133083.07940904907,933,3,155.63636363636363,37,7,16,33.50923365943571,0.6475225225225225,42.21491228070176,1031.140350877194,27.86865813181605,0
3389,4,0,0,43,0.0,0.0,1.0,43,900,400,500,0.4444444444444444,14,4,10,345.15340565247703,0.4297249907715024,0.2140032932184095,0.2100295191842733,132774.9370992615,565.5443450207099,133340.48144428222,934,4,159.48837209302326,36,7,17,33.4492005390443,0.6481481481481481,42.34234234234235,1030.6306306306312,28.628628628628647,0
3390,4,0,0,43,0.0,0.0,1.0,43,1200,900,300,0.75,15,9,6,344.56861619470675,0.4294481358434847,0.2087285964409007,0.21041060173344311,132906.3029008927,559.0681748230352,133465.37107571575,935,5,160.48837209302326,37,6,18,33.33244718559479,0.6475225225225225,42.21491228070176,1031.140350877194,27.86865813181605,0
3391,4,0,0,43,0.0,0.0,1.0,43,1450,900,550,0.6206896551724138,20,9,11,344.36118649760874,0.42815614617940195,0.20828174847345848,0.21140137809060655,133104.23790252785,567.1866583949029,133671.42456092275,936,6,161.48837209302326,37,6,18,33.13930064109375,0.6494932432432432,42.02302631578948,1031.9078947368432,27.88940256045522,0
3392,4,0,1,42,0.0,0.023255813953488372,0.9767441860465116,43,950,700,250,0.7368421052631579,12,7,5,340.1800222185487,0.42790236249538577,0.2017150421845053,0.20962925976504296,133245.71021852884,465.5057325330954,133711.21595106192,937,7,162.48837209302326,37,6,18,33.10544109317475,0.6509009009009009,41.885964912280706,1032.4561403508776,27.90422000948318,0
3393,4,0,0,42,0.0,0.0,1.0,42,1250,1000,250,0.8,15,10,5,347.6091975157553,0.4266961866047232,0.20649813492929403,0.21383798016304795,133181.4648263129,859.0204224494928,134040.4852487624,938,8,166.5952380952381,36,6,19,32.9780802240163,0.6521990740740741,41.948198198198206,1032.207207207208,28.672422422422446,0
3394,4,0,0,42,0.0,0.0,1.0,42,900,300,600,0.3333333333333333,15,3,12,345.1853600207993,0.4265752032520325,0.20345045999210876,0.21334502170557773,133355.881219057,806.4995738982377,134162.38079295523,939,9,167.5952380952381,36,6,20,32.86587803459807,0.6539351851851851,41.77927927927929,1032.8828828828837,28.691191191191212,0
3395,4,0,0,42,0.0,0.0,1.0,42,1300,900,400,0.6923076923076923,17,9,8,346.1305971534423,0.4261880565234224,0.20557674841053575,0.21443269607581597,133443.13221583085,837.7502079782632,134280.88242380912,940,10,168.5952380952381,36,6,20,32.7540871934605,0.6548032407407407,41.69481981981983,1033.2207207207218,28.700575575575606,0
3396,4,0,0,42,0.0,0.0,1.0,42,1450,1000,450,0.6896551724137931,19,10,9,350.72893417658156,0.4254742547425474,0.20968930114806583,0.21796485354142475,133559.51126379764,968.6370069393816,134528.14827073703,941,11,169.5952380952381,36,6,20,32.51874750335913,0.6559606481481481,41.58220720720721,1033.6711711711716,28.7130880880881,0
3397,4,0,0,42,0.0,0.0,1.0,42,1700,1200,500,0.7058823529411765,22,12,10,348.1148421412081,0.4251596980255517,0.20562959046686036,0.2177080364024017,133792.4215389377,915.0255407434595,134707.44707968115,942,12,170.5952380952381,36,6,17,32.353234643155176,0.658275462962963,41.35698198198199,1034.572072072073,28.73811311311314,0
3398,4,0,0,42,0.0,0.0,1.0,42,1250,900,350,0.72,16,9,7,351.0133116093685,0.4247483546264034,0.2015624352438974,0.22039032515801338,133938.09349890435,1002.8107499391315,134940.90424884346,943,13,171.5952380952381,36,6,18,32.132560922541344,0.6597222222222222,41.21621621621622,1035.1351351351354,28.753753753753763,0
3399,4,0,0,42,0.0,0.0,1.0,42,1150,800,350,0.6956521739130435,15,8,7,351.0714277771173,0.4245305845915602,0.19595077535038397,0.22077638214656736,133996.38447569183,1008.4604029705317,135004.84487866235,944,14,172.5952380952381,36,6,18,32.07277391052137,0.6603009259259259,41.159909909909906,1035.3603603603597,28.760010010009992,0
3400,4,0,0,42,0.0,0.0,1.0,42,1150,900,250,0.782608695652174,14,9,5,347.7411257777039,0.42413133952768095,0.23662456711119262,0.19798912170425986,130234.60493853885,658.7301417552886,130893.33508029414,945,15,173.5952380952381,37,5,21,35.94538887098507,0.620777027027027,44.819078947368425,1020.7236842105269,27.587126600284513,8
3401,4,0,0,42,0.0,0.0,1.0,42,1000,600,400,0.6,14,6,8,350.5041104573076,0.423586914440573,0.24094061082518592,0.2000182139316254,130323.35778061232,735.7835353381988,131059.14131595052,946,16,174.5952380952381,34,8,21,35.78489953752284,0.6277573529411764,44.73214285714286,1021.0714285714292,30.031512605042035,0
3402,4,0,1,41,0.0,0.023809523809523808,0.9761904761904762,42,800,400,400,0.5,12,4,8,350.51767142505616,0.4222923925667828,0.24577999320267385,0.20077997960213947,130469.43486636224,746.3685003000626,131215.8033666623,947,17,175.5952380952381,35,7,21,35.63651769193006,0.6270833333333333,44.58912037037037,1021.643518518518,29.1898148148148,0
3403,4,0,1,40,0.0,0.024390243902439025,0.975609756097561,41,1500,1000,500,0.6666666666666666,20,10,10,386.79175638479865,0.42253556910569107,0.27134214409793156,0.2040565697111319,127205.59030314075,1740.6463545040351,128946.23665764478,948,18,177.3170731707317,36,5,14,38.04932276549823,0.5920138888888888,47.80405405405404,1008.7837837837819,28.02177177177172,8
3404,4,0,0,40,0.0,0.0,1.0,40,1450,1000,450,0.6896551724137931,19,10,9,392.117666863059,0.42202190170940174,0.26933486238532134,0.2074797363498708,127325.53155006842,1985.3180727023134,129310.84962277074,949,19,175.25,35,5,12,37.7914755351682,0.5952380952380952,47.685185185185176,1009.2592592592579,28.835978835978796,0
3405,4,1,0,41,0.024390243902439025,0.0,1.0,41,1300,900,400,0.6923076923076923,17,9,8,381.1244553087474,0.42502540650406506,0.262408850892633,0.2031267701370793,127617.730034722,1527.6475694444202,129145.37760416642,950,0,171.9512195121951,37,4,13,37.768470790378,0.5943130630630631,47.39583333333332,1010.4166666666648,27.30855855855851,0
3406,4,0,0,41,0.0,0.0,1.0,41,1050,800,250,0.7619047619047619,13,8,5,377.9391275039911,0.4240853658536585,0.25793320571845224,0.2027166980215455,127874.24123611997,1465.7358326027884,129339.97706872276,951,1,172.9512195121951,38,3,15,37.585604380127464,0.5951206140350878,47.142094017094,1011.4316239316216,26.616621682411097,0
3407,4,1,0,42,0.023809523809523808,0.0,1.0,42,1200,600,600,0.5,18,6,12,372.0638791512134,0.4272406116918312,0.25935724083872236,0.20091449474165526,128144.53124999999,1136.1609914895162,129280.69224148951,952,0,169.8095238095238,37,5,16,37.457133058984915,0.5996621621621622,46.875,1012.4999999999999,27.364864864864863,0
3408,4,1,0,43,0.023255813953488372,0.0,1.0,43,1300,1000,300,0.7692307692307693,16,10,6,367.9925420198284,0.4299326319675157,0.2660341621070639,0.20060983436589244,128523.41666894934,859.1317618160391,129382.54843076538,953,0,166.8372093023256,38,5,13,37.17249675130825,0.6016995614035088,46.50106837606837,1013.9957264957251,26.684098065676977,0
3409,4,1,0,44,0.022727272727272728,0.0,1.0,44,1250,1000,250,0.8,15,10,5,361.43589743589763,0.43104739252995067,0.2743822843822845,0.19909604519774002,128936.76757812487,520.4752604166512,129457.24283854153,954,0,164.02272727272728,39,5,15,36.916666666666664,0.6041666666666667,46.09374999999999,1015.624999999999,26.04166666666664,0
3410,4,0,1,43,0.0,0.022727272727272728,0.9772727272727273,44,1100,700,400,0.6363636363636364,15,7,8,340.72111013785155,0.4304968287526427,0.2150921123396805,0.18517774558064248,128401.90120174811,-43.370651718163515,128358.53055002996,955,1,165.02272727272728,40,4,11,37.98777532671545,0.5971354166666667,46.62093495934958,1013.5162601626002,25.337906504065007,8
3411,4,0,0,43,0.0,0.0,1.0,43,1300,1100,200,0.8461538461538461,15,11,4,347.97667841785074,0.4274870801033592,0.2279208408330884,0.18902652732145556,128381.94580078124,334.78461371527715,128716.73041449652,956,2,169.74418604651163,39,4,12,37.824309624147745,0.5985576923076923,46.640625,1013.4374999999999,25.98557692307692,0
3412,4,1,0,44,0.022727272727272728,0.0,1.0,44,1350,900,450,0.6666666666666666,18,9,9,344.84892440878025,0.4304968287526427,0.23642781069936314,0.18912719429272334,128762.65290377768,80.73247157777973,128843.38537535546,957,0,166.86363636363637,40,4,14,37.5152281299022,0.60078125,46.26524390243903,1014.9390243902452,25.37347560975613,0
3413,4,2,0,46,0.043478260869565216,0.0,1.0,46,1250,900,350,0.72,16,9,7,331.0258663245547,0.43479267310789055,0.23576747537833298,0.18425819430939427,129349.2024592873,-636.4136395048383,128712.78881978246,958,0,160.56521739130434,42,4,17,37.26959897123261,0.6036706349206349,45.68798449612403,1017.2480620155039,24.220191952750092,0
3414,4,0,0,46,0.0,0.0,1.0,46,1850,1400,450,0.7567567567567568,23,14,9,331.5421782526249,0.4340881642512077,0.24219758932414948,0.18524037448753056,129497.10053482374,-613.2498422570663,128883.85069256667,959,1,161.56521739130434,42,4,14,37.10630077430821,0.6051587301587302,45.54263565891473,1017.8294573643419,24.234034699151,0
3415,4,1,1,46,0.02127659574468085,0.02127659574468085,0.9787234042553191,47,1150,400,750,0.34782608695652173,19,4,15,334.9658459851078,0.43511023743447425,0.2567346890358908,0.18873834735558798,129827.93578541094,-702.4151314279145,129125.52065398303,960,0,159.10638297872342,43,4,15,36.68346961531315,0.6070736434108528,45.21780303030303,1019.128787878788,23.70066948555321,0
3416,4,2,1,47,0.041666666666666664,0.020833333333333332,0.9791666666666666,48,1200,1000,200,0.8333333333333334,14,10,4,331.45269810752154,0.43725989952718675,0.27280665940845594,0.18850730849025268,130191.70524691335,-969.5216049382957,129222.18364197505,961,0,156.70833333333334,44,4,17,36.40446379967337,0.609375,44.8611111111111,1020.5555555555536,23.1944444444444,0
3417,4,0,1,46,0.0,0.02127659574468085,0.9787234042553191,47,1250,1000,250,0.8,15,10,5,340.2476426428502,0.4371916435399322,0.27547633948578465,0.19350125829878578,130190.09452658668,-540.625448375825,129649.46907821085,962,1,160.38297872340425,43,4,19,36.18170254554452,0.6107073643410852,44.862689393939384,1020.5492424242407,23.733703312191643,0
3418,4,1,1,46,0.02127659574468085,0.02127659574468085,0.9787234042553191,47,1650,1100,550,0.6666666666666666,22,11,11,338.98665922934003,0.43738436632747457,0.2617567264431646,0.19430854457763885,130496.11363110579,-552.6511488223507,129943.46248228344,459,0,140.89361702127658,40,7,15,35.90403487832372,0.6182291666666666,44.5630081300813,1021.7479674796746,25.543699186991866,0
3419,4,0,1,45,0.0,0.021739130434782608,0.9782608695652174,46,1400,900,500,0.6428571428571429,19,9,10,343.8408722840378,0.4356481481481482,0.2591222748478883,0.1964461487105306,130368.94531249999,-234.76562500000045,130134.17968749999,460,3,144.95652173913044,39,7,19,35.90881272949815,0.6185897435897436,44.6875,1021.2499999999999,26.185897435897434,0
3420,4,0,0,45,0.0,0.0,1.0,45,1250,700,550,0.56,18,7,11,351.5167084889277,0.4351220538720539,0.25491089131346123,0.20124485464979056,130448.74267578124,170.98253038194468,130619.72520616317,461,4,145.22222222222223,39,6,19,35.63196781210701,0.6193910256410257,44.609375,1021.5624999999999,26.193910256410252,0
3421,4,0,0,45,0.0,0.0,1.0,45,1300,900,400,0.6923076923076923,17,9,8,342.40122380758066,0.43470117845117845,0.2144891461049403,0.18724575347884698,128648.39916386886,-190.12613708102654,128458.27302678784,462,5,146.22222222222223,43,2,13,37.693787143346086,0.595203488372093,46.377840909090914,1014.4886363636368,23.592758985200856,8
3422,4,1,1,45,0.021739130434782608,0.021739130434782608,0.9782608695652174,46,1200,800,400,0.6666666666666666,16,8,8,339.55737034664065,0.43586956521739134,0.22623638950877356,0.1870720640548617,128942.6451045952,-443.3149005487127,128499.33020404649,463,0,144.02173913043478,44,2,14,37.466192603397424,0.5968276515151515,46.087962962962955,1015.648148148147,23.082912457912432,0
3423,4,3,1,47,0.0625,0.020833333333333332,0.9791666666666666,48,1000,800,200,0.8,12,8,4,336.16149299734093,0.4380540780141844,0.28712277091906735,0.1815272062185644,128144.53125000026,-793.1841563785724,127351.34709362169,464,0,138.83333333333334,43,5,20,38.365912208504845,0.5901162790697674,46.875000000000014,1012.500000000002,23.546511627907023,8
3424,4,2,4,45,0.04081632653061224,0.08163265306122448,0.9183673469387755,49,1150,800,350,0.6956521739130435,15,8,7,330.04316006755477,0.44120252267573695,0.28772714565278146,0.17979963197710092,128496.33487654336,-1318.1327160493677,127178.202160494,465,0,136.79591836734693,41,8,17,38.16210045662101,0.5965447154471545,46.527777777777786,1013.88888888889,24.728997289972927,0
3425,4,1,0,46,0.021739130434782608,0.0,1.0,46,700,300,400,0.42857142857142855,11,3,8,342.2114726487528,0.43871779388083737,0.28619864379736715,0.18554553431264295,128306.84222961872,-418.3853139381939,127888.45691568052,466,0,141.2391304347826,38,8,21,38.047031530106494,0.5995065789473684,46.71474358974359,1013.141025641026,26.661605937921735,0
3426,4,0,1,45,0.0,0.021739130434782608,0.9782608695652174,46,1450,1000,450,0.6896551724137931,19,10,9,342.8786615638402,0.43808373590982286,0.2823182746310535,0.1865037594006558,128434.73442925357,-392.49403211804616,128042.24039713552,467,1,142.2391304347826,39,7,17,37.89960350083924,0.5990918803418803,46.58854166666667,1013.6458333333342,25.990918803418825,0
3427,4,1,0,46,0.021739130434782608,0.0,1.0,46,1250,600,650,0.48,19,6,13,354.46445263933856,0.43660426731078905,0.3134669707125295,0.19434705470259261,128751.69406466997,-72.42024739585156,128679.27381727411,468,0,143.19565217391303,39,7,19,37.28242926545553,0.6022970085470085,46.27604166666666,1014.8958333333319,26.02297008547005,0
3428,4,0,0,46,0.0,0.0,1.0,46,1450,900,550,0.6206896551724138,20,9,11,354.4474555207245,0.4372584541062802,0.31341214466347767,0.19464406999431091,128814.23017259892,-68.42477609228024,128745.80539650665,469,1,144.19565217391303,40,6,19,37.219065972569815,0.6013020833333333,46.21443089430894,1015.1422764227638,25.378556910569095,0
3429,4,1,2,45,0.02127659574468085,0.0425531914893617,0.9574468085106383,47,900,500,400,0.5555555555555556,13,5,8,351.55252650953133,0.4385407030527289,0.31727397120901024,0.19482740611915428,129176.17517203621,-317.5578506865904,128858.61732134962,470,0,142.10638297872342,41,6,22,36.923713444585395,0.6034044715447154,45.85813492063491,1016.5674603174587,24.79432830042582,0
3430,4,3,1,47,0.0625,0.020833333333333332,0.9791666666666666,48,750,500,250,0.6666666666666666,10,5,5,350.65306078858583,0.44349327718676124,0.3388139978213507,0.19870340111353163,130049.99999999975,-479.5065074641252,129570.49349253562,471,0,132.0,39,9,17,36.05834694989105,0.6153846153846154,44.999999999999986,1019.9999999999981,26.153846153846104,0
3431,4,0,0,47,0.0,0.0,1.0,47,1250,800,450,0.64,17,8,9,357.4123353639841,0.4413351834720938,0.3420843171222756,0.20194114365769655,129935.60209155137,-111.8826019066662,129823.7194896447,472,1,135.80851063829786,38,9,17,36.00217436864716,0.615953947368421,45.112179487179475,1019.55128205128,26.830296896086317,0
3432,4,0,0,47,0.0,0.0,1.0,47,1700,1400,300,0.8235294117647058,20,14,6,333.19850745069283,0.44125809435707675,0.20803008670822254,0.18677457619483767,129625.347222222,-753.9725098619551,128871.37471236005,473,2,136.80851063829786,39,8,14,36.93398799781779,0.6111111111111112,45.41666666666666,1018.3333333333316,26.111111111111065,8
3433,4,0,2,45,0.0,0.0425531914893617,0.9574468085106383,47,1300,900,400,0.6923076923076923,17,9,8,328.04287703145667,0.4407762873882208,0.20151123880416488,0.18468758719788952,129796.16057117101,-884.2588117192436,128911.90175945176,474,3,137.80851063829786,40,7,14,36.89205810977027,0.6111979166666667,45.248983739837385,1019.0040650406485,25.47510162601621,0
3434,4,1,1,45,0.021739130434782608,0.021739130434782608,0.9782608695652174,46,1200,800,400,0.6666666666666666,16,8,8,331.87470315409337,0.43942230273752014,0.22175690386794344,0.1871696812889221,129864.12896050325,-580.2761501736335,129283.85281032961,475,0,141.19565217391303,39,7,16,36.725536535513555,0.6135149572649572,45.18229166666666,1019.2708333333316,26.135149572649528,0
3435,4,1,0,46,0.021739130434782608,0.0,1.0,46,1250,700,550,0.56,18,7,11,332.5012107557191,0.43702697262479867,0.22153663746208796,0.1882891471665264,130023.4388563366,-553.4098307291889,129470.02902560741,476,0,141.93478260869566,39,7,17,36.54812668096551,0.6151175213675213,45.02604166666666,1019.8958333333317,26.15117521367517,0
3436,4,0,0,46,0.0,0.0,1.0,46,1350,900,450,0.6666666666666666,18,9,9,328.6642228908254,0.43634259259259256,0.20833369413679925,0.18688822912059255,130184.7910056843,-642.5833663824624,129542.20763930184,477,1,142.93478260869566,40,6,17,36.48260638650998,0.6151041666666667,44.86788617886178,1020.5284552845517,25.51321138211379,0
3437,4,1,1,46,0.02127659574468085,0.02127659574468085,0.9787234042553191,47,1650,1300,350,0.7878787878787878,20,13,7,348.59890374582864,0.43798180696885597,0.2973426130223076,0.18905029156125527,128315.61872260801,-227.79436706145674,128087.82435554655,478,0,140.87234042553192,36,11,15,37.87628283501909,0.6032986111111112,46.706081081081095,1013.1756756756778,28.143768768768826,8
3438,4,1,1,46,0.02127659574468085,0.02127659574468085,0.9787234042553191,47,1050,700,350,0.6666666666666666,14,7,7,350.65120373964766,0.43983194572926304,0.31327920451430535,0.19111764155398273,128515.36502718968,-387.18651083512145,128128.17851635456,479,0,141.80851063829786,36,11,14,37.62031689619429,0.6053240740740741,46.50900900900903,1013.9639639639665,28.16566566566574,0
3439,4,1,1,46,0.02127659574468085,0.02127659574468085,0.9787234042553191,47,1500,1000,500,0.6666666666666666,20,10,10,348.2369219597521,0.44185553499845825,0.3153195266830986,0.19089483824217096,128743.83674214776,-433.3285143251102,128310.50822782265,480,0,136.61702127659575,36,11,15,37.448448365142774,0.6076388888888888,46.2837837837838,1014.8648648648666,28.19069069069074,0
3440,4,0,0,46,0.0,0.0,1.0,46,900,500,400,0.5555555555555556,13,5,8,346.7193321518078,0.4422000805152979,0.3013301332481646,0.1902537556448896,128783.68975309726,-269.64101935208726,128514.04873374518,481,1,136.34782608695653,37,9,15,37.446324403154385,0.6061373873873874,46.24451754385966,1015.0219298245627,27.433025130393585,0
3441,4,0,0,46,0.0,0.0,1.0,46,1100,700,400,0.6363636363636364,15,7,8,347.80582180440433,0.4417572463768116,0.3032379924446842,0.19192501125776126,129006.37846500865,-226.16610399351657,128780.21236101513,482,2,137.34782608695653,37,9,16,37.19182856628889,0.6083896396396397,46.025219298245624,1015.899122807019,27.456733048838352,0
3442,4,0,0,46,0.0,0.0,1.0,46,1400,700,700,0.5,21,7,14,344.03669858193507,0.4413747987117553,0.2953553155468429,0.19064938628530337,129173.52123970867,-311.91364169741337,128861.60759801127,483,3,138.34782608695653,37,9,16,37.11742260813289,0.6100788288288288,45.8607456140351,1016.557017543862,27.474513987671948,0
3443,4,1,0,47,0.02127659574468085,0.0,1.0,47,650,200,450,0.3076923076923077,11,2,9,351.433796109347,0.4440718470551958,0.27032761252888426,0.18872690354510083,127922.58795975673,-364.41332910127585,127558.17463065546,484,0,136.38297872340425,37,10,18,38.206337163089806,0.5974099099099099,47.09429824561403,1011.6228070175429,27.341156946420078,8
3444,4,2,1,48,0.04081632653061224,0.02040816326530612,0.9795918367346939,49,1700,1300,400,0.7647058823529411,21,13,8,335.5076724233539,0.4468714569160998,0.26973706852049384,0.18252848600646682,128442.17985243625,-1181.1402724633444,127261.03957997292,485,0,131.77551020408163,38,11,17,38.07880129286115,0.6008771929824561,46.58119658119658,1013.6752136752136,26.67566351776878,0
3445,4,1,0,49,0.02040816326530612,0.0,1.0,49,1400,900,500,0.6428571428571429,19,9,10,337.97807119957923,0.44708404195011336,0.2714139573268226,0.18487556244880204,128658.8684345094,-1103.2247607568224,127555.64367375257,486,0,132.75510204081633,38,11,18,37.795299775344006,0.6030701754385965,46.36752136752136,1014.529914529914,26.698155645524054,0
3446,4,1,0,50,0.02,0.0,1.0,50,1200,800,400,0.6666666666666666,16,8,8,329.8843566541446,0.4477380952380952,0.2766625666256659,0.18244624623116987,129095.50781250001,-1482.6822916666663,127612.82552083334,487,0,131.08,39,11,20,37.55637556375563,0.6057692307692308,45.9375,1016.2500000000001,26.05769230769231,0
3447,4,0,1,49,0.0,0.02,0.98,50,1500,1100,400,0.7333333333333333,19,11,8,332.3954926221112,0.4471258503401361,0.2694921832884094,0.1847194843660923,129285.00987082561,-1405.1622855109313,127879.84758531468,488,1,132.08,37,13,20,37.29997753818508,0.611204954954955,45.75109649122807,1016.9956140350874,27.486367946894255,0
3448,4,0,1,48,0.0,0.02040816326530612,0.9795918367346939,49,1450,900,550,0.6206896551724138,20,9,11,338.5121439406038,0.4448164682539682,0.27615909480843426,0.1885183476279066,129368.65790435522,-1041.427650815635,128327.23025353959,489,2,135.59183673469389,37,12,20,37.05944169001942,0.6120495495495495,45.66885964912281,1017.3245614035089,27.495258416311053,0
3449,4,0,0,48,0.0,0.0,1.0,48,1200,900,300,0.75,15,9,6,335.3549332483891,0.4451462765957446,0.2684990662931839,0.18729028221489474,129480.2306959835,-915.6331755924796,128564.59752039102,490,3,137.5,37,11,18,37.0264131293543,0.6131756756756757,45.559210526315795,1017.7631578947377,27.50711237553345,0
3450,4,0,0,48,0.0,0.0,1.0,48,1550,1100,450,0.7096774193548387,20,11,9,336.048996936764,0.444425975177305,0.2602820844099911,0.18847965480366352,129647.68005540187,-886.405432440728,128761.27462296114,491,4,138.5,37,11,18,36.838752512202134,0.6148648648648649,45.394736842105274,1018.4210526315806,27.52489331436704,0
3451,4,0,0,48,0.0,0.0,1.0,48,1350,900,450,0.6666666666666666,18,9,9,333.64636846458563,0.4442043439716312,0.2595479572438033,0.18779986082019373,129787.30384589508,-939.3874798014582,128847.91636609362,492,5,139.5,37,11,18,36.75829029018257,0.6162725225225225,45.2576754385965,1018.9692982456155,27.539710763395014,0
3452,4,0,1,47,0.0,0.020833333333333332,0.9791666666666666,48,1550,1100,450,0.7096774193548387,20,11,9,336.2561159411682,0.44408429373522457,0.2601612170753862,0.18985537623139806,129908.37191358033,-863.5030864197449,129044.86882716058,493,6,140.5,38,10,18,36.5690281562216,0.6156798245614035,45.13888888888889,1019.444444444445,26.827485380116975,0
3453,4,0,0,47,0.0,0.0,1.0,47,1500,1100,400,0.7333333333333333,19,11,8,339.5744634193139,0.44258788159111934,0.26221232037428943,0.19280238559182256,130126.2932372711,-562.4867594418545,129563.80647782923,494,7,138.2340425531915,38,9,18,36.26352530541013,0.6178728070175439,44.92521367521369,1020.2991452991477,26.849977507872307,0
3454,4,1,0,48,0.020833333333333332,0.0,1.0,48,1850,1400,450,0.7567567567567568,23,14,9,332.1465012610779,0.44362256205673756,0.2680300181083717,0.1915244765103037,130726.51855504431,-915.8575087661529,129810.66104627815,495,0,136.33333333333334,38,10,17,35.845869898314525,0.6239035087719298,44.33760683760684,1022.6495726495735,26.911830859199302,0
3455,4,0,1,47,0.0,0.020833333333333332,0.9791666666666666,48,1350,900,450,0.6666666666666666,18,9,9,337.61242458467865,0.44352098108747046,0.2743138943997774,0.19536641632915214,130863.12601587042,-763.7965474103282,130099.3294684601,496,1,137.33333333333334,38,10,19,35.56807107305699,0.6252741228070176,44.20405982905983,1023.1837606837607,26.925888439046336,0
3456,4,0,2,45,0.0,0.0425531914893617,0.9574468085106383,47,1650,1100,550,0.6666666666666666,22,11,11,340.2011837969174,0.4431082331174838,0.2750916151616256,0.1975197917865686,130991.17036011085,-487.32975530932083,130503.84060480153,497,2,139.59574468085106,37,10,19,35.37248286203942,0.6283783783783784,44.078947368421055,1023.6842105263161,27.66714082503557,0
3457,4,0,0,45,0.0,0.0,1.0,45,1500,900,600,0.6,21,9,12,346.48721607872517,0.44137205387205386,0.27067507454661,0.20142338673834853,131039.71370018675,80.71711914618163,131120.43081933292,498,3,143.8,36,9,20,35.16255132717408,0.630787037037037,44.031531531531535,1023.8738738738745,28.44094094094096,0
3458,4,0,2,43,0.0,0.044444444444444446,0.9555555555555556,45,1450,1200,250,0.8275862068965517,17,12,5,347.7261100480291,0.4410143097643098,0.27421254551230434,0.2024469426873736,131097.37059694825,117.19574304033483,131214.56633998858,499,4,144.8,36,9,20,35.072575324389724,0.6313657407407407,43.97522522522522,1024.0990990990988,28.447197197197188,0
3459,4,0,0,43,0.0,0.0,1.0,43,1300,900,400,0.6923076923076923,17,9,8,357.7001081665767,0.4413298265042451,0.2611411573823692,0.20785276555625404,131023.24263038553,773.405612244906,131796.64824263044,500,5,144.90697674418604,34,9,21,34.89219961240312,0.6348039215686274,44.04761904761905,1023.8095238095241,30.112044817927178,0
3460,4,0,0,43,0.0,0.0,1.0,43,1600,1200,400,0.75,20,12,8,356.4344484598059,0.44139904023624954,0.2683766317973548,0.20843666659932122,131267.1201814059,757.6247165532895,132024.74489795917,501,6,145.90697674418604,34,9,22,34.67801270136308,0.6372549019607843,43.80952380952381,1024.7619047619046,30.14005602240896,0
3461,4,0,0,43,0.0,0.0,1.0,43,850,300,550,0.35294117647058826,14,3,11,353.61130959990885,0.4412375415282392,0.2708193185040224,0.20745527462221863,131390.93888168014,692.2785658380981,132083.21744751823,502,7,146.90697674418604,33,10,22,34.62526894573273,0.6407828282828283,43.68872549019608,1025.2450980392157,31.068033273915628,0
3462,4,0,1,42,0.0,0.023255813953488372,0.9767441860465116,43,1450,1100,350,0.7586206896551724,18,11,7,353.1329533564858,0.44061461794019935,0.2762468394876496,0.20785673836805807,131516.61169982696,688.5699009996077,132205.18160082656,503,8,147.90697674418604,33,10,23,34.51065312624451,0.6420454545454546,43.56617647058823,1025.7352941176468,31.08288770053475,0
3463,4,0,1,41,0.0,0.023809523809523808,0.9761904761904762,42,900,700,200,0.7777777777777778,11,7,4,350.278928124414,0.43844367015098723,0.27777777777777857,0.20668678401590682,131610.9057363754,820.1053981641724,132431.01113453956,504,9,151.11904761904762,33,9,19,34.488708746367315,0.6429924242424243,43.474264705882355,1026.1029411764705,31.094028520499105,0
3464,4,0,1,40,0.0,0.024390243902439025,0.975609756097561,41,1500,1200,300,0.8,18,12,6,357.99561833498683,0.4382621951219512,0.28373463606683313,0.211467179202527,131651.87225793282,1226.158682787468,132878.0309407203,505,10,154.9268292682927,32,9,20,34.24940534776904,0.6458333333333333,43.43434343434343,1026.2626262626259,32.07070707070706,0
3465,4,0,0,40,0.0,0.0,1.0,40,1300,1300,0,1.0,13,13,0,363.8939148346097,0.437633547008547,0.2868975139523082,0.21538585769940413,131728.82080078125,1587.0632595486106,133315.88406032987,506,11,157.05,31,9,20,34.02037882631489,0.6491935483870968,43.359375,1026.5625,33.11491935483871,0
3466,4,0,0,40,0.0,0.0,1.0,40,1350,800,550,0.5925925925925926,19,8,11,365.9206048815952,0.4372061965811966,0.2924490046694528,0.21799867368421819,131976.01807213548,1658.5488725640307,133634.5669446995,507,12,158.05,32,8,20,33.718870320308035,0.6490885416666667,43.11868686868687,1027.5252525252524,32.11016414141414,0
3467,4,0,1,39,0.0,0.025,0.975,40,1200,800,400,0.6666666666666666,16,8,8,386.9566644516468,0.4368055555555555,0.2964127132507599,0.21758049503135274,129746.6057256234,2041.936315197928,131788.54204082134,508,13,159.05,34,6,15,35.441740671496454,0.6219362745098039,45.29761904761904,1018.8095238095224,29.96498599439772,8
3468,4,1,1,39,0.025,0.025,0.975,40,1250,1000,250,0.8,15,10,5,388.25640237571935,0.4372996794871795,0.2972974550548686,0.21967003584877207,129989.29280045339,2093.8350340135935,132083.12783446698,509,0,157.25,34,6,17,35.16129659895713,0.6243872549019608,45.0595238095238,1019.7619047619037,29.99299719887952,0
3469,4,0,0,39,0.0,0.0,1.0,39,1150,900,250,0.782608695652174,14,9,5,399.36574066427806,0.43820287899235266,0.2933661282020461,0.22554810567455033,129918.78311526802,2577.022209006131,132495.80532427414,510,1,160.76923076923077,33,6,17,34.9499889810474,0.6259469696969697,45.128676470588225,1019.4852941176458,30.893493761140782,0
3470,4,1,0,40,0.025,0.0,1.0,40,650,200,450,0.3076923076923077,11,2,9,389.92361074043095,0.4394898504273504,0.28307674364357394,0.2219923664334962,130232.20663265293,2156.122448979575,132388.32908163252,511,0,157.725,34,6,18,34.87141357592722,0.6268382352941176,44.82142857142856,1020.7142857142846,30.021008403361314,0
3471,4,0,0,40,0.0,0.0,1.0,40,900,600,300,0.6666666666666666,12,6,6,388.66055342738696,0.43924946581196583,0.28032885261641893,0.22180272131212228,130325.14537677799,2130.4521686125227,132455.5975453905,512,1,158.725,33,7,18,34.80906945111218,0.630050505050505,44.730392156862735,1021.0784313725476,30.94177064765296,0
3472,4,0,0,40,0.0,0.0,1.0,40,1300,1000,300,0.7692307692307693,16,10,6,389.59389483865016,0.43926282051282056,0.28114801864801864,0.2228477078477077,130414.5408163264,2161.7417800453304,132576.28259637172,513,2,159.725,34,6,18,34.694298756798744,0.6286764705882353,44.64285714285713,1021.4285714285703,30.042016806722657,0
3473,4,0,0,40,0.0,0.0,1.0,40,900,600,300,0.6666666666666666,12,6,6,390.8699630437104,0.4384081196581197,0.2782898567602192,0.22480913413639267,130627.42524092972,2211.6673752834495,132839.09261621317,514,3,160.725,34,6,14,34.44523698614186,0.6308210784313726,44.43452380952381,1022.2619047619048,30.06652661064426,0
3474,4,0,0,40,0.0,0.0,1.0,40,1150,900,250,0.782608695652174,14,9,5,391.76933248964906,0.4375267094017094,0.283087978587222,0.22639367007959366,130810.0357851475,2249.47208049888,133059.5078656464,515,4,161.725,34,6,15,34.236684898560846,0.6326593137254901,44.25595238095239,1022.9761904761913,30.087535014005624,0
3475,4,0,1,39,0.0,0.025,0.975,40,1150,900,250,0.782608695652174,14,9,5,390.14980520145616,0.4372996794871795,0.2816876017678531,0.22635006917153316,130962.30867346936,2218.98384353741,133181.29251700678,516,5,162.725,34,6,15,34.123488020469864,0.6341911764705883,44.107142857142854,1023.5714285714284,30.10504201680672,0
3476,4,1,0,40,0.025,0.0,1.0,40,1400,800,600,0.5714285714285714,20,8,12,386.2226230239908,0.4377938034188034,0.27781812899477054,0.2253183505845045,131175.63952664402,2132.599914965991,133308.23944161,517,0,163.575,34,6,17,34.00760216928143,0.6363357843137255,43.898809523809526,1024.4047619047622,30.1295518207283,0
3477,4,0,1,39,0.0,0.025,0.975,40,600,500,100,0.8333333333333334,7,5,2,392.5059828527904,0.4374198717948718,0.3221487141259787,0.217132691132791,129105.1315713958,2146.24518023463,131251.37675163042,518,1,164.575,32,8,21,35.95555348490496,0.6201171875,45.928030303030305,1016.287878787879,31.758996212121218,8
3478,4,0,0,39,0.0,0.0,1.0,39,1000,800,200,0.8,12,8,4,390.88150454518143,0.43733130904183537,0.3106136087896594,0.21713725869227934,129269.72229448504,2305.900448649787,131575.62274313482,519,2,163.35897435897436,30,9,21,35.828597233236394,0.6270833333333333,45.76612903225807,1016.9354838709688,33.89784946236563,0
3479,4,0,0,39,0.0,0.0,1.0,39,850,600,250,0.7058823529411765,11,6,5,392.63972474501116,0.43707827260458837,0.3136493478769147,0.21830307106138863,129303.89577191009,2353.9692088680795,131657.86498077816,520,3,164.35897435897436,30,9,21,35.74897581604333,0.6274305555555555,45.73252688172043,1017.0698924731187,33.902329749103956,0
3480,4,0,0,39,0.0,0.0,1.0,39,1250,900,350,0.72,16,9,7,393.8863192920827,0.4369376968061178,0.3205111275889039,0.2201403022877447,129509.03148124053,2402.3671450456563,131911.3986262862,521,4,165.35897435897436,30,9,20,35.507724811831494,0.6295138888888889,45.53091397849462,1017.8763440860209,33.92921146953403,0
3481,4,1,1,39,0.025,0.025,0.975,40,1200,800,400,0.6666666666666666,16,8,8,384.21308858562827,0.4381276709401709,0.312258543833581,0.21729025934296453,129972.73875114789,1987.4454775023016,131960.18422865018,522,0,162.2,32,8,21,35.281234522040606,0.62890625,45.07575757575758,1019.69696969697,31.86553030303031,0
3482,4,2,0,41,0.04878048780487805,0.0,1.0,41,500,200,300,0.4,8,2,6,369.60729318504343,0.44085365853658537,0.2934414304632469,0.21167436659341954,130462.0446099174,1444.5902954886035,131906.634905406,523,0,155.609756097561,31,10,23,35.15644914606168,0.6364247311827957,44.59635416666666,1021.6145833333322,32.95530913978491,0
3483,4,0,1,40,0.0,0.024390243902439025,0.975609756097561,41,1400,1000,400,0.7142857142857143,18,10,8,370.13283225807436,0.440625,0.28758618819978476,0.21300394760437996,130649.553058999,1471.5378213957654,132121.09088039477,524,1,156.609756097561,32,9,19,34.95276028158577,0.6357421875,44.41287878787878,1022.3484848484842,31.94839015151513,0
3484,4,0,0,40,0.0,0.0,1.0,40,1350,1000,350,0.7407407407407407,17,10,7,381.2971857911935,0.4390758547008547,0.2970904373610077,0.21888081005630647,130552.75769054181,1955.8798209366396,132508.63751147845,525,2,161.5,32,8,19,34.765721522115136,0.634765625,44.50757575757576,1021.9696969696971,31.936553030303035,0
3485,4,0,1,39,0.0,0.025,0.975,40,850,500,350,0.5882352941176471,12,5,7,379.76685339389206,0.43884882478632475,0.29289551685809534,0.2185481316226258,130649.5530589991,1923.2739325068892,132572.82699150598,526,3,162.5,32,8,20,34.70652710880572,0.6357421875,44.41287878787879,1022.348484848485,31.948390151515156,0
3486,4,1,1,39,0.025,0.025,0.975,40,1650,1300,350,0.7878787878787878,20,13,7,374.0583996868465,0.4378205128205128,0.2809006582884501,0.21748489418118314,131045.64838343424,1803.7451040465166,132849.39348748076,527,0,156.825,33,7,22,34.45080291242768,0.6373106060606061,44.025735294117645,1023.8970588235293,31.02718360071301,0
3487,4,0,2,37,0.0,0.05128205128205128,0.9487179487179487,39,1400,1100,300,0.7857142857142857,17,11,6,385.79110750763283,0.4363753936122357,0.29219505404105606,0.22331793823156115,130875.54841342718,2298.124553616975,133173.67296704417,528,1,161.71794871794873,32,7,22,34.323070911484045,0.6380208333333333,44.19191919191919,1023.2323232323231,31.976010101010097,0
3488,4,1,0,38,0.02631578947368421,0.0,1.0,38,800,600,200,0.75,10,6,4,384.55383164605837,0.4367591275486012,0.2920225702889381,0.22466913922302098,131231.07854109266,2493.0828168043927,133724.16135789704,529,0,158.8421052631579,32,6,24,33.99414664202094,0.6416015625,43.84469696969696,1024.6212121212113,32.019412878787854,0
3489,4,0,0,38,0.0,0.0,1.0,38,1600,1300,300,0.8125,19,13,6,379.8718468127995,0.4360182550972025,0.2923074352548043,0.22307910467194583,131428.24172973618,2385.2136519110545,133813.45538164725,530,1,159.8421052631579,31,7,24,33.914417989418006,0.6461693548387097,43.65234374999999,1025.3906249999989,33.077116935483836,0
3490,4,0,0,38,0.0,0.0,1.0,38,1150,900,250,0.782608695652174,14,9,5,382.65512287873713,0.43530701754385964,0.29700870401667356,0.22550035251769404,131561.79004245327,2468.558586968312,134030.34862942158,531,2,160.8421052631579,31,7,21,33.70787853788553,0.647513440860215,43.522135416666664,1025.9114583333328,33.093918010752674,0
3491,4,0,0,38,0.0,0.0,1.0,38,1100,600,500,0.5454545454545454,16,6,10,381.7242872635288,0.43484767662399243,0.2998865267162836,0.22613794177858182,131762.2396681043,2459.369405110673,134221.609073215,532,3,161.8421052631579,31,7,21,33.528984358486575,0.6495295698924731,43.326822916666664,1026.6927083333328,33.1191196236559,0
3492,4,0,1,37,0.0,0.02631578947368421,0.9736842105263158,38,1400,1000,400,0.7142857142857143,18,10,8,385.04532377220994,0.433884542437174,0.2991861783736902,0.22911067907712948,131929.39758300784,2559.759521484375,134489.15710449222,533,4,162.8421052631579,31,7,22,33.274714828897345,0.6512096774193548,43.1640625,1027.3437500000002,33.14012096774194,0
3493,4,0,0,37,0.0,0.0,1.0,37,600,300,300,0.5,9,3,6,389.04979318029586,0.4343718718718719,0.272766385646271,0.22284607972595522,130468.48127312386,2753.408643758019,133221.8899168819,534,5,163.86486486486487,30,7,21,34.65333508748851,0.6392361111111111,44.59005376344085,1021.639784946235,34.05465949820783,8
3494,4,0,0,37,0.0,0.0,1.0,37,1450,1000,450,0.6896551724137931,19,10,9,425.273565638759,0.4345908408408408,0.3221711105829064,0.2215778443072022,126698.43885633665,3439.185976047609,130137.62483238426,535,6,164.86486486486487,31,6,16,37.603466114847386,0.5981182795698925,48.30729166666666,1006.7708333333321,32.47647849462361,8
3495,4,2,1,38,0.05128205128205128,0.02564102564102564,0.9743589743589743,39,1200,900,300,0.75,15,9,6,400.3639240885255,0.438540260908682,0.30760890137844976,0.21178748148508156,127314.91246110084,2395.069941145184,129709.98240224602,536,0,157.35897435897436,32,7,16,37.5943533925518,0.6018880208333333,47.695707070707066,1009.2171717171713,31.5380366161616,0
3496,4,1,0,39,0.02564102564102564,0.0,1.0,39,1400,900,500,0.6428571428571429,19,9,10,402.02567521100104,0.4391587944219523,0.3221189912862832,0.21350606575946768,127474.24529384746,2449.5839072543504,129923.8292011018,537,0,158.33333333333334,32,7,17,37.38825331332832,0.603515625,47.53787878787878,1009.848484848484,31.557765151515124,0
3497,4,2,1,40,0.04878048780487805,0.024390243902439025,0.975609756097561,41,1000,700,300,0.7,13,7,6,384.5949098226497,0.4432926829268293,0.31570190084399163,0.20721330312497846,128054.14540816299,1649.7945011337608,129703.93990929675,538,0,151.5609756097561,34,7,19,37.23266094252334,0.6047794117647058,46.9642857142857,1012.142857142855,29.768907563025145,0
3498,4,2,0,42,0.047619047619047616,0.0,1.0,42,1100,600,500,0.5454545454545454,16,6,10,372.3435749299094,0.4465979481223384,0.3197550317944593,0.2036657217941389,128657.32001133768,1180.9771825396554,129838.29719387734,539,0,147.6904761904762,34,8,19,36.92526206680746,0.610906862745098,46.369047619047606,1014.5238095238079,29.838935574229644,0
3499,4,0,1,41,0.0,0.023809523809523808,0.9761904761904762,42,1050,700,350,0.6666666666666666,14,7,7,372.3435749299094,0.4465979481223384,0.3197550317944593,0.2036657217941389,128657.32001133768,1180.9452947845537,129838.26530612224,540,1,148.6904761904762,34,8,19,36.92526206680746,0.610906862745098,46.369047619047606,1014.5238095238079,29.838935574229644,0
3500,4,0,0,41,0.0,0.0,1.0,41,1350,800,550,0.5925925925925926,19,8,11,381.7102801179254,0.4437245934959349,0.3277282440498126,0.20821704469188085,128548.11137843614,1613.627120578621,130161.73849901475,541,2,153.26829268292684,33,8,19,36.79947129909365,0.6120580808080809,46.47671568627451,1014.0931372549016,30.730095068330353,0
3501,4,1,0,42,0.023809523809523808,0.0,1.0,42,900,500,400,0.5555555555555556,13,5,8,375.8612111724844,0.44371854432830043,0.3287277396304362,0.20684491169685748,128898.98667800458,1289.6258503401477,130188.61252834473,542,0,150.5952380952381,34,8,20,36.58899960922237,0.6133578431372548,46.13095238095239,1015.4761904761908,29.866946778711494,0
3502,4,0,1,41,0.0,0.023809523809523808,0.9761904761904762,42,1050,600,450,0.5714285714285714,15,6,9,377.0556562386225,0.44334349593495936,0.32600882846986234,0.20797775789813627,128989.67013888898,1327.2569444444543,130316.92708333343,543,1,151.5952380952381,34,8,21,36.46602406343997,0.6142769607843137,46.04166666666667,1015.833333333334,29.87745098039218,0
3503,4,0,0,41,0.0,0.0,1.0,41,1400,1000,400,0.7142857142857143,18,10,8,382.2604806248211,0.44341971544715447,0.31881806331635487,0.21081551057213202,128983.44574502605,1661.0547926278477,130644.5005376539,544,2,154.3658536585366,33,8,21,36.34020489001487,0.6164772727272727,46.047794117647065,1015.8088235294126,30.782085561497354,0
3504,4,2,1,42,0.046511627906976744,0.023255813953488372,0.9767441860465116,43,1250,800,450,0.64,17,8,9,362.3561993638431,0.4465439276485788,0.3069259811542244,0.20275350697228786,129554.63927469142,788.9853395061789,130343.6246141976,545,0,148.13953488372093,35,8,19,36.263642564802176,0.6178571428571429,45.486111111111114,1018.0555555555561,29.087301587301603,0
3505,4,0,1,41,0.0,0.023809523809523808,0.9761904761904762,42,1400,800,600,0.5714285714285714,20,8,12,378.656866836122,0.44483159117305454,0.3091296755511035,0.19735986127066676,126713.00482521017,1210.1352184070824,127923.14004361726,546,1,152.66666666666666,35,7,16,38.76175901444613,0.5889880952380953,48.29282407407408,1006.8287037037047,28.76653439153442,8
3506,4,1,0,42,0.023809523809523808,0.0,1.0,42,950,400,550,0.42105263157894735,15,4,11,369.75688626421095,0.44503726287262874,0.3067574253475269,0.19411694363348722,127006.8648674014,992.332577509967,127999.19744491136,547,0,152.95238095238096,36,6,18,38.68329423155699,0.5899884259259259,48.00112612612614,1007.9954954954973,27.999874874874923,0
3507,4,1,1,42,0.023255813953488372,0.023255813953488372,0.9767441860465116,43,1500,1100,400,0.7333333333333333,19,11,8,366.05388594751844,0.44562107788851973,0.3033099979982614,0.1941527834096877,127422.33737244902,728.7739511436444,128151.11132359266,548,0,150.37209302325581,34,9,16,38.34969343237825,0.5983455882352942,47.589285714285715,1009.6428571428576,29.695378151260517,0
3508,4,0,0,42,0.0,0.0,1.0,42,1700,1400,300,0.8235294117647058,20,14,6,345.6742890820576,0.4442508710801394,0.2039231276926361,0.17784466652773082,126181.50686990199,323.540536511205,126505.0474064132,549,2,154.95238095238096,37,5,17,40.138669104005245,0.5796734234234234,48.82127192982455,1004.7149122806994,27.154457088667552,8
3509,4,0,0,42,0.0,0.0,1.0,42,1850,1300,550,0.7027027027027027,24,13,11,330.1981119213333,0.4444686411149826,0.16539570444441165,0.16813736751404126,125756.34901258687,-95.09819878471257,125661.25081380215,550,3,155.95238095238096,39,3,15,40.96490203205597,0.5718482905982907,49.24479166666667,1003.0208333333339,25.71848290598292,8
3510,4,2,1,43,0.045454545454545456,0.022727272727272728,0.9772727272727273,44,1200,800,400,0.6666666666666666,16,8,8,320.67407431667095,0.4469256518675124,0.179687952854797,0.16561707131283593,126339.03704616832,-696.2845485112504,125642.75249765707,551,0,149.8181818181818,38,6,14,40.60485299326959,0.5794956140350878,48.66452991452991,1005.3418803418792,26.456365272154716,0
3511,4,2,0,45,0.044444444444444446,0.0,1.0,45,1450,900,550,0.6206896551724138,20,9,11,354.8654894793549,0.4479587542087542,0.2270649938772209,0.17944775382820377,125469.189453125,46.41984868096654,125515.60930180596,552,0,147.44444444444446,39,6,19,40.6429784431968,0.5689102564102564,49.53125,1001.875,25.689102564102566,8
3512,4,5,2,48,0.1,0.04,0.96,50,1450,1000,450,0.6896551724137931,19,10,9,329.7508491331743,0.4564625850340136,0.2580511016861491,0.1720292206460006,126750.8802625866,-1634.1932508680816,125116.68701171852,553,0,133.6,39,11,17,39.95390245163959,0.5819978632478633,48.25520833333332,1006.9791666666649,25.819978632478588,0
3513,4,2,1,49,0.04,0.02,0.98,50,1800,1200,600,0.6666666666666666,24,12,12,329.4323159874983,0.45780612244897956,0.2748755299489074,0.17366463465724882,127174.94956380787,-1619.975482239757,125554.97408156811,554,0,134.4,37,13,21,39.527281045041114,0.5898085585585586,47.83442982456139,1008.6622807017526,27.26114272166899,0
3514,4,1,2,48,0.02,0.04,0.96,50,1350,1100,250,0.8148148148148148,16,11,5,327.34064844976234,0.4574319727891156,0.2739937004453128,0.17350750433373405,127396.24361582405,-1659.6062009464558,125736.6374148776,555,0,135.08,37,13,15,39.353548930161814,0.5920608108108107,47.61513157894736,1009.5394736842101,27.284850640113785,0
3515,4,5,3,50,0.09433962264150944,0.05660377358490566,0.9433962264150944,53,1000,700,300,0.7,13,7,6,310.1131178360473,0.4609941944847605,0.29126773905308156,0.1679144757397811,128252.72715547164,-2641.0470241349103,125611.68013133673,556,0,128.26415094339623,38,15,19,38.91511092360159,0.5989583333333333,46.7681623931624,1012.9273504273513,26.655982905982928,0
3516,4,2,1,51,0.038461538461538464,0.019230769230769232,0.9807692307692307,52,1450,1200,250,0.8275862068965517,17,12,5,320.79750826036127,0.4575006284565108,0.3136586117053597,0.17407456100023477,128338.88942992066,-2165.8408115958914,126173.04861832477,557,0,131.59615384615384,37,15,21,38.556771453305906,0.6016328828828829,46.68311403508771,1013.2675438596484,27.38560929350401,0
3517,4,0,1,50,0.0,0.0196078431372549,0.9803921568627451,51,1750,1200,550,0.6857142857142857,23,12,11,324.6965254011929,0.4577777777777778,0.31066514710657467,0.17594552482003628,128283.34349270914,-1869.368820213932,126413.97467249521,558,1,134.88235294117646,37,14,22,38.51460746112492,0.6010698198198199,46.73793859649122,1013.0482456140339,27.379682313892808,0
3518,4,0,0,50,0.0,0.0,1.0,50,1400,1200,200,0.8571428571428571,16,12,4,332.7143027745139,0.4556292517006803,0.3158728747638624,0.18069378459069707,128372.67324334475,-1457.7151053080063,126914.95813803675,559,2,138.46,36,14,16,38.220450420417066,0.6038773148148149,46.64977477477478,1013.4009009009013,28.150025025025037,0
3519,4,1,3,48,0.0196078431372549,0.058823529411764705,0.9411764705882353,51,1300,1000,300,0.7692307692307693,16,10,6,324.71544071672275,0.45676470588235296,0.3181232735099222,0.17805486488589942,128755.86718990435,-1838.1963681132947,126917.67082179106,560,0,136.72549019607843,37,14,19,38.032987611639285,0.6058558558558558,46.27192982456139,1014.9122807017526,27.43006164058791,0
3520,4,0,0,48,0.0,0.0,1.0,48,1450,700,750,0.4827586206896552,22,7,15,351.95302694524213,0.45320811170212766,0.3330690627202253,0.1913491744196547,128415.8801020409,-560.7284580498786,127855.15164399102,561,1,145.64583333333334,34,14,20,37.68890454936967,0.6084558823529411,46.60714285714286,1013.5714285714292,29.81092436974792,0
3521,4,2,0,50,0.04,0.0,1.0,50,950,700,250,0.7368421052631579,12,7,5,339.03641449550094,0.4554336734693878,0.34429568879530015,0.18733163306753867,129058.3166570287,-1248.9062119551977,127809.4104450735,562,0,140.78,36,14,22,37.36169603605599,0.6108217592592593,45.9740990990991,1016.103603603604,28.22510010010011,0
3522,4,1,0,51,0.0196078431372549,0.0,1.0,51,1600,1200,400,0.75,20,12,8,347.6726792909974,0.45676470588235296,0.2883229176999633,0.18914669616473526,128442.17985243625,-1263.2400535163913,127178.93979891986,563,0,139.0,38,13,12,37.77051714446318,0.6008771929824561,46.58119658119658,1013.6752136752136,26.67566351776878,8
3523,4,0,1,50,0.0,0.0196078431372549,0.9803921568627451,51,1950,1400,550,0.717948717948718,25,14,11,351.75786962719366,0.4564052287581699,0.2870130567499809,0.19215127814963012,128604.67916757963,-1152.4584063847062,127452.22076119493,564,1,140.0,38,13,14,37.50109718418651,0.6025219298245614,46.42094017094016,1014.3162393162378,26.692532613585204,0
3524,4,0,1,49,0.0,0.02,0.98,50,2100,1500,600,0.7142857142857143,27,15,12,354.86485682492025,0.45590986394557825,0.27403796818881454,0.19482580449345646,128804.55864800364,-858.3577473958134,127946.20090060783,565,2,135.98,39,11,14,37.21833846416967,0.6028311965811965,46.22395833333334,1015.1041666666681,26.028311965812,0
3525,4,0,2,47,0.0,0.04081632653061224,0.9591836734693877,49,1200,700,500,0.5833333333333334,17,7,10,360.23224376731264,0.454187925170068,0.28725241675617563,0.19758696973380346,128767.28121119176,-522.7746730951549,128244.50653809661,566,3,139.57142857142858,38,11,14,37.1201754385965,0.6041666666666667,46.260683760683776,1014.9572649572673,26.70940170940177,0
3526,4,0,1,46,0.0,0.02127659574468085,0.9787234042553191,47,1700,1200,500,0.7058823529411765,22,12,10,366.98284516379107,0.45330326857847675,0.2829683893858146,0.2025072102705495,129006.37846500851,68.62556267313542,129075.00402768164,567,4,142.70212765957447,37,10,15,36.70478053606764,0.6083896396396397,46.02521929824562,1015.899122807018,27.456733048838323,0
3527,4,1,0,47,0.02127659574468085,0.0,1.0,47,1350,1100,250,0.8148148148148148,16,11,5,364.1494221983335,0.4519349367869257,0.29089640739448863,0.2019374068554396,129201.38888888896,9.722222222226577,129211.1111111112,568,0,143.5744680851064,37,10,16,36.577868852459,0.6103603603603603,45.833333333333336,1016.6666666666673,27.477477477477496,0
3528,4,1,1,47,0.020833333333333332,0.020833333333333332,0.9791666666666666,48,1650,1000,650,0.6060606060606061,23,10,13,357.3303061299769,0.4529957151300236,0.29063483735571927,0.200079777756679,129581.83235627133,-339.29683505005323,129242.53552122127,569,0,141.5625,38,10,14,36.36389471843301,0.612390350877193,45.4594017094017,1018.1623931623922,26.793747188484005,0
3529,4,0,0,47,0.0,0.0,1.0,47,1200,800,400,0.6666666666666666,16,8,8,363.0303535903933,0.4513760407030527,0.29591497612886575,0.20289047395422133,129508.13140822161,3.076547591550735,129511.20795581317,570,2,145.5744680851064,37,10,14,36.29383011957341,0.6134572072072072,45.53179824561403,1017.8728070175426,27.51007586533899,0
3530,4,1,0,48,0.020833333333333332,0.0,1.0,48,1650,1400,250,0.8484848484848485,19,14,5,355.0741044283982,0.45321734633569744,0.2957730797443161,0.2006200224132742,129935.6020915515,-372.6464907955387,129562.95560075596,571,0,143.52083333333334,38,10,16,36.061773027349886,0.615953947368421,45.11217948717948,1019.5512820512811,26.830296896086345,0
3531,4,0,1,47,0.0,0.020833333333333332,0.9791666666666666,48,1250,600,650,0.48,19,6,13,353.59457736656435,0.4532819887706856,0.29280382399161864,0.20006284771569974,129990.07100819997,-407.24315600117427,129582.8278521988,572,1,144.52083333333334,38,10,17,36.044176706827294,0.6165021929824561,45.05876068376068,1019.7649572649569,26.83591992802518,0
3532,4,0,0,47,0.0,0.0,1.0,47,1700,1200,500,0.7058823529411765,22,12,10,360.1646433113656,0.45156876349059516,0.28962708762296985,0.20374277267613738,129982.90339335169,-36.95079255156591,129945.95260080013,573,2,148.40425531914894,37,10,17,35.8839605734767,0.6182432432432432,45.065789473684205,1019.7368421052623,27.560455192034116,0
3533,4,0,0,47,0.0,0.0,1.0,47,1350,900,450,0.6666666666666666,18,9,9,360.19042777029813,0.4514531298180697,0.28968745067448753,0.20390329693801199,130010.85820877553,-34.26667339953167,129976.591535376,574,3,149.40425531914894,37,10,18,35.85490359459556,0.6185247747747749,45.038377192982445,1019.8464912280682,27.563418681839682,0
3534,4,0,2,45,0.0,0.0425531914893617,0.9574468085106383,47,800,200,600,0.25,14,2,12,361.54809847039263,0.45158803576934936,0.29247543952726884,0.2051124090346664,130094.74068944271,7.101223453353242,130101.84191289607,575,4,150.40425531914894,37,10,19,35.73507810260819,0.6193693693693694,44.956140350877185,1020.1754385964897,27.57230915125648,0
3535,4,0,1,44,0.0,0.022222222222222223,0.9777777777777777,45,1400,900,500,0.6428571428571429,19,9,10,375.5689031769484,0.4500420875420876,0.2957311534968208,0.21205198071683068,129908.37191358011,757.9089506172628,130666.28086419737,576,5,156.37777777777777,35,10,19,35.567098092643036,0.6214285714285714,45.13888888888888,1019.4444444444433,29.126984126984095,0
3536,4,0,1,43,0.0,0.022727272727272728,0.9772727272727273,44,1500,1000,500,0.6666666666666666,20,10,10,374.25971161722254,0.4485332980972516,0.30701950352767593,0.20224819128715732,128173.8297994897,850.001473551074,129023.83127304078,577,6,160.47727272727272,35,9,20,37.37153293709756,0.6038690476190476,46.8460648148148,1012.6157407407393,28.931878306878264,8
3537,4,0,0,43,0.0,0.0,1.0,43,950,800,150,0.8421052631578947,11,8,3,377.1260783777972,0.4473975636766334,0.3034816760365904,0.20426262259176795,128265.09530895682,1074.422477324248,129339.51778628107,578,7,162.90697674418604,34,9,21,37.20545892584322,0.6069240196078431,46.75595238095237,1012.9761904761897,29.793417366946755,0
3538,4,0,1,42,0.0,0.023255813953488372,0.9767441860465116,43,1250,900,350,0.72,16,9,7,376.62700399171285,0.4470514950166113,0.3083935027909164,0.20507388529369705,128476.2188208615,1077.522675736941,129553.74149659844,579,8,163.90697674418604,34,9,21,37.001917958352905,0.6090686274509804,46.54761904761904,1013.8095238095224,29.817927170868305,0
3539,4,2,0,44,0.045454545454545456,0.0,1.0,44,1450,900,550,0.6206896551724138,20,9,11,365.83357038961657,0.44805981324876676,0.30080806960589634,0.2012642650520543,128886.73460200043,630.2188590617379,129516.95346106218,580,0,155.70454545454547,36,8,23,36.85607740933789,0.6090856481481481,46.143018018018005,1015.4279279279262,28.206331331331285,0
3540,4,1,1,44,0.022222222222222223,0.022222222222222223,0.9777777777777777,45,1700,1100,600,0.6470588235294118,23,11,12,353.8811836589392,0.44888468013468014,0.29152201257861665,0.196659555328739,129285.00987082536,150.30646448904122,129435.3163353144,581,0,153.22222222222223,37,8,24,36.75370619946091,0.611204954954955,45.751096491228054,1016.9956140350855,27.4863679468942,0
3541,4,0,1,43,0.0,0.022727272727272728,0.9772727272727273,44,1400,900,500,0.6428571428571429,19,9,10,354.8989480175203,0.4479827343199436,0.29826777518318703,0.19737975975949762,129315.90374157931,378.8156399642734,129694.71938154359,582,1,157.04545454545453,36,8,24,36.69637584883377,0.6134259259259259,45.72072072072071,1017.1171171171163,28.25325325325323,0
3542,4,0,1,42,0.0,0.023255813953488372,0.9767441860465116,43,850,400,450,0.47058823529411764,13,4,9,357.7410517129893,0.4465439276485788,0.28808430497069226,0.1995722923007994,129436.83556241418,660.9739368998543,130097.80949931404,583,2,151.04651162790697,35,8,18,36.50098574461633,0.6166666666666667,45.60185185185185,1017.5925925925919,29.074074074074055,0
3543,4,0,1,41,0.0,0.023809523809523808,0.9761904761904762,42,1350,800,550,0.5925925925925926,19,8,11,360.22023870592693,0.44598093302361597,0.2727095516569207,0.20129954515919424,129504.1454081631,930.0028344671034,130434.1482426302,582,3,141.76190476190476,34,8,18,36.369395711500985,0.6194852941176471,45.53571428571428,1017.8571428571415,29.936974789915926,0
3544,4,0,0,41,0.0,0.0,1.0,41,1250,600,650,0.48,19,6,13,368.28325276439585,0.4463160569105691,0.27846287132347514,0.2056887971895297,129481.87183114665,1337.2009863994556,130819.07281754611,583,4,137.3658536585366,33,8,20,36.186910495685325,0.6215277777777778,45.557598039215684,1017.7696078431371,30.841503267973852,0
3545,4,0,1,40,0.0,0.024390243902439025,0.975609756097561,41,1000,600,400,0.6,14,6,8,369.46001803401896,0.4460619918699187,0.2828939448657757,0.20667369493660562,129544.24267409154,1372.2836469146255,130916.52632100617,584,5,138.3658536585366,33,8,20,36.09343023955698,0.6221590909090908,45.496323529411754,1018.0147058823517,30.848930481283386,0
3546,4,1,0,41,0.024390243902439025,0.0,1.0,41,1250,900,350,0.72,16,9,7,372.4056021846679,0.44484247967479673,0.2967729063793705,0.20931763157276156,129731.44531249991,1462.5434027777628,131193.98871527766,585,0,139.21951219512195,33,8,21,35.82779481935922,0.6240530303030303,45.31249999999999,1018.7499999999993,30.8712121212121,0
3547,4,0,1,40,0.0,0.024390243902439025,0.975609756097561,41,900,500,400,0.5555555555555556,13,5,8,370.7082160944071,0.4447154471544716,0.2940495077669303,0.20902916835641924,129856.32216274989,1427.7611075067234,131284.0832702566,586,1,140.21951219512195,33,8,21,35.74393310889343,0.6253156565656566,45.189950980392155,1019.2401960784313,30.886066547831252,0
3548,4,0,0,40,0.0,0.0,1.0,40,1150,700,450,0.6086956521739131,16,7,9,397.5508086217237,0.4436965811965812,0.3416060909888461,0.2080037968519823,126869.31060924893,2088.033925975736,128957.34453522466,587,2,144.525,32,8,21,38.124817228558314,0.5973307291666667,48.137626262626256,1007.449494949494,31.482796717171688,8
3549,4,1,0,41,0.024390243902439025,0.0,1.0,41,1100,700,400,0.6363636363636364,15,7,8,391.4582310093655,0.4458587398373984,0.33777498033044884,0.20694415350085818,127289.0302870008,1766.0583097537444,129055.08859675455,588,0,141.97560975609755,31,10,22,37.84569892473118,0.6041666666666667,47.721354166666664,1009.1145833333328,32.552083333333314,0
3550,4,0,1,40,0.0,0.024390243902439025,0.975609756097561,41,750,600,150,0.8,9,6,3,390.71910334934034,0.4453506097560975,0.3376878350826851,0.20688896783907693,127354.73632812501,1751.9856770833335,129106.72200520834,589,1,142.97560975609755,31,10,19,37.79669762641898,0.6048387096774194,47.65625,1009.3750000000001,32.560483870967744,0
3551,4,1,0,41,0.024390243902439025,0.0,1.0,41,1400,1000,400,0.7142857142857143,18,10,8,392.51582763721035,0.44400406504065043,0.3473754386847634,0.20851731227083586,127486.19927300344,1808.0702039930522,129294.26947699649,590,0,143.9268292682927,31,10,21,37.616039195461575,0.6061827956989247,47.526041666666664,1009.895833333333,32.57728494623655,0
3552,4,0,0,41,0.0,0.0,1.0,41,1800,1600,200,0.8888888888888888,20,16,4,395.3682828750542,0.44458841463414633,0.35268950890408424,0.21096851574212885,127665.57621671252,1894.983930211194,129560.56014692372,591,1,144.9268292682927,32,9,21,37.35944527736132,0.60546875,47.348484848484844,1010.6060606060602,31.58143939393938,0
3553,4,2,0,43,0.046511627906976744,0.0,1.0,43,1200,900,300,0.75,15,9,6,381.0146629304938,0.4502583979328165,0.3414621419004715,0.2062415402178421,128240.42986685025,1174.090335169868,129414.52020202011,592,0,139.13953488372093,32,11,23,37.13226128147593,0.611328125,46.780303030303024,1012.8787878787873,31.652462121212103,0
3554,4,2,3,42,0.044444444444444446,0.06666666666666667,0.9333333333333333,45,1750,1300,450,0.7428571428571429,22,13,9,360.09521579300167,0.4522727272727273,0.3270988886424677,0.19825022320032296,128915.32368517166,284.3582602873129,129199.68194545897,593,0,133.9111111111111,36,9,22,36.97258261255266,0.609375,46.11486486486486,1015.5405405405406,28.209459459459463,0
3555,4,1,0,43,0.023255813953488372,0.0,1.0,43,1600,1200,400,0.75,20,12,8,368.2829362253398,0.44954318936877075,0.333382798753471,0.20301828192924504,128966.15655006852,899.2069615912113,129865.36351165973,594,0,135.65116279069767,35,8,23,36.71281525372226,0.611904761904762,46.06481481481481,1015.7407407407402,29.021164021164005,0
3556,4,0,0,43,0.0,0.0,1.0,43,1200,700,500,0.5833333333333334,17,7,10,367.34495671949884,0.4497277593207826,0.3276996523410707,0.20355777633232544,129171.97312510718,890.1345754029535,130062.10770051013,595,1,136.65116279069767,35,8,23,36.52664712133287,0.6139880952380952,45.86226851851852,1016.5509259259261,29.044312169312175,0
3557,4,0,0,43,0.0,0.0,1.0,43,1400,800,600,0.5714285714285714,20,8,12,367.2594162463334,0.44970468807678105,0.327367581270098,0.20381823743729274,129231.64859693882,892.3113138323803,130123.9599107712,596,2,137.65116279069767,34,9,23,36.46796823166686,0.6167279411764706,45.80357142857143,1016.7857142857147,29.90546218487396,0
3558,4,0,1,42,0.0,0.023255813953488372,0.9767441860465116,43,1400,800,600,0.5714285714285714,20,8,12,366.83567976098726,0.44910483573274274,0.3293643773728685,0.2042091780819307,129352.72285997734,890.2388038548776,130242.96166383222,597,3,138.65116279069767,34,9,23,36.35532475131656,0.617953431372549,45.68452380952381,1017.2619047619048,29.919467787114847,0
3559,4,0,0,42,0.0,0.0,1.0,42,950,700,250,0.7368421052631579,12,7,5,368.2418178732673,0.4478319783197832,0.31716781716781717,0.20530742448550665,129413.28125000003,1131.07638888889,130544.35763888892,598,4,135.57142857142858,34,8,23,36.25784875784876,0.6185661764705883,45.625,1017.5000000000002,29.9264705882353,0
3560,4,0,0,42,0.0,0.0,1.0,42,800,500,300,0.625,11,5,6,367.9310728554397,0.4476626016260163,0.32196748157679345,0.205450211746646,129473.85381235812,1127.4907879818443,130601.34460033997,599,5,136.57142857142858,34,8,18,36.20403945880611,0.6191789215686274,45.56547619047618,1017.7380952380939,29.933473389355704,0
3561,4,2,0,44,0.045454545454545456,0.0,1.0,44,1250,900,350,0.72,16,9,7,352.22958115605275,0.44994274136715995,0.31928820158757243,0.19980261588557818,130090.20580969492,364.32374097071124,130454.52955066563,600,0,131.3181818181818,36,8,21,35.97734297383818,0.6212384259259259,44.96058558558559,1020.1576576576583,28.33771271271273,0
3562,4,0,0,44,0.0,0.0,1.0,44,900,500,400,0.5555555555555556,13,5,8,353.75299867343824,0.44960139182522907,0.3178983856889168,0.20096275366645922,130147.65346004789,408.0245363606855,130555.67799640857,601,1,132.3181818181818,36,8,21,35.8801916639076,0.6218171296296297,44.90427927927928,1020.3828828828829,28.34396896896897,0
3563,4,0,3,41,0.0,0.06818181818181818,0.9318181818181819,44,1000,700,300,0.7,13,7,6,350.1339693648538,0.44950229034531364,0.3089494904918557,0.1993476318042108,130233.84871357847,319.8588791494211,130553.7075927279,602,2,133.3181818181818,36,8,21,35.88509488084731,0.6226851851851851,44.81981981981982,1020.7207207207209,28.35335335335336,0
3564,4,1,0,42,0.023809523809523808,0.0,1.0,42,1200,700,500,0.5833333333333334,17,7,10,353.3539845177403,0.4492958768873403,0.2877011108560128,0.201998613481555,130391.51178770034,814.8815586955604,131206.3933463959,603,0,135.42857142857142,32,10,23,35.643054353649006,0.6331380208333333,44.66540404040405,1021.3383838383846,31.91682449494952,0
3565,4,0,0,42,0.0,0.0,1.0,42,900,400,500,0.4444444444444444,14,4,10,357.69295653755523,0.44915069686411146,0.29146810688693536,0.20533097802943096,130552.75769054201,939.5603764922236,131492.31806703424,604,1,136.42857142857142,32,10,19,35.368791697553725,0.634765625,44.50757575757577,1021.9696969696989,31.93655303030309,0
3566,4,0,0,42,0.0,0.0,1.0,42,850,500,350,0.5882352941176471,12,5,7,355.9719131169883,0.4489087301587302,0.28991663811807666,0.20446320629446865,130575.52984429077,896.2442329873254,131471.7740772781,605,2,137.42857142857142,33,9,19,35.38968824940048,0.6325757575757576,44.485294117647065,1022.0588235294126,30.97147950089129,0
3567,4,0,0,42,0.0,0.0,1.0,42,1550,1200,350,0.7741935483870968,19,12,7,380.35972654502973,0.44861837011227257,0.27724643936124305,0.20748033863942805,128548.11137843625,1520.2117274606067,130068.32310589687,606,3,138.42857142857142,33,9,19,36.833710976837864,0.6120580808080809,46.47671568627452,1014.0931372549027,30.730095068330385,8
3568,4,0,0,42,0.0,0.0,1.0,42,1300,1100,200,0.8461538461538461,15,11,4,386.6228957826166,0.44784407665505227,0.2881610801548007,0.21188776968734943,128734.5931402586,1554.3482374567561,130288.94137771535,607,4,139.42857142857142,33,9,19,36.483994485368115,0.6139520202020202,46.29289215686275,1014.8284313725494,30.752376708259074,0
3569,4,2,1,43,0.045454545454545456,0.022727272727272728,0.9772727272727273,44,1550,1000,550,0.6451612903225806,21,10,11,369.455982103728,0.44907285059901336,0.3008486398511978,0.2069588667658417,129598.82948133671,779.5916741006974,130378.4211554374,608,0,134.04545454545453,31,13,16,36.03793691389599,0.6276881720430108,45.44270833333333,1018.2291666666658,32.84610215053761,0
3570,4,0,0,43,0.0,0.0,1.0,43,2100,1600,500,0.7619047619047619,26,16,10,376.4138706064134,0.4472360649686231,0.32140719619656744,0.21110939286341937,129645.87894915603,1160.1014206844752,130805.9803698405,609,1,137.97674418604652,30,13,17,35.81287668822313,0.6309027777777778,45.39650537634409,1018.4139784946242,33.94713261648747,0
3571,4,0,0,43,0.0,0.0,1.0,43,1150,800,350,0.6956521739130435,15,8,7,374.68293031469136,0.4466362126245847,0.32561705921688056,0.2107759834444616,129764.60986667217,1124.1168551974938,130888.72672186967,610,2,138.97674418604652,31,12,19,35.736022364217256,0.6293682795698925,45.27994791666667,1018.8802083333339,32.86710349462368,0
3572,4,0,0,43,0.0,0.0,1.0,43,1150,600,550,0.5217391304347826,17,6,11,372.49317064287004,0.4465669988925803,0.3208697530419755,0.21048861812044628,129940.55333958281,1080.3937417100428,131020.94708129285,611,3,139.97674418604652,32,11,19,35.61274509803921,0.6285807291666667,45.10732323232324,1019.570707070708,31.861584595959624,0
3573,4,0,1,42,0.0,0.023255813953488372,0.9767441860465116,43,1700,1100,600,0.6470588235294118,23,11,12,374.7805422900174,0.4464747139165744,0.3201054948984725,0.2125118006827046,130075.00120146088,1149.9158977316283,131224.9170991925,612,4,140.97674418604652,33,10,20,35.41766778792246,0.6275252525252526,44.975490196078425,1020.0980392156855,30.91206179441471,0
3574,4,0,0,42,0.0,0.0,1.0,42,1650,1200,450,0.7272727272727273,21,12,9,369.34610578925424,0.4460172280294232,0.30330417881438265,0.2104413858566683,130262.58680555565,1222.5309976932042,131485.11780324887,613,5,141.4047619047619,32,10,21,35.365646258503396,0.6318359375,44.79166666666667,1020.8333333333342,31.901041666666693,0
3575,4,0,0,42,0.0,0.0,1.0,42,1050,700,350,0.6666666666666666,14,7,7,368.76810573307876,0.44532762291908634,0.3035537657199383,0.21063534174923304,130359.27456381997,1214.4685491276368,131573.74311294762,614,6,142.4047619047619,32,10,21,35.28220820969339,0.6328125,44.696969696969695,1021.2121212121208,31.912878787878775,0
3576,4,0,0,42,0.0,0.0,1.0,42,1500,1000,500,0.6666666666666666,20,10,10,367.2988633678591,0.4453034262485482,0.3004554763081708,0.21049450441733125,130488.24737271716,1185.6369885726126,131673.88436128976,615,7,143.4047619047619,32,10,16,35.18881817432857,0.6341145833333333,44.57070707070708,1021.7171717171724,31.928661616161637,0
3577,4,0,0,42,0.0,0.0,1.0,42,850,500,350,0.5882352941176471,12,5,7,367.66657453205056,0.4449283778552071,0.29900455363761536,0.21105625916754747,130552.75769054188,1199.9770431588754,131752.73473370075,616,8,144.4047619047619,32,10,16,35.113973313565616,0.634765625,44.507575757575765,1021.9696969696977,31.936553030303052,0
3578,4,0,1,41,0.0,0.023809523809523808,0.9761904761904762,42,1000,700,300,0.7,13,7,6,362.0141596292377,0.4447469028261711,0.1960202995653837,0.2090384368666473,130780.41459956557,1165.865031255825,131946.2796308214,617,9,145.4047619047619,36,6,17,35.02766156556203,0.6281828703703703,44.2849099099099,1022.8603603603588,28.412787787787742,8
3579,4,0,0,41,0.0,0.0,1.0,41,1350,800,550,0.5925925925925926,19,8,11,366.76405973079216,0.44273373983739833,0.18669042450134077,0.21273251684066163,130953.25213304511,1405.7892774531208,132359.04141049823,618,10,143.90243902439025,36,5,17,34.731085194557515,0.6299189814814814,44.11599099099099,1023.5360360360353,28.431556556556536,0
3580,4,0,1,40,0.0,0.024390243902439025,0.975609756097561,41,850,500,350,0.5882352941176471,12,5,7,364.66211913457187,0.44250508130081306,0.1892262340637263,0.21214796220669616,131068.54056336732,1359.1463507426201,132427.68691410995,619,11,144.90243902439025,36,5,17,34.668151325195204,0.6310763888888888,44.00337837837837,1023.9864864864858,28.444069069069048,0
3581,4,0,2,38,0.0,0.05,0.95,40,1350,1000,350,0.7407407407407407,17,10,7,366.76487611548396,0.44142628205128204,0.2035262206148285,0.21349576472827622,131090.9636488339,1615.912208504785,132706.87585733866,620,12,148.8,35,5,17,34.59162145871006,0.6333333333333333,43.981481481481474,1024.074074074073,29.259259259259228,0
3582,4,0,0,38,0.0,0.0,1.0,38,1100,900,200,0.8181818181818182,13,9,4,387.39366123344405,0.4396040777619725,0.23029868637312956,0.21125603113869873,128536.57171201806,2359.0649582878323,130895.63667030589,621,13,152.94736842105263,34,4,15,36.6672047428974,0.6096813725490196,46.488095238095234,1014.0476190476185,29.82492997198878,6
3583,4,0,1,37,0.0,0.02631578947368421,0.9736842105263158,38,1150,900,250,0.782608695652174,14,9,5,389.8088378618791,0.43884838786154573,0.22841907655446247,0.2133809071995373,128687.51594387757,2432.706207482996,131120.22215136056,622,14,153.94736842105263,34,4,17,36.451366889592876,0.6112132352941176,46.339285714285715,1014.6428571428573,29.842436974789923,0
3584,4,0,1,36,0.0,0.02702702702702703,0.972972972972973,37,750,500,250,0.6666666666666666,10,5,5,390.86661220175745,0.43784409409409414,0.22526960457994938,0.21444843858636958,128778.125,2667.013888888889,131445.13888888888,623,15,156.0,34,3,17,36.3317597153804,0.6121323529411764,46.25,1015.0,29.852941176470587,0
3585,4,1,0,37,0.02702702702702703,0.0,1.0,37,1600,1200,400,0.75,20,12,8,388.3106924924407,0.4383133133133133,0.22886514355930787,0.21434951162551671,129019.90504535146,2619.961734693873,131639.86678004533,624,0,156.43243243243242,34,3,18,36.14927544723067,0.6145833333333333,46.01190476190476,1015.9523809523808,29.88095238095238,0
3586,4,1,0,38,0.02631578947368421,0.0,1.0,38,950,600,350,0.631578947368421,13,6,7,384.669631881607,0.4406264817449028,0.23100714597861716,0.21512818981161694,129534.44054705219,2365.720663265305,131900.16121031748,625,0,153.28947368421052,34,4,14,35.716339219584434,0.6197916666666667,45.50595238095238,1017.9761904761907,29.940476190476197,0
3587,4,0,0,38,0.0,0.0,1.0,38,1300,800,500,0.6153846153846154,18,8,10,386.78351748434693,0.4403004978662874,0.23405551044511674,0.21714696690262938,129685.9693877551,2432.079081632648,132118.04846938775,626,1,154.28947368421052,34,4,14,35.50797685834501,0.6213235294117647,45.357142857142854,1018.5714285714286,29.95798319327731,0
3588,4,0,1,37,0.0,0.02631578947368421,0.9736842105263158,38,1000,400,600,0.4,16,4,12,387.48856669792633,0.44015232337600757,0.2365790669312995,0.2181233594123108,129790.40745027429,2458.4597908093224,132248.86724108362,627,2,155.28947368421052,35,3,14,35.38353778585492,0.6202380952380953,45.254629629629626,1018.981481481481,29.1137566137566,0
3589,4,0,0,37,0.0,0.0,1.0,37,1250,1000,250,0.8,15,10,5,395.53966421383217,0.4380005005005005,0.24062324412709835,0.2230968777996596,129867.92091836738,2873.582766439914,132741.5036848073,628,3,160.40540540540542,34,3,16,35.09937319940822,0.6231617647058824,45.17857142857143,1019.2857142857147,29.978991596638668,0
3590,4,0,0,37,0.0,0.0,1.0,37,1050,700,350,0.6666666666666666,14,7,7,395.53966421383217,0.4380005005005005,0.24062324412709835,0.2230968777996596,129867.92091836738,2873.582766439914,132741.5036848073,629,4,161.40540540540542,34,3,16,35.09937319940822,0.6231617647058824,45.17857142857143,1019.2857142857147,29.978991596638668,0
3591,4,0,1,36,0.0,0.02702702702702703,0.972972972972973,37,1300,1000,300,0.7692307692307693,16,10,6,397.5948546657295,0.4372184684684685,0.23936150068798345,0.22460437568319977,129928.59977324269,2931.788548752839,132860.38832199553,630,5,162.40540540540542,34,3,16,34.98511209715086,0.6237745098039216,45.11904761904762,1019.52380952381,29.985994397759118,0
3592,4,1,2,35,0.02702702702702703,0.05405405405405406,0.9459459459459459,37,1000,500,500,0.5,15,5,10,392.3365264473137,0.43762512512512514,0.2460011031439604,0.2235405790223067,130262.58680555562,2821.3541666666774,133083.9409722223,631,0,161.72972972972974,34,3,18,34.77891156462585,0.6271446078431373,44.79166666666667,1020.8333333333339,30.024509803921585,0
3593,4,0,0,35,0.0,0.0,1.0,35,700,400,300,0.5714285714285714,10,4,6,394.92442393172723,0.4358543417366947,0.22612628529027212,0.2252016143802501,130294.8120727477,3291.3207198245086,133586.13279257223,632,1,163.14285714285714,32,3,19,34.68005400280319,0.6321614583333333,44.76010101010101,1020.9595959595962,31.90498737373738,0
3594,4,2,1,36,0.05405405405405406,0.02702702702702703,0.972972972972973,37,800,500,300,0.625,11,5,6,378.691821116052,0.4390640640640641,0.22024653477485878,0.21952889994165192,130931.84700963716,2516.5639172335555,133448.4109268707,633,0,155.27027027027026,34,3,17,34.44757861269434,0.6338848039215687,44.13690476190476,1023.4523809523807,30.101540616246492,0
3595,4,0,0,36,0.0,0.0,1.0,36,700,500,200,0.7142857142857143,9,5,4,379.39242929723713,0.4389880952380953,0.22798705576870892,0.22063247358928573,131053.71492346934,2744.157454648518,133797.87237811784,634,1,158.72222222222223,34,2,17,34.30608843932876,0.6351102941176471,44.01785714285714,1023.928571428571,30.11554621848738,0
3596,4,0,0,36,0.0,0.0,1.0,36,1150,900,250,0.782608695652174,14,9,5,380.67690164660496,0.43895502645502643,0.22640358014646011,0.22173076403965766,131114.67013888896,2782.465277777783,133897.13541666674,635,2,159.72222222222223,34,2,18,34.21141849742337,0.6357230392156863,43.958333333333336,1024.1666666666672,30.12254901960786,0
3597,4,0,0,36,0.0,0.0,1.0,36,750,600,150,0.8,9,6,3,381.14118341804306,0.4383267195767196,0.22775712275538007,0.22270754688928038,131236.62308673482,2803.9363662131686,134040.559452948,636,3,160.72222222222223,34,2,18,34.07594593547887,0.6369485294117647,43.83928571428572,1024.6428571428582,30.136554621848774,0
3598,4,0,0,36,0.0,0.0,1.0,36,1150,1000,150,0.8695652173913043,13,10,3,385.2539401672219,0.4377810846560846,0.23058742298704082,0.2263907985477045,131453.7677816224,2928.648285294506,134382.4160669169,637,4,161.72222222222223,33,3,21,33.75059751434035,0.6414141414141414,43.627450980392155,1025.490196078431,31.07546048722518,0
3599,4,0,0,36,0.0,0.0,1.0,36,800,500,300,0.625,11,5,6,384.81462925136583,0.4376984126984127,0.22901234567901252,0.22650481342010761,131516.6116998269,2921.903234332941,134438.51493415984,638,5,162.72222222222223,33,3,21,33.69822779769016,0.6420454545454546,43.56617647058823,1025.7352941176464,31.08288770053474,0
3600,4,0,1,35,0.0,0.027777777777777776,0.9722222222222222,36,1200,1000,200,0.8333333333333334,14,10,4,382.7192871463578,0.43705357142857143,0.2274461028192376,0.2262014135392198,131673.78720023538,2878.819594627054,134552.60679486243,639,6,163.72222222222223,33,3,17,33.592910447761184,0.6436237373737373,43.412990196078425,1026.3480392156855,31.101455733808653,0
3601,4,0,0,35,0.0,0.0,1.0,35,950,600,350,0.631578947368421,13,6,7,393.6008848580201,0.4351190476190476,0.24206271091113662,0.23249912733473713,131651.8722579327,3363.6586827874517,135015.53094072014,640,7,168.28571428571428,32,3,17,33.33589648950132,0.6458333333333333,43.434343434343425,1026.262626262625,32.07070707070703,0
3602,4,0,0,35,0.0,0.0,1.0,35,1050,600,450,0.5714285714285714,15,6,9,393.00057064281054,0.43497899159663866,0.2389374000737916,0.23273762854309474,131749.0741537853,3355.4922648199145,135104.56641860522,641,8,169.28571428571428,32,3,17,33.252879924568525,0.6468098958333333,43.339646464646464,1026.641414141414,32.08254419191919,0
3603,4,0,0,35,0.0,0.0,1.0,35,950,700,250,0.7368421052631579,12,7,5,393.29611113673883,0.4352591036414566,0.2397555235519344,0.2335088005829365,131846.31191970193,3370.928349148031,135217.24026884994,642,9,170.28571428571428,32,3,17,33.14687320711417,0.6477864583333333,43.24494949494949,1027.020202020201,32.09438131313128,0
3604,4,0,0,35,0.0,0.0,1.0,35,900,600,300,0.6666666666666666,12,6,6,393.8744419877779,0.43480392156862746,0.23767861531439838,0.23465228469227925,131976.01807213546,3396.396094786238,135372.4141669217,643,10,171.28571428571428,32,3,18,33.000788482018514,0.6490885416666667,43.118686868686865,1027.525252525252,32.110164141414124,0
3605,4,0,1,34,0.0,0.02857142857142857,0.9714285714285714,35,1150,1000,150,0.8695652173913043,13,10,3,394.26944856691296,0.4351890756302521,0.18047630437010964,0.2305511278962606,131265.32613658212,3350.7815503652464,134616.10768694736,644,11,172.28571428571428,33,2,20,33.710535756995924,0.639520202020202,43.81127450980392,1024.7549019607845,31.0531788472965,8
3606,4,0,0,34,0.0,0.0,1.0,34,1200,1100,100,0.9166666666666666,13,11,2,397.5640209344938,0.4327837195484254,0.19944269300303352,0.23326520870627432,131394.86524793826,3647.5892098854624,135042.4544578237,645,12,178.02941176470588,31,3,20,33.494729489458976,0.6458333333333333,43.68489583333333,1025.2604166666658,33.07291666666664,0
3607,4,0,0,34,0.0,0.0,1.0,34,1400,1300,100,0.9285714285714286,15,13,2,397.8883073076325,0.4318553178847297,0.19658528108436868,0.23423511656284116,131522.3255280074,3666.239095500464,135188.56462350787,646,13,179.02941176470588,32,2,20,33.35718242245198,0.64453125,43.56060606060606,1025.7575757575762,32.054924242424256,0
3608,4,0,0,34,0.0,0.0,1.0,34,750,600,150,0.8,9,6,3,393.93056325175183,0.43116830065359474,0.19206663964798576,0.2326938675952206,131651.8722579327,3572.339238343008,135224.2114962757,647,14,180.02941176470588,32,2,19,33.32743807414699,0.6458333333333333,43.434343434343425,1026.262626262625,32.07070707070703,0
3609,4,1,0,35,0.02857142857142857,0.0,1.0,35,1000,700,300,0.7,13,7,6,381.7156875787538,0.43196778711484596,0.19359629402547873,0.22805065437397343,132082.88278546714,3083.6216839677063,135166.50446943485,648,0,175.85714285714286,33,2,20,33.205174058178365,0.6477272727272727,43.01470588235294,1027.9411764705883,31.149732620320858,0
3610,4,0,0,35,0.0,0.0,1.0,35,950,500,450,0.5263157894736842,14,5,9,384.64548556510283,0.43144257703081235,0.20033020714541028,0.23075979702272406,132240.39619677534,3173.134281286053,135413.5304780614,649,1,176.85714285714286,33,2,20,32.97080404305176,0.6493055555555556,42.86151960784314,1028.553921568628,31.16830065359479,0
3611,4,0,0,35,0.0,0.0,1.0,35,1150,800,350,0.6956521739130435,15,8,7,384.3695192512581,0.4308823529411765,0.20242914979757076,0.23155919818307494,132398.00347222216,3177.9513888888805,135575.95486111104,650,2,177.85714285714286,33,2,21,32.818825910931174,0.6508838383838385,42.70833333333333,1029.166666666666,31.186868686868667,0
3612,4,0,0,35,0.0,0.0,1.0,35,600,400,200,0.6666666666666666,8,4,4,384.35015161843864,0.430812324929972,0.20428282278502552,0.23174134410935154,132429.5361910083,3179.8624627547147,135609.398653763,651,3,178.85714285714286,33,2,21,32.78750942572528,0.651199494949495,42.677696078431374,1029.2892156862747,31.190582293523477,0
3613,4,0,0,35,0.0,0.0,1.0,35,1450,1000,450,0.6896551724137931,19,10,9,383.1912374278983,0.43025210084033616,0.19897655599190744,0.231818284240938,132555.70461180795,3158.8368956651284,135714.54150747307,652,4,179.85714285714286,33,2,21,32.69008588202626,0.6524621212121212,42.55514705882353,1029.7794117647059,31.2054367201426,0
3614,4,0,1,34,0.0,0.02857142857142857,0.9714285714285714,35,1200,1000,200,0.8333333333333334,14,10,4,382.6283629024711,0.4293417366946779,0.19968050032289852,0.2320616175005896,132650.37035034606,3151.1588091118765,135801.52915945795,653,5,180.85714285714286,33,2,18,32.60914822745657,0.6534090909090908,42.463235294117645,1030.1470588235295,31.216577540106954,0
3615,4,0,0,34,0.0,0.0,1.0,34,1300,900,400,0.6923076923076923,17,9,8,391.18118160236696,0.42918152109328583,0.21852086833017315,0.2372971941036218,132658.02158261914,3578.6643263442556,136236.6859089634,654,6,185.85294117647058,32,2,18,32.381163949830444,0.6559244791666667,42.45580808080808,1030.176767676768,32.193023989899,0
3616,4,0,0,34,0.0,0.0,1.0,34,1300,900,400,0.6923076923076923,17,9,8,392.37066274113636,0.4280117349970291,0.21258404133428455,0.23884576584309464,132788.12629132243,3620.4330234159897,136408.55931473844,655,7,186.85294117647058,32,2,18,32.21931275266446,0.6572265625,42.32954545454546,1030.6818181818192,32.20880681818185,0
3617,4,0,0,34,0.0,0.0,1.0,34,800,600,200,0.75,10,6,4,394.4918875807044,0.42786319073083784,0.14741809689902197,0.228468072549503,130894.72664727108,3559.3059150969075,134454.032562368,656,8,187.85294117647058,31,3,20,34.08101645671629,0.6407930107526882,44.173177083333336,1023.3072916666669,33.00991263440861,8
3618,4,0,0,34,0.0,0.0,1.0,34,700,400,300,0.5714285714285714,10,4,6,394.46289713756653,0.4279745989304813,0.14442448735219315,0.22864884745584607,130928.03955078124,3529.250759548611,134457.29031032984,657,9,188.85294117647058,31,3,20,34.047921967769305,0.6411290322580645,44.140625,1023.4374999999999,33.0141129032258,0
3619,4,0,0,34,0.0,0.0,1.0,34,1150,800,350,0.6956521739130435,15,8,7,395.30563209602616,0.427584670231729,0.14502397677880752,0.22973305137997443,131028.00369262697,3559.221564398871,134587.22525702583,658,10,189.85294117647058,31,3,20,33.924843147229645,0.6421370967741935,44.04296875,1023.8281250000001,33.02671370967742,0
3620,4,0,0,34,0.0,0.0,1.0,34,1000,700,300,0.7,13,7,6,400.13295119342047,0.42572786690433745,0.15040820598702087,0.23354941097847418,131194.69536675353,3699.0641276041706,134893.75949435768,659,11,190.85294117647058,31,3,21,33.632011523470595,0.6438172043010753,43.880208333333336,1024.479166666667,33.04771505376345,0
3621,4,0,0,34,0.0,0.0,1.0,34,1450,1300,150,0.896551724137931,16,13,3,399.2332606252892,0.4259135472370767,0.15303682448589195,0.2338366240805265,131328.125,3686.1789279513882,135014.30392795138,660,12,191.85294117647058,30,4,21,33.519647696476966,0.6479166666666667,43.75,1025.0,34.166666666666664,0
3622,4,0,0,34,0.0,0.0,1.0,34,1000,700,300,0.7,13,7,6,399.80246285872306,0.42580213903743314,0.15155346542286652,0.23501485297473462,131465.9299485489,3712.0805150884385,135178.01046363733,661,13,192.85294117647058,30,4,22,33.36527959807776,0.6493055555555556,43.61559139784946,1025.5376344086017,34.184587813620055,0
3623,4,0,0,34,0.0,0.0,1.0,34,950,800,150,0.8421052631578947,11,8,3,395.35672754092525,0.42548648247177656,0.15577673779827883,0.2333937355618001,131628.58963012695,3608.049689398871,135236.63931952583,662,14,193.85294117647058,31,3,19,33.314432390136616,0.6481854838709677,43.45703125,1026.171875,33.102318548387096,0
3624,4,0,0,34,0.0,0.0,1.0,34,900,800,100,0.8888888888888888,10,8,2,395.5591816252096,0.42522653000594174,0.14765563803200465,0.23433389535047155,131762.23966810427,3623.9527384440053,135386.19240654827,663,15,194.85294117647058,31,3,20,33.1738797294441,0.6495295698924731,43.326822916666664,1026.6927083333326,33.11911962365589,0
3625,4,0,0,34,0.0,0.0,1.0,34,550,400,150,0.7272727272727273,7,4,3,396.9158482445929,0.4242795603089721,0.14777472855267892,0.23575844961998094,131862.52170138882,3667.6649305555507,135530.18663194438,664,16,195.85294117647058,31,3,20,33.037525354969574,0.6505376344086021,43.229166666666664,1027.0833333333328,33.13172043010751,0
3626,4,0,0,34,0.0,0.0,1.0,34,750,500,250,0.6666666666666666,10,5,5,396.9158482445929,0.4244281045751634,0.14777472855267892,0.23575844961998094,131862.52170138882,3667.6649305555507,135530.18663194438,665,17,196.85294117647058,31,3,20,33.037525354969574,0.6505376344086021,43.229166666666664,1027.0833333333328,33.13172043010751,0
3627,4,0,0,34,0.0,0.0,1.0,34,1000,900,100,0.9,11,9,2,386.94394875251055,0.4246137849079026,0.14581388110799876,0.21800988332153634,129825.09731833896,3247.0071607074015,133072.10447904636,666,18,197.85294117647058,33,1,20,35.362053070386395,0.625,45.22058823529411,1019.1176470588224,30.882352941176435,8
3628,4,2,1,35,0.05555555555555555,0.027777777777777776,0.9722222222222222,36,1000,500,500,0.5,15,5,10,356.3217151057032,0.43096891534391535,0.09960647884110929,0.19512007972090561,128701.77636584787,1972.5834332140455,130674.35979906192,667,0,187.80555555555554,35,1,18,37.28624862172542,0.6092261904761904,46.32523148148148,1014.6990740740737,28.991402116402107,7
3629,4,1,0,36,0.027777777777777776,0.0,1.0,36,750,600,150,0.8,9,6,3,355.744063033725,0.4326884920634921,0.089406259103056,0.19567038652005464,128877.99968117719,1969.5166484482236,130847.5163296254,647,0,170.25,35,1,19,37.121114973973164,0.6110119047619047,46.151620370370374,1015.393518518519,29.0112433862434,0
3630,4,0,1,35,0.0,0.027777777777777776,0.9722222222222222,36,1250,1000,250,0.8,15,10,5,356.9156462375104,0.43234126984126986,0.10233262528518594,0.18832522952781205,127212.08191609972,1881.2017118125466,129093.28362791227,648,1,171.25,34,2,18,38.79612146959327,0.5962009803921569,47.797619047619044,1008.8095238095234,29.670868347338924,8
3631,4,3,0,38,0.07894736842105263,0.0,1.0,38,1000,600,400,0.6,14,6,8,362.60916808553657,0.4373666429587482,0.15867255833661176,0.1884570661388963,126596.50051708227,1620.5582495021936,128217.05876658447,649,0,163.1315789473684,35,3,15,39.285628713820195,0.5877976190476191,48.4085648148148,1006.365740740739,28.75330687830683,8
3632,4,1,0,39,0.02564102564102564,0.0,1.0,39,1350,1000,350,0.7407407407407407,17,10,7,355.8977524540037,0.43868083670715247,0.15705558039040368,0.18645041504440443,126921.74437951474,1234.232712442183,128155.97709195693,650,0,159.92307692307693,36,3,18,39.12000819549992,0.5891203703703703,48.08558558558559,1007.6576576576584,27.99049049049051,0
3633,4,1,3,37,0.025,0.075,0.925,40,1300,1000,300,0.7692307692307693,16,10,6,349.3910360338962,0.4400106837606838,0.14808527973927177,0.18494217864818938,127340.9020684248,898.3539406355651,128239.25600906037,651,0,156.9,37,3,13,38.85377059569073,0.5914977477477478,47.66995614035087,1009.3201754385957,27.278923660502585,0
3634,4,4,3,38,0.0975609756097561,0.07317073170731707,0.926829268292683,41,1300,1000,300,0.7692307692307693,16,10,6,336.7809218358723,0.44738313008130076,0.1461054206959247,0.18102673457619403,127960.0273980034,418.8991970486068,128378.926595052,652,0,149.2439024390244,39,2,15,38.53866381825048,0.594284188034188,47.057291666666664,1011.7708333333327,25.942841880341863,0
3635,4,3,1,40,0.07317073170731707,0.024390243902439025,0.975609756097561,41,850,500,350,0.5882352941176471,12,5,7,337.8704300328597,0.4465701219512195,0.1621675870694137,0.18257331447271646,128171.57594601513,461.2100175808456,128632.78596359598,653,0,150.1219512195122,38,3,18,38.295042906379685,0.5981359649122807,46.8482905982906,1012.6068376068382,26.64754835807469,0
3636,4,1,1,40,0.024390243902439025,0.024390243902439025,0.975609756097561,41,1400,1200,200,0.8571428571428571,16,12,4,338.15219315685135,0.44720528455284553,0.16962832076912981,0.18334461107526723,128306.8422296187,477.448019395138,128784.29024901384,654,0,151.0,38,3,19,38.14984709480122,0.5995065789473684,46.71474358974359,1013.1410256410259,26.661605937921735,0
3637,4,0,1,39,0.0,0.025,0.975,40,850,400,450,0.47058823529411764,13,4,9,354.31142283821646,0.4452857905982906,0.14502062303267138,0.18857718882775779,127562.3403956025,1057.2593007964676,128619.59969639896,655,1,155.575,37,3,17,38.502546220919704,0.59375,47.45065789473684,1010.1973684210527,27.30263157894737,8
3638,4,0,2,37,0.0,0.05128205128205128,0.9487179487179487,39,950,700,250,0.7368421052631579,12,7,5,363.03478167204884,0.44101439496176337,0.14936247723133,0.19273729350226526,127461.32270361567,1454.5786918675312,128915.9013954832,656,2,160.48717948717947,36,3,18,38.385887141741954,0.5946180555555556,47.55067567567567,1009.7972972972965,28.049924924924902,0
3639,4,0,0,37,0.0,0.0,1.0,37,1300,900,400,0.6923076923076923,17,9,8,384.031323110955,0.439502002002002,0.15493114915080275,0.20308381322592373,127302.17013888856,2377.604166666627,129679.77430555518,657,3,162.32432432432432,34,3,19,38.01954307734653,0.5971200980392157,47.708333333333314,1009.1666666666639,29.681372549019528,0
3640,4,3,1,39,0.075,0.025,0.975,40,950,600,350,0.631578947368421,13,6,7,364.03315588796994,0.4459401709401709,0.16591817540559628,0.1967259227435241,128174.66695011326,1340.2990362811624,129514.96598639443,658,0,151.075,34,6,21,37.62956540481229,0.6060049019607843,46.84523809523809,1012.6190476190466,29.782913165266077,0
3641,4,1,2,38,0.025,0.05,0.95,40,1300,800,500,0.6153846153846154,18,8,10,365.0502620058576,0.44445779914529915,0.1731788273998356,0.198020572334726,128325.39859693861,1369.044075963699,129694.44267290231,659,0,151.925,34,6,22,37.44957505972663,0.6075367647058824,46.69642857142856,1013.2142857142844,29.800420168067188,0
3642,4,0,0,38,0.0,0.0,1.0,38,1200,900,300,0.75,15,9,6,371.7495961204835,0.44219713134186817,0.15900622304884804,0.20090038670657642,128175.5533478709,1929.8420379180918,130105.39538578899,660,1,145.1578947368421,33,5,22,37.433312154584684,0.608270202020202,46.84436274509803,1012.6225490196069,30.685531788472936,0
3643,4,0,0,38,0.0,0.0,1.0,38,750,300,450,0.4,12,3,9,370.0753437717413,0.4421526789947843,0.16361002324322627,0.20030600630474393,128237.60880730955,1891.5154327662246,130129.12424007578,661,2,146.1578947368421,33,5,22,37.41215466827989,0.6089015151515151,46.78308823529411,1012.8676470588224,30.692959001782498,0
3644,4,0,0,38,0.0,0.0,1.0,38,950,800,150,0.8421052631578947,11,8,3,365.38848638117474,0.44252311522048365,0.16131136795107293,0.19820404127407107,128325.39859693861,1777.7246315192547,130103.12322845787,662,3,147.1578947368421,34,4,22,37.44100771550543,0.6075367647058824,46.69642857142856,1013.2142857142844,29.800420168067188,0
3645,4,0,0,38,0.0,0.0,1.0,38,600,400,200,0.6666666666666666,8,4,4,367.48282617050114,0.44219713134186817,0.16789492231695147,0.1996414358129848,128385.71605725608,1835.909155328776,130221.62521258486,663,4,148.1578947368421,34,4,19,37.32624613336466,0.6081495098039216,46.63690476190475,1013.4523809523797,29.807422969187638,0
3646,4,1,0,39,0.02564102564102564,0.0,1.0,39,1050,500,550,0.47619047619047616,16,5,11,359.27757242283155,0.444331983805668,0.17495541326784214,0.19717548874519591,128789.87295310342,1454.262581447168,130244.13553455059,664,0,145.33333333333334,35,4,20,37.12134169517292,0.6101190476190477,46.23842592592592,1015.0462962962952,29.001322751322718,0
3647,4,1,1,39,0.025,0.025,0.975,40,1150,800,350,0.6956521739130435,15,8,7,347.63723421397935,0.4459001068376069,0.16116620498614997,0.1923621115132533,129115.53603857226,977.0735685009233,130092.60960707319,665,0,142.675,36,4,21,37.08494921514311,0.611400462962963,45.91779279279279,1016.3288288288281,28.231356356356336,0
3648,4,0,0,39,0.0,0.0,1.0,39,1200,600,600,0.5,18,6,12,352.3373166390794,0.4435728744939271,0.16293440803691395,0.19480614862034742,129083.74592764062,1296.2041323731175,130379.95006001374,666,1,147.15384615384616,35,4,21,36.99791192103265,0.6130952380952381,45.949074074074076,1016.2037037037038,29.03439153439154,0
3649,4,0,0,39,0.0,0.0,1.0,39,1450,1000,450,0.6896551724137931,19,10,9,356.59134604552344,0.4433198380566801,0.1641902154662631,0.19804962795324188,129261.9118480725,1418.7894113406585,130680.70125941317,667,2,148.15384615384616,34,5,21,36.70832357761646,0.6170343137254901,45.77380952380952,1016.9047619047614,29.908963585434158,0
3650,4,0,0,39,0.0,0.0,1.0,39,1150,900,250,0.782608695652174,14,9,5,356.4736786846301,0.4430668016194332,0.15966083997911773,0.1985934848786732,129383.00028344661,1424.3268140589448,130807.32709750556,668,3,149.15384615384616,34,5,22,36.58802363678914,0.6182598039215687,45.6547619047619,1017.3809523809516,29.922969187675047,0
3651,4,0,0,39,0.0,0.0,1.0,39,1100,800,300,0.7272727272727273,14,8,6,399.6278503901592,0.44289811066126855,0.2513295822414061,0.2099097866786203,127028.36445260677,2503.2467011904073,129531.61115379717,669,4,150.15384615384616,32,7,19,37.90836882097528,0.5989583333333333,47.97979797979797,1008.0808080808072,31.502525252525224,8
3652,4,1,0,40,0.025,0.0,1.0,40,1400,900,500,0.6428571428571429,19,9,10,394.11231030257323,0.4436698717948718,0.2519538834951456,0.20924519567610836,127462.99500192232,2046.9470876585879,129509.9420895809,670,0,147.375,33,7,19,37.59961569579287,0.601010101010101,47.549019607843135,1009.8039215686273,30.60011883541295,0
3653,4,1,0,41,0.024390243902439025,0.0,1.0,41,900,500,400,0.5555555555555556,13,5,8,387.3222550368525,0.44568089430894314,0.25441200962515853,0.20743475625996363,127813.27239229018,1700.9849773242568,129514.25736961444,671,0,144.7560975609756,34,7,20,37.41096656463386,0.602328431372549,47.20238095238095,1011.1904761904757,29.740896358543402,0
3654,4,1,0,42,0.023809523809523808,0.0,1.0,42,1050,600,450,0.5714285714285714,15,6,9,378.49921251841664,0.4467673248161053,0.24191651969429717,0.20438957475994513,128144.53125000004,1301.3782596371893,129445.90950963723,672,0,142.28571428571428,33,9,21,37.29423868312757,0.6079545454545454,46.875,1012.5000000000003,30.68181818181819,0
3655,4,1,2,41,0.023255813953488372,0.046511627906976744,0.9534883720930233,43,1100,1000,100,0.9090909090909091,12,10,2,367.843493451169,0.45002768549280175,0.23307699870012133,0.2002912525722607,128476.21882086172,851.8282312925247,129328.04705215424,673,0,139.95348837209303,34,9,18,37.22453812431503,0.6090686274509804,46.54761904761905,1013.8095238095241,29.817927170868355,0
3656,4,0,1,40,0.0,0.024390243902439025,0.975609756097561,41,1400,1000,400,0.7142857142857143,18,10,8,344.8327942056625,0.44621443089430896,0.12357000501633708,0.1867411790415372,128258.57688347127,901.9337836181418,129160.5106670894,674,2,146.2439024390244,36,5,20,38.029924031869555,0.6027199074074074,46.762387387387385,1012.95045045045,28.1375125125125,8
3657,4,0,0,40,0.0,0.0,1.0,40,1250,800,450,0.64,17,8,9,351.557837564921,0.4447248931623931,0.1452466598150055,0.19109819885512164,128408.33875868037,1028.5915798610868,129436.93033854145,675,4,150.85,35,5,19,37.70662041795134,0.60625,46.61458333333332,1013.5416666666652,28.95833333333329,0
3658,4,1,1,40,0.024390243902439025,0.024390243902439025,0.975609756097561,41,1300,1000,300,0.7692307692307693,16,10,6,345.6152434282626,0.4465701219512195,0.15385669414170344,0.1895150884580565,128755.86718990435,699.9980763311505,129455.8652662355,676,0,148.14634146341464,37,4,20,37.50270095073465,0.6058558558558558,46.27192982456139,1014.9122807017526,27.43006164058791,0
3659,4,1,0,41,0.024390243902439025,0.0,1.0,41,1300,1000,300,0.7692307692307693,16,10,6,339.89334581405524,0.44469004065040646,0.1878941015048028,0.18835997511637512,129174.91455078124,581.1387803819439,129756.05333116317,677,0,148.85365853658536,39,2,21,37.2213042661475,0.6065705128205128,45.859375,1016.5624999999999,26.065705128205124,0
3660,4,0,1,40,0.0,0.024390243902439025,0.975609756097561,41,1050,800,250,0.7619047619047619,13,8,5,340.401197435888,0.44435975609756095,0.19302595683764134,0.18904199340996738,129258.63997443396,599.9673032671689,129858.60727770113,678,1,149.85365853658536,36,5,21,37.123246585455874,0.6128472222222222,45.77702702702703,1016.8918918918924,28.246996996997012,0
3661,4,0,0,40,0.0,0.0,1.0,40,1300,900,400,0.6923076923076923,17,9,8,349.1908291705121,0.44236111111111115,0.2029282868525899,0.1937865719686007,129230.80800165042,1025.2426000943158,130256.05060174473,679,2,154.4,35,5,22,36.92812084993359,0.6145833333333333,45.80439814814815,1016.7824074074078,29.050925925925938,0
3662,4,0,0,40,0.0,0.0,1.0,40,1150,900,250,0.782608695652174,14,9,5,341.9223498618582,0.441653311965812,0.1808249721293198,0.18191242457063292,127546.62390430986,755.9726864705842,128302.59659078045,680,3,155.4,36,4,16,38.83152173913043,0.5954861111111112,47.466216216216225,1010.1351351351364,28.05930930930934,8
3663,4,1,0,41,0.024390243902439025,0.0,1.0,41,1250,800,450,0.64,17,8,9,339.1062348056388,0.44425813008130083,0.19597711659870876,0.18213255458732788,127928.27641034761,476.25522773758996,128404.5316380852,681,0,152.58536585365854,38,3,17,38.51229450487557,0.5956688596491229,47.08867521367521,1011.6452991452982,26.62224471434995,0
3664,4,1,0,42,0.023809523809523808,0.0,1.0,42,1200,700,500,0.5833333333333334,17,7,10,336.6858852357586,0.44623499806426636,0.2029596292343938,0.18218907568381365,128227.80957842778,234.86397272655205,128462.67355115434,682,0,149.92857142857142,37,5,18,38.26763288946626,0.6005067567567568,46.792763157894726,1012.8289473684196,27.37375533428161,0
3665,4,0,1,41,0.0,0.023809523809523808,0.9761904761904762,42,1550,1000,550,0.6451612903225806,21,10,11,339.62966783978436,0.4462108013937282,0.2033521913418037,0.18442170330054553,128366.66690712518,319.4256886734239,128686.0925957986,683,1,150.92857142857142,37,5,20,38.05137776815983,0.6019144144144144,46.65570175438596,1013.3771929824554,27.388572783309606,0
3666,4,2,1,42,0.046511627906976744,0.023255813953488372,0.9767441860465116,43,1550,1000,550,0.6451612903225806,21,10,11,330.95212205304745,0.4483204134366925,0.2084508923354309,0.18242589836852843,128963.21750217032,-63.869900173592896,128899.34760199672,684,0,144.25581395348837,39,4,17,37.663765254845664,0.6044337606837606,46.06770833333334,1015.7291666666681,26.044337606837644,0
3667,4,3,2,43,0.06666666666666667,0.044444444444444446,0.9555555555555556,45,1150,600,550,0.5217391304347826,17,6,11,315.571884841388,0.448442760942761,0.1174999482433805,0.1747857900870724,129153.25574638447,-848.5727301423137,128304.68301624215,685,0,138.73333333333332,43,2,18,37.86139059685735,0.6002906976744187,45.88068181818183,1016.4772727272741,23.639006342494746,8
3668,4,1,1,43,0.022727272727272728,0.022727272727272728,0.9772727272727273,44,1650,1300,350,0.7878787878787878,20,13,7,318.87209366263863,0.4475753171247357,0.15383864612367515,0.17787555843142094,129433.96297053696,-545.4063122743341,128888.55665826262,686,0,142.25,40,4,13,37.492717800193084,0.6075520833333333,45.60467479674798,1017.5813008130101,25.43953252032525,0
3669,4,0,2,41,0.0,0.046511627906976744,0.9534883720930233,43,1050,700,350,0.6666666666666666,14,7,7,322.74556351876157,0.44587486157253603,0.15705410487729377,0.18018423746161727,129466.28146701396,-243.06640624998954,129223.21506076398,687,1,146.2093023255814,39,4,13,37.361395428181524,0.6095085470085471,45.57291666666667,1017.7083333333339,26.095085470085486,0
3670,4,0,0,41,0.0,0.0,1.0,41,1100,800,300,0.7272727272727273,14,8,6,349.8705466137315,0.44247967479674793,0.19683577447355494,0.18736969691474017,127811.68845221584,759.2425674245667,128570.9310196404,459,2,136.65853658536585,37,4,14,38.359358056820646,0.5962837837837838,47.20394736842104,1011.1842105263139,27.32930298719767,8
3671,4,2,1,42,0.046511627906976744,0.023255813953488372,0.9767441860465116,43,1200,500,700,0.4166666666666667,19,5,14,335.4603059587277,0.443844592100406,0.19971796649059526,0.18234797636750927,128408.33875868031,15.180121527752988,128423.51888020807,460,0,131.25581395348837,39,4,12,38.11450839328537,0.5988247863247863,46.61458333333332,1013.5416666666647,25.988247863247814,0
3672,4,0,0,42,0.0,0.0,1.0,42,1850,1400,450,0.7567567567567568,23,14,9,341.0538890629194,0.44284746418892756,0.19966266076322947,0.18529422632593648,128388.0362426035,357.4478139381886,128745.48405654168,461,1,135.38095238095238,38,4,13,37.99349040691543,0.600328947368421,46.63461538461538,1013.4615384615381,26.67004048582995,0
3673,4,0,0,42,0.0,0.0,1.0,42,1350,900,450,0.6666666666666666,18,9,9,341.8341906066802,0.44218205574912894,0.2052132701421805,0.18685754978758923,128631.77237426018,394.1475591715773,129025.91993343175,462,2,136.38095238095238,38,4,13,37.72511848341231,0.602796052631579,46.39423076923076,1014.4230769230755,26.69534412955462,0
3674,4,1,1,42,0.023255813953488372,0.023255813953488372,0.9767441860465116,43,1200,1000,200,0.8333333333333334,14,10,4,338.96097548754994,0.44370616463639717,0.21041587680832863,0.1870903448743675,129016.12548828122,146.28634982638715,129162.41183810761,463,0,134.1860465116279,39,4,15,37.40654584914045,0.6049679487179487,46.015625,1015.9374999999998,26.049679487179482,0
3675,4,0,0,42,0.0,0.0,1.0,42,1450,1000,450,0.6896551724137931,19,10,9,372.74678548177064,0.4434039876113047,0.17625661375661372,0.19879828559027776,127645.42936288097,1136.4169218533657,128781.84628473433,464,1,136.28571428571428,37,5,16,37.95166015624999,0.5945945945945945,47.36842105263158,1010.5263157894743,27.31152204836417,8
3676,4,1,3,40,0.023255813953488372,0.06976744186046512,0.9302325581395349,43,1250,900,350,0.72,16,9,7,362.73429653259694,0.4455057216685124,0.17896566624764332,0.1952170032248158,128009.35057345318,686.6763459712247,128696.0269194244,465,0,134.09302325581396,38,5,17,37.83167933558559,0.5964912280701755,47.00854700854701,1011.9658119658122,26.630679262258216,0
3677,4,1,0,41,0.024390243902439025,0.0,1.0,41,950,500,450,0.5263157894736842,14,5,9,368.77737212219864,0.44618902439024394,0.1878059352765178,0.19831454486851102,127978.05574792245,1239.0822176054194,129217.13796552787,466,0,136.8048780487805,37,4,18,37.71086186967201,0.597972972972973,47.03947368421053,1011.842105263158,27.3470839260313,0
3678,4,2,2,41,0.046511627906976744,0.046511627906976744,0.9534883720930233,43,1600,1300,300,0.8125,19,13,6,353.1096428250723,0.4490125507567368,0.17939049391877426,0.19214235714642683,128450.017373134,471.60436384271406,128921.62173697671,467,0,131.3953488372093,37,6,14,37.62472958355866,0.602759009009009,46.5734649122807,1013.7061403508769,27.397463252726403,0
3679,4,0,0,41,0.0,0.0,1.0,41,1200,600,600,0.5,18,6,12,365.5196473575564,0.44519817073170737,0.17812581373144676,0.1975211940528333,128173.0379027676,1169.9527229932596,129342.99062576085,468,2,138.8048780487805,36,5,18,37.593601720047445,0.6018518518518519,46.846846846846844,1012.6126126126123,28.12812812812812,0
3680,4,0,1,40,0.0,0.024390243902439025,0.975609756097561,41,1100,800,300,0.7272727272727273,14,8,6,363.48191051642823,0.44410569105691056,0.17785874424266068,0.19712156412997622,128315.61872260776,1128.0812484782077,129443.69997108597,469,3,139.8048780487805,36,5,18,37.499305323996886,0.6032986111111112,46.70608108108108,1013.1756756756758,28.143768768768773,0
3681,4,0,0,40,0.0,0.0,1.0,40,1050,600,450,0.5714285714285714,15,6,9,365.41320919029476,0.4422809829059829,0.18818693206404125,0.1986988062208873,128422.23087873185,1385.4359033548708,129807.66678208672,470,4,143.75,37,3,14,37.34133852589066,0.6024774774774775,46.60087719298245,1013.5964912280697,27.394499762920802,0
3682,4,1,1,40,0.024390243902439025,0.024390243902439025,0.975609756097561,41,1550,1200,350,0.7741935483870968,19,12,7,357.49406234598985,0.44425813008130083,0.19430081728486948,0.19675628619563587,128902.8613873365,1016.401513076187,129919.26290041268,471,0,141.21951219512195,38,3,15,37.051332631948085,0.6055372807017544,46.12713675213675,1015.4914529914525,26.72345928924875,0
3683,4,1,1,40,0.024390243902439025,0.024390243902439025,0.975609756097561,41,800,500,300,0.625,11,5,6,355.04717851819584,0.4447916666666667,0.20540717915062268,0.19661925823178783,129147.08547921687,970.6616626488408,130117.74714186571,472,0,141.3170731707317,38,3,16,36.864532968958024,0.6080043859649122,45.886752136752136,1016.4529914529913,26.748762932973456,0
3684,4,1,1,40,0.024390243902439025,0.024390243902439025,0.975609756097561,41,1250,800,450,0.64,17,8,9,379.09937805160274,0.4442073170731707,0.13026178697710278,0.1946567272793464,126100.38406227183,1419.5876571504696,127519.97171942229,473,0,142.1219512195122,36,5,17,39.382918488619794,0.5807291666666667,48.90202702702703,1004.3918918918927,27.899774774774798,8
3685,4,2,1,41,0.047619047619047616,0.023809523809523808,0.9761904761904762,42,1000,700,300,0.7,13,7,6,367.5318037502147,0.4459083430120015,0.1356283710475359,0.19036528717113038,126457.07242853566,895.3991853262464,127352.4716138619,474,0,139.66666666666666,37,5,14,39.30545713870417,0.5824887387387387,48.547149122807014,1005.8114035087715,27.184091986723555,0
3686,4,0,0,41,0.0,0.0,1.0,41,1300,900,400,0.6923076923076923,17,9,8,372.04227860406854,0.44349593495934964,0.1316346571462128,0.192354690541733,126383.31056986042,1203.9869683873092,127587.29753824773,475,1,144.0731707317073,36,5,14,39.268115130473724,0.5836226851851851,48.6204954954955,1005.5180180180182,27.93105605605606,0
3687,4,0,0,41,0.0,0.0,1.0,41,1400,1000,400,0.7142857142857143,18,10,8,372.1783089711729,0.4427845528455285,0.13026688172219103,0.1934937491143324,126609.88004474073,1224.2902108189348,127834.17025555966,476,2,145.0731707317073,36,5,15,39.03108798627429,0.5859375,48.395270270270274,1006.4189189189192,27.956081081081088,0
3688,4,3,2,42,0.06818181818181818,0.045454545454545456,0.9545454545454546,44,1450,1300,150,0.896551724137931,16,13,3,349.9192886469325,0.44565935517970406,0.13127544097693367,0.18519257814272105,127334.51727892832,112.2769869261553,127446.79426585448,477,0,136.11363636363637,38,6,14,38.84698846194559,0.5896381578947368,47.67628205128205,1009.2948717948717,26.56039136302294,0
3689,4,2,2,42,0.045454545454545456,0.045454545454545456,0.9545454545454546,44,1350,900,450,0.6666666666666666,18,9,9,348.388904635523,0.44880857998590556,0.14475657591139823,0.185493551927562,127577.25180802093,89.299802761331,127666.55161078226,478,0,137.0681818181818,38,6,17,38.636844331641285,0.5921052631578947,47.43589743589743,1010.2564102564094,26.585695006747613,0
3690,4,1,0,43,0.023255813953488372,0.0,1.0,43,1200,900,300,0.75,15,9,6,348.63775026517476,0.44827427094868955,0.15525823141819717,0.18687457214100459,127847.22792935923,314.4739845861534,128161.70191394538,479,0,136.8372093023256,38,5,18,38.35415346151138,0.5948464912280702,47.168803418803414,1011.3247863247854,26.61381016644172,0
3691,4,0,0,43,0.0,0.0,1.0,43,1500,1200,300,0.8,18,12,6,348.83285979444406,0.4476282761166482,0.16178896920176022,0.1877355027257372,128009.35057345318,330.77356819344675,128340.12414164662,480,1,137.8372093023256,38,5,19,38.183373803491,0.5964912280701755,47.00854700854701,1011.9658119658122,26.630679262258216,0
3692,4,1,0,44,0.022727272727272728,0.0,1.0,44,900,600,300,0.6666666666666666,12,6,6,338.8287397388352,0.44926004228329813,0.1615929941618015,0.1837114316148298,128306.84222961868,-105.11953027978498,128201.72269933889,481,0,135.6818181818182,38,6,20,38.1327111673521,0.5995065789473684,46.71474358974359,1013.1410256410256,26.661605937921728,0
3693,4,0,3,41,0.0,0.06818181818181818,0.9318181818181819,44,1100,800,300,0.7272727272727273,14,8,6,325.99936474688025,0.44908386187455956,0.08731613338708266,0.17340734174166206,127538.80343967023,-446.2198652459267,127092.5835744243,482,1,136.6818181818182,39,5,15,39.241625416795564,0.5900106837606838,47.473958333333336,1010.1041666666674,25.900106837606856,8
3694,4,2,0,43,0.046511627906976744,0.0,1.0,43,950,800,150,0.8421052631578947,11,8,3,332.7181337606286,0.4467054263565891,0.12042590115679808,0.17755947930393948,127670.361328125,-104.35112847222229,127566.01019965278,483,0,140.51162790697674,39,4,17,38.93741840170412,0.5913461538461539,47.34375,1010.625,25.91346153846154,0
3695,4,2,1,44,0.044444444444444446,0.022222222222222223,0.9777777777777777,45,1450,1100,350,0.7586206896551724,18,11,7,326.33930535731014,0.4505050505050505,0.1503667768168926,0.17681995962274377,128279.78326576094,-624.8162087830485,127654.9670569779,484,0,135.22222222222223,38,7,19,38.476631160795876,0.5992324561403508,46.741452991452995,1013.0341880341889,26.65879442195234,0
3696,4,0,0,44,0.0,0.0,1.0,44,1600,1300,300,0.8125,19,13,6,332.86735503327014,0.4486103770260747,0.14522141999960603,0.1807497118224138,128366.66690712521,-254.18542243768718,128112.48148468752,485,1,138.6590909090909,37,7,20,38.22269710740818,0.6019144144144144,46.65570175438596,1013.3771929824557,27.388572783309613,0
3697,4,1,2,43,0.022222222222222223,0.044444444444444446,0.9555555555555556,45,1100,600,500,0.5454545454545454,16,6,10,323.47211862006907,0.4495791245791246,0.15309838060469905,0.176940739540102,128658.86843450925,-676.4886496457261,127982.37978486351,486,0,136.55555555555554,38,7,16,38.16321784611063,0.6030701754385965,46.367521367521356,1014.5299145299128,26.69815564552402,0
3698,4,1,0,44,0.022727272727272728,0.0,1.0,44,1550,1200,350,0.7741935483870968,19,12,7,331.581828254848,0.4458355355884425,0.17149760765550282,0.18187224990883663,128767.28121119118,-260.6218953174362,128506.65931587374,487,0,140.4090909090909,38,6,17,37.847149122807025,0.6041666666666667,46.26068376068375,1014.9572649572626,26.709401709401646,0
3699,4,2,1,45,0.043478260869565216,0.021739130434782608,0.9782608695652174,46,1600,1300,300,0.8125,19,13,6,319.4748393636868,0.4485809178743962,0.1735910330369015,0.17752953858160692,129282.86540516072,-938.0144413398006,128344.85096382092,488,0,135.2608695652174,38,8,20,37.630659733165245,0.609375,45.75320512820511,1016.9871794871766,26.762820512820436,0
3700,4,1,1,45,0.021739130434782608,0.021739130434782608,0.9782608695652174,46,1300,1000,300,0.7692307692307693,16,10,6,339.09813105915754,0.44742351046698875,0.20639710319855142,0.18067061195016837,127604.89477989287,-529.8324100849131,127075.06236980796,489,0,136.1304347826087,40,6,13,38.84320726882586,0.5890625,47.40853658536585,1010.3658536585361,25.259146341463403,8
3701,4,0,0,45,0.0,0.0,1.0,45,1500,1000,500,0.6666666666666666,20,10,10,348.24146256462524,0.44734848484848483,0.20912661605230953,0.1859651574719072,127696.68104383661,-106.14420572919079,127590.53683810742,490,1,138.6888888888889,39,6,15,38.518263251915215,0.5916132478632479,47.31770833333332,1010.729166666665,25.916132478632438,0
3702,4,2,2,45,0.0425531914893617,0.0425531914893617,0.9574468085106383,47,1950,1700,250,0.8717948717948718,22,17,5,334.4423983762579,0.4503160653715695,0.22466965170429343,0.18143453480233437,128329.16802300328,-814.6891276041925,127514.4788953991,491,0,133.74468085106383,39,8,17,38.22103851821388,0.5980235042735043,46.69270833333332,1013.229166666665,25.980235042735,0
3703,4,2,2,45,0.0425531914893617,0.0425531914893617,0.9574468085106383,47,850,500,350,0.5882352941176471,12,5,7,331.5782989857839,0.4534767190872649,0.22773716246489428,0.1808355596989694,128540.3442382811,-875.7622612847383,127664.58197699637,492,0,133.87234042553192,39,8,15,38.07834702961823,0.6001602564102564,46.48437499999999,1014.0624999999989,26.001602564102534,0
3704,4,1,0,46,0.021739130434782608,0.0,1.0,46,700,400,300,0.5714285714285714,10,4,6,338.78097615210754,0.44947665056360714,0.17856365614798686,0.1775026893294109,126926.22369382883,-547.1326889643972,126379.09100486443,493,0,137.7391304347826,37,9,17,39.54660863257165,0.5872747747747749,48.08114035087719,1007.675438596491,27.234471313418673,8
3705,4,3,2,47,0.061224489795918366,0.04081632653061224,0.9591836734693877,49,1300,900,400,0.6923076923076923,17,9,8,325.3047789394639,0.45261125283446707,0.20785036610846497,0.17454223529835514,127887.41949443132,-1479.5222544450978,126407.89723998623,494,0,130.24489795918367,40,9,17,38.903052680933726,0.5919270833333333,47.12906504065041,1011.4837398373991,25.287093495934975,0
3706,4,0,2,45,0.0,0.0425531914893617,0.9574468085106383,47,1600,1100,500,0.6875,21,11,10,333.4319651500296,0.4517036694418748,0.20965786918411555,0.17852311559356573,127801.98703342052,-877.3464626735715,126924.64057074695,495,1,134.74468085106383,39,8,17,38.784833110126705,0.5926816239316239,47.213541666666686,1011.1458333333364,25.92681623931632,0
3707,4,0,2,43,0.0,0.044444444444444446,0.9555555555555556,45,1800,1500,300,0.8333333333333334,21,15,6,347.21978858932954,0.44884259259259257,0.21945137157107286,0.18607833295522289,127839.40882050249,-122.32549919205087,127717.08332131043,496,2,141.37777777777777,37,8,17,38.39800408399294,0.5965653153153153,47.1765350877193,1011.293859649123,27.332266477003323,0
3708,4,2,1,44,0.044444444444444446,0.022222222222222223,0.9777777777777777,45,1200,900,300,0.75,15,9,6,349.26557889337744,0.4474537037037037,0.2461842625543691,0.18873774551738295,128173.03790276762,-46.350250036902764,128126.68765273072,497,0,142.0888888888889,36,9,19,38.00507858837485,0.6018518518518519,46.846846846846844,1012.6126126126126,28.128128128128125,0
3709,4,2,1,45,0.043478260869565216,0.021739130434782608,0.9782608695652174,46,1750,1200,550,0.6857142857142857,23,12,11,350.35495088542746,0.4519424315619968,0.24894840383135786,0.18419496777190936,127065.08333561593,-296.42379373952883,126768.6595418764,498,0,138.97826086956522,38,8,17,39.11244745858499,0.5868969298245614,47.943376068376054,1008.2264957264936,26.532276203328777,8
3710,4,1,0,46,0.021739130434782608,0.0,1.0,46,1500,1000,500,0.6666666666666666,20,10,10,353.8319391277071,0.4539754428341385,0.25321643351169243,0.18664140610300567,127199.7646376649,-198.53212433344467,127001.23251333146,499,0,139.93478260869566,38,8,19,38.886535338558225,0.5882675438596492,47.80982905982904,1008.7606837606808,26.54633378317581,0
3711,4,1,1,46,0.02127659574468085,0.02127659574468085,0.9787234042553191,47,1150,800,350,0.6956521739130435,15,8,7,348.648670799924,0.45451742213999385,0.2650064823528637,0.18569705975224926,127591.41845703113,-503.08430989584883,127088.33414713529,500,0,137.93617021276594,39,8,15,38.61577224456128,0.5905448717948718,47.42187499999999,1010.3124999999991,25.905448717948694,0
3712,4,0,0,46,0.0,0.0,1.0,46,1300,900,400,0.6923076923076923,17,9,8,357.02721584650084,0.45109702093397747,0.27052935656589794,0.189585463156243,127469.34125940531,-97.9951968734099,127371.3460625319,501,1,141.91304347826087,38,8,15,38.52932359994357,0.5910087719298245,47.54273504273504,1009.8290598290594,26.57444894286998,0
3713,4,2,0,48,0.041666666666666664,0.0,1.0,48,1950,1600,350,0.8205128205128205,23,16,7,347.5487519105424,0.4531157653664302,0.2927415846884829,0.18755583242322993,128118.80845561503,-694.4936049970299,127424.314850618,502,0,136.95833333333334,40,8,18,38.10396172120724,0.5942708333333333,46.90040650406504,1012.3983739837397,25.30995934959349,0
3714,4,2,1,49,0.04,0.02,0.98,50,1150,800,350,0.6956521739130435,15,8,7,335.6479329495021,0.45541666666666664,0.3025884002804766,0.18360401724026734,128659.52934967612,-1363.133819981492,127296.39552969462,503,0,132.44,40,10,16,37.85372633476911,0.5997395833333333,46.36686991869919,1014.5325203252032,25.36331300813008,0
3715,4,3,2,50,0.057692307692307696,0.038461538461538464,0.9615384615384616,52,1400,1000,400,0.7142857142857143,18,10,8,327.11003737718573,0.4580191050779286,0.3166047039178308,0.18212979618161917,129360.29188368078,-1933.5740819060054,127426.71780177478,504,0,127.78846153846153,39,13,21,37.357925455662496,0.608440170940171,45.67708333333334,1017.2916666666684,26.084401709401757,0
3716,4,0,0,50,0.0,0.0,1.0,50,1250,900,350,0.72,16,9,7,337.61085729642537,0.455,0.3127868852459008,0.18722056631892706,129201.38888888912,-1276.041666666647,127925.34722222248,505,1,133.46,40,10,21,37.25239071038251,0.6052083333333333,45.83333333333334,1016.6666666666686,25.416666666666714,0
3717,4,1,1,50,0.0196078431372549,0.0196078431372549,0.9803921568627451,51,1700,1100,600,0.6470588235294118,23,11,12,330.0313544567547,0.4560294117647059,0.3048256428319822,0.18495045702777893,129614.99851279028,-1644.5972965826984,127970.40121620758,506,0,131.8235294117647,40,11,14,37.025116433799035,0.609375,45.42682926829269,1018.2926829268314,25.457317073170785,0
3718,4,0,1,49,0.0,0.02,0.98,50,1200,800,400,0.6666666666666666,16,8,8,337.39497563691936,0.45535714285714285,0.31210273201677996,0.18874419558669864,129545.80213758723,-1258.3794487846812,128287.42268880256,507,3,135.46,39,11,15,36.90791381015723,0.610309829059829,45.494791666666686,1018.0208333333368,26.10309829059838,0
3719,4,1,0,50,0.02,0.0,1.0,50,1350,800,550,0.5925925925925926,19,8,11,340.7618356160008,0.45306122448979597,0.31451385338922333,0.19166138666820628,129757.97661675369,-1156.686740451367,128601.28987630233,508,0,136.38,39,11,17,36.60679293187472,0.6124465811965811,45.28645833333334,1018.8541666666684,26.12446581196586,0
3720,4,0,1,49,0.0,0.02,0.98,50,1850,1500,350,0.8108108108108109,22,15,7,338.22647545506635,0.45232142857142854,0.30188374706302934,0.19127088204677323,129970.32470703128,-1208.1190321180534,128762.20567491323,509,1,137.38,39,11,17,36.4559922702353,0.6145833333333333,45.078125,1019.6875000000002,26.14583333333334,0
3721,4,0,0,49,0.0,0.0,1.0,49,1750,1400,350,0.8,21,14,7,345.92663102858614,0.4505208333333333,0.30629135275240094,0.1953597194389369,129917.22140842034,-811.6346571180349,129105.58675130231,510,2,141.0612244897959,39,10,17,36.31358349511257,0.6140491452991452,45.13020833333334,1019.4791666666683,26.140491452991494,0
3722,4,0,2,47,0.0,0.04081632653061224,0.9591836734693877,49,1250,700,550,0.56,18,7,11,341.57020439140524,0.45036139455782315,0.2998090737739747,0.19358216496197275,130055.18297846861,-915.4049135765655,129139.77806489205,511,3,142.0612244897959,40,9,17,36.28470492511042,0.6138020833333333,44.994918699187,1020.0203252032529,25.50050813008132,0
3723,4,0,0,47,0.0,0.0,1.0,47,1450,1000,450,0.6896551724137931,19,10,9,352.04896958189966,0.446904872032069,0.29788572193229035,0.19849569561532632,129853.92011834319,-257.01224523339613,129596.9078731098,512,4,148.06382978723406,38,9,17,36.22182914046124,0.6151315789473684,45.19230769230769,1019.230769230769,26.821862348178133,0
3724,4,1,2,46,0.020833333333333332,0.041666666666666664,0.9583333333333334,48,1700,1300,400,0.7647058823529411,21,13,8,344.05207082051277,0.4487754875886525,0.1428966038613635,0.1942141993472458,129899.73855054831,-535.7028170896258,129364.03573345869,513,0,145.95833333333334,40,8,18,36.37909979064899,0.6122395833333334,45.14735772357722,1019.4105691056886,25.485264227642215,8
3725,4,0,2,44,0.0,0.043478260869565216,0.9565217391304348,46,1550,1000,550,0.6451612903225806,21,10,11,350.6037545253912,0.4480072463768116,0.1514586785487404,0.19800109322215817,129917.22140842004,-90.10687934028806,129827.11452907976,514,1,151.93478260869566,39,7,18,36.194377745989584,0.6140491452991452,45.13020833333333,1019.4791666666658,26.14049145299143,0
3726,4,0,0,44,0.0,0.0,1.0,44,1100,600,500,0.5454545454545454,16,6,10,362.9084450535189,0.44582452431289643,0.1634334197271261,0.2045624012597004,129843.17440221997,624.2369046245076,130467.41130684447,515,2,150.97727272727272,37,7,19,35.95604715797024,0.6168355855855856,45.202850877192986,1019.1885964912285,27.545637743006175,0
3727,4,0,1,43,0.0,0.022727272727272728,0.9772727272727273,44,950,700,250,0.7368421052631579,12,7,5,362.0902799173522,0.4450207011980268,0.1581425135415242,0.2045392115839333,129927.00277970145,609.0609610649423,130536.06374076639,516,3,151.97727272727272,37,7,19,35.891679214167915,0.6176801801801801,45.12061403508772,1019.5175438596492,27.55452821242295,0
3728,4,0,0,43,0.0,0.0,1.0,43,1600,1300,300,0.8125,19,13,6,368.1441497237057,0.4445136581764489,0.16830724088048798,0.20760577564792937,129860.54202428802,961.4797652382315,130822.02178952625,517,4,156.0,36,7,19,35.80497550915183,0.6189236111111112,45.18581081081082,1019.2567567567586,28.31268768768774,0
3729,4,1,0,44,0.022727272727272728,0.0,1.0,44,1250,800,450,0.64,17,8,9,360.4052372581656,0.444481148696265,0.1687687379759566,0.20519953233249336,130234.60493853886,587.4467384195204,130822.05167695838,518,0,153.4318181818182,37,7,20,35.622224907795314,0.620777027027027,44.819078947368425,1020.723684210527,27.587126600284513,0
3730,4,0,2,42,0.0,0.045454545454545456,0.9545454545454546,44,1300,1100,200,0.8461538461538461,15,11,4,357.8004609722678,0.44443710359408034,0.17164841001793918,0.20477021965169964,130435.08193582091,533.9494944509765,130969.03143027189,519,1,154.4318181818182,36,8,20,35.48533788997905,0.6247106481481481,44.622747747747745,1021.5090090090087,28.37525025025024,0
3731,4,0,0,42,0.0,0.0,1.0,42,1250,900,350,0.72,16,9,7,360.5757435716035,0.4420005807200929,0.18783308520508313,0.20669887430195516,130498.99798525352,1010.9546467763731,131509.9526320299,520,2,161.5952380952381,35,7,18,35.34964506872073,0.6273809523809524,44.56018518518517,1021.7592592592572,29.193121693121633,0
3732,4,0,0,42,0.0,0.0,1.0,42,1400,1000,400,0.7142857142857143,18,10,8,357.5350007638631,0.4413835656213705,0.18480879618400858,0.2060549074852397,130706.03358892717,946.3963638116933,131652.42995273886,521,3,162.5952380952381,35,7,18,35.217529711375214,0.6294642857142857,44.35763888888887,1022.569444444442,29.21626984126977,0
3733,4,0,0,42,0.0,0.0,1.0,42,1250,900,350,0.72,16,9,7,355.9456920954231,0.4410206155632985,0.17996816212823963,0.20620987860500206,130906.99932912047,919.1564952677741,131826.15582438826,522,4,163.5952380952381,37,5,18,35.05471177542055,0.6275337837837838,44.161184210526315,1023.3552631578945,27.65825035561877,0
3734,4,0,0,42,0.0,0.0,1.0,42,1150,500,650,0.43478260869565216,18,5,13,356.8552288285979,0.4397139953542393,0.17689405526664714,0.20779475294632793,131103.4404816865,956.9896506617258,132060.43013234824,523,5,164.5952380952381,37,5,19,34.83270877944326,0.6295045045045045,43.96929824561403,1024.1228070175425,27.678994784257906,0
3735,4,0,0,42,0.0,0.0,1.0,42,1000,600,400,0.6,14,6,8,358.4806835302198,0.4395204219899342,0.1734198763525534,0.20919956441117038,131187.67463305997,1005.6494546398656,132193.32408769985,524,6,165.5952380952381,37,5,19,34.705907274608435,0.6303490990990991,43.88706140350876,1024.4517543859633,27.687885253674686,0
3736,4,0,0,42,0.0,0.0,1.0,42,1400,1100,300,0.7857142857142857,17,11,6,354.16031101935476,0.4387219318621758,0.21297797960139797,0.19325243165887984,128561.19340806788,726.0502029470623,129287.24361101494,525,7,166.5952380952381,37,5,16,37.48457040400763,0.6038851351351351,46.463815789473685,1014.1447368421054,27.409317211948796,8
3737,4,1,0,43,0.023255813953488372,0.0,1.0,43,850,400,450,0.47058823529411764,13,4,9,349.97624604632165,0.44040697674418605,0.22426297862344358,0.19248693532547706,128875.73964497056,420.68951347798895,129296.42915844855,526,0,163.69767441860466,38,5,17,37.26983375420875,0.6052631578947368,46.15384615384616,1015.3846153846165,26.72064777327938,0
3738,4,2,0,45,0.044444444444444446,0.0,1.0,45,1050,700,350,0.6666666666666666,14,7,7,336.94296291277726,0.4425084175084175,0.23896237198777603,0.18814294634860007,129473.07715136248,-274.16972569215693,129198.90742567032,527,0,157.37777777777777,38,7,17,36.99327279725664,0.6112938596491229,45.56623931623932,1017.7350427350433,26.7825011246064,0
3739,4,1,1,45,0.021739130434782608,0.021739130434782608,0.9782608695652174,46,1350,800,550,0.5925925925925926,19,8,11,334.35869733086633,0.44302536231884054,0.23998364677023654,0.18844271282748848,129837.58680555565,-517.5347222222179,129320.05208333343,528,0,154.93478260869566,39,7,18,36.689152357590615,0.6132478632478633,45.208333333333336,1019.1666666666674,26.13247863247865,0
3740,4,1,0,46,0.021739130434782608,0.0,1.0,46,950,600,350,0.631578947368421,13,6,7,338.743755556511,0.4414653784219002,0.2656494678892569,0.1931371464926917,130289.17236328151,-373.07128906246965,129916.10107421904,529,0,155.69565217391303,39,7,19,36.119719926538124,0.6177884615384616,44.765625000000014,1020.937500000002,26.177884615384666,0
3741,4,0,0,46,0.0,0.0,1.0,46,1350,1100,250,0.8148148148148148,16,11,5,338.1986472054109,0.4411735104669887,0.26666740571580605,0.19335497002035323,130395.54172092033,-380.0808376735905,130015.46088324673,530,1,156.69565217391303,39,7,19,36.025943396226424,0.6188568376068376,44.66145833333334,1021.3541666666682,26.188568376068417,0
3742,4,0,0,46,0.0,0.0,1.0,46,1400,900,500,0.6428571428571429,19,9,10,337.82541063073006,0.44047906602254433,0.26226565616274455,0.19380510399341896,130528.5644531251,-380.82682291665276,130147.73763020844,531,2,157.69565217391303,39,7,15,35.90086646279309,0.6201923076923077,44.53125000000001,1021.8750000000008,26.201923076923098,0
3743,4,0,1,45,0.0,0.021739130434782608,0.9782608695652174,46,1350,900,450,0.6666666666666666,18,9,9,341.62672498776806,0.43990539452495975,0.26948635932695963,0.196525479427313,130635.03146701405,-274.31640624998045,130360.71506076407,532,3,158.69565217391303,39,7,15,35.69602948169284,0.6212606837606838,44.42708333333334,1022.291666666668,26.21260683760687,0
3744,4,0,0,45,0.0,0.0,1.0,45,1400,1000,400,0.7142857142857143,18,10,8,348.5792999120932,0.4394149831649832,0.2698820932798971,0.20000965828789288,130535.38795976707,100.38682975382551,130635.7747895209,533,4,160.93333333333334,38,7,15,35.619228088517154,0.621984649122807,44.524572649572654,1021.9017094017103,26.89215024741343,0
3745,4,2,1,46,0.0425531914893617,0.02127659574468085,0.9787234042553191,47,1250,900,350,0.72,16,9,7,340.95263050251646,0.4443802035152637,0.2704159432962039,0.19808286041997394,131015.81090124912,-465.9629271597747,130549.84797408934,534,0,155.04255319148936,40,7,17,35.3283617894249,0.6234375,44.05487804878048,1023.780487804877,25.594512195121926,0
3746,4,0,2,44,0.0,0.043478260869565216,0.9565217391304348,46,1400,1100,300,0.7857142857142857,17,11,6,346.7988346965214,0.44305555555555554,0.2899248113813908,0.20216225881470445,131145.89659139735,-103.75117737457663,131042.14541402277,535,1,158.7173913043478,40,6,17,35.04729305155934,0.6247395833333333,43.927845528455286,1024.2886178861793,25.60721544715448,0
3747,4,0,0,44,0.0,0.0,1.0,44,1300,800,500,0.6153846153846154,18,8,10,347.8565286972175,0.441508104298802,0.2888941424648561,0.192147490271535,129046.45568940458,218.83386211912108,129265.2895515237,536,2,165.97727272727272,40,4,17,37.149721610988856,0.6036458333333333,45.98577235772358,1016.0569105691068,25.401422764227668,7
3748,4,1,1,44,0.022222222222222223,0.022222222222222223,0.9777777777777777,45,1450,900,550,0.6206896551724138,20,9,11,342.64640017973375,0.44168771043771043,0.28933889073315844,0.1912597602485645,129459.11864144578,-127.79505229034658,129331.32358915544,537,0,163.26666666666668,36,9,16,36.862343698129905,0.6148726851851851,45.57995495495497,1017.6801801801824,28.268893893893956,0
3749,4,0,0,44,0.0,0.0,1.0,44,1500,900,600,0.6,21,9,12,346.91934301998424,0.44042899929527835,0.2925073163669454,0.19339048474880682,129407.39300679453,178.78555276922117,129586.17855956375,538,4,167.97727272727272,35,9,18,36.80622701247489,0.6163690476190475,45.630787037037045,1017.4768518518529,29.070767195767225,0
3750,4,0,0,44,0.0,0.0,1.0,44,1100,700,400,0.6363636363636364,15,7,8,346.4727448870814,0.440197762508809,0.2940312619445167,0.19353650607474948,129487.77113261935,172.7966987257808,129660.56783134514,539,5,168.97727272727272,36,8,16,36.7358652356716,0.615162037037037,45.551801801801815,1017.7927927927948,28.272022022022078,0
3751,4,0,1,43,0.0,0.022727272727272728,0.9772727272727273,44,1150,800,350,0.6956521739130435,15,8,7,344.28521343943333,0.44007663847780126,0.28928134332011557,0.19268765562297396,129563.94184989612,121.38987476916091,129685.33172466527,540,6,169.97727272727272,37,7,16,36.714122240172344,0.6140202702702703,45.47697368421053,1018.0921052631578,27.51600284495021,0
3752,4,1,0,44,0.022727272727272728,0.0,1.0,44,1600,900,700,0.5625,23,9,14,340.7107535806471,0.44169529598308666,0.283663153366315,0.1924622470712549,129927.00277970135,53.505405509373475,129980.50818521073,541,0,163.63636363636363,37,7,17,36.436599268659904,0.6176801801801801,45.12061403508771,1019.5175438596484,27.55452821242293,0
3753,4,1,1,44,0.022222222222222223,0.022222222222222223,0.9777777777777777,45,1300,700,600,0.5384615384615384,19,7,12,335.965999558781,0.4431607744107744,0.2824778038575362,0.19129173908637417,130236.00396050367,-249.0261501735894,129986.97781033008,542,0,160.9777777777778,39,6,18,36.24445096438412,0.6172542735042735,44.81770833333334,1020.7291666666682,26.172542735042775,0
3754,4,0,0,44,0.0,0.0,1.0,44,650,400,250,0.6153846153846154,9,4,5,341.024573094544,0.4438755285412262,0.27764378478664176,0.19430469862363522,130262.5868055553,84.55674913190995,130347.14355468721,543,1,157.9090909090909,35,9,20,36.08843537414964,0.625,44.79166666666665,1020.8333333333313,29.16666666666661,0
3755,4,0,1,43,0.0,0.022727272727272728,0.9772727272727273,44,1300,900,400,0.6923076923076923,17,9,8,383.1454366840136,0.4433029422128259,0.2651973742396403,0.20936080536112292,128616.79945993,1060.128236572798,129676.9276965028,544,2,158.9090909090909,37,7,17,36.69276744856412,0.6044481981981982,46.40899122807018,1014.3640350877196,27.41524419155999,8
3756,4,0,0,43,0.0,0.0,1.0,43,1100,900,200,0.8181818181818182,13,9,4,391.9284671865419,0.441422111480251,0.29233815280326825,0.21438272986542567,128658.1360710374,1484.95721227986,130143.09328331726,545,3,163.53488372093022,36,7,17,36.42769267769266,0.6067708333333333,46.36824324324325,1014.5270270270282,28.18130630630634,0
3757,4,1,2,42,0.022727272727272728,0.045454545454545456,0.9545454545454546,44,1050,700,350,0.6666666666666666,14,7,7,387.1084433246584,0.44350114517265676,0.2948459983117724,0.21316280630636064,128922.84765504769,1181.4245729455206,130104.2722279932,546,0,160.79545454545453,37,7,18,36.27906139782624,0.607545045045045,46.10745614035088,1015.5701754385964,27.447842579421525,0
3758,4,2,0,44,0.045454545454545456,0.0,1.0,44,800,600,200,0.75,10,6,4,377.90843984673444,0.44443710359408034,0.2983004415128465,0.21037313475507138,129352.72285997732,977.8994302014449,130330.62229017877,547,0,155.5909090909091,34,10,20,36.0737273259216,0.617953431372549,45.68452380952381,1017.2619047619047,29.919467787114844,0
3759,4,0,0,44,0.0,0.0,1.0,44,850,600,250,0.7058823529411765,11,6,5,390.13470593012954,0.4447784531360113,0.3285038531420341,0.20436298133740716,126917.0163001543,1106.1353418682315,128023.15164202252,548,1,156.5909090909091,35,9,18,38.262405237767084,0.5910714285714286,48.09027777777778,1007.6388888888887,28.789682539682534,8
3760,4,6,4,46,0.12,0.08,0.92,50,1600,1100,500,0.6875,21,11,10,350.74834006315496,0.4550680272108844,0.32017534365191014,0.1900623996389144,128283.3434927094,-977.3356412015538,127306.00785150785,549,0,138.68,37,13,19,37.85481383266586,0.6010698198198199,46.73793859649123,1013.048245614036,27.379682313892864,0
3761,4,0,1,45,0.0,0.021739130434782608,0.9782608695652174,46,650,500,150,0.7692307692307693,8,5,3,373.91169219141,0.4502717391304348,0.32802487705285177,0.20010677386517686,127783.97108966237,355.98417301479265,128139.95526267716,550,1,149.02173913043478,37,9,19,37.780044644470934,0.5960022522522522,47.231359649122815,1011.0745614035102,27.326339497392166,0
3762,4,0,0,45,0.0,0.0,1.0,45,1450,1300,150,0.896551724137931,16,13,3,380.64735415423064,0.45054713804713803,0.31710253816885814,0.20469777296825425,127978.05574792255,742.9016620498786,128720.95740997243,551,2,151.06666666666666,37,8,20,37.41059817945386,0.597972972972973,47.039473684210535,1011.8421052631588,27.34708392603132,0
3763,4,2,1,46,0.0425531914893617,0.02127659574468085,0.9787234042553191,47,1450,1100,350,0.7586206896551724,18,11,7,364.7789627465306,0.4524745605920444,0.31637492811960954,0.19918567918567923,128588.99493113253,-18.47154893814593,128570.52338219438,552,0,145.59574468085106,37,10,18,37.186936936936945,0.6041666666666667,46.436403508771924,1014.2543859649113,27.41228070175436,0
3764,4,0,0,46,0.0,0.0,1.0,46,1350,900,450,0.6666666666666666,18,9,9,371.06324489942693,0.4519927536231884,0.3147688955263135,0.2037546572526034,128811.51532202208,359.4437711603474,129170.95909318244,553,1,141.1304347826087,37,9,18,36.80015482105567,0.6064189189189189,46.21710526315789,1015.1315789473678,27.43598862019913,0
3765,4,1,0,47,0.02127659574468085,0.0,1.0,47,1600,900,700,0.5625,23,9,14,367.9994580771897,0.4531876349059513,0.3372734436564222,0.19871970736168276,128144.53125000029,157.0992997845785,128301.63054978487,554,0,139.10638297872342,40,7,19,37.56001371742115,0.59453125,46.875000000000014,1012.5000000000023,25.312500000000057,8
3766,4,3,1,49,0.06,0.02,0.98,50,1150,900,250,0.782608695652174,14,9,5,342.78583684980174,0.4565561224489796,0.32948653788409565,0.1884850465584134,128865.81776926776,-1165.3245629254911,127700.49320634226,555,0,131.7,40,10,19,37.462466219597644,0.6018229166666667,46.16361788617887,1015.3455284552856,25.38363821138214,0
3767,4,1,2,48,0.02,0.04,0.96,50,1650,1300,350,0.7878787878787878,20,13,7,345.83852157508903,0.45754251700680276,0.3315423084616922,0.1910327921937979,129046.45568940457,-1074.1529099742081,127972.30277943036,556,0,132.62,40,10,20,37.200981863039274,0.6036458333333333,45.98577235772358,1016.0569105691067,25.401422764227668,0
3768,4,2,0,50,0.04,0.0,1.0,50,1650,1300,350,0.7878787878787878,20,13,7,344.3521765108876,0.45582482993197276,0.3500365246264525,0.19193225877704334,129401.82317029881,-1087.668306867597,128314.15486343122,557,0,133.24,36,14,22,36.8771905552481,0.6142939814814814,45.63626126126127,1017.4549549549561,28.262637637637667,0
3769,4,0,3,47,0.0,0.06,0.94,50,1600,1200,400,0.75,20,12,8,327.9884686880376,0.4557227891156463,0.2970139028813219,0.172986904367559,127194.5074443122,-1639.248369262357,125555.25907504985,558,1,134.24,40,10,19,39.5436647860837,0.5848958333333334,47.8150406504065,1008.7398373983735,25.21849593495934,8
3770,4,1,1,47,0.020833333333333332,0.020833333333333332,0.9791666666666666,48,1650,1200,450,0.7272727272727273,21,12,9,339.9485587563471,0.4556922281323877,0.3156759966948979,0.17907409934053048,127144.53667534713,-955.4796006944537,126189.05707465268,559,0,140.625,39,9,20,39.293276182606895,0.5860042735042735,47.86458333333333,1008.5416666666658,25.860042735042715,0
3771,4,0,0,47,0.0,0.0,1.0,47,1250,800,450,0.64,17,8,9,343.8972747763134,0.4543825161887141,0.31580798311939584,0.18091987064319084,127092.0138888888,-658.6805555555609,126433.33333333324,560,1,144.5744680851064,38,9,20,39.24758953168046,0.587171052631579,47.916666666666664,1008.3333333333326,26.535087719298225,0
3772,4,3,3,47,0.06,0.06,0.94,50,1250,900,350,0.72,16,9,7,326.65754636681703,0.45727891156462586,0.31680988816951183,0.17507607926726254,127843.36911848077,-1647.799744897951,126195.56937358282,561,0,136.84,41,9,17,38.913821855993746,0.5899390243902439,47.17261904761905,1011.3095238095241,24.66608594657376,0
3773,4,0,0,47,0.0,0.0,1.0,47,950,700,250,0.7368421052631579,12,7,5,346.41798713029095,0.4519734813444342,0.3255229189110911,0.18426852557336454,127538.80343967032,-563.6528862847044,126975.15055338561,562,1,146.38297872340425,39,8,18,38.72600202811867,0.5900106837606838,47.47395833333334,1010.1041666666681,25.900106837606874,0
3774,4,0,2,45,0.0,0.0425531914893617,0.9574468085106383,47,1400,1100,300,0.7857142857142857,17,11,6,343.8887661419838,0.45129895158803573,0.32209415509815353,0.18339533884409676,127642.79120212901,-621.0156053161986,127021.77559681282,563,2,147.38297872340425,41,6,18,38.683405327573794,0.5879065040650406,47.37103174603175,1010.5158730158731,24.646728610143246,0
3775,4,0,0,45,0.0,0.0,1.0,45,650,100,550,0.15384615384615385,12,1,11,354.5854360836547,0.4495159932659933,0.3179448397557083,0.18861299910604562,127538.80343967059,44.6804470486594,127583.48388671924,564,3,149.7111111111111,39,6,18,38.51975267264792,0.5900106837606838,47.47395833333336,1010.1041666666704,25.900106837606934,0
3776,4,1,0,46,0.021739130434782608,0.0,1.0,46,1050,700,350,0.6666666666666666,14,7,7,352.5160056012977,0.45062399355877614,0.32997401349551114,0.18938461067247306,127938.82118985092,-179.90355856299522,127758.91763128793,565,0,147.43478260869566,40,6,19,38.1623556002009,0.5924479166666667,47.07825203252034,1011.6869918699211,25.29217479674803,0
3777,4,0,0,46,0.0,0.0,1.0,46,1350,900,450,0.6666666666666666,18,9,9,350.32637742957667,0.45063405797101447,0.328354868550625,0.18834890476564353,127968.81028163599,-233.8300540123243,127734.98022762366,566,1,148.43478260869566,41,5,19,38.18705673758867,0.5912093495934959,47.04861111111112,1011.805555555557,24.678184281842853,0
3778,4,0,0,46,0.0,0.0,1.0,46,1150,800,350,0.6956521739130435,15,8,7,351.18525856889886,0.45055354267310793,0.33222325914372974,0.1892838453871358,128069.20750070883,-204.79644982990703,127864.41105087892,567,2,149.43478260869566,41,5,20,38.06264088993435,0.5922256097560976,46.94940476190477,1012.2023809523826,24.68786295005811,0
3779,4,1,1,46,0.02127659574468085,0.02127659574468085,0.9787234042553191,47,1500,1100,400,0.7333333333333333,19,11,8,348.8525199735607,0.45131822386679005,0.3367271550913884,0.19013048317036077,128513.93771701398,-433.4513623157504,128080.48635469822,568,0,147.2340425531915,39,8,18,37.66736867337852,0.5998931623931624,46.51041666666667,1013.9583333333342,25.998931623931647,0
3780,4,1,0,47,0.02127659574468085,0.0,1.0,47,1350,1000,350,0.7407407407407407,17,10,7,347.26009397411735,0.4507786000616713,0.3482650621392418,0.19119394595500597,128917.41569378357,-446.42522225526307,128470.9904715283,569,0,145.14893617021278,40,7,19,37.29631575436137,0.60234375,46.112804878048784,1015.5487804878057,25.388719512195145,0
3781,4,0,2,45,0.0,0.0425531914893617,0.9574468085106383,47,950,700,250,0.7368421052631579,12,7,5,346.1628749138706,0.450431699044095,0.34693451848824575,0.1909626985452018,128994.83194527088,-469.3556249586692,128525.47632031221,570,1,146.14893617021278,40,7,19,37.245314792583684,0.603125,46.03658536585367,1015.8536585365871,25.39634146341468,0
3782,4,0,1,44,0.0,0.022222222222222223,0.9777777777777777,45,1250,900,350,0.72,16,9,7,353.3092803718094,0.4513257575757576,0.33719715297500086,0.19471949730404595,128957.11343277451,112.34898915187551,129069.46242192638,571,2,145.2888888888889,38,7,19,37.10226675081518,0.6060855263157895,46.07371794871795,1015.7051282051284,26.72908232118759,0
3783,4,1,0,45,0.022222222222222223,0.0,1.0,45,1500,1000,500,0.6666666666666666,20,10,10,345.16557014877105,0.4516624579124579,0.3132221238067112,0.19196646733889802,129315.90374157969,-72.45819304028419,129243.44554853941,572,0,143.11111111111111,36,9,21,36.943875479775606,0.6134259259259259,45.720720720720735,1017.1171171171194,28.253253253253316,0
3784,4,0,0,45,0.0,0.0,1.0,45,1700,1200,500,0.7058823529411765,22,12,10,342.11529780018043,0.45155723905723905,0.30355781760959877,0.19110247598998997,129487.77113261935,-140.05052349644137,129347.72060912292,573,1,144.11111111111111,36,9,19,36.8467396916722,0.615162037037037,45.551801801801815,1017.7927927927948,28.272022022022078,0
3785,4,2,2,45,0.0425531914893617,0.0425531914893617,0.9574468085106383,47,1400,900,500,0.6428571428571429,19,9,10,335.2301091145028,0.45312981806968855,0.32261034601069327,0.19074242793867024,130209.42382812523,-669.9761284721928,129539.44769965304,574,0,138.93617021276594,39,8,21,36.29014424712529,0.6169871794871795,44.843750000000014,1020.6250000000018,26.169871794871842,0
3786,4,2,1,46,0.0425531914893617,0.02127659574468085,0.9787234042553191,47,1400,1000,400,0.7142857142857143,18,10,8,334.1015446211402,0.45260946654332407,0.3226397840969517,0.19143277838298164,130480.80490037624,-681.2214571804882,129799.58344319575,575,0,139.31914893617022,38,9,23,36.04430269441249,0.6214364035087719,44.577991452991455,1021.6880341880344,26.88652721547459,0
3787,4,0,0,46,0.0,0.0,1.0,46,1450,1000,450,0.6896551724137931,19,10,9,340.9570713656568,0.45237520128824477,0.32269007157721874,0.19538979034349255,130486.54994806091,-301.93761542013317,130184.61233264078,576,1,142.2826086956522,37,9,23,35.863382700150254,0.6233108108108107,44.57236842105263,1021.7105263157893,27.613798008534843,0
3788,4,0,1,45,0.0,0.021739130434782608,0.9782608695652174,46,1400,1100,300,0.7857142857142857,17,11,6,339.3952496536,0.45176127214170697,0.3164508654763525,0.1954279506128131,130671.89554569367,-330.11587771203017,130341.77966798164,577,2,143.2826086956522,38,8,18,35.71577847439917,0.6233552631578947,44.39102564102564,1022.4358974358978,26.90620782726047,0
3789,4,0,1,44,0.0,0.022222222222222223,0.9777777777777777,45,1200,800,400,0.6666666666666666,16,8,8,346.3362743833925,0.45109427609427605,0.32296614210777275,0.19875948751559222,130542.57079101253,42.3255232379077,130584.89631425044,578,3,147.42222222222222,37,8,19,35.66925965665236,0.6238738738738738,44.517543859649116,1021.9298245614028,27.61972498814602,0
3790,4,0,0,44,0.0,0.0,1.0,44,1350,800,550,0.5925925925925926,19,8,11,349.94070839147366,0.45087869978858347,0.31383767163760545,0.20116604243631453,130607.69120049098,340.989596014928,130948.68079650591,579,4,149.38636363636363,36,8,19,35.511228012191985,0.6264467592592593,44.453828828828826,1022.1846846846843,28.39401901901901,0
3791,4,0,0,44,0.0,0.0,1.0,44,950,400,550,0.42105263157894735,15,4,11,349.133860566065,0.4505593727977449,0.30877699786720614,0.2010010348813763,130665.25298524875,323.9328433162878,130989.18582856504,580,5,150.38636363636363,36,8,19,35.47357454932627,0.627025462962963,44.39752252252252,1022.4099099099099,28.400275275275273,0
3792,4,0,0,44,0.0,0.0,1.0,44,1000,500,500,0.5,15,5,10,348.7391511623588,0.45021802325581395,0.3053281354778652,0.2013730267010621,130780.41459956588,321.6501552227993,131102.06475478868,581,6,151.38636363636363,36,8,19,35.36712356416749,0.6281828703703703,44.28490990990991,1022.8603603603611,28.41278778778781,0
3793,4,0,1,43,0.0,0.022727272727272728,0.9772727272727273,44,1350,800,550,0.5925925925925926,19,8,11,345.2134907720896,0.44979959478505993,0.30058675230349063,0.19993339647201902,130895.6269402849,237.38726057138518,131133.0142008563,582,7,152.38636363636363,36,8,20,35.340779868676876,0.6293402777777778,44.1722972972973,1023.310810810811,28.425300300300304,0
3794,4,0,0,43,0.0,0.0,1.0,43,1250,700,550,0.56,18,7,11,349.6678056420134,0.4498892580287929,0.29968783612843186,0.2027614691994964,130942.84664619753,557.2995702588973,131500.14621645643,583,8,149.04651162790697,35,8,21,35.17907290135323,0.6318452380952381,44.1261574074074,1023.495370370369,29.242724867724828,0
3795,4,0,2,41,0.0,0.046511627906976744,0.9534883720930233,43,1050,600,450,0.5714285714285714,15,6,9,347.769498115543,0.44993540051679587,0.2982296557634776,0.20212673983771945,131031.70680084002,513.7661822702098,131545.47298311023,584,9,150.04651162790697,35,8,21,35.13782123747078,0.6327380952380952,44.03935185185184,1023.8425925925912,29.252645502645464,0
3796,4,0,0,41,0.0,0.0,1.0,41,1650,1400,250,0.8484848484848485,19,14,5,358.6654496593634,0.4482469512195122,0.2977039470324925,0.2080840442760595,130962.30867346918,1194.3310657596153,132156.6397392288,585,10,151.29268292682926,34,7,21,34.92915018996666,0.6341911764705883,44.10714285714285,1023.5714285714268,30.10504201680667,0
3797,4,0,0,41,0.0,0.0,1.0,41,1250,900,350,0.72,16,9,7,350.79264459013785,0.4480945121951219,0.20790754066352757,0.19759192962549976,129815.23762119135,907.6461026469883,130722.88372383834,586,11,152.29268292682926,37,4,17,36.29312818305718,0.6165540540540541,45.23026315789475,1019.0789473684227,27.542674253200616,8
3798,4,0,0,41,0.0,0.0,1.0,41,950,800,150,0.8421052631578947,11,8,3,352.08826259011505,0.4473323170731707,0.13901508606366697,0.18261219950617863,126512.22160905253,760.2600078870092,127272.48161693955,587,12,153.29268292682926,37,4,17,39.63703451407809,0.5830518018018018,48.49232456140349,1006.0307017543839,27.1900189663347,8
3799,4,2,1,42,0.046511627906976744,0.023255813953488372,0.9767441860465116,43,1550,1200,350,0.7741935483870968,19,12,7,360.3008863352022,0.44857419712070873,0.044003095060310526,0.1790044258905834,124733.66914736216,388.33030992730926,125121.99945728946,588,0,147.11627906976744,42,1,17,41.26855175089725,0.5567956349206349,50.266472868217065,998.9341085271337,23.78414544112223,8
3800,4,3,2,43,0.06666666666666667,0.044444444444444446,0.9555555555555556,45,1100,800,300,0.7272727272727273,14,8,6,349.4573470259154,0.4551767676767677,0.07830708791390184,0.1765117975448059,125421.98252275454,-233.2212522995374,125188.761270455,589,0,140.3111111111111,41,4,17,40.827205275494364,0.5652947154471545,49.57837301587302,1001.6865079365084,24.431378242353862,0
3801,4,3,1,45,0.06521739130434782,0.021739130434782608,0.9782608695652174,46,1550,1000,550,0.6451612903225806,21,10,11,347.20535296256884,0.45775966183574884,0.09775994355763262,0.1769875440286305,125800.69674486245,-464.2649367525622,125336.43180810989,590,0,138.19565217391303,42,4,20,40.49269132940534,0.5677083333333333,49.200581395348856,1003.1976744186076,23.88565891472875,0
3802,4,3,3,45,0.0625,0.0625,0.9375,48,1150,800,350,0.6956521739130435,15,8,7,328.2149234670195,0.4624889184397163,0.12603564547206125,0.17000353820297748,126457.71362898893,-1298.2340304068039,125159.47959858213,591,0,132.77083333333334,42,6,16,40.29343288375078,0.5744047619047619,48.54651162790699,1005.8139534883744,23.947951273532723,0
3803,4,2,2,45,0.0425531914893617,0.0425531914893617,0.9574468085106383,47,1000,600,400,0.6,14,6,8,335.59187877118006,0.4602412889300031,0.12370406762153108,0.1733378236221785,126342.87308673482,-920.0715702947725,125422.80151644004,592,0,136.5531914893617,41,6,16,40.22597197552794,0.5746951219512195,48.66071428571429,1005.3571428571438,24.52090592334497,0
3804,4,4,4,45,0.08163265306122448,0.08163265306122448,0.9183673469387755,49,1450,1000,450,0.6896551724137931,19,10,9,322.56114705982463,0.4617169784580499,0.14947579933890132,0.1692968860603932,126996.54571280998,-1607.1697084481095,125389.37600436187,593,0,131.89795918367346,43,6,19,39.8831892772141,0.5784883720930232,48.01136363636364,1007.954545454546,23.44080338266386,0
3805,4,3,0,48,0.0625,0.0,1.0,48,1100,400,700,0.36363636363636365,18,4,14,325.1089147259138,0.4590351654846336,0.15932211925866246,0.1716851758190889,127245.76971379473,-1326.1814408483697,125919.58827294636,594,0,133.375,40,8,22,39.56381782164921,0.5854166666666667,47.764227642276424,1008.9430894308945,25.22357723577236,0
3806,4,1,2,47,0.02040816326530612,0.04081632653061224,0.9591836734693877,49,1250,1000,250,0.8,15,10,5,317.81309764525906,0.4603883219954648,0.16215327266747037,0.16902468009460117,127532.07439456774,-1693.7272775073504,125838.34711706039,595,0,131.6326530612245,42,7,17,39.45522352264007,0.5853174603174602,47.480620155038764,1010.0775193798459,24.049464747139186,0
3807,4,0,0,47,0.0,0.0,1.0,47,1050,600,450,0.5714285714285714,15,6,9,325.94810197059144,0.45802497687326554,0.15595123309978365,0.17234636062662284,127297.04231112445,-1101.5541344437731,126195.48817668068,596,1,138.19148936170214,40,7,21,39.49018126888218,0.5859375,47.713414634146346,1009.1463414634155,25.22865853658539,0
3808,4,1,3,45,0.020833333333333332,0.0625,0.9375,48,1500,900,600,0.6,21,9,12,323.6020496078254,0.4586842494089835,0.18433637433784522,0.1734384486699358,127843.36911848099,-1325.9247448979372,126517.44437358304,597,0,136.29166666666666,41,7,18,38.991073180302116,0.5899390243902439,47.17261904761906,1011.3095238095259,24.6660859465738,0
3809,4,0,1,44,0.0,0.022222222222222223,0.9777777777777777,45,1950,1600,350,0.8205128205128205,23,16,7,330.2427953059966,0.4570496632996633,0.18598936693025858,0.17662663052172387,127758.96044021452,-561.7047557670387,127197.25568444747,598,1,142.95555555555555,40,5,19,38.909412277174624,0.590625,47.256097560975626,1010.9756097561005,25.274390243902513,0
3810,4,3,1,46,0.06382978723404255,0.02127659574468085,0.9787234042553191,47,1300,900,400,0.6923076923076923,17,9,8,315.2367621452435,0.4597787542399013,0.12490236585629466,0.1685733028939684,127752.38985224738,-1329.355988952469,126423.03386329491,599,0,137.29787234042553,42,5,12,39.29538483657626,0.5875496031746033,47.2625968992248,1010.9496124031001,24.07022886674048,8
3811,4,0,0,46,0.0,0.0,1.0,46,1200,800,400,0.6666666666666666,16,8,8,316.4725571701807,0.4582528180354268,0.1403766921718661,0.16961731060950674,127843.36911848049,-1108.2164115646474,126735.15270691585,600,1,141.19565217391303,41,5,14,39.1713262703551,0.5899390243902439,47.17261904761904,1011.3095238095219,24.666085946573705,0
3812,4,4,2,48,0.08,0.04,0.96,50,1650,1300,350,0.7878787878787878,20,13,7,297.97922836896055,0.46198979591836736,0.16790819182683347,0.16344633416880855,128768.51343692606,-2325.2229287892865,126443.29050813678,601,0,130.82,43,7,11,38.69852895440691,0.5964147286821706,46.259469696969695,1014.962121212121,23.603770260747,0
3813,4,0,0,48,0.0,0.0,1.0,48,1700,1300,400,0.7647058823529411,21,13,8,306.96334909523466,0.4588320035460993,0.1559596577017106,0.1677552241848624,128622.09590143937,-1703.5461348891386,126918.54976655023,602,1,137.04166666666666,41,7,11,38.61929502852484,0.5978150406504066,46.40376984126984,1014.3849206349214,24.741095625241986,0
3814,4,1,2,47,0.02040816326530612,0.04081632653061224,0.9591836734693877,49,1400,1100,300,0.7857142857142857,17,11,6,335.5469382476598,0.45975056689342403,0.03244785438705944,0.18217594044587554,128360.35358019113,-1096.054686808623,127264.29889338251,603,0,135.22448979591837,43,6,16,38.161250506183215,0.592296511627907,46.66193181818182,1013.3522727272729,23.566331923890065,8
3815,4,0,0,47,0.0,0.0,1.0,47,1450,900,550,0.6206896551724138,20,9,11,353.6569006076869,0.45798643231575703,0.027058606217594816,0.18419165391271025,126682.45278108274,-286.5446158815767,126395.90816520117,604,1,141.80851063829786,40,7,16,39.422445992327916,0.5796875,48.32317073170732,1006.7073170731711,25.16768292682928,8
3816,4,0,1,46,0.0,0.02127659574468085,0.9787234042553191,47,950,500,450,0.5263157894736842,14,5,9,354.43826577839826,0.45804424915201974,0.03663730187350889,0.18529494147655484,126835.960737656,-408.8964075616489,126427.06433009435,605,2,142.80851063829786,40,7,17,39.24493879472694,0.58125,48.17073170731707,1007.3170731707304,25.18292682926826,0
3817,4,2,2,46,0.041666666666666664,0.041666666666666664,0.9583333333333334,48,1150,600,550,0.5217391304347826,17,6,11,350.59021503183516,0.45814864066193856,0.06307230885744808,0.18479940403664985,127170.80213758672,-682.5158342034592,126488.28630338327,606,0,140.66666666666666,39,9,19,38.99800767668423,0.5862713675213675,47.838541666666664,1008.6458333333327,25.86271367521366,0
3818,4,1,1,46,0.02127659574468085,0.02127659574468085,0.9787234042553191,47,1150,900,250,0.782608695652174,14,9,5,348.3038385537012,0.4595474868948504,0.08301170705378902,0.1846344894446357,127399.61848932524,-525.2447699781776,126874.37371934706,607,0,141.06382978723406,40,7,15,38.82101033487686,0.5869791666666666,47.611788617886184,1009.5528455284561,25.238821138211403,0
3819,4,2,1,47,0.041666666666666664,0.020833333333333332,0.9791666666666666,48,1350,1100,250,0.8148148148148148,16,11,5,343.56329168271196,0.45753915484633567,0.08887322216772908,0.18425185474514713,127868.4524301618,-813.8187161438764,127054.63371401792,608,0,139.08333333333334,41,7,17,38.46074464606833,0.5901930894308943,47.147817460317455,1011.4087301587296,24.66850561362755,0
3820,4,0,2,45,0.0,0.0425531914893617,0.9574468085106383,47,800,600,200,0.75,10,6,4,344.4040064251778,0.45528831329016345,0.09429910316488543,0.18526367865885976,127990.23321311713,-583.9301796219263,127406.3030334952,609,1,142.3404255319149,40,7,17,38.31496267282648,0.59296875,47.02743902439024,1011.8902439024386,25.297256097560965,0
3821,4,3,8,40,0.0625,0.16666666666666666,0.8333333333333334,48,1150,700,450,0.6086956521739131,16,7,9,335.5548716905613,0.4577792553191489,0.10367689220183562,0.1828774050713557,128512.70957274192,-975.3868457424511,127537.32272699947,610,0,138.33333333333334,42,6,12,38.00570208970439,0.5952380952380952,46.51162790697674,1013.9534883720922,24.141749723145054,0
3822,4,2,0,42,0.047619047619047616,0.0,1.0,42,900,600,300,0.6666666666666666,12,6,6,369.0858261070678,0.4511953155245838,0.11379673186432293,0.19903039407829742,128089.02739304409,1055.1688981225088,129144.19629116659,611,0,156.3095238095238,37,5,19,37.58936308492202,0.5990990990990991,46.929824561403514,1012.2807017543865,27.35893788525369,0
3823,4,0,0,42,0.0,0.0,1.0,42,1050,900,150,0.8571428571428571,12,9,3,373.6485228025757,0.4505299070847852,0.11606756171502819,0.20205021994172084,128200.04712988627,1180.3516466605297,129380.3987765468,612,1,157.3095238095238,37,5,19,37.36014869351812,0.6002252252252251,46.8201754385965,1012.7192982456153,27.370791844476088,0
3824,4,1,1,42,0.023255813953488372,0.023255813953488372,0.9767441860465116,43,1150,800,350,0.6956521739130435,15,8,7,371.4661140313196,0.4520118124769288,0.12263136362411475,0.20277905810806876,128577.58881446782,952.4434536854432,129530.03226815326,613,0,154.62790697674419,38,5,15,37.02903894097406,0.6022478070175439,46.447649572649574,1014.2094017094016,26.68972109761583,0
3825,4,1,2,41,0.023255813953488372,0.046511627906976744,0.9534883720930233,43,1400,1000,400,0.7142857142857143,18,10,8,363.31666283697183,0.45129660391288295,0.13772941447017484,0.2000978097872686,128929.9859832713,768.4824494119403,129698.46843268324,614,0,154.69767441860466,38,5,16,36.875832807349745,0.6058114035087719,46.10042735042735,1015.5982905982911,26.72627080521819,0
3826,4,2,4,39,0.046511627906976744,0.09302325581395349,0.9069767441860466,43,1150,700,450,0.6086956521739131,16,7,9,365.26925182588025,0.4514581026208933,0.1570283355821891,0.2034674729752528,129377.95380015441,852.4137480367563,130230.36754819116,615,0,146.3953488372093,35,8,19,36.36945392491467,0.6160714285714286,45.65972222222223,1017.3611111111119,29.06746031746034,0
3827,4,1,0,40,0.025,0.0,1.0,40,1400,1000,400,0.7142857142857143,18,10,8,375.22659311946563,0.45205662393162394,0.15080722891566234,0.20873865434930067,129326.0104286813,1705.311658977315,131031.32208765861,616,0,147.325,33,7,20,36.1691767068273,0.619949494949495,45.71078431372549,1017.1568627450982,30.822935234699948,0
3828,4,0,0,40,0.0,0.0,1.0,40,1150,900,250,0.782608695652174,14,9,5,375.3907395651189,0.45177617521367525,0.1507947976878612,0.2094922514347276,129450.69204152246,1718.9182045367113,131169.61024605916,617,1,148.325,33,7,17,36.037853243416826,0.6212121212121212,45.588235294117645,1017.6470588235292,30.837789661319064,0
3829,4,1,0,41,0.024390243902439025,0.0,1.0,41,1700,1400,300,0.8235294117647058,20,14,6,365.9996092190642,0.4513719512195122,0.1560827496631847,0.20659556056314093,129898.25857426306,1308.5423752834486,131206.8009495465,618,0,145.6829268292683,34,7,19,35.821265911479635,0.623468137254902,45.148809523809526,1019.404761904762,29.982492997198882,0
3830,4,3,0,44,0.06818181818181818,0.0,1.0,44,2050,1700,350,0.8292682926829268,24,17,7,345.68335398053824,0.45203488372093026,0.18661352391423858,0.20140871905528496,131126.20380092945,266.1393890098235,131392.34318993927,619,0,136.6818181818182,36,8,20,35.095748579805765,0.6316550925925926,43.94707207207208,1024.211711711713,28.45032532532536,0
3831,4,0,1,43,0.0,0.022727272727272728,0.9772727272727273,44,1150,900,250,0.782608695652174,14,9,5,341.9141577922687,0.45153937632135305,0.1794150840597759,0.19967786815068492,131215.75869498312,172.90512465374508,131388.66381963686,620,1,137.6818181818182,37,7,20,35.101847888127864,0.6306306306306306,43.85964912280702,1024.5614035087722,27.69084874348033,0
3832,4,0,0,43,0.0,0.0,1.0,43,1000,900,100,0.9,11,9,2,347.77369070504744,0.45120431893687707,0.17853754101672892,0.2023228515406909,131068.54056336753,516.4380174093162,131584.97858077683,621,2,141.8372093023256,36,7,20,35.10048938744089,0.6310763888888888,44.003378378378386,1023.9864864864874,28.444069069069094,0
3833,4,0,1,42,0.0,0.023255813953488372,0.9767441860465116,43,1000,700,300,0.7,13,7,6,347.6693541781953,0.4510197489848653,0.18148995742613505,0.20256584088729593,131126.20380092945,517.7125182615241,131643.91631919096,622,3,142.8372093023256,36,7,20,35.04489646325821,0.6316550925925926,43.94707207207208,1024.211711711713,28.45032532532536,0
3834,4,0,0,42,0.0,0.0,1.0,42,1050,700,350,0.6666666666666666,14,7,7,357.27406604028357,0.44990079365079366,0.17737247493096864,0.20781089166721842,131061.33355034735,964.9631076388982,132026.29665798624,623,4,146.54761904761904,35,7,20,34.86457273652084,0.6330357142857144,44.01041666666667,1023.9583333333344,29.25595238095241,0
3835,4,0,1,41,0.0,0.023809523809523808,0.9761904761904762,42,1800,1300,500,0.7222222222222222,23,13,10,358.7834322282586,0.44910230352303526,0.17720385341530687,0.20965740762486965,131239.16437596455,1017.2875675154361,132256.45194348,624,5,147.54761904761904,35,7,20,34.64609454422229,0.6348214285714286,43.83680555555556,1024.652777777778,29.27579365079366,0
3836,4,1,1,41,0.023809523809523808,0.023809523809523808,0.9761904761904762,42,1950,1300,650,0.6666666666666666,26,13,13,350.4867781412503,0.4478803716608595,0.17612171222279538,0.2065634841385668,131565.5006858712,822.3936899862977,132387.8943758575,625,0,146.8095238095238,35,7,15,34.5291817087846,0.638095238095238,43.518518518518526,1025.925925925927,29.312169312169342,0
3837,4,0,2,39,0.0,0.04878048780487805,0.9512195121951219,41,800,400,400,0.5,12,4,8,351.58811629999116,0.4472560975609756,0.17738359201773823,0.20753530220477537,131624.87809713668,1055.5485896776638,132680.42668681435,626,1,149.0,35,6,16,34.44102940070682,0.6386904761904761,43.46064814814816,1026.157407407409,29.318783068783112,0
3838,4,0,2,37,0.0,0.05128205128205128,0.9487179487179487,39,1100,700,400,0.6363636363636364,15,7,8,361.12935438547373,0.44632816014394966,0.16366232375513134,0.2132147284111498,131633.3616780047,1707.334183673491,133340.6958616782,627,2,153.12820512820514,34,5,16,34.18769334880125,0.6409313725490196,43.45238095238096,1026.1904761904775,30.18207282913169,0
3839,4,1,0,38,0.02631578947368421,0.0,1.0,38,1000,500,500,0.5,15,5,10,353.0392676166911,0.4451013513513513,0.13130627560002628,0.2105195202933916,132011.15779588916,1721.0244930984363,133732.1822889876,628,0,134.0,35,3,17,34.01436441791493,0.6425595238095239,43.08449074074075,1027.6620370370379,29.36177248677251,0
3840,4,0,3,35,0.0,0.07894736842105263,0.9210526315789473,38,900,600,300,0.6666666666666666,12,6,6,349.58177448694454,0.44489390706495974,0.12829577039095863,0.20878518757354125,132070.63567654768,1633.8974354852758,133704.53311203295,629,1,135.0,35,3,17,34.04329936568704,0.643154761904762,43.02662037037038,1027.89351851852,29.368386243386286,0
3841,4,0,0,35,0.0,0.0,1.0,35,900,700,200,0.7777777777777778,11,7,4,374.42845277161297,0.4407563025210084,0.1294675803900902,0.22155046004608517,131716.6695362716,2863.69375573919,134580.3632920108,630,2,133.77142857142857,32,3,17,33.76230012300124,0.646484375,43.37121212121211,1026.51515151515,32.078598484848435,0
3842,4,1,0,36,0.027777777777777776,0.0,1.0,36,800,500,300,0.625,11,5,6,363.7276482191821,0.44088955026455023,0.12375663898491429,0.21748476414188977,132114.37795859747,2410.7303981641408,134525.1083567616,631,0,131.02777777777777,33,3,20,33.63568860015099,0.6480429292929293,42.98406862745097,1028.0637254901944,31.15344622697559,0
3843,4,1,0,37,0.02702702702702703,0.0,1.0,37,1100,600,500,0.5454545454545454,16,6,10,356.4920452078722,0.44144144144144143,0.11780038164131557,0.21494448583639006,132429.53619100805,2042.3193603421523,134471.8555513502,632,0,128.45945945945945,33,4,21,33.50436063817121,0.651199494949495,42.67769607843136,1029.2892156862729,31.19058229352342,0
3844,4,0,0,37,0.0,0.0,1.0,37,1050,500,550,0.47619047619047616,16,5,11,361.4438729956286,0.44072197197197194,0.11424345225654031,0.2190292539674302,132618.81134960108,2186.8513612552847,134805.66271085636,633,1,129.45945945945945,33,4,22,33.186471346420774,0.6530934343434344,42.493872549019606,1030.0245098039213,31.212863933452162,0
3845,4,0,0,37,0.0,0.0,1.0,37,1000,600,400,0.6,14,6,8,359.6317981657823,0.44059684684684686,0.1161194500078766,0.21829779979637048,132681.9331056564,2143.328437379849,134825.26154303626,634,2,130.45945945945945,33,4,17,33.16965524761111,0.6537247474747474,42.432598039215684,1030.2696078431368,31.22029114676172,0
3846,4,0,1,36,0.0,0.02702702702702703,0.972972972972973,37,750,400,350,0.5333333333333333,11,4,7,359.29425504148975,0.44012762762762764,0.11849471350065843,0.2186443332054218,132776.64389898122,2141.1770713187298,134917.82097029994,635,3,131.45945945945945,33,4,17,33.08313515655964,0.6546717171717171,42.34068627450981,1030.6372549019613,31.231431966726102,0
3847,4,0,0,36,0.0,0.0,1.0,36,1050,700,350,0.6666666666666666,14,7,7,363.8752248646565,0.43835978835978834,0.11592584033073972,0.2208258201948624,132673.8166099773,2455.3429705215403,135129.15958049885,636,5,136.02777777777777,34,2,17,33.06852322625375,0.6513480392156863,42.44047619047619,1030.2380952380952,30.30112044817927,0
3848,4,0,0,36,0.0,0.0,1.0,36,750,400,350,0.5333333333333333,11,4,7,366.6369605385548,0.43723544973544975,0.11229819563152943,0.22323085825195524,132796.4923469386,2537.62046485259,135334.11281179122,637,6,137.02777777777777,34,2,17,32.873979748979735,0.6525735294117647,42.32142857142856,1030.7142857142844,30.31512605042013,0
3849,4,0,0,36,0.0,0.0,1.0,36,1150,800,350,0.6956521739130435,15,8,7,363.3622729522244,0.43637566137566136,0.11316349829395334,0.22196361130551243,132919.2247732426,2459.5663265306057,135378.7910997732,638,7,138.02777777777777,34,2,18,32.83498807049949,0.6537990196078431,42.20238095238095,1031.190476190476,30.329131652661058,0
3850,4,0,1,35,0.0,0.027777777777777776,0.9722222222222222,36,1450,900,550,0.6206896551724138,20,9,11,375.0255982883639,0.4364252645502646,-0.0052482462623670845,0.21267997033309008,130080.3589143991,2556.6928854875277,132637.05179988663,639,8,139.02777777777777,34,2,20,35.40596919127086,0.6253063725490196,44.970238095238095,1020.1190476190477,30.003501400560225,8
3851,4,1,2,34,0.027777777777777776,0.05555555555555555,0.9444444444444444,36,1150,800,350,0.6956521739130435,15,8,7,376.60325872336176,0.4373015873015873,0.014902300272075397,0.21475415726636835,130294.81207274775,2614.1452663097825,132908.95733905752,640,0,139.77777777777777,32,4,21,35.14768323851926,0.6321614583333333,44.76010101010102,1020.9595959595965,31.90498737373739,0
3852,4,0,1,33,0.0,0.029411764705882353,0.9705882352941176,34,750,600,150,0.8,9,6,3,400.18742551543164,0.4367572786690434,0.018965334784646126,0.21717284137803974,128342.36145019531,3510.4771868134853,131852.8386370088,641,1,143.8235294117647,31,3,19,36.54212713098604,0.6149193548387097,46.6796875,1013.28125,32.68649193548387,8
3853,4,0,0,33,0.0,0.0,1.0,33,1250,800,450,0.64,17,8,9,407.18885274612546,0.4357638888888889,0.03441171154888867,0.22214315936149787,128553.1225611342,3869.079698520054,132422.20225965424,642,2,148.3939393939394,30,3,16,36.148387453059414,0.6197916666666667,46.471774193548384,1014.1129032258061,33.8037634408602,0
3854,4,1,0,34,0.029411764705882353,0.0,1.0,34,700,400,300,0.5714285714285714,10,4,6,396.6453554824986,0.43607026143790845,0.054537847434244835,0.21903918675371103,129035.96878051758,3436.3035413953976,132472.27232191298,643,0,145.0,31,3,17,35.921146781152544,0.6219758064516129,45.99609375,1016.015625,32.77469758064516,0
3855,4,1,0,35,0.02857142857142857,0.0,1.0,35,750,500,250,0.6666666666666666,10,5,5,386.22404421494275,0.4372198879551821,0.05272433908402663,0.21505232372078711,129361.89746263115,2992.5350410672118,132354.43250369836,644,0,141.82857142857142,32,3,20,35.85288155227337,0.6227213541666667,45.67550505050504,1017.2979797979781,31.790561868686815,0
3856,4,0,1,34,0.0,0.02857142857142857,0.9714285714285714,35,850,500,350,0.5882352941176471,12,5,7,388.0362921225841,0.43795518207282913,0.06060928279015365,0.21676788293833318,129490.37606175386,3049.3930785123925,132539.76914026626,645,1,142.82857142857142,32,3,15,35.675629574494494,0.6240234375,45.54924242424242,1017.80303030303,31.80634469696969,0
3857,4,0,0,34,0.0,0.0,1.0,34,650,400,250,0.6153846153846154,9,4,5,393.7895241405028,0.43605169340463457,0.05922622407888323,0.2196620364852269,129433.15505981447,3393.8841078016503,132827.0391676161,646,3,148.0,31,3,15,35.58767860951162,0.626008064516129,45.60546875,1017.5781250000001,32.825100806451616,0
3858,4,0,0,34,0.0,0.0,1.0,34,950,700,250,0.7368421052631579,12,7,5,391.07592327654186,0.4356989007724302,0.060396069402434804,0.21870039829585153,129532.54699707033,3331.4120822482632,132863.9590793186,647,4,149.0,31,3,15,35.555235780677066,0.627016129032258,45.5078125,1017.9687500000001,32.83770161290323,0
3859,4,1,0,35,0.02857142857142857,0.0,1.0,35,800,400,400,0.5,12,4,8,384.5739371653733,0.4373949579831933,0.07722562161779778,0.2178533144755881,130037.12153096625,3001.777560963167,133038.89909192943,648,0,145.71428571428572,32,3,18,35.20647643806222,0.6295572916666667,45.01262626262626,1019.9494949494951,31.873421717171723,0
3860,4,0,0,35,0.0,0.0,1.0,35,900,600,300,0.6666666666666666,12,6,6,385.20311630657164,0.43686974789915967,0.08568246504145516,0.2187509756060018,130133.72559241409,3025.583326956435,133159.30891937052,649,1,146.71428571428572,32,3,18,35.09208843789959,0.6305338541666667,44.917929292929294,1020.3282828282832,31.88525883838385,0
3861,4,1,0,36,0.027777777777777776,0.0,1.0,36,1150,900,250,0.782608695652174,14,9,5,378.33100689037167,0.4372685185185185,0.07969580685134137,0.21713023169021387,130544.21864487215,2677.785136726258,133222.0037815984,650,0,143.61111111111111,33,3,16,34.8501768797218,0.632260101010101,44.51593137254902,1021.9362745098038,30.96776589423648,0
3862,4,0,0,36,0.0,0.0,1.0,36,1000,600,400,0.6,14,6,8,378.784187879016,0.4367228835978836,0.07503728560775502,0.2182717723523834,130700.81218762023,2701.4801999231145,133402.29238754336,651,1,144.61111111111111,33,3,17,34.67961009907319,0.6338383838383839,44.36274509803922,1022.5490196078439,30.986333927510422,0
3863,4,1,0,37,0.02702702702702703,0.0,1.0,37,700,500,200,0.7142857142857143,9,5,4,366.9609934286384,0.4366866866866867,0.085951098738823,0.21357229130400182,131084.1907596372,2220.55697278912,133304.7477324263,652,0,141.67567567567568,34,3,18,34.59345694799659,0.6354166666666667,43.98809523809524,1024.047619047619,30.11904761904762,0
3864,4,0,2,35,0.0,0.05405405405405406,0.9459459459459459,37,1150,900,250,0.782608695652174,14,9,5,365.3618554020811,0.4360297797797798,0.08422083793831026,0.2136572589199127,131267.12018140592,2191.999716553289,133459.1198979592,653,1,142.67567567567568,34,3,20,34.44930103779429,0.6372549019607843,43.80952380952381,1024.7619047619048,30.140056022408967,0
3865,4,0,0,35,0.0,0.0,1.0,35,1000,700,300,0.7,13,7,6,367.83206990575,0.4341736694677871,0.07162843135580244,0.21526799164603133,131296.72369100823,2659.029129421378,133955.7528204296,654,2,141.4857142857143,33,2,20,34.356067400055814,0.6398358585858586,43.78063725490196,1024.877450980392,31.056892453951274,0
3866,4,0,1,34,0.0,0.02857142857142857,0.9714285714285714,35,750,500,250,0.6666666666666666,10,5,5,369.1111573638343,0.43350840336134455,0.07268691628677315,0.21672653008162826,131422.35145436853,2701.8912497597184,134124.24270412824,655,3,142.4857142857143,33,2,20,34.196222262061276,0.6410984848484849,43.65808823529412,1025.3676470588239,31.07174688057042,0
3867,4,0,0,34,0.0,0.0,1.0,34,1050,700,350,0.6666666666666666,14,7,7,367.8427557195291,0.4320967023172906,0.07602372052499917,0.21687179935802103,131579.4706362938,2880.111014994239,134459.58165128803,656,4,143.91176470588235,33,1,17,34.06991559165472,0.6426767676767677,43.504901960784316,1025.9803921568632,31.090314913844338,0
3868,4,0,0,34,0.0,0.0,1.0,34,1150,1000,150,0.8695652173913043,13,10,3,367.33223360328805,0.43161393345216875,0.07757203669621648,0.2169280764593747,131642.34459102261,2871.295295078805,134513.63988610142,657,5,144.91176470588235,33,1,17,34.019484913621525,0.6433080808080809,43.44362745098039,1026.2254901960778,31.09774212715387,0
3869,4,1,0,35,0.02857142857142857,0.0,1.0,35,750,300,450,0.4,12,3,9,359.65626605883256,0.4325280112044818,0.08820638414058979,0.21457584968112656,132030.69905045352,2497.1336451247157,134527.83269557822,658,0,141.74285714285713,34,1,18,33.824665044982424,0.6449142156862745,43.06547619047619,1027.7380952380954,30.22759103641457,0
3870,4,0,2,33,0.0,0.05714285714285714,0.9428571428571428,35,850,700,150,0.8235294117647058,10,7,3,359.1614622675611,0.43151260504201683,0.09125918083768925,0.2148004423921508,132122.47732426305,2490.6604308389988,134613.13775510204,659,1,142.74285714285713,34,1,18,33.744885749575424,0.6458333333333333,42.976190476190474,1028.095238095238,30.238095238095237,0
3871,4,1,1,33,0.029411764705882353,0.029411764705882353,0.9705882352941176,34,900,500,400,0.5555555555555556,13,5,8,364.04924611055503,0.43042557932263814,0.08508290776117522,0.21913415911041792,132366.47450800167,2837.583050989995,135204.05755899166,660,0,139.91176470588235,33,1,19,33.37340220713748,0.6505681818181819,42.73897058823529,1029.0441176470583,31.18315508021389,0
3872,4,1,1,33,0.029411764705882353,0.029411764705882353,0.9705882352941176,34,1050,700,350,0.6666666666666666,14,7,7,363.97129986098423,0.43116830065359474,0.08721300685492661,0.21982191877297816,132492.61289227687,2844.701707276035,135337.3145995529,661,0,140.58823529411765,33,1,20,33.24839800817362,0.6518308080808081,42.616421568627445,1029.5343137254893,31.198009506833007,0
3873,4,0,0,33,0.0,0.0,1.0,33,800,400,400,0.5,12,4,8,371.58452031667485,0.43166035353535354,0.09520304257146406,0.22385701589809426,132398.00347222213,3239.4097222222126,135637.41319444435,662,1,144.45454545454547,32,1,20,33.14777327935225,0.6533203125,42.70833333333333,1029.1666666666658,32.16145833333331,0
3874,4,0,0,33,0.0,0.0,1.0,33,950,500,450,0.5263157894736842,14,5,9,370.40872715666364,0.4309895833333333,0.09433969276971843,0.2235338528873633,132462.98408644518,3213.089066166705,135676.07315261188,663,2,145.45454545454547,32,1,20,33.11255570546628,0.6539713541666667,42.645202020202014,1029.4191919191912,32.169349747474726,0
3875,4,1,1,33,0.029411764705882353,0.029411764705882353,0.9705882352941176,34,750,600,150,0.8,9,6,3,362.4612698795875,0.43291369578134287,0.10238706203984016,0.2211302874181992,132871.3884833957,2832.146440071115,135703.53492346682,664,0,142.14705882352942,33,1,16,32.90629085938429,0.6556186868686869,42.248774509803916,1031.0049019607836,31.242572786690413,0
3876,4,0,0,33,0.0,0.0,1.0,33,850,600,250,0.7058823529411765,11,6,5,370.67443566960424,0.43134469696969696,0.1052846524544635,0.22544297644823466,132755.59413580244,3241.8209876543133,135997.41512345677,665,1,146.0909090909091,32,1,17,32.81109613656783,0.6569010416666667,42.36111111111111,1030.5555555555552,32.2048611111111,0
3877,4,0,2,31,0.0,0.06060606060606061,0.9393939393939394,33,1350,1000,350,0.7407407407407407,17,10,7,372.89460506637784,0.430831755050505,0.10734425548333504,0.22797927651064187,132950.84685236207,3315.330706050414,136266.17755841248,666,2,147.0909090909091,32,1,18,32.557439601697695,0.6588541666666667,42.17171717171718,1031.3131313131319,32.22853535353537,0
3878,4,0,0,31,0.0,0.0,1.0,31,750,300,450,0.4,12,3,9,384.5567524338217,0.42459677419354835,0.10613339200658434,0.23437535096370815,132833.88137817394,4016.4332071940257,136850.31458536797,667,3,151.8709677419355,31,0,19,32.37455791335101,0.6602822580645161,42.28515625000001,1030.859375000001,33.253528225806484,0
3879,4,0,0,31,0.0,0.0,1.0,31,1050,700,350,0.6666666666666666,14,7,7,385.8365083293493,0.42334229390681005,0.11153911931656224,0.2362130462894208,133001.7174614801,4063.383653428825,137065.1011149089,668,4,152.8709677419355,31,0,20,32.172536396532855,0.6619623655913979,42.122395833333336,1031.510416666667,33.274529569892486,0
3880,4,0,0,31,0.0,0.0,1.0,31,1050,800,250,0.7619047619047619,13,8,5,387.1044936505408,0.4232974910394265,0.10891931615997508,0.23720254471718752,133035.29739379883,4099.712287055121,137135.00968085395,669,5,153.8709677419355,31,0,20,32.1060257057512,0.6622983870967742,42.08984375,1031.640625,33.27872983870968,0
3881,4,0,0,31,0.0,0.0,1.0,31,850,500,350,0.5882352941176471,12,5,7,387.1044936505408,0.4232974910394265,0.10891931615997508,0.23720254471718752,133035.29739379883,4099.712287055121,137135.00968085395,670,6,154.8709677419355,31,0,20,32.1060257057512,0.6622983870967742,42.08984375,1031.640625,33.27872983870968,0
3882,4,0,0,31,0.0,0.0,1.0,31,850,700,150,0.8235294117647058,10,7,3,395.4823309001006,0.42343189964157707,0.11266642109140634,0.2265707185437027,130475.34722222229,4179.080200195318,134654.42742241762,671,7,155.8709677419355,29,2,22,34.48205546492659,0.6422413793103448,44.583333333333336,1021.6666666666672,35.229885057471286,6
3883,4,0,0,31,0.0,0.0,1.0,31,850,500,350,0.5882352941176471,12,5,7,397.1231096408319,0.4228494623655914,0.11676016830294533,0.22834578804347824,130617.28395061725,4174.228395061727,134791.51234567896,672,8,156.8709677419355,29,2,18,34.2957427536232,0.6436781609195402,44.44444444444444,1022.222222222222,35.24904214559386,0
3884,4,0,0,31,0.0,0.0,1.0,31,1300,900,400,0.6923076923076923,17,9,8,402.96987995556424,0.42141577060931895,0.12437068804773443,0.23308561749405418,130846.37674875699,4345.429746213418,135191.8064949704,673,9,157.8709677419355,30,1,19,33.91328385006129,0.6430555555555555,44.22043010752687,1023.1182795698917,34.10394265232972,0
3885,4,0,0,31,0.0,0.0,1.0,31,1050,700,350,0.6666666666666666,14,7,7,399.77308099306276,0.4219086021505376,0.1396965757876374,0.2179109915470857,128519.04844490695,4075.6911926234297,132594.73963753038,674,10,158.8709677419355,30,1,17,36.37134367267588,0.6194444444444445,46.505376344086024,1013.978494623656,33.799283154121866,8
3886,4,0,0,31,0.0,0.0,1.0,31,850,500,350,0.5882352941176471,12,5,7,400.3782910079038,0.42172939068100357,0.13876909004646132,0.21880195237050318,128621.28434284305,4099.434002485826,132720.71834532887,675,11,159.8709677419355,30,1,18,36.251159401086525,0.6204861111111111,46.40456989247311,1014.3817204301071,33.8127240143369,0
3887,4,0,1,30,0.0,0.03225806451612903,0.967741935483871,31,700,600,100,0.8571428571428571,8,6,2,400.6125845254811,0.4210125448028674,0.13894598301847272,0.21930561280513836,128689.46419022433,4110.923770089026,132800.38796031335,676,12,160.8709677419355,30,1,18,36.175321234600595,0.6211805555555556,46.33736559139785,1014.6505376344088,33.82168458781363,0
3888,4,1,0,31,0.03225806451612903,0.0,1.0,31,700,500,200,0.7142857142857143,9,5,4,400.15865996052503,0.4235215053763441,0.13952018584471393,0.21999989209183443,128859.9928459937,4112.88841195513,132972.88125794881,677,0,159.58064516129033,30,1,19,36.012101756243915,0.6229166666666667,46.16935483870967,1015.3225806451608,33.84408602150536,0
3889,4,0,0,31,0.0,0.0,1.0,31,1100,700,400,0.6363636363636364,15,7,8,402.2132544989453,0.4241935483870967,0.13996126643403728,0.22266007544077784,129133.07354896521,4187.806755116196,133320.88030408142,678,1,160.58064516129033,30,1,20,35.68032046195891,0.6256944444444444,45.9005376344086,1016.3978494623657,33.87992831541219,0
3890,4,0,0,31,0.0,0.0,1.0,31,750,500,250,0.6666666666666666,10,5,5,405.8113954462522,0.42392473118279567,0.1434142171658197,0.22524224610022836,129236.69222608021,4289.162548697016,133525.85477477722,679,2,161.58064516129033,29,2,20,35.48282907617355,0.6296695402298851,45.79861111111111,1016.8055555555553,35.06226053639846,0
3891,4,1,0,32,0.03125,0.0,1.0,32,750,400,350,0.5333333333333333,11,4,7,392.77447509741387,0.42683131720430106,0.1381466086038532,0.22047740535468166,129680.10210717998,3787.006807145329,133467.1089143253,680,0,157.5,30,2,19,35.36140802322512,0.63125,45.36290322580645,1018.5483870967739,33.9516129032258,0
3892,4,3,2,33,0.08571428571428572,0.05714285714285714,0.9428571428571428,35,650,500,150,0.7692307692307693,8,5,3,363.44454013883677,0.43546918767507004,0.13148750985162594,0.208418196401487,130512.91120001923,2486.8409986543647,132999.75219867358,681,0,144.9142857142857,33,2,18,35.26225313824259,0.6319444444444444,44.54656862745098,1021.8137254901961,30.9640522875817,0
3893,4,0,0,33,0.0,0.0,1.0,33,550,200,350,0.36363636363636365,9,2,7,379.18472118969754,0.4289772727272727,0.13866072671585639,0.21531097646684577,130129.69970703138,3268.63878038196,133398.33848741333,682,1,154.6969696969697,31,2,20,35.24970222902841,0.6330645161290323,44.92187500000001,1020.312500000001,32.91330645161294,0
3894,4,0,0,33,0.0,0.0,1.0,33,900,600,300,0.6666666666666666,12,6,6,382.0074968763015,0.4283459595959596,0.1353123067408779,0.21765543426672992,130262.58680555552,3352.25694444444,133614.84374999997,683,2,155.6969696969697,31,2,21,35.04251700680271,0.6344086021505376,44.791666666666664,1020.833333333333,32.93010752688171,0
3895,4,1,0,34,0.029411764705882353,0.0,1.0,34,700,500,200,0.7142857142857143,9,5,4,371.15842941353065,0.4300913547237077,0.13638411510373127,0.2132382885807334,130585.01882779825,2893.5460986123926,133478.56492641065,684,0,152.08823529411765,32,2,19,34.99202182417129,0.6350911458333333,44.476010101010104,1022.0959595959602,31.940498737373755,0
3896,4,0,0,34,0.0,0.0,1.0,34,450,200,250,0.4444444444444444,7,2,5,372.3121455576561,0.4302956030897207,0.13922634271099787,0.21407948369565233,130617.28395061735,2926.0802469135924,133543.36419753093,685,1,153.08823529411765,32,2,19,34.9298007246377,0.6354166666666667,44.44444444444445,1022.2222222222227,31.94444444444446,0
3897,4,0,0,34,0.0,0.0,1.0,34,1250,900,350,0.72,16,9,7,373.5903495345757,0.43010992275698157,0.14299100722037394,0.21517316148869106,130681.82615294366,2964.2938220589817,133646.11997500263,686,2,154.08823529411765,32,2,19,34.83164567382892,0.6360677083333333,44.381313131313135,1022.4747474747481,31.95233585858588,0
3898,4,0,0,34,0.0,0.0,1.0,34,1100,800,300,0.7272727272727273,14,8,6,378.82679412455434,0.42910724896019015,0.1449320596945589,0.21928659568467074,130875.54841342731,3115.832886950323,133991.38130037763,687,3,155.08823529411765,32,2,19,34.501223675551174,0.6380208333333333,44.1919191919192,1023.2323232323241,31.97601010101013,0
3899,4,0,0,34,0.0,0.0,1.0,34,850,400,450,0.47058823529411764,13,4,9,377.3735462536041,0.42838309566250743,0.15169419599138223,0.21936359043515982,131037.09323347126,3089.9865128558554,134127.0797463271,688,4,156.08823529411765,32,2,19,34.374614625724504,0.6396484375,44.03409090909092,1023.8636363636379,31.995738636363683,0
3900,4,0,0,34,0.0,0.0,1.0,34,1200,900,300,0.75,15,9,6,373.5883290124637,0.42829025549613786,0.1452178702925231,0.21844689324676914,131263.42337516585,3007.6965998367555,134271.1199750026,689,5,157.08823529411765,32,2,20,34.24228889436505,0.6419270833333333,43.813131313131315,1024.747474747475,32.023358585858595,0
3901,4,0,0,34,0.0,0.0,1.0,34,1050,700,350,0.6666666666666666,14,7,7,377.00646456160007,0.4274175579322638,0.16739130434782634,0.20645592106944763,128703.50346020758,2945.0672883239745,131648.57074853155,690,6,158.08823529411765,33,1,17,36.75976247987116,0.6136363636363636,46.3235294117647,1014.7058823529409,30.74866310160427,8
3902,4,0,0,34,0.0,0.0,1.0,34,1150,800,350,0.6956521739130435,15,8,7,380.4793693585745,0.4259878193701723,0.17797223898612002,0.20917528700303833,128858.98940611772,3005.637405084572,131864.6268112023,691,7,159.08823529411765,33,1,18,36.51264836049084,0.6152146464646464,46.170343137254896,1015.3186274509794,30.767231134878163,0
3903,4,0,0,34,0.0,0.0,1.0,34,950,600,350,0.631578947368421,13,6,7,379.7252168624864,0.42517082590612,0.17820528283681103,0.20974695356474848,129045.6964418733,3000.3810133121838,132046.07745518547,692,8,160.08823529411765,33,1,18,36.34098721505246,0.6171085858585859,45.986519607843135,1016.0539215686273,30.789512774806887,0
3904,4,0,0,34,0.0,0.0,1.0,34,800,600,200,0.75,10,6,4,380.58802862062424,0.42446524064171126,0.17836045810729395,0.21088695373467445,129170.2428903546,3032.129619617446,132202.37250997205,693,9,161.08823529411765,33,1,19,36.191857544705655,0.6183712121212122,45.86397058823529,1016.5441176470582,30.804367201426007,0
3905,4,0,0,34,0.0,0.0,1.0,34,1350,1100,250,0.8148148148148148,16,11,5,375.15206943132887,0.42329545454545453,0.17708751615329033,0.20888736858384338,129361.89746263118,2906.0804622994306,132267.9779249306,694,10,162.08823529411765,32,2,20,36.13446899176697,0.6227213541666667,45.67550505050504,1017.2979797979783,31.790561868686822,0
3906,4,0,0,34,0.0,0.0,1.0,34,1050,700,350,0.6666666666666666,14,7,7,373.1227191397392,0.42197712418300654,0.180453431372549,0.2089487227182539,129586.77685950411,2870.354109274561,132457.13096877869,695,11,163.08823529411765,32,2,18,35.956876240079374,0.625,45.45454545454545,1018.181818181818,31.818181818181813,0
3907,4,2,0,36,0.05555555555555555,0.0,1.0,36,1050,600,450,0.5714285714285714,15,6,9,358.8623049577743,0.4271660052910053,0.1856062037771984,0.20431289008538478,130233.05047850215,2147.146535279483,132380.19701378164,696,0,154.97222222222223,35,1,20,35.66317515213365,0.624702380952381,44.82060185185185,1020.7175925925919,29.16335978835977,0
3908,4,0,0,36,0.0,0.0,1.0,36,1250,900,350,0.72,16,9,7,362.9315959929534,0.4266534391534391,0.187359961663494,0.20743438787631893,130384.14292800456,2264.1083659865767,132648.25129399114,697,1,155.97222222222223,34,2,20,35.40598166064422,0.6283700980392157,44.67261904761905,1021.309523809524,30.03851540616247,0
3909,4,0,1,35,0.0,0.027777777777777776,0.9722222222222222,36,900,700,200,0.7777777777777778,11,7,4,364.3282986137257,0.42632275132275127,0.19016496393841664,0.20855911477013886,130444.9422477325,2304.9567743764237,132749.89902210893,698,2,156.97222222222223,34,2,20,35.3086275880822,0.6289828431372548,44.61309523809524,1021.5476190476196,30.045518207282928,0
3910,4,0,0,35,0.0,0.0,1.0,35,800,600,200,0.75,10,6,4,374.96150775900486,0.4252450980392157,0.19213548630395239,0.21432984949681397,130387.71896626303,2778.075139369479,133165.7941056325,699,3,159.68571428571428,33,2,20,35.09519238460922,0.6306818181818181,44.669117647058826,1021.3235294117652,30.94919786096258,0
3911,4,0,0,35,0.0,0.0,1.0,35,1200,900,300,0.75,15,9,6,376.08164661658526,0.42436974789915966,0.19068635849638516,0.21566497726885042,130512.91120001911,2816.702109765462,133329.61330978456,700,4,160.68571428571428,33,2,16,34.93943391700648,0.6319444444444444,44.546568627450974,1021.8137254901951,30.96405228758167,0
3912,4,0,0,35,0.0,0.0,1.0,35,1200,800,400,0.6666666666666666,16,8,8,375.2593413790311,0.42377450980392156,0.1906816664098221,0.2160654717132681,130669.48596993939,2806.9890486831937,133476.4750186226,701,5,161.68571428571428,33,2,17,34.80150525390547,0.6335227272727273,44.393382352941174,1022.4264705882348,30.9826203208556,0
3913,4,0,0,35,0.0,0.0,1.0,35,1050,800,250,0.7619047619047619,13,8,5,375.84108675302406,0.4238795518207283,0.18662832494608228,0.2169273658396084,130763.47588667812,2829.257376970389,133592.73326364852,702,6,162.68571428571428,33,2,17,34.691269270708524,0.634469696969697,44.30147058823529,1022.7941176470582,30.993761140819945,0
3914,4,1,1,35,0.027777777777777776,0.027777777777777776,0.9722222222222222,36,800,500,300,0.625,11,5,6,365.81392150806045,0.4255125661375661,0.18400638168688443,0.21273600668633036,131053.7149234692,2388.2546768707266,133441.96960033994,703,0,159.13888888888889,34,2,18,34.65367399139635,0.6351102941176471,44.01785714285713,1023.92857142857,30.115546218487353,0
3915,4,0,0,35,0.0,0.0,1.0,35,1050,500,550,0.47619047619047616,16,5,11,372.1549954731078,0.42307422969187675,0.19057648909252545,0.21655481491457435,131077.01965590153,2756.193531334097,133833.21318723564,704,1,164.4857142857143,33,2,18,34.46774772618477,0.6376262626262627,43.995098039215684,1024.019607843137,31.030897207367786,0
3916,4,1,0,36,0.027777777777777776,0.0,1.0,36,700,400,300,0.5714285714285714,10,4,6,364.10531240810474,0.4258101851851852,0.18709292577545655,0.21411380657991952,131480.6990504535,2374.5642006802686,133855.26325113376,705,0,160.88888888888889,34,2,20,34.265573611917205,0.6393995098039216,43.601190476190474,1025.5952380952378,30.164565826330524,0
3917,4,0,0,36,0.0,0.0,1.0,36,750,700,50,0.9333333333333333,8,7,1,364.4592392473704,0.4262566137566137,0.1893646373224005,0.2148365064181831,131572.28599773234,2390.5470521541883,133962.83304988654,706,1,161.88888888888889,34,2,16,34.16395915525645,0.6403186274509804,43.51190476190476,1025.9523809523803,30.175070028011184,0
3918,4,0,0,36,0.0,0.0,1.0,36,1200,800,400,0.6666666666666666,16,8,8,368.04759754195896,0.4250330687830688,0.19331092047298837,0.2183479075926369,131816.6737528346,2502.9620181406076,134319.63577097523,707,2,162.88888888888889,34,2,16,33.825063760723395,0.6427696078431373,43.27380952380953,1026.904761904763,30.20308123249303,0
3919,4,0,0,36,0.0,0.0,1.0,36,1100,800,300,0.7272727272727273,14,8,6,369.394609356228,0.4245205026455026,0.18678937948262297,0.2196765047646378,131908.37762188225,2545.248724489811,134453.62634637207,708,3,163.88888888888889,34,2,17,33.69789855912235,0.6436887254901961,43.18452380952382,1027.261904761906,30.213585434173705,0
3920,4,0,0,36,0.0,0.0,1.0,36,1650,1300,350,0.7878787878787878,20,13,7,371.91775964107205,0.42319775132275134,0.18953718710606915,0.22278957058110815,132183.6805555556,2632.2916666666765,134815.97222222228,709,4,164.88888888888889,34,2,19,33.35528092922744,0.6464460784313726,42.91666666666667,1028.3333333333337,30.245098039215698,0
3921,4,0,0,36,0.0,0.0,1.0,36,650,500,150,0.7692307692307693,8,5,3,371.4956275720163,0.42293320105820104,0.18512088477366206,0.22289737654320982,132244.89795918376,2625.680272108851,134870.5782312926,710,5,165.88888888888889,34,2,19,33.30439814814813,0.6470588235294117,42.85714285714286,1028.5714285714294,30.25210084033616,0
3922,4,0,1,35,0.0,0.027777777777777776,0.9722222222222222,36,1400,900,500,0.6428571428571429,19,9,10,368.24150772571915,0.42251984126984127,0.18214304077330423,0.22166292428837886,132367.3752834468,2548.632369614518,134916.00765306133,711,6,166.88888888888889,34,2,20,33.26464406910382,0.6482843137254901,42.73809523809524,1029.0476190476197,30.26610644257705,0
3923,4,0,0,35,0.0,0.0,1.0,35,1100,800,300,0.7272727272727273,14,8,6,370.1822511631311,0.4230392156862745,0.17976307304079642,0.22320456445871628,132430.49178655236,2804.687057521199,135235.17884407355,712,7,169.88571428571427,32,3,21,33.15111833496891,0.6536458333333333,42.676767676767675,1029.292929292929,32.165404040404034,0
3924,4,0,2,33,0.0,0.05714285714285714,0.9428571428571428,35,950,600,350,0.631578947368421,13,6,7,368.7679484868623,0.4215686274509804,0.18511539943263422,0.22350734946179962,132625.50536935008,2781.6071064177113,135407.1124757678,713,8,170.88571428571427,32,3,17,32.99113344774045,0.6555989583333333,42.48737373737374,1030.050505050505,32.189078282828284,0
3925,4,0,0,33,0.0,0.0,1.0,33,900,700,200,0.7777777777777778,11,7,4,385.8527224263578,0.4213620580808081,0.17423846823324607,0.2330939947780679,132501.77043588855,3625.233769799979,136127.00420568854,714,9,172.87878787878788,30,3,21,32.6759682332463,0.6597222222222222,42.60752688172043,1029.5698924731184,34.31899641577061,0
3926,4,0,1,32,0.0,0.030303030303030304,0.9696969696969697,33,1100,800,300,0.7272727272727273,14,8,6,386.8825172855584,0.42088857323232326,0.17625248045284625,0.23501120265539513,132709.42630650918,3668.5913833968966,136378.0176899061,715,10,173.87878787878788,30,3,17,32.44004913470737,0.6618055555555555,42.40591397849461,1030.3763440860196,34.34587813620065,0
3927,4,0,0,32,0.0,0.0,1.0,32,800,500,300,0.625,11,5,6,395.2120834654381,0.4197328629032258,0.17548271330367982,0.24013746496560895,132719.8133680556,4090.4947916666724,136810.30815972228,716,11,178.34375,29,3,17,32.215005391562215,0.6648706896551724,42.395833333333336,1030.416666666667,35.53160919540231,0
3928,4,0,0,32,0.0,0.0,1.0,32,1350,1000,350,0.7407407407407407,17,10,7,396.58249212143215,0.41901881720430106,0.17045799083681423,0.24143057211100472,132791.37972608022,4132.547260802464,136923.9269868827,717,12,179.34375,29,3,17,32.107504604051556,0.6655890804597702,42.326388888888886,1030.6944444444443,35.541187739463595,0
3929,4,0,0,32,0.0,0.0,1.0,32,1050,700,350,0.6666666666666666,14,7,7,393.9862792512989,0.4182627688172043,0.16240485652701087,0.24030896884818345,132862.96537422837,4069.2370756172822,136932.20244984564,718,13,180.34375,29,3,17,32.10222169832502,0.6663074712643677,42.25694444444444,1030.9722222222222,35.5507662835249,0
3930,4,0,1,31,0.0,0.03125,0.96875,32,1100,700,400,0.6363636363636364,15,7,8,385.01173776541077,0.417023689516129,0.07293783337566673,0.225900329594996,131394.86524793843,3717.7130805121583,135112.5783284506,719,14,181.34375,31,1,18,33.81646346626027,0.6458333333333333,43.684895833333336,1025.2604166666672,33.072916666666686,8
3931,4,0,0,31,0.0,0.0,1.0,31,950,700,250,0.7368421052631579,12,7,5,394.18719699005635,0.41303763440860214,0.09348704389212048,0.23067362832303756,131293.68505390798,4150.857938779045,135444.54299268703,720,17,187.74193548387098,30,1,18,33.68387978142076,0.6475694444444444,43.78360215053763,1024.8655913978494,34.162186379928315,0
3932,4,0,0,31,0.0,0.0,1.0,31,800,700,100,0.875,9,7,2,393.36231552253344,0.41250000000000003,0.10084716013145134,0.23060525599464737,131362.5694625101,4134.616899352515,135497.1863618626,721,18,188.74193548387098,30,1,19,33.63516673222324,0.6482638888888889,43.71639784946236,1025.1344086021502,34.17114695340501,0
3933,4,0,0,31,0.0,0.0,1.0,31,850,600,250,0.7058823529411765,11,6,5,391.9131560307367,0.41151433691756273,0.1024513761778143,0.23058514214884768,131500.39247673153,4107.346766967287,135607.73924369883,722,19,189.74193548387098,30,1,20,33.53263006159087,0.6496527777777779,43.58198924731183,1025.6720430107534,34.18906810035845,0
3934,4,0,0,31,0.0,0.0,1.0,31,950,600,350,0.631578947368421,13,6,7,392.24849840064473,0.4120071684587814,0.10733537234491974,0.23182736329623232,131672.7728639148,4129.689487223943,135802.46235113876,723,20,190.74193548387098,30,1,18,33.349430330015714,0.6513888888888889,43.41397849462365,1026.3440860215046,34.21146953405015,0
3935,4,0,0,31,0.0,0.0,1.0,31,700,600,100,0.8571428571428571,8,6,2,392.7786255965518,0.41236559139784945,0.1101056125400639,0.23277237555718067,131776.255293242,4151.7792880679835,135928.03458130997,724,21,191.74193548387098,30,1,18,33.231062093642265,0.6524305555555556,43.31317204301075,1026.747311827957,34.22491039426523,0
3936,4,1,1,31,0.03125,0.03125,0.96875,32,1000,800,200,0.8,12,8,4,382.33616407627,0.41412550403225806,0.09321202531645545,0.2295179100457851,132264.0313042534,3713.8644748263846,135977.8957790798,725,0,186.71875,31,1,20,33.00632911392404,0.6545698924731183,42.838541666666664,1028.645833333333,33.18212365591397,0
3937,4,0,0,31,0.0,0.0,1.0,31,750,500,250,0.6666666666666666,10,5,5,392.7866666812557,0.4127240143369176,0.10689701714131505,0.23469003334205027,132086.9464677997,4176.398283038497,136263.34475083818,726,1,193.03225806451613,30,1,20,32.916557705718276,0.6555555555555556,43.01075268817204,1027.9569892473114,34.26523297491038,0
3938,4,0,1,30,0.0,0.03225806451612903,0.967741935483871,31,950,800,150,0.8421052631578947,11,8,3,393.17390369951806,0.41223118279569887,0.10523387412905749,0.2359968537264637,132259.71075052032,4200.213355590244,136459.92410611056,727,2,194.03225806451613,30,1,21,32.73198963369484,0.6572916666666666,42.84274193548387,1028.6290322580649,34.28763440860216,0
3939,4,0,0,30,0.0,0.0,1.0,30,1250,900,350,0.72,16,9,7,403.5955079734307,0.4109195402298851,0.10191555375691319,0.24383484112526826,132505.23003472216,4695.703124999996,137200.93315972216,728,3,198.1,29,1,21,32.21578645622555,0.6627155172413793,42.604166666666664,1029.583333333333,35.50287356321838,0
3940,4,0,0,30,0.0,0.0,1.0,30,950,700,250,0.7368421052631579,12,7,5,399.4511997151266,0.4099856321839081,0.09681769147788555,0.24202043276857674,132612.5,4594.444444444446,137206.94444444444,729,4,199.1,29,1,22,32.21413160733548,0.6637931034482758,42.5,1030.0,35.51724137931034,0
3941,4,0,0,30,0.0,0.0,1.0,30,1150,900,250,0.782608695652174,14,9,5,399.9067798402828,0.40936302681992337,0.09737575267367649,0.24275846913708804,132684.03742283944,4612.249228395052,137296.2866512345,730,5,200.1,29,1,18,32.130178844252725,0.6645114942528736,42.43055555555555,1030.2777777777771,35.526819923371626,0
3942,4,0,0,30,0.0,0.0,1.0,30,650,400,250,0.6153846153846154,9,4,5,397.73439822384074,0.4083572796934866,0.09904813218390784,0.24282731681034467,132898.76543209868,4571.682098765417,137470.4475308641,731,6,201.1,29,1,18,31.96951329022988,0.6666666666666667,42.222222222222214,1031.1111111111104,35.55555555555553,0
3943,4,0,0,30,0.0,0.0,1.0,30,850,500,350,0.5882352941176471,12,5,7,397.4466034717931,0.40682471264367814,0.10044863167339613,0.2440519226277209,133113.6670524691,4581.114969135798,137694.7820216049,732,7,202.1,29,1,18,31.760318528488106,0.6688218390804598,42.013888888888886,1031.9444444444443,35.58429118773946,0
3944,4,0,0,30,0.0,0.0,1.0,30,850,600,250,0.7058823529411765,11,6,5,398.8903771663222,0.4063936781609196,0.10235019734481487,0.2454100399917307,133185.33950617275,4625.270061728378,137810.60956790112,733,8,203.1,29,1,18,31.650856655902402,0.6695402298850575,41.944444444444436,1032.2222222222215,35.593869731800744,0
3945,4,0,1,29,0.0,0.03333333333333333,0.9666666666666667,30,1000,700,300,0.7,13,7,6,401.6457077693854,0.4056992337164751,0.1045448433508136,0.24829917944147306,133364.60503472228,4713.064236111118,138077.6692708334,734,9,204.1,29,1,19,31.399169692080157,0.6713362068965517,41.770833333333336,1032.916666666667,35.61781609195403,0
3946,4,0,0,29,0.0,0.0,1.0,29,600,400,200,0.6666666666666666,8,4,4,429.7113855068695,0.4025554187192118,0.10058179962680724,0.25294624938504295,131518.85640323846,5575.990070507371,137094.84647374583,735,39,211.82758620689654,27,2,21,32.544640698292945,0.6593364197530864,43.563988095238095,1025.7440476190482,37.99052028218697,8
3947,4,0,0,29,0.0,0.0,1.0,29,950,700,250,0.7368421052631579,12,7,5,428.4676234893964,0.4022475369458128,0.09501137755995037,0.2527189276269794,131595.187717014,5476.855468750006,137072.043185764,736,40,212.82758620689654,27,2,20,32.49894247038916,0.660108024691358,43.489583333333336,1026.0416666666674,38.00154320987657,0
3948,4,0,0,29,0.0,0.0,1.0,29,1100,800,300,0.7272727272727273,14,8,6,433.41505344092485,0.40178571428571425,0.09675565174363099,0.2566635582565614,131747.91677738805,5620.306078160434,137368.2228555485,737,41,213.82758620689654,27,2,20,32.21677658597864,0.6616512345679013,43.34077380952381,1026.6369047619048,38.023589065255734,0
3949,4,0,1,28,0.0,0.034482758620689655,0.9655172413793104,29,750,400,350,0.5333333333333333,11,4,7,432.06721277042595,0.40163177339901474,0.09523238380809573,0.25612231684844866,131786.11288265322,5588.091695011356,137374.20457766458,738,42,214.82758620689654,27,2,20,32.21256038647342,0.662037037037037,43.30357142857144,1026.7857142857156,38.029100529100575,0
3950,4,0,0,28,0.0,0.0,1.0,28,600,400,200,0.6666666666666666,8,4,4,432.5620256055808,0.4001047178130512,0.06686016431779152,0.25718997956548867,131900.73441485967,5811.0497714710855,137711.78418633077,739,43,207.89285714285714,27,1,20,32.08342387367812,0.6631944444444444,43.191964285714285,1027.2321428571427,38.04563492063491,0
3951,4,0,0,28,0.0,0.0,1.0,28,900,600,300,0.6666666666666666,12,6,6,431.24960864080066,0.3981205908289242,0.06856998118396307,0.25796567498695167,132130.12695312497,5796.213107638889,137926.34006076385,740,44,208.89285714285714,27,1,21,31.88428740290443,0.6655092592592593,42.96875,1028.1249999999998,38.078703703703695,0
3952,4,0,0,28,0.0,0.0,1.0,28,850,400,450,0.47058823529411764,13,4,9,430.8996802210125,0.3966324955908289,0.07260131016098059,0.25880186701719016,132283.16603334044,5800.154788477901,138083.32082181834,741,45,209.89285714285714,27,1,21,31.73805993538745,0.6670524691358024,42.81994047619048,1028.7202380952383,38.1007495590829,0
3953,4,1,0,29,0.034482758620689655,0.0,1.0,29,750,700,50,0.9333333333333333,8,7,1,418.41956246981783,0.3994252873563218,0.06386835866685248,0.25406322459534847,132693.9061674264,5304.345232197131,137998.25139962355,742,0,203.6206896551724,28,1,19,31.643366801468886,0.6677827380952381,42.42097701149426,1030.3160919540235,36.79700328407227,0
3954,4,0,0,29,0.0,0.0,1.0,29,950,700,250,0.7368421052631579,12,7,5,416.65745904298365,0.39860426929392445,0.06552349086853493,0.2534931258452351,132767.9334497622,5263.749958713174,138031.68340847536,743,1,204.6206896551724,28,1,19,31.613922580045546,0.6685267857142857,42.349137931034484,1030.603448275862,36.80726600985222,0
3955,4,0,0,29,0.0,0.0,1.0,29,750,400,350,0.5333333333333333,11,4,7,416.6763432669443,0.3975779967159277,0.0632617419738406,0.25439187273139735,132898.76543209865,5275.154320987638,138173.9197530863,744,2,205.6206896551724,29,0,19,31.481232040229877,0.6666666666666667,42.222222222222214,1031.1111111111102,35.55555555555552,0
3956,4,0,0,29,0.0,0.0,1.0,29,850,600,250,0.7058823529411765,11,6,5,410.5611757356212,0.39752668308702793,0.05986106664068025,0.25234740255511984,133149.50086805545,5133.203124999981,138282.70399305542,745,3,206.6206896551724,29,0,19,31.38583299690485,0.6691810344827587,41.97916666666666,1032.0833333333323,35.58908045977008,0
3957,4,0,0,29,0.0,0.0,1.0,29,1050,900,150,0.8571428571428571,12,9,3,411.3887269584552,0.3970648604269294,0.05593302877814632,0.2538319655548639,133292.88435570968,5167.038001543184,138459.92235725286,746,4,207.6206896551724,29,0,20,31.21987783008295,0.670617816091954,41.840277777777764,1032.6388888888873,35.608237547892664,0
3958,4,0,1,28,0.0,0.034482758620689655,0.9655172413793104,29,1050,800,250,0.7619047619047619,13,8,5,411.7344874029382,0.39655172413793105,0.05953457317327593,0.25453610829722795,133364.60503472228,5182.16145833334,138546.76649305562,747,5,208.6206896551724,29,0,20,31.138647976334557,0.6713362068965517,41.770833333333336,1032.916666666667,35.61781609195403,0
3959,4,0,0,28,0.0,0.0,1.0,28,750,500,250,0.6666666666666666,10,5,5,421.63597604621737,0.3943176807760141,0.05288815122542667,0.26011139569477787,133286.70244170286,5639.693775597815,138926.39621730067,748,6,208.35714285714286,28,0,20,30.961574138490786,0.6737351190476191,41.84626436781608,1032.6149425287347,36.87910509031195,0
3960,4,1,0,29,0.034482758620689655,0.0,1.0,29,1150,800,350,0.6956521739130435,15,8,7,407.2683433995741,0.3979885057471264,0.044174233549265196,0.2542269365713855,133723.49778163587,5092.269483024699,138815.76726466056,749,0,202.13793103448276,29,0,19,30.892613356608923,0.6749281609195402,41.423611111111114,1034.305555555556,35.665708812260554,0
3961,4,0,0,29,0.0,0.0,1.0,29,750,500,250,0.6666666666666666,10,5,5,404.6250269032597,0.3961925287356322,0.04358931645288444,0.25381024414840836,133903.12500000003,5036.111111111112,138939.23611111115,750,1,203.13793103448276,29,0,19,30.780327428878156,0.6767241379310345,41.25,1035.0000000000002,35.6896551724138,0
3962,4,0,0,29,0.0,0.0,1.0,29,500,300,200,0.6,7,3,4,404.5929424286144,0.395628078817734,0.04996160358243196,0.25428632317562316,133975.00964506168,5041.068672839496,139016.07831790118,751,2,204.13793103448276,29,0,19,30.708903497003845,0.6774425287356323,41.18055555555555,1035.2777777777774,35.699233716475085,0
3963,4,0,0,29,0.0,0.0,1.0,29,1150,1100,50,0.9565217391304348,12,11,1,403.58228694233424,0.3938321018062398,0.05380419709716211,0.25514608988049253,134190.77932098752,5031.40432098764,139222.18364197516,752,3,205.13793103448276,29,0,19,30.51831992850759,0.6795977011494253,40.972222222222214,1036.1111111111102,35.727969348658974,0
3964,4,0,0,29,0.0,0.0,1.0,29,550,400,150,0.7272727272727273,7,4,3,402.6745267590911,0.39352422003284077,0.05324237760492467,0.2548222768574706,134226.7578125,5009.939236111112,139236.69704861112,753,4,206.13793103448276,29,0,19,30.505713041147303,0.6799568965517242,40.9375,1036.25,35.73275862068966,0
3965,4,0,1,28,0.0,0.034482758620689655,0.9655172413793104,29,750,500,250,0.6666666666666666,10,5,5,403.764435851573,0.39270320197044334,0.05432974830912518,0.2562668154078352,134334.72222222228,5047.916666666673,139382.63888888896,754,5,207.13793103448276,29,0,19,30.36910503751339,0.6810344827586207,40.833333333333336,1036.666666666667,35.74712643678162,0
3966,4,0,0,28,0.0,0.0,1.0,28,750,400,350,0.5333333333333333,11,4,7,415.5455225732484,0.38778659611992944,0.0634931642559935,0.2623540470887147,134141.16172876215,5548.351829832226,139689.51355859436,755,6,215.10714285714286,28,0,19,30.258321775312073,0.6822916666666667,41.02011494252874,1035.9195402298858,36.997126436781635,0
3967,4,0,0,28,0.0,0.0,1.0,28,750,500,250,0.6666666666666666,10,5,5,416.1704906953027,0.3882550705467372,0.06621332488063869,0.26301537321681223,134178.37406278902,5568.215954881757,139746.59001767077,756,7,216.10714285714286,28,0,19,30.204721952572463,0.6826636904761905,40.98419540229885,1036.0632183908046,37.0022577996716,0
3968,4,0,0,28,0.0,0.0,1.0,28,550,400,150,0.7272727272727273,7,4,3,415.7682853422781,0.3879794973544974,0.0604513675704581,0.263295578768556,134252.8142134034,5563.612473576439,139816.42668697986,757,8,217.10714285714286,28,0,20,30.14031378529506,0.6834077380952381,40.912356321839084,1036.3505747126442,37.01252052545158,0
3969,4,0,0,28,0.0,0.0,1.0,28,400,300,100,0.75,5,3,2,415.7682853422781,0.3879794973544974,0.0604513675704581,0.263295578768556,134252.8142134034,5563.612473576439,139816.42668697986,758,9,218.10714285714286,28,0,20,30.14031378529506,0.6834077380952381,40.912356321839084,1036.3505747126442,37.01252052545158,0
3970,4,0,0,28,0.0,0.0,1.0,28,700,500,200,0.7142857142857143,9,5,4,414.09562421711973,0.38773148148148145,0.06403223890055054,0.2625031487787612,134290.04202999081,5521.7837561104625,139811.82578610128,759,10,219.10714285714286,28,0,20,30.14624341558082,0.6837797619047619,40.8764367816092,1036.4942528735637,37.01765188834156,0
3971,4,0,1,27,0.0,0.03571428571428571,0.9642857142857143,28,450,300,150,0.6666666666666666,6,3,3,411.76612403223623,0.38764880952380953,0.06387981387981356,0.2612922238252053,134327.27500743163,5462.284276324481,139789.5592837561,760,11,220.10714285714286,28,0,20,30.169207669207662,0.6841517857142857,40.84051724137931,1036.6379310344828,37.02278325123153,0
3972,4,0,0,27,0.0,0.0,1.0,27,650,600,50,0.9230769230769231,7,6,1,420.4605551616734,0.3841405508072175,0.08547663114004322,0.26618975510417203,134242.1786422902,5888.708191609969,140130.88683390018,761,12,226.88888888888889,27,0,20,30.02943710511201,0.6867283950617284,40.922619047619044,1036.3095238095234,38.38183421516754,0
3973,4,0,0,27,0.0,0.0,1.0,27,1050,900,150,0.8571428571428571,12,9,3,431.4961151452077,0.3839624881291548,0.04642389543527936,0.2618789149735822,132676.08786770294,6072.519034477047,138748.60690217998,762,13,227.88888888888889,26,1,18,31.32458308368283,0.6746794871794872,42.43827160493826,1030.2469135802457,39.624881291547915,8
3974,4,0,0,27,0.0,0.0,1.0,27,1000,800,200,0.8,12,8,4,428.2254575567319,0.38342830009496676,0.043702527755060894,0.2614250392432241,132896.208125177,5981.907906391706,138878.11603156873,763,14,228.88888888888889,27,0,18,31.186107903978456,0.6732253086419753,42.22470238095237,1031.1011904761892,38.1889329805996,0
3975,4,0,0,27,0.0,0.0,1.0,27,750,400,350,0.5333333333333333,11,4,7,430.50263146950476,0.3817663817663817,0.04726722972792485,0.263896971174012,133049.69009088006,6055.648340065188,139105.33843094524,764,15,229.88888888888889,27,0,18,30.97219217270061,0.6747685185185186,42.075892857142854,1031.6964285714282,38.21097883597882,0
3976,4,0,0,27,0.0,0.0,1.0,27,650,500,150,0.7692307692307693,8,5,3,427.3284370420773,0.3817070275403609,0.04366471734892796,0.26249093984825556,133126.46429014305,5977.744782808943,139104.20907295198,765,16,230.88888888888889,27,0,18,30.976478010093725,0.6755401234567902,42.00148809523809,1031.9940476190468,38.2220017636684,0
3977,4,0,0,27,0.0,0.0,1.0,27,450,300,150,0.6666666666666666,6,3,3,426.7163299157606,0.3809354226020893,0.041260230967597566,0.2626558279170923,133203.26063368047,5968.001302083325,139171.2619357638,766,17,231.88888888888889,27,0,19,30.91469054826775,0.6763117283950617,41.92708333333333,1032.291666666666,38.233024691358004,0
3978,4,0,1,26,0.0,0.037037037037037035,0.962962962962963,27,600,400,200,0.6666666666666666,8,4,4,430.0214453361394,0.3798076923076923,0.04810226533073014,0.26606139692722636,133395.3483737244,6072.572101757359,139467.92047548178,767,18,232.88888888888889,27,0,20,30.635383655046578,0.6782407407407407,41.74107142857142,1033.0357142857138,38.26058201058199,0
3979,4,0,0,26,0.0,0.0,1.0,26,750,700,50,0.9333333333333333,8,7,1,439.9874916441252,0.375,0.07138259230309418,0.2716232743618528,133312.8048315805,6531.1933203779745,139843.99815195845,768,84,242.15384615384616,26,0,21,30.461434050607693,0.6810897435897436,41.82098765432098,1032.7160493827155,39.719848053181366,0
3980,4,0,0,26,0.0,0.0,1.0,26,900,700,200,0.7777777777777778,11,7,4,443.24696960992713,0.3752884615384615,0.07460791635548891,0.27451789653454767,133432.358943949,6628.697749961882,140061.05669391088,769,85,243.15384615384616,26,0,21,30.256410256410255,0.6822916666666667,41.70524691358024,1033.1790123456783,39.73765432098763,0
3981,4,0,0,26,0.0,0.0,1.0,26,800,700,100,0.875,9,7,2,440.261183720983,0.3754807692307693,0.07737678179667107,0.2732557133808549,133512.09145423718,6556.038284941324,140068.1297391785,770,86,244.15384615384616,26,0,22,30.252973968443587,0.6830929487179487,41.62808641975309,1033.487654320988,39.749525166191845,0
3982,4,0,0,26,0.0,0.0,1.0,26,600,400,200,0.6666666666666666,8,4,4,442.1023330176007,0.3744551282051282,0.07890385476592354,0.27499011410259117,133591.84777949247,6612.253515089159,140204.10129458163,771,87,245.15384615384616,26,0,22,30.12483206448724,0.6838942307692308,41.550925925925924,1033.7962962962963,39.76139601139601,0
3983,4,0,1,25,0.0,0.038461538461538464,0.9615384615384616,26,600,300,300,0.5,9,3,6,439.9949571748473,0.37355769230769226,0.08073995844477855,0.27427034493289776,133671.62791971493,6562.968440405411,140234.59636012034,772,88,246.15384615384616,26,0,22,30.098741481370936,0.6846955128205128,41.47376543209876,1034.1049382716044,39.773266856600166,0
3984,4,0,0,25,0.0,0.0,1.0,25,700,400,300,0.5714285714285714,10,4,6,446.8010699440612,0.36694444444444446,0.08054522924411378,0.2795104367789593,133803.62426035505,6956.7204963839595,140760.344756739,773,89,247.8,25,0,19,29.78947232548534,0.69,41.34615384615385,1034.6153846153848,41.38461538461539,0
3985,4,0,0,25,0.0,0.0,1.0,25,800,500,300,0.625,11,5,6,445.3316728781528,0.36590277777777774,0.0766434432574703,0.2795332628882399,133928.00596338758,6928.47658818212,140856.4825515697,774,90,248.8,25,0,19,29.70193399391031,0.6912499999999999,41.22596153846154,1035.0961538461538,41.40384615384615,0
3986,4,0,0,25,0.0,0.0,1.0,25,700,500,200,0.7142857142857143,9,5,4,447.63551125667504,0.36562500000000003,0.07919517102615714,0.28161373303109793,134010.95920138882,6997.612847222212,141008.57204861104,775,91,249.8,25,0,19,29.558601609657952,0.6920833333333334,41.14583333333333,1035.416666666666,41.41666666666664,0
3987,4,0,0,25,0.0,0.0,1.0,25,600,300,300,0.5,9,3,6,446.849905936719,0.3648611111111111,0.044095477386934645,0.2540660893754487,130180.80210387896,6634.255834976982,136815.05793885596,776,92,250.8,25,0,21,33.47139342546065,0.6533333333333333,44.87179487179487,1020.51282051282,40.820512820512796,8
3988,4,0,0,25,0.0,0.0,1.0,25,900,700,200,0.7777777777777778,11,7,4,447.52526882413173,0.36541666666666667,0.048318945220530374,0.25525366944302086,130303.48878718769,6662.820769641679,136966.30955682936,777,93,251.8,25,0,21,33.32859179615968,0.6545833333333333,44.75160256410256,1020.9935897435896,40.839743589743584,0
3989,4,0,0,25,0.0,0.0,1.0,25,650,300,350,0.46153846153846156,10,3,7,446.391522231798,0.3653472222222222,0.04504708097928445,0.2548751594678331,130344.39718934918,6636.92677514794,136981.32396449713,778,94,252.8,25,0,22,33.3156779661017,0.655,44.71153846153847,1021.1538461538466,40.84615384615387,0
3990,4,1,0,26,0.038461538461538464,0.0,1.0,26,900,600,300,0.6666666666666666,12,6,6,430.0586127360051,0.37301282051282053,0.041676338145861136,0.24829516421726858,130775.08192348733,6048.19006249048,136823.2719859778,779,0,244.03846153846155,26,0,19,33.29309997988333,0.655448717948718,44.29012345679013,1022.83950617284,39.33998100664769,0
3991,4,0,0,26,0.0,0.0,1.0,26,800,600,200,0.75,10,6,4,429.5392504930788,0.37195512820512816,0.04244051831142781,0.24875762183577335,130893.49291742871,6044.778568434684,136938.2714858634,780,1,245.03846153846155,26,0,20,33.185668325541656,0.656650641025641,44.17438271604938,1023.3024691358021,39.357787274453926,0
3992,4,1,0,27,0.037037037037037035,0.0,1.0,27,600,500,100,0.8333333333333334,7,5,2,433.777775899967,0.3789767331433998,0.0743024627916713,0.2357909362852893,128408.33875868052,5740.136718749991,134148.4754774305,781,0,236.92592592592592,27,0,16,35.62328708461801,0.6277006172839505,46.61458333333333,1013.5416666666663,37.53858024691357,8
3993,4,1,0,28,0.03571428571428571,0.0,1.0,28,750,500,250,0.6666666666666666,10,5,5,421.81281575089565,0.38387345679012347,0.06949724963598136,0.23134205981865893,128763.54207953493,5262.822450125514,134026.36452966044,782,0,229.42857142857142,28,0,18,35.56147366930919,0.6279761904761905,46.264367816091955,1014.9425287356321,36.247947454844,0
3994,4,0,0,28,0.0,0.0,1.0,28,700,500,200,0.7142857142857143,9,5,4,395.5528713567501,0.38423170194003525,0.06248098955692982,0.2132111689906887,128071.80450274122,4531.834002179911,132603.63850492114,783,1,230.42857142857142,28,0,22,36.93724863969719,0.6209077380952381,46.94683908045975,1012.2126436781591,36.150451559934254,7
3995,4,0,0,28,0.0,0.0,1.0,28,400,300,100,0.75,5,3,2,395.83841765184627,0.38403880070546736,0.06585296622197001,0.2135587665218151,128108.16529594375,4542.026687805493,132650.19198374925,784,2,231.42857142857142,28,0,22,36.89268142681427,0.6212797619047619,46.91091954022987,1012.3563218390786,36.15558292282424,0
3996,4,1,0,29,0.034482758620689655,0.0,1.0,29,850,400,450,0.47058823529411764,13,4,9,381.07770701153004,0.3865455665024631,0.060068568838012926,0.20796931364709928,128566.75347222199,3998.784722222185,132565.53819444418,785,0,224.41379310344828,29,0,18,36.79642563681181,0.6228448275862069,46.458333333333314,1014.1666666666647,34.971264367816026,0
3997,4,1,0,30,0.03333333333333333,0.0,1.0,30,800,600,200,0.75,10,6,4,371.81826394292045,0.39111590038314176,0.05756693573287475,0.20494752885606432,128962.364236472,3590.1124768758864,132552.4767133479,786,0,217.9,30,0,19,36.62691323717525,0.6239583333333334,46.06854838709675,1015.7258064516094,33.85752688172031,0
3998,4,3,1,32,0.09090909090909091,0.030303030303030304,0.9696969696969697,33,200,0,200,0.0,4,0,4,341.81111141188126,0.40443497474747475,0.062194819770577725,0.1925813822832791,129825.09731833884,2275.132160707388,132100.22947904622,787,0,199.0,33,0,18,36.51194484527817,0.625,45.2205882352941,1019.1176470588214,30.882352941176407,0
3999,4,0,0,32,0.0,0.0,1.0,32,700,400,300,0.5714285714285714,10,4,6,350.33703068009555,0.40081065188172044,0.06914193208576047,0.19699439028276575,129747.52456700832,2691.0724989796768,132438.597065988,788,1,206.0625,32,0,19,36.373517990663856,0.6266276041666667,45.29671717171716,1018.81313131313,31.837910353535314,0
4000,4,0,0,32,0.0,0.0,1.0,32,750,500,250,0.6666666666666666,10,5,5,352.3464330017579,0.40030661962365593,0.07064056112969208,0.19877657258023676,129876.19447314036,2752.282770890714,132628.4772440311,789,2,207.0625,32,0,20,36.19162640901772,0.6279296875,45.17045454545454,1019.3181818181807,31.853693181818148,0
4001,4,2,0,34,0.058823529411764705,0.0,1.0,34,550,400,150,0.7272727272727273,7,4,3,357.30528368553644,0.41000074272133097,0.12290923900229367,0.18869110972309294,127246.52364775557,2342.27716399008,129588.80081174565,790,0,195.8235294117647,33,1,17,38.75093627272359,0.598800505050505,47.76348039215686,1008.9460784313717,30.574123588829444,8
4002,4,0,0,34,0.0,0.0,1.0,34,1000,800,200,0.8,12,8,4,361.1585907663488,0.40890522875817,0.13256534559448263,0.19160242300862493,127432.0592590589,2404.636588091102,129836.69584715,791,1,196.8235294117647,33,1,16,38.46327932192416,0.6006944444444444,47.57965686274509,1009.6813725490185,30.596405228758137,0
4003,4,1,1,34,0.02857142857142857,0.02857142857142857,0.9714285714285714,35,800,600,200,0.75,10,6,4,355.18144204446594,0.41141456582633057,0.13794217086340033,0.1900791422358942,127783.17920918328,2077.2427721087947,129860.42198129206,792,0,192.17142857142858,34,1,17,38.254297656893904,0.6020220588235294,47.23214285714283,1011.0714285714254,29.7373949579831,0
4004,4,0,0,34,0.0,0.0,1.0,34,650,400,250,0.6153846153846154,9,4,5,387.10951490056385,0.40784685086155675,0.1675976453400938,0.20150301364976114,126659.88592128025,3006.249399269508,129666.13532054976,793,1,198.6764705882353,33,1,15,38.60380650921191,0.5928030303030303,48.345588235294116,1006.6176470588233,30.503565062388585,8
4005,4,1,0,35,0.02857142857142857,0.0,1.0,35,950,600,350,0.631578947368421,13,6,7,384.7638866459148,0.41242997198879555,0.15947910868208437,0.20226973035408122,127062.00573979579,2777.774234693859,129839.77997448965,794,0,193.97142857142856,34,1,16,38.2483173928445,0.5946691176470589,47.94642857142856,1008.2142857142846,29.653361344537785,0
4006,4,1,2,34,0.027777777777777776,0.05555555555555555,0.9444444444444444,36,800,400,400,0.5,12,4,8,383.28893851446236,0.41375661375661377,0.17704234320280188,0.20354205651483137,127471.5889301481,2571.690002357653,130043.27893250575,795,0,189.55555555555554,35,1,15,37.864016236867236,0.5967261904761905,47.540509259259245,1009.8379629629611,28.852513227513175,0
4007,4,0,1,33,0.0,0.029411764705882353,0.9705882352941176,34,1300,1000,300,0.7692307692307693,16,10,6,396.58051610550154,0.40762403446226975,0.2010202551708875,0.2103945184928028,127432.05925905901,3307.414365868894,130739.47362492791,796,1,201.23529411764707,33,1,15,37.56915786705506,0.6006944444444444,47.5796568627451,1009.6813725490194,30.596405228758165,0
4008,4,1,0,34,0.029411764705882353,0.0,1.0,34,1300,1000,300,0.7692307692307693,16,10,6,397.82856567644546,0.40400326797385616,0.2111599246876248,0.21251878301161398,127710.61610918868,3361.386245674728,131072.0023548634,797,0,202.14705882352942,33,1,16,37.25094972518589,0.6035353535353536,47.303921568627445,1010.7843137254895,30.629827688651197,0
4009,4,3,2,35,0.08108108108108109,0.05405405405405406,0.9459459459459459,37,800,400,400,0.5,12,4,8,371.6444199270332,0.41485235235235235,0.19894903466087355,0.20231407545934627,128466.99948827579,2149.544595765471,130616.54408404126,798,0,186.67567567567568,35,2,15,37.13763462343492,0.606845238095238,46.556712962962955,1013.7731481481474,28.964947089947067,0
4010,4,3,0,38,0.07894736842105263,0.0,1.0,38,1150,900,250,0.782608695652174,14,9,5,356.48889211480684,0.4166518492176387,0.223953080159371,0.18841844353801634,127280.60766171751,1474.8245626050193,128755.43222432253,799,0,182.68421052631578,38,0,17,38.73654490912299,0.5890899122807017,47.72970085470086,1009.0811965811972,26.554768331084137,8
4011,4,1,0,39,0.02564102564102564,0.0,1.0,39,1000,600,400,0.6,14,6,8,349.2400892762247,0.41942195231668916,0.2271213322759713,0.1861334541746914,127617.73003472238,1113.8454861111297,128731.5755208335,800,0,178.97435897435898,39,0,18,38.573883161512036,0.5908119658119658,47.39583333333334,1010.416666666668,25.90811965811969,0
4012,4,0,1,38,0.0,0.02564102564102564,0.9743589743589743,39,850,500,350,0.5882352941176471,12,5,7,348.2414625646249,0.41908457040035985,0.22768533126154433,0.18596515747190742,127696.68104383687,1093.8557942708374,128790.53683810771,801,1,179.97435897435898,39,0,18,38.5182632519152,0.5916132478632479,47.317708333333336,1010.7291666666672,25.91613247863249,0
4013,4,1,0,39,0.02564102564102564,0.0,1.0,39,1250,900,350,0.72,16,9,7,346.5165388437708,0.4189158794421952,0.23069001029866087,0.18589367912558105,127880.99500868068,1062.5759548611206,128943.5709635418,802,0,180.87179487179486,39,0,19,38.37324064538275,0.593482905982906,47.13541666666667,1011.4583333333344,25.934829059829088,0
4014,4,3,1,41,0.07142857142857142,0.023809523809523808,0.9761904761904762,42,950,500,450,0.5263157894736842,14,5,9,326.8769369111501,0.42679297328687577,0.22303391956802732,0.17880616225665832,128659.52934967625,11.709106372708561,128671.23845604896,803,0,168.88095238095238,40,2,15,38.07618785268291,0.5997395833333333,46.366869918699194,1014.5325203252042,25.363313008130106,0
4015,4,1,1,41,0.023809523809523808,0.023809523809523808,0.9761904761904762,42,850,600,250,0.7058823529411765,11,6,5,326.0491722954185,0.426853464963221,0.23001573001573017,0.17916563428114593,128840.0226799525,1.6365506642971752,128841.65923061679,804,0,169.85714285714286,40,2,16,37.91353853853853,0.6015625,46.18902439024391,1015.2439024390251,25.381097560975626,0
4016,4,1,0,42,0.023809523809523808,0.0,1.0,42,1000,500,500,0.5,15,5,10,329.38724061298853,0.426659891598916,0.23570242629721072,0.18161529114897082,128974.55401431397,96.51449121314022,129071.0685055271,805,0,170.78571428571428,41,1,17,37.69197431389782,0.6013719512195121,46.05654761904761,1015.7738095238088,24.774970963995337,0
4017,4,1,3,40,0.023255813953488372,0.06976744186046512,0.9302325581395349,43,750,400,350,0.5333333333333333,11,4,7,340.47760566823683,0.42898671096345514,0.2448182138992694,0.18244979289200974,127836.02812685886,150.10240903568047,127986.13053589454,806,0,167.7906976744186,40,3,16,38.5719190701102,0.59140625,47.17987804878048,1011.2804878048769,25.282012195121922,8
4018,4,0,1,39,0.0,0.025,0.975,40,1600,1200,400,0.75,20,12,8,357.60813458893523,0.42043269230769226,0.27973375989588956,0.1913815791668353,127783.97108966224,1139.3175063481094,128923.28859601034,807,1,181.0,37,3,17,38.19214745327694,0.5960022522522522,47.23135964912281,1011.074561403509,27.326339497392137,0
4019,4,1,1,39,0.025,0.025,0.975,40,850,600,250,0.7058823529411765,11,6,5,358.2639594652563,0.42301014957264954,0.2806675335934117,0.19266082855159575,127978.05574792234,1169.9849953831826,129148.04074330552,808,0,181.425,37,3,18,37.97680970957955,0.597972972972973,47.03947368421052,1011.842105263157,27.34708392603127,0
4020,4,0,0,39,0.0,0.0,1.0,39,500,200,300,0.4,8,2,6,366.0324498147305,0.4206027890238417,0.2927345671614541,0.1969561433553991,128002.04554216361,1570.5804622189569,129572.62600438258,809,1,186.94871794871796,36,3,18,37.75572186363973,0.6001157407407407,47.01576576576576,1011.9369369369356,28.10935935935932,0
4021,4,2,1,40,0.04878048780487805,0.024390243902439025,0.975609756097561,41,1400,1000,400,0.7142857142857143,18,10,8,356.3023885638932,0.42652439024390243,0.3054696867876292,0.19523852019886526,128728.04763244472,973.3014293245902,129701.34906176932,810,0,178.78048780487805,37,4,17,37.25992706645057,0.6055743243243243,46.299342105263165,1014.8026315789484,27.42709815078239,0
4022,4,1,0,41,0.024390243902439025,0.0,1.0,41,750,600,150,0.8,9,6,3,355.754109481062,0.42550813008130084,0.31537446569801,0.19575988163423155,128895.0100631926,970.9859043167253,129865.99596750933,811,0,179.7560975609756,37,4,18,37.10351203973654,0.6072635135135135,46.13486842105264,1015.4605263157902,27.44487908961595,0
4023,4,1,0,42,0.023809523809523808,0.0,1.0,42,750,400,350,0.5333333333333333,11,4,7,347.3175121057891,0.42687766163375923,0.3103446549946445,0.1923386967505518,129147.08547921691,571.0088848710644,129718.09436408797,812,0,176.45238095238096,38,4,19,37.06095403265361,0.6080043859649122,45.886752136752136,1016.4529914529917,26.748762932973467,0
4024,4,0,0,42,0.0,0.0,1.0,42,1650,1400,250,0.8484848484848485,19,14,5,343.5951689983396,0.42653890824622537,0.3059127442595566,0.19119635324565704,129337.19735051876,487.927236284622,129825.12458680339,813,1,177.45238095238096,38,4,19,36.96215383538146,0.6099232456140351,45.69978632478633,1017.2008547008554,26.768443544759354,0
4025,4,1,0,43,0.023255813953488372,0.0,1.0,43,1250,900,350,0.72,16,9,7,338.0588019046348,0.42771779254337394,0.31259543255623634,0.18975539408860642,129678.3908420141,167.78428819446523,129846.17513020856,814,0,174.30232558139534,39,4,18,36.75640894525124,0.6116452991452992,45.36458333333334,1018.5416666666683,26.116452991453034,0
4026,4,0,0,43,0.0,0.0,1.0,43,1250,900,350,0.72,16,9,7,337.63189441499145,0.4268641565153193,0.30984294836743276,0.1900296427599225,129784.5106336808,163.87803819446842,129948.38867187526,815,1,175.30232558139534,39,4,19,36.659595856334775,0.6127136752136753,45.26041666666668,1018.9583333333353,26.127136752136803,0
4027,4,1,1,43,0.022727272727272728,0.022727272727272728,0.9772727272727273,44,1450,1000,450,0.6896551724137931,19,10,9,333.2272589932435,0.4276889534883721,0.31341178494779487,0.1891050567005751,130107.01844346961,-128.95897365984132,129978.05946980977,816,0,172.29545454545453,40,4,20,36.44494803599299,0.6143229166666666,44.94410569105692,1020.2235772357733,25.505589430894332,0
4028,4,0,0,43,0.0,0.0,1.0,43,700,300,400,0.42857142857142855,11,3,8,337.2990496050934,0.42727943890734593,0.30216182477091813,0.1920507488134989,130236.00396050369,185.69607204863146,130421.70003255233,817,1,169.65116279069767,39,4,20,36.21043388781167,0.6172542735042735,44.81770833333334,1020.7291666666683,26.17254273504278,0
4029,4,0,0,43,0.0,0.0,1.0,43,1300,1000,300,0.7692307692307693,16,10,6,337.5338595759295,0.4264719453672942,0.30554085494323324,0.19314898254357227,130430.54112803926,204.950216052033,130635.4913440913,818,2,170.65116279069767,37,6,20,36.00749606411907,0.6227477477477478,44.62719298245613,1021.4912280701743,27.60787102892363,0
4030,4,0,0,43,0.0,0.0,1.0,43,900,700,200,0.7777777777777778,11,7,4,337.2982225743783,0.42635658914728686,0.3066433060293403,0.19329304046421014,130486.54994806091,202.57627346875717,130689.12622152967,819,3,171.65116279069767,37,6,22,35.95683980825643,0.6233108108108107,44.57236842105263,1021.7105263157893,27.613798008534843,0
4031,4,0,0,43,0.0,0.0,1.0,43,900,400,500,0.4444444444444444,14,4,10,333.8727234517276,0.42665651531930604,0.2989595763451258,0.19211233257423835,130644.58832137125,123.73290141720514,130768.32122278845,820,4,172.65116279069767,38,5,16,35.88454035601072,0.6230811403508771,44.417735042735046,1022.3290598290605,26.903396311291065,0
4032,4,1,0,44,0.022727272727272728,0.0,1.0,44,1500,1000,500,0.6666666666666666,20,10,10,331.0698507258703,0.4274356941508104,0.22702634312654846,0.18254303724190546,128974.55401431395,-260.0827310090807,128714.47128330487,821,0,169.70454545454547,41,3,15,37.64924553179019,0.6013719512195121,46.05654761904761,1015.7738095238087,24.774970963995333,8
4033,4,0,1,43,0.0,0.022727272727272728,0.9772727272727273,44,1550,900,650,0.5806451612903226,22,9,13,332.17375765793395,0.42753479563072583,0.23240211565084712,0.1837358516980491,129100.54878432828,-223.23711892167,128877.31166540661,822,1,170.70454545454547,41,3,16,37.493085383313804,0.6026422764227642,45.93253968253967,1016.269841269839,24.787069299264367,0
4034,4,1,1,43,0.022727272727272728,0.022727272727272728,0.9772727272727273,44,750,200,550,0.26666666666666666,13,2,11,332.7676970019709,0.426852096546864,0.2532959666306658,0.18503096774073138,129307.31336805549,-194.0618898022226,129113.25147825327,823,0,171.5,39,5,17,37.26785470435615,0.607905982905983,45.729166666666664,1017.0833333333328,26.079059829059815,0
4035,4,1,0,44,0.022727272727272728,0.0,1.0,44,1400,1000,400,0.7142857142857143,18,10,8,334.96568587649,0.426786028893587,0.2725254641597057,0.1880874548761936,129692.62390318251,-111.48425622977186,129581.13964695274,824,0,172.13636363636363,40,4,15,36.82072898998969,0.61015625,45.350609756097555,1018.5975609756088,25.46493902439022,0
4036,4,0,0,44,0.0,0.0,1.0,44,1200,900,300,0.75,15,9,6,331.87259804349736,0.4266649048625793,0.26608963466440105,0.1868966736350221,129807.25623582758,-184.10572562359204,129623.15051020398,825,1,173.13636363636363,41,3,15,36.783245716510905,0.6097560975609756,45.238095238095234,1019.0476190476184,24.85481997677118,0
4037,4,1,1,44,0.022222222222222223,0.022222222222222223,0.9777777777777777,45,1050,600,450,0.5714285714285714,15,6,9,325.6545352613306,0.43085016835016837,0.268114519686369,0.18484186532434232,130114.25212014001,-525.5407389880413,129588.71138115197,826,0,170.26666666666668,42,3,17,36.630773736030655,0.611359126984127,44.93701550387597,1020.2519379844961,24.291712809154667,0
4038,4,0,0,44,0.0,0.0,1.0,44,1950,1700,250,0.8717948717948718,22,17,5,323.71151367095774,0.4305739076814658,0.2651097952560162,0.1840890746210869,130188.40889970562,-371.30261853253455,129817.1062811731,827,1,174.4318181818182,42,2,17,36.605306051398905,0.6121031746031746,44.86434108527132,1020.5426356589154,24.29863418235513,0
4039,4,0,0,44,0.0,0.0,1.0,44,1300,800,500,0.6153846153846154,18,8,10,323.82183106199585,0.43063997533474274,0.26765279527762953,0.1843859009949764,130237.85848957392,-365.22763806261685,129872.6308515113,828,2,175.4318181818182,42,2,18,36.55247294475034,0.6125992063492063,44.815891472868216,1020.7364341085269,24.303248431155403,0
4040,4,0,0,44,0.0,0.0,1.0,44,1400,1000,400,0.7142857142857143,18,10,8,326.50050845063026,0.4307721106412967,0.27412990457466657,0.18641144346776528,130342.35161675354,-288.62414280099847,130053.72747395255,829,3,176.4318181818182,39,5,19,36.37842582202728,0.6183226495726496,44.71354166666667,1021.1458333333339,26.18322649572651,0
4041,4,1,0,45,0.022222222222222223,0.0,1.0,45,1150,900,250,0.782608695652174,14,9,5,323.1113040591677,0.43156565656565654,0.27983620851406643,0.1868329407216337,130833.79937743745,-545.2240936281271,130288.57528380932,830,0,173.48888888888888,40,5,16,35.96859375517366,0.6216145833333333,44.232723577235774,1023.0691056910575,25.57672764227644,0
4042,4,0,0,45,0.0,0.0,1.0,45,1300,800,500,0.6153846153846154,18,8,10,322.949619617883,0.43150252525252525,0.27953344147603776,0.1869913582479855,130885.78976014619,-546.0967967149065,130339.69296343128,831,1,174.48888888888888,40,5,16,35.92027510179761,0.6221354166666666,44.181910569105696,1023.2723577235781,25.581808943089452,0
4043,4,0,1,44,0.0,0.022222222222222223,0.9777777777777777,45,850,600,250,0.7058823529411765,11,6,5,322.6451834322659,0.43171296296296297,0.2758229635513192,0.18719368015724583,130963.79469892281,-549.0324872760702,130414.76221164674,832,2,175.48888888888888,40,5,17,35.849384432088954,0.6229166666666667,44.10569105691058,1023.5772357723595,25.589430894308986,0
4044,4,0,1,43,0.0,0.022727272727272728,0.9772727272727273,44,1050,600,450,0.5714285714285714,15,6,9,327.810474655064,0.4283826638477801,0.27433495257922735,0.1900140361938648,130928.0395507815,-216.08344184024668,130711.95610894125,833,3,180.3409090909091,39,5,18,35.75328668363022,0.624198717948718,44.140625000000014,1023.4375000000019,26.24198717948723,0
4045,4,0,0,43,0.0,0.0,1.0,43,1700,1300,400,0.7647058823529411,21,13,8,330.5122998139246,0.426702657807309,0.21193493021888243,0.17814141547815465,128069.20750070842,-134.31033871884102,127934.89716198957,834,4,184.4418604651163,41,2,17,38.58577134176221,0.5922256097560976,46.94940476190475,1012.2023809523794,24.687862950058033,8
4046,4,2,0,45,0.044444444444444446,0.0,1.0,45,1500,1100,400,0.7333333333333333,19,11,8,324.0599726430798,0.43223905723905726,0.1265470236344024,0.1740094545045539,127918.62643494869,-596.4471726190811,127322.1792623296,835,0,177.2,41,4,13,38.90267970971855,0.5907012195121951,47.09821428571427,1011.6071428571405,24.673344947735135,8
4047,4,1,0,46,0.021739130434782608,0.0,1.0,46,1300,1000,300,0.7692307692307693,16,10,6,320.40405481360824,0.4344202898550725,0.13311144897724514,0.17334419690472297,128219.87714356552,-983.3669926304094,127236.51015093511,836,0,174.32608695652175,41,5,14,38.6879836418846,0.59375,46.80059523809523,1012.7976190476172,24.702380952380906,0
4048,4,2,1,47,0.041666666666666664,0.020833333333333332,0.9791666666666666,48,1350,900,450,0.6666666666666666,18,9,9,309.36739222231796,0.4392453457446808,0.1465487076607257,0.16959029884637222,128744.48609855643,-1634.1308145374387,127110.355284019,837,0,168.02083333333334,43,5,14,38.433971727162444,0.596172480620155,46.28314393939393,1014.867424242423,23.601568005637745,0
4049,4,1,1,47,0.020833333333333332,0.020833333333333332,0.9791666666666666,48,1800,1400,400,0.7777777777777778,22,14,8,303.3345144349808,0.4411015070921986,0.1662147587799252,0.16741379740345094,129013.18587105605,-1773.1695816186696,127240.01628943738,838,0,168.45833333333334,44,4,15,38.314383582452315,0.5975378787878788,46.01851851851851,1015.9259259259244,23.089225589225553,0
4050,4,1,0,48,0.020833333333333332,0.0,1.0,48,1150,600,550,0.5217391304347826,17,6,11,301.6662187583981,0.4413970153664302,0.16837431693989036,0.16728763040238454,129201.38888888895,-1804.8611111111086,127396.52777777784,839,0,169.375,44,4,17,38.16598360655738,0.5994318181818181,45.833333333333336,1016.6666666666672,23.10606060606062,0
4051,4,3,2,49,0.058823529411764705,0.0392156862745098,0.9607843137254902,51,1850,1300,550,0.7027027027027027,24,13,11,290.0767105961622,0.4465849673202615,0.16614065145731316,0.16359657712872872,129864.12896050324,-2665.8881293403,127198.24083116294,840,0,160.35294117647058,47,4,14,37.790623403168134,0.6023936170212766,45.18229166666666,1019.2708333333314,21.686613475177264,0
4052,4,0,0,49,0.0,0.0,1.0,49,1200,700,500,0.5833333333333334,17,7,10,298.44908060798144,0.4430980725623583,0.15973958304966018,0.1671582518741559,129593.0651140118,-2064.613772710611,127528.45134130119,841,1,167.89795918367346,45,4,14,37.851299558165046,0.6020833333333333,45.44836956521737,1018.2065217391265,22.626811594202813,0
4053,4,0,2,47,0.0,0.04081632653061224,0.9591836734693877,49,1100,600,500,0.5454545454545454,16,6,10,298.6354188883452,0.4428854875283447,0.15466800217019339,0.16785370096138025,129731.44531249999,-2051.5190972222226,127679.92621527777,842,2,168.89795918367346,45,4,14,37.70662917518745,0.6034722222222222,45.3125,1018.7499999999999,22.638888888888886,0
4054,4,0,0,47,0.0,0.0,1.0,47,1250,700,550,0.56,18,7,11,306.0855282211595,0.4382130743139068,0.1525637397411823,0.17130273367546492,129562.67329724783,-1468.548141213287,128094.12515603454,843,3,176.85106382978722,43,4,14,37.687676340185405,0.6044089147286822,45.47821969696969,1018.0871212121195,23.67644467935162,0
4055,4,0,1,46,0.0,0.02127659574468085,0.9787234042553191,47,1150,600,550,0.5217391304347826,17,6,11,308.15910831284043,0.43796253469010177,0.15585694817229356,0.1731001320167741,129707.32829896979,-1405.901073949723,128301.42722502007,844,4,177.85106382978722,43,4,14,37.48847649592513,0.6058624031007752,45.33617424242424,1018.6553030303029,23.689658210007043,0
4056,4,0,4,42,0.0,0.08695652173913043,0.9130434782608696,46,1350,1100,250,0.8148148148148148,16,11,5,317.44328517448696,0.43727858293075683,0.15692669791067737,0.1781444938851592,129669.7550947209,-967.4413909921266,128702.31370372877,845,5,181.54347826086956,42,4,14,37.290100846731995,0.6068948412698413,45.373062015503876,1018.5077519379847,24.25018456995202,0
4057,4,1,1,42,0.023255813953488372,0.023255813953488372,0.9767441860465116,43,1700,1200,500,0.7058823529411765,22,12,10,326.152868213164,0.43332410483573275,0.1673086983402292,0.18332040523705428,129731.44531250001,-137.54340277777743,129593.90190972223,846,0,178.7906976744186,39,4,16,37.005794137695965,0.6121794871794872,45.3125,1018.7500000000001,26.121794871794876,0
4058,4,0,0,42,0.0,0.0,1.0,42,1200,900,300,0.75,15,9,6,331.8548565106795,0.4331808943089431,0.16122035353610986,0.18697953197019335,129826.6985010776,216.72408046607626,130043.42258154368,847,1,178.02380952380952,38,4,16,36.763986441625605,0.6148574561403508,45.2190170940171,1019.1239316239323,26.819050832208745,0
4059,4,0,0,42,0.0,0.0,1.0,42,1300,1000,300,0.7692307692307693,16,10,6,334.562675051677,0.43305991095625246,0.1671805233355783,0.1892946492808687,129990.07100819996,297.9651773321598,130288.03618553211,848,2,179.02380952380952,38,4,17,36.52937838309761,0.6165021929824561,45.05876068376068,1019.7649572649568,26.83591992802518,0
4060,4,0,0,42,0.0,0.0,1.0,42,1400,1100,300,0.7857142857142857,17,11,6,334.64669452791634,0.4324670925280681,0.16874551328068965,0.1902705491744435,130180.80210387881,312.91502301115673,130493.71712688997,849,3,180.02380952380952,38,4,17,36.33401381909549,0.618421052631579,44.87179487179486,1020.5128205128188,26.85560053981102,0
4061,4,0,0,42,0.0,0.0,1.0,42,1250,900,350,0.72,16,9,7,333.0279050395672,0.4323824041811846,0.16783284742468463,0.18974845752254382,130262.58680555536,276.2152777777578,130538.80208333311,850,4,181.02380952380952,38,4,18,36.29251700680271,0.6192434210526316,44.79166666666666,1020.8333333333318,26.86403508771926,0
4062,4,0,0,42,0.0,0.0,1.0,42,1350,700,650,0.5185185185185185,20,7,13,357.3996856871892,0.4314508323654665,0.16595593461265157,0.19792203781303355,129147.08547921685,870.4880515377295,130017.57353075458,851,5,182.02380952380952,38,4,14,36.80475264522458,0.6080043859649122,45.886752136752136,1016.4529914529912,26.748762932973452,8
4063,4,0,0,42,0.0,0.0,1.0,42,1500,1100,400,0.7333333333333333,19,11,8,363.95260133245205,0.4307128339140534,0.17232447696059605,0.20225646359247984,129285.00987082548,1010.7345454299574,130295.74441625543,852,6,183.02380952380952,37,5,15,36.49764150943396,0.611204954954955,45.75109649122806,1016.9956140350864,27.486367946894227,0
4064,4,0,0,42,0.0,0.0,1.0,42,1100,700,400,0.6363636363636364,15,7,8,368.0752560542131,0.4310152922957801,0.16066381929835738,0.19500157182446637,127376.05003652317,996.494017495372,128372.54405401854,853,7,184.02380952380952,36,6,14,38.346208909712935,0.59375,47.635135135135144,1009.4594594594608,28.04054054054058,8
4065,4,0,0,42,0.0,0.0,1.0,42,800,600,200,0.75,10,6,4,367.23818696031714,0.43091850561362754,0.15806996304320142,0.19510616473105022,127489.75326678038,963.8211691421288,128453.5744359225,854,8,185.02380952380952,36,6,14,38.250585414808214,0.5949074074074074,47.52252252252253,1009.9099099099107,28.053053053053073,0
4066,4,0,0,42,0.0,0.0,1.0,42,1250,900,350,0.72,16,9,7,368.42188132429635,0.4309427022841657,0.15369267831937816,0.1965646826994195,127660.40322417018,1006.5771852934141,128666.98040946359,855,9,186.02380952380952,36,6,14,38.0455575365872,0.5966435185185186,47.35360360360361,1010.585585585586,28.071821821821835,0
4067,4,0,0,42,0.0,0.0,1.0,42,1300,700,600,0.5384615384615384,19,7,12,368.0577448816826,0.430991095625242,0.15789691147608775,0.19683830671746577,127756.25673284073,1004.3359495229162,128760.59268236365,856,10,187.02380952380952,37,5,15,37.95643528561101,0.5957207207207207,47.258771929824555,1010.9649122807006,27.3233760075865,0
4068,4,0,1,41,0.0,0.023809523809523808,0.9761904761904762,42,1100,800,300,0.7272727272727273,14,8,6,368.2694183322247,0.4312088656600852,0.15403262031257237,0.19735902645427714,127839.40882050253,1015.8689452523919,128855.27776575493,857,11,188.02380952380952,37,5,15,37.86582005132098,0.5965653153153153,47.1765350877193,1011.2938596491233,27.332266477003333,0
4069,4,2,1,42,0.046511627906976744,0.023255813953488372,0.9767441860465116,43,1500,1300,200,0.8666666666666667,17,13,4,361.2689578353186,0.43438538205980065,0.16129649353200892,0.19578165931846567,128287.0962178396,669.9564981406498,128957.05271598024,858,0,184.13953488372093,36,7,19,37.58452830887803,0.6030092592592593,46.73423423423424,1013.0630630630642,28.140640640640672,0
4070,4,0,1,41,0.0,0.023809523809523808,0.9761904761904762,42,700,600,100,0.8571428571428571,8,6,2,361.9459259259258,0.43204365079365076,0.167269841269841,0.19670974235104674,128401.20525931349,894.8586255174218,129296.0638848309,859,1,188.38095238095238,36,6,11,37.450694444444444,0.6041666666666667,46.62162162162163,1013.5135135135145,28.15315315315318,0
4071,4,1,2,40,0.023809523809523808,0.047619047619047616,0.9523809523809523,42,1200,700,500,0.5833333333333334,17,7,10,357.91801192656806,0.4318742740998838,0.1869721473495054,0.19591988380670594,128686.69979100731,811.8575501176921,129498.55734112501,860,0,188.52380952380952,36,6,13,37.261145024047345,0.6070601851851851,46.340090090090094,1014.6396396396403,28.184434434434454,0
4072,4,0,1,39,0.0,0.025,0.975,40,1100,900,200,0.8181818181818182,13,9,4,378.99682402199284,0.4246394230769231,0.19144157369348225,0.20620817613720566,128446.04768990925,1736.128826530605,130182.17651643985,861,1,198.85,34,6,13,36.972744176942626,0.6087622549019608,46.57738095238095,1013.6904761904758,29.814425770308112,0
4073,4,1,1,39,0.025,0.025,0.975,40,950,600,350,0.631578947368421,13,6,7,374.2110222473944,0.4278712606837607,0.19915532613796305,0.2049983774830842,128717.71541950115,1633.5175736961462,130351.23299319729,862,0,198.1,34,6,15,36.81614656655716,0.6115196078431373,46.30952380952381,1014.7619047619048,29.84593837535014,0
4074,4,0,1,38,0.0,0.02564102564102564,0.9743589743589743,39,650,400,250,0.6153846153846154,9,4,5,376.0783068954461,0.42628205128205127,0.20756630972113843,0.20654870568440545,128819.2451801482,1889.224724579889,130708.46990472809,863,1,202.5897435897436,35,4,17,36.66498023790522,0.6104166666666666,46.20949074074073,1015.162037037036,29.0046296296296,0
4075,4,1,0,39,0.02564102564102564,0.0,1.0,39,1600,1000,600,0.625,22,10,12,366.85178360801444,0.42819388214125054,0.20410861982135642,0.20391848306516475,129294.84941188476,1688.1071563576725,130982.95656824243,864,0,201.4102564102564,33,6,19,36.41390026910872,0.6196338383838385,45.741421568627445,1017.0343137254895,30.819221628045135,0
4076,4,0,0,39,0.0,0.0,1.0,39,1050,700,350,0.6666666666666666,14,7,7,407.5635908003348,0.4288686459739091,0.27041737605117855,0.2088238192038832,126012.14161820244,2641.219701531746,128653.36131973419,865,1,202.4102564102564,32,7,16,38.75964118041583,0.5885416666666667,48.989898989899004,1004.0404040404059,31.376262626262683,8
4077,4,1,0,40,0.025,0.0,1.0,40,1100,600,500,0.5454545454545454,16,6,10,398.8481436675357,0.4301682692307693,0.26757679180887384,0.20605479664033166,126351.67363514048,2079.0260957324317,128430.69973087292,866,0,198.325,33,7,15,38.62699089874858,0.5896464646464646,48.65196078431374,1005.3921568627463,30.466428995840797,0
4078,4,4,0,44,0.09090909090909091,0.0,1.0,44,1000,700,300,0.7,13,7,6,366.3840723324997,0.4385240486257928,0.27176901924839614,0.194987816055979,127559.26354595332,551.4617478557584,128110.72529380908,867,0,181.20454545454547,35,9,15,38.20080965475099,0.5976190476190476,47.4537037037037,1010.1851851851849,28.862433862433853,0
4079,4,1,0,45,0.022222222222222223,0.0,1.0,45,1650,1500,150,0.9090909090909091,18,15,3,360.89852454080045,0.4409090909090909,0.27947244805781324,0.19367590976666024,127894.8585742731,231.41315116192118,128126.27172543501,868,0,178.15555555555557,37,8,17,37.99537037037035,0.5971283783783784,47.1217105263158,1011.5131578947388,27.33819345661456,0
4080,4,2,2,45,0.0425531914893617,0.0425531914893617,0.9574468085106383,47,1200,1000,200,0.8333333333333334,14,10,4,343.6779067495147,0.4449198273203823,0.2792656873140733,0.18735479683857814,128523.41666894962,-565.6247738487534,127957.79189510086,869,0,171.53191489361703,38,9,13,37.78887015769326,0.6016995614035088,46.50106837606838,1013.9957264957274,26.684098065677034,0
4081,4,0,1,44,0.0,0.022222222222222223,0.9777777777777777,45,1050,700,350,0.6666666666666666,14,7,7,356.553759371881,0.44252946127946124,0.2781161245708925,0.19350245638288216,128344.1443977762,152.31743567892943,128496.46183345512,870,1,180.0888888888889,36,9,21,37.64563421501076,0.603587962962963,46.67792792792793,1013.2882882882886,28.146896896896905,0
4082,4,0,0,44,0.0,0.0,1.0,44,1450,1100,350,0.7586206896551724,18,11,7,370.0611951321877,0.4424991190979563,0.2779496656837912,0.20100842584227235,128379.0134173523,701.618227023291,129080.6316443756,871,2,183.95454545454547,35,9,16,37.26777828536622,0.605952380952381,46.643518518518505,1013.4259259259239,28.9550264550264,0
4083,4,0,0,44,0.0,0.0,1.0,44,1050,800,250,0.7619047619047619,13,8,5,368.6037557754928,0.44286249119097953,0.2762275685269182,0.2006588127307356,128466.99948827563,670.6837009173212,129137.68318919295,872,3,184.95454545454547,35,9,16,37.21469821516915,0.606845238095238,46.55671296296295,1013.773148148146,28.964947089947028,0
4084,4,0,1,43,0.0,0.022727272727272728,0.9772727272727273,44,900,500,400,0.5555555555555556,13,5,8,370.1000580362976,0.4424440627202255,0.27600070552592815,0.20191884859987771,128555.01570001697,715.643754286674,129270.65945430365,873,4,185.95454545454547,35,9,16,37.08675720916077,0.6077380952380953,46.4699074074074,1014.120370370369,28.974867724867686,0
4085,4,0,1,42,0.0,0.023255813953488372,0.9767441860465116,43,950,600,350,0.631578947368421,13,6,7,369.47339235380815,0.4425526024363234,0.2626389139503045,0.2018743647499233,128613.70991940991,903.8687414265855,129517.5786608365,874,5,185.1860465116279,35,8,17,37.042636543435265,0.6083333333333334,46.412037037037024,1014.3518518518499,28.981481481481428,0
4086,4,1,0,43,0.023255813953488372,0.0,1.0,43,1350,1000,350,0.7407407407407407,17,10,7,378.92199858816497,0.44068383167220376,0.28361314743809585,0.2087658830340048,128943.91593874272,1171.9372666585425,130115.85320540126,875,0,186.02325581395348,36,7,18,36.46537864508259,0.6096643518518519,46.08671171171171,1015.6531531531525,28.21258758758757,0
4087,4,0,2,41,0.0,0.046511627906976744,0.9534883720930233,43,1000,600,400,0.6,14,6,8,377.3992068392595,0.440453119232189,0.2796622082981892,0.20810870548564844,128978.53185595541,1135.2791243459267,130113.81098030134,876,1,187.02325581395348,37,6,18,36.468678036845134,0.6081081081081081,46.052631578947356,1015.7894736842084,27.453769559032658,0
4088,4,0,0,41,0.0,0.0,1.0,41,1150,800,350,0.6956521739130435,15,8,7,394.7873891680762,0.4375,0.2899169368191119,0.21586472027811507,128643.06205257612,1957.3317204646544,130600.39377304078,877,2,196.70731707317074,35,6,18,36.37062654497052,0.6086309523809523,46.38310185185184,1014.4675925925911,28.98478835978832,0
4089,4,0,0,41,0.0,0.0,1.0,41,1850,1500,350,0.8108108108108109,22,15,7,397.8375424858422,0.4385670731707317,0.2913032657389576,0.21871361482026527,128858.14868922968,2052.921840759671,130911.07052998935,878,3,197.70731707317074,36,5,18,36.072907423839084,0.6087962962962963,46.17117117117117,1015.3153153153147,28.203203203203188,0
4090,4,0,0,41,0.0,0.0,1.0,41,1750,1400,350,0.8,21,14,7,343.3066615673694,0.4377286585365854,0.17049327791656044,0.1868468299534135,128458.27880245114,620.11656927198,129078.39537172312,879,4,198.70731707317074,36,5,15,37.86473376286751,0.6047453703703703,46.56531531531532,1013.7387387387391,28.15940940940942,8
4091,4,1,0,42,0.023809523809523808,0.0,1.0,42,1800,1600,200,0.8888888888888888,20,16,4,336.8418241761043,0.4380081300813008,0.17987914862914844,0.18526300329685752,128875.73964497057,282.1478468113221,129157.88749178189,880,0,194.95238095238096,38,4,17,37.603246001683495,0.6052631578947368,46.15384615384616,1015.3846153846166,26.720647773279385,0
4092,4,1,1,42,0.023255813953488372,0.023255813953488372,0.9767441860465116,43,1150,900,250,0.782608695652174,14,9,5,327.8770064448284,0.4398532668881506,0.1783792764749288,0.18207312411562893,129255.70371283524,-123.59444627071576,129132.10926656453,881,0,191.3953488372093,38,5,18,37.444622469706516,0.6091008771929824,45.779914529914535,1016.8803418803428,26.760008996851127,0
4093,4,0,1,41,0.0,0.023809523809523808,0.9761904761904762,42,1050,700,350,0.6666666666666666,14,7,7,336.7597736139671,0.4403673054587689,0.17344885123860942,0.18714481128038005,129285.00987082557,307.59813115573763,129592.60800198131,882,1,195.57142857142858,37,5,18,37.18901617250674,0.611204954954955,45.75109649122807,1016.9956140350871,27.486367946894244,0
4094,4,0,1,40,0.0,0.024390243902439025,0.975609756097561,41,1500,1200,300,0.8,18,12,6,340.4857281316916,0.44057418699186995,0.16480959630313463,0.18991537280234355,129430.46932067197,613.845517815108,130044.31483848707,883,2,196.4390243902439,36,5,12,36.94642725394717,0.6145833333333333,45.608108108108105,1017.567567567567,28.26576576576575,0
4095,4,0,0,40,0.0,0.0,1.0,40,1250,800,450,0.64,17,8,9,339.5653041587583,0.43935630341880344,0.14155607166556017,0.1902323098019513,129602.41280131495,801.6965445175001,130404.10934583245,884,3,188.875,36,4,13,36.79518727420185,0.6163194444444444,45.43918918918919,1018.2432432432441,28.284534534534558,0
4096,4,0,1,39,0.0,0.025,0.975,40,1600,1500,100,0.9375,17,15,2,340.38472574097284,0.43935630341880344,0.13945856353591246,0.19181081992252808,129831.84831791231,838.5556164272225,130670.40393433954,885,4,189.875,36,4,15,36.54143646408841,0.6186342592592593,45.213963963963955,1019.1441441441426,28.309559559559517,0
4097,4,2,0,41,0.04878048780487805,0.0,1.0,41,1400,1000,400,0.7142857142857143,18,10,8,332.8519649203758,0.4403455284552846,0.14054861666295326,0.18896812285442902,130122.70752779677,462.3197762772875,130585.02730407406,886,0,186.09756097560975,37,4,17,36.43863066451728,0.6196509009009009,44.928728070175424,1020.2850877192963,27.57527264106206,0
4098,4,0,0,41,0.0,0.0,1.0,41,1450,1100,350,0.7586206896551724,18,11,7,330.4512395268712,0.4399390243902439,0.1346651713186664,0.18800978835673057,130206.62607725435,405.3881963680907,130612.01427362244,887,1,187.09756097560975,37,4,18,36.41491190373871,0.6204954954954955,44.846491228070164,1020.6140350877178,27.58416311047886,0
4099,4,1,0,42,0.023809523809523808,0.0,1.0,42,1050,600,450,0.5714285714285714,15,6,9,325.3044279258025,0.4401253387533875,0.14896323401289435,0.18665488021057566,130535.38795976678,92.74794086491005,130628.13590063169,888,0,183.61904761904762,38,4,12,36.21384387523958,0.621984649122807,44.52457264957264,1021.9017094017079,26.892150247413365,0
4100,4,0,0,42,0.0,0.0,1.0,42,1100,700,400,0.6363636363636364,15,7,8,325.89943745457435,0.43993176538908246,0.15520604730553567,0.18752445682518465,130644.58832137109,115.39956808385637,130759.98788945495,889,1,184.61904761904762,38,4,12,36.08832340544118,0.6230811403508771,44.41773504273504,1022.3290598290592,26.903396311291033,0
4101,4,0,0,42,0.0,0.0,1.0,42,1300,1100,200,0.8461538461538461,15,11,4,326.69399886835424,0.43960511033681765,0.15418376227775732,0.18878063000389203,130808.4744708342,146.8687221491679,130955.34319298338,890,2,185.61904761904762,38,4,13,35.90252393385553,0.6247258771929824,44.25747863247863,1022.9700854700851,26.920265407107504,0
4102,4,0,4,38,0.0,0.09523809523809523,0.9047619047619048,42,1650,800,850,0.48484848484848486,25,8,17,328.7167507115117,0.43947202864885787,0.15640222686151706,0.19062387843924247,130945.12473518887,208.7711848929839,131153.89592008185,891,3,186.61904761904762,38,4,14,35.71285664578984,0.6260964912280702,44.123931623931625,1023.5042735042739,26.934322986954577,0
4103,4,1,1,38,0.02564102564102564,0.02564102564102564,0.9743589743589743,39,1100,700,400,0.6363636363636364,15,7,8,351.3949792802002,0.4358974358974359,0.17341812585300653,0.2017436714593085,130558.13426997582,1375.4945773319366,131933.62884730776,892,0,200.84615384615384,35,4,15,35.52425443563608,0.6279761904761905,44.5023148148148,1021.9907407407394,29.19973544973541,0
4104,4,1,0,39,0.02564102564102564,0.0,1.0,39,1050,800,250,0.7619047619047619,13,8,5,360.1694036444186,0.43437921727395407,0.19886155935035799,0.2080507966934226,130794.81336805536,1621.6579861110877,132416.47135416645,893,0,201.82051282051282,35,4,16,35.06025118805158,0.6303571428571428,44.27083333333332,1022.916666666665,29.22619047619043,0
4105,4,1,0,40,0.025,0.0,1.0,40,1300,1000,300,0.7692307692307693,16,10,6,352.8827427963106,0.43517628205128206,0.2033534953431113,0.20563179666003326,131131.51552641173,1254.8097731994183,132386.32529961114,894,0,197.75,37,3,18,34.906037005317046,0.6297860360360361,43.94188596491227,1024.232456140349,27.68195827406349,0
4106,4,0,0,40,0.0,0.0,1.0,40,1800,1400,400,0.7777777777777778,22,14,8,354.81434867001315,0.4344150641025641,0.20598244863013715,0.2072115796232875,131215.75869498303,1311.4467913203985,132527.20548630343,895,1,198.75,37,3,19,34.77142194634703,0.6306306306306306,43.859649122807014,1024.5614035087715,27.69084874348031,0
4107,4,1,1,40,0.024390243902439025,0.024390243902439025,0.975609756097561,41,1300,1100,200,0.8461538461538461,15,11,4,346.8377143126577,0.43630589430894307,0.2086140848237592,0.20453323075097884,131587.96623904307,928.0300717212306,132515.9963107643,896,0,194.8780487804878,36,5,16,34.600117074598465,0.6362847222222222,43.49662162162162,1026.0135135135133,28.50037537537537,0
4108,4,0,1,39,0.0,0.025,0.975,40,1150,900,250,0.782608695652174,14,9,5,356.09499016017406,0.4343616452991453,0.2127481949458483,0.20986874951993242,131565.50068587108,1369.963134430729,132935.4638203018,897,1,200.025,35,5,16,34.38534145607702,0.638095238095238,43.51851851851852,1025.925925925926,29.312169312169317,0
4109,4,0,0,39,0.0,0.0,1.0,39,1700,1200,500,0.7058823529411765,22,12,10,364.44776776433827,0.43390125955915426,0.21588559562802523,0.21500173239978304,131602.8220663265,1792.4709467120124,133395.29301303852,898,2,203.5897435897436,34,5,16,34.133406814402285,0.640625,43.482142857142854,1026.0714285714282,30.178571428571416,0
4110,4,0,0,39,0.0,0.0,1.0,39,1550,1300,250,0.8387096774193549,18,13,5,365.8922246584585,0.43277665317138997,0.2192390942390945,0.21672077922077923,131755.55555555547,1841.6666666666574,133597.22222222213,899,3,204.5897435897436,34,5,17,33.94209956709957,0.642156862745098,43.33333333333333,1026.666666666666,30.19607843137253,0
4111,4,0,0,39,0.0,0.0,1.0,39,900,500,400,0.5555555555555556,13,5,8,364.89642781993655,0.43266419253261357,0.21559502157555,0.21682688562192926,131877.806122449,1824.3480725623601,133702.15419501136,900,4,205.5897435897436,34,5,17,33.84426672848092,0.6433823529411764,43.214285714285715,1027.1428571428573,30.21008403361345,0
4112,4,0,0,39,0.0,0.0,1.0,39,1000,800,200,0.8,12,8,4,364.6701191913199,0.43255173189383717,0.21377425201295464,0.2170415950773165,131938.95266439908,1822.8387188208626,133761.79138321994,901,5,206.5897435897436,34,5,17,33.788383545770586,0.6439950980392157,43.154761904761905,1027.3809523809523,30.21708683473389,0
4113,4,0,0,39,0.0,0.0,1.0,39,1450,1100,350,0.7586206896551724,18,11,7,369.29023254550486,0.43106162843004947,0.21939759175238738,0.22107644379610952,132159.8776148834,1961.0703875171505,134120.94800240055,902,6,207.5897435897436,35,4,19,33.446833258292074,0.644047619047619,42.93981481481482,1028.2407407407406,29.378306878306876,0
4114,4,1,0,40,0.025,0.0,1.0,40,850,600,250,0.7058823529411765,11,6,5,359.3658292310572,0.4323717948717949,0.21693838542837907,0.21683851324158898,132457.56842635456,1520.3591177983524,133977.92754415292,903,0,203.375,35,5,20,33.402199985008615,0.6470238095238094,42.65046296296296,1029.3981481481478,29.41137566137565,0
4115,4,0,0,40,0.0,0.0,1.0,40,1150,700,450,0.6086956521739131,16,7,9,357.833595255169,0.4316907051282051,0.22087032250814675,0.21677067148915916,132606.53941883138,1490.2149509173403,134096.75436974873,904,1,204.375,35,5,20,33.291779038843316,0.6485119047619048,42.50578703703703,1029.9768518518513,29.427910052910036,0
4116,4,0,0,40,0.0,0.0,1.0,40,1000,600,400,0.6,14,6,8,359.667540921673,0.43062232905982906,0.21994609164420464,0.2187486191507223,132755.59413580244,1549.5756172839424,134305.16975308637,905,2,205.375,35,5,17,33.09467654986523,0.65,42.36111111111111,1030.5555555555552,29.444444444444436,0
4117,4,0,2,38,0.0,0.05,0.95,40,1450,1100,350,0.7586206896551724,18,11,7,361.55494337312524,0.4302083333333333,0.2220707070707073,0.2209502431724654,132934.5703125,1612.6302083333335,134547.20052083334,906,3,206.375,35,5,17,32.866161616161605,0.6517857142857143,42.1875,1031.25,29.464285714285715,0
4118,4,0,0,38,0.0,0.0,1.0,38,1200,1000,200,0.8333333333333334,14,10,4,381.4409003794128,0.4258386676149834,0.24332715709349473,0.23173085913223315,132713.49961553267,2524.471357170342,135237.970972703,907,11,217.3421052631579,33,5,17,32.576117982873456,0.654040404040404,42.40196078431374,1030.3921568627466,31.224004753416562,0
4119,4,0,0,38,0.0,0.0,1.0,38,1050,900,150,0.8571428571428571,12,9,3,380.9134707008348,0.4251718824087245,0.2449989366094103,0.23258388552081466,132902.9775206652,2524.9068867743335,135427.88440743956,908,12,218.3421052631579,33,5,18,32.39887885270582,0.6559343434343434,42.21813725490197,1031.127450980393,31.24628639334524,0
4120,4,0,0,38,0.0,0.0,1.0,38,850,400,450,0.47058823529411764,13,4,9,375.0854479871899,0.4252311522048364,0.2405776414492664,0.22969013475682007,133011.31129535162,2378.1214569161193,135389.43275226775,909,13,219.3421052631579,34,4,18,32.440132717830366,0.654718137254902,42.11309523809525,1031.5476190476202,30.33963585434177,0
4121,4,0,1,37,0.0,0.02631578947368421,0.9736842105263158,38,1350,900,450,0.6666666666666666,18,9,9,372.481582102236,0.4253496917970602,0.22922445659761226,0.22922553572806884,133195.5800028346,2322.5800736961614,135518.16007653077,910,14,220.3421052631579,34,4,18,32.32206012378427,0.6565563725490196,41.93452380952382,1032.2619047619057,30.36064425770311,0
4122,4,0,0,37,0.0,0.0,1.0,37,1050,700,350,0.6666666666666666,14,7,7,382.73035638012925,0.42492492492492495,0.22777676144259695,0.235081862222981,133124.20590938587,2790.1349541041986,135914.34086349007,911,15,220.0810810810811,33,4,18,32.129373985670746,0.6581439393939394,42.00367647058824,1031.9852941176475,31.272281639928714,0
4123,4,0,0,37,0.0,0.0,1.0,37,900,500,400,0.5555555555555556,13,5,8,382.6143637001499,0.42520645645645644,0.22924206257539526,0.23560989764693474,133219.07439446385,2794.3062764321603,136013.380670896,912,16,221.0810810810811,33,4,19,32.036938113327,0.6590909090909092,41.91176470588236,1032.352941176472,31.283422459893092,0
4124,4,0,0,37,0.0,0.0,1.0,37,1000,700,300,0.7,13,7,6,384.0577963616657,0.4244557057057057,0.23461050039123132,0.23730491992200275,133345.6182718185,2842.4848615916953,136188.1031334102,913,17,222.0810810810811,33,4,19,31.87242920423984,0.6603535353535354,41.78921568627451,1032.8431372549019,31.298276886512177,0
4125,4,0,0,37,0.0,0.0,1.0,37,1100,900,200,0.8181818181818182,13,9,4,386.96670135275724,0.4239552052052052,0.23910200523103708,0.2399193548387097,133472.2222222223,2929.861111111121,136402.08333333343,914,18,223.0810810810811,33,4,19,31.670026881720418,0.6616161616161615,41.66666666666667,1033.3333333333342,31.31313131313134,0
4126,4,0,0,37,0.0,0.0,1.0,37,950,700,250,0.7368421052631579,12,7,5,386.2977900731273,0.4228603603603604,0.2386380517564104,0.24013819341903506,133570.09369260786,2919.5664026629906,136489.66009527084,915,19,224.0810810810811,32,5,19,31.58895199706854,0.6650390625,41.571969696969695,1033.7121212121208,32.303503787878775,0
4127,4,0,0,37,0.0,0.0,1.0,37,1000,700,300,0.7,13,7,6,388.71111213316266,0.4215778278278279,0.24045940008839706,0.24313731700909438,133798.5999515356,3001.8005178043127,136800.40046933992,916,20,225.0810810810811,32,5,18,31.297036449434547,0.6673177083333333,41.351010101010104,1034.59595959596,32.33112373737375,0
4128,4,0,0,37,0.0,0.0,1.0,37,850,500,350,0.5882352941176471,12,5,7,391.3042630577642,0.4214527027027027,0.24260688650099405,0.24541094447471273,133896.59098880223,3078.8613725640325,136975.45236136627,917,21,226.0810810810811,32,5,18,31.131562360213085,0.6682942708333333,41.256313131313135,1034.974747474748,32.342960858585876,0
4129,4,0,0,37,0.0,0.0,1.0,37,950,600,350,0.631578947368421,13,6,7,392.88706512856646,0.42082707707707706,0.23988505027402685,0.24728064628698193,134027.30150303544,3131.5186269258243,137158.82012996127,918,22,227.0810810810811,32,5,18,30.959385034345395,0.6695963541666667,41.130050505050505,1035.4797979797984,32.3587436868687,0
4130,4,0,0,37,0.0,0.0,1.0,37,1400,1100,300,0.7857142857142857,17,11,6,393.96593591833425,0.420482982982983,0.2361603436688764,0.2486228106364626,134125.37623711865,3168.1658759310294,137293.54211304968,919,23,228.0810810810811,32,5,18,30.833028603933048,0.6705729166666667,41.035353535353536,1035.8585858585857,32.3705808080808,0
4131,4,0,2,35,0.0,0.05405405405405406,0.9459459459459459,37,1000,800,200,0.8,12,8,4,389.1317461048719,0.4199512012012012,0.23461185079315894,0.24623008791693793,134223.48684126625,3046.1239605652527,137269.6108018315,920,24,229.0810810810811,32,5,18,30.859835100117785,0.6715494791666667,40.94065656565657,1036.2373737373741,32.38241792929294,0
4132,4,0,0,35,0.0,0.0,1.0,35,650,300,350,0.46153846153846156,10,3,7,405.88795795822335,0.41687675070028013,0.23443261490521938,0.2549876877809326,133958.77594230536,3874.450803561089,137833.22674586644,921,25,234.14285714285714,30,5,18,30.6917034536484,0.6743055555555555,41.19623655913978,1035.21505376344,34.50716845878133,0
4133,4,0,0,35,0.0,0.0,1.0,35,1050,700,350,0.6666666666666666,14,7,7,407.9147277603711,0.4158263305322129,0.23427493939121824,0.2573324075601706,134112.0931837293,3941.25959608289,138053.35277981218,922,26,235.14285714285714,31,4,18,30.485150848522935,0.6730510752688172,41.04817708333333,1035.807291666666,33.413138440860195,0
4134,4,0,0,35,0.0,0.0,1.0,35,1200,900,300,0.75,15,9,6,406.8483119113151,0.4154761904761905,0.2319023689877957,0.2578433569119483,134280.734592014,3926.378038194454,138207.11263020846,923,27,236.14285714285714,31,4,19,30.343383584589617,0.674731182795699,40.88541666666667,1036.4583333333342,33.43413978494626,0
4135,4,0,0,35,0.0,0.0,1.0,35,800,400,400,0.5,12,4,8,407.3719592038448,0.41509103641456585,0.2320506575742809,0.25892713072615925,134387.08422609954,3949.105958575671,138336.19018467522,924,28,237.14285714285714,32,3,19,30.223047572657887,0.6731770833333333,40.78282828282829,1036.8686868686882,32.402146464646506,0
4136,4,0,0,35,0.0,0.0,1.0,35,1300,800,500,0.6153846153846154,18,8,10,405.3160432896242,0.41453081232493,0.23384968445209364,0.258778704561837,134550.78125000003,3907.416972757881,138458.1982227579,925,29,238.14285714285714,29,6,19,30.112115127175365,0.6831896551724138,40.625,1037.5000000000002,35.77586206896552,0
4137,4,0,0,35,0.0,0.0,1.0,35,650,400,250,0.6153846153846154,9,4,5,408.17887943087885,0.41379551820728294,0.2391208791208792,0.2619001822957784,134730.96305941354,3998.8667052469073,138729.82976466045,926,30,239.14285714285714,29,6,19,29.857162764771456,0.6849856321839081,40.451388888888886,1038.1944444444441,35.79980842911876,0
4138,4,0,0,35,0.0,0.0,1.0,35,650,300,350,0.46153846153846156,10,3,7,408.2359234113239,0.41313025210084037,0.23990090406552156,0.2626510391506498,134829.82362484114,4008.475510174607,138838.29913501575,927,31,240.14285714285714,30,5,16,29.75658944825504,0.6829861111111111,40.356182795698935,1038.5752688172054,34.61917562724018,0
4139,4,0,0,35,0.0,0.0,1.0,35,1050,700,350,0.6666666666666666,14,7,7,403.62001628480886,0.41235994397759107,0.23669985775248925,0.26118774777660503,135039.2950955314,3900.9124971095102,138940.2075926409,928,32,241.14285714285714,30,5,18,29.6666882193198,0.6850694444444445,40.15456989247313,1039.3817204301085,34.646057347670286,0
4140,4,0,0,35,0.0,0.0,1.0,35,850,800,50,0.9411764705882353,9,8,1,403.5815708451279,0.4116946778711485,0.23281134584133545,0.2619217308773416,135144.09180252065,3908.332972019902,139052.42477454056,929,33,242.14285714285714,30,5,18,29.56281239227852,0.6861111111111111,40.05376344086022,1039.7849462365602,34.65949820788534,0
4141,4,0,0,35,0.0,0.0,1.0,35,750,500,250,0.6666666666666666,10,5,5,403.9153629923414,0.41046918767507007,0.22793650793650788,0.26315697891925294,135283.88397502605,3928.647820557295,139212.53179558335,930,34,243.14285714285714,30,5,18,29.414298018949186,0.6875,39.91935483870968,1040.3225806451617,34.677419354838726,0
4142,4,0,0,35,0.0,0.0,1.0,35,1250,900,350,0.72,16,9,7,402.2975951002534,0.4092086834733894,0.22942921476821931,0.2631724202317042,135430.30632866756,3896.657307942714,139326.96363661028,931,35,244.14285714285714,31,4,19,29.310003335835223,0.6861559139784946,39.778645833333336,1040.8854166666667,33.576948924731184,0
4143,4,0,0,35,0.0,0.0,1.0,35,950,800,150,0.8421052631578947,11,8,3,403.5811403463516,0.4077380952380953,0.22657092844639704,0.26501165521265374,135565.87219238284,3942.3658582899297,139508.23805067278,932,36,245.14285714285714,31,4,19,29.141139451529547,0.6875,39.6484375,1041.4062500000002,33.59375000000001,0
4144,4,0,0,35,0.0,0.0,1.0,35,1050,600,450,0.5714285714285714,15,6,9,403.9471776263506,0.40682773109243703,0.22276803564288605,0.26656250428588457,135742.20920138885,3966.570366753467,139708.77956814232,933,37,246.14285714285714,29,6,20,28.95550113288019,0.6950431034482758,39.479166666666664,1042.083333333333,35.933908045977,0
4145,4,0,0,35,0.0,0.0,1.0,35,650,500,150,0.7692307692307693,8,5,3,405.02867064861516,0.4066176470588236,0.2246883030360718,0.2678185174641282,135814.58574459873,4001.7602237654296,139816.34596836416,934,38,247.14285714285714,29,6,20,28.855068842993568,0.6957614942528736,39.40972222222222,1042.3611111111109,35.943486590038304,0
4146,4,0,0,35,0.0,0.0,1.0,35,1350,900,450,0.6666666666666666,18,9,9,404.21996396301637,0.40609243697478986,0.21997165313748268,0.2688218629234764,136018.9784404266,3996.317312695104,140015.29575312173,935,39,248.14285714285714,30,5,17,28.672207189795138,0.6947916666666667,39.21370967741935,1043.1451612903222,34.771505376344074,0
4147,4,0,0,35,0.0,0.0,1.0,35,1000,900,100,0.9,11,9,2,403.14580419998305,0.4044117647058823,0.2153407470772739,0.2693013972055887,136176.75781250003,3979.817708333332,140156.57552083337,936,40,249.14285714285714,31,4,20,28.54291417165668,0.6935483870967742,39.0625,1043.7500000000002,33.66935483870969,0
4148,4,0,1,34,0.0,0.02857142857142857,0.9714285714285714,35,950,500,450,0.5263157894736842,14,5,9,402.3965533772508,0.4038865546218487,0.2112104906816803,0.2693168251234389,136244.7187635634,3964.8810492621583,140209.59981282556,937,41,250.14285714285714,31,4,20,28.494740999417978,0.6942204301075269,38.997395833333336,1044.010416666667,33.677755376344095,0
4149,4,0,0,34,0.0,0.0,1.0,34,700,300,400,0.42857142857142855,11,3,8,413.9824144126914,0.4017751039809863,0.21586239286133613,0.27654025282767786,136176.75781250003,4474.956597222222,140651.71440972225,938,42,254.55882352941177,31,3,20,28.260146373918825,0.6935483870967742,39.0625,1043.7500000000002,33.66935483870969,0
4150,4,0,0,34,0.0,0.0,1.0,34,1100,700,400,0.6363636363636364,15,7,8,410.0062400077671,0.4000668449197861,0.21443236980656133,0.27546650396501743,136380.6915283203,4383.386908637152,140764.07843695747,939,43,255.55882352941177,31,3,20,28.16057924042217,0.6955645161290323,38.8671875,1044.53125,33.694556451612904,0
4151,4,0,0,34,0.0,0.0,1.0,34,850,400,450,0.47058823529411764,13,4,9,410.0062400077671,0.39982546048722517,0.21443236980656133,0.27546650396501743,136380.6915283203,4383.386908637152,140764.07843695747,940,44,256.55882352941177,31,3,20,28.16057924042217,0.6955645161290323,38.8671875,1044.53125,33.694556451612904,0
4152,4,0,0,34,0.0,0.0,1.0,34,1250,1100,150,0.88,14,11,3,409.3334305303134,0.39828431372549017,0.21730702995038786,0.2763430989795478,136550.75285169805,4378.957621256501,140929.71047295455,941,45,257.55882352941177,31,3,21,28.008725758897057,0.697244623655914,38.70442708333333,1045.182291666666,33.715557795698906,0
4153,4,0,0,34,0.0,0.0,1.0,34,750,500,250,0.6666666666666666,10,5,5,408.0399422686857,0.3980243612596554,0.21667411515608892,0.2760027545472011,136618.80705091683,4349.186028374561,140967.9930792914,942,46,258.55882352941177,31,3,22,27.97476335782787,0.6979166666666667,38.639322916666664,1045.442708333333,33.72395833333332,0
4154,4,0,0,34,0.0,0.0,1.0,34,900,600,300,0.6666666666666666,12,6,6,407.8547290748114,0.39763443256090314,0.21307596513075988,0.2761444750818494,136652.84050835497,4346.901448567698,140999.74195692266,943,47,259.55882352941177,31,3,22,27.945724366957236,0.698252688172043,38.60677083333333,1045.572916666666,33.728158602150515,0
4155,4,0,0,34,0.0,0.0,1.0,34,1100,700,400,0.6363636363636364,15,7,8,408.4239499636754,0.3970773915626857,0.2177120655509699,0.277343383823501,136756.06464620188,4370.907375067972,141126.97202126984,944,48,260.55882352941177,30,4,22,27.828107598732114,0.7020833333333334,38.50806451612903,1045.967741935484,34.865591397849464,0
4156,4,0,0,34,0.0,0.0,1.0,34,1400,1100,300,0.7857142857142857,17,11,6,408.3082925043178,0.39652035056446816,0.21393395570863194,0.2789390335108444,136967.0265348595,4384.954546768409,141351.98108162792,945,49,261.55882352941177,30,4,18,27.621287022770073,0.7041666666666666,38.306451612903224,1046.7741935483868,34.89247311827956,0
4157,4,0,0,34,0.0,0.0,1.0,34,850,600,250,0.7058823529411765,11,6,5,405.79237045798027,0.39572192513368987,0.2095249937826409,0.2779712302575026,137061.57260470933,4323.708089192729,141385.28069390205,946,50,262.55882352941177,31,3,18,27.593156760341547,0.7022849462365591,38.21614583333334,1047.1354166666679,33.77856182795703,0
4158,4,0,0,34,0.0,0.0,1.0,34,1250,800,450,0.64,17,8,9,405.4445144446577,0.39514631610219847,0.21068621357803496,0.27854834489387464,137163.85099622942,4322.4661933051275,141486.31718953454,947,51,263.55882352941177,31,3,18,27.500647400041434,0.7032930107526882,38.118489583333336,1047.526041666667,33.791162634408614,0
4159,4,0,0,34,0.0,0.0,1.0,34,1100,800,300,0.7272727272727273,14,8,6,392.2773822404438,0.3950906120023767,0.1310402796394905,0.2447650626186837,133707.78613620324,3691.638183593741,137399.424319797,948,52,264.55882352941177,31,3,18,31.296031096563024,0.669018817204301,41.43880208333333,1034.2447916666658,33.36273521505374,8
4160,4,0,0,34,0.0,0.0,1.0,34,1450,1300,150,0.896551724137931,16,13,3,389.26145258726257,0.39380941770647654,0.1260102430504162,0.2439944814797762,133876.17323133675,3622.566731770829,137498.7399631076,949,53,265.55882352941177,31,3,19,31.204915282670687,0.6706989247311828,41.276041666666664,1034.895833333333,33.38373655913978,0
4161,4,0,0,34,0.0,0.0,1.0,34,1200,700,500,0.5833333333333334,17,7,10,390.20124028364864,0.3925653594771242,0.1306906014008773,0.24570629168454935,134044.6662902832,3660.8790079752607,137705.54529825845,950,54,266.55882352941177,31,3,19,31.011489375078586,0.6723790322580645,41.11328125,1035.546875,33.40473790322581,0
4162,4,0,0,34,0.0,0.0,1.0,34,1100,800,300,0.7272727272727273,14,8,6,390.4870657778326,0.3922868389780154,0.1272241861290655,0.24611205397756597,134078.37761773012,3671.174452039941,137749.55206977006,951,55,267.55882352941177,31,3,19,30.970266532562228,0.6727150537634409,41.08072916666667,1035.6770833333342,33.40893817204304,0
4163,4,0,0,34,0.0,0.0,1.0,34,650,600,50,0.9230769230769231,7,6,1,395.1626760205337,0.3920825906120024,0.12865845093850004,0.24974657768827557,134179.5370313857,3804.548984103743,137984.08601548945,952,56,268.55882352941177,31,3,20,30.747690712580127,0.6737231182795699,40.98307291666667,1036.067708333334,33.421538978494645,0
4164,4,0,0,34,0.0,0.0,1.0,34,1050,800,250,0.7619047619047619,13,8,5,393.03938117007823,0.3909870766488413,0.13049485054006582,0.24955179847497305,134348.22082519528,3760.8283148871533,138109.04914008244,953,57,269.55882352941177,31,3,20,30.633530101314587,0.6754032258064516,40.8203125,1036.7187499999998,33.44254032258064,0
4165,4,0,0,34,0.0,0.0,1.0,34,650,400,250,0.6153846153846154,9,4,5,392.5840990469404,0.3909685086155674,0.12845070214447696,0.24949299127779634,134381.97029961488,3751.24494764541,138133.2152472603,954,58,270.55882352941177,31,3,21,30.61150006279039,0.675739247311828,40.78776041666667,1036.8489583333342,33.44674059139788,0
4166,4,0,0,34,0.0,0.0,1.0,34,850,600,250,0.7058823529411765,11,6,5,393.5650587290623,0.3903371954842543,0.12925745169412073,0.25104346060003524,134517.01058281798,3788.239034016933,138305.24961683492,955,59,271.55882352941177,31,3,21,30.450739508807157,0.6770833333333333,40.657552083333336,1037.369791666667,33.46354166666668,0
4167,4,0,0,34,0.0,0.0,1.0,34,950,700,250,0.7368421052631579,12,7,5,395.23810273469053,0.38935308972073673,0.12761827441139606,0.2528128153126391,134618.33530002163,3841.259087456588,138459.59438747822,956,60,272.55882352941177,31,3,21,30.305834378920952,0.6780913978494624,40.55989583333333,1037.760416666666,33.47614247311826,0
4168,4,0,0,34,0.0,0.0,1.0,34,900,700,200,0.7777777777777778,11,7,4,397.78158849141084,0.38903743315508016,0.13235478563681902,0.2551498475496394,134719.69816419802,3917.8031073676125,138637.50127156565,957,61,273.55882352941177,31,3,21,30.138305322128858,0.6790994623655914,40.46223958333333,1038.1510416666658,33.48874327956987,0
4169,4,0,0,34,0.0,0.0,1.0,34,900,600,300,0.6666666666666666,12,6,6,399.5839071879632,0.38909313725490197,0.13024367219304978,0.2570226809460639,134821.09917534716,3974.468315972212,138795.56749131938,958,62,274.55882352941177,31,3,17,29.98996990972918,0.6801075268817205,40.36458333333333,1038.541666666666,33.50134408602148,0
4170,4,0,0,34,0.0,0.0,1.0,34,1150,800,350,0.6956521739130435,15,8,7,377.41823448674813,0.3881275995246583,0.13230618458753196,0.21933773671613419,131028.00369262673,3092.912970648843,134120.91666327557,959,63,275.55882352941177,31,3,21,34.382683666115554,0.6421370967741935,44.042968749999986,1023.8281249999983,33.02671370967737,8
4171,4,0,1,33,0.0,0.029411764705882353,0.9705882352941176,34,1050,900,150,0.8571428571428571,12,9,3,378.9282670170378,0.38706922162804513,0.1350024307243558,0.22059739600954845,131094.66764661984,3135.0950453016267,134229.76269192147,960,64,276.55882352941177,31,3,21,34.276462174189426,0.6428091397849462,43.97786458333332,1024.0885416666654,33.03511424731179,0
4172,4,0,0,33,0.0,0.0,1.0,33,1150,900,250,0.782608695652174,14,9,5,386.6321360589024,0.3852588383838384,0.1337183862781135,0.22483691698448233,131052.73189097003,3533.8395334720735,134586.5714244421,961,65,280.7878787878788,30,3,21,34.12176205478253,0.6451388888888889,44.01881720430107,1023.9247311827954,34.13082437275985,0
4173,4,0,0,33,0.0,0.0,1.0,33,900,600,300,0.6666666666666666,12,6,6,387.4624475623344,0.3852193813131313,0.13622244229935543,0.2255214964077482,131087.14022213538,3558.268838883094,134645.40906101846,962,66,281.7878787878788,30,3,21,34.0656035350221,0.6454861111111111,43.98521505376343,1024.0591397849453,34.135304659498175,0
4174,4,0,0,33,0.0,0.0,1.0,33,1000,600,400,0.6,14,6,8,389.22852996506333,0.38419349747474746,0.13891306507699963,0.2277718757470151,131293.68505390795,3620.6496054457116,134914.33465935366,963,67,282.7878787878788,30,3,22,33.81092896174864,0.6475694444444444,43.78360215053763,1024.8655913978491,34.16218637992831,0
4175,4,0,0,33,0.0,0.0,1.0,33,1250,1100,150,0.88,14,11,3,394.6065881012645,0.382773042929293,0.11545843199948713,0.21863806782489856,129167.22896071813,3594.047902936772,132761.2768636549,964,68,283.7878787878788,30,3,22,35.838677332628144,0.6260416666666666,45.866935483870975,1016.5322580645171,33.88440860215057,8
4176,4,1,1,33,0.029411764705882353,0.029411764705882353,0.9705882352941176,34,1150,700,450,0.6086956521739131,16,7,9,384.282171442896,0.390857100415924,0.1021792623919211,0.21472006677406136,129499.41211276589,3152.8630574544313,132652.27517022032,965,0,276.4117647058824,31,3,15,35.76193445908488,0.6266801075268817,45.540364583333336,1017.8385416666671,32.83350134408604,0
4177,4,0,0,33,0.0,0.0,1.0,33,900,600,300,0.6666666666666666,12,6,6,387.06275495514734,0.38450915404040403,0.16551810944334333,0.1972176894295275,125782.470703125,3137.141927083334,128919.61263020833,966,70,285.7878787878788,31,2,20,39.51194184839044,0.5887096774193548,49.21875,1003.125,32.358870967741936,8
4178,4,2,2,33,0.05714285714285714,0.05714285714285714,0.9428571428571428,35,1050,800,250,0.7619047619047619,13,8,5,368.525193808505,0.3915266106442577,0.16075061444896943,0.19043258392583562,126361.00788503734,2313.7142514953994,128674.72213653274,967,0,270.4,32,3,18,39.379526141738886,0.5921223958333333,48.642676767676775,1005.4292929292938,31.41966540404043,0
4179,4,1,0,34,0.029411764705882353,0.0,1.0,34,900,700,200,0.7777777777777778,11,7,4,380.406580995696,0.3910056446821153,0.1728144296392593,0.19672454617206006,126392.74691358028,2816.126543209882,129208.87345679017,968,0,279.3235294117647,32,2,19,39.0481123388582,0.5924479166666667,48.611111111111114,1005.5555555555559,31.42361111111112,0
4180,4,0,0,34,0.0,0.0,1.0,34,750,500,250,0.6666666666666666,10,5,5,380.081130243867,0.39133986928104575,0.16424521615875265,0.197167086314006,126519.74288337925,2817.5533746556475,129337.2962580349,969,1,280.3235294117647,32,2,19,38.925232178714865,0.59375,48.484848484848484,1006.0606060606061,31.43939393939394,0
4181,4,1,1,34,0.02857142857142857,0.02857142857142857,0.9714285714285714,35,1000,600,400,0.6,14,6,8,354.57873278424233,0.3961484593837535,0.09183673469387754,0.1871084697615311,127215.61418685137,2021.5902537485772,129237.20444059995,970,0,273.2857142857143,33,2,24,38.85143343051507,0.5984848484848485,47.79411764705883,1008.823529411766,30.570409982174727,8
4182,4,3,3,34,0.08108108108108109,0.08108108108108109,0.9189189189189189,37,900,500,400,0.5555555555555556,13,5,8,345.16554224174166,0.40962837837837834,0.03715172194055083,0.18489953050681152,127822.46823827583,1423.9823120284523,129246.45055030429,971,0,250.51351351351352,35,2,19,38.46727042081567,0.600297619047619,47.19328703703703,1011.2268518518514,28.892195767195755,8
4183,4,2,1,35,0.05555555555555555,0.027777777777777776,0.9722222222222222,36,1300,1100,200,0.8461538461538461,15,11,4,348.2724575024269,0.4038690476190476,0.04385480007370557,0.1794942665589434,126253.12500000023,1601.4951185271213,127854.62011852735,972,0,258.3888888888889,34,2,22,39.999654505251534,0.5863970588235294,48.750000000000014,1005.0000000000018,29.558823529411818,7
4184,4,1,1,35,0.027777777777777776,0.027777777777777776,0.9722222222222222,36,1500,1000,500,0.6666666666666666,20,10,10,362.88965464678563,0.4089285714285715,0.03136030767609732,0.18621272059612434,126073.72448979596,2012.8436791383274,128086.56816893429,973,0,249.11111111111111,34,2,19,39.81744902797535,0.5845588235294117,48.92857142857143,1004.2857142857147,29.537815126050432,8
4185,4,4,2,37,0.10256410256410256,0.05128205128205128,0.9487179487179487,39,800,500,300,0.625,11,5,6,350.97193268283206,0.4216149347728295,0.08408996549700065,0.18477093810551226,127120.40323685177,1127.2345264804298,128247.6377633322,974,0,230.71794871794873,36,3,17,39.04010794714312,0.5911458333333333,47.888513513513516,1008.4459459459464,28.0123873873874,0
4186,4,2,3,36,0.05128205128205128,0.07692307692307693,0.9230769230769231,39,600,300,300,0.5,9,3,6,355.40631318994036,0.4221210076473234,0.11044079390809802,0.18825492055388904,127368.57133925824,1253.5188711911376,128622.09021044937,975,0,231.66666666666666,37,2,13,38.67360055036572,0.5917792792792793,47.64254385964912,1009.4298245614036,27.281887150308204,0
4187,4,1,0,37,0.02702702702702703,0.0,1.0,37,1050,800,250,0.7619047619047619,13,8,5,368.4487981464355,0.419700950950951,0.11696414174615177,0.19439465645546813,127208.74592764069,1973.981910150902,129182.7278377916,976,0,236.24324324324326,35,2,19,38.508681352302276,0.594047619047619,47.80092592592593,1008.796296296297,28.822751322751344,0
4188,4,0,1,36,0.0,0.02702702702702703,0.972972972972973,37,1100,800,300,0.7272727272727273,14,8,6,372.1232715472508,0.4198260760760761,0.1133535462509998,0.1966164049302384,127267.1320408951,2071.812307098769,129338.94434799386,977,1,237.24324324324326,35,2,19,38.35598761183758,0.5946428571428571,47.74305555555556,1009.027777777778,28.829365079365086,0
4189,4,2,0,38,0.05263157894736842,0.0,1.0,38,1100,900,200,0.8181818181818182,13,9,4,361.7169552556069,0.42512743006164055,0.09906534384088506,0.19326020180799602,127717.31190650137,1639.503439250092,129356.81534575147,677,0,206.23684210526315,36,2,17,38.156612076648834,0.5972222222222222,47.29729729729731,1010.8108108108131,28.078078078078143,0
4190,4,2,0,40,0.05,0.0,1.0,40,1150,800,350,0.6956521739130435,15,8,7,354.17008483334644,0.4307692307692308,0.12126330768419957,0.1925508077257282,128415.1066207356,1096.1578411498285,129511.26446188544,678,0,196.875,38,2,15,37.63351603949265,0.6006030701754386,46.60790598290598,1013.5683760683759,26.672852001799367,0
4191,4,1,1,40,0.024390243902439025,0.024390243902439025,0.975609756097561,41,1150,600,550,0.5217391304347826,17,6,11,351.21659235287433,0.43249491869918694,0.11960282608369055,0.19243824762101835,128725.26584201407,842.0898437500192,129567.35568576408,679,0,193.0487804878049,39,2,16,37.39179155546432,0.6020299145299146,46.30208333333334,1014.7916666666681,26.020299145299184,0
4192,4,0,3,37,0.0,0.075,0.925,40,1400,1100,300,0.7857142857142857,17,11,6,394.56203976680155,0.4305555555555556,0.10245376955903307,0.20246504668325643,126073.7244897958,1993.9634708049787,128067.68796060079,680,1,198.7,34,6,16,39.02224593014067,0.5845588235294117,48.92857142857142,1004.2857142857133,29.53781512605039,8
4193,4,1,1,37,0.02631578947368421,0.02631578947368421,0.9736842105263158,38,950,600,350,0.631578947368421,13,6,7,415.7565164898063,0.42555713608345186,0.12600743750248133,0.2133501504619303,126075.53597847157,2883.3451305989156,128958.88110907048,681,0,209.94736842105263,32,6,18,38.48823443131339,0.5891927083333333,48.926767676767675,1004.2929292929291,31.384154040404034,0
4194,4,1,0,38,0.02631578947368421,0.0,1.0,38,1600,1200,400,0.75,20,12,8,406.16201299822626,0.42696479374110957,0.1429052314759811,0.21168208442142847,126710.35640495869,2692.9866850321437,129403.34308999083,682,0,205.6315789473684,32,6,15,38.07217205919238,0.595703125,48.29545454545455,1006.818181818182,31.463068181818187,0
4195,4,2,1,39,0.05,0.025,0.975,40,1200,700,500,0.5833333333333334,17,7,10,390.36666980865294,0.43311965811965814,0.15124999999999988,0.20725653087778997,127462.99500192233,1952.0348975759443,129415.02989949827,683,0,196.3,33,7,15,37.69417475728154,0.601010101010101,47.549019607843135,1009.8039215686274,30.600118835412953,0
4196,4,2,0,41,0.04878048780487805,0.0,1.0,41,750,400,350,0.5333333333333333,11,4,7,386.1567467010288,0.4374237804878049,0.17445293380118843,0.20789857528216876,128024.02388038542,1687.468112244886,129711.4919926303,684,0,192.26829268292684,34,7,17,37.22405207230519,0.6044730392156863,46.99404761904761,1012.023809523809,29.76540616246497,0
4197,4,1,1,41,0.023809523809523808,0.023809523809523808,0.9761904761904762,42,1350,900,450,0.6666666666666666,18,9,9,378.1961085389277,0.43953252032520324,0.1678977113759721,0.20499674418256517,128295.24518140576,1304.2091836734505,129599.4543650792,685,0,188.66666666666666,34,8,18,37.14747356051703,0.6072303921568627,46.72619047619047,1013.095238095237,29.796918767506973,0
4198,4,1,0,42,0.023809523809523808,0.0,1.0,42,900,700,200,0.7777777777777778,11,7,4,378.9522377077564,0.43999225706542777,0.1698778195488726,0.20571692904135336,128355.55555555549,1328.1249999999945,129683.68055555549,686,0,189.54761904761904,34,8,19,37.06654331140353,0.607843137254902,46.666666666666664,1013.3333333333328,29.803921568627434,0
4199,4,0,2,40,0.0,0.047619047619047616,0.9523809523809523,42,1300,900,400,0.6923076923076923,17,9,8,380.343104605019,0.4396293070073558,0.1712910152318321,0.20709730682968971,128476.21882086188,1373.0087868480932,129849.22760770997,687,1,190.54761904761904,34,8,15,36.90773250352279,0.6090686274509804,46.54761904761906,1013.8095238095254,29.817927170868394,0
4200,4,2,1,41,0.047619047619047616,0.023809523809523808,0.9761904761904762,42,1300,800,500,0.6153846153846154,18,8,10,386.82218824906073,0.4387340301974448,0.1852764094143402,0.21222947085016058,128778.12500000013,1562.847222222237,130340.97222222236,688,0,191.42857142857142,34,8,18,36.434386973180075,0.6121323529411764,46.25000000000001,1015.000000000001,29.85294117647062,0
4201,4,0,0,41,0.0,0.0,1.0,41,1850,1400,450,0.7567567567567568,23,14,9,388.6716212910373,0.43816056910569107,0.18838690496609556,0.21422133545575797,128959.43877551034,1824.5748299319844,130784.01360544232,689,1,194.82926829268294,34,7,18,36.201945616502584,0.6139705882352942,46.07142857142858,1015.7142857142868,29.873949579831965,0
4202,4,1,1,41,0.023809523809523808,0.023809523809523808,0.9761904761904762,42,1250,800,450,0.64,17,8,9,376.76962539155943,0.4392058652729385,0.19053848362231984,0.21003055021034883,129407.39300679453,1351.3549972136666,130758.7480040082,690,0,191.16666666666666,35,7,19,36.04692772911691,0.6163690476190475,45.630787037037045,1017.4768518518529,29.070767195767225,0
4203,4,0,0,41,0.0,0.0,1.0,41,800,700,100,0.875,9,7,2,383.11748507149184,0.43788109756097565,0.19030786187047077,0.2127821558830095,129261.9118480727,1704.4997165533064,130966.41156462602,691,1,196.65853658536585,34,7,19,36.033959650355115,0.6170343137254901,45.77380952380953,1016.904761904763,29.908963585434204,0
4204,4,0,0,41,0.0,0.0,1.0,41,1800,1200,600,0.6666666666666666,24,12,12,384.31683078083665,0.4378556910569105,0.19267322324522063,0.21410506100736848,129383.00028344683,1744.8129251700843,131127.81320861692,692,2,197.65853658536585,34,7,19,35.87984632186598,0.6182598039215687,45.65476190476191,1017.3809523809534,29.9229691876751,0
4205,4,0,0,41,0.0,0.0,1.0,41,1200,700,500,0.5833333333333334,17,7,10,386.0331832892314,0.4378048780487805,0.1939465177784303,0.21555830724622088,129473.8538123584,1796.2407879818732,131270.09460034026,693,3,198.65853658536585,34,7,17,35.74345927398915,0.6191789215686274,45.5654761904762,1017.7380952380963,29.933473389355775,0
4206,4,0,0,41,0.0,0.0,1.0,41,1750,1400,350,0.8,21,14,7,383.611468827064,0.4369918699186992,0.1885840662566478,0.2156995368082796,129746.60572562364,1754.4571995464923,131501.06292517012,694,4,199.65853658536585,34,7,18,35.526943600529734,0.6219362745098039,45.29761904761905,1018.8095238095242,29.96498599439777,0
4207,4,0,1,40,0.0,0.024390243902439025,0.975609756097561,41,1000,600,400,0.6,14,6,8,404.39199540474533,0.4367378048780488,0.21555114166490186,0.22119567296785894,128657.32001133799,2232.4156746031917,130889.73568594118,695,5,200.65853658536585,34,7,16,36.1124149260737,0.610906862745098,46.36904761904763,1014.5238095238104,29.83893557422972,8
4208,4,2,0,42,0.047619047619047616,0.0,1.0,42,600,300,300,0.5,9,3,6,403.7295584064854,0.4377419667053813,0.2743122844223429,0.2250173159335433,129400.03289116759,2053.1154641218513,131453.14835528945,696,0,196.66666666666666,31,11,18,35.368675880897534,0.6256720430107527,45.638020833333336,1017.4479166666671,32.82090053763442,0
4209,4,1,0,43,0.023255813953488372,0.0,1.0,43,1450,1000,450,0.6896551724137931,19,10,9,390.050312794365,0.4392995570321152,0.2691186300043791,0.21986634950252207,129844.02101826352,1529.1402025303662,131373.16122079387,697,0,193.06976744186048,32,11,18,35.263617030062775,0.6276041666666667,45.20202020202021,1019.1919191919199,31.849747474747495,0
4210,4,0,0,43,0.0,0.0,1.0,43,1150,900,250,0.782608695652174,14,9,5,392.56017425198013,0.4395533407161314,0.27750466038574295,0.22205936165538598,129981.25908604867,1605.0931432622115,131586.35222931087,698,1,194.06976744186048,33,10,18,35.05976344990586,0.6265782828282829,45.067401960784316,1019.730392156863,30.900920974450393,0
4211,4,2,2,43,0.044444444444444446,0.044444444444444446,0.9555555555555556,45,1350,900,450,0.6666666666666666,18,9,9,379.95585515131035,0.44223484848484845,0.27334945523571763,0.21167553703540415,129383.00028344683,854.5306419136439,130237.53092536048,699,0,186.4,34,11,22,35.990765660347925,0.6182598039215687,45.65476190476191,1017.3809523809534,29.9229691876751,7
4212,4,0,0,43,0.0,0.0,1.0,43,1500,1000,500,0.6666666666666666,20,10,10,389.5791880887644,0.4420681063122924,0.27812879743455765,0.2169204919441037,129361.89746263162,1479.340596622827,130841.23805925445,700,1,188.34883720930233,32,11,22,35.76755202515411,0.6227213541666667,45.675505050505066,1017.297979797982,31.790561868686936,0
4213,4,0,0,43,0.0,0.0,1.0,43,1450,1100,350,0.7586206896551724,18,11,7,389.0077866251764,0.44160668143226284,0.27369483412390494,0.21802277964781472,129618.9184298799,1484.5537126313966,131103.47214251128,701,2,189.34883720930233,32,11,18,35.5197354825377,0.6253255208333333,45.422979797979814,1018.3080808080832,31.8221275252526,0
4214,4,1,0,44,0.022727272727272728,0.0,1.0,44,850,400,450,0.47058823529411764,13,4,9,388.2784229332415,0.4420917019027484,0.2980801772983832,0.22069586537645758,130168.77710796338,1308.345498125735,131477.1226060891,702,0,186.02272727272728,33,11,19,34.97795824826869,0.6284722222222222,44.883578431372555,1020.4656862745105,30.923202614379107,0
4215,4,0,1,43,0.0,0.022727272727272728,0.9772727272727273,44,1250,700,550,0.56,18,7,11,385.67263640149906,0.4421467582804792,0.2954545454545452,0.21974371143806382,130262.58680555575,1247.7430555555813,131510.32986111133,703,1,187.02272727272728,33,11,20,34.94897959183674,0.6294191919191919,44.79166666666668,1020.833333333335,30.934343434343482,0
4216,4,0,0,43,0.0,0.0,1.0,43,1600,1200,400,0.75,20,12,8,392.64120518390075,0.4400839793281654,0.3060137803446268,0.2244808756168017,130395.5417209202,1639.7325303819493,132035.27425130215,704,2,192.2325581395349,31,12,21,34.635815060343354,0.635752688172043,44.661458333333336,1021.3541666666672,32.94690860215056,0
4217,4,0,0,43,0.0,0.0,1.0,43,1400,1000,400,0.7142857142857143,18,10,8,397.9950827448015,0.43980712440014763,0.3110772595659428,0.22812764165803212,130495.30241224515,1787.2977362738907,132282.60014851904,705,3,193.2325581395349,31,12,19,34.39756701074721,0.636760752688172,44.56380208333334,1021.7447916666678,32.95950940860219,0
4218,4,0,0,43,0.0,0.0,1.0,43,1100,600,500,0.5454545454545454,16,6,10,363.85379128844386,0.4384920634920635,0.2137651777793499,0.20270498698507428,129383.00028344661,815.2990362811652,130198.29931972778,706,4,194.2325581395349,34,9,21,36.40031398705046,0.6182598039215687,45.6547619047619,1017.3809523809516,29.922969187675047,8
4219,4,0,0,43,0.0,0.0,1.0,43,1100,800,300,0.7272727272727273,14,8,6,362.90140556068525,0.4388612033960871,0.2122943016455865,0.20279784428391232,129504.14540816327,799.4472789115622,130303.59268707484,707,5,195.2325581395349,34,9,14,36.30116959064327,0.6194852941176471,45.535714285714285,1017.8571428571429,29.93697478991597,0
4220,4,0,1,42,0.0,0.023255813953488372,0.9767441860465116,43,1150,800,350,0.6956521739130435,15,8,7,363.4166928264562,0.43807678110003695,0.21236051268807854,0.20387080702493982,129655.65653344667,823.8059807256179,130479.4625141723,708,6,196.2325581395349,34,9,15,36.13383985973114,0.6210171568627452,45.38690476190476,1018.4523809523806,29.954481792717075,0
4221,4,0,0,42,0.0,0.0,1.0,42,900,800,100,0.8888888888888888,10,8,2,366.7947140403865,0.43861304684475416,0.21175982953059735,0.20640341600734147,129776.92920918352,1120.2983276643763,130897.2275368479,709,7,198.4047619047619,34,8,15,35.92441679323907,0.6222426470588236,45.26785714285713,1018.9285714285702,29.968487394957947,0
4222,4,0,0,42,0.0,0.0,1.0,42,950,900,50,0.9473684210526315,10,9,1,371.20482621603844,0.43828639179248935,0.20678476902204146,0.20969644668299148,129928.59977324255,1246.0246598639342,131174.62443310648,710,8,199.4047619047619,34,8,15,35.657743655612634,0.6237745098039216,45.11904761904761,1019.5238095238088,29.985994397759082,0
4223,4,1,0,43,0.023255813953488372,0.0,1.0,43,1350,1000,350,0.7407407407407407,17,10,7,362.0930699522444,0.4399916943521595,0.21018635022561627,0.20647009095149246,130292.97052154191,836.0650510204034,131129.0355725623,711,0,195.74418604651163,34,9,16,35.51991021455224,0.6274509803921569,44.76190476190476,1020.9523809523806,30.028011204481782,0
4224,4,0,1,42,0.0,0.023255813953488372,0.9767441860465116,43,1150,800,350,0.6956521739130435,15,8,7,359.67009662890007,0.43920727205610927,0.20843778710672334,0.20589253496815124,130444.94224773224,783.4289965986172,131228.37124433086,712,1,196.74418604651163,34,9,16,35.42759196674825,0.6289828431372548,44.61309523809523,1021.5476190476176,30.045518207282868,0
4225,4,0,0,42,0.0,0.0,1.0,42,1800,1100,700,0.6111111111111112,25,11,14,366.01713943506655,0.43555216802168023,0.21748694817551883,0.20985471661798097,130505.75573979583,1153.468679138311,131659.22441893414,713,2,202.11904761904762,34,8,15,35.203794322109594,0.6295955882352942,44.55357142857142,1021.7857142857135,30.05252100840334,0
4226,4,0,0,42,0.0,0.0,1.0,42,1050,700,350,0.6666666666666666,14,7,7,365.95017053207386,0.4348988579171506,0.21180688416044213,0.21047649794768333,130627.42524092944,1160.625708616752,131788.0509495462,714,3,203.11904761904762,34,8,15,35.082100850122295,0.6308210784313726,44.434523809523796,1022.2619047619027,30.066526610644196,0
4227,4,0,0,42,0.0,0.0,1.0,42,1150,900,250,0.782608695652174,14,9,5,364.3194570151438,0.4336043360433604,0.2190686796133725,0.2103651058248734,130779.59183673466,1129.1099773242602,131908.7018140589,715,4,204.11904761904762,34,8,15,34.9695453134699,0.6323529411764706,44.285714285714285,1022.8571428571425,30.08403361344537,0
4228,4,0,0,42,0.0,0.0,1.0,42,1350,1000,350,0.7407407407407407,17,10,7,361.58208575157323,0.4334349593495935,0.21416938110749228,0.20944471759572247,130901.3888888888,1066.3194444444396,131967.70833333326,716,5,205.11904761904762,34,8,16,34.91619163952227,0.633578431372549,44.166666666666664,1023.3333333333326,30.098039215686253,0
4229,4,0,0,42,0.0,0.0,1.0,42,1050,700,350,0.6666666666666666,14,7,7,360.01892915089235,0.43374951606658924,0.21392580287929142,0.20920018856065362,131023.24263038543,1034.169501133779,132057.4121315192,717,6,206.11904761904762,34,8,17,34.8328488372093,0.6348039215686274,44.047619047619044,1023.8095238095233,30.112044817927156,0
4230,4,0,0,42,0.0,0.0,1.0,42,1250,900,350,0.72,16,9,7,360.48412351094834,0.43328977932636464,0.2203301174009069,0.20996918852841462,131114.6701388887,1052.951388888865,132167.62152777758,718,7,207.11904761904762,34,8,17,34.72843775427175,0.6357230392156863,43.95833333333332,1024.1666666666652,30.1225490196078,0
4231,4,0,0,42,0.0,0.0,1.0,42,1200,800,400,0.6666666666666666,16,8,8,358.9828403982813,0.43359223770809135,0.21872838829966756,0.20976003444046193,131236.62308673456,1022.3391439909178,132258.96223072548,719,8,208.11904761904762,34,8,18,34.64355563301189,0.6369485294117647,43.83928571428571,1024.6428571428562,30.136554621848713,0
4232,4,2,1,43,0.045454545454545456,0.022727272727272728,0.9772727272727273,44,1400,1000,400,0.7142857142857143,18,10,8,340.79547745516356,0.43431774136715995,0.21514844182186987,0.20242430166915115,131862.52170138873,187.6620960884157,132050.18379747713,720,0,199.61363636363637,35,9,16,34.478532792427316,0.6410714285714285,43.22916666666666,1027.083333333332,29.345238095238056,0
4233,4,0,0,43,0.0,0.0,1.0,43,1500,900,600,0.6,21,9,12,345.07372400756174,0.4328626799557032,0.21616447590158439,0.20455401165396683,131786.11288265293,495.1849489795817,132281.29783163252,721,1,205.25581395348837,34,9,16,34.44565217391303,0.6424632352941176,43.30357142857142,1026.7857142857133,30.199579831932745,0
4234,4,0,1,42,0.0,0.023255813953488372,0.9767441860465116,43,1050,700,350,0.6666666666666666,14,7,7,345.8078397919122,0.43210132890365444,0.21964722752315358,0.2054841626532105,131877.80612244885,520.8758503401237,132398.68197278897,722,2,206.25581395348837,34,9,17,34.334434399629124,0.6433823529411764,43.21428571428571,1027.1428571428562,30.210084033613416,0
4235,4,0,0,42,0.0,0.0,1.0,42,850,300,550,0.35294117647058826,14,3,11,358.80325333819474,0.43070073557878435,0.23032922442159887,0.212768043858509,131799.59518274214,1058.024708044981,132857.61989078711,723,3,211.54761904761904,33,9,18,34.07961868958111,0.6448863636363636,43.29044117647059,1026.838235294117,31.11631016042779,0
4236,4,0,0,42,0.0,0.0,1.0,42,1350,1100,250,0.8148148148148148,16,11,5,355.7639237798991,0.4303256871854433,0.22788709998012302,0.21201709316947087,131988.4197934689,991.3436238466024,132979.7634173155,724,4,212.54761904761904,33,9,19,33.96727787716159,0.646780303030303,43.106617647058826,1027.573529411765,31.13859180035652,0
4237,4,1,0,43,0.023255813953488372,0.0,1.0,43,1100,600,500,0.5454545454545454,16,6,10,323.556946944919,0.43180140273163525,0.1315481420195337,0.1862760634947952,130665.25298524875,-144.469934461491,130520.78305078726,725,0,208.58139534883722,36,7,12,36.1273267981055,0.627025462962963,44.39752252252252,1022.4099099099099,28.400275275275273,8
4238,4,0,0,43,0.0,0.0,1.0,43,1400,1000,400,0.7142857142857143,18,10,8,322.38451746353167,0.4320551864156515,0.12824361998713285,0.18581940728460394,130710.70545744828,-172.17845875655706,130538.52699869171,726,1,209.58139534883722,37,6,13,36.11140896418616,0.6255630630630631,44.35307017543859,1022.5877192982442,27.637505926979575,0
4239,4,1,0,44,0.022727272727272728,0.0,1.0,44,1350,800,550,0.5925925925925926,19,8,11,313.8211719593172,0.43251189217758984,0.1328791671407441,0.18302417255145575,131163.91354372117,-567.5973865877753,130596.31615713339,727,0,205.79545454545453,38,6,16,35.87361806424697,0.6282894736842105,43.91025641025641,1024.358974358974,26.95681511470984,0
4240,4,0,2,42,0.0,0.045454545454545456,0.9545454545454546,44,1000,800,200,0.8,12,8,4,316.2811757572839,0.4325559372797745,0.1214627582803347,0.17574576658613367,129280.82817925379,-622.1815321180213,128658.64664713577,728,1,206.79545454545453,39,5,16,37.71392416948343,0.6076388888888888,45.75520833333335,1016.9791666666692,26.076388888888953,8
4241,4,0,0,42,0.0,0.0,1.0,42,1050,800,250,0.7619047619047619,13,8,5,325.7189206443721,0.43191056910569103,0.11998400343340965,0.18111159118289588,129307.31336805565,23.56770833334315,129330.88107638899,729,2,207.33333333333334,39,3,18,37.447084528198815,0.607905982905983,45.72916666666667,1017.0833333333342,26.07905982905985,0
4242,4,1,0,43,0.023255813953488372,0.0,1.0,43,550,100,450,0.18181818181818182,10,1,9,321.9947330887128,0.4331164636397195,0.12994940351854423,0.18044671283830555,129614.99851279006,-252.93062991604899,129362.067882874,730,0,203.48837209302326,40,3,14,37.22970725216234,0.609375,45.426829268292686,1018.2926829268297,25.457317073170742,0
4243,4,0,0,43,0.0,0.0,1.0,43,1000,600,400,0.6,14,6,8,321.5793339093406,0.43346253229974163,0.13056945768917538,0.18057084951111044,129692.62390318266,-258.70647845197783,129433.91742473068,731,1,204.48837209302326,40,3,14,37.161611626592176,0.61015625,45.35060975609756,1018.5975609756099,25.464939024390247,0
4244,4,0,0,43,0.0,0.0,1.0,43,950,500,450,0.5263157894736842,14,5,9,319.6830808736226,0.43360095976375046,0.13507251351583238,0.17998103604266247,129796.16057117145,-301.2727006080864,129494.88787056337,732,2,205.48837209302326,40,3,15,37.10502476646388,0.6111979166666667,45.248983739837406,1019.0040650406519,25.475101626016297,0
4245,4,0,0,43,0.0,0.0,1.0,43,1250,900,350,0.72,16,9,7,317.76280504972493,0.4339931709117755,0.12794522262580021,0.17961206890500797,129951.5430320081,-341.24663312180945,129610.29639888629,733,3,206.48837209302326,40,3,18,36.99666101863852,0.6127604166666667,45.09654471544716,1019.6138211382117,25.490345528455293,0
4246,4,0,0,43,0.0,0.0,1.0,43,1700,1300,400,0.7647058823529411,21,13,8,315.8541861645807,0.4337624584717608,0.11661953432785976,0.1794845434792619,130158.86423631782,-377.7555729063278,129781.10866341149,734,4,207.48837209302326,40,3,18,36.8356405404508,0.61484375,44.893292682926834,1020.4268292682939,25.510670731707346,0
4247,4,0,0,43,0.0,0.0,1.0,43,1750,1300,450,0.7428571428571429,22,13,9,317.66469988640506,0.43390088593576964,0.12439823729817756,0.1813576650260567,130340.40584308289,-319.0908189569631,130021.31502412593,735,5,208.48837209302326,40,3,18,36.605958067940556,0.6166666666666667,44.71544715447155,1021.1382113821144,25.52845528455286,0
4248,4,0,0,43,0.0,0.0,1.0,43,1100,600,500,0.5454545454545454,16,6,10,316.36997887951713,0.43270118124769286,0.1281035894541569,0.18134457056183953,130496.1136311058,-342.9894573335994,130153.1241737722,736,6,209.48837209302326,40,3,15,36.481748557787945,0.6182291666666666,44.5630081300813,1021.7479674796747,25.543699186991866,0
4249,4,0,0,43,0.0,0.0,1.0,43,1500,1100,400,0.7333333333333333,19,11,8,320.7589453339608,0.4318244739756368,0.13521660733274787,0.1846015440537554,130651.91436975346,-218.44594817898889,130433.46842157448,737,7,210.48837209302326,40,3,15,36.2123094764745,0.6197916666666667,44.41056910569106,1022.3577235772358,25.558943089430894,0
4250,4,0,0,43,0.0,0.0,1.0,43,1150,800,350,0.6956521739130435,15,8,7,324.0349111991445,0.4309708379475821,0.13670128921616254,0.18673764470136245,130703.86860499682,-129.4767086390533,130574.39189635777,738,8,211.48837209302326,40,3,15,36.076119724375545,0.6203125,44.35975609756097,1022.5609756097545,25.564024390243862,0
4251,4,0,1,42,0.0,0.023255813953488372,0.9767441860465116,43,900,600,300,0.6666666666666666,12,6,6,326.55864057002566,0.43074012550756735,0.13352742060328793,0.18857215819491133,130781.81932257567,-58.41337414900494,130723.40594842666,739,9,212.48837209302326,40,3,15,35.93289451896009,0.62109375,44.283536585365844,1022.8658536585352,25.57164634146338,0
4252,4,1,0,43,0.023255813953488372,0.0,1.0,43,1050,700,350,0.6666666666666666,14,7,7,325.84066228179347,0.43011720191952746,0.1400289514451485,0.18917538853974042,130989.80150910465,-63.639264822560364,130926.1622442821,740,0,212.13953488372093,40,3,17,35.741379595618675,0.6231770833333333,44.08028455284551,1023.6788617886149,25.59197154471537,0
4253,4,0,1,42,0.0,0.023255813953488372,0.9767441860465116,43,1750,1200,550,0.6857142857142857,23,12,11,330.0257861729022,0.42912513842746397,0.14811107061629514,0.19277636015035926,131223.97898902767,61.45936611805132,131285.4383551457,741,1,213.13953488372093,40,3,17,35.39806916617075,0.6255208333333333,43.85162601626016,1024.5934959349593,25.614837398373982,0
4254,4,0,1,41,0.0,0.023809523809523808,0.9761904761904762,42,1400,1100,300,0.7857142857142857,17,11,6,334.8597354482563,0.4276156600851723,0.149683378841573,0.19558671958842352,131221.37586805568,388.15104166667686,131609.52690972236,742,2,217.85714285714286,39,3,19,35.276874068049345,0.6271367521367521,43.85416666666667,1024.5833333333344,26.271367521367548,0
4255,4,0,0,41,0.0,0.0,1.0,41,1050,800,250,0.7619047619047619,13,8,5,333.4600490678565,0.4268038617886179,0.14696189914359525,0.19503346284505382,131273.37643363295,554.8853093724983,131828.26174300545,743,3,219.8048780487805,38,3,19,35.260286349735885,0.6293859649122807,43.80341880341881,1024.7863247863256,26.968061178587515,0
4256,4,0,0,41,0.0,0.0,1.0,41,1200,800,400,0.6666666666666666,16,8,8,333.7856453701649,0.42634654471544714,0.14345378055135427,0.19564283856608025,131355.5035635365,568.9163059756114,131924.41986951212,744,4,220.8048780487805,38,3,20,35.169141914191414,0.6302083333333333,43.7232905982906,1025.1068376068383,26.976495726495745,0
4257,4,0,0,41,0.0,0.0,1.0,41,700,400,300,0.5714285714285714,10,4,6,333.7856453701649,0.42604166666666665,0.14345378055135427,0.19564283856608025,131355.5035635365,568.9163059756114,131924.41986951212,745,5,221.8048780487805,38,3,20,35.169141914191414,0.6302083333333333,43.7232905982906,1025.1068376068383,26.976495726495745,0
4258,4,0,0,41,0.0,0.0,1.0,41,1350,1000,350,0.7407407407407407,17,10,7,335.25390625000006,0.4254065040650406,0.1432926829268295,0.19720818014705893,131492.43918474688,616.6707758053939,132109.10996055228,746,6,222.8048780487805,38,3,20,34.99348958333334,0.631578947368421,43.58974358974359,1025.6410256410256,26.99055330634278,0
4259,4,0,0,41,0.0,0.0,1.0,41,1050,600,450,0.5714285714285714,15,6,9,335.11968385049266,0.42502540650406506,0.1398997160144484,0.19741222112468892,131547.23340821094,616.8134542333204,132164.04686244426,747,7,223.8048780487805,38,3,20,34.94172221065055,0.6321271929824561,43.53632478632478,1025.8547008547005,26.99617633828159,0
4260,4,0,0,41,0.0,0.0,1.0,41,900,800,100,0.8888888888888888,10,8,2,336.172407167987,0.4248475609756098,0.1356051853074487,0.1984594942131847,131629.4461451713,650.037552962228,132279.48369813352,748,8,224.8048780487805,38,3,15,34.83190178726357,0.6329495614035088,43.45619658119658,1026.1752136752136,27.004610886189834,0
4261,4,0,0,41,0.0,0.0,1.0,41,950,700,250,0.7368421052631579,12,7,5,335.3660111612893,0.4242632113821138,0.1361528445131468,0.19855403581323652,131739.10307774495,636.163502629856,132375.2665803748,749,9,225.8048780487805,38,3,15,34.742168800083256,0.634046052631579,43.34935897435898,1026.6025641025647,27.01585695006749,0
4262,4,0,0,41,0.0,0.0,1.0,41,1100,700,400,0.6363636363636364,15,7,8,335.90580438621527,0.4235518292682927,0.13839408057001923,0.1993041106024876,131821.37573964492,655.9130506245833,132477.2887902695,750,10,226.8048780487805,38,3,16,34.645495214315446,0.6348684210526316,43.26923076923077,1026.9230769230765,27.024291497975696,0
4263,4,0,1,40,0.0,0.024390243902439025,0.975609756097561,41,1100,900,200,0.8181818181818182,13,9,4,342.09645056138964,0.42337398373983737,0.13770933053656442,0.19064942731286075,129396.54659366336,707.5632205505547,130104.10981421391,751,11,227.8048780487805,37,4,18,36.93993156590149,0.6123310810810811,45.64144736842105,1017.4342105263152,27.498221906116626,8
4264,4,1,0,41,0.024390243902439025,0.0,1.0,41,1200,800,400,0.6666666666666666,16,8,8,339.918427906735,0.4224847560975609,0.15158351432765893,0.19051432950934527,129619.7643145007,612.0293022853255,130231.79361678603,752,0,228.5121951219512,37,4,17,36.76857883780193,0.6145833333333333,45.42214912280702,1018.3114035087726,27.521929824561422,0
4265,4,0,0,41,0.0,0.0,1.0,41,2000,1600,400,0.8,24,16,8,342.2699700792197,0.4215701219512195,0.15537980992888967,0.1932508907985747,129908.37191358018,692.7469135802403,130601.11882716042,753,1,229.5121951219512,38,3,18,36.41575840145321,0.6156798245614035,45.138888888888886,1019.4444444444439,26.827485380116944,0
4266,4,0,0,41,0.0,0.0,1.0,41,1150,800,350,0.6956521739130435,15,8,7,339.9049634207682,0.42096036585365854,0.15563760875953458,0.192317301473102,129990.07100819996,636.8540662210482,130626.925074421,754,2,230.5121951219512,38,3,18,36.39318142133753,0.6165021929824561,45.05876068376068,1019.7649572649568,26.83591992802518,0
4267,4,0,0,41,0.0,0.0,1.0,41,1350,1000,350,0.7407407407407407,17,10,7,346.2849769540881,0.4196646341463415,0.15157140996601037,0.19675001873221248,130153.5462437905,814.0435523047545,130967.58979609524,755,3,231.5121951219512,38,3,18,36.064722716643985,0.6181469298245614,44.898504273504265,1020.4059829059818,26.852789023841627,0
4268,4,0,1,40,0.0,0.024390243902439025,0.975609756097561,41,1250,900,350,0.72,16,9,7,349.0212411495208,0.4191819105691057,0.15111996017919305,0.1988609397247271,130262.58680555566,892.8819444444543,131155.46875000012,756,4,232.5121951219512,39,2,19,35.8843537414966,0.6175213675213675,44.79166666666667,1020.8333333333343,26.1752136752137,0
4269,4,0,1,39,0.0,0.025,0.975,40,1350,1000,350,0.7407407407407407,17,10,7,357.3488975263465,0.41861645299145295,0.14702218965878178,0.20346313271553737,130235.3223847616,1307.8897746365828,131543.2121593982,757,5,237.9,38,2,19,35.69948887028123,0.6189692982456141,44.818376068376075,1020.7264957264966,26.86122357174991,0
4270,4,0,0,39,0.0,0.0,1.0,39,1400,1200,200,0.8571428571428571,16,12,4,358.88844898712034,0.4160481331533963,0.13991666218292464,0.20496305695149922,130353.74858276639,1556.4994904108848,131910.24807317727,758,6,238.69230769230768,34,5,19,35.54004429937049,0.6280637254901961,44.70238095238095,1021.1904761904758,30.03501400560223,0
4271,4,0,0,39,0.0,0.0,1.0,39,950,500,450,0.5263157894736842,14,5,9,360.30694247477464,0.4155420602789024,0.14018887095810184,0.20609557109557108,130414.54081632648,1597.8528911564542,132012.39370748293,759,7,239.69230769230768,34,5,19,35.442162004662,0.6286764705882353,44.64285714285714,1021.428571428571,30.042016806722675,0
4272,4,0,0,39,0.0,0.0,1.0,39,1000,700,300,0.7,13,7,6,358.376224366382,0.4149797570850202,0.13856026947759692,0.20575175950293587,130558.13426997601,1557.7862439986322,132115.92051397465,760,8,240.69230769230768,35,4,17,35.345885239713105,0.6279761904761905,44.50231481481482,1021.9907407407409,29.199735449735453,0
4273,4,0,0,39,0.0,0.0,1.0,39,850,600,250,0.7058823529411765,11,6,5,355.8620963963452,0.4144455690508322,0.13262279189379034,0.2049338826313766,130676.44702717781,1500.5588777435041,132177.00590492133,761,9,241.69230769230768,35,4,17,35.290261112368896,0.6291666666666667,44.38657407407408,1022.4537037037051,29.212962962963,0
4274,4,1,1,39,0.025,0.025,0.975,40,800,600,200,0.75,10,6,4,347.51001076503354,0.4169471153846154,0.13310691893081117,0.2018666778188449,131010.89000740615,1105.5191593620757,132116.40916676822,762,0,236.625,36,4,18,35.165502511641556,0.6304976851851851,44.05968468468469,1023.7612612612621,28.437812812812837,0
4275,4,1,2,38,0.025,0.05,0.95,40,1650,1200,450,0.7272727272727273,21,12,9,343.12883084149627,0.41861645299145295,0.14539415898111563,0.20188742837883386,131501.32395909433,1024.7627272542945,132526.08668634863,763,0,233.375,36,4,20,34.78260869565218,0.6354166666666667,43.58108108108109,1025.6756756756765,28.490990990991016,0
4276,4,0,0,38,0.0,0.0,1.0,38,1100,800,300,0.7272727272727273,14,8,6,333.0270445815741,0.4155257230915126,0.10126354224218659,0.18196066201452085,128613.70991941009,981.0286716270717,129594.73859103717,764,1,244.28947368421052,35,3,17,37.96687205233531,0.6083333333333334,46.41203703703703,1014.3518518518514,28.981481481481467,8
4277,4,1,1,38,0.02564102564102564,0.02564102564102564,0.9743589743589743,39,850,700,150,0.8235294117647058,10,7,3,327.02604858208065,0.41734143049932526,0.1098292019475926,0.18043437212592975,129001.10995708557,637.3446503936482,129638.45460747922,765,0,239.0,36,3,18,37.72493810737907,0.6102430555555556,46.03040540540541,1015.8783783783792,28.218843843843867,0
4278,4,0,1,37,0.0,0.02631578947368421,0.9736842105263158,38,900,600,300,0.6666666666666666,12,6,6,332.1630751189543,0.416459222380275,0.09616352955281116,0.18365187654561824,129083.74592764054,975.3707990397713,130059.11672668031,762,1,226.1578947368421,35,3,19,37.510440394836735,0.6130952380952381,45.94907407407407,1016.2037037037032,29.03439153439152,0
4279,4,1,0,38,0.02631578947368421,0.0,1.0,38,1550,1200,350,0.7741935483870968,19,12,7,332.39292245687204,0.42010431484115696,0.12159152146578034,0.1851542324712232,129377.9538001542,1000.8632330246764,130378.81703317887,763,0,225.92105263157896,35,3,20,37.20563139931739,0.6160714285714286,45.659722222222214,1017.3611111111102,29.06746031746029,0
4280,4,0,0,38,0.0,0.0,1.0,38,1250,800,450,0.64,17,8,9,337.70582140511186,0.41957088667614983,0.12705381673220884,0.18853633572159656,129466.28146701376,1144.3033854166479,130610.5848524304,764,1,226.92105263157896,35,3,13,36.98076595018763,0.6169642857142856,45.57291666666666,1017.7083333333322,29.07738095238092,0
4281,4,1,0,39,0.02564102564102564,0.0,1.0,39,1350,1000,350,0.7407407407407407,17,10,7,329.35282805775194,0.4224583895636527,0.12938943193086905,0.1855942150636769,129831.84831791231,752.0972830938892,130583.9456010062,765,0,222.07692307692307,36,3,15,36.82251381215471,0.6186342592592593,45.213963963963955,1019.1441441441426,28.309559559559517,0
4282,4,0,1,38,0.0,0.02564102564102564,0.9743589743589743,39,1350,1000,350,0.7407407407407407,17,10,7,329.38825131661736,0.4223740440845704,0.12703537855421176,0.18602319645473075,129917.93894823866,758.6885449638661,130676.62749320253,766,1,223.07692307692307,36,3,16,36.73436982215839,0.6195023148148149,45.129504504504496,1019.481981981981,28.318943943943918,0
4283,4,0,0,38,0.0,0.0,1.0,38,800,400,400,0.5,12,4,8,336.9624081098416,0.4202524893314367,0.13315699811709836,0.18982431243807774,129819.89354263117,1148.8847897376525,130968.77833236882,767,2,229.73684210526315,35,3,18,36.640758091993185,0.6205357142857143,45.22569444444444,1019.0972222222222,29.11706349206349,0
4284,4,0,0,38,0.0,0.0,1.0,38,1050,800,250,0.7619047619047619,13,8,5,336.5381200057775,0.42066737790422004,0.13349130177550128,0.18987131472715446,129878.87577428407,1141.83853630829,131020.71431059236,768,3,230.73684210526315,35,3,18,36.591749933764795,0.6211309523809524,45.16782407407407,1019.3287037037032,29.123677248677236,0
4285,4,0,0,38,0.0,0.0,1.0,38,1250,1000,250,0.8,15,10,5,336.4804606601529,0.42011913229018494,0.14314212676493732,0.1905569292633204,130026.38996056237,1150.267918381339,131176.65787894372,769,4,231.73684210526315,35,3,18,36.44367529126947,0.6226190476190476,45.023148148148145,1019.9074074074072,29.140211640211632,0
4286,4,0,0,38,0.0,0.0,1.0,38,950,700,250,0.7368421052631579,12,7,5,338.69719769985284,0.41928935514461835,0.14993852287784493,0.19268592834305182,130203.51750042863,1219.9133016117844,131423.4308020404,770,5,232.73684210526315,35,3,20,36.20766235729945,0.6244047619047619,44.84953703703703,1020.6018518518515,29.1600529100529,0
4287,4,0,0,38,0.0,0.0,1.0,38,1200,900,300,0.75,15,9,6,339.51381914607725,0.4193782598387861,0.1501537158741555,0.19374650877018637,130323.35778061207,1249.3295807263025,131572.68736133838,771,6,233.73684210526315,34,4,20,36.0654463487622,0.6277573529411764,44.73214285714285,1021.0714285714271,30.03151260504197,0
4288,4,0,0,38,0.0,0.0,1.0,38,1400,1100,300,0.7857142857142857,17,11,6,342.03547482920203,0.4195264343290659,0.15808180864701127,0.19579762571777043,130444.94224773222,1323.359552154172,131768.3017998864,772,7,234.73684210526315,34,4,21,35.8779571145554,0.6289828431372548,44.61309523809523,1021.5476190476174,30.045518207282868,0
4289,4,0,0,38,0.0,0.0,1.0,38,1200,900,300,0.75,15,9,6,343.0500163077842,0.4198524182076813,0.15671779028283495,0.19715043105881078,130597.00255102031,1360.2607709750446,131957.26332199536,773,8,235.73684210526315,34,4,15,35.69813261899215,0.6305147058823529,44.46428571428571,1022.1428571428564,30.063025210084014,0
4290,4,0,1,37,0.0,0.02631578947368421,0.9736842105263158,38,600,400,200,0.6666666666666666,8,4,4,342.9881471508757,0.41920045045045046,0.15660162282744627,0.1974250809471662,130657.85147392288,1362.8188775510216,132020.6703514739,774,9,236.73684210526315,34,4,15,35.638148191274645,0.6311274509803921,44.404761904761905,1022.3809523809522,30.070028011204474,0
4291,4,0,0,37,0.0,0.0,1.0,37,950,700,250,0.7368421052631579,12,7,5,342.9947236070963,0.4172922922922923,0.16227539071714592,0.19820804707167317,130810.03578514748,1573.4304138322123,132383.4661989797,775,10,241.56756756756758,34,3,15,35.484066488226844,0.6326593137254901,44.25595238095239,1022.9761904761912,30.087535014005624,0
4292,4,0,0,37,0.0,0.0,1.0,37,1050,900,150,0.8571428571428571,12,9,3,342.9947236070963,0.4172922922922923,0.16227539071714592,0.19820804707167317,130810.03578514748,1573.4304138322123,132383.4661989797,776,11,242.56756756756758,34,3,15,35.484066488226844,0.6326593137254901,44.25595238095239,1022.9761904761912,30.087535014005624,0
4293,4,0,2,35,0.0,0.05405405405405406,0.9459459459459459,37,1100,700,400,0.6363636363636364,15,7,8,343.7871822606816,0.41694819819819817,0.16011942174732874,0.19976822752985546,131023.24263038553,1608.8222789115725,132632.0649092971,777,12,243.56756756756758,34,3,15,35.248304263565906,0.6348039215686274,44.04761904761905,1023.8095238095241,30.112044817927178,0
4294,4,0,0,35,0.0,0.0,1.0,35,1200,900,300,0.75,15,9,6,359.7695154150316,0.4163165266106443,0.16015381087612246,0.2073860003805225,130714.10323245073,2405.389915569839,133119.49314802056,778,13,235.82857142857142,32,3,15,35.15223072807343,0.6363932291666667,44.349747474747474,1022.6010101010097,31.956281565656553,0
4295,4,0,0,35,0.0,0.0,1.0,35,1250,900,350,0.72,16,9,7,357.43173456224287,0.41603641456582635,0.15723014256619194,0.2064693902000719,130794.81336805546,2350.043402777769,133144.85677083323,779,14,236.82857142857142,33,2,15,35.13026137135099,0.6347853535353536,44.27083333333333,1022.9166666666658,30.997474747474723,0
4296,4,0,0,35,0.0,0.0,1.0,35,1300,800,500,0.6153846153846154,18,8,10,358.61880985416497,0.41491596638655465,0.15910109284944673,0.2081683751710799,130982.91710219628,2394.587568483275,133377.50467067957,780,15,237.82857142857142,33,2,15,34.90948860688773,0.6366792929292929,44.08700980392157,1023.6519607843138,31.019756387403447,0
4297,4,0,0,35,0.0,0.0,1.0,35,1050,900,150,0.8571428571428571,12,9,3,378.0189918869981,0.41526610644257705,0.13201042630118587,0.20260386978422998,127843.36911848055,2713.3863502508634,130556.75546873141,781,16,238.82857142857142,34,1,17,37.61526388071414,0.6026348039215687,47.17261904761904,1011.3095238095224,29.7443977591036,8
4298,4,0,0,35,0.0,0.0,1.0,35,1300,1000,300,0.7692307692307693,16,10,6,378.6982941218222,0.41526610644257705,0.1298401868687722,0.20388310312410426,128024.02388038528,2696.4958900226497,130720.51977040793,782,17,239.82857142857142,34,1,17,37.412755362114254,0.6044730392156863,46.994047619047606,1012.0238095238078,29.765406162464934,0
4299,4,2,1,36,0.05405405405405406,0.02702702702702703,0.972972972972973,37,1050,1000,50,0.9523809523809523,11,10,1,362.8977246846944,0.42185935935935936,0.13030185783060677,0.19849899934293747,128657.32001133791,1938.0031179138357,130595.32312925174,783,0,227.8108108108108,34,3,16,37.164838066181645,0.610906862745098,46.36904761904762,1014.5238095238099,29.8389355742297,0
4300,4,0,0,36,0.0,0.0,1.0,36,750,500,250,0.6666666666666666,10,5,5,369.7410129307171,0.41830357142857144,0.1318445545751239,0.20137375905041652,128485.98082768662,2301.3073397251233,130787.28816741175,784,1,235.13888888888889,33,3,16,37.16646017164269,0.6114267676767677,46.53799019607844,1013.8480392156875,30.722667855020834,0
4301,4,1,0,37,0.02702702702702703,0.0,1.0,37,750,300,450,0.4,12,3,9,361.90612704854414,0.4208896396396396,0.1434767319188841,0.1993170542189239,128929.21095521541,1932.0542800453482,130861.26523526077,785,0,229.75675675675674,34,3,18,36.912436994490676,0.6136642156862745,46.101190476190474,1015.5952380952381,29.87044817927171,0
4302,4,0,0,37,0.0,0.0,1.0,37,1400,1100,300,0.7857142857142857,17,11,6,366.59071901117727,0.420264014014014,0.15016070552098681,0.20251467875471837,129050.14349489803,2061.7169784580587,131111.8604733561,786,1,230.75675675675674,34,3,18,36.670083967975,0.6148897058823529,45.98214285714286,1016.0714285714291,29.884453781512622,0
4303,4,0,0,37,0.0,0.0,1.0,37,850,800,50,0.9411764705882353,9,8,1,370.24968505919674,0.4196696696696696,0.06462092380946816,0.1977382153462154,127700.83703639593,2056.238938904289,129757.07597530022,787,2,231.75675675675674,37,0,16,37.957890359441656,0.5951576576576576,47.313596491228076,1010.7456140350887,27.31744902797537,8
4304,4,4,2,39,0.0975609756097561,0.04878048780487805,0.9512195121951219,41,600,300,300,0.5,9,3,6,342.825932425974,0.4263973577235773,0.08351336819981414,0.18716645544919167,128582.21379469911,617.0329350412128,129199.24672974032,788,0,210.0487804878049,40,1,14,37.75050100200401,0.5989583333333333,46.44308943089432,1014.2276422764243,25.355691056910608,0
4305,4,1,1,39,0.025,0.025,0.975,40,1000,800,200,0.8,12,8,4,351.668421542022,0.42465277777777777,0.1014243917462272,0.19255773435867565,128698.8403320314,1051.8636067708485,129750.70393880224,789,0,216.2,39,1,17,37.40728621291449,0.6017628205128205,46.32812500000001,1014.6875000000011,26.017628205128233,0
4306,4,0,0,39,0.0,0.0,1.0,39,1100,800,300,0.7272727272727273,14,8,6,355.871708603214,0.4220647773279352,0.11336799650128748,0.19492903623490945,128713.06911571347,1361.067965154515,130074.137080868,790,1,222.07692307692307,38,1,17,37.28613918719729,0.6036184210526316,46.31410256410257,1014.7435897435907,26.703778677462914,0
4307,4,1,0,40,0.025,0.0,1.0,40,1000,800,200,0.8,12,8,4,355.52781624950853,0.42291666666666666,0.14057343445731263,0.19676034617960628,129121.97401258703,1181.290690104187,130303.26470269122,791,0,217.5,39,1,18,36.877903898056076,0.6060363247863247,45.91145833333334,1016.3541666666684,26.060363247863293,0
4308,4,0,0,40,0.0,0.0,1.0,40,1500,1100,400,0.7333333333333333,19,11,8,357.9869106867851,0.4221955128205128,0.14292003544135579,0.19866403298039254,129230.01284646145,1252.603855571169,130482.61670203262,792,1,218.5,36,4,19,36.70533835419206,0.6125578703703703,45.80518018018019,1016.7792792792802,28.243868868868894,0
4309,4,0,0,40,0.0,0.0,1.0,40,950,500,450,0.5263157894736842,14,5,9,353.2740055317945,0.42143429487179485,0.13589674498814364,0.19673926910708245,129368.65790435538,1140.516793628827,130509.1746979842,793,2,219.5,37,3,19,36.68400158080047,0.6120495495495495,45.668859649122815,1017.3245614035103,27.49525841631109,0
4310,4,0,0,40,0.0,0.0,1.0,40,1050,700,350,0.6666666666666666,14,7,7,358.1490607613273,0.42015224358974357,0.13987825899590622,0.20002043212916018,129480.23069598348,1274.6446021852992,130754.87529816879,794,3,220.5,37,3,16,36.44643754937872,0.6131756756756757,45.559210526315795,1017.7631578947376,27.50711237553345,0
4311,4,0,1,39,0.0,0.025,0.975,40,1100,1000,100,0.9090909090909091,12,10,2,359.95332164169946,0.41963141025641026,0.1393711318577573,0.201967923202491,129663.42872242317,1334.5563728175946,130997.98509524076,795,4,221.5,38,2,17,36.21411587817756,0.6132127192982456,45.379273504273506,1018.4829059829063,26.80218173639227,0
4312,4,1,0,40,0.025,0.0,1.0,40,1150,800,350,0.6956521739130435,15,8,7,359.41653330877136,0.41952457264957266,0.152837158126375,0.20307353329577327,129935.60209155179,1340.2007314267116,131275.8028229785,796,0,222.175,38,2,18,35.951089804044855,0.615953947368421,45.112179487179496,1019.5512820512835,26.830296896086406,0
4313,4,0,1,39,0.0,0.025,0.975,40,1500,1100,400,0.7333333333333333,19,11,8,356.7355737077188,0.41924412393162397,0.14629724208375872,0.20187521772246075,129996.88042534742,1274.90234375002,131271.78276909745,797,1,223.175,39,1,18,35.95718420156622,0.6148504273504274,45.05208333333334,1019.7916666666682,26.14850427350431,0
4314,4,0,0,39,0.0,0.0,1.0,39,550,300,250,0.5454545454545454,8,3,5,366.08718009572414,0.416751012145749,0.15013707466537674,0.20641085686248276,129853.9201183432,1707.5710880999377,131561.49120644314,798,2,229.66666666666666,38,1,18,35.864124737945495,0.6151315789473684,45.19230769230769,1019.2307692307693,26.82186234817814,0
4315,4,0,0,39,0.0,0.0,1.0,39,1150,1000,150,0.8695652173913043,13,10,3,368.03104831111204,0.41655420602789023,0.14868893938661376,0.20837629817187867,130017.309746877,1770.0813609467375,131787.39110782373,799,3,230.66666666666666,38,1,18,35.64843913681122,0.6167763157894737,45.03205128205128,1019.8717948717944,26.83873144399459,0
4316,4,0,0,39,0.0,0.0,1.0,39,1450,1000,450,0.6896551724137931,19,10,9,345.4748302742915,0.415963787674314,0.0855114448634331,0.1902713636493291,128929.98598327143,1108.4130049675118,130038.39898823894,800,4,231.66666666666666,38,1,15,37.32883617364471,0.6058114035087719,46.10042735042736,1015.5982905982921,26.726270805218213,8
4317,4,0,1,38,0.0,0.02564102564102564,0.9743589743589743,39,1500,1100,400,0.7333333333333333,19,11,8,350.56089037168505,0.41512033288349076,0.09057258936346302,0.19373530670105152,129065.65176647308,1249.0739599313297,130314.7257264044,801,5,232.66666666666666,38,1,16,37.06147268075562,0.6071820175438596,45.96688034188034,1016.1324786324786,26.740328385065226,0
4318,4,0,0,38,0.0,0.0,1.0,38,1350,1100,250,0.8148148148148148,16,11,5,354.20738537752385,0.4123696064485538,0.10253985562806345,0.19573284676765146,129062.08070031174,1542.9484312480859,130605.02913155983,802,11,239.6578947368421,37,1,16,36.97247850796734,0.6089527027027026,45.97039473684211,1016.1184210526324,27.462660028449523,0
4319,4,0,0,38,0.0,0.0,1.0,38,1300,1100,200,0.8461538461538461,15,11,4,356.84167530712904,0.41262150308202944,0.10883438369386211,0.19760587396039947,129145.65659626042,1616.9104916897522,130762.56708795017,803,12,240.6578947368421,37,1,16,36.82038834951458,0.6097972972972974,45.88815789473684,1016.4473684210529,27.471550497866296,0
4320,4,1,0,39,0.02564102564102564,0.0,1.0,39,1350,1000,350,0.7407407407407407,17,10,7,352.2737401666947,0.41697593342330186,0.1287901365387376,0.1981433168056252,129759.3730763312,1342.175957987075,131101.54903431828,804,0,235.46153846153845,37,2,14,36.31215023676282,0.615990990990991,45.28508771929825,1018.8596491228072,27.536747273589384,0
4321,4,0,1,38,0.0,0.02564102564102564,0.9743589743589743,39,1000,700,300,0.7,13,7,6,381.02557101271907,0.4160481331533963,0.07929325576384416,0.19645599198662717,126270.1019220233,1823.4013946753464,128093.50331669864,805,1,236.46153846153845,36,3,12,39.159197012138186,0.5824652777777778,48.733108108108105,1005.0675675675669,27.918543543543525,8
4322,4,0,0,38,0.0,0.0,1.0,38,950,400,550,0.42105263157894735,15,4,11,385.07342478992746,0.41463667614983407,0.09487319334605959,0.19871436092100508,126305.47417534706,2127.376302083314,128432.85047743037,806,2,243.23684210526315,35,3,12,39.02094127806562,0.5848214285714286,48.69791666666666,1005.208333333332,28.720238095238056,0
4323,4,0,0,38,0.0,0.0,1.0,38,1000,700,300,0.7,13,7,6,382.6032300963106,0.4142069701280227,0.08883015398758931,0.1980886636516026,126439.93391617952,2075.2654258988514,128515.19934207837,807,3,244.23684210526315,36,2,13,38.9441738513791,0.5842013888888888,48.56418918918918,1005.7432432432417,27.937312312312272,0
4324,4,1,0,39,0.02564102564102564,0.0,1.0,39,1000,700,300,0.7,13,7,6,376.37266406088867,0.41784750337381915,0.09421521272647682,0.197064866669829,126898.60251471575,1752.2330188134465,128650.8355335292,808,0,238.94871794871796,37,2,14,38.62804712155838,0.5869932432432432,48.10855263157893,1007.5657894736817,27.23150782361302,0
4325,4,1,0,40,0.025,0.0,1.0,40,550,400,150,0.7272727272727273,7,4,3,370.04511413108384,0.42192841880341886,0.09676867050766425,0.19507421231471817,127174.94956380774,1412.241026084906,128587.19058989263,809,0,233.95,37,3,15,38.50316610501142,0.5898085585585586,47.83442982456138,1008.6622807017513,27.261142721668953,0
4326,4,1,0,41,0.024390243902439025,0.0,1.0,41,1100,700,400,0.6363636363636364,15,7,8,366.4541166652453,0.42604166666666665,0.09914003297443297,0.19472123467321845,127496.31461620607,1144.3098701511744,128640.62448635725,810,0,229.21951219512195,38,3,14,38.2636464614408,0.591282894736842,47.51602564102562,1009.9358974358945,26.57726045883933,0
4327,4,0,0,41,0.0,0.0,1.0,41,850,500,350,0.5882352941176471,12,5,7,367.4405421422872,0.4259146341463415,0.1031168750773801,0.1956372616271091,127577.25180802058,1175.410913872398,128752.66272189298,811,1,230.21951219512195,38,3,14,38.15566835871401,0.5921052631578947,47.43589743589741,1010.2564102564065,26.58569500674754,0
4328,4,0,0,41,0.0,0.0,1.0,41,950,500,450,0.5263157894736842,14,5,9,368.0051791451302,0.42522865853658537,0.10789569360964846,0.1963316970972236,127658.21468195214,1195.7768326758182,128853.99151462797,812,2,231.21951219512195,38,3,14,38.058330690347816,0.5929276315789473,47.355769230769205,1010.5769230769189,26.594129554655762,0
4329,4,1,0,42,0.023809523809523808,0.0,1.0,42,1100,800,300,0.7272727272727273,14,8,6,355.2158270047809,0.42872870692992643,0.10549258295476283,0.1914382801445064,128065.44189453099,698.1743706596923,128763.61626519068,813,0,226.6904761904762,39,3,15,37.96449950258994,0.5953525641025641,46.953124999999986,1012.187499999998,25.95352564102559,0
4330,4,4,2,44,0.08695652173913043,0.043478260869565216,0.9565217391304348,46,1000,700,300,0.7,13,7,6,329.3394188407659,0.43763083735909825,0.1239974250569793,0.18168194430089898,128994.83194527043,-703.310160548991,128291.52178472144,814,0,207.8913043478261,40,6,16,37.67256902761103,0.603125,46.03658536585365,1015.8536585365835,25.396341463414586,0
4331,4,0,0,44,0.0,0.0,1.0,44,1300,1000,300,0.7692307692307693,16,10,6,340.6825484764546,0.4329413319238901,0.12751196172248824,0.18686398444147304,128767.2812111912,-26.246895317434905,128741.03431587377,815,1,218.3181818181818,38,6,16,37.61622807017543,0.6041666666666667,46.26068376068375,1014.9572649572629,26.709401709401654,0
4332,4,0,1,43,0.0,0.022727272727272728,0.9772727272727273,44,950,600,350,0.631578947368421,13,6,7,352.4689834099395,0.43273211768851305,0.112904468412943,0.18567562518916472,127145.88355614012,298.5748137190605,127444.45836985919,816,2,219.3181818181818,38,6,18,38.976209392655385,0.5877192982456141,47.86324786324787,1008.5470085470098,26.5407107512371,8
4333,4,2,1,44,0.044444444444444446,0.022222222222222223,0.9777777777777777,45,1800,1400,400,0.7777777777777778,22,14,8,341.7578913805928,0.43329124579124584,0.13699885452462768,0.1821456893621843,127617.7300347224,-277.12673611109176,127340.6032986113,817,0,215.26666666666668,39,6,16,38.762886597938156,0.5908119658119658,47.39583333333334,1010.4166666666681,25.908119658119695,0
4334,4,1,0,45,0.022222222222222223,0.0,1.0,45,1200,900,300,0.75,15,9,6,340.5640601690787,0.434553872053872,0.14943420405267793,0.18282020941414742,127907.33642578141,-287.8716362847084,127619.4647894967,818,0,216.24444444444444,39,6,18,38.49682919713039,0.59375,47.10937500000001,1011.5625000000013,25.937500000000032,0
4335,4,1,1,45,0.021739130434782608,0.021739130434782608,0.9782608695652174,46,1450,1200,250,0.8275862068965517,17,12,5,331.94622166375115,0.4361312399355877,0.15145397063887045,0.17960562678000308,128223.64501953141,-687.1093749999857,127536.53564453142,819,0,212.52173913043478,39,7,19,38.39189293427955,0.5969551282051282,46.79687500000001,1012.8125000000013,25.969551282051313,0
4336,4,1,1,45,0.021739130434782608,0.021739130434782608,0.9782608695652174,46,1350,800,550,0.5925925925925926,19,8,11,333.0942645677906,0.4367451690821256,0.1470351668975376,0.181061854427073,128408.33875868072,-645.583767361092,127762.75499131963,820,0,213.3913043478261,39,7,14,38.174460431654694,0.5988247863247863,46.61458333333334,1013.541666666668,25.988247863247896,0
4337,4,0,0,45,0.0,0.0,1.0,45,1550,1200,350,0.7741935483870968,19,12,7,335.2427512857911,0.4341329966329966,0.14561680896665652,0.18226062930935813,128415.10662073559,-389.9532699612833,128025.1533507743,821,2,219.13333333333333,38,7,14,38.11311970767015,0.6006030701754386,46.60790598290598,1013.5683760683758,26.672852001799363,0
4338,4,1,1,45,0.021739130434782608,0.021739130434782608,0.9782608695652174,46,1600,1200,400,0.75,20,12,8,327.706191473815,0.43592995169082127,0.14946098379381745,0.17979555910590392,128778.125,-759.7222222222231,128018.40277777778,822,0,215.34782608695653,39,7,16,37.93445539135193,0.6025641025641026,46.25,1015.0,26.025641025641026,0
4339,4,0,2,43,0.0,0.044444444444444446,0.9555555555555556,45,1550,1200,350,0.7741935483870968,19,12,7,334.4574443987384,0.43371212121212116,0.14853493350177205,0.1833243660902258,128740.17373666793,-388.3781001169057,128351.79563655102,823,1,220.95555555555555,38,7,16,37.80178615292838,0.6038925438596492,46.28739316239315,1014.8504273504258,26.70659019343226,0
4340,4,1,0,44,0.022727272727272728,0.0,1.0,44,1050,500,550,0.47619047619047616,16,5,11,334.36576471639665,0.43152087737843553,0.1622946273167185,0.18415301039363083,128929.98598327127,-178.0453283658369,128751.94065490543,824,0,225.8409090909091,38,6,17,37.61089487341329,0.6058114035087719,46.10042735042735,1015.5982905982909,26.72627080521818,0
4341,4,0,1,43,0.0,0.022727272727272728,0.9772727272727273,44,1200,800,400,0.6666666666666666,16,8,8,335.4280880089471,0.43155391120507397,0.15975999082402192,0.18537225712103986,129065.65176647306,-141.551040068671,128924.10072640439,825,1,226.8409090909091,38,6,18,37.445895980093226,0.6071820175438596,45.96688034188034,1016.1324786324785,26.740328385065226,0
4342,4,0,0,43,0.0,0.0,1.0,43,1300,1100,200,0.8461538461538461,15,11,4,344.6800064957258,0.42808693244739754,0.1562643813829494,0.1902469781184389,129016.12548828126,293.8557942708333,129309.9812825521,826,2,232.93023255813952,39,4,19,37.261291397518704,0.6049679487179487,46.015625,1015.9375000000001,26.04967948717949,0
4343,4,1,0,44,0.022727272727272728,0.0,1.0,44,1000,700,300,0.7,13,7,6,343.80769816444507,0.42963794926004223,0.18197561254866068,0.19224176925533037,129527.44904667966,106.77266318415298,129634.2217098638,827,0,228.61363636363637,38,6,14,36.76335537363559,0.611842105263158,45.512820512820504,1017.9487179487166,26.788124156545177,0
4344,4,0,0,44,0.0,0.0,1.0,44,1450,1100,350,0.7586206896551724,18,11,7,346.1785104548213,0.4289662614517266,0.18891042985857398,0.1941817152447953,129651.86767578097,176.53808593747164,129828.40576171844,828,1,229.61363636363637,39,5,14,36.576595581466705,0.6113782051282051,45.390624999999986,1018.4374999999978,26.113782051281994,0
4345,4,0,0,44,0.0,0.0,1.0,44,1250,700,550,0.56,18,7,11,346.6612847041588,0.42877906976744184,0.19461069496849515,0.19511166208147734,129784.51063368039,198.25303819442598,129982.76367187481,829,2,230.61363636363637,39,5,14,36.42958154433312,0.6127136752136753,45.26041666666666,1018.958333333332,26.127136752136717,0
4346,4,1,1,44,0.022222222222222223,0.022222222222222223,0.9777777777777777,45,1000,500,500,0.5,15,5,10,343.1979079975866,0.4294823232323232,0.20755790149276887,0.19502264822884918,130158.86423631762,-65.95001735078728,130092.91421896683,830,0,226.46666666666667,40,5,16,36.13808385618963,0.61484375,44.89329268292683,1020.4268292682922,25.510670731707304,0
4347,4,1,2,43,0.022222222222222223,0.044444444444444446,0.9555555555555556,45,1350,1000,350,0.7407407407407407,17,10,7,342.6905456059979,0.4291456228956229,0.20734693877551047,0.1952539155196964,130262.58680555547,-71.92467694494508,130190.66212861054,831,0,227.3111111111111,37,8,17,36.04591836734695,0.6210585585585586,44.791666666666664,1020.8333333333327,27.590090090090072,0
4348,4,1,0,44,0.022727272727272728,0.0,1.0,44,1650,1300,350,0.7878787878787878,20,13,7,344.47572168863877,0.4292195207892882,0.21983597442313063,0.1976202824424296,130528.564453125,192.7842881944448,130721.34874131944,832,0,230.6818181818182,39,5,15,35.730971797485566,0.6201923076923077,44.53125,1021.875,26.201923076923077,0
4349,4,0,0,44,0.0,0.0,1.0,44,600,200,400,0.3333333333333333,10,2,8,345.10561715079746,0.4289882840028189,0.2166561651578467,0.19811768343279568,130555.177137587,211.06499565974167,130766.24213324675,833,1,231.6818181818182,39,5,15,35.68793955763938,0.6204594017094017,44.50520833333334,1021.9791666666682,26.204594017094056,0
4350,4,0,1,43,0.0,0.022727272727272728,0.9772727272727273,44,900,700,200,0.7777777777777778,11,7,4,344.6169259745426,0.4289332276250881,0.21879226337143565,0.19824563373471063,130635.03146701398,203.80859375000634,130838.84006076398,834,2,232.6818181818182,39,5,15,35.61960804293186,0.6212606837606838,44.427083333333336,1022.2916666666674,26.212606837606856,0
4351,4,0,0,43,0.0,0.0,1.0,43,1050,800,250,0.7619047619047619,13,8,5,351.7095716635405,0.42744093761535623,0.21604300382066577,0.20204767664886758,130581.79253472216,585.3732638888841,131167.16579861104,835,3,239.02325581395348,39,4,15,35.492254382388914,0.6207264957264957,44.479166666666664,1022.0833333333328,26.207264957264943,0
4352,4,0,1,42,0.0,0.023255813953488372,0.9767441860465116,43,1550,1100,450,0.7096774193548387,20,11,9,348.2733892927883,0.42725636766334446,0.21225371529274684,0.20090177062729694,130741.54188368049,506.75998263888533,131248.30186631938,836,4,240.02325581395348,39,4,15,35.41836422896722,0.6223290598290598,44.322916666666664,1022.7083333333328,26.223290598290586,0
4353,4,1,0,43,0.023255813953488372,0.0,1.0,43,1450,1000,450,0.6896551724137931,19,10,9,343.2848834655696,0.4296327057954965,0.22064045153796852,0.1998125334132632,131088.00048828125,400.1057942708327,131488.1062825521,837,0,237.7906976744186,39,4,16,35.195745600651,0.625801282051282,43.984375,1024.0625,26.25801282051282,0
4354,4,0,1,42,0.0,0.023255813953488372,0.9767441860465116,43,600,400,200,0.6666666666666666,8,4,4,343.94458277903317,0.4296327057954965,0.22297581716966697,0.20061393991987034,131168.01757812503,422.9058159722234,131590.92339409725,838,1,238.7906976744186,39,4,16,35.09804420039319,0.6266025641025641,43.90625,1024.3750000000002,26.266025641025646,0
4355,4,0,0,42,0.0,0.0,1.0,42,1600,1200,400,0.75,20,12,8,351.91331935260035,0.42680507162214476,0.22732645044669253,0.20538629453877566,131191.27498584634,833.5914100737893,132024.86639592014,839,2,245.0952380952381,38,4,16,34.87046789724338,0.6285635964912281,43.88354700854701,1024.4658119658122,26.95962663067927,0
4356,4,0,0,42,0.0,0.0,1.0,42,1100,800,300,0.7272727272727273,14,8,6,353.6284146296507,0.4265752032520325,0.22906489534929952,0.20682949714192725,131273.37643363274,884.3991982613727,132157.77563189412,840,3,246.0952380952381,38,4,16,34.74357971921047,0.6293859649122807,43.8034188034188,1024.786324786324,26.968061178587476,0
4357,4,1,0,43,0.023255813953488372,0.0,1.0,43,1250,800,450,0.64,17,8,9,343.7788232772771,0.42693337024732375,0.2304012802003792,0.20299217710107478,131637.38031173046,450.85156912248743,132088.23188085295,841,0,241.34883720930233,37,6,14,34.62876642803718,0.6348536036036037,43.4484649122807,1026.2061403508767,27.735301090564235,0
4358,4,0,0,43,0.0,0.0,1.0,43,1450,800,650,0.5517241379310345,21,8,13,347.0103593113978,0.4269795127353267,0.23497239256946534,0.2055065144992168,131749.92696069946,543.7178987765469,132293.64485947601,842,1,242.34883720930233,37,6,14,34.43240681405532,0.6359797297297297,43.338815789473685,1026.6447368421054,27.747155049786635,0
4359,4,0,0,43,0.0,0.0,1.0,43,1100,800,300,0.7272727272727273,14,8,6,348.6784995993477,0.4265642303433001,0.23745462310484755,0.20695328436295907,131834.36850761788,593.561961372752,132427.93046899064,843,2,243.34883720930233,37,6,14,34.304487863904924,0.6368243243243243,43.25657894736843,1026.9736842105276,27.75604551920345,0
4360,4,0,0,43,0.0,0.0,1.0,43,650,400,250,0.6153846153846154,9,4,5,349.43571049459143,0.4266103728313031,0.2382187839049008,0.20755639189618516,131862.521701389,615.4947916666765,132478.01649305568,844,3,244.34883720930233,37,6,14,34.2566768086545,0.6371058558558558,43.22916666666667,1027.0833333333342,27.75900900900903,0
4361,4,0,1,42,0.0,0.023255813953488372,0.9767441860465116,43,750,500,250,0.6666666666666666,10,5,5,350.66522849895625,0.4261489479512735,0.24183068178997802,0.20875052039613845,131946.99931709754,653.8449330563265,132600.84425015387,845,4,245.34883720930233,37,6,15,34.139985770188545,0.6379504504504505,43.146929824561404,1027.4122807017543,27.767899478425793,0
4362,4,0,1,41,0.0,0.023809523809523808,0.9761904761904762,42,1800,1500,300,0.8333333333333334,21,15,6,355.00338715286495,0.42276422764227645,0.23772174540502378,0.21148993903429736,131975.16453379887,970.3260859110528,132945.49061970992,846,5,251.88095238095238,37,5,15,34.00017340732045,0.6382319819819819,43.11951754385965,1027.5219298245615,27.77086296823139,0
4363,4,0,0,41,0.0,0.0,1.0,41,1000,700,300,0.7,13,7,6,361.4462261931984,0.41996951219512196,0.23768322094534278,0.2149356242069335,131905.8987196657,1335.3778609690949,133241.27658063482,847,6,258.8048780487805,36,5,15,33.90452568881095,0.6394675925925926,43.186936936936945,1027.2522522522531,28.534784784784808,0
4364,4,1,0,42,0.023809523809523808,0.0,1.0,42,1000,500,500,0.5,15,5,10,353.88853346689433,0.42223190089043744,0.2464306732143473,0.2125759631162025,132288.07259706705,963.0464013076269,133251.11899837467,848,0,253.61904761904762,38,4,16,33.71369474157926,0.6395285087719298,42.815170940170944,1028.7393162393168,27.072087269455707,0
4365,4,0,0,42,0.0,0.0,1.0,42,1000,800,200,0.8,12,8,4,354.2100345850613,0.421602787456446,0.2503373819163295,0.213389947664659,132398.00347222234,979.4315919716745,133377.435064194,849,1,254.61904761904762,36,6,16,33.59480431848854,0.6443865740740741,42.70833333333334,1029.1666666666677,28.58796296296299,0
4366,4,0,0,42,0.0,0.0,1.0,42,1050,800,250,0.7619047619047619,13,8,5,355.71375155095967,0.42034456058846303,0.25379640044994356,0.21512212593796146,132542.91453615788,1029.4674742309967,133572.3820103889,850,2,255.61904761904762,36,6,16,33.41034193642461,0.6458333333333333,42.56756756756757,1029.7297297297305,28.603603603603624,0
4367,4,1,0,43,0.023255813953488372,0.0,1.0,43,1150,900,250,0.782608695652174,14,9,5,348.3892904992329,0.42174234034699154,0.25417914619035487,0.21258303040650803,132878.0384950178,658.657110841806,133536.6956058596,851,0,250.65116279069767,37,6,17,33.26232319472509,0.647240990990991,42.242324561403514,1031.0307017543867,27.86569464201045,0
4368,4,0,0,43,0.0,0.0,1.0,43,1300,700,600,0.5384615384615384,19,7,12,348.1927069982643,0.4210732742709487,0.25555937289136854,0.21342965342975045,133047.67001625503,665.2456765543329,133712.91569280936,852,1,251.65116279069767,37,6,17,33.097189747404975,0.6489301801801801,42.077850877192986,1031.6885964912283,27.883475580844006,0
4369,4,0,0,43,0.0,0.0,1.0,43,900,800,100,0.8888888888888888,10,8,2,349.5160755657557,0.4210502030269472,0.26191743090550546,0.21462020177302207,133113.6670524692,705.0733024691433,133818.74035493832,853,2,252.65116279069767,38,5,17,32.99685957828623,0.6477521929824561,42.01388888888889,1031.944444444445,27.156432748538027,0
4370,4,0,0,43,0.0,0.0,1.0,43,1400,800,600,0.5714285714285714,20,8,12,350.6467852477209,0.42061184939091917,0.2674623215373251,0.21563326494450882,133168.79799702324,739.0421825918754,133907.84017961513,854,3,253.65116279069767,38,5,17,32.91239692233379,0.6483004385964912,41.96047008547009,1032.1581196581203,27.16205578047685,0
4371,4,0,0,43,0.0,0.0,1.0,43,1250,700,550,0.56,18,7,11,349.4667300418917,0.4196889996308601,0.2655260318105752,0.21562532264410506,133292.88435570992,716.2856867283965,134009.17004243832,855,4,254.65116279069767,41,2,17,32.818454382425465,0.6445630081300813,41.84027777777778,1032.6388888888891,25.186314363143637,0
4372,4,0,0,43,0.0,0.0,1.0,43,1250,1200,50,0.96,13,12,1,350.1406753555558,0.4189045773348099,0.27060376658855856,0.216339143687044,133344.11144376732,737.8394471214363,134081.95089088875,856,5,255.65116279069767,41,2,17,32.7497158454199,0.6450711382113821,41.7906746031746,1032.8373015873015,25.191153697251256,0
4373,4,0,0,43,0.0,0.0,1.0,43,1000,600,400,0.6,14,6,8,354.3603346255867,0.4183508674787744,0.27521065942878287,0.21987137286676456,133500.54974848026,861.7059438073186,134362.25569228758,857,6,256.6511627906977,37,6,17,32.483974358974365,0.6534346846846847,41.63925438596491,1033.44298245614,27.930891417733516,0
4374,4,0,0,43,0.0,0.0,1.0,43,1100,700,400,0.6363636363636364,15,7,8,350.20543693146567,0.41805094130675524,0.2661147305563174,0.2182353655002296,133660.6567382812,761.737738715278,134422.39447699647,858,7,257.6511627906977,39,4,17,32.43101725932643,0.6514423076923077,41.484375,1034.0624999999995,26.514423076923066,0
4375,4,0,0,43,0.0,0.0,1.0,43,1750,900,850,0.5142857142857142,26,9,17,347.00035896109694,0.417843300110742,0.2600996025037692,0.2169817969425042,133787.44877387796,684.8585498050065,134472.30732368297,859,8,258.6511627906977,40,3,17,32.387033398821195,0.6510416666666667,41.36178861788618,1034.5528455284552,25.86382113821138,0
4376,4,0,0,43,0.0,0.0,1.0,43,1400,1100,300,0.7857142857142857,17,11,6,345.23853784782625,0.4176356589147287,0.25172637424870725,0.21649687619718355,133892.60691387398,644.9775679159194,134537.5844817899,860,9,259.6511627906977,40,3,17,32.32746628698613,0.6520833333333333,41.260162601626014,1034.9593495934957,25.873983739837392,0
4377,4,0,0,43,0.0,0.0,1.0,43,800,400,400,0.5,12,4,8,344.14803176526294,0.41719730527870064,0.24932077315421552,0.216121569146792,133945.2014756427,619.3954904487966,134564.5969660915,861,10,260.6511627906977,40,3,17,32.30312029583088,0.6526041666666667,41.20934959349593,1035.1626016260154,25.879065040650385,0
4378,4,0,0,43,0.0,0.0,1.0,43,1450,900,550,0.6206896551724138,20,9,11,329.3642793642817,0.4172434477667036,0.20584232548912906,0.19238995738995862,131223.97898902764,101.86706821336571,131325.846057241,862,11,261.6511627906977,40,3,17,35.415013555511486,0.6255208333333333,43.85162601626016,1024.593495934959,25.614837398373975,8
4379,4,0,1,42,0.0,0.023255813953488372,0.9767441860465116,43,1350,900,450,0.6666666666666666,18,9,9,328.838654240201,0.41675895164267257,0.19852524106636404,0.1926054974835461,131328.12499999988,37.23540055521164,131365.3604005551,863,12,262.6511627906977,38,5,17,35.323509485094846,0.6299342105263157,43.74999999999999,1024.999999999999,26.97368421052629,0
4380,4,1,1,42,0.023255813953488372,0.023255813953488372,0.9767441860465116,43,1050,800,250,0.7619047619047619,13,8,5,321.52973743038194,0.41802787006275377,0.20034821539609515,0.18987177126152008,131640.81090124912,-134.71292715977333,131506.09797408935,864,0,261.2093023255814,40,3,16,35.19611969366871,0.6296875,43.445121951219505,1026.2195121951208,25.65548780487802,0
4381,4,0,0,42,0.0,0.0,1.0,42,1200,700,500,0.5833333333333334,17,7,10,330.55219150197144,0.4153479481223384,0.19625332366449166,0.1949664123529589,131595.18771701367,299.8155381944212,131895.00325520808,865,14,268.42857142857144,39,3,17,35.010575296108286,0.6308760683760684,43.48958333333332,1026.041666666665,26.30876068376064,0
4382,4,0,0,42,0.0,0.0,1.0,42,1200,800,400,0.6666666666666666,16,8,8,334.2945424138229,0.4155657181571815,0.19670522968676019,0.19772739621523444,131702.0887586804,405.45789930553605,132107.54665798592,866,15,269.42857142857144,39,3,17,34.80693119545362,0.6319444444444444,43.38541666666666,1026.458333333332,26.319444444444407,0
4383,4,0,0,42,0.0,0.0,1.0,42,850,700,150,0.8235294117647058,10,7,3,340.5543711187385,0.4156504065040651,0.20052094649073315,0.20270897781195607,131942.7747938366,586.7377387152583,132529.51253255186,867,16,270.42857142857144,39,3,18,34.403938118895525,0.6343482905982907,43.15104166666666,1027.3958333333317,26.343482905982864,0
4384,4,0,1,41,0.0,0.023809523809523808,0.9761904761904762,42,1150,1000,150,0.8695652173913043,13,10,3,341.01533966398864,0.4154205381339528,0.19749034749034777,0.20350915431560582,132040.89506172814,605.594135802444,132646.48919753058,868,17,271.42857142857144,41,1,18,34.293355855855836,0.6321138211382114,43.05555555555554,1027.7777777777758,25.067750677506726,0
4385,4,0,0,41,0.0,0.0,1.0,41,1200,900,300,0.75,15,9,6,380.8210875657786,0.4148119918699187,0.16636453526697426,0.20985672697773766,128952.3260284507,1678.4588726558277,130630.78490110653,869,18,270.9268292682927,33,8,15,36.408562580437575,0.6161616161616161,46.078431372549026,1015.6862745098048,30.77837195484257,8
4386,4,0,0,41,0.0,0.0,1.0,41,1300,800,500,0.6153846153846154,18,8,10,379.8410352167435,0.4141006097560975,0.1643701858458353,0.21014154136440655,129107.96215698293,1608.100400086513,130716.06255706944,870,19,271.9268292682927,33,8,17,36.2744433055991,0.617739898989899,45.92524509803922,1016.2990196078435,30.79693998811647,0
4387,4,0,0,41,0.0,0.0,1.0,41,1100,500,600,0.45454545454545453,17,5,12,381.2600530251091,0.41417682926829263,0.16641232596774436,0.21125932797884303,129170.2428903547,1649.4907307285714,130819.73362108327,871,20,272.9268292682927,33,8,17,36.1747789833233,0.6183712121212122,45.8639705882353,1016.544117647059,30.804367201426032,0
4388,4,0,1,40,0.0,0.024390243902439025,0.975609756097561,41,1450,1100,350,0.7586206896551724,18,11,7,381.39328429893646,0.4144817073170732,0.16961438888131908,0.21201676363201735,129297.68207644622,1662.6572784406576,130960.33935488688,872,21,273.9268292682927,32,9,18,36.04127870887648,0.6220703125,45.73863636363636,1017.045454545454,31.78267045454544,0
4389,4,1,0,41,0.024390243902439025,0.0,1.0,41,800,400,400,0.5,12,4,8,371.1469370555248,0.41577743902439024,0.17080801854950023,0.20811275620319877,129637.82709775065,1422.9364907727527,131060.7635885234,873,0,269.9512195121951,33,8,15,35.95517448856799,0.6231060606060606,45.40441176470587,1018.3823529411746,30.860071301247718,0
4390,4,0,0,41,0.0,0.0,1.0,41,1350,1000,350,0.7407407407407407,17,10,7,367.13206297541655,0.4153201219512195,0.18074760285094094,0.20707409243712205,129867.92091836716,1335.7355442176622,131203.65646258483,874,1,270.9512195121951,34,7,16,35.8232597523943,0.6231617647058824,45.178571428571416,1019.2857142857127,29.97899159663861,0
4391,4,1,0,42,0.023809523809523808,0.0,1.0,42,1150,800,350,0.6956521739130435,15,8,7,357.52922467997035,0.4192315137437089,0.18109439035847918,0.2035539207522697,130233.05047850218,912.4243130572614,131145.47479155945,875,0,265.4761904761905,35,7,17,35.69719261443095,0.624702380952381,44.82060185185185,1020.7175925925922,29.163359788359777,0
4392,4,0,0,42,0.0,0.0,1.0,42,900,400,500,0.4444444444444444,14,4,10,355.4979491657128,0.4192073170731707,0.1831425008502443,0.2027050684932611,130292.1264815885,863.71675132886,131155.84323291737,876,1,266.4761904761905,35,7,18,35.689098930582325,0.625297619047619,44.762731481481474,1020.9490740740728,29.16997354497351,0
4393,4,0,0,42,0.0,0.0,1.0,42,1350,1000,350,0.7407407407407407,17,10,7,355.9890727076429,0.4188201703445606,0.1810349012183874,0.2042253101322794,130528.56445312501,893.3485243055557,131421.91297743056,877,2,267.4761904761905,35,7,16,35.43684165817194,0.6276785714285714,44.53125,1021.8750000000001,29.196428571428573,0
4394,4,0,0,42,0.0,0.0,1.0,42,1050,600,450,0.5714285714285714,15,6,9,353.8146857277882,0.41863869531552456,0.18148291925465831,0.20344344429347822,130617.28395061727,842.8626543209848,131460.14660493826,878,3,268.4761904761905,35,7,16,35.40251358695652,0.6285714285714286,44.44444444444444,1022.2222222222222,29.206349206349206,0
4395,4,0,1,41,0.0,0.023809523809523808,0.9761904761904762,42,900,700,200,0.7777777777777778,11,7,4,352.2258934549206,0.41822735191637633,0.18110974584492023,0.20315065238692415,130735.62349965703,809.69435871056,131545.31785836758,879,4,269.4761904761905,35,7,16,35.32329862682964,0.6297619047619047,44.3287037037037,1022.6851851851849,29.21957671957671,0
4396,4,1,0,42,0.023809523809523808,0.0,1.0,42,1350,1200,150,0.8888888888888888,15,12,3,350.6070793058959,0.4206470189701897,0.1815316331904009,0.19165309257394805,128631.77237426018,729.5813726146503,129361.35374687483,880,0,265.4047619047619,38,4,18,37.50263296471826,0.602796052631579,46.39423076923076,1014.4230769230755,26.69534412955462,8
4397,4,0,1,41,0.0,0.023809523809523808,0.9761904761904762,42,1500,1200,300,0.8,18,12,6,352.76137015942936,0.419981610530391,0.18165098074590857,0.1937536727893,128821.50472094349,688.6501022718605,129510.15482321534,881,1,266.4047619047619,38,4,18,37.25443766224655,0.6047149122807017,46.20726495726494,1015.1709401709375,26.71502474134046,0
4398,4,1,0,42,0.023809523809523808,0.0,1.0,42,1600,1000,600,0.625,22,10,12,355.6719326208672,0.42033246225319393,0.19346611017549042,0.19657675369498892,129069.04432508658,781.2472873263687,129850.29161241296,882,0,266.42857142857144,39,3,19,36.92817785750897,0.6055021367521367,45.96354166666666,1016.1458333333316,26.055021367521324,0
4399,4,2,1,43,0.045454545454545456,0.022727272727272728,0.9772727272727273,44,950,500,450,0.5263157894736842,14,5,9,340.46546981674777,0.4233394996476392,0.1986794288494007,0.19076874737351057,129609.0282914198,25.683192466889523,129634.7114838867,883,0,255.27272727272728,38,6,18,36.7655545063477,0.6126644736842105,45.43269230769229,1018.2692307692282,26.796558704453375,0
4400,4,0,3,40,0.0,0.06976744186046512,0.9302325581395349,43,1650,1300,350,0.7878787878787878,20,13,7,347.1296626980307,0.42111941675895165,0.20330680344003738,0.1944177350913097,129591.85157933214,397.03514542936705,129988.88672476151,884,1,262.2093023255814,37,6,18,36.613360614545186,0.6143018018018018,45.449561403508774,1018.2017543859652,27.518966334755817,0
4401,4,0,0,40,0.0,0.0,1.0,40,1200,1000,200,0.8333333333333334,14,10,4,369.18444705190285,0.4176148504273504,0.2255266237565825,0.20551668404289997,129352.7228599775,1551.00269274378,130903.72555272128,885,2,277.8,34,6,21,36.295591964111566,0.617953431372549,45.68452380952382,1017.2619047619062,29.919467787114886,0
4402,4,0,1,39,0.0,0.025,0.975,40,1000,700,300,0.7,13,7,6,370.58948606860145,0.4174813034188034,0.22278869778869748,0.2066163299040013,129413.28125000023,1591.8402777778074,131005.12152777804,886,3,278.8,34,6,21,36.198129948129946,0.6185661764705883,45.625000000000014,1017.5000000000018,29.926470588235347,0
4403,4,0,0,39,0.0,0.0,1.0,39,1500,1100,400,0.7333333333333333,19,11,8,371.0189875442819,0.4163292847503374,0.20424775149050278,0.2074451363923689,129525.18332315258,1811.2604756087285,131336.44379876132,887,4,265.5897435897436,35,4,18,36.07317130945612,0.6175595238095238,45.515046296296305,1017.939814814816,29.083994708994744,0
4404,4,0,0,39,0.0,0.0,1.0,39,800,400,400,0.5,12,4,8,373.05447834899144,0.4159356725146199,0.1996097981499434,0.20899371705276268,129602.41280131516,1869.7521000730835,131472.16490138826,888,5,266.5897435897436,36,3,18,35.942684140676846,0.6163194444444444,45.43918918918921,1018.243243243246,28.28453453453461,0
4405,4,0,0,39,0.0,0.0,1.0,39,550,300,250,0.5454545454545454,8,3,5,373.05447834899144,0.4159356725146199,0.1996097981499434,0.20899371705276268,129602.41280131516,1869.7521000730835,131472.16490138826,889,6,267.5897435897436,36,3,18,35.942684140676846,0.6163194444444444,45.43918918918921,1018.243243243246,28.28453453453461,0
4406,4,1,0,40,0.025,0.0,1.0,40,1000,700,300,0.7,13,7,6,368.43732679856134,0.41760149572649574,0.19879006237900598,0.20812456042363484,129927.0027797017,1573.9915166205274,131500.99429632223,890,0,261.875,37,3,19,35.72990607299061,0.6176801801801801,45.12061403508773,1019.5175438596511,27.554528212423005,0
4407,4,1,0,41,0.024390243902439025,0.0,1.0,41,1600,1300,300,0.8125,19,13,6,363.01438987290277,0.4190294715447154,0.20117228386016262,0.20668888443657465,130235.32238476188,1255.4592190810577,131490.78160384294,891,0,256.4634146341463,38,3,20,35.55491591654455,0.6189692982456141,44.81837606837609,1020.7264957264989,26.86122357174997,0
4408,4,0,1,40,0.0,0.024390243902439025,0.975609756097561,41,1250,1000,250,0.8,15,10,5,361.62916013278766,0.4192581300813008,0.2047099546035136,0.20635785580151708,130321.66950660151,1225.6317388606856,131547.3012454622,892,1,257.4634146341463,35,6,20,35.50262601073075,0.6255952380952381,44.7337962962963,1021.0648148148149,29.173280423280424,0
4409,4,0,1,39,0.0,0.025,0.975,40,900,500,400,0.5555555555555556,13,5,8,361.2047913503846,0.4189102564102564,0.19805077062556675,0.206429474020453,130380.7656035666,1418.8314471879387,131799.59705075453,893,2,257.3,35,5,22,35.45349803566033,0.6261904761904762,44.67592592592593,1021.2962962962969,29.179894179894195,0
4410,4,0,0,39,0.0,0.0,1.0,39,1300,800,500,0.6153846153846154,18,8,10,360.70330606177606,0.4182411156095367,0.17542759241513517,0.20708778885081158,130558.134269976,1618.5501328875207,132176.68440286352,894,3,249.71794871794873,35,4,19,35.286428841072116,0.6279761904761905,44.50231481481482,1021.9907407407408,29.19973544973545,0
4411,4,0,0,39,0.0,0.0,1.0,39,1050,800,250,0.7619047619047619,13,8,5,358.18707118220914,0.4177912730544309,0.1726778240248923,0.20627278923231,130676.44702717756,1561.3227666323621,132237.76979380992,895,4,250.71794871794873,35,4,19,35.230831635348274,0.6291666666666667,44.38657407407407,1022.4537037037031,29.212962962962948,0
4412,4,0,1,38,0.0,0.02564102564102564,0.9743589743589743,39,1050,700,350,0.6666666666666666,14,7,7,359.34425162626496,0.4164417453891138,0.17866940418399269,0.20821244252158824,130913.23329260985,1608.5835691015131,132521.81686171136,896,5,251.71794871794873,35,4,20,34.961452914121985,0.631547619047619,44.155092592592595,1023.3796296296306,29.239417989418016,0
4413,4,0,0,38,0.0,0.0,1.0,38,400,300,100,0.75,5,3,2,365.55712771603254,0.41296230440967285,0.18466377161336966,0.21124629444948667,130810.03578514735,1963.708191609974,132773.74397675734,897,7,259.2105263157895,34,4,20,34.90704643314325,0.6326593137254901,44.25595238095238,1022.9761904761901,30.087535014005592,0
4414,4,1,0,39,0.02564102564102564,0.0,1.0,39,1350,1000,350,0.7407407407407407,17,10,7,357.70514249822287,0.4151484480431849,0.18137352909643512,0.20838267320386925,131120.5970963005,1580.5023737568465,132701.09947005735,898,0,253.53846153846155,35,4,21,34.79359720495724,0.6336309523809525,43.95254629629629,1024.1898148148143,29.262566137566125,0
4415,4,0,1,38,0.0,0.02564102564102564,0.9743589743589743,39,900,600,300,0.6666666666666666,12,6,6,371.36666122449003,0.4150922177237966,0.21431794871794896,0.2008317852728234,128203.13169795925,1728.2660590277414,129931.39775698699,899,1,254.53846153846155,35,4,17,37.41476190476189,0.6041666666666667,46.81712962962961,1012.7314814814792,28.935185185185123,8
4416,4,0,0,38,0.0,0.0,1.0,38,1100,900,200,0.8181818181818182,13,9,4,389.2894639442012,0.4131993835941204,0.18035020720395822,0.19770930390731473,125648.36109335702,2186.588047710514,127834.94914106753,900,10,262.2105263157895,36,2,13,39.59503350930399,0.576099537037037,49.352477477477485,1002.5900900900913,27.84972472472476,8
4417,4,4,0,42,0.09523809523809523,0.0,1.0,42,1000,600,400,0.6,14,6,8,367.84593943631853,0.4254742547425474,0.22466072943172155,0.19275127226463104,126930.47337278114,939.4146410323708,127869.88801381351,901,0,238.14285714285714,38,4,16,38.81003498727735,0.5855263157894737,48.07692307692308,1007.6923076923083,26.518218623481797,0
4418,4,1,1,42,0.023255813953488372,0.023255813953488372,0.9767441860465116,43,1400,1000,400,0.7142857142857143,18,10,8,343.5935704538925,0.4279715762273902,0.2061489948758375,0.18100018443553278,127145.8835561401,148.85857257653794,127294.74212871665,902,0,233.58139534883722,38,5,16,39.199991172316395,0.5877192982456141,47.86324786324787,1008.5470085470097,26.540710751237096,7
4419,4,3,1,44,0.06666666666666667,0.022222222222222223,0.9777777777777777,45,1250,800,450,0.64,17,8,9,336.9673225695557,0.4349957912457913,0.2326321900678816,0.18068420227436532,127861.72251966437,-382.9555406834378,127478.76697898093,903,0,224.11111111111111,40,5,17,38.6344034699893,0.5916666666666667,47.154471544715456,1011.3821138211395,25.284552845528488,0
4420,4,0,0,44,0.0,0.0,1.0,44,950,800,150,0.8421052631578947,11,8,3,338.88008695626786,0.4328202078928823,0.2421677338034216,0.18182606498521506,127887.41949443142,-132.30003222286177,127755.11946220856,904,1,230.1590909090909,40,4,17,38.55977259787669,0.5919270833333333,47.12906504065042,1011.4837398373999,25.287093495934997,0
4421,4,1,0,45,0.022222222222222223,0.0,1.0,45,1050,700,350,0.6666666666666666,14,7,7,331.77508483456825,0.4349957912457913,0.2398583855009262,0.17927960399441503,128171.57594601513,-494.39831488752816,127677.1776311276,905,0,226.0222222222222,38,7,18,38.44934761201379,0.5981359649122807,46.8482905982906,1012.6068376068382,26.64754835807469,0
4422,4,0,0,45,0.0,0.0,1.0,45,1350,900,450,0.6666666666666666,18,9,9,326.11707261107654,0.43474326599326596,0.23434641556281677,0.1772992932871797,128415.10662073575,-624.3282699612677,127790.77835077449,906,1,227.0222222222222,38,7,15,38.344357190541444,0.6006030701754386,46.60790598290599,1013.5683760683771,26.6728520017994,0
4423,4,1,1,45,0.021739130434782608,0.021739130434782608,0.9782608695652174,46,950,600,350,0.631578947368421,13,6,7,320.7540008327953,0.43445048309178746,0.24486476355376596,0.17586416601654087,128751.69406467037,-940.4758029513631,127811.21826171901,907,0,223.06521739130434,39,7,16,38.13774419241166,0.6022970085470085,46.27604166666668,1014.8958333333353,26.022970085470135,0
4424,4,1,0,46,0.021739130434782608,0.0,1.0,46,700,400,300,0.5714285714285714,10,4,6,319.8719493295458,0.4361010466988728,0.2441922694412355,0.1760830962176028,128910.3203667536,-953.0409071180443,127957.27945963555,908,0,224.0,39,7,17,37.9988759530892,0.6038995726495726,46.11979166666667,1015.5208333333344,26.038995726495752,0
4425,4,0,1,45,0.0,0.021739130434782608,0.9782608695652174,46,1800,1400,400,0.7777777777777778,22,14,8,337.9893166748035,0.43583937198067635,0.22907893465144236,0.17887871566537047,127334.51727892806,-442.1684470794594,126892.3488318486,909,1,225.0,38,8,13,39.14800995024875,0.5896381578947368,47.67628205128204,1009.2948717948696,26.560391363022884,8
4426,4,1,0,46,0.021739130434782608,0.0,1.0,46,1050,800,250,0.7619047619047619,13,8,5,338.9309463194288,0.43477254428341383,0.21606139120105383,0.17170914843123694,125546.23035556794,-687.1312560472597,124859.09909952068,910,0,225.84782608695653,41,5,14,40.96259816537978,0.5665650406504066,49.45436507936507,1002.1825396825379,24.443476577622878,8
4427,4,1,0,47,0.02127659574468085,0.0,1.0,47,1100,700,400,0.6363636363636364,15,7,8,336.6570798993259,0.43557277212457596,0.2223504907297471,0.17211717836116583,125922.23743314714,-921.4774502734133,125000.75998287373,911,0,222.0212765957447,42,5,17,40.63203964729355,0.5689484126984127,49.07945736434109,1003.6821705426364,23.897194536729437,0
4428,4,4,3,48,0.0784313725490196,0.058823529411764705,0.9411764705882353,51,1200,1000,200,0.8333333333333334,14,10,4,328.104835284274,0.44135620915032675,0.26093731271724785,0.17183795610650965,126909.41044423447,-1872.0230739104697,125037.387370324,912,0,205.52941176470588,45,6,16,39.83279395900753,0.575,48.09782608695652,1007.6086956521744,22.3913043478261,0
4429,4,3,0,51,0.058823529411764705,0.0,1.0,51,1200,900,300,0.75,15,9,6,332.8315289909802,0.4425326797385621,0.29631911167447544,0.17609749144429568,127322.6824827321,-1723.9430080966295,125598.73947463547,913,0,206.27450980392157,40,11,17,39.29026952639882,0.5861979166666667,47.688008130081315,1009.2479674796768,25.231199186991923,0
4430,4,3,2,52,0.05555555555555555,0.037037037037037035,0.962962962962963,54,1200,800,400,0.6666666666666666,16,8,8,320.183919966173,0.44792394595853713,0.31654101457564265,0.1721774124226754,127976.7949828542,-2604.777623536489,125372.01735931772,914,0,195.75925925925927,43,11,20,38.94137030104509,0.5884205426356589,47.0407196969697,1011.8371212121219,23.53109584214237,0
4431,4,1,0,53,0.018867924528301886,0.0,1.0,53,1100,600,500,0.5454545454545454,16,6,10,332.00889829681483,0.44687348814707306,0.33035022271813186,0.17874957662962535,128024.70842121511,-2098.9315204602726,125925.77690075483,915,0,200.33962264150944,43,10,21,38.59332600355573,0.5889050387596899,46.99337121212122,1012.0265151515162,23.53550035236084,0
4432,4,1,2,52,0.018518518518518517,0.037037037037037035,0.962962962962963,54,1350,800,550,0.5925925925925926,19,8,11,328.44853927558296,0.4476182156999767,0.3310359301232835,0.17827764752949593,128350.40655570441,-2368.475102368581,125981.93145333583,916,0,197.61111111111111,40,14,22,38.35121853374787,0.5966145833333334,46.67174796747968,1013.3130081300824,25.33282520325206,0
4433,4,1,0,53,0.018867924528301886,0.0,1.0,53,1350,900,450,0.6666666666666666,18,9,9,330.9623922941075,0.4472968069666183,0.3308634787901239,0.18092369112156537,128633.75491605539,-2085.41294864167,126548.34196741373,917,0,191.9433962264151,40,13,18,37.998814532825754,0.5994791666666667,46.39227642276423,1014.4308943089442,25.360772357723604,0
4434,4,0,0,53,0.0,0.0,1.0,53,1350,600,750,0.4444444444444444,21,6,15,333.7969772943485,0.44732704402515727,0.33479701771158843,0.1829471248771332,128736.86814230958,-2005.6045095511809,126731.2636327584,918,1,192.9433962264151,40,13,18,37.821909005941656,0.6005208333333334,46.29065040650407,1014.8373983739847,25.37093495934962,0
4435,4,2,1,54,0.03636363636363636,0.01818181818181818,0.9818181818181818,55,1500,1100,400,0.7333333333333333,19,11,8,329.7620723869415,0.4492564534231201,0.35630483527321144,0.18422556942783327,129492.78564453112,-2457.128462475329,127035.65718205579,919,0,186.8909090909091,39,16,13,37.15597601746665,0.609775641025641,45.54687499999999,1017.812499999999,26.097756410256384,0
4436,4,0,1,53,0.0,0.018518518518518517,0.9814814814814815,54,1550,1200,350,0.7741935483870968,19,12,7,328.54777272609317,0.4475235849056604,0.3558492046864141,0.17333190643536234,127206.20770485455,-2426.140358758007,124780.06734609653,920,1,191.25925925925927,45,9,19,39.517580287929135,0.5780092592592593,47.80344202898551,1008.786231884058,22.417471819645733,8
4437,4,2,1,54,0.03636363636363636,0.01818181818181818,0.9818181818181818,55,1900,1300,600,0.6842105263157895,25,13,12,328.8340950154112,0.4492424242424242,0.3782567947516411,0.1752577319587629,127617.73003472209,-2606.9878472222276,125010.74218749985,921,0,188.72727272727272,47,8,18,39.08934707903779,0.5797872340425532,47.39583333333333,1010.4166666666655,21.498226950354585,0
4438,4,0,1,53,0.0,0.018518518518518517,0.9814814814814815,54,2200,1400,800,0.6363636363636364,30,14,16,313.83347104441293,0.44702859305846726,0.28873279683386666,0.16149574497565886,126189.83351548918,-2821.972626907909,123367.86088858127,922,1,193.22222222222223,42,12,18,40.9298952004372,0.5716765873015873,48.812984496124045,1004.7480620155065,23.92257290513111,8
4439,4,2,0,55,0.03636363636363636,0.0,1.0,55,1350,700,650,0.5185185185185185,20,7,13,316.8983339970649,0.4496071829405163,0.3295191295191293,0.1655725301258445,126812.07561728435,-2962.6929012345245,123849.38271604983,923,0,190.65454545454546,44,11,15,40.214768339768355,0.5752840909090908,48.194444444444464,1007.2222222222255,22.891414141414216,0
4440,4,2,1,56,0.03508771929824561,0.017543859649122806,0.9824561403508771,57,1850,1400,450,0.7567567567567568,23,14,9,310.0259068253306,0.452890037593985,0.346973803517328,0.16435535517975405,127402.53318877719,-3499.456897335079,123903.0762914421,924,0,184.9298245614035,43,14,12,39.78412359691085,0.5826065891472868,47.60890151515152,1009.5643939393957,23.47824171952083,0
4441,4,1,1,56,0.017543859649122806,0.017543859649122806,0.9824561403508771,57,2050,1600,450,0.7804878048780488,25,16,9,310.52681520602863,0.45222431077694236,0.34917361827100235,0.1654024259327572,127593.81030654594,-3475.7400891012053,124118.07021744474,925,0,185.91228070175438,43,14,15,39.576205986190516,0.5845445736434108,47.41950757575759,1010.3219696969727,23.495859760394715,0
4442,4,0,0,56,0.0,0.0,1.0,56,1450,900,550,0.6206896551724138,20,9,11,319.1284154416518,0.45149485930735933,0.36000260288234953,0.17013656013423048,127629.96890210935,-3053.9300522804983,124576.03884982885,926,1,190.05357142857142,42,14,16,39.32201764480246,0.5863095238095238,47.38372093023256,1010.4651162790706,24.058693244739775,0
4443,4,0,1,55,0.0,0.017857142857142856,0.9821428571428571,56,1650,900,750,0.5454545454545454,24,9,15,316.94866412789395,0.45157602813852815,0.36353678906870357,0.1695919159748947,127776.88108436999,-3100.2576467760255,124676.62343759397,927,2,191.05357142857142,42,14,17,39.227126062232465,0.5877976190476191,47.23837209302326,1011.0465116279074,24.072535991140654,0
4444,4,1,1,55,0.017857142857142856,0.017857142857142856,0.9821428571428571,56,2100,1700,400,0.8095238095238095,25,17,8,312.02102491686236,0.4529423701298701,0.3670615009676723,0.16870805823638318,128195.98458465567,-3198.447028598007,124997.53755605766,928,0,191.19642857142858,40,16,19,38.92456932597424,0.5950520833333333,46.82418699186994,1012.7032520325233,25.31758130081308,0
4445,4,0,0,55,0.0,0.0,1.0,55,1550,1300,250,0.8387096774193549,18,13,5,312.31871876487344,0.4519781144781145,0.36275640189556957,0.16927383124348128,128291.7392002435,-2986.417676972526,125305.32152327096,929,1,195.34545454545454,42,13,19,38.81954407779371,0.5930059523809523,46.7296511627907,1013.0813953488382,24.120985603543765,0
4446,4,1,1,55,0.017857142857142856,0.017857142857142856,0.9821428571428571,56,1500,1000,500,0.6666666666666666,20,10,10,303.26570206813676,0.4530167748917749,0.3589180701684198,0.1658440768890226,128648.39916386905,-3397.0705815254555,125251.32858234359,930,0,192.83928571428572,43,13,18,38.686350695416785,0.595203488372093,46.37784090909092,1014.4886363636384,23.592758985200895,0
4447,4,0,0,55,0.0,0.0,1.0,55,1750,1400,350,0.8,21,14,7,314.6826108419889,0.45039281705948375,0.36970375648987064,0.17239973710545795,128720.46100206637,-2898.781852617053,125821.67914944931,931,1,196.94545454545454,43,12,18,38.323534901082496,0.5959302325581395,46.306818181818194,1014.7727272727293,23.599365750528587,0
4448,4,0,0,55,0.0,0.0,1.0,55,1900,1300,600,0.6842105263157895,25,13,12,317.82317629983817,0.44990179573512906,0.3647273390479657,0.17478680798916924,128872.1236282583,-2808.2904663922827,126063.83316186602,932,2,197.94545454545454,44,11,19,38.08970150161104,0.5961174242424243,46.157407407407426,1015.3703703703736,23.0765993265994,0
4449,4,1,0,56,0.017857142857142856,0.0,1.0,56,1600,1100,500,0.6875,21,11,10,309.71429652080286,0.451075487012987,0.3607371978462586,0.17165054567175225,129178.36757147968,-3198.3225523786646,125980.04501910102,933,0,195.39285714285714,45,11,20,37.984774570079296,0.5979166666666667,45.855978260869584,1016.5760869565256,22.590579710145015,0
4450,4,1,1,56,0.017543859649122806,0.017543859649122806,0.9824561403508771,57,2100,1500,600,0.7142857142857143,27,15,12,302.9946804466892,0.4517543859649123,0.35717146956356527,0.16933505450688685,129507.51135973977,-3551.978493679966,125955.5328660598,934,0,192.94736842105263,44,13,15,37.8221747172443,0.6025094696969697,45.532407407407426,1017.8703703703736,23.133417508417583,0
4451,4,0,1,55,0.0,0.017857142857142856,0.9821428571428571,56,1750,1300,450,0.7428571428571429,22,13,9,296.48073056200207,0.4500135281385282,0.2283978074958386,0.16449855960071827,129222.15497378135,-3522.721525671523,125699.43344810982,935,2,197.39285714285714,50,6,13,38.27675103790009,0.5927083333333334,45.81290849673202,1016.748366013071,20.33496732026142,8
4452,4,0,3,52,0.0,0.05454545454545454,0.9454545454545454,55,1400,1000,400,0.7142857142857143,18,10,8,308.88459104981524,0.44908810325476994,0.14971503316827106,0.167902071000821,128408.33875868027,-2973.8715820104144,125434.46717666986,936,3,197.23636363636365,43,12,11,38.78789825282632,0.592781007751938,46.61458333333332,1013.5416666666644,23.570736434108472,8
4453,4,2,3,51,0.037037037037037035,0.05555555555555555,0.9444444444444444,54,1950,1400,550,0.717948717948718,25,14,11,308.1553218800979,0.4475890985324948,0.19791612678076032,0.16913040938211799,128792.54301717435,-2862.3784901572735,125930.16452701707,937,0,201.27777777777777,43,11,13,38.415916441210314,0.596656976744186,46.235795454545446,1015.0568181818163,23.605972515856195,0
4454,4,1,1,51,0.019230769230769232,0.019230769230769232,0.9807692307692307,52,1750,1400,350,0.8,21,14,7,322.30284293015393,0.4474610356963298,0.21772834268111985,0.16374964016048293,125663.75760445344,-2241.52874626953,123422.22885818391,938,0,205.03846153846155,43,9,15,41.258185367082234,0.564922480620155,49.337121212121204,1002.6515151515135,23.317477096546828,8
4455,4,1,0,52,0.019230769230769232,0.0,1.0,52,1650,1400,250,0.8484848484848485,19,14,5,327.4531861872552,0.4497941804927099,0.22404934687953548,0.1675194871421287,125948.76320018369,-2151.5352387511466,123797.22796143254,939,0,203.71153846153845,43,9,17,40.83569182389937,0.5678294573643411,49.053030303030305,1003.7878787878791,23.343904157857654,0
4456,4,1,1,52,0.018867924528301886,0.018867924528301886,0.9811320754716981,53,1500,900,600,0.6,21,9,12,327.83836141026967,0.45199866956942425,0.24471288148197523,0.16957452096992295,126401.2629407928,-2312.01993520323,124089.24300558957,940,0,200.8490566037736,40,13,13,40.36087249452585,0.5768229166666667,48.60264227642278,1005.5894308943112,25.13973577235778,0
4457,4,2,0,54,0.037037037037037035,0.0,1.0,54,2050,1600,450,0.7804878048780488,25,16,9,327.4448341981671,0.45318687398089913,0.2680334923343983,0.17141905856271028,126892.0264865203,-2489.9722852104055,124402.0542013099,941,0,197.90740740740742,41,13,15,39.86723775764736,0.5802845528455285,48.11507936507935,1007.5396825396806,24.574138598528794,0
4458,4,2,2,54,0.03571428571428571,0.03571428571428571,0.9642857142857143,56,1500,1000,500,0.6666666666666666,20,10,10,340.77600283049736,0.4561214826839827,0.3436578895657296,0.18083514894727862,127442.37075617294,-2232.001921138818,125210.36883503413,942,0,191.80357142857142,38,18,14,38.96721687299403,0.590734649122807,47.56944444444445,1009.7222222222231,26.571637426900608,8
4459,4,2,1,55,0.03571428571428571,0.017857142857142856,0.9821428571428571,56,1900,1600,300,0.8421052631578947,22,16,6,338.4537545357923,0.45508658008658004,0.38719996178325244,0.18264475515454584,128118.16541883702,-2527.5851779513614,125590.58024088565,943,0,192.375,39,17,17,38.3348123949652,0.5958867521367521,46.90104166666668,1012.3958333333351,25.958867521367566,0
4460,4,0,0,55,0.0,0.0,1.0,55,1600,1100,500,0.6875,21,11,10,341.69275779076605,0.45413860830527497,0.3763270286760221,0.18502682863253794,128255.57503270244,-2235.1970603334616,126020.37797236898,944,1,196.1090909090909,37,18,19,38.11250631449809,0.6007882882882882,46.765350877192986,1012.9385964912286,27.37671882408726,0
4461,4,1,0,56,0.017857142857142856,0.0,1.0,56,1700,900,800,0.5294117647058824,25,9,16,335.61663705872894,0.45423430735930737,0.38390224455409827,0.18358384709157186,128658.86843450936,-2563.9886496457125,126094.87978486365,945,0,193.58928571428572,38,18,15,37.855193414771136,0.6030701754385965,46.36752136752136,1014.5299145299138,26.698155645524047,0
4462,4,0,2,54,0.0,0.03571428571428571,0.9642857142857143,56,1950,1400,550,0.717948717948718,25,14,11,333.4164515679089,0.4537743506493506,0.3798040055933971,0.18300344924013293,128794.3915392833,-2611.5661982248544,126182.82534105844,946,1,194.58928571428572,38,18,15,37.77299757920218,0.6044407894736843,46.23397435897436,1015.0641025641021,26.71221322537111,0
4463,4,1,1,54,0.01818181818181818,0.01818181818181818,0.9818181818181818,55,1150,600,550,0.5217391304347826,17,6,11,328.570612864051,0.4543771043771044,0.3757359056969951,0.1813336017251458,129011.37689248673,-2522.130565600114,126489.24632688661,947,0,195.4,38,17,16,37.67527254881342,0.6066337719298245,46.02029914529915,1015.9188034188039,26.73470535312642,0
4464,4,2,4,52,0.03571428571428571,0.07142857142857142,0.9285714285714286,56,1300,700,600,0.5384615384615384,19,7,12,324.12540035678785,0.45475514069264067,0.38512160926089756,0.18111100816417125,129500.26167223696,-2804.9953429760953,126695.26632926086,948,0,192.08928571428572,38,18,16,37.291819740386984,0.6115679824561404,45.53952991452992,1017.8418803418813,26.785312640575825,0
4465,4,1,0,53,0.018867924528301886,0.0,1.0,53,1800,1100,700,0.6111111111111112,25,11,14,346.3719744737763,0.451061320754717,0.3895220655321734,0.19279691473400998,129348.51794249391,-1639.459689000348,127709.05825349357,949,0,202.0,35,18,20,36.88002522092011,0.6157738095238094,45.688657407407405,1017.2453703703696,29.06415343915342,0
4466,4,1,0,54,0.018518518518518517,0.0,1.0,54,1900,1400,500,0.7368421052631579,24,14,10,337.89081429245687,0.45253173771255534,0.3891120996157582,0.19005335631994613,129759.37307633122,-2031.0999538319477,127728.27312249927,950,0,199.24074074074073,37,17,18,36.678504807002454,0.615990990990991,45.28508771929825,1018.8596491228074,27.536747273589388,0
4467,4,0,0,54,0.0,0.0,1.0,54,1750,1200,550,0.6857142857142857,23,12,11,337.2455274750342,0.4520877009084556,0.38727927583349264,0.1902326713232959,129871.11418898118,-2040.3095183133314,127830.80467066786,951,1,200.24074074074073,37,17,18,36.58159423407917,0.6171171171171171,45.175438596491226,1019.2982456140348,27.54860123281175,0
4468,4,0,0,54,0.0,0.0,1.0,54,1700,1100,600,0.6470588235294118,23,11,12,339.1282229159439,0.4516873398555788,0.3916527279968136,0.19184260785391,129982.90339335185,-1983.825792551551,127999.0776008003,952,2,201.24074074074073,37,17,19,36.42025089605735,0.6182432432432432,45.06578947368421,1019.7368421052636,27.56045519203415,0
4469,4,2,1,55,0.03571428571428571,0.017857142857142856,0.9821428571428571,56,1550,1200,350,0.7741935483870968,19,12,7,327.2283184540998,0.45429518398268404,0.39718100114954535,0.18828910278336033,130644.58832137127,-2649.577636440599,127995.01068493066,953,0,195.01785714285714,38,18,15,36.05435956386943,0.6230811403508771,44.417735042735046,1022.3290598290606,26.90339631129107,0
4470,4,0,1,54,0.0,0.01818181818181818,0.9818181818181818,55,1950,1100,850,0.5641025641025641,28,11,17,338.87869611483205,0.4520622895622896,0.4107183602624982,0.19490228771613685,130626.62459843411,-2146.683955640203,128479.94064279391,954,1,199.56363636363636,37,18,16,35.774764024455635,0.6247184684684685,44.435307017543856,1022.2587719298243,27.62861545756282,0
4471,4,1,1,54,0.01818181818181818,0.01818181818181818,0.9818181818181818,55,1400,1000,400,0.7142857142857143,18,10,8,332.87735365023565,0.45231481481481484,0.3210294049333402,0.18773515305288493,129864.12896050337,-2352.355900673771,127511.77305982959,955,0,193.4181818181818,39,16,16,36.69998722534492,0.6135149572649572,45.182291666666664,1019.2708333333325,26.13514957264955,8
4472,4,0,0,54,0.0,0.0,1.0,54,1800,1300,500,0.7222222222222222,23,13,10,342.71488376887237,0.4513888888888889,0.33892789362767317,0.19363695297846947,129935.60209155166,-1893.8270463510821,128041.77504520057,956,1,197.88888888888889,38,16,16,36.37679450906423,0.615953947368421,45.11217948717949,1019.5512820512824,26.83029689608638,0
4473,4,2,2,54,0.03571428571428571,0.03571428571428571,0.9642857142857143,56,2100,1400,700,0.6666666666666666,28,14,14,331.32714381109975,0.45195481601731596,0.34272103991382585,0.1906005034796096,130635.0314670142,-2543.002714599734,128092.02875241447,957,0,191.78571428571428,39,17,16,35.959258881869445,0.6212606837606838,44.42708333333335,1022.2916666666691,26.212606837606902,0
4474,4,0,3,51,0.0,0.05555555555555555,0.9444444444444444,54,1750,1500,250,0.8571428571428571,20,15,5,345.946410626491,0.4502897158164454,0.3541492769867951,0.19824899472433224,130486.54994806094,-1771.7292820867976,128714.82066597414,958,1,199.27777777777777,37,17,17,35.73594118909637,0.6233108108108107,44.57236842105263,1021.7105263157895,27.61379800853485,0
4475,4,1,1,51,0.019230769230769232,0.019230769230769232,0.9807692307692307,52,1600,900,700,0.5625,23,9,14,360.1271477781454,0.4490086098541981,0.360306451489365,0.204915407656426,130210.72035701317,-1021.5169335382219,129189.20342347494,959,0,206.8653846153846,40,12,18,35.653564671910786,0.6153645833333333,44.842479674796756,1020.6300813008141,25.515752032520354,0
4476,4,0,2,49,0.0,0.0392156862745098,0.9607843137254902,51,1900,1500,400,0.7894736842105263,23,15,8,367.01374427321906,0.44702614379084965,0.36910764305722243,0.20911248220218323,130262.5868055558,-638.368055555531,129624.21875000026,960,1,211.7450980392157,40,11,18,35.425170068027214,0.6158854166666667,44.79166666666668,1020.8333333333353,25.520833333333382,0
4477,4,0,1,48,0.0,0.02040816326530612,0.9795918367346939,49,1200,800,400,0.6666666666666666,16,8,8,374.9154152282631,0.44777494331065765,0.36531539996812357,0.2142837673046816,130384.14292800457,-23.394982993187654,130360.74794501139,961,2,217.3469387755102,34,15,18,35.100001942728376,0.6283700980392157,44.67261904761905,1021.3095238095241,30.038515406162475,0
4478,4,0,0,48,0.0,0.0,1.0,48,1550,1000,550,0.6451612903225806,21,10,11,384.46545196975484,0.4478612588652482,0.36496691455759467,0.2202947404173092,130481.60750973198,433.1340409938652,130914.74155072586,962,3,221.89583333333334,33,15,19,34.75708188397105,0.6316287878787878,44.57720588235295,1021.6911764705894,30.960338680926952,0
4479,4,0,2,46,0.0,0.041666666666666664,0.9583333333333334,48,1200,1000,200,0.8333333333333334,14,10,4,379.8608515386009,0.4475749852245863,0.3566216426020805,0.21864912821806354,130657.85147392303,326.3605442177026,130984.21201814074,963,4,222.89583333333334,34,14,17,34.69569942555504,0.6311274509803921,44.40476190476191,1022.3809523809534,30.070028011204514,0
4480,4,0,1,45,0.0,0.021739130434782608,0.9782608695652174,46,1250,1000,250,0.8,15,10,5,387.11310110931106,0.44706119162640906,0.3522022607278268,0.22299895542775822,130688.2812500001,918.2291666666829,131606.51041666677,964,5,229.7826086956522,34,12,17,34.47942135289324,0.6314338235294117,44.37500000000001,1022.5000000000008,30.073529411764728,0
4481,4,0,0,45,0.0,0.0,1.0,45,1100,500,600,0.45454545454545453,17,5,12,401.8318972932788,0.4460016835016835,0.3576651084741702,0.23136532223035355,130669.48596993928,1501.4334931276246,132170.9194630669,965,6,235.37777777777777,33,12,17,34.12229313995765,0.6335227272727273,44.39338235294117,1022.426470588234,30.982620320855574,0
4482,4,0,1,44,0.0,0.022222222222222223,0.9777777777777777,45,1750,1300,450,0.7428571428571429,22,13,9,398.24981214248584,0.4460648148148148,0.35770100681116146,0.2308667319614936,130931.84700963715,1428.7166950113324,132360.5637046485,966,7,236.37777777777777,34,11,19,33.947161800628116,0.6338848039215687,44.13690476190476,1023.4523809523806,30.10154061624649,0
4483,4,0,0,44,0.0,0.0,1.0,44,1500,1200,300,0.8,18,12,6,408.6399655778264,0.4441508104298802,0.3636418072945018,0.23662577757107145,130888.84833958092,1897.2828960015402,132786.13123558246,967,10,242.5909090909091,33,11,19,33.72504990019961,0.6357323232323233,44.17892156862745,1023.2843137254902,31.008615567439097,0
4484,4,2,0,46,0.043478260869565216,0.0,1.0,46,1300,1000,300,0.7692307692307693,16,10,6,391.9299506346311,0.44560185185185186,0.3577264081322953,0.2299359023148193,131390.9388816801,1100.6806276432112,132491.61950932333,968,0,233.0,33,13,21,33.643118973623395,0.6407828282828283,43.68872549019608,1025.2450980392155,31.06803327391562,0
4485,4,0,0,46,0.0,0.0,1.0,46,1450,900,550,0.6206896551724138,20,9,11,393.2197107622101,0.4454408212560386,0.3599362921622731,0.23088205754016938,131422.35145436856,1135.571805315274,132557.92325968383,969,1,234.0,33,13,21,33.57821899525915,0.6410984848484849,43.65808823529412,1025.367647058824,31.071746880570426,0
4486,4,0,0,46,0.0,0.0,1.0,46,1550,1200,350,0.7741935483870968,19,12,7,393.42420572547655,0.44443438003220614,0.35332156256896985,0.2320496063710144,131595.18771701376,1154.5464409722115,132749.73415798598,970,2,235.0,35,11,17,33.39784263959392,0.6383928571428572,43.48958333333333,1026.0416666666656,29.31547619047616,0
4487,4,0,0,46,0.0,0.0,1.0,46,1550,1200,350,0.7741935483870968,19,12,7,387.2011890981073,0.4439009661835749,0.3440020617694992,0.22930833229130804,131749.92696069946,1002.7456765543247,132752.6726372538,971,3,236.0,37,9,17,33.40086421730926,0.6359797297297297,43.338815789473685,1026.6447368421054,27.747155049786635,0
4488,4,0,2,44,0.0,0.043478260869565216,0.9565217391304348,46,1200,800,400,0.6666666666666666,16,8,8,394.68097309534664,0.44378019323671497,0.3537266749270258,0.23477879599557477,131918.83710612878,1213.1709997306853,133132.00810585945,972,4,237.0,37,9,17,33.03792204788843,0.6376689189189189,43.17434210526316,1027.3026315789473,27.7649359886202,0
4489,4,0,0,44,0.0,0.0,1.0,44,1100,800,300,0.7272727272727273,14,8,6,409.3223099719992,0.4408804615926709,0.36905225709218126,0.2418028595950506,131654.57182623856,1977.8306916580636,133632.40251789664,973,16,248.5909090909091,35,9,18,32.92980057140709,0.6389880952380953,43.43171296296295,1026.2731481481458,29.32208994708988,0
4490,4,0,1,43,0.0,0.022727272727272728,0.9772727272727273,44,1400,1000,400,0.7142857142857143,18,10,8,410.6599087015518,0.44039596546863985,0.3726473120925087,0.24278213802435714,131684.26890432075,2015.4899691357768,133699.75887345654,974,17,249.5909090909091,35,9,18,32.86535859269282,0.6392857142857142,43.402777777777764,1026.388888888887,29.325396825396773,0
4491,4,0,0,43,0.0,0.0,1.0,43,1150,800,350,0.6956521739130435,15,8,7,413.3998153669353,0.43906884459210044,0.3663377284655158,0.24466345970549613,131725.00177154178,2291.0182823129026,134016.02005385468,975,18,246.1627906976744,34,9,18,32.75373033360391,0.6418504901960784,43.36309523809523,1026.5476190476177,30.192577030812284,0
4492,4,0,0,43,0.0,0.0,1.0,43,1650,1200,450,0.7272727272727273,21,12,9,413.3998153669353,0.43879198966408267,0.3663377284655158,0.24466345970549613,131725.00177154178,2291.0182823129026,134016.02005385468,976,19,247.1627906976744,34,9,18,32.75373033360391,0.6418504901960784,43.36309523809523,1026.5476190476177,30.192577030812284,0
4493,4,0,0,43,0.0,0.0,1.0,43,1250,1000,250,0.8,15,10,5,399.46001009854785,0.43835363602805466,0.30450432872819655,0.22548753575508199,129899.05698147517,1893.9033757836114,131792.96035725877,977,20,248.1627906976744,37,6,19,34.9677091176365,0.6173986486486487,45.14802631578948,1019.4078947368429,27.551564722617375,8
4494,4,0,0,43,0.0,0.0,1.0,43,1250,700,550,0.56,18,7,11,401.58302459985396,0.43874584717607973,0.30095582795096854,0.22782490615103923,130094.74068944299,1848.7678901200484,131943.50857956303,978,21,249.1627906976744,37,6,19,34.714011894525655,0.6193693693693694,44.9561403508772,1020.175438596492,27.57230915125654,0
4495,4,2,1,44,0.044444444444444446,0.022222222222222223,0.9777777777777777,45,1600,1400,200,0.875,18,14,4,390.38825505680785,0.4400042087542087,0.2984094639723771,0.22473083421598705,130661.65500217052,1201.7550998264273,131863.41010199694,979,0,239.04444444444445,39,6,19,34.42275853285788,0.6215277777777778,44.401041666666686,1022.3958333333363,26.215277777777853,0
4496,4,0,1,43,0.0,0.022727272727272728,0.9772727272727273,44,1400,1100,300,0.7857142857142857,17,11,6,375.4389742739663,0.43980135658914726,0.25577614637872936,0.20791904148498083,129148.44292534716,897.4717881944398,130045.9147135416,980,1,245.47727272727272,39,5,19,36.344964815194366,0.6063034188034189,45.885416666666664,1016.4583333333328,26.063034188034173,8
4497,4,0,2,41,0.0,0.046511627906976744,0.9534883720930233,43,1200,700,500,0.5833333333333334,17,7,10,365.6217774773992,0.43791528239202654,0.18635724678783694,0.19133259498401103,126876.64936262708,732.4932641514342,127609.14262677851,981,2,251.25581395348837,38,5,17,38.921438670908444,0.5849780701754386,48.13034188034189,1007.4786324786337,26.512595591542993,8
4498,4,1,0,42,0.023809523809523808,0.0,1.0,42,850,700,150,0.8235294117647058,10,7,3,369.0677470733531,0.4365442315137437,0.21101539443247996,0.19429757054919922,127120.40323685184,983.5734227117393,128103.97665956357,982,0,255.83333333333334,36,6,18,38.58389168062536,0.5911458333333333,47.88851351351352,1008.445945945947,28.012387387387417,0
4499,4,3,1,44,0.06666666666666667,0.022222222222222223,0.9777777777777777,45,1200,900,300,0.75,15,9,6,353.13416037391124,0.4414772727272727,0.23263560958728147,0.18947408615641775,127887.41949443161,32.28330111048598,127919.70279554209,983,0,239.7111111111111,40,5,18,38.19932851066678,0.5919270833333333,47.129065040650424,1011.4837398374016,25.28709349593504,0
4500,4,0,1,43,0.0,0.022727272727272728,0.9772727272727273,44,1750,1500,250,0.8571428571428571,20,15,5,370.99137864097565,0.4392507928118394,0.19280264986659335,0.196132964247893,127290.80590303158,697.9209074210573,127988.72681045263,984,1,246.1590909090909,36,8,19,38.36020905404903,0.5928819444444444,47.719594594594604,1009.121621621623,28.031156156156197,8
4501,4,0,0,43,0.0,0.0,1.0,43,1800,1500,300,0.8333333333333334,21,15,6,378.1001222763494,0.4357465854558878,0.19759011141519345,0.200453435612506,127404.47108848733,1034.3292194221513,128438.80030790949,985,2,252.86046511627907,36,7,18,38.06399888455105,0.5940393518518519,47.606981981981995,1009.5720720720736,28.04366866866871,0
4502,4,2,0,45,0.044444444444444446,0.0,1.0,45,1350,1000,350,0.7407407407407407,17,10,7,368.99778890876416,0.43817340067340066,0.2285305567281084,0.1991243193450713,128117.48940755366,455.0140623858756,128572.50346993953,986,0,242.57777777777778,38,7,20,37.562438440973686,0.5975877192982456,46.90170940170941,1012.3931623931636,26.641925326135883,0
4503,4,2,1,46,0.0425531914893617,0.02127659574468085,0.9787234042553191,47,1050,700,350,0.6666666666666666,14,7,7,352.10472101288065,0.44260715386987354,0.23620668193858818,0.19305325249456906,128751.69406467004,-333.18128271617036,128418.51278195386,987,0,233.2127659574468,39,8,17,37.34230131034249,0.6022970085470085,46.276041666666664,1014.8958333333325,26.022970085470064,0
4504,4,3,0,49,0.061224489795918366,0.0,1.0,49,950,400,550,0.42105263157894735,15,4,11,348.3529652199765,0.44621598639455784,0.26907107670654473,0.19427376906498658,129424.438288704,-779.7867793455925,128644.6515093584,988,0,224.6122448979592,37,12,20,36.75242456896552,0.6126126126126126,45.61403508771929,1017.543859649121,27.50118539592219,0
4505,4,0,0,49,0.0,0.0,1.0,49,1850,1500,350,0.8108108108108109,22,15,7,350.2964625983671,0.4459325396825397,0.27163629355204866,0.1961413213021404,129581.83235627109,-721.5885017167504,128860.24385455434,989,1,225.6122448979592,38,11,18,36.54293459251487,0.612390350877193,45.45940170940169,1018.1623931623901,26.79374718848395,0
4506,4,0,0,49,0.0,0.0,1.0,49,1600,1100,500,0.6875,21,11,10,355.3654906264109,0.4450999149659864,0.276298023043966,0.19960477500492058,129704.91672091992,-581.4697265625183,129123.44699435741,990,2,226.6122448979592,39,10,18,36.288752258240464,0.6119123931623931,45.33854166666666,1018.6458333333316,26.119123931623886,0
4507,4,1,2,48,0.02,0.04,0.96,50,1500,1000,500,0.6666666666666666,20,10,10,353.41772196118984,0.446547619047619,0.2828770671448495,0.20042977926815947,130081.0994199881,-805.4068345561525,129275.69258543194,991,0,223.06,40,10,19,35.95628279205685,0.6140625,44.96951219512195,1020.1219512195121,25.503048780487802,0
4508,4,1,1,48,0.02040816326530612,0.02040816326530612,0.9795918367346939,49,1500,1000,500,0.6666666666666666,20,10,10,354.9105163881868,0.44534793083900226,0.27080031534716653,0.20208170218837568,130236.6522903033,-555.5284965959486,129681.12379370736,992,0,225.16326530612244,40,9,20,35.76036273728926,0.615625,44.8170731707317,1020.7317073170725,25.518292682926813,0
4509,4,1,0,49,0.02040816326530612,0.0,1.0,49,1600,1000,600,0.625,22,10,12,352.6580584066964,0.4449759070294785,0.278614788691681,0.20169846827213828,130410.31867551865,-601.9371341296384,129808.38154138901,993,0,225.9387755102041,35,14,22,35.64176109537301,0.6264880952380952,44.64699074074074,1021.4120370370367,29.18320105820105,0
4510,4,0,0,49,0.0,0.0,1.0,49,1450,1100,350,0.7586206896551724,18,11,7,348.35155441992157,0.44421414399092973,0.2780431631996283,0.2002054987856048,130598.60365689448,-701.1546822099062,129897.44897468458,994,1,226.9387755102041,37,12,15,35.56103840377602,0.6244369369369369,44.46271929824562,1022.149122807018,27.625651967757243,0
4511,4,0,1,48,0.0,0.02040816326530612,0.9795918367346939,49,1600,1200,400,0.75,20,12,8,354.59358121014986,0.44435586734693877,0.28513657232140055,0.2043844090460975,130710.70545744846,-530.1645698676531,130180.5408875808,995,2,227.9387755102041,37,12,15,35.28799413825147,0.6255630630630631,44.353070175438596,1022.5877192982458,27.637505926979617,0
4512,4,0,1,47,0.0,0.020833333333333332,0.9791666666666666,48,1700,1300,400,0.7647058823529411,21,13,8,356.2308235654647,0.44463837174940896,0.27931430947289804,0.20591777034940742,130821.45317925359,-279.4731987847113,130541.97998046888,996,3,226.91666666666666,39,9,15,35.13400281709262,0.6231303418803419,44.24479166666667,1023.0208333333343,26.231303418803442,0
4513,4,0,1,46,0.0,0.02127659574468085,0.9787234042553191,47,1600,1200,400,0.75,20,12,8,394.84891589194655,0.4429347826086956,0.29368152817263926,0.212944778083361,128093.08824319181,716.462680388752,128809.55092358057,997,4,232.6595744680851,40,7,17,36.93320617073252,0.5940104166666667,46.92581300813008,1012.2967479674792,25.30741869918698,7
4514,4,0,1,45,0.0,0.021739130434782608,0.9782608695652174,46,1800,1400,400,0.7777777777777778,22,14,8,399.8374231570392,0.44164653784219005,0.30300590445517983,0.21591220850480108,128144.53124999997,1047.4268168748763,129191.95806687485,998,5,238.58695652173913,36,10,17,36.754115226337454,0.6015625,46.875,1012.4999999999998,28.124999999999993,0
4515,4,3,2,46,0.0625,0.041666666666666664,0.9583333333333334,48,1000,800,200,0.8,12,8,4,396.03327408996626,0.445811170212766,0.3315730106644794,0.21844550276727087,128989.67013888883,616.8402777777717,129606.5104166666,999,0,216.60416666666666,39,9,17,35.984071643423576,0.6047008547008548,46.041666666666664,1015.8333333333328,26.047008547008534,0
4516,4,1,0,47,0.02127659574468085,0.0,1.0,47,1600,1200,400,0.75,20,12,8,401.4445975897603,0.4444572926302806,0.3390407709528438,0.22279503854195595,129232.53864198869,976.8089496828165,130209.34759167151,1000,0,220.95744680851064,33,14,18,35.59808264031176,0.6190025252525253,45.802696078431374,1016.7892156862748,30.8117944147356,0
4517,4,0,1,46,0.0,0.02127659574468085,0.9787234042553191,47,1150,600,550,0.5217391304347826,17,6,11,399.0214232160429,0.4438791242676534,0.3373395156184724,0.22215136379050107,129357.17520004323,923.2568303056507,130280.43203034888,1001,1,221.95744680851064,33,14,18,35.53224009155525,0.6202651515151515,45.68014705882353,1017.2794117647057,30.826648841354718,0
4518,4,0,0,46,0.0,0.0,1.0,46,850,500,350,0.5882352941176471,12,5,7,403.8148247086451,0.44340780998389695,0.34357249430672954,0.22553343101582357,129481.87183114665,1257.3398752883465,130739.211706435,1002,2,226.56521739130434,33,13,18,35.2828366445916,0.6215277777777778,45.557598039215684,1017.7696078431371,30.841503267973852,0
4519,4,0,0,46,0.0,0.0,1.0,46,1650,1000,650,0.6060606060606061,23,10,13,399.2615238713091,0.44304549114331726,0.3366624825800333,0.22373903738979473,129613.56122470848,1149.9415937928661,130763.50281850135,1003,3,227.56521739130434,35,11,18,35.264169887095555,0.618452380952381,45.42824074074074,1018.2870370370368,29.093915343915338,0
4520,4,0,0,46,0.0,0.0,1.0,46,1200,700,500,0.5833333333333334,17,7,10,400.6131248758356,0.4427536231884058,0.33984346047228686,0.2246650660154541,129643.02722318663,1187.3396508487515,130830.36687403538,1004,4,228.56521739130434,35,11,18,35.1996675758609,0.61875,45.39930555555555,1018.4027777777769,29.097222222222197,0
4521,4,0,0,46,0.0,0.0,1.0,46,950,600,350,0.631578947368421,13,6,7,399.10187092002724,0.44201892109500807,0.3330494675176401,0.22448272303806852,129759.37307633109,1157.4417128347047,130916.81478916579,1005,5,229.56521739130434,37,9,18,35.11936791505236,0.615990990990991,45.28508771929824,1018.8596491228063,27.53674727358936,0
4522,4,0,0,46,0.0,0.0,1.0,46,1450,900,550,0.6206896551724138,20,9,11,397.49629425974217,0.442079307568438,0.33499856484835244,0.22458893641922537,129935.60209155151,1129.784064760015,131065.38615631152,1006,6,230.56521739130434,38,8,18,34.980483076600656,0.615953947368421,45.11217948717948,1019.5512820512812,26.83029689608635,0
4523,4,0,1,45,0.0,0.021739130434782608,0.9782608695652174,46,1250,900,350,0.72,16,9,7,399.00402850383944,0.4422805958132045,0.3363541121005762,0.22575539134968264,129990.07100819997,1173.3123995543833,131163.38340775436,1007,7,231.56521739130434,38,8,18,34.8865025318666,0.6165021929824561,45.05876068376068,1019.7649572649569,26.83591992802518,0
4524,4,1,0,46,0.021739130434782608,0.0,1.0,46,1300,900,400,0.6923076923076923,17,9,8,390.6275908082558,0.44304549114331726,0.32628451590353014,0.22396503753555497,130505.75573979583,997.2565745287703,131503.0123143246,1008,0,218.3695652173913,34,12,17,34.575129131228394,0.6295955882352942,44.55357142857142,1021.7857142857135,30.05252100840334,0
4525,4,1,0,47,0.02127659574468085,0.0,1.0,47,1000,500,500,0.5,15,5,10,375.8534242707955,0.44476564909034844,0.32340040565803974,0.21794569382469792,130942.84664619763,443.0634591478,131385.91010534542,1009,0,214.70212765957447,35,12,18,34.509051415432175,0.6318452380952381,44.126157407407405,1023.4953703703698,29.24272486772485,0
4526,4,0,0,47,0.0,0.0,1.0,47,1250,900,350,0.72,16,9,7,376.8127340785214,0.44488128276287386,0.3278716910889381,0.21917569088709235,131061.33355034703,477.11588541664634,131538.44943576367,1010,1,215.70212765957447,35,12,18,34.36440318752119,0.6330357142857144,44.01041666666666,1023.9583333333318,29.255952380952337,0
4527,4,0,0,47,0.0,0.0,1.0,47,1250,900,350,0.72,16,9,7,372.7986210858951,0.4442067530064755,0.32005769924269756,0.2173430696054129,131150.23389274674,378.5252700617058,131528.75916280845,1011,2,216.70212765957447,35,12,19,34.377118644067785,0.6339285714285714,43.9236111111111,1024.305555555554,29.265873015872973,0
4528,4,0,1,46,0.0,0.02127659574468085,0.9787234042553191,47,1600,900,700,0.5625,23,9,14,369.28424897215876,0.4435707678075856,0.3136339939263164,0.2161322154273707,131299.269603218,297.3504332034653,131596.6200364215,1012,3,217.70212765957447,36,11,19,34.316283924843425,0.6333912037037037,43.77815315315315,1024.8873873873868,28.469094094094075,0
4529,4,0,0,46,0.0,0.0,1.0,46,1050,700,350,0.6666666666666666,14,7,7,353.6481964500881,0.4440418679549114,0.27889413502204086,0.19034305975139115,128012.72922092034,-145.70583767359253,127867.02338324675,1013,4,219.47826086956522,39,7,18,38.058093154915085,0.5948183760683761,47.00520833333334,1011.9791666666683,25.948183760683804,8
4530,4,1,0,47,0.02127659574468085,0.0,1.0,47,1400,1000,400,0.7142857142857143,18,10,8,364.97935788606605,0.44507400555041626,0.2856734731774906,0.1897510483669444,126609.88004474076,-93.5754575838435,126516.30458715692,1014,0,215.7872340425532,36,11,18,39.212217000484884,0.5859375,48.395270270270274,1006.4189189189194,27.956081081081095,8
4531,4,1,0,48,0.020833333333333332,0.0,1.0,48,1750,1200,550,0.6857142857142857,23,12,11,355.9060324905069,0.448082890070922,0.2871700029010731,0.186728781429951,126981.47506925212,-561.3054016620479,126420.16966759007,1015,0,212.27083333333334,37,11,19,39.05842036553525,0.5878378378378378,48.026315789473685,1007.8947368421057,27.240398293029884,0
4532,4,3,0,51,0.058823529411764705,0.0,1.0,51,1500,1100,400,0.7333333333333333,19,11,8,332.7479987377466,0.45184640522875813,0.2960432324989124,0.17883788581421448,127955.29827781422,-1684.5299305921187,126270.7683472221,1016,0,200.72549019607843,38,13,20,38.645503343892976,0.5959429824561404,47.061965811965806,1011.7521367521362,26.625056230319373,0
4533,4,3,1,53,0.05555555555555555,0.018518518518518517,0.9814814814814815,54,1500,1100,400,0.7333333333333333,19,11,8,323.3836555002292,0.4540458304216166,0.3280928168061352,0.17766049078383486,128830.99500868036,-2467.3527287534926,126363.64227992686,1017,0,190.5185185185185,39,15,19,37.990372118475946,0.6030982905982907,46.19791666666666,1015.2083333333318,26.030982905982867,0
4534,4,0,3,50,0.0,0.05660377358490566,0.9433962264150944,53,1900,1300,600,0.6842105263157895,25,13,12,323.45196183327005,0.45248246250604746,0.2919005704785873,0.1723343732339963,127604.89477989297,-2312.7782644775666,125292.1165154154,1018,1,195.0943396226415,40,13,16,39.238416146985855,0.5890625,47.40853658536586,1010.3658536585369,25.259146341463424,8
4535,4,2,1,51,0.038461538461538464,0.019230769230769232,0.9807692307692307,52,1600,1200,400,0.75,20,12,8,331.48273206324455,0.4519466440422322,0.31479542556890583,0.1780847597242096,127938.82118985077,-1918.0980030074566,126020.72318684332,1019,0,192.96153846153845,40,12,19,38.694332831073154,0.5924479166666667,47.07825203252033,1011.68699186992,25.292174796748,0
4536,4,2,0,53,0.03773584905660377,0.0,1.0,53,1150,700,450,0.6086956521739131,16,7,9,324.3114003641977,0.4543269230769231,0.3226455820664538,0.17617116773552677,128381.94580078154,-2272.5237840637915,126109.42201671776,1020,0,190.22641509433961,39,14,15,38.423891629835204,0.5985576923076923,46.640625000000014,1013.4375000000023,25.98557692307698,0
4537,4,1,1,53,0.018518518518518517,0.018518518518518517,0.9814814814814815,54,1400,1100,300,0.7857142857142857,17,11,6,318.28838362892895,0.45618594223153974,0.31627241100503656,0.17444718984184893,128736.86814230958,-2604.9100651067347,126131.95807720284,1021,0,187.6851851851852,40,14,18,38.215376527138005,0.6005208333333334,46.29065040650407,1014.8373983739847,25.37093495934962,0
4538,4,0,1,52,0.0,0.018867924528301886,0.9811320754716981,53,1600,1300,300,0.8125,19,13,6,324.2092353034291,0.45555152394775034,0.3147588426866954,0.17792317814344244,128788.44024720743,-2249.1196543062933,126539.32059290113,1022,1,191.83018867924528,40,13,18,38.01269857161927,0.6010416666666667,46.239837398373986,1015.0406504065047,25.37601626016262,0
4539,4,0,2,50,0.0,0.038461538461538464,0.9615384615384616,52,1900,1500,400,0.7894736842105263,23,15,8,332.040042964034,0.4536041980894922,0.3173606457625684,0.1821023563471613,128762.6529037775,-1849.1286395333464,126913.52426424416,1023,2,196.46153846153845,40,12,18,37.84023397082876,0.60078125,46.265243902439025,1014.9390243902437,25.373475609756092,0
4540,4,1,0,51,0.0196078431372549,0.0,1.0,51,1350,1100,250,0.8148148148148148,16,11,5,333.0028478372649,0.4550653594771242,0.3197110211404286,0.18331139263497975,128910.32036675331,-1614.4992404514092,127295.8211263019,1024,0,198.94117647058823,39,12,20,37.66550842821485,0.6038995726495726,46.11979166666666,1015.520833333332,26.038995726495692,0
4541,4,1,1,51,0.019230769230769232,0.019230769230769232,0.9807692307692307,52,1850,1200,650,0.6486486486486487,25,12,13,342.46482366147194,0.45578022875817,0.3448944860449292,0.18083422931657162,127242.10778061226,-1677.7551352572236,125564.35264535504,1025,0,196.09615384615384,41,11,19,39.12979351032449,0.5838414634146342,47.767857142857146,1008.9285714285716,24.608013937282234,8
4542,4,0,0,51,0.0,0.0,1.0,51,1400,900,500,0.6428571428571429,19,9,10,340.8899829434228,0.4558496732026143,0.3360727635858203,0.1801138709879247,127267.13204089491,-1523.1819058642095,125743.9501350307,1026,1,197.9607843137255,41,10,19,39.143869006652906,0.5840955284552846,47.74305555555555,1009.0277777777766,24.610433604336013,0
4543,4,0,0,51,0.0,0.0,1.0,51,1000,700,300,0.7,13,7,6,339.8684783721377,0.455718954248366,0.33088572562895835,0.17990748693850828,127342.21958459317,-1544.0787194507354,125798.14086514244,1027,2,198.9607843137255,41,10,14,39.092703623615755,0.5848577235772358,47.6686507936508,1009.3253968253973,24.617692605497496,0
4544,4,2,0,53,0.03773584905660377,0.0,1.0,53,2000,1600,400,0.8,24,16,8,331.1025043309138,0.45818214804063856,0.33659797285049176,0.17816933874114016,128003.94483024694,-2123.51466049382,125880.43016975312,1028,0,192.41509433962264,44,9,17,38.63745539390613,0.5873579545454546,47.01388888888889,1011.9444444444447,22.99873737373738,0
4545,4,3,2,54,0.05357142857142857,0.03571428571428571,0.9642857142857143,56,1100,700,400,0.6363636363636364,15,7,8,318.66366675970175,0.4620941558441558,0.35282475281281966,0.17485604553734305,128783.04268260636,-2991.9188779887527,125791.12380461761,1029,0,183.05357142857142,42,14,17,38.158910103420865,0.5979662698412698,46.2451550387597,1015.0193798449624,24.167128091546722,0
4546,4,0,0,54,0.0,0.0,1.0,54,1500,900,600,0.6,21,9,12,325.50106038918545,0.4601385977172141,0.35211973776141536,0.17856307500491989,128773.09032698724,-2416.8445097946615,126356.24581719257,1030,1,182.55555555555554,41,13,17,37.99553236894406,0.599339430894309,46.254960317460316,1014.9801587301583,24.755613627564838,0
4547,4,0,0,54,0.0,0.0,1.0,54,1500,900,600,0.6,21,9,12,325.3222929930224,0.45989110179361753,0.3458521051584067,0.17891852062243857,128873.80248685113,-2414.8958136495485,126458.90667320158,1031,2,183.55555555555554,41,13,17,37.89763475004067,0.6003556910569106,46.15575396825396,1015.3769841269834,24.765292295780082,0
4548,4,1,0,55,0.01818181818181818,0.0,1.0,55,1600,1100,500,0.6875,21,11,10,323.5655074002501,0.46036756453423117,0.35861824887539506,0.1795521840667332,129227.86593966994,-2636.0165366059787,126591.84940306396,1032,0,181.2,39,16,19,37.5824924017348,0.6071047008547008,45.80729166666666,1016.7708333333317,26.071047008546966,0
4549,4,1,1,55,0.017857142857142856,0.017857142857142856,0.9821428571428571,56,1750,1400,350,0.8,21,14,7,318.8203308856941,0.46105925324675323,0.3584980168394687,0.1787378862119959,129630.39852804529,-2934.238689688856,126696.15983835644,1033,0,178.94642857142858,41,15,17,37.29491394706934,0.6079776422764227,45.41170634920634,1018.3531746031731,24.837882307394466,0
4550,4,0,2,53,0.0,0.03636363636363636,0.9636363636363636,55,1250,800,450,0.64,17,8,9,324.3516830415975,0.46102693602693606,0.35812628178369876,0.18152822126875529,129563.26116233706,-2595.1876363276006,126968.07352600947,1034,1,182.47272727272727,40,15,17,37.22216676648699,0.6088541666666667,45.477642276422756,1018.0894308943076,25.45223577235769,0
4551,4,1,0,54,0.018518518518518517,0.0,1.0,54,1500,1000,500,0.6666666666666666,20,10,10,316.59236483265846,0.461827393431167,0.3445179635215643,0.1788685944686767,129933.65698420562,-2572.799252802984,127360.85773140263,1035,0,176.37037037037038,41,13,18,37.04459391521521,0.6110264227642277,45.1140873015873,1019.5436507936499,24.86691831204024,0
4552,4,0,1,53,0.0,0.018518518518518517,0.9814814814814815,54,1500,1000,500,0.6666666666666666,20,10,10,319.79242238396745,0.4608592476123923,0.35150354115871374,0.1812845896842229,130064.8260039208,-2481.2508450514033,127583.5751588694,1036,1,177.37037037037038,42,12,18,36.830293530920486,0.6108630952380952,44.98546511627906,1020.0581395348818,24.287098560354327,0
4553,4,0,1,52,0.0,0.018867924528301886,0.9811320754716981,53,1300,800,500,0.6153846153846154,18,8,10,322.82967902882376,0.4582426221577165,0.3486070179430627,0.18298427562151934,130060.11924445682,-2202.5466899723106,127857.5725544845,1037,2,181.58490566037736,41,12,18,36.75760228230565,0.6122967479674797,44.99007936507935,1020.0396825396806,24.87901664730928,0
4554,4,1,1,52,0.018867924528301886,0.018867924528301886,0.9811320754716981,53,1350,800,550,0.5925925925925926,19,8,11,316.340018751334,0.4586961780358007,0.3479089822466983,0.18047513708363236,130313.2283005794,-2355.1847127740084,127958.0435878054,1038,0,181.64150943396226,41,12,20,36.66723344992875,0.6148373983739837,44.74206349206349,1021.0317460317453,24.90321331784745,0
4555,4,0,1,51,0.0,0.019230769230769232,0.9807692307692307,52,1250,1000,250,0.8,15,10,5,319.5724595248354,0.45897750125691306,0.34619787001094826,0.18232507103043855,130314.46358194533,-2071.0172722916236,128243.44630965371,1039,1,183.5,40,12,21,36.58347433728143,0.61640625,44.74085365853659,1021.0365853658541,25.525914634146353,0
4556,4,0,2,49,0.0,0.0392156862745098,0.9607843137254902,51,1400,1000,400,0.7142857142857143,18,10,8,325.13133643363653,0.4583006535947713,0.3450756348244255,0.18550275667767768,130315.76063368049,-1726.0525173611234,128589.70811631937,1040,2,187.09803921568627,39,12,21,36.44026729238931,0.6180555555555556,44.73958333333333,1021.0416666666661,26.18055555555554,0
4557,4,0,1,48,0.0,0.02040816326530612,0.9795918367346939,49,1400,1000,400,0.7142857142857143,18,10,8,336.96070961168385,0.45790816326530615,0.32981794027355793,0.18484959892960545,128773.09032698743,-1113.8714195168686,127659.21890747055,1041,3,193.0204081632653,41,8,18,37.70474945427296,0.599339430894309,46.25496031746032,1014.9801587301599,24.755613627564877,8
4558,4,1,0,49,0.02040816326530612,0.0,1.0,49,1300,900,400,0.6923076923076923,17,9,8,336.00466584480796,0.4582801870748299,0.34050132793525556,0.18573641620336565,129075.34490937568,-1126.0163729843903,127949.32853639129,1042,0,193.14285714285714,41,8,20,37.42138940414593,0.6023882113821138,45.957341269841265,1016.170634920634,24.784649632210588,0
4559,4,1,2,48,0.02,0.04,0.96,50,1700,1200,500,0.7058823529411765,22,12,10,332.03371420860134,0.45800170068027213,0.3479836189244534,0.1850414915400365,129396.5465936632,-1406.8892463816092,127989.65734728158,1043,0,190.26,37,13,22,37.195885871322346,0.6123310810810811,45.64144736842104,1017.4342105263139,27.49822190611659,0
4560,4,3,2,49,0.058823529411764705,0.0392156862745098,0.9607843137254902,51,2150,1800,350,0.8372093023255814,25,18,7,327.6492227364426,0.45771241830065357,0.3446910839807624,0.18473839154288768,129853.92011834309,-1690.6928007889678,128163.22731755412,1044,0,187.0392156862745,38,13,19,36.843553459119505,0.6151315789473684,45.192307692307686,1019.2307692307683,26.82186234817811,0
4561,4,2,0,51,0.0392156862745098,0.0,1.0,51,1500,1000,500,0.6666666666666666,20,10,10,339.57172367707744,0.45656862745098037,0.3829693359805866,0.19361995263247733,130291.32806793308,-1350.0657237078424,128941.26234422524,1045,0,188.0,36,15,21,36.096404147363785,0.6232638888888888,44.76351351351353,1020.9459459459483,28.359609609609677,0
4562,4,2,1,52,0.03773584905660377,0.018867924528301886,0.9811320754716981,53,1750,1300,450,0.7428571428571429,22,13,9,325.02589496606976,0.45827285921625543,0.37254542551870595,0.18755110865040298,130753.83434007232,-2100.3235946745563,128653.51074539777,1046,0,181.8679245283019,38,15,19,36.00033949650059,0.6241776315789473,44.31089743589744,1022.7564102564103,26.914642375168693,0
4563,4,0,1,51,0.0,0.019230769230769232,0.9807692307692307,52,1650,1300,350,0.7878787878787878,20,13,7,332.0584787766254,0.45701357466063347,0.37449262449262455,0.1911181022292135,130654.64854570657,-1723.0032317635978,128931.64531394298,1047,1,186.3653846153846,37,15,19,35.92074217074219,0.625,44.40789473684212,1022.3684210526332,27.631578947368464,0
4564,4,1,1,51,0.019230769230769232,0.019230769230769232,0.9807692307692307,52,1550,1100,450,0.7096774193548387,20,11,9,339.38184920053186,0.4570371417797889,0.3898926094773343,0.19736866764186276,131054.49631090664,-1504.4965391920377,129549.9997717146,1048,0,186.92307692307693,38,14,20,35.32949881747359,0.6271929824561404,44.017094017094024,1023.9316239316246,26.945569050832226,0
4565,4,0,0,51,0.0,0.0,1.0,51,1750,1100,650,0.6285714285714286,24,11,13,346.4503000697994,0.4563398692810458,0.3905521072917646,0.2010014637135849,130963.11034404833,-1125.558224646029,129837.5521194023,1049,1,191.50980392156862,37,14,21,35.24091680057133,0.6280968468468469,44.106359649122815,1023.5745614035101,27.66417733523,0
4566,4,0,0,51,0.0,0.0,1.0,51,1150,400,750,0.34782608695652173,19,4,15,344.21601720254813,0.455702614379085,0.3859024782333922,0.20060783932649423,131136.55495516476,-1172.1394687340187,129964.41548643073,1050,2,192.50980392156862,38,13,22,35.12286603386531,0.628015350877193,43.93696581196581,1024.252136752137,26.954003598740446,0
4567,4,0,0,51,0.0,0.0,1.0,51,1700,1200,500,0.7058823529411765,22,12,10,345.6911950074035,0.4552124183006536,0.38446125781273377,0.2017728725755379,131194.69536675353,-1129.4297960069407,130065.26557074659,1051,3,193.50980392156862,39,12,22,35.0263726487036,0.6268696581196581,43.880208333333336,1024.479166666667,26.26869658119659,0
4568,4,1,1,51,0.019230769230769232,0.019230769230769232,0.9807692307692307,52,1550,1200,350,0.7741935483870968,19,12,7,332.86096798964036,0.45604732277526394,0.3224883160400933,0.18185744326281578,128610.97965867417,-1832.5917992810691,126778.3878593931,1052,0,190.76923076923077,42,10,13,37.97386479429372,0.5962301587301587,46.414728682170534,1014.3410852713163,24.150978220745625,8
4569,4,1,1,51,0.019230769230769232,0.019230769230769232,0.9807692307692307,52,1350,1000,350,0.7407407407407407,17,10,7,340.317001153037,0.4563301282051282,0.29868692829743315,0.17936770091876242,127167.04976261337,-1567.8403946478084,125599.20936796557,1053,0,191.30769230769232,41,11,16,39.26090538015147,0.5830792682926829,47.842261904761905,1008.6309523809523,24.600754936120786,8
4570,4,2,1,52,0.03773584905660377,0.018867924528301886,0.9811320754716981,53,1650,1200,450,0.7272727272727273,21,12,9,370.86597169498157,0.45854499274310595,0.37778492979844636,0.18783600510253434,125534.75874790008,-1119.8801395215353,124414.87860837854,1054,0,186.58490566037736,38,15,15,40.17435145700072,0.5712719298245614,49.46581196581198,1002.1367521367546,26.37201979307249,8
4571,4,0,2,50,0.0,0.038461538461538464,0.9615384615384616,52,1150,700,450,0.6086956521739131,16,7,9,375.57864357615483,0.4590796254399196,0.3705784803946328,0.1900353070320547,125493.90798130212,-973.4336526623354,124520.47432863979,1055,1,190.51923076923077,37,15,16,40.098581016998615,0.5726351351351351,49.50657894736843,1001.9736842105278,27.08036984352778,0
4572,4,3,0,53,0.05660377358490566,0.0,1.0,53,2000,1400,600,0.7,26,14,12,357.6944463407663,0.465136671504596,0.37380785268981476,0.18432408769002237,126247.3090947575,-1564.8008552281108,124682.50823952939,1056,0,184.37735849056602,35,18,20,39.76892107182618,0.5842261904761905,48.755787037037045,1004.9768518518529,28.713624338624367,0
4573,4,3,3,53,0.05357142857142857,0.05357142857142857,0.9464285714285714,56,1300,900,400,0.6923076923076923,17,9,8,336.5970665325384,0.46722808441558444,0.37646491028843965,0.17672750822117422,127011.23078977653,-2649.678459894799,124361.55232988173,1057,0,175.44642857142858,38,18,17,39.51444091149974,0.5863486842105263,47.996794871794876,1008.012820512821,26.526653171390027,0
4574,4,0,0,53,0.0,0.0,1.0,53,1600,1200,400,0.75,20,12,8,358.1861590857302,0.4641237300435414,0.3776033640551051,0.1863485384114236,126638.21549590133,-1527.9887996104178,125110.2266962909,1058,1,186.1320754716981,36,17,17,39.353975535168196,0.5862268518518519,48.36711711711712,1006.5315315315318,27.959209209209217,0
4575,4,2,1,54,0.03636363636363636,0.01818181818181818,0.9818181818181818,55,1750,1100,650,0.6285714285714286,24,11,13,345.8610102017018,0.4657687991021324,0.38104887888169614,0.18313623982811408,127354.73632812488,-2188.15758061695,125166.57874750793,1059,0,180.3272727272727,35,20,13,38.92866357069143,0.5955357142857143,47.65624999999999,1009.3749999999991,28.839285714285687,0
4576,4,1,1,54,0.01818181818181818,0.01818181818181818,0.9818181818181818,55,1550,700,850,0.45161290322580644,24,7,17,350.85556382187247,0.46585297418630756,0.3831302717900651,0.18699444885011893,127617.73003472229,-2044.9218749999923,125572.8081597223,1060,0,181.3090909090909,37,18,16,38.53307560137456,0.5943130630630631,47.395833333333336,1010.4166666666673,27.308558558558577,0
4577,4,3,4,53,0.05263157894736842,0.07017543859649122,0.9298245614035088,57,1900,1500,400,0.7894736842105263,23,15,8,342.8583480207892,0.46594350459482037,0.40400241831261696,0.18665420908601674,128469.2559377055,-2589.5635581032175,125879.69237960229,1061,0,175.40350877192984,38,19,14,37.86489619559491,0.6011513157894737,46.55448717948718,1013.7820512820516,26.6784750337382,0
4578,4,0,2,51,0.0,0.03773584905660377,0.9622641509433962,53,1150,600,550,0.5217391304347826,17,6,11,370.23375966544563,0.4632468553459119,0.41274188771663023,0.1987931777091868,127916.59216226346,-1128.191832034755,126788.4003302287,1062,1,188.79245283018867,36,17,18,37.73702178188429,0.5992476851851851,47.100225225225216,1011.5990990990979,28.09997497497494,0
4579,4,1,3,49,0.019230769230769232,0.057692307692307696,0.9423076923076923,52,1300,800,500,0.6153846153846154,18,8,10,365.9672475401786,0.4631567370537959,0.3965653687875912,0.19762231367169633,128144.53124999988,-1020.2539110056142,127124.27733899427,1063,0,187.67307692307693,34,18,19,37.61145404663923,0.6056985294117647,46.87499999999999,1012.4999999999991,29.779411764705856,0
4580,4,2,2,49,0.0392156862745098,0.0392156862745098,0.9607843137254902,51,1650,1200,450,0.7272727272727273,21,12,9,357.3371897055948,0.4648039215686275,0.37292708298379296,0.1953874278084553,128643.06205257634,-1006.2099462019816,127636.85210637435,1064,0,174.58823529411765,35,16,17,37.320426887240934,0.6086309523809523,46.383101851851855,1014.4675925925928,28.984788359788368,0
4581,4,0,0,49,0.0,0.0,1.0,49,1350,1000,350,0.7407407407407407,17,10,7,377.1726494793903,0.4635948129251701,0.3863268019645909,0.2054212856578668,128485.9808276865,-107.72043805266964,128378.26038963383,1065,1,182.69387755102042,33,16,19,36.9780964180668,0.6114267676767677,46.53799019607843,1013.8480392156864,30.722667855020802,0
4582,4,1,0,50,0.02,0.0,1.0,50,1350,900,450,0.6666666666666666,18,9,9,369.0629301028902,0.46395408163265306,0.38448874296435287,0.20279437293282523,128838.54875283445,-490.0935374149666,128348.45521541948,1066,0,180.02,34,16,20,36.82330753595998,0.6127450980392157,46.19047619047619,1015.2380952380952,29.859943977591033,0
4583,4,0,0,50,0.0,0.0,1.0,50,950,700,250,0.7368421052631579,12,7,5,374.32800514175636,0.4633503401360544,0.36779731127197457,0.19566225998490738,126829.56271701407,-504.31835494612415,126325.24436206794,1067,1,181.02,35,15,17,38.75064632885213,0.5901785714285714,48.17708333333334,1007.2916666666681,28.779761904761944,7
4584,4,5,2,53,0.09090909090909091,0.03636363636363636,0.9636363636363636,55,1400,1200,200,0.8571428571428571,16,12,4,353.92225132149764,0.46680695847362513,0.4058691632901934,0.19245042889505432,128422.23087873196,-1902.3787667840033,126519.85211194796,1068,0,165.47272727272727,37,18,16,37.63251839030721,0.6024774774774775,46.60087719298246,1013.5964912280706,27.394499762920827,0
4585,4,0,1,52,0.0,0.018867924528301886,0.9811320754716981,53,1200,1000,200,0.8333333333333334,14,10,4,363.53947699299516,0.46494013062409284,0.42776634376043887,0.19732102424511289,128349.69142500426,-1267.9640614283294,127081.72736357593,1069,1,172.52830188679246,35,18,21,37.462997334856276,0.6056547619047619,46.6724537037037,1013.310185185185,28.951719576719572,0
4586,4,2,0,54,0.037037037037037035,0.0,1.0,54,1150,900,250,0.782608695652174,14,9,5,362.46605720745646,0.46462264150943394,0.4429637023071644,0.19941161914823902,128886.73460200077,-1456.5866964937716,127430.147905507,1070,0,169.7962962962963,36,18,18,36.94156408265869,0.6090856481481481,46.143018018018026,1015.427927927929,28.20633133133136,0
4587,4,1,0,55,0.01818181818181818,0.0,1.0,55,2000,1400,600,0.7,26,14,12,349.94340981795625,0.46459034792368126,0.4308850912401212,0.19463941047343042,129319.08543381348,-1948.3604209189107,127370.72501289457,1071,0,167.6909090909091,35,20,19,36.819147322105906,0.6154761904761905,45.717592592592595,1017.12962962963,29.06084656084657,0
4588,4,0,1,54,0.0,0.01818181818181818,0.9818181818181818,55,1550,900,650,0.5806451612903226,22,9,13,349.0163862141807,0.4646043771043771,0.42847686782620964,0.19481538494240602,129459.1186414456,-1963.329249857947,127495.78939158765,1072,1,168.6909090909091,36,19,17,36.700278484747905,0.6148726851851851,45.579954954954964,1017.680180180181,28.268893893893917,0
4589,4,0,1,53,0.0,0.018518518518518517,0.9814814814814815,54,1900,1300,600,0.6842105263157895,25,13,12,352.92405079246487,0.46385103657116233,0.43050344261259554,0.19732784658103794,129525.18332315245,-1657.4895243912854,127867.69379876116,1073,2,172.4814814814815,35,19,17,36.5336602236119,0.6175595238095238,45.5150462962963,1017.939814814815,29.083994708994716,0
4590,4,1,3,51,0.018518518518518517,0.05555555555555555,0.9444444444444444,54,1350,700,650,0.5185185185185185,20,7,13,354.7637629520702,0.46430235266713255,0.43380802686563436,0.19925181095987013,129701.9692670823,-1597.2882641032438,128104.68100297905,1074,0,173.14814814814815,35,19,18,36.30707211301746,0.6193452380952381,45.341435185185176,1018.6342592592578,29.103835978835935,0
4591,4,1,1,51,0.019230769230769232,0.019230769230769232,0.9807692307692307,52,1850,1300,550,0.7027027027027027,24,13,11,346.15806324284057,0.4648849924585219,0.4108167770419435,0.19650326146492064,130118.92804967117,-1391.6567750182699,128727.2712746529,1075,0,169.44230769230768,36,16,19,36.103062913907294,0.6215277777777778,44.93243243243243,1020.2702702702693,28.340840840840812,0
4592,4,0,2,49,0.0,0.0392156862745098,0.9607843137254902,51,1500,1100,400,0.7333333333333333,19,11,8,348.8008972578251,0.46299019607843134,0.4081693577695864,0.19858865155432937,130233.8487135783,-1114.8633430728155,129118.98537050548,1076,1,172.66666666666666,36,15,20,35.919112238893796,0.6226851851851851,44.81981981981981,1020.7207207207197,28.353353353353324,0
4593,4,0,0,49,0.0,0.0,1.0,49,1500,900,600,0.6,21,9,12,365.0738559436785,0.4613272392290249,0.4200242221023218,0.20690648825926897,130055.90284475712,-303.9980120456428,129751.90483271147,1077,2,180.20408163265307,35,14,22,35.6846183668066,0.6229166666666667,44.99421296296295,1020.023148148146,29.14351851851846,0
4594,4,1,0,50,0.02,0.0,1.0,50,1750,1100,650,0.6285714285714286,24,11,13,362.19266693297027,0.460187074829932,0.42172641170123515,0.2082046199095729,130606.84479827466,-538.5394125367602,130068.3053857379,1078,0,177.58,33,17,17,35.19899192742678,0.6328914141414141,44.4546568627451,1022.1813725490192,30.975193107546037,0
4595,4,0,1,49,0.0,0.02,0.98,50,1400,900,500,0.6428571428571429,19,9,10,359.18348894757946,0.459719387755102,0.4157618292959022,0.2068466063469958,130676.44702717755,-612.6355667009705,130063.81146047657,1079,1,178.58,35,15,18,35.20536185948231,0.6291666666666667,44.38657407407407,1022.453703703703,29.212962962962944,0
4596,4,1,1,49,0.02,0.02,0.98,50,1200,700,500,0.5833333333333334,17,7,10,352.69220253106056,0.45956632653061225,0.39957774356718767,0.20533821317653406,131097.37059694823,-752.5959236263341,130344.7746733219,1080,0,176.44,36,14,20,34.945431053441844,0.6313657407407407,43.97522522522522,1024.0990990990986,28.447197197197184,0
4597,4,0,2,47,0.0,0.04081632653061224,0.9591836734693877,49,1750,1100,650,0.6285714285714286,24,11,13,354.34911832074977,0.458687641723356,0.389538933151093,0.20739519154314606,131300.02891514672,-494.7901036857811,130805.23881146093,1081,1,178.24489795918367,37,12,20,34.69818747548232,0.6314752252252251,43.77741228070174,1024.890350877191,27.699739212897054,0
4598,4,0,1,46,0.0,0.02127659574468085,0.9787234042553191,47,1650,1300,350,0.7878787878787878,20,13,7,362.67297414802,0.4559821153253161,0.38827157174685034,0.21226281271518513,131299.269603218,123.73932209235335,131423.00892531037,1082,2,185.19148936170214,36,11,20,34.48567922938871,0.6333912037037037,43.77815315315315,1024.8873873873868,28.469094094094075,0
4599,4,0,1,45,0.0,0.021739130434782608,0.9782608695652174,46,1400,700,700,0.5,21,7,14,370.3573019619783,0.45491143317230276,0.3949104100252834,0.2161090683738366,131183.87972009156,516.9815508075451,131700.8612708991,1083,3,189.97826086956522,36,10,21,34.40557326591183,0.6322337962962963,43.89076576576576,1024.4369369369358,28.45658158158155,0
4600,4,0,0,45,0.0,0.0,1.0,45,1600,1200,400,0.75,20,12,8,373.49646310090196,0.4542718855218855,0.38941607671838163,0.2180864572143258,131209.51753257864,801.2581447187607,132010.7756772974,1084,4,193.9777777777778,35,10,21,34.29921674951045,0.6345238095238095,43.865740740740726,1024.5370370370351,29.27248677248672,0
4601,4,0,0,45,0.0,0.0,1.0,45,1500,1200,300,0.8,18,12,6,373.31421187262896,0.4538089225589226,0.392476315954577,0.2184862753557255,131298.46810967496,803.1168284893491,132101.5849381643,1085,5,194.9777777777778,35,10,21,34.213838697534335,0.6354166666666667,43.778935185185176,1024.8842592592582,29.282407407407376,0
4602,4,0,0,45,0.0,0.0,1.0,45,2150,1700,450,0.7906976744186046,26,17,9,371.38658058194915,0.4534090909090909,0.38936690036116395,0.21824177712849385,131453.76778162253,764.0397621656198,132217.80754378816,1086,6,195.9777777777778,33,12,21,34.10611854684512,0.6414141414141414,43.62745098039216,1025.490196078432,31.075460487225214,0
4603,4,1,0,46,0.021739130434782608,0.0,1.0,46,1450,900,550,0.6206896551724138,20,9,11,360.2154298104501,0.453713768115942,0.3834994267572098,0.21395928541753229,131862.5217013888,299.7829861111054,132162.30468749988,1087,0,192.69565217391303,35,11,20,33.97988505747127,0.6410714285714285,43.229166666666664,1027.0833333333326,29.345238095238074,0
4604,4,0,0,46,0.0,0.0,1.0,46,1950,1500,450,0.7692307692307693,24,15,9,356.2454346238129,0.4535225442834139,0.3792009400705052,0.21259808195292065,132040.89506172843,207.79320987654648,132248.68827160497,1088,1,193.69565217391303,35,11,21,33.90202702702703,0.6428571428571428,43.05555555555556,1027.777777777778,29.365079365079374,0
4605,4,0,0,46,0.0,0.0,1.0,46,2050,1400,650,0.6829268292682927,27,14,13,367.2366282457872,0.4533514492753623,0.37679934483374056,0.20142077848553722,128765.68657487522,289.3240180059148,129055.01059288114,1089,2,194.69565217391303,33,13,18,36.94407550511147,0.6142676767676767,46.262254901960794,1014.9509803921583,30.756090314913887,8
4606,4,1,0,47,0.02127659574468085,0.0,1.0,47,1500,900,600,0.6,21,9,12,360.5368706477241,0.4544596053037311,0.3716860486856375,0.19917036834811164,129050.143494898,-94.53302154194344,128955.61047335606,1090,0,191.53191489361703,34,13,19,36.82386252685023,0.6148897058823529,45.98214285714286,1016.0714285714289,29.884453781512615,0
4607,4,0,1,46,0.0,0.02127659574468085,0.9787234042553191,47,1350,800,550,0.5925925925925926,19,8,11,360.8023718979796,0.45484505087881594,0.374704353265759,0.19962215482132567,129110.63102324282,-83.31561791381142,129027.315405329,1091,1,192.53191489361703,34,13,19,36.75544687829448,0.6155024509803921,45.92261904761906,1016.3095238095254,29.8914565826331,0
4608,4,0,1,45,0.0,0.021739130434782608,0.9782608695652174,46,1300,900,400,0.6923076923076923,17,9,8,361.5923762704219,0.4547101449275362,0.3645543707415444,0.20021243246412854,129140.88010204083,139.2715419501189,129280.15164399095,1092,2,192.43478260869566,34,12,19,36.70453658155698,0.6158088235294117,45.892857142857146,1016.4285714285716,29.89495798319328,0
4609,4,1,1,45,0.021739130434782608,0.021739130434782608,0.9782608695652174,46,1400,1000,400,0.7142857142857143,18,10,8,353.00225734835067,0.4552636876006441,0.26462542323474625,0.18752640465711043,127486.19927300372,-199.4167751735879,127286.78249783012,1093,0,191.84782608695653,39,7,16,38.61365394533266,0.5894764957264957,47.52604166666668,1009.8958333333353,25.894764957265007,8
4610,4,3,0,48,0.0625,0.0,1.0,48,1300,800,500,0.6153846153846154,18,8,10,343.1164833299871,0.45641252955082745,0.2875119990400772,0.18564950291694288,128223.64501953122,-797.4799262152783,127426.16509331594,1094,0,184.72916666666666,39,9,20,38.10905841818368,0.5969551282051282,46.796875,1012.8124999999998,25.969551282051277,0
4611,4,0,1,47,0.0,0.020833333333333332,0.9791666666666666,48,1450,1200,250,0.8275862068965517,17,12,5,343.5319618559219,0.45622783687943264,0.29028491859468697,0.18611968406957355,128276.40109592036,-786.5912543402534,127489.8098415801,1095,1,185.72916666666666,39,9,20,38.044665809768624,0.5974893162393162,46.74479166666668,1013.0208333333352,25.97489316239321,0
4612,4,0,0,47,0.0,0.0,1.0,47,1300,1000,300,0.7692307692307693,16,10,6,346.56876632425445,0.45524976873265494,0.27497791886384815,0.18863575133488011,128461.13281250047,-495.876736111067,127965.2560763894,1096,2,182.10638297872342,39,8,15,37.779147828469654,0.5993589743589743,46.56250000000002,1013.7500000000038,25.99358974358984,0
4613,4,1,3,45,0.020833333333333332,0.0625,0.9375,48,1600,1100,500,0.6875,21,11,10,340.19785551317074,0.45559988179669025,0.2793460126793461,0.18694040575228713,128840.0226799525,-833.7801160023685,128006.24256395013,1097,0,179.29166666666666,40,8,17,37.55442942942943,0.6015625,46.18902439024391,1015.2439024390251,25.381097560975626,0
4614,4,0,0,45,0.0,0.0,1.0,45,1550,1000,550,0.6451612903225806,21,10,11,361.40365230094983,0.45393518518518516,0.29328528528528586,0.1973426082516991,128588.99493113255,294.5064827639165,128883.50141389646,1098,1,190.33333333333334,37,8,17,37.27252252252253,0.6041666666666667,46.436403508771924,1014.2543859649114,27.412280701754362,0
4615,4,1,1,45,0.021739130434782608,0.021739130434782608,0.9782608695652174,46,1450,800,650,0.5517241379310345,21,8,13,356.71184700540744,0.4550825281803543,0.2962917215634604,0.19619151585297417,128875.73964497042,-5.699375410914769,128870.04026955951,1099,0,187.17391304347825,38,8,18,37.0988531144781,0.6052631578947368,46.15384615384615,1015.3846153846155,26.720647773279353,0
4616,4,1,1,45,0.021739130434782608,0.021739130434782608,0.9782608695652174,46,1350,1100,250,0.8148148148148148,16,11,5,345.67320612738536,0.4551127214170692,0.2991803278688534,0.1916915052160954,129201.38888888877,-267.29741946089086,128934.09146942788,1100,0,187.6304347826087,37,9,20,37.04747267759565,0.6103603603603603,45.83333333333333,1016.6666666666657,27.477477477477454,0
4617,4,1,0,46,0.021739130434782608,0.0,1.0,46,1250,800,450,0.64,17,8,9,344.5046904568586,0.45635064412238324,0.32516198175843036,0.1932428203440451,129651.86767578126,-266.86469184027726,129385.00298394098,1101,0,187.95652173913044,39,7,16,36.619212607821076,0.6113782051282051,45.390625,1018.4375000000001,26.113782051282055,0
4618,4,0,1,45,0.0,0.021739130434782608,0.9782608695652174,46,950,600,350,0.631578947368421,13,6,7,347.23006344068483,0.4559078099838969,0.330354761269672,0.19516724255459184,129731.44531250001,-190.66840277777646,129540.77690972223,1102,1,188.95652173913044,39,7,16,36.46898432174505,0.6121794871794872,45.3125,1018.7500000000001,26.121794871794876,0
4619,4,0,0,45,0.0,0.0,1.0,45,1450,1100,350,0.7586206896551724,18,11,7,357.12800519303414,0.4538510101010101,0.3434025592615906,0.20052169620202492,129690.63321827729,263.2314266929501,129953.86464497024,1103,2,194.11111111111111,38,7,16,36.258391021606876,0.6134868421052632,45.352564102564095,1018.5897435897423,26.80499325236164,0
4620,4,0,1,44,0.0,0.022222222222222223,0.9777777777777777,45,1300,1000,300,0.7692307692307693,16,10,6,355.5910930306021,0.4534722222222222,0.34113522265320184,0.20035342211570656,129826.69850107742,233.04352491050554,130059.74202598793,1104,3,195.11111111111111,38,7,17,36.15923227452215,0.6148574561403508,45.21901709401709,1019.123931623931,26.81905083220871,0
4621,4,0,0,44,0.0,0.0,1.0,44,1250,800,450,0.64,17,8,9,361.7510639703097,0.4518366807610994,0.3460367942068696,0.20318424330617754,129703.52055440133,584.0773122499209,130287.59786665125,1105,4,200.4318181818182,37,7,17,36.1275565123789,0.615427927927928,45.33991228070175,1018.6403508771928,27.530820293978184,0
4622,4,1,1,44,0.022222222222222223,0.022222222222222223,0.9777777777777777,45,1650,1000,650,0.6060606060606061,23,10,13,359.65198164187785,0.45355639730639735,0.3554299274148527,0.20448784099066772,130180.80210387906,363.95668967785025,130544.75879355692,1106,0,196.95555555555555,38,7,18,35.69605841708544,0.618421052631579,44.871794871794876,1020.5128205128208,26.855600539811075,0
4623,4,1,0,45,0.022222222222222223,0.0,1.0,45,1350,1300,50,0.9629629629629629,14,13,1,360.82744111111583,0.4533249158249158,0.3590000477076474,0.20647840549085716,130430.54112803948,412.6093617107546,130843.15048975023,1107,0,197.35555555555555,37,8,20,35.41264133390582,0.6227477477477478,44.627192982456144,1021.491228070176,27.607871028923675,0
4624,4,0,0,45,0.0,0.0,1.0,45,1700,1300,400,0.7647058823529411,21,13,8,359.1214624427137,0.45307239057239057,0.3621787949512896,0.2066406057795748,130644.58832137121,383.45512363942544,131028.04344501064,1108,1,198.35555555555555,38,7,19,35.23922736614763,0.6230811403508771,44.417735042735046,1022.3290598290602,26.903396311291058,0
4625,4,2,0,47,0.0425531914893617,0.0,1.0,47,1400,1100,300,0.7857142857142857,17,11,6,347.96418851789093,0.4530334566759174,0.35842555724920033,0.20270422496435322,131119.8742894443,-274.99586886111274,130844.87842058319,1109,0,190.87234042553192,40,7,21,35.043742144605396,0.6244791666666667,43.95325203252033,1024.1869918699201,25.604674796748004,0
4626,4,0,3,44,0.0,0.06382978723404255,0.9361702127659575,47,1550,1100,450,0.7096774193548387,20,11,9,322.3341037155607,0.4524552883132902,0.23933506909673574,0.17666456419887946,128736.86814230928,-1100.5781528852049,127636.28998942407,1110,1,191.87234042553192,40,7,13,38.11273282595635,0.6005208333333334,46.29065040650406,1014.8373983739822,25.370934959349555,8
4627,4,1,0,45,0.022222222222222223,0.0,1.0,45,1550,1200,350,0.7741935483870968,19,12,7,333.61613383513793,0.4531144781144781,0.25959149294588313,0.18273852590346829,128713.06911571333,-411.8487015121684,128301.22041420116,1111,0,198.82222222222222,38,7,16,37.85073173299642,0.6036184210526316,46.31410256410256,1014.7435897435896,26.703778677462886,0
4628,4,0,0,45,0.0,0.0,1.0,45,1300,900,400,0.6923076923076923,17,9,8,334.8078809540268,0.4527988215488215,0.25968635301968623,0.18397858804899525,128840.02267995267,-372.66900489124066,128467.35367506143,1112,1,199.82222222222222,40,5,16,37.691232899566245,0.6015625,46.189024390243915,1015.2439024390264,25.38109756097566,0
4629,4,0,1,44,0.0,0.022222222222222223,0.9777777777777777,45,1250,900,350,0.72,16,9,7,333.5241407597243,0.45235690235690235,0.26133511200044457,0.1838705894590982,128969.02394614673,-397.14342074820024,128571.88052539853,1113,2,200.82222222222222,40,5,16,37.59254627313658,0.6028645833333333,46.061991869918714,1015.7520325203272,25.39380081300818,0
4630,4,1,0,45,0.022222222222222223,0.0,1.0,45,1000,500,500,0.5,15,5,10,332.1802606260719,0.45290404040404036,0.2583919385839193,0.18384807894418098,129123.91067031882,-421.5171400951567,128702.39353022366,1114,0,200.0222222222222,40,5,17,37.469169749691694,0.6044270833333334,45.90955284552847,1016.361788617888,25.4090447154472,0
4631,4,0,2,43,0.0,0.044444444444444446,0.9555555555555556,45,1500,1100,400,0.7333333333333333,19,11,8,343.6850971093033,0.45250420875420877,0.20590557856744907,0.17813373338309324,126484.64551592806,-305.7527516360137,126178.89276429205,1115,1,201.0222222222222,37,8,13,39.876734975655815,0.5827702702702703,48.51973684210527,1005.9210526315796,27.187055476529178,8
4632,4,1,1,43,0.022727272727272728,0.022727272727272728,0.9772727272727273,44,1150,1000,150,0.8695652173913043,13,10,3,378.1893487261845,0.4528166842847075,0.2543950572119582,0.19785274349148824,126865.01323959102,795.799346643947,127660.81258623497,1116,0,206.45454545454547,36,8,15,38.616886504210434,0.5885416666666667,48.141891891891895,1007.4324324324331,27.98423423423425,0
4633,4,4,2,45,0.0851063829787234,0.0425531914893617,0.9574468085106383,47,700,400,300,0.5714285714285714,10,4,6,350.06529607733324,0.4565988282454518,0.24401369799985573,0.18792062411315544,127907.33642578124,-444.6131751208558,127462.72325066038,1117,0,185.0,39,8,13,38.25655184841931,0.59375,47.109375,1011.5624999999999,25.937499999999996,0
4634,4,1,0,46,0.021739130434782608,0.0,1.0,46,600,300,300,0.5,9,3,6,352.5045395794958,0.4561392914653784,0.2557082835550426,0.18997707216272658,128065.44189453122,-171.27007378472308,127894.1718207465,1118,0,188.58695652173913,39,7,16,38.03310778360947,0.5953525641025641,46.953125,1012.1874999999998,25.953525641025635,0
4635,4,0,0,46,0.0,0.0,1.0,46,1200,600,600,0.5,18,6,12,356.8298349623458,0.45617954911433173,0.25774628508530517,0.19307915727414582,128225.67389875073,-49.02637489214874,128176.64752385858,1119,1,189.58695652173913,38,8,17,37.75975738396623,0.5986842105263157,46.79487179487179,1012.820512820512,26.653171390013473,0
4636,4,0,2,44,0.0,0.043478260869565216,0.9565217391304348,46,1350,900,450,0.6666666666666666,18,9,9,356.3770347483948,0.45558574879227054,0.26455082243779016,0.1933569678234425,128333.90404704504,-52.94876360581645,128280.95528343922,1120,2,190.58695652173913,38,8,17,37.660577463798674,0.5997807017543859,46.68803418803419,1013.2478632478629,26.66441745389113,0
4637,4,1,2,43,0.022222222222222223,0.044444444444444446,0.9555555555555556,45,1450,1000,450,0.6896551724137931,19,10,9,356.3421313805469,0.45494528619528624,0.2663590261254116,0.1940364750732944,128477.80687326878,156.41110726378298,128634.21798053257,1121,0,193.17777777777778,37,8,11,37.514420650371335,0.6030405405405406,46.54605263157895,1013.815789473685,27.400426742532026,0
4638,4,0,0,43,0.0,0.0,1.0,43,1500,1200,300,0.8,18,12,6,368.5505982730217,0.45378829826504247,0.2611035922019149,0.20087346167374645,128515.36502718953,872.8829336093081,129388.24796079884,1122,4,189.4418604651163,36,7,12,37.16658337035392,0.6053240740740741,46.50900900900902,1013.9639639639654,28.165665665665706,0
4639,4,1,1,43,0.022727272727272728,0.022727272727272728,0.9772727272727273,44,1350,1000,350,0.7407407407407407,17,10,7,361.7000163573433,0.4548317477096547,0.25960735991516914,0.19875254904763448,128839.34389667978,520.2385589796932,129359.58245565947,1123,0,186.11363636363637,37,7,13,37.00937376246536,0.6067004504504505,46.189692982456144,1015.2412280701757,27.43895211000475,0
4640,4,0,1,42,0.0,0.023255813953488372,0.9767441860465116,43,1400,1000,400,0.7142857142857143,18,10,8,385.51756970923606,0.4551956441491325,0.22145745200027234,0.20295392607990015,127119.65610812981,1209.6980561326975,128329.3541642625,1124,1,177.90697674418604,37,6,15,38.169942191294275,0.5892454954954955,47.88925438596493,1008.4429824561436,27.255215742057935,8
4641,4,2,2,42,0.045454545454545456,0.045454545454545456,0.9545454545454546,44,1100,600,500,0.5454545454545454,16,6,10,376.5487739750521,0.4565495066948555,0.22807565821105036,0.2002189037772859,127523.29082657621,803.747762802263,128327.03858937847,1125,0,174.6590909090909,38,6,15,37.98105740074749,0.5915570175438596,47.489316239316246,1010.0427350427361,26.580071974808845,0
4642,4,3,0,45,0.06666666666666667,0.0,1.0,45,1300,900,400,0.6923076923076923,17,9,8,372.1613734128125,0.4593644781144781,0.24316604347478088,0.20057083003063236,128065.44189453137,532.2021484375148,128597.64404296888,1126,0,171.0,39,6,18,37.53569774621798,0.5953525641025641,46.95312500000001,1012.1875000000009,25.953525641025664,0
4643,4,0,0,45,0.0,0.0,1.0,45,1150,600,550,0.5217391304347826,17,6,11,368.7270988899839,0.4592382154882155,0.24239054546377758,0.19984323817857755,128291.057487247,460.9755444101398,128752.03303165715,1127,1,172.0,35,10,18,37.391584789976775,0.6050595238095238,46.73032407407407,1013.078703703703,28.945105820105802,0
4644,4,0,1,44,0.0,0.022222222222222223,0.9777777777777777,45,1400,1000,400,0.7142857142857143,18,10,8,369.38502888628153,0.45871212121212124,0.23726714379980773,0.2006411484446821,128379.01341735228,484.25711591217976,128863.27053326445,1128,2,173.0,35,10,14,37.28490939546216,0.605952380952381,46.643518518518505,1013.4259259259238,28.955026455026395,0
4645,4,0,1,43,0.0,0.022727272727272728,0.9772727272727273,44,1000,600,400,0.6,14,6,8,372.03355159897905,0.45902704369274133,0.23740093887234348,0.20291714913075748,128543.91289515869,764.5296901631375,129308.44258532183,1129,3,176.61363636363637,36,8,15,37.04909309642791,0.6056134259259259,46.48085585585586,1014.0765765765767,28.168793793793796,0
4646,4,0,0,43,0.0,0.0,1.0,43,1100,700,400,0.6363636363636364,15,7,8,379.5534253060247,0.4591638981173865,0.24067989149764046,0.2070764080031996,128555.01570001707,1158.699309842244,129713.71500985931,1130,4,171.13953488372093,35,8,15,36.84708590124022,0.6077380952380953,46.469907407407405,1014.1203703703698,28.974867724867707,0
4647,4,0,2,41,0.0,0.046511627906976744,0.9534883720930233,43,1100,900,200,0.8181818181818182,13,9,4,378.2534816944881,0.4587486157253599,0.2391480827085628,0.20697690515192763,128672.41753472216,1134.157986111106,129806.57552083327,1131,5,172.13953488372093,35,8,15,36.75992470910335,0.6089285714285715,46.354166666666664,1014.5833333333328,28.988095238095223,0
4648,4,0,0,41,0.0,0.0,1.0,41,1200,800,400,0.6666666666666666,16,8,8,396.06889567182054,0.4553353658536585,0.24753678596292494,0.21487517253376706,128330.72015570929,1965.5613225682362,130296.28147827752,1132,6,181.29268292682926,33,8,17,36.65840187066601,0.6098484848484849,46.69117647058823,1013.2352941176466,30.704099821746865,0
4649,4,0,1,40,0.0,0.024390243902439025,0.975609756097561,41,1350,800,550,0.5925925925925926,19,8,11,394.10865923654853,0.45457317073170733,0.23997434715513988,0.21508082434568573,128566.75347222213,1933.8541666666565,130500.60763888879,1133,7,182.29268292682926,34,7,16,36.46603670227335,0.6099877450980392,46.45833333333333,1014.1666666666658,29.828431372548994,0
4650,4,0,1,39,0.0,0.025,0.975,40,1350,900,450,0.6666666666666666,18,9,9,394.27144157058666,0.4535523504273504,0.23970312133302052,0.21565989891299994,128657.3200113379,2145.1814058956948,130802.5014172336,1134,8,186.125,34,6,17,36.36910349683172,0.610906862745098,46.36904761904762,1014.5238095238097,29.838935574229698,0
4651,4,0,1,38,0.0,0.02564102564102564,0.9743589743589743,39,1200,1000,200,0.8333333333333334,14,10,4,393.0938585969535,0.45310391363022945,0.2256193673368707,0.2153426767789481,128717.71541950115,2319.628684807258,131037.34410430842,1135,9,188.02564102564102,34,5,17,36.33710699202252,0.6115196078431373,46.30952380952381,1014.7619047619048,29.84593837535014,0
4652,4,2,0,40,0.05,0.0,1.0,40,1200,800,400,0.6666666666666666,16,8,8,380.0218128686932,0.4551282051282051,0.2273709167544784,0.21090099439321053,129231.64859693882,1823.0761054421814,131054.72470238099,1136,0,184.025,34,6,19,36.14355266752527,0.6167279411764706,45.80357142857143,1016.7857142857147,29.90546218487396,0
4653,4,0,1,39,0.0,0.025,0.975,40,1200,800,400,0.6666666666666666,16,8,8,379.206359852151,0.45547542735042734,0.22997425093632962,0.21093353766775896,129322.44897959188,1807.979024943313,131130.42800453518,1137,1,185.025,34,6,19,36.07160970661672,0.6176470588235294,45.714285714285715,1017.1428571428575,29.91596638655463,0
4654,4,0,1,38,0.0,0.02564102564102564,0.9743589743589743,39,1100,700,400,0.6363636363636364,15,7,8,373.96510966670337,0.45518443544759335,0.21951885210745892,0.20881957691317096,129473.85381235827,1883.7407879818586,131357.59460034012,1138,2,188.6153846153846,34,5,17,36.05051273053378,0.6191789215686274,45.56547619047619,1017.7380952380952,29.93347338935574,0
4655,4,1,1,38,0.02564102564102564,0.02564102564102564,0.9743589743589743,39,1350,800,550,0.5925925925925926,19,8,11,367.36287011966107,0.455100089968511,0.22828300982506566,0.20688330054107223,129807.25623582762,1737.273242630377,131544.529478458,1139,0,188.76923076923077,34,5,18,35.879088785046726,0.6225490196078431,45.238095238095234,1019.0476190476187,29.971988795518197,0
4656,4,0,0,38,0.0,0.0,1.0,38,1000,700,300,0.7,13,7,6,376.37448798346895,0.45329540066382173,0.23859628013602774,0.21121190882043273,129669.02941476826,2160.82291065935,131829.8523254276,1140,1,194.6578947368421,33,5,18,35.79029298520033,0.6234217171717171,45.373774509803916,1018.5049019607835,30.86378490790253,0
4657,4,0,0,38,0.0,0.0,1.0,38,1300,1000,300,0.7692307692307693,16,10,6,374.41295411109866,0.4532509483167378,0.2369497363039501,0.21044590179347955,129731.44531249999,2114.626736111111,131846.0720486111,1141,2,195.6578947368421,33,5,18,35.77667007498295,0.6240530303030303,45.3125,1018.7499999999999,30.871212121212118,0
4658,4,0,0,38,0.0,0.0,1.0,38,950,600,350,0.631578947368421,13,6,7,374.51955599264426,0.4527619724988146,0.24090431657407518,0.21134692447400366,129887.5507617262,2129.0855680507448,132016.63632977696,1142,3,196.6578947368421,33,5,18,35.61503165825118,0.6256313131313131,45.15931372549019,1019.3627450980388,30.889780154486022,0
4659,4,0,0,38,0.0,0.0,1.0,38,1250,1000,250,0.8,15,10,5,352.39183015318434,0.4511024182076813,0.22131147540983553,0.19541728763040234,129201.38888888896,1505.9027777777828,130707.29166666674,1143,4,197.6578947368421,35,3,19,36.87670765027322,0.6142857142857143,45.833333333333336,1016.6666666666673,29.047619047619065,8
4660,4,0,0,38,0.0,0.0,1.0,38,1150,800,350,0.6956521739130435,15,8,7,351.06966176509076,0.4506430772878141,0.22221257433035246,0.19541173256829544,129348.5179424941,1482.0680887774433,130830.58603127155,1144,5,198.6578947368421,35,3,19,36.76055770470663,0.6157738095238094,45.68865740740741,1017.2453703703712,29.064153439153465,0
4661,4,0,1,37,0.0,0.02631578947368421,0.9736842105263158,38,1150,900,250,0.782608695652174,14,9,5,350.4450886248607,0.4496947605500237,0.22030383019985966,0.19564848662085113,129466.2814670141,1474.1644965278015,130940.44596354189,1145,6,199.6578947368421,35,3,16,36.656644489935175,0.6169642857142856,45.57291666666668,1017.7083333333351,29.077380952381002,0
4662,4,0,0,37,0.0,0.0,1.0,37,900,500,400,0.5555555555555556,13,5,8,346.4277574391242,0.44891766766766766,0.22264354849412804,0.1940403804438001,129595.04145408157,1579.0639172335561,131174.10537131512,1146,7,204.48648648648648,34,3,16,36.627986281616586,0.6204044117647058,45.44642857142857,1018.2142857142851,29.947478991596622,0
4663,4,0,0,37,0.0,0.0,1.0,37,1200,800,400,0.6666666666666666,16,8,8,342.0460505057568,0.44813563563563563,0.21208590293763807,0.19247680120176003,129776.92920918361,1477.93721655328,131254.8664257369,1147,8,205.48648648648648,34,3,16,36.55484480274175,0.6222426470588236,45.26785714285714,1018.9285714285709,29.968487394957968,0
4664,4,0,1,36,0.0,0.02702702702702703,0.972972972972973,37,1450,1000,450,0.6896551724137931,19,10,9,340.0125861300859,0.4475412912912913,0.2068654390353939,0.192523980527194,130019.6446286848,1441.663123582767,131461.30775226757,1148,9,206.48648648648648,34,3,18,36.360452900665344,0.6246936274509804,45.029761904761905,1019.8809523809523,29.996498599439775,0
4665,4,0,0,36,0.0,0.0,1.0,36,1300,1000,300,0.7692307692307693,16,10,6,347.9180006415941,0.44462632275132274,0.20996447222556136,0.1964921824397434,129918.7831152681,1840.2166534505886,131758.9997687187,1149,13,212.97222222222223,33,3,19,36.26124434026526,0.6259469696969697,45.12867647058823,1019.4852941176465,30.893493761140803,0
4666,4,0,0,36,0.0,0.0,1.0,36,1150,800,350,0.6956521739130435,15,8,7,352.33174003258193,0.4445601851851852,0.1828112118713936,0.18827242319802706,127723.00347222197,1800.1736111110772,129523.17708333305,1150,14,213.97222222222223,34,2,16,38.387949986259954,0.6014093137254901,47.29166666666665,1010.8333333333313,29.730392156862685,8
4667,4,3,1,38,0.07692307692307693,0.02564102564102564,0.9743589743589743,39,550,300,250,0.5454545454545454,8,3,5,329.31627915964776,0.4509109311740891,0.17871622933271225,0.1793202778038926,128477.8068732683,661.9666628192806,129139.77353608758,1151,0,198.43589743589743,37,2,17,38.199401543009564,0.6030405405405406,46.546052631578924,1013.815789473681,27.40042674253192,0
4668,4,1,0,39,0.02564102564102564,0.0,1.0,39,1150,700,450,0.6086956521739131,16,7,9,329.4896024878234,0.4506578947368421,0.18123058075495657,0.1800418377209006,128616.79945992967,675.5796254616419,129292.37908539131,1152,0,199.4102564102564,37,2,18,38.05343116059523,0.6044481981981982,46.40899122807016,1014.3640350877167,27.41524419155991,0
4669,4,0,0,39,0.0,0.0,1.0,39,1000,400,600,0.4,16,4,12,329.21423379718107,0.4504329734592893,0.17595717444431602,0.1802691431691778,128700.23108071672,673.9895929516297,129374.22067366836,1153,1,200.4102564102564,37,2,18,37.97547006699805,0.6052927927927928,46.32675438596489,1014.6929824561369,27.424134660976673,0
4670,4,0,0,39,0.0,0.0,1.0,39,1050,600,450,0.5714285714285714,15,6,9,329.7659642952108,0.4495051731893837,0.1776264052721941,0.18133211575853012,128867.17547706956,699.2016774391768,129566.37715450874,1154,2,201.4102564102564,37,2,19,37.791576673866096,0.6069819819819819,46.16228070175437,1015.3508771929799,27.441915599810265,0
4671,4,0,0,39,0.0,0.0,1.0,39,850,500,350,0.5882352941176471,12,5,7,330.6240883424166,0.4486898335582546,0.17551259908772887,0.18231556871453228,128978.53185595543,728.6819021237036,129707.21375807913,1155,3,202.4102564102564,37,2,19,37.65651986183075,0.6081081081081081,46.052631578947356,1015.7894736842085,27.45376955903266,0
4672,4,1,0,40,0.025,0.0,1.0,40,900,700,200,0.7777777777777778,11,7,4,345.2892025062269,0.44857104700854705,0.11168639053254448,0.18203386620649065,127177.19144397785,921.6273891151853,128098.81883309303,1156,0,198.325,36,4,18,39.12512560008932,0.591724537037037,47.83220720720721,1008.6711711711719,28.018643643643664,8
4673,4,1,1,40,0.024390243902439025,0.024390243902439025,0.975609756097561,41,1150,700,450,0.6086956521739131,16,7,9,334.56739751686354,0.45081300813008135,0.11837329584295286,0.17801546108733504,127550.26989051426,334.83236996858244,127885.10226048285,1157,0,194.46341463414635,38,3,16,39.013528997003334,0.5918311403508771,47.462606837606835,1010.1495726495725,26.582883490778226,0
4674,4,1,0,41,0.024390243902439025,0.0,1.0,41,1400,1000,400,0.7142857142857143,18,10,8,336.5007245501748,0.44939024390243903,0.13629053872956298,0.18012685843568216,127793.20987654346,400.5015432099058,128193.71141975337,1158,0,195.3170731707317,38,3,18,38.71623168498168,0.5942982456140351,47.222222222222236,1011.1111111111131,26.608187134502977,0
4675,4,4,1,44,0.08888888888888889,0.022222222222222223,0.9777777777777777,45,1300,900,400,0.6923076923076923,17,9,8,317.35844248485137,0.4553030303030303,0.1756060258469072,0.16768066070199575,127267.13204089481,-873.4326774691617,126393.69936342565,1159,0,178.86666666666667,41,4,18,39.7374684560679,0.5840955284552846,47.74305555555554,1009.0277777777757,24.61043360433599,8
4676,4,1,2,43,0.022222222222222223,0.044444444444444446,0.9555555555555556,45,1650,1200,450,0.7272727272727273,21,12,9,313.90755884393104,0.4535353535353535,0.1826791929904963,0.16709465089951628,127567.6150813333,-991.1122724552963,126576.502808878,1160,0,179.66666666666666,41,4,12,39.517557857867686,0.5871443089430894,47.4454365079365,1010.2182539682526,24.63946960898177,0
4677,4,1,0,44,0.022727272727272728,0.0,1.0,44,1450,1100,350,0.7586206896551724,18,11,7,320.44597666340184,0.45150634249471455,0.18954467801317376,0.1717155580924883,127836.02812685886,-607.0918228237301,127228.93630403513,1161,0,180.70454545454547,40,4,14,39.078358958898605,0.59140625,47.17987804878048,1011.2804878048769,25.282012195121922,0
4678,4,0,2,42,0.0,0.045454545454545456,0.9545454545454546,44,1600,1000,600,0.625,22,10,12,321.58896324925837,0.4518587033121917,0.1357820373480878,0.1648000960529492,126018.93310854446,-573.1583913936245,125445.77471715084,1162,1,181.70454545454547,41,3,20,40.910709580739706,0.5713922764227642,48.983134920634924,1004.0674603174613,24.489450251645398,8
4679,4,1,1,42,0.023255813953488372,0.023255813953488372,0.9767441860465116,43,1350,1000,350,0.7407407407407407,17,10,7,337.7776382094635,0.4539497969730528,0.16450771080668125,0.1664090277674875,124381.397867462,-127.06803230653554,124254.32983515547,1163,0,184.86046511627907,36,7,15,42.19584932640927,0.5630787037037037,50.619369369369366,997.5225225225221,27.708958958958945,8
4680,4,4,3,43,0.08695652173913043,0.06521739130434782,0.9347826086956522,46,1600,1200,400,0.75,20,12,8,339.40334877546434,0.4634460547504026,0.2267127097432089,0.17190083215517601,125534.75874789995,-677.0820249856847,124857.67672291426,1164,0,173.6304347826087,38,8,14,40.962597725657396,0.5712719298245614,49.46581196581197,1002.1367521367536,26.37201979307246,0
4681,4,3,0,46,0.06521739130434782,0.0,1.0,46,1500,1000,500,0.6666666666666666,20,10,10,338.38025210524313,0.46221819645732687,0.24744273432903774,0.17420879945463194,126209.04989996925,-656.6096988776591,125552.4402010916,1165,0,170.02173913043478,37,9,17,40.29353993889131,0.579954954954955,48.79385964912281,1004.8245614035089,27.157420578473214,0
4682,4,2,1,47,0.041666666666666664,0.020833333333333332,0.9791666666666666,48,1600,1300,300,0.8125,19,13,6,327.1723302677417,0.4642434988179669,0.25426831369306124,0.1714553154393354,126934.51063368046,-1294.1080729166715,125640.40256076379,1166,0,163.89583333333334,39,9,17,39.830559575494476,0.5838675213675213,48.072916666666664,1007.7083333333326,25.838675213675195,0
4683,4,2,4,45,0.04081632653061224,0.08163265306122448,0.9183673469387755,49,1700,1000,700,0.5882352941176471,24,10,14,311.59682282111277,0.465702947845805,0.2475347152344538,0.1655962152511345,127502.23597891447,-1854.0440170265083,125648.19196188796,1167,0,144.91836734693877,40,9,15,39.64265948883076,0.5880208333333333,47.51016260162601,1009.9593495934944,25.24898373983736,0
4684,4,2,3,44,0.0425531914893617,0.06382978723404255,0.9361702127659575,47,1000,500,500,0.5,15,5,10,313.29040642243774,0.4647895467160037,0.2289866860738896,0.16670806423121162,127553.56021548029,-1407.738655892655,126145.82155958764,1168,0,146.51063829787233,40,7,15,39.54749329309185,0.5885416666666667,47.459349593495936,1010.162601626017,25.254065040650424,0
4685,4,1,0,45,0.022222222222222223,0.0,1.0,45,1150,500,650,0.43478260869565216,18,5,13,328.73194762400146,0.4624368686868687,0.23807978172923172,0.17409526015423574,127361.4763678866,-626.4427642632814,126735.03360362332,1169,0,153.95555555555555,38,7,16,39.354007902907135,0.5899122807017544,47.64957264957265,1009.4017094017091,26.563202878992346,0
4686,4,2,0,47,0.0425531914893617,0.0,1.0,47,1200,700,500,0.5833333333333334,17,7,10,318.97642445797703,0.46199506629663895,0.25379267291509877,0.17103735863177724,127861.72251966415,-1243.0249851279111,126618.69753453624,1170,0,148.36170212765958,40,7,19,39.08929528402999,0.5916666666666667,47.15447154471544,1011.3821138211376,25.28455284552844,0
4687,4,3,1,49,0.06,0.02,0.98,50,1800,1400,400,0.7777777777777778,22,14,8,304.77101512787397,0.46476190476190476,0.27008502913919874,0.16640783595949202,128586.40861614404,-2161.8055255048025,126424.60309063923,1171,0,140.4,42,8,14,38.71114773414858,0.5959821428571428,46.4389534883721,1014.244186046513,24.14867109634555,0
4688,4,0,0,49,0.0,0.0,1.0,49,1400,800,600,0.5714285714285714,20,8,12,315.24126892534395,0.4639491213151927,0.2766573021929639,0.17184432051658352,128521.48216057254,-1696.9449759070326,126824.53718466552,1172,1,144.14285714285714,41,8,14,38.51170384502496,0.5967987804878049,46.50297619047619,1013.9880952380952,24.731416957026713,0
4689,4,0,1,48,0.0,0.02040816326530612,0.9795918367346939,49,1700,1200,500,0.7058823529411765,22,12,10,316.1001471809305,0.46347080498866217,0.2701283465776576,0.17318630988289951,128722.74900990477,-1662.1440184870362,127060.60499141774,1173,2,145.14285714285714,41,8,14,38.28524701013459,0.5988313008130082,46.30456349206349,1014.7817460317451,24.750774293457198,0
4690,4,0,3,45,0.0,0.0625,0.9375,48,1150,900,250,0.782608695652174,14,9,5,321.1773980180953,0.46349549349881797,0.2608486943164361,0.17557463236673754,128633.75491605524,-1337.1490597527973,127296.60585630244,1174,3,149.10416666666666,40,8,14,38.24696954518133,0.5994791666666667,46.392276422764226,1014.4308943089429,25.360772357723572,0
4691,4,0,1,44,0.0,0.022222222222222223,0.9777777777777777,45,1200,900,300,0.75,15,9,6,330.737628280226,0.46298400673400675,0.24098890293580566,0.18042307859976456,128550.50131492433,-496.70241617357703,128053.79889875076,1175,4,144.04444444444445,38,7,16,38.089312052254506,0.6019736842105263,46.47435897435897,1014.1025641025636,26.68690958164641,0
4692,4,0,0,44,0.0,0.0,1.0,44,850,600,250,0.7058823529411765,11,6,5,335.2544849988959,0.46313424947145876,0.2381756258661878,0.1829362083631141,128561.19340806767,-179.8566626269772,128381.3367454407,1176,5,147.20454545454547,37,7,16,37.9639015028652,0.6038851351351351,46.46381578947368,1014.1447368421037,27.40931721194875,0
4693,4,1,1,44,0.022222222222222223,0.022222222222222223,0.9777777777777777,45,1250,800,450,0.64,17,8,9,328.97236138116335,0.4637415824915825,0.24289405684754484,0.18081112493957174,128848.62075617278,-522.4729938271734,128326.1477623456,1177,0,144.9111111111111,38,7,17,37.83059735522114,0.6049890350877193,46.18055555555555,1015.2777777777773,26.717836257309926,0
4694,4,1,1,44,0.022222222222222223,0.022222222222222223,0.9777777777777777,45,1200,1000,200,0.8333333333333334,14,10,4,330.9255946630413,0.4648989898989899,0.25004615510452144,0.18263328378704907,129011.37689248643,-461.36667671125224,128550.01021577517,1178,0,145.7111111111111,38,7,19,37.615460791530836,0.6066337719298245,46.020299145299134,1015.9188034188015,26.734705353126355,0
4695,4,0,1,43,0.0,0.022727272727272728,0.9772727272727273,44,850,600,250,0.7058823529411765,11,6,5,339.3948466467792,0.4657329105003523,0.25139822401020506,0.18728369590127472,129006.37846500814,-43.17999288246466,128963.19847212567,1179,1,147.36363636363637,37,7,20,37.4054461234035,0.6083896396396397,46.025219298245595,1015.8991228070148,27.456733048838238,0
4696,4,0,0,43,0.0,0.0,1.0,43,1250,1000,250,0.8,15,10,5,348.22257162680216,0.46518549280177185,0.2572859709772801,0.19212940786821917,129001.10995708556,384.21965039364653,129385.3296074792,1180,2,151.51162790697674,36,7,20,37.18661087093079,0.6102430555555556,46.03040540540541,1015.8783783783791,28.218843843843864,0
4697,4,0,1,42,0.0,0.023255813953488372,0.9767441860465116,43,1650,1400,250,0.8484848484848485,19,14,5,352.4970305287381,0.4644010705057217,0.260762930845706,0.195333989845483,129172.76810171652,506.60343620647063,129679.37153792298,1181,3,152.51162790697674,36,7,20,36.90317935083639,0.6119791666666667,45.861486486486484,1016.5540540540535,28.237612612612597,0
4698,4,1,0,43,0.023255813953488372,0.0,1.0,43,1350,1100,250,0.8148148148148148,16,11,5,346.84522232520203,0.46467792543373937,0.2575854577242982,0.19473712203174778,129688.42734203817,396.3622828910207,130084.78962492918,1182,0,150.3953488372093,36,7,19,36.52248019163443,0.6171875,45.35472972972974,1018.5810810810825,28.29391891891896,0
4699,4,1,0,44,0.022727272727272728,0.0,1.0,44,1200,800,400,0.6666666666666666,16,8,8,338.82469096916714,0.46425739957716705,0.2578388443080406,0.19180818324432294,130010.85820877597,10.177771044957694,130021.03597982092,1183,0,147.95454545454547,37,7,20,36.39964788732395,0.6185247747747749,45.038377192982466,1019.8464912280717,27.563418681839778,0
4700,4,1,0,45,0.022222222222222223,0.0,1.0,45,1500,1100,400,0.7333333333333333,19,11,8,332.96940882940237,0.4634680134680134,0.2566665473334997,0.1898516941586386,130290.57167830499,-323.20161011079216,129967.3700681942,1184,0,145.64444444444445,37,8,22,36.26568485304119,0.6213400900900901,44.76425438596492,1020.9429824561414,27.593053579895713,0
4701,4,1,1,45,0.021739130434782608,0.021739130434782608,0.9782608695652174,46,1700,1300,400,0.7647058823529411,21,13,8,376.5850057504741,0.4644223027375201,0.3448521218143834,0.20658311970961796,128772.40997331789,622.5729017613893,129394.98287507928,1185,0,143.45652173913044,36,10,17,36.69999815081917,0.6079282407407407,46.25563063063063,1014.9774774774774,28.193818818818816,8
4702,4,0,0,45,0.0,0.0,1.0,45,1100,500,600,0.45454545454545453,17,5,12,386.237939279367,0.46376262626262627,0.3633903458760932,0.2119716350112668,128789.87295310329,948.7070258916006,129738.5799789949,1186,1,147.46666666666667,35,10,17,36.43719118206003,0.6101190476190477,46.23842592592591,1015.0462962962941,29.00132275132269,0
4703,4,3,2,46,0.0625,0.041666666666666664,0.9583333333333334,48,1700,1300,400,0.7647058823529411,21,13,8,365.55504218364075,0.4648714539007092,0.35930094786729905,0.20444656696583827,129536.03512619242,-128.83344299435777,129407.20168319806,1187,0,139.1875,37,11,15,36.20117047249747,0.6137387387387387,45.50438596491227,1017.9824561403489,27.513039355144564,0
4704,4,0,2,44,0.0,0.043478260869565216,0.9565217391304348,46,1700,1200,500,0.7058823529411765,22,12,10,376.45782130596024,0.46430152979066025,0.35830480299222245,0.20938679326815043,129319.08543381338,536.6362311385375,129855.72166495191,1188,1,146.2391304347826,35,11,19,36.14493248368987,0.6154761904761905,45.71759259259259,1017.1296296296291,29.060846560846546,0
4705,4,0,1,43,0.0,0.022727272727272728,0.9772727272727273,44,1550,1000,550,0.6451612903225806,21,10,11,384.9771566783125,0.46513830162085973,0.3533904619970196,0.21348733233979134,129201.3888888888,1147.9166666666588,130349.30555555546,1189,2,139.9090909090909,34,10,19,36.048497267759565,0.616421568627451,45.83333333333333,1016.666666666666,29.901960784313705,0
4706,4,0,0,43,0.0,0.0,1.0,43,1200,900,300,0.75,15,9,6,384.9118443062745,0.4642626430417128,0.3478083355108441,0.21410721339536523,129322.44897959183,1355.5484693877577,130677.99744897959,1190,3,142.62790697674419,34,9,19,35.926527387640455,0.6176470588235294,45.714285714285715,1017.1428571428571,29.915966386554622,0
4707,4,0,0,43,0.0,0.0,1.0,43,1250,1100,150,0.88,14,11,3,387.02316343594,0.46419342930970836,0.35213225910900325,0.2157786678334623,129413.28124999988,1417.1874999999848,130830.46874999987,1191,4,143.62790697674419,34,9,20,35.78009828009827,0.6185661764705883,45.62499999999999,1017.4999999999991,29.92647058823527,0
4708,4,1,0,44,0.022727272727272728,0.0,1.0,44,1400,800,600,0.5714285714285714,20,8,12,377.75075529139303,0.46452167019027485,0.3490088276289298,0.2128020089789325,129819.89354263117,1007.9125675154294,130827.8061101466,1192,0,141.3409090909091,35,9,17,35.60157580919931,0.6205357142857143,45.22569444444444,1019.0972222222222,29.11706349206349,0
4709,4,2,0,46,0.043478260869565216,0.0,1.0,46,1100,700,400,0.6363636363636364,15,7,8,364.12278442650177,0.4657910628019324,0.3423403776008589,0.20838850331437206,130435.08193582101,299.63056472154346,130734.71250054256,1193,0,136.15217391304347,36,10,19,35.32388013081984,0.6247106481481481,44.62274774774775,1021.5090090090094,28.37525025025026,0
4710,4,0,0,46,0.0,0.0,1.0,46,2050,1600,450,0.7804878048780488,25,16,9,361.14051387251135,0.4647644927536232,0.3345512966996065,0.2077059229385208,130626.62459843408,234.91326658201564,130861.5378650161,1194,1,137.15217391304347,37,9,15,35.20583056240837,0.6247184684684685,44.435307017543856,1022.2587719298241,27.628615457562812,0
4711,4,0,1,45,0.0,0.021739130434782608,0.9782608695652174,46,1250,800,450,0.64,17,8,9,373.90893532413173,0.4640901771336554,0.33176743879844595,0.2036020032984052,128477.80687326865,477.8035068482564,128955.61038011691,1195,2,138.15217391304347,37,9,15,37.06918307015646,0.6030405405405406,46.546052631578945,1013.8157894736839,27.400426742531998,8
4712,4,0,0,45,0.0,0.0,1.0,45,1650,1200,450,0.7272727272727273,21,12,9,382.67918113453266,0.46296296296296297,0.3568681149229609,0.20902312822794064,128601.0181422979,842.5864631523632,129443.60460545025,1196,3,142.17777777777778,36,9,15,36.72074497612969,0.6061921296296297,46.42454954954956,1014.3018018018033,28.175050050050093,0
4713,4,2,1,46,0.0425531914893617,0.02127659574468085,0.9787234042553191,47,1200,700,500,0.5833333333333334,17,7,10,393.31208878463445,0.4629779525131052,0.37366637201189334,0.21406260116319714,128458.27880245111,894.6189432675968,129352.89774571871,1197,0,137.08510638297872,36,11,16,36.59742279493446,0.6047453703703703,46.56531531531532,1013.7387387387389,28.159409409409413,8
4714,4,0,2,44,0.0,0.043478260869565216,0.9565217391304348,46,1500,1200,300,0.8,18,12,6,388.0605656756236,0.46209742351046695,0.35198159214231706,0.21212637139263377,128631.77237426044,783.3836702827176,129415.15604454317,1198,1,135.65217391304347,38,8,16,36.55279094260136,0.602796052631579,46.394230769230774,1014.4230769230776,26.695344129554673,0
4715,4,1,1,44,0.022222222222222223,0.022222222222222223,0.9777777777777777,45,1400,1100,300,0.7857142857142857,17,11,6,386.9107214036952,0.46249999999999997,0.34892840857273155,0.2126554416136099,128848.62075617287,970.5825617283986,129819.20331790127,1199,0,137.73333333333332,38,7,18,36.36000911992705,0.6049890350877193,46.18055555555556,1015.2777777777779,26.717836257309944,0
4716,4,0,0,44,0.0,0.0,1.0,44,1550,900,650,0.5806451612903226,22,9,13,391.3414118171646,0.46217626849894294,0.35212570641728025,0.215680162443234,128957.11343277464,1293.2517669296672,130250.3651997043,1200,1,141.22727272727272,38,6,18,36.136530977174715,0.6060855263157895,46.073717948717956,1015.7051282051294,26.729082321187615,0
4717,4,1,0,45,0.022222222222222223,0.0,1.0,45,1400,1000,400,0.7142857142857143,18,10,8,375.2076859316029,0.46353114478114477,0.31942419729863936,0.20276471261335516,128174.66695011324,660.2088406861632,128834.8757907994,1201,0,139.06666666666666,34,11,20,37.34667685555296,0.6060049019607843,46.84523809523809,1012.6190476190465,29.782913165266073,7
4718,4,0,1,44,0.0,0.022222222222222223,0.9777777777777777,45,1250,1000,250,0.8,15,10,5,371.7683350340583,0.4631734006734007,0.3144535840188014,0.20151264529553084,128295.24518140574,539.2219387754924,128834.46712018123,1202,1,140.06666666666666,34,11,20,37.31027222875048,0.6072303921568627,46.72619047619047,1013.0952380952369,29.79691876750697,0
4719,4,3,0,47,0.06382978723404255,0.0,1.0,47,1450,1100,350,0.7586206896551724,18,11,7,359.7387988121637,0.4629201356768424,0.3264878882536688,0.1990584095205259,129115.53603857242,-110.42643149906118,129005.10960707336,1203,0,133.95744680851064,36,11,20,36.7774699907664,0.611400462962963,45.917792792792795,1016.3288288288294,28.231356356356372,0
4720,4,0,1,46,0.0,0.02127659574468085,0.9787234042553191,47,1150,800,350,0.6956521739130435,15,8,7,359.53028467560165,0.46286231884057966,0.3232757235649202,0.1990947275354136,129145.65659626016,-113.64506386583295,129032.01153239433,1204,1,134.95744680851064,37,10,21,36.75206760158216,0.6097972972972974,45.88815789473683,1016.4473684210508,27.471550497866236,0
4721,4,0,1,45,0.0,0.021739130434782608,0.9782608695652174,46,1300,900,400,0.6923076923076923,17,9,8,365.70006366618765,0.46209742351046695,0.32315821925066746,0.20250360580681032,129144.15048494439,245.6048108919736,129389.75529583637,1205,2,138.7391304347826,36,10,21,36.59682214343747,0.6116898148148149,45.88963963963964,1016.4414414414414,28.234484484484483,0
4722,4,0,2,43,0.0,0.044444444444444446,0.9555555555555556,45,1450,1000,450,0.6896551724137931,19,10,9,374.27552334829767,0.46094276094276093,0.32994483845547684,0.2069523482043526,129086.92476260028,662.8152645888949,129749.74002718917,1206,3,142.42222222222222,36,9,21,36.43732454196218,0.6111111111111112,45.94594594594594,1016.2162162162149,28.22822822822819,0
4723,4,2,2,43,0.044444444444444446,0.044444444444444446,0.9555555555555556,45,1100,700,400,0.6363636363636364,15,7,8,363.22531355169735,0.4631313131313131,0.3041983393755121,0.20313536011645267,129534.44054705203,410.18973589555765,129944.63028294759,1207,0,140.11111111111111,34,11,14,36.262084356605456,0.6197916666666667,45.50595238095237,1017.9761904761895,29.94047619047616,0
4724,4,0,0,43,0.0,0.0,1.0,43,1250,900,350,0.72,16,9,7,385.2477769398375,0.4612172388335179,0.32483633139751444,0.2138111886765343,129233.48263251207,1357.3823780736775,130590.86501058574,1208,5,147.62790697674419,32,11,22,36.008837286311525,0.6214192708333333,45.80176767676768,1016.7929292929299,31.77477904040406,0
4725,4,0,2,41,0.0,0.046511627906976744,0.9534883720930233,43,1200,1100,100,0.9166666666666666,13,11,2,385.2175010527958,0.4605481727574751,0.3300495596779922,0.21449187325379251,129361.89746263147,1366.4933744005893,130728.39083703206,1209,6,148.62790697674419,32,11,23,35.87848041040918,0.6227213541666667,45.67550505050506,1017.2979797979807,31.790561868686897,0
4726,4,0,0,41,0.0,0.0,1.0,41,1650,1200,450,0.7272727272727273,21,12,9,383.1848079394122,0.45919715447154474,0.2942984552643839,0.2142327268798573,129522.50567544141,1726.2112922150968,131248.7169676565,1210,7,143.2439024390244,32,9,18,35.76630075250146,0.6243489583333333,45.517676767676775,1017.929292929294,31.810290404040437,0
4727,4,0,1,40,0.0,0.024390243902439025,0.975609756097561,41,850,500,350,0.5882352941176471,12,5,7,386.5852381802588,0.4590193089430894,0.30218868198351,0.21702039780098467,129683.21352731876,1826.7231978879843,131509.93672520673,1211,8,144.2439024390244,32,9,18,35.51583612247428,0.6259765625,45.35984848484849,1018.560606060607,31.83001893939397,0
4728,4,1,0,41,0.024390243902439025,0.0,1.0,41,1400,1200,200,0.8571428571428571,16,12,4,373.62131893751825,0.4571392276422764,0.2979935639298712,0.2115154160678932,130012.50270328738,1515.08854767399,131527.59125096136,1212,0,144.2439024390244,33,8,20,35.510794680765834,0.6268939393939394,45.03676470588236,1019.8529411764721,30.904634581105213,0
4729,4,0,1,40,0.0,0.024390243902439025,0.975609756097561,41,650,400,250,0.6153846153846154,9,4,5,372.0367190195092,0.45701219512195124,0.2947635555894186,0.21078703964597528,130043.75007509145,1476.210021386023,131519.96009647747,1213,1,145.2439024390244,33,8,20,35.51941907965878,0.627209595959596,45.0061274509804,1019.9754901960795,30.908348187759984,0
4730,4,1,0,41,0.024390243902439025,0.0,1.0,41,900,500,400,0.5555555555555556,13,5,8,370.56198212534144,0.45787601626016255,0.29224937457157374,0.210456962017435,130137.51471789718,1444.803080545972,131582.31779844317,1214,0,145.97560975609755,33,8,22,35.461706301545355,0.6281565656565656,44.914215686274524,1020.3431372549038,30.91948900772436,0
4731,4,1,1,41,0.023809523809523808,0.023809523809523808,0.9761904761904762,42,1250,800,450,0.64,17,8,9,368.0229785886606,0.457909891598916,0.2765435495334394,0.20603334946863797,129575.43372741231,1221.7200115340038,130797.15373894632,1215,0,143.47619047619048,33,9,17,36.09823864548228,0.6224747474747474,45.46568627450979,1018.137254901959,30.85264408793815,8
4732,4,0,2,39,0.0,0.04878048780487805,0.9512195121951219,41,1150,600,550,0.5217391304347826,17,6,11,377.3202131441369,0.45675813008130084,0.28762519548797183,0.2111265009424825,129554.63927469117,1576.7168209876334,131131.3560956788,1216,1,147.9512195121951,32,9,17,35.882787630741255,0.6246744791666667,45.4861111111111,1018.055555555554,31.81423611111106,0
4733,4,0,0,39,0.0,0.0,1.0,39,1500,1100,400,0.7333333333333333,19,11,8,389.40056141637695,0.4557186234817814,0.2857705098687444,0.21776348992512404,129532.54699707024,2288.0093044704713,131820.55630154072,1217,2,148.51282051282053,31,8,17,35.597872431141795,0.627016129032258,45.50781249999999,1017.9687499999994,32.83770161290321,0
4734,4,0,0,39,0.0,0.0,1.0,39,1500,1100,400,0.7333333333333333,19,11,8,390.93611826538444,0.4548470535312641,0.28766770603884795,0.2194628855982503,129683.21352731866,2339.5704201101935,132022.78394742886,1218,3,149.51282051282053,32,7,18,35.40504524606422,0.6259765625,45.359848484848484,1018.5606060606062,31.830018939393945,0
4735,4,0,0,39,0.0,0.0,1.0,39,1000,600,400,0.6,14,6,8,389.3844538957265,0.45414417453891137,0.23973572439830182,0.21886091718966702,129731.44531250009,2313.448045798912,132044.89335829898,1219,4,150.51282051282053,31,8,19,35.39536468984322,0.6290322580645161,45.31250000000001,1018.7500000000007,32.86290322580648,8
4736,4,1,0,40,0.025,0.0,1.0,40,1200,900,300,0.75,15,9,6,379.2213998627586,0.4548611111111111,0.23135519801980275,0.21517618756257662,130101.52025303546,1867.456126925836,131968.9763799613,1220,0,147.725,32,8,20,35.277433993399356,0.6302083333333333,44.949494949494955,1020.2020202020207,31.881313131313146,0
4737,4,0,1,39,0.0,0.025,0.975,40,500,200,300,0.4,8,2,6,379.199676410853,0.4549278846153846,0.23228870189333017,0.21534171363851767,130133.72559241418,1869.3333269564496,132003.05891937064,1221,1,148.725,32,8,20,35.24522542589614,0.6305338541666667,44.9179292929293,1020.3282828282839,31.885258838383873,0
4738,4,0,0,39,0.0,0.0,1.0,39,1250,800,450,0.64,17,8,9,414.54520045418843,0.4544815564552407,0.19249460819554298,0.22493071221398644,128336.36435376482,3002.8716776349247,131339.23603139975,1222,2,152.82051282051282,32,7,20,36.184579439252325,0.6123046875,46.685606060606055,1013.257575757575,31.664299242424217,8
4739,4,2,0,41,0.04878048780487805,0.0,1.0,41,1300,800,500,0.6153846153846154,18,8,10,409.34675486370867,0.45647865853658537,0.2380257985142904,0.2275734877039453,129300.69181654204,2394.4801449666425,131695.1719615087,1223,0,146.3170731707317,31,10,22,35.32744953697777,0.6246639784946236,45.73567708333334,1017.0572916666679,32.808299731182835,0
4740,4,0,0,41,0.0,0.0,1.0,41,1000,500,500,0.5,15,5,10,409.7541875493375,0.4557672764227642,0.2412627887312515,0.2289527150874321,129499.412112766,2412.5852796766703,131911.99739244266,1224,1,147.3170731707317,31,10,17,35.11377446590763,0.6266801075268817,45.54036458333334,1017.838541666668,32.833501344086066,0
4741,4,1,0,42,0.023809523809523808,0.0,1.0,42,1400,1200,200,0.8571428571428571,16,12,4,403.52218815196494,0.4552966511807975,0.24659400544959165,0.22783483546426336,129908.3719135803,2084.182098765441,131992.55401234573,1225,0,144.78571428571428,32,10,18,34.85467756584924,0.6282552083333333,45.13888888888889,1019.4444444444448,31.8576388888889,0
4742,4,1,0,43,0.023255813953488372,0.0,1.0,43,1250,1000,250,0.8,15,10,5,399.06631651242844,0.456187707641196,0.25572769305085896,0.22794126892320082,130359.27456382012,1804.881357769628,132164.15592158976,1226,0,142.3953488372093,32,11,19,34.50868570722057,0.6328125,44.6969696969697,1021.2121212121219,31.91287878787881,0
4743,4,0,1,42,0.0,0.023255813953488372,0.9767441860465116,43,1500,1100,400,0.7333333333333333,19,11,8,396.41860150738376,0.4556570690291621,0.251696125563579,0.22737177476961434,130520.50053884818,1748.1508583307923,132268.65139717897,1227,1,143.3953488372093,32,11,19,34.41219778409325,0.6344401041666667,44.53914141414142,1021.8434343434352,31.93260732323235,0
4744,4,0,1,41,0.0,0.023809523809523808,0.9761904761904762,42,1300,1000,300,0.7692307692307693,16,10,6,409.86218974759436,0.45413521099496706,0.2592707233288425,0.23472837523792872,130462.04460991747,2294.291856553815,132756.3364664713,1228,2,147.64285714285714,31,11,19,34.12832441158977,0.6364247311827957,44.596354166666664,1021.6145833333328,32.95530913978493,0
4745,4,0,0,41,0.0,0.0,1.0,41,1350,900,450,0.6666666666666666,18,9,9,418.6298476454294,0.4538871951219512,0.2714441591784338,0.2395773224476856,130434.15423748411,2720.726023239684,133154.8802607238,1229,3,151.6341463414634,30,11,19,33.9328399122807,0.6388888888888888,44.623655913978496,1021.5053763440861,34.05017921146954,0
4746,4,0,2,39,0.0,0.04878048780487805,0.9512195121951219,41,1650,1200,450,0.7272727272727273,21,12,9,421.7254781587928,0.45246443089430893,0.27539615518354754,0.24360848208937344,130794.81336805562,2831.9010416666715,133626.7144097223,1230,4,152.6341463414634,31,10,19,33.486082824168356,0.6397849462365591,44.270833333333336,1022.9166666666672,32.997311827957006,0
4747,4,0,0,39,0.0,0.0,1.0,39,1350,1100,250,0.8148148148148148,16,11,5,431.48932276722405,0.4530195681511471,0.2754927336946267,0.2486947551221999,130708.89698231003,3479.8986877095563,134188.79567001958,1231,5,157.97435897435898,30,9,19,33.324022958289525,0.6416666666666666,44.354838709677416,1022.5806451612898,34.08602150537633,0
4748,4,0,2,37,0.0,0.05128205128205128,0.9487179487179487,39,1150,900,250,0.782608695652174,14,9,5,433.04617194633573,0.4521761133603239,0.27701603532419283,0.25070574197927387,130880.75798141395,3535.48224505722,134416.24022647116,1232,6,158.97435897435898,30,9,19,33.10893646832174,0.6434027777777778,44.18682795698924,1023.2526881720423,34.10842293906808,0
4749,4,2,0,39,0.05128205128205128,0.0,1.0,39,1450,1200,250,0.8275862068965517,17,12,5,415.89437084365,0.45001124606387766,0.2643999973143729,0.24624815538789116,131741.7566337148,3158.8942724592384,134900.65090617404,1025,0,127.12820512820512,30,9,20,32.672711006371664,0.6520833333333333,43.346774193548384,1026.612903225806,34.220430107526866,0
4750,4,0,0,39,0.0,0.0,1.0,39,1050,700,350,0.6666666666666666,14,7,7,419.1040284565817,0.44953328834907785,0.26962831751527316,0.24927720540806664,131914.2950955314,3257.1624971095107,135171.4575926409,1026,1,128.12820512820514,30,9,21,32.41528195734659,0.6538194444444445,43.17876344086022,1027.28494623656,34.24283154121867,0
4751,4,0,0,39,0.0,0.0,1.0,39,700,300,400,0.42857142857142855,11,3,8,422.5202251382255,0.449589518668466,0.27214292180945776,0.2522257737417652,132052.40716050993,3358.962560700664,135411.3697212106,1027,2,129.12820512820514,30,9,21,32.18745913430104,0.6552083333333334,43.04435483870968,1027.8225806451617,34.260752688172055,0
4752,4,0,1,38,0.0,0.02564102564102564,0.9743589743589743,39,1000,600,400,0.6,14,6,8,421.814102651379,0.44877417903733696,0.27901832842363516,0.2527251134992719,132190.59148817786,3351.971145508159,135542.56263368603,1028,3,130.12820512820514,30,9,21,32.06552520367709,0.6565972222222223,42.90994623655914,1028.3602150537638,34.27867383512546,0
4753,4,0,0,38,0.0,0.0,1.0,38,1050,800,250,0.7619047619047619,13,8,5,420.93447800539343,0.447101706970128,0.2632850905840698,0.2531228145429134,132328.84807853517,3540.354918198646,135869.20299673383,1029,4,128.02631578947367,30,8,21,31.948073154800788,0.6579861111111112,42.77553763440861,1028.8978494623661,34.29659498207887,0
4754,4,0,0,38,0.0,0.0,1.0,38,1050,700,350,0.6666666666666666,14,7,7,419.91935318940045,0.44597558084400185,0.2615294764325955,0.25367367866173574,132501.77043588858,3528.0115475777566,136029.78198346635,1030,5,129.02631578947367,30,8,21,31.799118798955604,0.6597222222222222,42.60752688172043,1029.5698924731187,34.31899641577062,0
4755,4,0,0,38,0.0,0.0,1.0,38,1400,800,600,0.5714285714285714,20,8,12,418.9792826807314,0.4458570412517781,0.26065751693250294,0.25357182179303056,132570.9709937566,3508.898066250445,136079.86906000704,1031,6,130.02631578947367,30,8,22,31.75329548420778,0.6604166666666667,42.54032258064517,1029.8387096774202,34.32795698924734,0
4756,4,0,0,38,0.0,0.0,1.0,38,1100,700,400,0.6363636363636364,15,7,8,417.95238175295174,0.4451754385964912,0.26274595960289426,0.2538845450489805,132709.42630650965,3493.244161174733,136202.67046768437,1032,7,131.02631578947367,30,8,21,31.639707800678316,0.6618055555555555,42.40591397849464,1030.3763440860234,34.34587813620078,0
4757,4,0,1,37,0.0,0.02631578947368421,0.9736842105263158,38,1350,1100,250,0.8148148148148148,16,11,5,419.11167392159786,0.44459755808440016,0.2629279875918773,0.25529526825295745,132813.31521346405,3532.7221716383538,136346.03738510242,1033,8,132.02631578947367,30,8,22,31.504813752336254,0.6628472222222221,42.30510752688173,1030.7795698924738,34.359318996415794,0
4758,4,0,0,37,0.0,0.0,1.0,37,800,500,300,0.625,11,5,6,423.71354573713245,0.44456956956956956,0.2657918594871307,0.2584408915371188,132862.96537422846,3859.167631172851,136722.1330054013,1034,9,135.0,29,8,22,31.33602204858772,0.6663074712643677,42.25694444444445,1030.9722222222229,35.55076628352493,0
4759,4,1,1,37,0.02631578947368421,0.02631578947368421,0.9736842105263158,38,750,400,350,0.5333333333333333,11,4,7,411.53971354166634,0.4441678520625889,0.25729166666666603,0.2532552083333334,133194.58896982326,3362.972597988225,136557.5615678115,1035,0,132.42105263157896,30,8,24,31.315104166666675,0.6666666666666667,41.93548387096775,1032.2580645161304,34.40860215053768,0
4760,4,0,2,35,0.0,0.05405405405405406,0.9459459459459459,37,850,500,350,0.5882352941176471,12,5,7,414.84866739516247,0.4415665665665666,0.24437948295816336,0.2560066113732558,133298.66756633722,3659.7549210891602,136958.42248742637,1036,1,133.16216216216216,30,7,24,31.124723415332564,0.6677083333333333,41.83467741935485,1032.6612903225814,34.422043010752716,0
4761,4,0,0,35,0.0,0.0,1.0,35,1050,700,350,0.6666666666666666,14,7,7,415.96526595894403,0.43942577030812324,0.2240534777848211,0.25715159459157677,133364.60503472228,4095.00868055556,137459.61371527784,1037,2,134.54285714285714,29,6,24,31.029396934247693,0.6713362068965517,41.770833333333336,1032.916666666667,35.61781609195403,0
4762,4,0,1,34,0.0,0.02857142857142857,0.9714285714285714,35,450,200,250,0.4444444444444444,7,2,5,402.40873189646385,0.43893557422969187,0.2335505390024588,0.22546285592230036,129606.62853529875,3431.011209630886,133037.63974492962,1038,3,135.54285714285714,33,2,17,35.191133108677334,0.622790404040404,45.43504901960783,1018.2598039215673,30.856357694592948,8
4763,4,1,1,34,0.02857142857142857,0.02857142857142857,0.9714285714285714,35,850,400,450,0.47058823529411764,13,4,9,363.91276356888784,0.4407563025210084,0.14363280723054106,0.19173314259674235,127152.04081632651,2284.19002711378,129436.2308434403,1039,0,136.42857142857142,34,1,21,38.681342461441595,0.5955882352941176,47.857142857142854,1008.5714285714284,29.663865546218485,8
4764,4,0,1,33,0.0,0.029411764705882353,0.9705882352941176,34,750,500,250,0.6666666666666666,10,5,5,366.13161639726485,0.4411764705882353,0.15219846597042053,0.19276372817230253,127122.90833153098,2508.7431817089378,129631.65151323992,1040,1,139.97058823529412,33,1,21,38.6553398549844,0.5975378787878788,47.886029411764696,1008.4558823529399,30.5592691622103,0
4765,4,0,1,32,0.0,0.030303030303030304,0.9696969696969697,33,950,500,450,0.5263157894736842,14,5,9,374.590649206488,0.43888099747474746,0.15493358525786216,0.19722185334292805,127123.84458537384,2923.880694571969,130047.72527994581,1041,2,143.78787878787878,32,1,21,38.44111264137556,0.5999348958333333,47.885101010101,1008.4595959595952,31.51436237373735,0
4766,4,1,0,33,0.030303030303030304,0.0,1.0,33,950,600,350,0.631578947368421,13,6,7,371.1442540893877,0.4410905934343434,0.1421570299619086,0.19664004714676284,127378.63363751136,2855.169593663898,130233.80323117526,1042,0,138.93939393939394,32,1,20,38.26610381488432,0.6025390625,47.63257575757575,1009.469696969696,31.545928030303,0
4767,4,0,0,33,0.0,0.0,1.0,33,950,700,250,0.7368421052631579,12,7,5,371.34781748052615,0.44077493686868685,0.14131308078281601,0.19690299393728675,127410.50020406065,2862.722234975999,130273.22243903665,1043,1,139.93939393939394,32,1,20,38.228228697682155,0.6028645833333333,47.60101010101009,1009.5959595959583,31.549873737373698,0
4768,4,0,0,33,0.0,0.0,1.0,33,700,500,200,0.7142857142857143,9,5,4,372.74416128413213,0.44113005050505055,0.14337675327922894,0.19795536533535768,127474.24529384746,2903.0561294765716,130377.30142332402,1044,2,140.93939393939394,32,1,20,38.12750062515627,0.603515625,47.53787878787878,1009.848484848484,31.557765151515124,0
4769,4,1,1,33,0.029411764705882353,0.029411764705882353,0.9705882352941176,34,750,500,250,0.6666666666666666,10,5,5,364.5137924701561,0.4437574272133096,0.13968627450980375,0.19502197067955815,127772.5589316608,2514.972005959231,130287.53093762003,1045,0,137.76470588235293,33,1,21,38.02929292929292,0.6041666666666667,47.24264705882352,1011.0294117647051,30.63725490196076,0
4770,4,3,1,35,0.08333333333333333,0.027777777777777776,0.9722222222222222,36,1150,1000,150,0.8695652173913043,13,10,3,344.22817816970564,0.44872685185185185,0.14151472564320655,0.1888331448474472,128772.40997331787,1665.4184167275305,130437.8283900454,1046,0,126.61111111111111,36,0,20,37.52103443174672,0.6079282407407407,46.25563063063063,1014.9774774774772,28.193818818818812,0
4771,4,1,0,36,0.027777777777777776,0.0,1.0,36,1050,700,350,0.6666666666666666,14,7,7,340.8206111984873,0.4500165343915344,0.1381991402776248,0.18804542713281638,129001.10995708527,1593.2474281713955,130594.35738525666,1047,0,127.47222222222223,36,0,21,37.37459815984925,0.6102430555555556,46.030405405405396,1015.8783783783767,28.2188438438438,0
4772,4,0,0,36,0.0,0.0,1.0,36,1200,800,400,0.6666666666666666,16,8,8,340.40082772251196,0.44905753968253964,0.14175067390421336,0.18863095591473963,129172.76810171631,1594.103436206443,130766.87153792275,1048,1,128.47222222222223,36,0,22,37.21059045086961,0.6119791666666667,45.86148648648647,1016.5540540540518,28.23761261261255,0
4773,4,0,0,36,0.0,0.0,1.0,36,1100,900,200,0.8181818181818182,13,9,4,343.3376976891346,0.4484953703703704,0.1450699287796604,0.19108868904657703,129344.54038075206,1681.7713405973188,131026.31172134938,1049,2,129.47222222222223,36,0,25,36.96123473190892,0.6137152777777778,45.69256756756755,1017.2297297297272,28.25638138138131,0
4774,4,0,1,35,0.0,0.027777777777777776,0.9722222222222222,36,800,500,300,0.625,11,5,6,334.6438706021409,0.44775132275132273,0.11009636787388422,0.17815482345858,127572.62613378669,1344.7724579239855,128917.39859171068,1050,3,130.47222222222223,34,2,19,38.988726529970926,0.5998774509803921,47.44047619047618,1010.2380952380939,29.712885154061585,8
4775,4,1,0,36,0.027777777777777776,0.0,1.0,36,1350,900,450,0.6666666666666666,18,9,9,351.13191764828633,0.44537037037037036,0.10259394184712956,0.18571428014345773,127308.35383326114,1794.8837408737872,129103.23757413492,1051,0,131.33333333333334,33,3,18,38.84322505565676,0.5994318181818181,47.702205882352935,1009.1911764705873,30.58155080213901,8
4776,4,1,0,37,0.02702702702702703,0.0,1.0,37,1050,700,350,0.6666666666666666,14,7,7,342.38064852370564,0.44682182182182184,0.10831179743096864,0.18309171708207206,127753.08956916083,1348.0371315192554,129101.12670068009,1052,0,128.75675675675674,34,3,17,38.60864146647824,0.6017156862745099,47.26190476190475,1010.9523809523796,29.73389355742293,0
4777,4,0,0,37,0.0,0.0,1.0,37,800,400,400,0.5,12,4,8,344.74802717798553,0.4464777277277277,0.11275312982199392,0.18477189216889484,127843.36911848058,1414.7498582766234,129258.1189767572,1053,1,129.75675675675674,34,3,17,38.456444967628016,0.6026348039215687,47.17261904761904,1011.3095238095226,29.744397759103606,0
4778,4,0,1,36,0.0,0.02702702702702703,0.972972972972973,37,1500,1000,500,0.6666666666666666,20,10,10,345.1592714526705,0.4458208208208208,0.11325338752094871,0.18554766907503126,127963.79145408151,1433.5778061224391,129397.36926020395,1054,2,130.75675675675674,34,3,19,38.322890928344535,0.6038602941176471,47.05357142857142,1011.7857142857133,29.75840336134451,0
4779,4,0,0,36,0.0,0.0,1.0,36,800,500,300,0.625,11,5,6,353.13668186662244,0.4450396825396825,0.11964595696580682,0.18995762750310746,127989.47707912818,1839.5558499134875,129829.03292904167,1055,3,135.16666666666666,33,3,19,38.0948235840297,0.6063762626262627,47.0281862745098,1011.8872549019604,30.663250148544254,0
4780,4,1,0,37,0.02702702702702703,0.0,1.0,37,700,500,200,0.7142857142857143,9,5,4,346.52276686746984,0.44544544544544545,0.12511230836145648,0.1882545191029207,128385.7160572561,1497.7147108843342,129883.43076814043,1056,0,132.48648648648648,34,3,17,37.857296683503655,0.6081495098039216,46.63690476190475,1013.4523809523798,29.80742296918764,0
4781,4,0,1,36,0.0,0.02702702702702703,0.972972972972973,37,1000,700,300,0.7,13,7,6,346.54524993283076,0.4456644144144144,0.12562456748503292,0.18840908415888352,128415.88010204064,1500.3826530612043,129916.26275510184,1057,1,133.48648648648648,34,3,18,37.82593375616633,0.6084558823529411,46.60714285714285,1013.5714285714271,29.810924369747855,0
4782,4,0,0,36,0.0,0.0,1.0,36,1050,700,350,0.6666666666666666,14,7,7,346.5958872226431,0.44580026455026456,0.1383652232292718,0.18906268732810616,128548.11137843608,1710.8493428008321,130258.96072123692,1058,2,137.30555555555554,33,3,19,37.689702920443075,0.6120580808080809,46.4767156862745,1014.0931372549012,30.73009506833034,0
4783,4,0,0,36,0.0,0.0,1.0,36,950,700,250,0.7368421052631579,12,7,5,353.54536216790564,0.44545304232804234,0.14231120237280415,0.19345684424243803,128672.41753472209,1898.3072916666474,130570.72482638873,1059,3,138.30555555555554,33,3,19,37.38663586584532,0.6133207070707071,46.35416666666666,1014.5833333333322,30.744949494949463,0
4784,4,1,0,37,0.02702702702702703,0.0,1.0,37,900,800,100,0.8888888888888888,10,8,2,345.76277573906725,0.4472284784784785,0.14242955014078862,0.19071711476286096,128989.67013888877,1519.9652777777592,130509.63541666654,1060,0,135.54054054054055,34,3,20,37.26073284112659,0.6142769607843137,46.04166666666666,1015.8333333333323,29.877450980392126,0
4785,4,3,3,37,0.075,0.075,0.925,40,750,500,250,0.6666666666666666,10,5,5,322.9339046464771,0.4508279914529914,0.140597416576965,0.18138186059043343,129703.52055440107,377.13286780545025,130080.65342220652,1061,0,126.3,37,3,10,37.116074632221036,0.615427927927928,45.33991228070174,1018.6403508771907,27.530820293978127,0
4786,4,1,1,37,0.02631578947368421,0.02631578947368421,0.9736842105263158,38,1050,600,450,0.5714285714285714,15,6,9,339.7733229274659,0.4484649122807018,0.1437937848033053,0.18926536809457664,129377.95380015406,1191.835455246885,130569.78925540094,1062,0,133.92105263157896,35,3,22,37.017918088737204,0.6160714285714286,45.65972222222221,1017.361111111109,29.06746031746026,0
4787,4,0,0,37,0.0,0.0,1.0,37,650,300,350,0.46153846153846156,10,3,7,345.64468659260206,0.44716591591591587,0.14221454600668126,0.19226485691713474,129322.44897959173,1539.9234693877447,130862.37244897948,1063,1,132.8918918918919,34,3,22,36.925035112359545,0.6176470588235294,45.71428571428571,1017.1428571428563,29.915966386554597,0
4788,4,0,0,37,0.0,0.0,1.0,37,800,500,300,0.625,11,5,6,345.4738210047535,0.44682182182182184,0.13788525367472726,0.19305889997324455,129504.14540816317,1548.058390022662,131052.20379818583,1064,2,133.8918918918919,34,3,12,36.74463937621832,0.6194852941176471,45.53571428571428,1017.8571428571421,29.936974789915944,0
4789,4,0,1,36,0.0,0.02702702702702703,0.972972972972973,37,1100,1000,100,0.9090909090909091,12,10,2,344.41829269614675,0.4466028528528529,0.13317912791781605,0.1929148433156607,129595.04145408151,1526.9805839002095,131122.02203798172,1065,3,134.8918918918919,34,3,12,36.67913792431505,0.6204044117647058,45.44642857142856,1018.2142857142846,29.947478991596608,0
4790,4,0,1,35,0.0,0.027777777777777776,0.9722222222222222,36,800,500,300,0.625,11,5,6,363.2576334908295,0.44394841269841273,0.10711019661636967,0.1961591220850481,128144.53125000012,2167.0422335601047,130311.57348356022,1066,6,139.55555555555554,32,4,17,37.680041152263385,0.6103515625,46.87500000000001,1012.5000000000009,31.64062500000003,8
4791,4,2,2,35,0.05405405405405406,0.05405405405405406,0.9459459459459459,37,700,400,300,0.5714285714285714,10,4,6,349.4976156243015,0.4460710710710711,0.11965147899439454,0.1912419537180168,128672.4175347223,1594.1406250000095,130266.55815972232,1067,0,136.56756756756758,33,4,18,37.48930527036276,0.6133207070707071,46.35416666666667,1014.583333333334,30.744949494949516,0
4792,4,0,0,35,0.0,0.0,1.0,35,850,600,250,0.7058823529411765,11,6,5,359.24155073690895,0.4443627450980392,0.10905016805676637,0.19617861162947578,128592.36501696255,2239.1441243240515,130831.5091412866,1068,1,140.22857142857143,32,3,19,37.323903481472264,0.6149088541666667,46.43308080808081,1014.2676767676767,31.695864898989896,0
4793,4,1,0,36,0.027777777777777776,0.0,1.0,36,1150,900,250,0.782608695652174,14,9,5,350.4639414322939,0.44581679894179893,0.09926091210013532,0.19358404652999,129045.69644187328,1845.1726799788498,130890.86912185213,1069,0,137.30555555555554,33,3,20,37.084263056326144,0.6171085858585859,45.986519607843135,1016.0539215686272,30.789512774806884,0
4794,4,2,1,37,0.05263157894736842,0.02631578947368421,0.9736842105263158,38,1200,800,400,0.6666666666666666,16,8,8,332.6513989148954,0.44855381697486957,0.10107308844904628,0.1865519221830569,129643.02722318664,1025.186873070976,130668.21409625762,1070,0,131.02631578947367,35,3,18,36.92997783839071,0.61875,45.39930555555555,1018.402777777777,29.0972222222222,0
4795,4,1,1,37,0.02631578947368421,0.02631578947368421,0.9736842105263158,38,950,700,250,0.7368421052631579,12,7,5,332.00860429436733,0.4494576813655761,0.1026109473205794,0.18647145669398388,129701.96926708246,1012.4339581189946,130714.40322520146,1071,0,132.0,35,3,19,36.88655171760784,0.6193452380952381,45.34143518518518,1018.6342592592591,29.103835978835974,0
4796,4,0,1,36,0.0,0.02702702702702703,0.972972972972973,37,1100,800,300,0.7272727272727273,14,8,6,340.0899772568367,0.44719719719719725,0.10745076226834893,0.19034355271599923,129564.73922902491,1412.7338435374113,130977.47307256232,1072,1,136.51351351351352,34,3,19,36.820090816962896,0.6200980392156863,45.476190476190474,1018.0952380952378,29.943977591036408,0
4797,4,1,0,37,0.02702702702702703,0.0,1.0,37,1150,900,250,0.782608695652174,14,9,5,342.95435190846376,0.4445382882882883,0.12859939378630947,0.19313745081160835,129807.25623582746,1503.5926870748053,131310.84892290225,1073,0,136.8108108108108,34,3,20,36.50092484423675,0.6225490196078431,45.23809523809523,1019.0476190476174,29.97198879551816,0
4798,4,0,0,37,0.0,0.0,1.0,37,900,500,400,0.5555555555555556,13,5,8,343.4785937942104,0.44400650650650647,0.1295492129214686,0.19403368583467137,129928.59977324259,1525.5385487528222,131454.13832199542,1074,1,137.8108108108108,34,3,20,36.36443250817373,0.6237745098039216,45.11904761904761,1019.5238095238092,29.985994397759093,0
4799,4,0,0,37,0.0,0.0,1.0,37,1150,900,250,0.782608695652174,14,9,5,344.6624227041324,0.44375625625625625,0.13382620571324066,0.19546077433168163,130080.35891439897,1566.7623299319575,131647.12124433092,1075,2,138.8108108108108,34,3,20,36.18032053526277,0.6253063725490196,44.97023809523809,1020.1190476190466,30.003501400560193,0
4800,4,0,1,36,0.0,0.02702702702702703,0.972972972972973,37,1050,700,350,0.6666666666666666,14,7,7,343.3865024957271,0.4433183183183183,0.1301219558335749,0.19519291110035625,130171.45691609968,1539.8242630385319,131711.2811791382,1076,3,139.8108108108108,34,3,20,36.12050863275781,0.6262254901960784,44.88095238095237,1020.4761904761897,30.01400560224087,0
4801,4,0,0,36,0.0,0.0,1.0,36,1350,900,450,0.6666666666666666,18,9,9,343.70055736600125,0.4408068783068783,0.13720841835714026,0.19598695026804622,130293.86421388394,1756.4147503363888,132050.2789642203,1077,4,143.86111111111111,33,3,20,35.98845176649463,0.6297348484848485,44.761029411764696,1020.95588235294,30.93805704099818,0
4802,4,1,0,37,0.02702702702702703,0.0,1.0,37,1000,800,200,0.8,12,8,4,333.78674545460854,0.44031531531531537,0.13859529920982472,0.1927349272141125,130779.59183673456,1330.498866213135,132110.0907029477,1078,0,140.94594594594594,34,3,20,35.750310366232156,0.6323529411764706,44.28571428571428,1022.8571428571418,30.084033613445346,0
4803,4,0,3,34,0.0,0.08108108108108109,0.9189189189189189,37,1250,700,550,0.56,18,7,11,386.5506514266033,0.4402527527527527,0.0631902333239629,0.21861225916815452,129972.73875114779,2729.25032444106,132701.98907558885,1079,1,141.94594594594594,32,5,18,35.221644378405145,0.62890625,45.07575757575757,1019.6969696969692,31.865530303030287,8
4804,4,1,0,35,0.02857142857142857,0.0,1.0,35,900,700,200,0.7777777777777778,11,7,4,394.06441488919756,0.4355392156862745,0.10836659387002068,0.22314632687904706,130022.58209041512,3247.454546768419,133270.03663718354,1080,0,150.5142857142857,30,5,19,34.97929845369883,0.6347222222222222,45.02688172043011,1019.8924731182799,33.99641577060933,0
4805,4,0,1,34,0.0,0.02857142857142857,0.9714285714285714,35,750,500,250,0.6666666666666666,10,5,5,396.4569527940893,0.43529411764705883,0.10696318037290053,0.2254904601172676,130193.99144771083,3323.262624291842,133517.25407200266,1081,1,151.5142857142857,30,5,19,34.743623512884675,0.6364583333333333,44.85887096774194,1020.5645161290331,34.0188172043011,0
4806,4,1,0,35,0.02857142857142857,0.0,1.0,35,1250,1100,150,0.88,14,11,3,393.2951470384321,0.43522408963585435,0.12215893068636885,0.22487959536080115,130399.8317182623,3257.12419788416,133656.95591614646,1082,0,152.0857142857143,30,5,21,34.61475194104488,0.6385416666666667,44.657258064516135,1021.370967741936,34.045698924731205,0
4807,4,1,1,35,0.027777777777777776,0.027777777777777776,0.9722222222222222,36,1350,1100,250,0.8148148148148148,16,11,5,381.57299828688275,0.4378968253968254,0.11727766463000688,0.22041452018689356,130794.81336805559,2781.5538194444503,133576.36718750003,1083,0,148.83333333333334,31,5,18,34.51289884589273,0.6397849462365591,44.270833333333336,1022.916666666667,32.997311827957,0
4808,4,0,0,35,0.0,0.0,1.0,35,1050,700,350,0.6666666666666666,14,7,7,392.40300487455687,0.4342436974789916,0.12778059547290344,0.2255649925979597,130605.83457986478,3250.0243886576577,133855.85896852243,1084,1,154.05714285714285,30,5,18,34.42800788954634,0.640625,44.45564516129033,1022.1774193548392,34.07258064516131,0
4809,4,0,1,34,0.0,0.02857142857142857,0.9714285714285714,35,900,400,500,0.4444444444444444,14,4,10,391.7182141555588,0.43392857142857144,0.11535902666740205,0.21100663053576973,128045.67337036123,3033.5562409713834,131079.22961133262,1085,2,155.05714285714285,31,4,19,37.061114327372536,0.6118951612903225,46.97265624999999,1012.1093749999992,32.648689516129004,8
4810,4,2,1,35,0.05555555555555555,0.027777777777777776,0.9722222222222222,36,1200,700,500,0.5833333333333334,17,7,10,370.3076498363138,0.43579695767195764,0.12605252311134718,0.20254218412786165,128655.37200832435,2328.489983389143,130983.8619917135,1086,0,151.55555555555554,30,6,19,36.97889065536127,0.6208333333333333,46.370967741935466,1014.5161290322555,33.817204301075186,0
4811,4,1,0,36,0.027777777777777776,0.0,1.0,36,900,500,400,0.5555555555555556,13,5,8,366.920972110517,0.4361607142857143,0.12661386193359347,0.20118081676837185,128752.49496224854,2248.3981226405185,131000.89308488906,1087,0,152.52777777777777,32,4,20,36.96555942605955,0.6165364583333333,46.27525252525251,1014.8989898989882,31.715593434343383,0
4812,4,0,1,35,0.0,0.027777777777777776,0.9722222222222222,36,1100,900,200,0.8181818181818182,13,9,4,366.53008165722355,0.4368716931216931,0.1245889634971955,0.20161661536849446,128880.6706586061,2247.728548107316,131128.39920671342,1088,1,153.52777777777777,32,4,21,36.844586752880694,0.6178385416666667,46.14898989898989,1015.4040404040392,31.731376262626224,0
4813,4,2,2,35,0.05405405405405406,0.05405405405405406,0.9459459459459459,37,650,400,250,0.6153846153846154,9,4,5,360.02376715576105,0.43771896896896895,0.1363691234658979,0.20095509440965592,129458.25043362903,1922.0079583715699,131380.2583920006,1089,0,149.75675675675674,32,5,18,36.42111248966087,0.6236979166666667,45.58080808080807,1017.6767676767662,31.802398989898943,0
4814,4,1,1,35,0.027777777777777776,0.027777777777777776,0.9722222222222222,36,800,300,500,0.375,13,3,10,386.3812369314227,0.4389880952380953,0.1291950962445223,0.20748568835754425,127920.90730537704,2687.7386554943428,130608.64596087138,1090,0,146.72222222222223,32,4,19,37.32422200033284,0.6080729166666667,47.0959595959596,1011.6161616161619,31.61300505050506,8
4815,4,0,1,34,0.0,0.02857142857142857,0.9714285714285714,35,700,400,300,0.5714285714285714,10,4,6,387.7439607294774,0.43704481792717087,0.14210719800014693,0.20869432567794316,128012.72922092021,2927.232530381949,130939.96175130217,1091,1,151.71428571428572,31,4,20,37.19548807685708,0.6115591397849462,47.005208333333336,1011.9791666666673,32.644489247311846,0
4816,4,1,0,35,0.02857142857142857,0.0,1.0,35,950,400,550,0.42105263157894735,15,4,11,387.9357239505706,0.4364495798319328,0.16702393187490827,0.21087232368933265,128408.33875868062,2962.836371527783,131371.1751302084,1092,0,152.54285714285714,31,4,19,36.784857828023284,0.6155913978494624,46.614583333333336,1013.5416666666672,32.694892473118294,0
4817,4,1,0,36,0.027777777777777776,0.0,1.0,36,1300,800,500,0.6153846153846154,18,8,10,378.26488085769694,0.4378968253968254,0.1655646754825959,0.20790347962930583,128848.62075617301,2547.781635802487,131396.4023919755,1093,0,149.27777777777777,32,4,20,36.57945736434108,0.6175130208333333,46.180555555555564,1015.2777777777792,31.7274305555556,0
4818,4,2,0,38,0.05263157894736842,0.0,1.0,38,1250,900,350,0.72,16,9,7,358.86943639093414,0.4396485301090564,0.16879220035822162,0.2006993165846228,129534.44054705238,1697.1903344671464,131231.63088151952,1094,0,142.3684210526316,34,4,22,36.372938837562856,0.6197916666666667,45.505952380952394,1017.9761904761923,29.940476190476243,0
4819,4,1,0,39,0.02564102564102564,0.0,1.0,39,1350,900,450,0.6666666666666666,18,9,9,350.177074594065,0.4407051282051282,0.1648850695172226,0.1977153636554182,129908.37191358028,1298.1867283950698,131206.55864197534,1095,0,139.69230769230768,35,4,24,36.21423705722071,0.6214285714285714,45.13888888888889,1019.4444444444447,29.126984126984134,0
4820,4,0,0,39,0.0,0.0,1.0,39,750,400,350,0.5333333333333333,11,4,7,350.43920511794545,0.4406770130454341,0.16223501023137765,0.19801276189121123,129937.87140185625,1307.0648737568706,131244.93627561312,1096,1,140.69230769230768,35,4,24,36.177607182048675,0.6217261904761905,45.10995370370371,1019.560185185186,29.130291005291028,0
4821,4,0,0,39,0.0,0.0,1.0,39,1050,700,350,0.6666666666666666,14,7,7,355.14503876719687,0.43941183085919927,0.1601698736128685,0.20158425735562424,130114.93866008674,1441.9349869256027,131556.87364701234,1097,2,141.69230769230768,35,4,24,35.877883342786916,0.6235119047619048,44.9363425925926,1020.2546296296309,29.15013227513231,0
4822,4,0,0,39,0.0,0.0,1.0,39,1350,900,450,0.6666666666666666,18,9,9,354.6855476884628,0.4387089518668466,0.16598639455782305,0.20208827717133382,130262.58680555591,1440.451388888928,131703.03819444485,1098,3,142.69230769230768,36,3,24,35.73979591836734,0.622974537037037,44.791666666666686,1020.8333333333362,28.356481481481563,0
4823,4,0,0,39,0.0,0.0,1.0,39,1350,1000,350,0.7407407407407407,17,10,7,346.71566840266195,0.43814664867296443,0.15853097419165918,0.1986324343278805,130475.34722222241,1247.5694444444644,131722.91666666686,1099,4,143.69230769230768,34,5,24,35.727637302881995,0.6292892156862745,44.58333333333334,1021.6666666666681,30.049019607843178,0
4824,4,0,0,39,0.0,0.0,1.0,39,1300,700,600,0.5384615384615384,19,7,12,348.38500465895004,0.4375,0.16110389319474927,0.20005921504997246,130566.58340419506,1297.4879535147422,131864.0713577098,1100,5,144.69230769230768,34,5,19,35.59260337798485,0.6302083333333333,44.49404761904762,1022.0238095238099,30.05952380952382,0
4825,4,0,0,39,0.0,0.0,1.0,39,1450,1200,250,0.8275862068965517,17,12,5,349.5654630304882,0.4378092667566352,0.16117713638936038,0.2014618960126787,130706.03358892743,1338.063030478389,132044.0966194058,1101,6,145.69230769230768,35,4,19,35.42126485568758,0.6294642857142857,44.357638888888886,1022.5694444444441,29.21626984126983,0
4826,4,0,0,39,0.0,0.0,1.0,39,1200,900,300,0.75,15,9,6,347.5595339325791,0.43769680611785877,0.14998172228314832,0.20076674254223065,130794.81336805533,1291.796874999976,132086.6102430553,1102,7,146.69230769230768,35,4,19,35.38272233537,0.6303571428571428,44.27083333333332,1022.9166666666648,29.226190476190425,0
4827,4,1,1,39,0.025,0.025,0.975,40,1050,800,250,0.7619047619047619,13,8,5,342.14421456187273,0.43993055555555555,0.15090454195535052,0.1990478146520221,131068.54056336729,968.868572964843,132037.40913633213,1103,0,144.0,36,4,20,35.24460207485611,0.6310763888888888,44.00337837837837,1023.9864864864855,28.444069069069045,0
4828,4,0,1,38,0.0,0.02564102564102564,0.9743589743589743,39,1400,1100,300,0.7857142857142857,17,11,6,342.2642891478015,0.4387089518668466,0.15166689850234216,0.19923384410393064,131090.9636488339,1173.551097393674,132264.51474622756,1104,1,147.3846153846154,35,4,20,35.218881856540065,0.6333333333333333,43.981481481481474,1024.074074074073,29.259259259259228,0
4829,4,0,1,37,0.0,0.02631578947368421,0.9736842105263158,38,1200,900,300,0.75,15,9,6,347.17933879637724,0.4375592697961119,0.1468393528854095,0.2025408956164625,131175.63952664376,1508.2943594104047,132683.93388605418,1105,2,149.71052631578948,34,4,21,35.00750532636064,0.6363357843137255,43.89880952380951,1024.40476190476,30.12955182072824,0
4830,4,0,0,37,0.0,0.0,1.0,37,1450,1000,450,0.6896551724137931,19,10,9,358.0608863664487,0.43477852852852855,0.1465241264236239,0.2086940647315744,131139.7734645328,1991.2047049211765,133130.97816945397,1106,3,154.48648648648648,33,4,22,34.76509531785914,0.6382575757575757,43.93382352941176,1024.2647058823525,31.03832442067735,0
4831,4,0,0,37,0.0,0.0,1.0,37,1500,1300,200,0.8666666666666667,17,13,4,355.57073696200655,0.43531031031031026,0.13592653248443853,0.2087761653446392,131422.35145436847,1945.9884719819265,133368.3399263504,1107,4,155.48648648648648,33,4,23,34.5433199872515,0.6410984848484849,43.658088235294116,1025.3676470588234,31.071746880570405,0
4832,4,1,0,38,0.02631578947368421,0.0,1.0,38,1350,1000,350,0.7407407407407407,17,10,7,352.0609979390234,0.4349069464201043,0.14207720274260027,0.20919988224641156,131877.8061224491,1685.8064058957086,133563.61252834482,1108,0,152.3684210526316,34,4,19,34.173862231494354,0.6433823529411764,43.21428571428572,1027.1428571428582,30.210084033613477,0
4833,4,1,0,39,0.02564102564102564,0.0,1.0,39,1000,700,300,0.7,13,7,6,338.68834992583186,0.4348571749887539,0.1415059234836491,0.2035565072677972,132308.68115837194,1162.2817804784033,133470.96293885034,1109,0,149.43589743589743,35,4,20,34.083909888626394,0.6455357142857143,42.79513888888889,1028.8194444444448,29.39484126984128,0
4834,4,0,0,39,0.0,0.0,1.0,39,1500,1100,400,0.7333333333333333,19,11,8,336.835548853448,0.4344073324336482,0.13266895048271587,0.20292287943122347,132398.00347222213,1119.270833333323,133517.27430555545,1110,1,150.43589743589743,35,4,20,34.041835357624834,0.6464285714285714,42.70833333333333,1029.1666666666658,29.40476190476188,0
4835,4,0,1,38,0.0,0.02564102564102564,0.9743589743589743,39,550,200,350,0.36363636363636365,9,2,7,334.11171011633417,0.4334514170040486,0.12957407135219912,0.20207966586709886,132546.94097490137,1057.0970239626145,133604.037998864,1111,2,151.43589743589743,35,4,20,33.96240774043686,0.6479166666666667,42.563657407407405,1029.74537037037,29.421296296296287,0
4836,4,0,1,37,0.0,0.02631578947368421,0.9736842105263158,38,1200,900,300,0.75,15,9,6,343.25006358849294,0.43012091038406824,0.14081640104423387,0.2074612019550578,132520.55165816328,1497.5375566893435,134018.08921485263,1112,3,156.21052631578948,34,4,21,33.75366130959263,0.6498161764705883,42.589285714285715,1029.6428571428573,30.28361344537816,0
4837,4,0,0,37,0.0,0.0,1.0,37,1100,900,200,0.8181818181818182,13,9,4,343.94277395502786,0.4299924924924925,0.12809411353100697,0.20838885716098737,132612.49999999997,1722.2222222222213,134334.7222222222,1113,4,157.27027027027026,34,3,21,33.643473570658045,0.6507352941176471,42.5,1029.9999999999998,30.294117647058815,0
4838,4,0,0,37,0.0,0.0,1.0,37,850,500,350,0.5882352941176471,12,5,7,342.91261967433167,0.4298048048048048,0.12637594266710406,0.2082742963706203,132704.4802295917,1701.208191609961,134405.68842120166,1114,5,158.27027027027026,34,3,17,33.57765260928172,0.6516544117647058,42.41071428571428,1030.3571428571418,30.304621848739462,0
4839,4,0,0,37,0.0,0.0,1.0,37,1300,900,400,0.6923076923076923,17,9,8,343.4315492527553,0.42864739739739743,0.12465896249680064,0.2091019939121204,132796.4923469386,1721.3010204081443,134517.79336734675,1115,6,159.27027027027026,34,3,17,33.47193347193346,0.6525735294117647,42.32142857142856,1030.7142857142844,30.31512605042013,0
4840,4,0,0,37,0.0,0.0,1.0,37,1050,900,150,0.8571428571428571,12,9,3,345.62625206420756,0.42836586586586584,0.12842439576827225,0.21130276793452563,132949.91673752826,1790.1962868480648,134740.11302437633,1116,7,160.27027027027026,34,3,18,33.261427911808845,0.6541053921568627,42.172619047619044,1031.3095238095232,30.33263305322127,0
4841,4,0,0,37,0.0,0.0,1.0,37,950,700,250,0.7368421052631579,12,7,5,347.7411467208246,0.4273023023023023,0.13263165114589737,0.21364762586270938,133134.14292800456,1859.2439058956934,134993.38683390024,1117,8,161.27027027027026,34,3,19,33.02211904487254,0.6559436274509804,41.99404761904762,1032.0238095238096,30.353641456582636,0
4842,4,0,1,36,0.0,0.02702702702702703,0.972972972972973,37,1050,600,450,0.5714285714285714,15,6,9,350.4794635021592,0.42689564564564564,0.13566519562260915,0.21642410054185224,133322.76562767907,1945.3782739626101,135268.14390164168,1118,9,162.27027027027026,35,2,19,32.7623603795435,0.6556547619047619,41.81134259259259,1032.7546296296289,29.50727513227511,0
4843,4,0,0,36,0.0,0.0,1.0,36,1050,700,350,0.6666666666666666,14,7,7,358.6033878385372,0.4255952380952381,0.14735803608036124,0.22086708660055338,133226.30385487515,2355.080782312911,135581.38463718805,1119,10,167.5,34,2,19,32.64937922816729,0.6568627450980392,41.9047619047619,1032.3809523809514,30.364145658263276,0
4844,4,0,1,35,0.0,0.027777777777777776,0.9722222222222222,36,750,500,250,0.6666666666666666,10,5,5,352.9445328894766,0.42534722222222227,0.13999013996132836,0.21828223178061207,133379.9762613378,2215.146683673467,135595.12294501127,1120,11,168.5,34,2,19,32.64136990511313,0.6583946078431373,41.75595238095238,1032.9761904761901,30.381652661064415,0
4845,4,0,1,34,0.0,0.02857142857142857,0.9714285714285714,35,600,400,200,0.6666666666666666,8,4,4,352.9445328894766,0.4257002801120448,0.13530680452427646,0.21828223178061207,133379.9762613378,2415.146683673467,135795.12294501127,1121,12,170.2,34,1,19,32.64136990511313,0.6583946078431373,41.75595238095238,1032.9761904761901,30.381652661064415,0
4846,4,0,1,33,0.0,0.029411764705882353,0.9705882352941176,34,1250,1000,250,0.8,15,10,5,363.8932074291181,0.4256907308377897,0.14395403517829863,0.22542128081079324,133440.56560277307,2911.6230836697546,136352.18868644282,1122,13,174.14705882352942,33,1,20,32.297844265211715,0.661300505050505,41.69730392156863,1033.2107843137262,31.30941770647655,0
4847,4,0,0,33,0.0,0.0,1.0,33,1050,700,350,0.6666666666666666,14,7,7,367.0706478497632,0.4226246843434343,0.12387091210899603,0.22797303711081773,133535.54672481745,3203.3959294502197,136738.94265426768,1123,14,173.93939393939394,33,0,20,32.12048454667615,0.6622474747474747,41.60539215686275,1033.5784313725496,31.320558526440898,0
4848,4,0,0,33,0.0,0.0,1.0,33,1400,1200,200,0.8571428571428571,16,12,4,368.8557862766305,0.4221906565656566,0.12578074211356194,0.2296705733443492,133630.56163795176,3258.081176710885,136888.64281466266,1124,15,174.93939393939394,33,0,20,31.979055548970805,0.6631944444444444,41.513480392156865,1033.9460784313726,31.33169934640523,0
4849,4,0,0,33,0.0,0.0,1.0,33,950,400,550,0.42105263157894735,15,4,11,368.6024572673569,0.42124368686868685,0.12012063765618275,0.23010390083849816,133725.61034217622,3258.3177143406547,136983.9280565169,1125,16,175.93939393939394,33,0,17,31.890304107424967,0.6641414141414141,41.42156862745099,1034.3137254901972,31.342840166369612,0
4850,4,1,0,34,0.029411764705882353,0.0,1.0,34,900,700,200,0.7777777777777778,11,7,4,360.0739859955083,0.422756981580511,0.12447599729547032,0.2270031650841246,134088.01020408157,2856.320861678003,136944.3310657596,1126,0,171.73529411764707,34,0,18,31.74808429118774,0.6654411764705883,41.07142857142857,1035.714285714285,30.46218487394956,0
4851,4,0,1,33,0.0,0.029411764705882353,0.9705882352941176,34,900,600,300,0.6666666666666666,12,6,6,358.3122606467498,0.4227755496137849,0.12126733235530751,0.22608230456036027,134118.8368055555,2811.2847222222185,136930.12152777772,1127,1,172.73529411764707,34,0,18,31.76287208366854,0.6657475490196079,41.041666666666664,1035.833333333333,30.465686274509796,0
4852,4,0,1,32,0.0,0.030303030303030304,0.9696969696969697,33,1300,1100,200,0.8461538461538461,15,11,4,377.9610704158788,0.4222695707070707,0.1101778656126482,0.21732761548913057,130617.28395061748,3282.156635802495,133899.44058641998,1128,2,177.8181818181818,32,1,19,34.785439311594196,0.6354166666666667,44.44444444444446,1022.2222222222238,31.944444444444493,8
4853,4,0,0,32,0.0,0.0,1.0,32,1250,900,350,0.72,16,9,7,377.14951989026036,0.42242103494623656,0.1023611111111109,0.21758626147515056,130746.38429752091,3462.1872130395177,134208.57151056043,1129,3,179.03125,32,0,19,34.67515432098765,0.63671875,44.318181818181834,1022.7272727272748,31.960227272727337,0
4854,4,0,0,32,0.0,0.0,1.0,32,800,700,100,0.875,9,7,2,377.42819071905683,0.4221900201612903,0.10601397630507181,0.21829412058504805,130843.25140610678,3476.7863292011352,134320.0377353079,1130,4,180.03125,32,0,19,34.56975811427866,0.6376953125,44.223484848484865,1023.1060606060627,31.97206439393946,0
4855,4,0,1,31,0.0,0.03125,0.96875,32,850,700,150,0.8235294117647058,10,7,3,376.28732397144177,0.4217489919354838,0.10737416728349336,0.21818204922120976,130940.15438475694,3454.224058769548,134394.37844352648,1131,5,181.03125,32,0,19,34.50067850974587,0.638671875,44.1287878787879,1023.4848484848508,31.983901515151587,0
4856,4,1,0,32,0.03125,0.0,1.0,32,1050,700,350,0.6666666666666666,14,7,7,375.1074096106812,0.42246303763440857,0.10213414634146312,0.21970576848625628,131328.12500000015,3452.4305555555698,134780.5555555557,1132,0,179.125,32,0,20,34.13787262872627,0.642578125,43.75000000000001,1025.0000000000011,32.031250000000036,0
4857,4,0,0,32,0.0,0.0,1.0,32,550,500,50,0.9090909090909091,6,5,1,372.2763416477702,0.42214801747311825,0.09966269841269848,0.2186186570079187,131428.24172973633,3385.5250040690107,134813.76673380533,1133,1,180.125,31,1,20,34.109126984126995,0.6461693548387097,43.65234375,1025.390625,33.07711693548387,0
4858,4,0,0,32,0.0,0.0,1.0,32,900,800,100,0.8888888888888888,10,8,2,373.52880582113613,0.4220220094086022,0.09894709280182767,0.21973759547819954,131495.00740898988,3423.4346177842926,134918.44202677417,1134,2,181.125,31,1,20,34.00948436375947,0.6468413978494624,43.587239583333336,1025.6510416666672,33.085517473118294,0
4859,4,0,0,32,0.0,0.0,1.0,32,850,700,150,0.8235294117647058,10,7,3,371.7682866156816,0.42181199596774194,0.09797801116893012,0.21908469186574084,131561.7900424533,3382.1002536349774,134943.89029608827,1135,3,182.125,31,1,17,33.987101789567205,0.647513440860215,43.522135416666664,1025.911458333333,33.09391801075268,0
4860,4,0,0,32,0.0,0.0,1.0,32,1250,1200,50,0.96,13,12,1,369.710396580983,0.4212029569892473,0.10185390763765545,0.2184450783996482,131661.99578179244,3335.361735026036,134997.35751681848,1136,4,183.125,31,1,17,33.93861541064028,0.648521505376344,43.424479166666664,1026.3020833333328,33.10651881720428,0
4861,4,0,1,31,0.0,0.03125,0.96875,32,850,700,150,0.8235294117647058,10,7,3,378.8427276925333,0.42097194220430106,0.032126566960406944,0.21094235362949137,129361.8974626313,3401.5628188450055,132763.4602814763,1137,5,184.125,32,0,18,36.04060651193578,0.6227213541666667,45.675505050505045,1017.2979797979793,31.790561868686854,8
4862,4,0,0,31,0.0,0.0,1.0,31,650,300,350,0.46153846153846156,10,3,7,385.40628227374134,0.41845878136200715,0.010566941159474208,0.21498573133256876,129433.1550598145,3776.8702189127625,133210.02527872726,1138,6,181.38709677419354,31,0,16,35.80094369801662,0.626008064516129,45.60546875,1017.5781250000003,32.82510080645162,0
4863,4,0,0,31,0.0,0.0,1.0,31,700,300,400,0.42857142857142855,11,3,8,383.6118552295684,0.4186379928315412,0.011620661337778948,0.21434552339739368,129499.41211276592,3735.501946343322,133234.91405910923,1139,7,182.38709677419354,31,0,16,35.77899130101059,0.6266801075268817,45.540364583333336,1017.8385416666673,32.833501344086045,0
4864,4,0,0,31,0.0,0.0,1.0,31,900,800,100,0.8888888888888888,10,8,2,385.8806934713804,0.41845878136200715,-0.04241974838129736,0.21027662421704976,128507.33651055237,3717.700025770404,132225.03653632276,1140,8,183.38709677419354,31,0,19,36.73550468729934,0.6165994623655914,46.516927083333336,1013.9322916666672,32.70749327956991,8
4865,4,0,0,31,0.0,0.0,1.0,31,1000,800,200,0.8,12,8,4,382.3200173282613,0.41836917562724013,-0.03816797054572407,0.2086818931303314,128573.3562045628,3631.233554416242,132204.58975897904,1141,9,184.38709677419354,31,0,19,36.75816857106175,0.617271505376344,46.45182291666667,1014.192708333334,32.715893817204325,0
4866,4,0,0,31,0.0,0.0,1.0,31,850,500,350,0.5882352941176471,12,5,7,382.80719655604213,0.41742831541218633,-0.035768695767371184,0.20946865699190176,128672.41753472232,3651.3454861111213,132323.76302083343,1142,10,185.38709677419354,31,0,20,36.64442162902121,0.6182795698924731,46.35416666666667,1014.5833333333342,32.72849462365594,0
4867,4,1,0,32,0.03125,0.0,1.0,32,550,400,150,0.7272727272727273,7,4,3,373.03680570500376,0.42111895161290325,-0.03281133482475762,0.20586105203720592,129008.91012396707,3225.0143480257275,132233.9244719928,1143,0,180.5625,32,0,21,36.548440218742236,0.619140625,46.02272727272728,1015.9090909090919,31.747159090909122,0
4868,4,1,1,32,0.030303030303030304,0.030303030303030304,0.9696969696969697,33,900,600,300,0.6666666666666666,12,6,6,362.74982225144373,0.4254655934343434,-0.02333136228583088,0.20211738418332145,129388.34372597098,2787.11973760095,132175.4634635719,1144,0,176.06060606060606,33,0,22,36.42295029310208,0.6205808080808081,45.64950980392158,1017.4019607843153,30.830362448009556,0
4869,4,0,0,32,0.0,0.0,1.0,32,900,600,300,0.6666666666666666,12,6,6,366.1923393148996,0.42504620295698925,-0.0039668383174087385,0.20423142301306424,129426.12879106733,3078.9713740944935,132505.10016516183,1145,1,181.0,32,0,20,36.29689374198618,0.6233723958333333,45.612373737373744,1017.5505050505058,31.798453282828305,0
4870,4,0,0,32,0.0,0.0,1.0,32,650,300,350,0.46153846153846156,10,3,7,364.57358750432303,0.4245001680107527,-0.010618254558987683,0.2036609624998163,129490.37606175398,3041.7541896235184,132532.1302513775,1146,2,182.0,32,0,20,36.27263987098376,0.6240234375,45.54924242424243,1017.8030303030309,31.806344696969717,0
4871,4,0,1,31,0.0,0.03125,0.96875,32,850,600,250,0.7058823529411765,11,6,5,386.14222700775,0.4244791666666667,-0.024030130920292603,0.21111818179771072,128639.39285278309,3536.9160115335585,132176.30886431664,1147,3,183.0,31,1,19,36.59363902793823,0.6179435483870968,46.38671874999999,1014.4531249999991,32.72429435483868,8
4872,4,1,1,31,0.03125,0.03125,0.96875,32,850,600,250,0.7058823529411765,11,6,5,378.7259950926299,0.42653729838709675,0.0012820114370963864,0.20866245921404886,128944.7824201611,3366.9482068156212,132311.7306269767,1148,0,182.78125,32,0,20,36.46946999834247,0.6184895833333333,46.08585858585858,1015.6565656565647,31.739267676767646,0
4873,4,0,0,31,0.0,0.0,1.0,31,850,500,350,0.5882352941176471,12,5,7,385.96312305568995,0.4251792114695341,0.016935277141510774,0.2129621135841932,129002.8974745008,3758.0722384982546,132760.96971299907,1149,1,188.96774193548387,31,0,20,36.2262881312484,0.6216397849462365,46.02864583333333,1015.8854166666661,32.77049731182794,0
4874,4,0,0,31,0.0,0.0,1.0,31,1250,900,350,0.72,16,9,7,384.5646105871641,0.4251792114695341,0.015075252287322538,0.21290151420165973,129135.2081298828,3732.1662055121524,132867.37433539494,1150,2,189.96774193548387,31,0,20,36.12659065675975,0.622983870967742,45.8984375,1016.4062499999999,32.78729838709677,0
4875,4,0,0,31,0.0,0.0,1.0,31,850,400,450,0.47058823529411764,13,4,9,384.3052942757326,0.4244623655913979,0.01586462189317861,0.21311475409836053,129201.38888888879,3730.5555555555443,132931.94444444432,1151,3,190.96774193548387,31,0,20,36.06557377049182,0.6236559139784946,45.83333333333333,1016.6666666666658,32.795698924731155,0
4876,4,0,0,31,0.0,0.0,1.0,31,800,400,400,0.5,12,4,8,383.9400434297571,0.42302867383512543,0.009775671458176705,0.21398769610271928,129400.03289116759,3736.370849609379,133136.40374077696,1152,4,191.96774193548387,31,0,20,35.872045900520426,0.6256720430107527,45.638020833333336,1017.4479166666671,32.82090053763442,0
4877,4,0,0,31,0.0,0.0,1.0,31,800,600,200,0.75,10,6,4,385.4062822737414,0.42334229390681005,0.007396858811631768,0.21498573133256885,129433.15505981457,3776.8702189127753,133210.02527872735,1153,5,192.96774193548387,31,0,16,35.80094369801663,0.626008064516129,45.60546875000001,1017.5781250000009,32.825100806451644,0
4878,4,0,0,31,0.0,0.0,1.0,31,800,500,300,0.625,11,5,6,385.95796197621456,0.42311827956989245,0.001848741576464974,0.21565642521573053,129499.41211276589,3796.26583523221,133295.6779479981,1154,6,193.96774193548387,31,0,16,35.71929235427059,0.6266801075268817,45.540364583333336,1017.8385416666671,32.83350134408604,0
4879,4,1,0,32,0.03125,0.0,1.0,32,700,400,300,0.5714285714285714,10,4,6,376.45984453073385,0.4236811155913978,0.00536444141689385,0.21255501991196823,129908.3719135803,3381.0570987654396,133289.42901234573,1155,0,188.875,32,0,17,35.54439146230699,0.6282552083333333,45.13888888888889,1019.4444444444448,31.8576388888889,0
4880,4,0,0,32,0.0,0.0,1.0,32,800,500,300,0.625,11,5,6,373.55998118652553,0.422820060483871,0.007275807649461674,0.21178884828111885,130069.31889921962,3317.738464187348,133387.05736340696,1156,1,189.875,32,0,18,35.454573585839825,0.6298828125,44.981060606060616,1020.0757575757589,31.877367424242465,0
4881,4,2,2,32,0.058823529411764705,0.058823529411764705,0.9411764705882353,34,350,200,150,0.5714285714285714,5,2,3,361.48105182271934,0.4284387997623292,0.026843799219338216,0.2083974654467892,130718.71456916102,2650.4676870748303,133369.18225623586,1157,0,179.64705882352942,34,0,16,35.10380287155606,0.6317401960784313,44.345238095238095,1022.6190476190478,30.077030812324935,0
4882,4,0,1,31,0.0,0.03125,0.96875,32,1100,800,300,0.7272727272727273,14,8,6,379.63491612544465,0.4210349462365592,0.030578206078577086,0.21792659653328714,130552.75769054177,3512.477043158861,134065.23473370064,1158,1,191.59375,32,0,16,34.80819125277985,0.634765625,44.50757575757576,1021.9696969696968,31.936553030303024,0
4883,4,0,0,31,0.0,0.0,1.0,31,950,900,50,0.9473684210526315,10,9,1,390.2827700920927,0.41711469534050183,0.031033490856790413,0.22428402234428477,130595.10125054262,3993.8035753038243,134588.90482584643,1159,2,198.32258064516128,31,0,17,34.493099787685765,0.637768817204301,44.466145833333336,1022.1354166666673,32.97211021505378,0
4884,4,1,1,31,0.03125,0.03125,0.96875,32,850,800,50,0.9411764705882353,9,8,1,380.3350744232582,0.42015288978494625,0.03688486679822378,0.22089948305327928,131004.77629833695,3565.142268646061,134569.91856698302,1160,0,193.09375,32,0,18,34.33157580989968,0.6393229166666667,44.06565656565657,1023.7373737373741,31.99179292929294,0
4885,4,0,0,31,0.0,0.0,1.0,31,800,500,300,0.625,11,5,6,391.4793880180512,0.4163082437275986,0.042551095789214344,0.22691946827595,130928.03955078126,4051.125759548612,134979.16531032987,1161,1,199.7741935483871,31,0,18,34.12425784563188,0.6411290322580645,44.140625,1023.4375000000001,33.01411290322581,0
4886,4,0,0,31,0.0,0.0,1.0,31,950,800,150,0.8421052631578947,11,8,3,392.3243991611465,0.4166666666666667,0.03938413065685342,0.22800049893600116,131028.00369262695,4081.09656439887,135109.10025702583,1162,2,200.7741935483871,31,0,19,34.0011499003773,0.6421370967741935,44.04296875,1023.828125,33.026713709677416,0
4887,4,0,0,31,0.0,0.0,1.0,31,1350,1200,150,0.8888888888888888,15,12,3,392.1714533515951,0.4171594982078853,0.036749174579086,0.22830706740268672,131094.6676466201,4082.3172675238775,135176.98491414398,1163,3,201.7741935483871,31,0,19,33.93740728968,0.6428091397849462,43.977864583333336,1024.0885416666674,33.03511424731185,0
4888,4,0,0,31,0.0,0.0,1.0,31,1400,1000,400,0.7142857142857143,18,10,8,392.9257034175103,0.41693548387096774,0.04695659302373234,0.22974184887784602,131261.40170627178,4115.195719401051,135376.59742567284,1164,4,202.7741935483871,31,0,19,33.74894112664126,0.644489247311828,43.81510416666667,1024.739583333334,33.05611559139787,0
4889,4,0,0,31,0.0,0.0,1.0,31,700,500,200,0.7142857142857143,9,5,4,393.61491175887363,0.4166666666666667,0.04982953055337025,0.2305458768873403,131328.125,4138.575575086806,135466.7005750868,1165,5,203.7741935483871,29,2,19,33.663617886178855,0.6508620689655172,43.75,1025.0,35.3448275862069,0
4890,4,0,0,31,0.0,0.0,1.0,31,850,700,150,0.8235294117647058,10,7,3,396.8802099845113,0.4167114695340502,0.050707475026437576,0.23289107393526726,131399.31520061722,4229.957561728384,135629.2727623456,1166,6,204.7741935483871,29,2,19,33.507744062133106,0.6515804597701149,43.68055555555555,1025.2777777777771,35.354406130268174,0
4891,4,0,0,31,0.0,0.0,1.0,31,800,400,400,0.5,12,4,8,401.20038625731627,0.41617383512544803,0.055258365830120226,0.23652571853813215,131577.37509645068,4357.778742283962,135935.15383873464,1167,7,205.7741935483871,29,2,17,33.216433148323645,0.6533764367816092,43.50694444444445,1025.9722222222226,35.37835249042147,0
4892,4,0,0,31,0.0,0.0,1.0,31,600,500,100,0.8333333333333334,7,5,2,398.3902114679211,0.41509856630824377,0.053695230455672815,0.23539067817017661,131661.9957817926,4290.570068359385,135952.56585015196,1168,8,206.7741935483871,31,0,17,33.2027615664383,0.648521505376344,43.42447916666667,1026.302083333334,33.10651881720432,0
4893,4,0,0,31,0.0,0.0,1.0,31,700,300,400,0.42857142857142855,11,3,8,402.1472265593428,0.4153673835125448,0.048438235113629435,0.23823673038470475,131762.23966810454,4397.563849555147,136159.8035176597,1169,9,207.7741935483871,31,0,17,33.004782287042914,0.6495295698924731,43.32682291666668,1026.6927083333346,33.119119623655955,0
4894,4,0,0,31,0.0,0.0,1.0,31,700,400,300,0.5714285714285714,10,4,6,404.15718641097055,0.41532258064516125,0.04187659490937645,0.2400596300007332,131862.52170138896,4458.637152777787,136321.15885416674,1170,10,208.7741935483871,31,0,17,32.85158891142664,0.6505376344086021,43.22916666666667,1027.083333333334,33.13172043010755,0
4895,4,0,1,30,0.0,0.03225806451612903,0.967741935483871,31,950,600,350,0.631578947368421,13,6,7,407.7130872656482,0.414426523297491,0.047878146193499393,0.24281237521609284,131962.841881646,4560.595533582894,136523.4374152289,1171,11,209.7741935483871,31,0,17,32.658645925738185,0.6515456989247312,43.131510416666664,1027.473958333333,33.14432123655913,0
4896,4,1,0,31,0.03225806451612903,0.0,1.0,31,1100,900,200,0.8181818181818182,13,9,4,407.07484979253104,0.41774193548387095,0.025352331246503157,0.2441521821193017,132230.54885864258,4565.546162923176,136796.09502156576,1172,0,199.03225806451613,31,0,19,32.40402266109635,0.654233870967742,42.87109375,1028.515625,33.177923387096776,0
4897,4,0,0,31,0.0,0.0,1.0,31,1150,800,350,0.6956521739130435,15,8,7,391.5672622731826,0.41742831541218633,0.058499124454102214,0.2333228152828124,131983.3420951845,4136.1771497882,136119.51924497267,1173,1,200.03225806451613,30,1,19,33.05264879005887,0.6545138888888888,43.11155913978495,1027.5537634408608,34.25179211469536,8
4898,4,1,0,32,0.03125,0.0,1.0,32,900,600,300,0.6666666666666666,12,6,6,381.73458836835766,0.4187878024193548,0.05858485193621865,0.2295636771146699,132331.0089111328,3703.0646430121533,136034.07355414497,1174,0,194.75,31,1,20,32.95420990466549,0.655241935483871,42.7734375,1028.90625,33.190524193548384,0
4899,4,0,0,32,0.0,0.0,1.0,32,950,800,150,0.8421052631578947,11,8,3,382.2379183228687,0.4187878024193548,0.0546588320890804,0.2300705459638713,132364.5040724012,3718.9464992947014,136083.4505716959,1175,1,195.75,31,1,20,32.907466573874885,0.6555779569892473,42.740885416666664,1029.036458333333,33.194724462365585,0
4900,4,0,0,32,0.0,0.0,1.0,32,950,700,250,0.7368421052631579,12,7,5,385.3212253848646,0.4184727822580645,0.05781210473058418,0.23254577159486564,132465.01498752166,3808.3163791232596,136273.3313666449,1176,2,196.75,31,1,20,32.726726536807476,0.6565860215053764,42.643229166666664,1029.427083333333,33.20732526881719,0
4901,4,0,0,32,0.0,0.0,1.0,32,1200,900,300,0.75,15,9,6,384.97282033613425,0.41742271505376344,0.06284757330637003,0.23358166828983853,132666.15125868062,3814.5724826388987,136480.72374131953,1177,3,197.75,31,1,17,32.53286147623863,0.6586021505376345,42.44791666666667,1030.208333333334,33.23252688172045,0
4902,4,0,0,32,0.0,0.0,1.0,32,1100,900,200,0.8181818181818182,13,9,4,386.02268391108913,0.4174437163978495,0.06499194363705318,0.23442805048261323,132699.68880547423,3845.0180053710988,136544.70681084532,1178,4,198.75,31,1,17,32.47201335355323,0.6589381720430108,42.415364583333336,1030.338541666667,33.23672715053765,0
4903,4,0,2,30,0.0,0.0625,0.9375,32,750,500,250,0.6666666666666666,10,5,5,397.70772094785565,0.4164776545698925,-0.029187523173896945,0.22773200072109687,130455.99819214873,3976.6715449954077,134432.66973714414,1179,5,199.75,32,0,19,34.444907922382896,0.6337890625,44.60227272727273,1021.5909090909089,31.924715909090903,8
4904,4,1,1,30,0.03225806451612903,0.03225806451612903,0.967741935483871,31,550,200,350,0.36363636363636365,9,2,7,422.9527675910297,0.4163082437275986,-0.06610511208310565,0.23213221663135586,128791.7678344317,4757.841723091279,133549.60955752298,1180,0,203.96774193548387,30,1,19,35.503564177259875,0.6222222222222222,46.236559139784944,1015.05376344086,33.83512544802867,8
4905,4,0,0,30,0.0,0.0,1.0,30,850,500,350,0.5882352941176471,12,5,7,424.63802560441354,0.4133860153256705,-0.050022799817601604,0.23339127572693702,128848.62075617285,4942.80478395062,133791.42554012348,1181,1,211.56666666666666,29,1,19,35.40241678066575,0.6257183908045977,46.18055555555556,1015.2777777777778,35.009578544061306,0
4906,4,1,0,31,0.03225806451612903,0.0,1.0,31,1400,1000,400,0.7142857142857143,18,10,8,410.09429895541,0.41774193548387095,-0.058172796139433824,0.22800760912531845,129303.89577190996,4405.358097756955,133709.25386966692,1182,0,205.70967741935485,30,1,20,35.30516276815999,0.6274305555555555,45.732526881720425,1017.0698924731175,33.90232974910392,0
4907,4,1,1,31,0.03125,0.03125,0.96875,32,800,600,200,0.75,10,6,4,401.0369823432011,0.4192708333333333,-0.0510499232932754,0.22502950329185947,129665.12891981343,4000.102403428828,133665.23132324227,1183,0,200.25,31,1,19,35.16630444046706,0.6283602150537635,45.37760416666667,1018.4895833333339,32.85450268817206,0
4908,4,1,1,31,0.03125,0.03125,0.96875,32,1150,800,350,0.6956521739130435,15,8,7,406.0782259028318,0.41710769489247307,-0.0196328094683742,0.21140678548517122,126665.66848754884,3887.2339884440116,130552.90247599286,1184,0,201.1875,31,1,15,38.12047277195705,0.5977822580645161,48.33984375,1006.6406250000001,32.472278225806456,8
4909,4,0,0,31,0.0,0.0,1.0,31,700,600,100,0.8571428571428571,8,6,2,415.46460091131564,0.41491935483870973,-0.008960573476702427,0.2160415924738842,126618.10613943812,4321.068187073659,130939.17432651178,1185,1,208.6451612903226,30,1,17,37.93347133190884,0.6,48.38709677419355,1006.4516129032261,33.5483870967742,0
4910,4,2,0,33,0.06060606060606061,0.0,1.0,33,750,400,350,0.5333333333333333,11,4,7,395.2111603835206,0.4239267676767677,-0.012576326468691557,0.2085691658827169,127219.36058820551,3455.702224262864,130675.06281246837,1186,0,196.93939393939394,32,1,19,37.82279933249899,0.6009114583333333,47.790404040404056,1008.8383838383857,31.52619949494955,0
4911,4,0,0,33,0.0,0.0,1.0,33,1000,800,200,0.8,12,8,4,393.2048386702179,0.42412405303030304,-0.01161622480276292,0.20800041532038768,127314.91246110116,3412.1679229160636,130727.08038401723,1187,1,197.93939393939394,32,1,15,37.77498019100045,0.6018880208333333,47.69570707070709,1009.2171717171739,31.538036616161683,0
4912,4,1,1,33,0.029411764705882353,0.029411764705882353,0.9705882352941176,34,1000,800,200,0.8,12,8,4,383.0386330944421,0.42660056446821154,-0.009190507778229273,0.20446081599546076,127679.65032980128,2981.247747260703,130660.89807706198,1188,0,193.08823529411765,33,1,16,37.656496301685465,0.603219696969697,47.33455882352943,1010.6617647058844,30.626114081996494,0
4913,4,0,1,32,0.0,0.030303030303030304,0.9696969696969697,33,850,400,450,0.47058823529411764,13,4,9,393.4304020636695,0.42286142676767674,-0.0030359812995663926,0.2101007584069165,127697.47865332638,3448.014073819024,131145.4927271454,1189,1,199.87878787878788,32,1,18,37.3755985842182,0.6057942708333333,47.316919191919204,1010.7323232323248,31.58538510101015,0
4914,4,2,0,34,0.058823529411764705,0.0,1.0,34,600,400,200,0.6666666666666666,8,4,4,373.5687965051978,0.4282345513963161,0.012033085485503303,0.20221112588155868,128240.42986685043,2782.1057800224626,131022.5356468729,1190,0,194.08823529411765,32,2,21,37.32080528546498,0.611328125,46.78030303030304,1012.8787878787888,31.65246212121215,0
4915,4,0,0,34,0.0,0.0,1.0,34,1000,600,400,0.6,14,6,8,372.2313829846656,0.42860591206179444,0.012134001582695841,0.20245755708678193,128432.33471074406,2761.309113865966,131193.64382461004,1191,1,195.08823529411765,32,2,13,37.15822745391131,0.61328125,46.59090909090911,1013.6363636363658,31.67613636363643,0
4916,4,0,1,33,0.0,0.029411764705882353,0.9705882352941176,34,900,500,400,0.5555555555555556,13,5,8,371.91869970317924,0.4282159833630422,0.01421519803140403,0.20293824701195243,128560.3509845936,2762.7997143148946,131323.1506989085,1192,2,196.08823529411765,32,2,14,37.035192563081004,0.6145833333333333,46.46464646464648,1014.1414141414158,31.691919191919244,0
4917,4,0,0,33,0.0,0.0,1.0,33,950,800,150,0.8421052631578947,11,8,3,378.1659835320153,0.4240451388888889,0.015293047551111938,0.20585048690024096,128464.33280086236,3116.1681524844666,131580.50095334684,1193,3,202.96969696969697,32,1,15,36.975079918628296,0.6136067708333333,46.55934343434345,1013.7626262626279,31.680082070707122,0
4918,4,2,0,35,0.05714285714285714,0.0,1.0,35,1100,800,300,0.7272727272727273,14,8,6,359.2397560605829,0.4287464985994398,0.034474450356390296,0.19890979489268856,129140.88010204083,2278.507653061231,131419.38775510207,1194,0,192.31428571428572,34,1,18,36.76431834153198,0.6158088235294117,45.892857142857146,1016.4285714285716,29.89495798319328,0
4919,4,2,2,35,0.05405405405405406,0.05405405405405406,0.9459459459459459,37,750,400,350,0.5333333333333333,11,4,7,343.05154893707623,0.43559184184184185,0.03585587632855014,0.19267368744066393,129701.9692670823,1498.9064637879142,131200.8757308702,1195,0,182.86486486486487,35,2,17,36.60533367420369,0.6193452380952381,45.341435185185176,1018.6342592592578,29.103835978835935,0
4920,4,1,0,36,0.027777777777777776,0.0,1.0,36,1100,800,300,0.7272727272727273,14,8,6,352.0660865448818,0.43323412698412694,0.05512956441617156,0.19803436165205088,129760.92470689744,1936.8841896004992,131697.80889649794,1196,0,188.72222222222223,35,1,18,36.315862963383694,0.6199404761904762,45.283564814814824,1018.865740740742,29.110449735449773,0
4921,4,0,0,36,0.0,0.0,1.0,36,1050,700,350,0.6666666666666666,14,7,7,353.91542198032465,0.432771164021164,0.060920606083544326,0.19967540816019985,129878.87577428418,1993.2274251971928,131872.10319948138,1197,1,189.72222222222223,35,1,18,36.14892036637522,0.6211309523809524,45.167824074074076,1019.3287037037042,29.12367724867726,0
4922,4,0,0,36,0.0,0.0,1.0,36,850,700,150,0.8235294117647058,10,7,3,348.90246009692794,0.43285383597883603,0.03567535019331958,0.1907754249999734,128643.06205257634,1776.7761649091299,130419.83821748546,1198,2,190.72222222222223,35,1,20,37.53434588324779,0.6086309523809523,46.383101851851855,1014.4675925925928,28.984788359788368,7
4923,4,1,1,36,0.02702702702702703,0.02702702702702703,0.972972972972973,37,800,400,400,0.5,12,4,8,341.22257651213204,0.4356544044044044,0.047227624564357695,0.18799550504355061,128943.91593874304,1399.7150444363497,130343.63098317939,1199,0,186.54054054054055,36,1,21,37.42261706767193,0.6096643518518519,46.08671171171172,1015.6531531531551,28.21258758758764,0
4924,4,1,1,36,0.02702702702702703,0.02702702702702703,0.972972972972973,37,1200,800,400,0.6666666666666666,16,8,8,338.2587896053203,0.4348410910910911,0.06895490983813324,0.18785978037119752,129260.23046339171,1344.9386225408477,130605.16908593256,1200,0,187.3783783783784,35,2,22,37.176094544350875,0.6148809523809524,45.77546296296297,1016.8981481481487,29.05423280423282,0
4925,4,0,0,36,0.0,0.0,1.0,36,1000,800,200,0.8,12,8,4,345.2470045393816,0.4316798941798942,0.07114011471380066,0.19189623681066606,129292.17864229028,1727.5474773242663,131019.72611961454,1201,1,193.41666666666666,34,2,23,36.96593702446447,0.6173406862745099,45.74404761904762,1017.0238095238097,29.912464985994404,0
4926,4,0,0,36,0.0,0.0,1.0,36,500,400,100,0.8,6,4,2,344.6378363948155,0.43196097883597884,0.07322227424053329,0.19170479649461616,129322.44897959183,1713.881802721091,131036.33078231293,1202,2,194.41666666666666,34,2,23,36.950637874531836,0.6176470588235294,45.714285714285715,1017.1428571428571,29.915966386554622,0
4927,4,0,0,36,0.0,0.0,1.0,36,1100,1000,100,0.9090909090909091,12,10,2,344.09437357840295,0.4314153439153439,0.07104832104832104,0.19184439732384942,129413.28125000001,1706.07638888889,131119.3576388889,1203,3,195.41666666666666,34,2,23,36.872099372099385,0.6185661764705883,45.625,1017.5000000000001,29.926470588235297,0
4928,4,1,0,37,0.02702702702702703,0.0,1.0,37,1300,900,400,0.6923076923076923,17,9,8,337.96540025365016,0.4324011511511512,0.06608039044154901,0.190389337762853,129819.89354263128,1374.9264564043335,131194.81999903562,1204,0,191.1081081081081,35,2,21,36.615204429301535,0.6205357142857143,45.22569444444445,1019.0972222222231,29.117063492063515,0
4929,4,1,1,37,0.02631578947368421,0.02631578947368421,0.9736842105263158,38,800,500,300,0.625,11,5,6,331.6613704234506,0.4329510431484116,0.0833904447722702,0.1885517778404839,130176.38204082484,1034.8954528853437,131211.2774937102,1205,0,187.05263157894737,36,2,22,36.41465276245126,0.6221064814814814,44.87612612612614,1020.4954954954974,28.347097097097148,0
4930,4,1,0,38,0.02631578947368421,0.0,1.0,38,1200,900,300,0.75,15,9,6,334.6526410833451,0.4334400189663348,0.09058096385829706,0.19096413969193202,130321.6695066014,1122.5267117561652,131444.19621835757,1206,0,187.89473684210526,35,3,23,36.191245371419946,0.6255952380952381,44.73379629629629,1021.0648148148141,29.173280423280403,0
4931,4,0,0,38,0.0,0.0,1.0,38,1350,900,450,0.6666666666666666,18,9,9,333.57471463715956,0.4335289236605026,0.09383499546690821,0.19063881359833515,130380.76560356651,1098.3453360768144,131479.11093964332,1207,1,188.89473684210526,35,3,24,36.158960411000315,0.6261904761904762,44.675925925925924,1021.2962962962962,29.179894179894177,0
4932,4,0,0,38,0.0,0.0,1.0,38,950,600,350,0.631578947368421,13,6,7,331.88836136446525,0.43318812233285914,0.09645942771281923,0.19010892704504415,130469.4348663621,1060.2573891889367,131529.69225555105,1208,2,189.89473684210526,35,3,24,36.112330538876925,0.6270833333333333,44.58912037037036,1021.6435185185169,29.189814814814767,0
4933,4,0,0,38,0.0,0.0,1.0,38,1000,800,200,0.8,12,8,4,335.26946257869554,0.43262505926979616,0.10279065333698756,0.1930749955945368,130676.44702717755,1162.3644332990307,131838.81146047657,1209,3,190.89473684210526,35,3,16,35.81663648026565,0.6291666666666667,44.38657407407407,1022.453703703703,29.212962962962944,0
4934,4,0,1,37,0.0,0.02631578947368421,0.9736842105263158,38,850,600,250,0.7058823529411765,11,6,5,334.59728180914993,0.4320471787577051,0.10393828785109038,0.19342742798633578,130824.41332572431,1154.6986186128056,131979.1119443371,1210,4,191.89473684210526,35,3,17,35.684301580118415,0.6306547619047619,44.24189814814814,1023.0324074074063,29.229497354497322,0
4935,4,0,0,37,0.0,0.0,1.0,37,1150,900,250,0.782608695652174,14,9,5,344.9855239696495,0.4297422422422423,0.10850440805055017,0.19935848066383297,130810.03578514728,1625.5137471655164,132435.54953231278,1211,6,197.97297297297297,34,3,17,35.43315295395476,0.6326593137254901,44.25595238095237,1022.9761904761896,30.087535014005574,0
4936,4,0,0,37,0.0,0.0,1.0,37,1350,1000,350,0.7407407407407407,17,10,7,347.0659502491184,0.4291478978978979,0.12104637785028594,0.2013544561566745,130962.3086734692,1690.5116213151725,132652.82029478438,1212,7,198.97297297297297,34,3,17,35.22597309451812,0.6341911764705883,44.10714285714285,1023.5714285714271,30.105042016806678,0
4937,4,0,1,36,0.0,0.02702702702702703,0.972972972972973,37,1000,500,500,0.5,15,5,10,343.6016368729395,0.4284284284284284,0.12191850108855795,0.2001357401501625,131114.670138889,1610.2430555555616,132724.91319444455,1213,8,199.97297297297297,34,3,17,35.160699755899095,0.6357230392156863,43.958333333333336,1024.1666666666674,30.122549019607867,0
4938,4,0,1,35,0.0,0.027777777777777776,0.9722222222222222,36,1100,800,300,0.7272727272727273,14,8,6,354.936535285584,0.4258267195767196,0.12850380298920294,0.206535493652252,131077.0196559015,2104.8046424452086,133181.8242983467,1214,9,206.27777777777777,33,3,18,34.90854874740707,0.6376262626262627,43.995098039215684,1024.0196078431368,31.030897207367783,0
4939,4,0,1,34,0.0,0.02857142857142857,0.9714285714285714,35,900,400,500,0.4444444444444444,14,4,10,359.7940506662767,0.42507002801120447,0.11922616111071949,0.208969209369783,131004.77629833683,2426.947824201603,133431.72412253844,1215,10,186.65714285714284,32,3,18,34.857291152770934,0.6393229166666667,44.06565656565656,1023.7373737373731,31.99179292929291,0
4940,4,1,1,34,0.02857142857142857,0.02857142857142857,0.9714285714285714,35,850,600,250,0.7058823529411765,11,6,5,356.0064462557264,0.42601540616246497,0.12670409546102568,0.20834205654345564,131295.7721948015,2348.428253494537,133644.20044829603,1216,0,182.0,32,3,20,34.66002422898445,0.6422526041666667,43.781565656565654,1024.873737373737,32.02730429292928,0
4941,4,1,0,35,0.02857142857142857,0.0,1.0,35,1150,800,350,0.6956521739130435,15,8,7,350.84282984118005,0.4283963585434174,0.11466771261447217,0.2077039141752342,131736.6836823577,2243.774179402152,133980.45786175985,1217,0,178.4,33,2,18,34.34739465202342,0.6442550505050505,43.35171568627451,1026.5931372549016,31.108882947118232,0
4942,4,0,0,35,0.0,0.0,1.0,35,1150,800,350,0.6956521739130435,15,8,7,353.85499891717797,0.42801120448179275,0.1127042824764406,0.21052991170494678,131925.46323829767,2336.4969302671966,134261.96016856487,1218,1,179.4,33,2,18,34.07975963258977,0.6461489898989898,43.16789215686274,1027.3284313725483,31.131164587046918,0
4943,4,0,0,35,0.0,0.0,1.0,35,900,700,200,0.7777777777777778,11,7,4,354.2370624521613,0.42692577030812323,0.1126503355933357,0.21128250396328765,132019.9037029027,2353.268574586686,134373.1722774894,1219,2,180.4,33,2,19,33.974779394228456,0.6470959595959596,43.07598039215686,1027.6960784313721,31.14230540701128,0
4944,4,0,1,34,0.0,0.02857142857142857,0.9714285714285714,35,900,600,300,0.6666666666666666,12,6,6,386.67781445641805,0.4271008403361345,0.1397117986979739,0.21515150188985308,129333.80126953116,3175.262885293504,132509.06415482468,1220,3,181.4,31,4,21,35.87002901519031,0.625,45.70312499999999,1017.1874999999993,32.81249999999998,8
4945,4,1,0,35,0.02857142857142857,0.0,1.0,35,1050,900,150,0.8571428571428571,12,9,3,380.77809528582475,0.4287464985994398,0.14604040153674536,0.21411139030392476,129747.52456700848,2881.003054535249,132628.52762154373,1221,0,178.65714285714284,32,3,18,35.59817408187714,0.6266276041666667,45.29671717171717,1018.8131313131314,31.837910353535356,0
4946,4,0,0,35,0.0,0.0,1.0,35,1050,800,250,0.7619047619047619,13,8,5,379.58896785255604,0.4288165266106443,0.14600426028997449,0.2138659794486353,129825.0973183391,2856.0349384851957,132681.1322568243,1222,1,179.65714285714284,33,2,19,35.5494428411095,0.625,45.220588235294116,1019.1176470588235,30.88235294117647,0
4947,4,0,0,35,0.0,0.0,1.0,35,950,700,250,0.7368421052631579,12,7,5,379.4344027366866,0.42878151260504205,0.14280219780219805,0.21446292328595304,129950.01922337546,2861.5015859284686,132811.52080930394,1223,2,180.65714285714284,33,2,20,35.426181891025635,0.6262626262626263,45.09803921568626,1019.6078431372537,30.897207367795566,0
4948,4,0,0,35,0.0,0.0,1.0,35,1100,700,400,0.6363636363636364,15,7,8,382.3831302106214,0.4283963585434174,0.14903966632910537,0.21664906689877458,130043.75007509114,2945.307243608202,132989.05731869934,1224,3,181.65714285714284,33,2,20,35.25559193399815,0.627209595959596,45.00612745098038,1019.9754901960771,30.908348187759913,0
4949,4,0,0,35,0.0,0.0,1.0,35,1000,700,300,0.7,13,7,6,384.3082050898744,0.4283263305322129,0.148538493207081,0.21861466748555133,130200.04325259503,3007.3889850057503,133207.4322376008,1225,4,182.65714285714284,33,2,21,35.047430355427466,0.6287878787878788,44.85294117647058,1020.5882352941167,30.92691622103384,0
4950,4,2,0,37,0.05405405405405406,0.0,1.0,37,1000,700,300,0.7,13,7,6,363.5713267313637,0.4320883383383383,0.15009259379168305,0.2101865260078548,130826.15460399842,2112.9577566320536,132939.11236063048,1226,0,173.72972972972974,33,4,20,34.94150295479953,0.6351010101010102,44.24019607843137,1023.0392156862742,31.00118835412952,0
4951,4,2,0,39,0.05128205128205128,0.0,1.0,39,1050,700,350,0.6666666666666666,14,7,7,347.72130796144586,0.4334514170040486,0.16789787692797709,0.2050086472009313,131579.47063629367,1352.5194636678116,132931.9900999615,1227,0,165.76923076923077,33,6,19,34.58602086319478,0.6426767676767677,43.50490196078431,1025.9803921568623,31.090314913844313,0
4952,4,0,0,39,0.0,0.0,1.0,39,800,400,400,0.5,12,4,8,347.7791935843172,0.43322649572649574,0.1656394948335247,0.20555051138099195,131673.78720023538,1358.6807057381661,133032.46790597355,1228,1,166.76923076923077,33,6,19,34.48942786069652,0.6436237373737373,43.412990196078425,1026.3480392156855,31.101455733808653,0
4953,4,0,0,39,0.0,0.0,1.0,39,600,200,400,0.3333333333333333,10,2,8,347.7791935843172,0.43322649572649574,0.1656394948335247,0.20555051138099195,131673.78720023538,1358.6807057381661,133032.46790597355,1229,2,167.76923076923077,33,6,19,34.48942786069652,0.6436237373737373,43.412990196078425,1026.3480392156855,31.101455733808653,0
4954,4,1,0,40,0.025,0.0,1.0,40,700,500,200,0.7142857142857143,9,5,4,339.5472834441346,0.43350694444444443,0.1719991889699921,0.20225207752976712,131969.53125,961.9791666666674,132931.51041666666,1230,0,164.55,34,6,20,34.4028791565288,0.6443014705882353,43.125,1027.5,30.220588235294116,0
4955,4,0,2,38,0.0,0.05,0.95,40,1400,1100,300,0.7857142857142857,17,11,6,336.49498035815657,0.4329861111111111,0.17351169793838328,0.20091961690265028,132061.2882653061,887.5921201814035,132948.8803854875,1231,1,165.55,34,6,20,34.38899505829666,0.6452205882352942,43.035714285714285,1027.8571428571427,30.231092436974784,0
4956,4,0,0,38,0.0,0.0,1.0,38,1050,600,450,0.5714285714285714,15,6,9,356.4291409846433,0.4300912754860123,0.19695617591712367,0.2125257713167775,132008.45457415062,1810.3320133149655,133818.78658746558,1232,2,174.21052631578948,32,6,20,33.92999754269565,0.6494140625,43.08712121212121,1027.6515151515152,32.11410984848485,0
4957,4,0,1,37,0.0,0.02631578947368421,0.9736842105263158,38,1200,700,500,0.5833333333333334,17,7,10,369.1075145148405,0.4302394499762921,0.2000830539235292,0.2070632646999645,129655.65653344666,1971.3754251700623,131627.03195861672,1233,3,175.21052631578948,34,4,17,35.98894408727839,0.6210171568627452,45.38690476190476,1018.4523809523805,29.954481792717075,8
4958,4,0,0,37,0.0,0.0,1.0,37,1400,1300,100,0.9285714285714286,15,13,2,376.7548646919341,0.42855355355355357,0.20107223788205397,0.2117622170509838,129731.4453125001,2375.390625000015,132106.83593750012,1234,4,178.83783783783784,33,4,17,35.717024539877315,0.6240530303030303,45.31250000000001,1018.7500000000008,30.871212121212146,0
4959,4,1,0,38,0.02631578947368421,0.0,1.0,38,650,400,250,0.6153846153846154,9,4,5,368.54147977273715,0.429691204362257,0.20257137942896475,0.20884017187121764,130049.99999999999,1985.7638888888891,132035.76388888888,1235,0,175.10526315789474,34,4,18,35.60219226579521,0.625,45.0,1019.9999999999999,29.999999999999996,0
4960,4,0,1,37,0.0,0.02631578947368421,0.9736842105263158,38,750,500,250,0.6666666666666666,10,5,5,418.86082508747734,0.42929113323850165,0.23020421487903064,0.21941048996459558,126917.01630015434,3108.8493441358055,130025.86564429014,1236,1,176.10526315789474,35,3,17,37.53876636802205,0.5910714285714286,48.09027777777778,1007.638888888889,28.789682539682545,8
4961,4,3,1,39,0.075,0.025,0.975,40,850,500,350,0.5882352941176471,12,5,7,395.5824564073172,0.4342147435897436,0.2599095488893979,0.2114453595019282,127734.70320001707,2106.162658607673,129840.86585862475,1237,0,168.075,35,5,17,37.282936417067404,0.5994047619047619,47.28009259259259,1010.879629629629,28.882275132275115,0
4962,4,2,0,41,0.04878048780487805,0.0,1.0,41,850,400,450,0.47058823529411764,13,4,9,393.078810883397,0.4365091463414634,0.28040813676948795,0.212921982356629,128268.6421688773,1885.9062675769246,130154.54843645422,1238,0,164.9268292682927,33,8,19,36.797826437615946,0.6092171717171717,46.752450980392155,1012.9901960784309,30.6966726084373,0
4963,4,0,0,41,0.0,0.0,1.0,41,1050,800,250,0.7619047619047619,13,8,5,391.6721611220065,0.4364329268292683,0.2768829575088203,0.21248985749060037,128330.72015570928,1852.7141003460129,130183.43425605529,1239,1,165.9268292682927,33,8,19,36.76977503628447,0.6098484848484849,46.69117647058823,1013.2352941176465,30.704099821746865,0
4964,4,2,0,43,0.046511627906976744,0.0,1.0,43,1150,1000,150,0.8695652173913043,13,10,3,375.78435239973714,0.43835363602805466,0.2843172331544426,0.20699985513544844,128936.76757812499,1090.4839409722217,130027.2515190972,1240,0,159.1627906976744,35,8,19,36.552350427350426,0.6116071428571428,46.09375,1015.6249999999999,29.01785714285714,0
4965,4,0,1,42,0.0,0.023255813953488372,0.9767441860465116,43,1300,900,400,0.6923076923076923,17,9,8,344.7808750985638,0.43807678110003695,0.22008097338987942,0.18086456990110186,126975.3354338134,156.00472072187307,127131.34015453527,1241,1,160.1627906976744,35,8,19,39.345046700352185,0.5916666666666667,48.032407407407405,1007.8703703703699,28.796296296296283,8
4966,4,1,1,42,0.023255813953488372,0.023255813953488372,0.9767441860465116,43,1650,1300,350,0.7878787878787878,20,13,7,344.3652596131257,0.43957641196013286,0.220978253412911,0.18183773054337948,127242.10778061226,163.60587959464212,127405.71366020691,1242,0,161.11627906976744,34,9,20,39.08185840707964,0.5965073529411764,47.767857142857146,1008.9285714285716,29.674369747899163,0
4967,4,1,1,42,0.023255813953488372,0.023255813953488372,0.9767441860465116,43,950,700,250,0.7368421052631579,12,7,5,341.18635645895665,0.4385612772240679,0.24139660990928502,0.1812325524008348,127482.44224773254,99.05399659865446,127581.4962443312,1243,0,162.0,34,9,17,38.91582183975795,0.5989583333333333,47.52976190476191,1009.8809523809534,29.702380952380985,0
4968,4,2,0,44,0.045454545454545456,0.0,1.0,44,1750,1300,450,0.7428571428571429,22,13,9,334.6320166361918,0.44128787878787884,0.25221173993582346,0.17942269500953106,127859.63909433116,-242.81422469763527,127616.82486963352,1244,0,159.25,36,8,19,38.695579556842205,0.5986689814814814,47.15653153153155,1011.3738738738766,28.093718718718794,0
4969,4,2,0,46,0.043478260869565216,0.0,1.0,46,1200,900,300,0.75,15,9,6,323.37477378765254,0.44419283413848626,0.2603169750981731,0.17596231804984389,128450.01737313409,-892.1838977755576,127557.83347535854,1245,0,153.2826086956522,37,9,16,38.37829006670272,0.602759009009009,46.573464912280706,1013.7061403508776,27.39746325272642,0
4970,4,2,0,48,0.041666666666666664,0.0,1.0,48,850,600,250,0.7058823529411765,11,6,5,319.25720000000007,0.4475934544917258,0.2860333333333336,0.17658030973451358,129098.0897613857,-1356.9010674862498,127741.18869389944,1246,0,147.85416666666666,40,8,19,37.823750000000025,0.6041666666666667,45.93495934959351,1016.2601626016282,25.406504065040703,0
4971,4,0,2,46,0.0,0.041666666666666664,0.9583333333333334,48,1650,1300,350,0.7878787878787878,20,13,7,319.47057242676675,0.44729794621749414,0.2836407103825134,0.17716095380029834,129201.38888888921,-1344.7916666666315,127856.59722222258,1247,1,148.85416666666666,40,8,20,37.71345628415304,0.6052083333333333,45.83333333333335,1016.6666666666692,25.416666666666732,0
4972,4,0,0,46,0.0,0.0,1.0,46,1350,900,450,0.6666666666666666,18,9,9,333.1152282769306,0.4472322866344605,0.2839669625584813,0.1835899405929727,128957.11343277448,-608.4843441814571,128348.62908859302,1248,2,156.02173913043478,38,8,20,37.61504680761545,0.6060855263157895,46.07371794871795,1015.7051282051282,26.729082321187583,0
4973,4,1,1,46,0.02127659574468085,0.02127659574468085,0.9787234042553191,47,1000,500,500,0.5,15,5,10,326.73782789685737,0.4486971939562134,0.2843572460176844,0.18107249265663516,129175.56023407033,-958.6916063520371,128216.8686277183,1249,0,153.68085106382978,40,7,21,37.55498350494851,0.6049479166666667,45.858739837398375,1016.5650406504066,25.414126016260163,0
4974,4,2,1,47,0.041666666666666664,0.020833333333333332,0.9791666666666666,48,1200,700,500,0.5833333333333334,17,7,10,322.1610884719265,0.4495234929078014,0.29467471143756585,0.180387495483987,129581.83235627138,-1250.747422497997,128331.08493377338,1250,0,151.1875,38,10,15,37.259094088842254,0.612390350877193,45.4594017094017,1018.1623931623925,26.793747188484012,0
4975,4,1,1,47,0.020833333333333332,0.020833333333333332,0.9791666666666666,48,1100,800,300,0.7272727272727273,14,8,6,320.65463433446445,0.448720079787234,0.29946904615804115,0.1799862809714349,129678.390842014,-1283.6046006944407,128394.78624131957,1251,0,152.16666666666666,39,9,17,37.19958069134791,0.6116452991452992,45.364583333333336,1018.5416666666677,26.116452991453016,0
4976,4,0,1,46,0.0,0.02127659574468085,0.9787234042553191,47,1050,800,250,0.7619047619047619,13,8,5,328.9557677837263,0.4466928769657725,0.30421156953955797,0.18444743403026326,129636.22708013716,-871.0830776536097,128765.14400248355,1252,1,156.36170212765958,38,9,17,37.03096586935235,0.6129385964912281,45.405982905982896,1018.376068376067,26.799370220422816,0
4977,4,1,1,46,0.02127659574468085,0.02127659574468085,0.9787234042553191,47,950,600,350,0.631578947368421,13,6,7,326.9303948130172,0.44667360468701817,0.29813334957390336,0.18400650874919044,129784.51063368043,-913.8997395833394,128870.61089409709,1253,0,157.19148936170214,39,8,19,36.93220541129967,0.6127136752136753,45.260416666666664,1018.9583333333323,26.127136752136728,0
4978,4,0,2,44,0.0,0.043478260869565216,0.9565217391304348,46,1600,1400,200,0.875,18,14,4,327.68840231167076,0.4471920289855072,0.2801660967269175,0.1854375409613442,129996.88042534715,-680.3059895833429,129316.5744357638,1254,1,155.91304347826087,39,7,19,36.697735784814434,0.6148504273504274,45.05208333333333,1019.791666666666,26.148504273504255,0
4979,4,1,2,43,0.022222222222222223,0.044444444444444446,0.9555555555555556,45,1650,1400,250,0.8484848484848485,19,14,5,337.9553172875325,0.44515993265993264,0.2205403587174588,0.18440995454822356,128561.19340806786,-231.47341609918237,128329.71999196868,1255,0,159.95555555555555,37,8,18,37.89542563159981,0.6038851351351351,46.463815789473685,1014.1447368421053,27.409317211948792,8
4980,4,0,0,43,0.0,0.0,1.0,43,1400,1200,200,0.8571428571428571,16,12,4,341.1003041287745,0.44299095607235145,0.2195011265654483,0.1862343903476918,128584.3611352239,172.03293788581544,128756.39407310971,1256,1,166.06976744186048,35,8,18,37.79206607326258,0.6080357142857142,46.44097222222223,1014.2361111111121,28.978174603174633,0
4981,4,0,0,43,0.0,0.0,1.0,43,1150,900,250,0.782608695652174,14,9,5,338.1231692063586,0.44273717238833515,0.22027993682841474,0.1853507299810042,128743.83674214776,106.25481900822473,128850.09156115599,1257,2,167.06976744186048,36,7,18,37.70505067317651,0.6076388888888888,46.2837837837838,1014.8648648648666,28.19069069069074,0
4982,4,1,0,44,0.022727272727272728,0.0,1.0,44,1650,1400,250,0.8484848484848485,19,14,5,336.26713249126556,0.4439856412966878,0.22019374068554387,0.18647540983606564,129201.38888888907,-109.9522664556261,129091.43662243344,1258,0,164.25,36,8,20,37.28654371584699,0.6122685185185186,45.83333333333334,1016.6666666666681,28.24074074074078,0
4983,4,3,2,45,0.06382978723404255,0.0425531914893617,0.9574468085106383,47,1200,900,300,0.75,15,9,6,318.69921034555347,0.4483695652173913,0.21627872601274656,0.18010553526918485,129943.77170138899,-1117.4045138888787,128826.36718750012,1259,0,154.70212765957447,39,8,20,36.98065658629615,0.6143162393162394,45.10416666666667,1019.5833333333342,26.143162393162413,0
4984,4,1,0,46,0.021739130434782608,0.0,1.0,46,1350,1000,350,0.7407407407407407,17,10,7,324.51202384960425,0.44557165861513687,0.2255255501372786,0.18412152797028322,130099.04308431929,-756.2592455621534,129342.78383875714,1260,0,158.58695652173913,38,8,21,36.67530631479737,0.6175986842105263,44.951923076923066,1020.1923076923058,26.847165991902784,0
4985,4,0,0,46,0.0,0.0,1.0,46,1500,1100,400,0.7333333333333333,19,11,8,325.36443148688033,0.44568236714975845,0.21410825199645056,0.18538205980066458,130262.58680555565,-723.3347715318779,129539.25203402377,1261,1,159.58695652173913,37,9,22,36.488095238095234,0.6210585585585586,44.79166666666667,1020.8333333333342,27.59009009009011,0
4986,4,0,0,46,0.0,0.0,1.0,46,1250,800,450,0.64,17,8,9,325.4999318648005,0.44517914653784224,0.21351406869313094,0.18586026152402751,130346.5504410012,-714.4413425284558,129632.10909847275,1262,2,160.58695652173913,37,9,22,36.399723504778265,0.6219031531531531,44.70942982456141,1021.1622807017555,27.598980559506906,0
4987,4,0,2,44,0.0,0.043478260869565216,0.9565217391304348,46,1100,600,500,0.5454545454545454,16,6,10,326.5525997093417,0.4448772141706924,0.21380700804599817,0.186865111725567,130430.5411280396,-681.5135426284794,129749.02758541111,1263,3,161.58695652173913,37,9,22,36.287927579791045,0.6227477477477478,44.62719298245615,1021.491228070177,27.607871028923704,0
4988,4,0,1,43,0.0,0.022727272727272728,0.9772727272727273,44,1050,700,350,0.6666666666666666,14,7,7,325.32380834837585,0.44354519027484146,0.2033064059786529,0.18643094995019505,130486.54994806119,-309.92372653121237,130176.62622152998,1264,4,161.75,37,7,22,36.26269943478572,0.6233108108108107,44.572368421052644,1021.7105263157915,27.613798008534907,0
4989,4,0,0,43,0.0,0.0,1.0,43,1700,1400,300,0.8235294117647058,20,14,6,331.7610667152363,0.44398301956441494,0.2138048561727206,0.19043211134982765,130550.14209733409,62.29088040746797,130612.43297774156,1265,5,165.65116279069767,36,7,16,36.03397612488523,0.6258680555555556,44.51013513513515,1021.9594594594616,28.387762762762822,0
4990,4,0,0,43,0.0,0.0,1.0,43,1550,1200,350,0.7741935483870968,19,12,7,328.6251431232897,0.44345238095238093,0.21553119557422384,0.189334790581185,130694.03863322812,-10.130569758910326,130683.9080634692,1266,6,166.65116279069767,36,7,18,35.96870411160061,0.6273148148148149,44.36936936936939,1022.5225225225249,28.40340340340347,0
4991,4,0,0,43,0.0,0.0,1.0,43,1050,600,450,0.5714285714285714,15,6,9,326.4048182975844,0.44372923588039864,0.209160233031781,0.1885467832754284,130794.81336805575,-61.58854166664685,130733.22482638911,1267,7,167.65116279069767,37,6,18,35.92371011541072,0.6264076576576576,44.27083333333334,1022.9166666666682,27.646396396396437,0
4992,4,2,0,45,0.044444444444444446,0.0,1.0,45,1050,600,450,0.5714285714285714,15,6,9,310.6616432017971,0.4475799663299664,0.20036133694670188,0.18195896244676746,131328.1250000005,-840.2777777777349,130487.84722222276,1268,0,161.15555555555557,40,5,20,35.78929539295391,0.6265625,43.75000000000002,1025.0000000000039,25.625000000000096,0
4993,4,0,3,42,0.0,0.06666666666666667,0.9333333333333333,45,800,500,300,0.625,11,5,6,312.2936105967452,0.44675925925925924,0.2035246167384559,0.18317661902728427,131382.8849806416,-793.9928957556963,130588.8920848859,1269,1,162.15555555555557,38,7,20,35.69238918994024,0.6304824561403508,43.69658119658121,1025.2136752136767,26.979307242465175,0
4994,4,0,0,42,0.0,0.0,1.0,42,700,600,100,0.8571428571428571,8,6,2,346.1873953104325,0.443996806039489,0.20983509557253455,0.1896959350857345,128728.04763244472,516.7120380115332,129244.75967045626,1270,2,167.14285714285714,37,5,18,37.51654511075095,0.6055743243243243,46.299342105263165,1014.8026315789484,27.42709815078239,8
4995,4,0,0,42,0.0,0.0,1.0,42,1650,1200,450,0.7272727272727273,21,12,9,344.1825067505389,0.4435007742934572,0.20191679652744599,0.18912675548980662,128839.34389667981,468.84967009080503,129308.19356677061,1271,3,168.14285714285714,37,5,18,37.45398621161392,0.6067004504504505,46.189692982456144,1015.2412280701759,27.438952110004756,0
4996,4,1,2,41,0.023255813953488372,0.046511627906976744,0.9534883720930233,43,1650,1300,350,0.7878787878787878,20,13,7,343.1280504140997,0.44379844961240306,0.21843003412969364,0.19113406610519199,129377.95380015402,280.16491719671393,129658.11871735074,1272,0,165.2093023255814,35,8,21,36.932593856655295,0.6160714285714286,45.65972222222221,1017.3611111111087,29.06746031746025,0
4997,4,0,1,40,0.0,0.024390243902439025,0.975609756097561,41,1300,1100,200,0.8461538461538461,15,11,4,343.12086251254283,0.4423526422764228,0.21954457871642252,0.19166417524031873,129487.77113261886,685.9911431701669,130173.76227578902,1273,1,170.9268292682927,36,5,12,36.82115327874898,0.615162037037037,45.55180180180179,1017.7927927927908,28.272022022021968,0
4998,4,0,0,40,0.0,0.0,1.0,40,1200,800,400,0.6666666666666666,16,8,8,345.1718741835326,0.44246794871794876,0.22084300718629146,0.19379761651086586,129688.42734203777,952.9595051131994,130641.38684715098,1274,2,174.35,36,4,14,36.56509121061361,0.6171875,45.35472972972972,1018.5810810810793,28.29391891891887,0
4999,4,0,0,40,0.0,0.0,1.0,40,900,500,400,0.5555555555555556,13,5,8,344.6673249106253,0.4426949786324786,0.2226127320954907,0.19393967386762018,129774.47041636199,945.8039120200914,130720.27432838207,1275,3,175.35,36,4,14,36.490568818155026,0.6180555555555556,45.27027027027025,1018.9189189189163,28.30330330330323,0
5000,4,1,0,41,0.024390243902439025,0.0,1.0,41,1600,1000,600,0.625,22,10,12,336.8169722070415,0.4454776422764228,0.2195934347868247,0.19149392549364258,130178.6502217025,569.2757627346481,130747.92598443714,1276,0,172.0487804878049,37,4,15,36.28082357365423,0.6202139639639639,44.87390350877191,1020.5043859649096,27.58119962067323,0
