period,mktsize,entries,exits,surviv,entryrate,exitrate,survivrate,firms,totresinv,totinninv,totimiinv,costshareinn,firmsres,firmsinn,firmsimi,hindex,div,gini,pcm,cs,totprofits,ts,maxage,minage,avgage,actfirms,inactfirms,profitablefirms,wmc,avgproxopt,price,totoutput,avgoutput,magtechshock
1,4,40,23,17,1.0,0.575,0.42500000000000004,40,0,0,0,0,0,0,0,370.2941703508672,0.5016159188034188,0.015968841285297186,0.16321549912031785,119583.78684807256,2056.2358276643954,121640.02267573695,0,0,0.0,34,6,17,46.42161635832519,0.517156862745098,55.476190476190474,978.0952380952381,28.76750700280112,0
2,4,29,34,12,0.6304347826086957,0.7391304347826086,0.26086956521739135,46,400,300,100,0.75,5,3,2,267.6615541386412,0.4986413043478261,-0.06796996626251606,0.12826451625154647,123211.23281179262,-2604.21798765153,120607.0148241411,1,0,0.3695652173913043,46,0,7,45.15172485638598,0.5360054347826086,51.795212765957444,992.8191489361699,21.583024976873258,0
3,4,34,29,17,0.7391304347826086,0.6304347826086957,0.3695652173913043,46,400,300,100,0.75,5,3,2,344.78785882535493,0.5002918679549114,-0.18883887246909337,0.16120879523552384,122158.42927030854,823.7486531156691,122982.17792342421,2,0,0.43478260869565216,38,8,16,44.33674664072914,0.5364583333333333,52.857905982906,988.5683760683783,26.01495726495732,0
4,4,18,16,19,0.5142857142857142,0.45714285714285713,0.5428571428571429,35,450,200,250,0.4444444444444444,7,2,5,336.7864476045471,0.48806022408963584,-0.07450803665314665,0.1593452296875246,122667.23632812497,1262.5325520833323,123929.7688802083,3,0,1.0571428571428572,35,0,16,44.00302313354363,0.5473214285714285,52.34375,990.6249999999998,28.303571428571423,8
5,4,18,17,20,0.4864864864864865,0.4594594594594595,0.5405405405405406,37,500,300,200,0.6,7,3,4,318.3934253795372,0.4908033033033033,-0.0929855949131202,0.15499699244079432,123878.62280942193,488.42780951828854,124367.05061894021,4,0,1.4324324324324325,37,0,16,43.199852223078906,0.5560247747747749,51.12390350877192,995.5043859649106,26.905523944997583,0
6,4,11,10,21,0.3548387096774194,0.3225806451612903,0.6774193548387097,31,950,700,250,0.7368421052631579,12,7,5,353.6246742705796,0.4838709677419355,-0.0685473329116596,0.17274768570689217,124025.34484863271,2571.6844346788043,126597.02928331151,5,0,2.129032258064516,31,0,19,42.17047930283224,0.5705645161290323,50.97656249999999,996.0937499999992,32.132056451612875,0
7,4,12,9,24,0.36363636363636365,0.2727272727272727,0.7272727272727273,33,800,700,100,0.875,9,7,2,335.0804933016901,0.48240214646464646,-0.001007631325479874,0.17003464238261892,125613.49601114917,1818.1264417531206,127431.62245290229,6,0,2.515151515151515,33,0,20,40.989710676446606,0.5820707070707071,49.38725490196076,1002.4509803921537,30.37730243612587,0
8,4,1,0,25,0.04,0.0,1.0,25,400,300,100,0.75,5,3,2,416.0316775444047,0.47770833333333335,0.015040977020729596,0.20466127504812892,124319.838022888,5344.198152942159,129664.03617583016,7,0,3.6,25,0,23,40.30863329583802,0.5929166666666666,50.68108974358975,997.2756410256418,39.89102564102567,0
9,4,4,0,29,0.13793103448275862,0.0,1.0,29,750,300,450,0.4,12,3,9,387.0230156218345,0.4812705254515599,0.04760723780802345,0.19218457175735643,124712.8088254722,4045.5054917954826,128758.31431726768,8,0,3.9655172413793105,28,1,22,40.62290228231682,0.5863095238095238,50.28735632183907,998.8505747126426,35.673234811165806,8
10,4,7,7,29,0.19444444444444445,0.19444444444444445,0.8055555555555556,36,800,600,200,0.75,10,6,4,321.6842925073799,0.48316798941798944,0.0651510508439952,0.1680250128090764,126800.41822059295,957.9405649862408,127758.3587855792,9,0,4.0,35,1,17,40.10620163946986,0.5898809523809524,48.2060185185185,1007.1759259259233,28.77645502645495,0
11,4,2,2,29,0.06451612903225806,0.06451612903225806,0.935483870967742,31,750,600,150,0.8,9,6,3,349.389515713128,0.4807347670250896,0.035014450142830444,0.18087698521234602,126436.39458550354,2635.110134548616,129071.50472005215,10,0,4.838709677419355,31,0,18,39.78292767132744,0.5954301075268817,48.567708333333336,1005.7291666666673,32.442876344086045,0
12,4,0,1,28,0.0,0.034482758620689655,0.9655172413793104,29,1300,900,400,0.6923076923076923,17,9,8,396.97772865555186,0.4772167487684729,0.06463721763111785,0.19882013920565253,125069.4540895061,4129.957561728384,129199.41165123449,11,1,6.0344827586206895,29,0,18,40.00335554938442,0.5869252873563218,49.93055555555555,1000.2777777777771,34.492337164750936,8
13,4,3,2,29,0.0967741935483871,0.06451612903225806,0.935483870967742,31,1200,700,500,0.5833333333333334,17,7,10,406.0837193607684,0.4779121863799283,0.09721727496242472,0.2007708189063294,124530.01250144526,4019.5548457753607,128549.56734722063,12,0,6.451612903225806,30,1,18,40.33744052428405,0.5784722222222223,50.47043010752688,998.1182795698926,33.27060931899642,7
14,4,5,5,29,0.14705882352941177,0.14705882352941177,0.8529411764705882,34,1050,700,350,0.6666666666666666,14,7,7,366.8540464103631,0.4805592691622103,0.08910446581856557,0.18740909457607371,125890.05918697134,2436.6555231161055,128326.71471008744,13,0,6.4411764705882355,33,1,20,39.90757418488214,0.5849116161616161,49.111519607843135,1003.5539215686274,30.410724896019012,0
15,4,2,0,31,0.06451612903225806,0.0,1.0,31,1050,700,350,0.6666666666666666,14,7,7,392.0556551231559,0.48095878136200715,0.10805393192412183,0.20037505659169094,125908.90429890736,3672.65959214937,129581.56389105674,14,0,7.32258064516129,30,1,23,39.25578099191999,0.5927083333333334,49.092741935483865,1003.6290322580643,33.45430107526881,0
16,4,7,5,33,0.18421052631578946,0.13157894736842105,0.868421052631579,38,800,700,100,0.875,9,7,2,342.5651957627514,0.481344831673779,0.12056333337602942,0.17885646625020932,126783.27596357187,1313.8311437488628,128097.10710732073,15,0,6.7894736842105265,33,5,23,39.59803682972336,0.5940656565656566,48.223039215686285,1007.1078431372563,30.518419489007766,8
17,4,1,3,31,0.029411764705882353,0.08823529411764706,0.9117647058823529,34,900,700,200,0.7777777777777778,11,7,4,359.67676787256147,0.4790738265002971,0.0892795452404136,0.18765308808504366,126753.41802520504,2318.0519424210706,129071.46996762611,16,0,7.470588235294118,30,4,25,39.19792222815449,0.6013888888888889,48.252688172043,1006.9892473118265,33.56630824372755,0
18,4,0,1,30,0.0,0.03225806451612903,0.967741935483871,31,1050,600,450,0.5714285714285714,15,6,9,374.5605153145268,0.47795698924731184,0.07983502724996328,0.19530655441400285,126730.08323424472,3293.617056414291,130023.70029065902,17,1,8.419354838709678,28,3,25,38.84726978691021,0.6071428571428572,48.2758620689655,1006.8965517241361,35.96059113300486,0
19,4,0,1,29,0.0,0.03333333333333333,0.9666666666666667,30,1150,800,350,0.6956521739130435,15,8,7,374.96518397223673,0.4782806513409961,0.0665477719123031,0.19569106287873436,126766.2530758684,3506.586281212798,130272.8393570812,18,2,9.3,28,2,25,38.799816902078256,0.6075148809523809,48.23994252873561,1007.0402298850552,35.96572249589483,0
20,4,0,1,28,0.0,0.034482758620689655,0.9655172413793104,29,800,600,200,0.75,10,6,4,377.8155860900859,0.47680623973727426,0.040012780494998346,0.19823308424995884,126983.38050353396,3795.260065728602,130778.64056926256,19,3,10.03448275862069,28,1,25,38.50439534331196,0.6097470238095238,48.02442528735631,1007.9022988505732,35.99651067323476,0
21,4,3,4,27,0.0967741935483871,0.12903225806451613,0.8709677419354839,31,750,500,250,0.6666666666666666,10,5,5,349.86632954698604,0.4761648745519713,0.020341919189753588,0.18733412079586997,127804.5352967104,2742.900732743641,130547.43602945404,20,0,9.935483870967742,30,1,22,38.36678629979176,0.6121527777777778,47.21102150537633,1011.1559139784929,33.705197132616426,0
22,4,1,1,27,0.03571428571428571,0.03571428571428571,0.9642857142857143,28,1250,800,450,0.64,17,8,9,374.1940495799158,0.4711750440917108,0.006769374416432772,0.2004244840900648,127817.42345422134,3965.703857841213,131783.12731206254,21,0,10.857142857142858,28,0,24,37.738585772473215,0.6183035714285714,47.198275862068975,1011.2068965517255,36.114532019704484,0
23,4,0,0,27,0.0,0.0,1.0,27,1100,800,300,0.7272727272727273,14,8,6,382.47750865051927,0.47008547008547014,-0.016470588235293793,0.205763216679077,127993.9058956917,4390.958049886638,132384.86394557834,22,1,11.592592592592593,27,0,24,37.34803921568629,0.6234567901234568,47.02380952380953,1011.9047619047626,37.47795414462084,0
24,4,0,0,27,0.0,0.0,1.0,27,1200,1000,200,0.8333333333333334,14,10,4,381.88623008010285,0.46961063627730293,-0.014936747447035437,0.2062185642432558,128144.5312500002,4387.326388888916,132531.8576388891,23,2,12.592592592592593,27,0,25,37.208504801097405,0.625,46.875000000000014,1012.5000000000016,37.50000000000006,0
25,4,0,2,25,0.0,0.07407407407407407,0.9259259259259259,27,1200,900,300,0.75,15,9,6,383.23466770468997,0.4681861348528015,-0.01766724868501912,0.20792389262161234,128332.93750442892,4436.32613201532,132769.26363644423,24,3,13.592592592592593,27,0,25,36.98123194791207,0.626929012345679,46.6889880952381,1013.2440476190482,37.52755731922401,0
26,4,1,0,26,0.038461538461538464,0.0,1.0,26,900,700,200,0.7777777777777778,11,7,4,396.20178785117366,0.4663782051282051,-0.008067256429784564,0.21478651835201942,128300.82887993453,4966.603557003516,133267.43243693805,25,0,14.384615384615385,26,0,26,36.6857070322417,0.6302083333333333,46.720679012345684,1013.1172839506178,38.966049382716065,0
27,4,3,2,27,0.10344827586206896,0.06896551724137931,0.9310344827586207,29,600,300,300,0.5,9,3,6,386.9867928755515,0.46787766830870275,0.026200251560386523,0.20446974910842777,127267.13204089507,4050.139853395065,131317.27189429014,26,0,13.793103448275861,29,0,23,37.98104496444138,0.6095545977011494,47.74305555555556,1009.0277777777778,34.794061302681996,8
28,4,2,0,29,0.06896551724137931,0.0,1.0,29,850,600,250,0.7058823529411765,11,6,5,392.69366911416586,0.4676724137931034,0.0295525514180921,0.19816053519819782,125382.23620756154,4047.3620756172586,129429.5982831788,27,0,14.344827586206897,29,0,19,39.785715111172735,0.5901580459770115,49.61805555555554,1001.5277777777762,34.535440613026765,8
29,4,1,1,29,0.03333333333333333,0.03333333333333333,0.9666666666666667,30,1400,900,500,0.6428571428571429,19,9,10,384.11873073810716,0.468654214559387,0.02614107883817418,0.19696300874017827,126043.83680555549,3683.159722222213,129726.99652777771,28,0,14.833333333333334,30,0,20,39.31535269709543,0.5940972222222223,48.95833333333333,1004.1666666666661,33.4722222222222,0
30,4,4,2,31,0.12121212121212122,0.06060606060606061,0.9393939393939394,33,1050,900,150,0.8571428571428571,12,9,3,349.7432772640843,0.47348484848484845,0.040816476835434434,0.18413547207972805,127122.9083315311,2292.076515042285,129414.98484657338,29,0,14.303030303030303,33,0,23,39.06851278000568,0.5975378787878788,47.8860294117647,1008.4558823529408,30.559269162210327,0
31,4,1,2,30,0.03125,0.0625,0.9375,32,950,600,350,0.631578947368421,13,6,7,359.22669442388775,0.47141717069892475,0.052550237886565654,0.1891327362138161,127123.84458537394,2733.2556945719834,129857.10027994592,30,0,15.625,32,0,24,38.828460832185634,0.5999348958333333,47.88510101010101,1008.459595959596,31.514362373737374,0
32,4,2,2,30,0.0625,0.0625,0.9375,32,900,700,200,0.7777777777777778,11,7,4,350.0898158258902,0.47049311155913975,0.06122281589801304,0.18636517740671643,127569.89282024796,2532.184056473833,130102.0768767218,31,0,15.625,32,0,20,38.60142482189726,0.6044921875,47.44318181818182,1010.2272727272729,31.569602272727277,0
33,4,2,1,31,0.0625,0.03125,0.96875,32,950,500,450,0.5263157894736842,14,5,9,346.00526818359594,0.4679519489247312,0.05045556665002526,0.1858039013865262,127920.90730537701,2452.2615676971795,130373.16887307419,32,0,15.65625,32,0,22,38.345346563488135,0.6080729166666667,47.0959595959596,1011.6161616161617,31.613005050505052,0
34,4,1,1,31,0.03125,0.03125,0.96875,32,1050,700,350,0.6666666666666666,14,7,7,360.33823526804446,0.4654737903225807,0.04307687468545551,0.18405965899167206,125885.40072441591,2672.2646286093313,128557.66535302525,33,0,16.53125,32,0,21,40.075857658111055,0.5872395833333333,49.11616161616162,1003.5353535353538,31.360479797979806,8
35,4,3,2,32,0.08823529411764706,0.058823529411764705,0.9411764705882353,34,1250,1100,150,0.88,14,11,3,337.77245883218427,0.4664104278074866,0.05728458333929831,0.1763541338426235,126783.27596357188,1764.8794112704622,128548.15537484235,34,0,16.41176470588235,33,1,21,39.71870690354506,0.5940656565656566,48.223039215686285,1007.1078431372564,30.51841948900777,0
36,4,3,1,34,0.08571428571428572,0.02857142857142857,0.9714285714285714,35,1150,700,450,0.6086956521739131,16,7,9,326.87427158557415,0.46925770308123255,0.06643092880716672,0.17375948121127918,127512.50000000013,1336.1111111111263,128848.61111111126,35,0,16.02857142857143,34,1,18,39.246424642464234,0.5992647058823529,47.50000000000001,1010.000000000001,29.705882352941206,0
37,4,0,1,33,0.0,0.029411764705882353,0.9705882352941176,34,1350,1000,350,0.7407407407407407,17,10,7,335.9545285057974,0.4661319073083779,0.07269228847018794,0.17823112429872937,127432.05925905916,1762.275476980019,129194.33473603918,36,1,17.5,33,1,20,39.09948112635027,0.6006944444444444,47.579656862745104,1009.6813725490208,30.596405228758208,0
38,4,1,3,31,0.029411764705882353,0.08823529411764706,0.9117647058823529,34,950,900,50,0.9473684210526315,10,9,1,331.07958477508686,0.4655377302436126,0.06636678200692092,0.1781124348473565,127993.90589569135,1675.233843537389,129669.13973922873,37,0,17.58823529411765,34,0,23,38.6482843137255,0.6041666666666667,47.02380952380951,1011.9047619047599,29.761904761904702,0
39,4,0,1,30,0.0,0.03225806451612903,0.967741935483871,31,850,600,250,0.7058823529411765,11,6,5,356.16336119485425,0.46169354838709675,0.06886151673140462,0.19060017227278034,127782.23885430224,2902.2703382703953,130684.50919257263,38,1,19.193548387096776,31,0,24,38.230441081777215,0.6092069892473118,47.233072916666664,1011.0677083333328,32.61508736559138,0
40,4,0,1,29,0.0,0.03333333333333333,0.9666666666666667,30,850,500,350,0.5882352941176471,12,5,7,357.57452812350823,0.4594827586206896,0.06647173489278724,0.19162327276362362,127838.51456815819,3142.359304543883,130980.87387270207,39,2,20.0,30,0,24,38.1371278575226,0.6125,47.17741935483871,1011.2903225806454,33.70967741935485,0
41,4,1,1,29,0.03333333333333333,0.03333333333333333,0.9666666666666667,30,900,700,200,0.7777777777777778,11,7,4,355.0275216090046,0.46000957854406127,0.05544046038069972,0.1912272702228759,128042.48504162328,3091.7212249971117,131134.2062666204,40,0,19.7,30,0,25,37.99275121735281,0.6145833333333333,46.975806451612904,1012.0967741935482,33.73655913978494,0
42,4,2,0,31,0.06451612903225806,0.0,1.0,31,1000,500,500,0.5,15,5,10,343.7551192898403,0.4601702508960574,0.04930662557781207,0.1874765314446272,128540.34423828126,2637.2802734375,131177.62451171875,41,0,19.580645161290324,31,0,20,37.769645608628664,0.6169354838709677,46.484375,1014.0625000000001,32.7116935483871,0
43,4,0,0,31,0.0,0.0,1.0,31,950,600,350,0.631578947368421,13,6,7,346.329167693649,0.4598566308243728,0.05034758882250401,0.18935091547376962,128639.3928527831,2710.314771864134,131349.70762464724,42,1,20.580645161290324,31,0,20,37.60335108886322,0.6179435483870968,46.38671874999999,1014.4531249999992,32.72429435483868,0
44,4,0,0,31,0.0,0.0,1.0,31,1000,700,300,0.7,13,7,6,346.7940708032693,0.459005376344086,0.046084131680771634,0.19023643785443223,128771.51701185429,2731.4397176106713,131502.95672946496,43,2,21.580645161290324,31,0,21,37.45683664742358,0.6192876344086021,46.256510416666664,1014.9739583333326,32.7410954301075,0
45,4,1,1,31,0.03125,0.03125,0.96875,32,1300,800,500,0.6153846153846154,18,8,10,340.6902057987339,0.4578293010752688,0.05453233614697184,0.18954421946924024,129329.78777675738,2412.2784027140046,131742.06617947138,44,0,21.875,32,0,23,37.04355966567364,0.6223958333333333,45.707070707070706,1017.1717171717164,31.786616161616138,0
46,4,2,3,30,0.06060606060606061,0.09090909090909091,0.9090909090909091,33,1400,1200,200,0.8571428571428571,16,12,4,331.5894463472466,0.45805713383838387,0.04759248931028037,0.18637613708483158,129731.4453124999,2003.5156249999839,131734.96093749988,45,0,21.757575757575758,33,0,18,36.867331288343536,0.6240530303030303,45.31249999999999,1018.7499999999992,30.871212121212096,0
47,4,1,0,31,0.03225806451612903,0.0,1.0,31,750,600,150,0.8,9,6,3,350.6222712714531,0.45600358422939063,0.05993671329969574,0.19624305934656355,129565.68611992738,2885.7230292426307,132451.40914917,46,0,23.70967741935484,31,0,20,36.551056187918306,0.6273521505376345,45.47526041666667,1018.098958333334,32.84190188172045,0
48,4,1,0,32,0.03125,0.0,1.0,32,850,400,450,0.47058823529411764,13,4,9,339.4654570583909,0.4558971774193548,0.06282503714710241,0.19198340554646834,129972.73875114799,2424.251033057869,132396.98978420586,47,0,23.9375,32,0,21,36.42196012877662,0.62890625,45.075757575757585,1019.6969696969709,31.86553030303034,0
49,4,1,0,33,0.030303030303030304,0.0,1.0,33,1050,800,250,0.7619047619047619,13,8,5,347.23684077477645,0.4533222853535353,0.0943374299078994,0.20009283145198442,130700.81218762012,2476.827422145322,133177.63960976544,48,0,24.181818181818183,33,0,17,35.48607782038988,0.6338383838383839,44.36274509803921,1022.549019607843,30.986333927510394,0
50,4,0,3,30,0.0,0.09090909090909091,0.9090909090909091,33,1250,800,450,0.64,17,8,9,344.6411129836136,0.451980744949495,0.08735982580293933,0.19956680259453352,130888.84833958093,2421.935673779317,133310.78401336024,49,1,25.181818181818183,33,0,19,35.36227544910179,0.6357323232323233,44.17892156862745,1023.2843137254903,31.0086155674391,0
51,4,0,1,29,0.0,0.03333333333333333,0.9666666666666667,30,1300,900,400,0.6923076923076923,17,9,8,389.77722449018984,0.4508141762452107,0.04646037203561626,0.21577564945789274,129133.0735489652,4066.62619956064,133199.69974852583,50,2,26.866666666666667,30,0,21,35.99631931587763,0.6256944444444444,45.9005376344086,1016.3978494623656,33.87992831541219,8
52,4,1,2,28,0.03333333333333333,0.06666666666666667,0.9333333333333333,30,950,700,250,0.7368421052631579,12,7,5,386.85114370880467,0.45047892720306515,0.05730129390018446,0.2163966441987067,129543.2365735924,4022.7898456469015,133566.0264192393,51,0,27.7,30,0,18,35.65184622832496,0.6298611111111111,45.49731182795699,1018.0107526881726,33.93369175627242,0
53,4,0,0,28,0.0,0.0,1.0,28,750,300,450,0.4,12,3,9,407.62397220620284,0.4488536155202822,0.07843216404957021,0.2264648724706045,129274.43560906325,4939.071789536263,134213.50739859953,52,1,30.178571428571427,28,0,22,35.39812329283226,0.6331845238095238,45.76149425287356,1016.9540229885054,36.31978653530376,0
54,4,1,0,29,0.034482758620689655,0.0,1.0,29,1100,700,400,0.6363636363636364,15,7,8,395.4936382804389,0.4479679802955665,0.07276350919414876,0.2224955007994861,129766.82098765425,4464.390432098754,134231.211419753,53,0,30.103448275862068,29,0,21,35.20367593602326,0.6350574712643677,45.27777777777777,1018.8888888888883,35.13409961685822,0
55,4,0,0,29,0.0,0.0,1.0,29,900,600,300,0.6666666666666666,12,6,6,395.65278136329255,0.4482245484400657,0.07303558252221842,0.2227862207876037,129802.20148533945,4471.320408950608,134273.52189429005,54,1,31.103448275862068,29,0,21,35.16352619144973,0.6354166666666667,45.24305555555555,1019.0277777777773,35.13888888888887,0
56,4,1,0,30,0.03333333333333333,0.0,1.0,30,900,400,500,0.4444444444444444,14,4,10,388.26791862831135,0.4465277777777778,0.08032816607741755,0.222031280994759,130404.40779320983,4127.18460648147,134531.5923996913,55,0,31.033333333333335,29,1,22,34.73846432780345,0.6415229885057472,44.65277777777777,1021.3888888888885,35.220306513409945,0
57,4,1,0,31,0.03225806451612903,0.0,1.0,31,950,800,150,0.8421052631578947,11,8,3,375.9366837206691,0.4450268817204301,0.08223384428443592,0.21753390726634886,130861.41798231332,3639.1215006510374,134500.53948296435,56,0,31.0,31,0,21,34.589484177483676,0.6404569892473118,44.205729166666664,1023.1770833333329,33.005712365591386,0
58,4,0,0,31,0.0,0.0,1.0,31,550,300,250,0.5454545454545454,8,3,5,375.8638942906376,0.444578853046595,0.0840408550172147,0.2180565367541476,130961.35669284391,3644.7291056315066,134606.08579847543,57,1,32.0,31,0,21,34.49001929355894,0.6414650537634409,44.108072916666664,1023.5677083333328,33.018313172042994,0
59,4,0,1,30,0.0,0.03225806451612903,0.967741935483871,31,900,500,400,0.5555555555555556,13,5,8,373.54327239072916,0.4436379928315412,0.08293759175873294,0.21765121337966503,131128.00598144543,3596.3968912760565,134724.4028727215,58,2,33.0,31,0,21,34.380561912026444,0.6431451612903225,43.94531250000001,1024.218750000001,33.03931451612906,0
60,4,0,1,29,0.0,0.03333333333333333,0.9666666666666667,30,1100,800,300,0.7272727272727273,14,8,6,376.0054178984145,0.44135536398467434,0.06870819672131168,0.22003386887762166,131293.68505390795,3873.4273832234885,135167.11243713144,59,3,33.46666666666667,30,0,21,34.14972677595628,0.6475694444444444,43.78360215053763,1024.8655913978491,34.16218637992831,0
61,4,0,0,29,0.0,0.0,1.0,29,950,800,150,0.8421052631578947,11,8,3,379.7342851477295,0.4398091133004926,0.0784973366975048,0.22241579558652722,131328.125,4173.958333333334,135502.08333333334,60,4,34.793103448275865,29,0,21,34.019308943089435,0.6508620689655172,43.75,1025.0,35.3448275862069,0
62,4,0,1,28,0.0,0.034482758620689655,0.9655172413793104,29,900,500,400,0.5555555555555556,13,5,8,377.97750751529753,0.4388854679802956,0.07733403070945588,0.22221225441822914,131470.5246913581,4138.580246913587,135609.1049382717,61,5,35.793103448275865,29,0,21,33.920187793427246,0.6522988505747127,43.611111111111114,1025.5555555555559,35.363984674329515,0
63,4,0,0,28,0.0,0.0,1.0,28,700,500,200,0.7142857142857143,9,5,4,406.87740656981754,0.43747244268077606,-0.004548398194807346,0.2221305191783714,128581.32524524377,4863.3672298189995,133444.69247506277,62,6,36.214285714285715,28,0,16,36.127343344194166,0.6261160714285714,46.44396551724138,1014.2241379310346,36.22229064039409,8
64,4,2,1,29,0.06666666666666667,0.03333333333333333,0.9666666666666667,30,1200,900,300,0.75,15,9,6,381.6339326819501,0.44027777777777777,0.0019115574348134157,0.2123680590100735,129338.0737657533,3871.959547346521,133210.03331309982,63,0,34.733333333333334,30,0,19,35.99393278717407,0.6277777777777778,45.6989247311828,1017.2043010752691,33.906810035842305,0
65,4,0,0,29,0.0,0.0,1.0,29,750,600,150,0.8,9,6,3,386.9929265529249,0.4390907224958949,0.0158216672081819,0.21518217168922335,129307.31336805562,4208.203125000009,133515.51649305562,64,1,36.58620689655172,29,0,21,35.88906527379488,0.6303879310344828,45.72916666666667,1017.0833333333339,35.07183908045979,0
66,4,0,1,28,0.0,0.034482758620689655,0.9655172413793104,29,1300,800,500,0.6153846153846154,18,8,10,391.70785267169657,0.4384749589490969,0.012138834389600062,0.2189799277063971,129519.29253472234,4346.744791666686,133866.03732638902,65,2,37.58620689655172,29,0,17,35.55268454086507,0.6325431034482758,45.52083333333334,1017.9166666666675,35.100574712643706,0
67,4,1,0,29,0.034482758620689655,0.0,1.0,29,700,400,300,0.5714285714285714,10,4,6,391.8144963247229,0.4390907224958949,0.0011281164216143669,0.220425701306608,129766.82098765446,4368.904320987671,134135.72530864214,66,0,37.51724137931034,29,0,18,35.297391857506355,0.6350574712643677,45.277777777777786,1018.8888888888899,35.13409961685827,0
68,4,0,0,29,0.0,0.0,1.0,29,1150,900,250,0.782608695652174,14,9,5,393.93106553079565,0.4385775862068966,-0.00225531055156436,0.22221830053270625,129872.9769483025,4432.200038580251,134305.17698688275,67,1,38.51724137931034,29,0,18,35.13520802107462,0.6361350574712643,45.173611111111114,1019.3055555555558,35.1484674329502,0
69,4,0,0,29,0.0,0.0,1.0,29,650,400,250,0.6153846153846154,9,4,5,395.1712554625574,0.43837233169129725,-0.00507306624579007,0.22332195429950985,129943.77170138886,4470.00868055555,134413.7803819444,68,2,39.51724137931034,29,0,18,35.03141601961585,0.6368534482758621,45.104166666666664,1019.583333333333,35.15804597701148,0
70,4,1,0,30,0.03333333333333333,0.0,1.0,30,800,500,300,0.625,11,5,6,384.00666389004584,0.43996647509578546,-0.0020408163265308588,0.218794494542003,130262.58680555562,4004.3402777777874,134266.9270833334,69,0,39.166666666666664,30,0,19,34.99149659863946,0.6371527777777778,44.79166666666667,1020.8333333333339,34.0277777777778,0
71,4,0,1,29,0.0,0.03333333333333333,0.9666666666666667,30,950,600,350,0.631578947368421,13,6,7,387.9696459599887,0.4390565134099617,-0.006391191823485798,0.22183456280285582,130399.83171826221,4118.2353089952585,134518.06702725746,70,1,40.166666666666664,30,0,20,34.75073474579988,0.6385416666666667,44.65725806451613,1021.3709677419354,34.04569892473118,0
72,4,0,0,29,0.0,0.0,1.0,29,650,300,350,0.46153846153846156,10,3,7,394.25889710228216,0.43811576354679804,0.0016880327853479038,0.22545722622785233,130404.4077932098,4482.619598765419,134887.02739197522,71,2,41.275862068965516,29,0,20,34.58548635663131,0.6415229885057472,44.65277777777777,1021.3888888888882,35.22030651340994,0
73,4,0,1,28,0.0,0.034482758620689655,0.9655172413793104,29,950,800,150,0.8421052631578947,11,8,3,396.45853024574683,0.43688423645320196,0.0014055472263867497,0.22796365489130443,130617.28395061733,4556.867283950627,135174.15123456795,72,3,42.275862068965516,29,0,17,34.31272644927537,0.6436781609195402,44.44444444444445,1022.2222222222226,35.24904214559388,0
74,4,0,0,28,0.0,0.0,1.0,28,1200,900,300,0.75,15,9,6,420.7624709384085,0.4361221340388007,0.01885795570006077,0.22374887826755005,127527.01190712117,5131.716128286429,132658.7280354076,73,4,43.42857142857143,28,0,21,36.86077524893313,0.6153273809523809,47.485632183908045,1010.0574712643679,36.07348111658457,8
75,4,1,0,29,0.034482758620689655,0.0,1.0,29,900,600,300,0.6666666666666666,12,6,6,409.1988513300163,0.43662766830870275,0.0315157365738703,0.22038669842142103,128039.08420138876,4678.68923611109,132717.77343749985,74,0,42.89655172413793,29,0,22,36.62558323041033,0.6174568965517242,46.97916666666666,1012.0833333333322,34.89942528735629,0
76,4,0,0,29,0.0,0.0,1.0,29,1400,1100,300,0.7857142857142857,17,11,6,410.9327832756346,0.4359605911330049,0.02493248268033943,0.22210538777045033,128180.90236490943,4734.790397096698,132915.69276200613,75,1,43.89655172413793,28,1,22,36.43586833144153,0.6220238095238095,46.83908045977011,1012.643678160919,36.16584564860425,0
77,4,2,1,30,0.06451612903225806,0.03225806451612903,0.967741935483871,31,1050,800,250,0.7619047619047619,13,8,5,386.46664427087694,0.4390681003584229,0.032181259600614354,0.21357367183390555,129064.77627471377,3775.8461960920204,132840.6224708058,76,0,42.0,30,1,20,36.150242504409164,0.625,45.967741935483865,1016.1290322580641,33.870967741935466,0
78,4,2,2,30,0.0625,0.0625,0.9375,32,1200,900,300,0.75,15,9,6,366.6215699032199,0.44165826612903225,0.014571455131383138,0.20598209094562514,129715.36705438212,3111.290302009988,132826.6573563921,77,0,39.71875,32,0,18,35.99146835233846,0.6263020833333333,45.32828282828282,1018.686868686868,31.833964646464626,0
79,4,0,0,30,0.0,0.0,1.0,30,1050,700,350,0.6666666666666666,14,7,7,383.14728352489465,0.43697318007662833,0.022380700827610456,0.21395215566744125,129474.83090530704,3921.585949242698,133396.41685454975,78,1,43.0,30,0,18,35.8158896812819,0.6291666666666667,45.56451612903226,1017.7419354838715,33.92473118279572,0
80,4,1,1,30,0.03225806451612903,0.03225806451612903,0.967741935483871,31,1050,700,350,0.6666666666666666,14,7,7,370.30755152921313,0.4381272401433692,0.01951388345234184,0.20902219328927266,129897.31046888571,3420.3909979926275,133317.70146687835,79,0,42.58064516129032,31,0,21,35.7124419891855,0.6307123655913979,45.149739583333336,1019.4010416666673,32.88390456989249,0
81,4,1,0,31,0.03225806451612903,0.0,1.0,31,700,400,300,0.5714285714285714,10,4,6,372.6748705667112,0.44229390681003583,0.03862370000496007,0.20597412818007163,129069.04432508667,3420.1578776041474,132489.20220269082,80,0,41.67741935483871,31,0,19,36.49624124380658,0.6223118279569892,45.96354166666666,1016.1458333333322,32.77889784946233,8
82,4,0,1,30,0.0,0.03225806451612903,0.967741935483871,31,1200,1100,100,0.9166666666666666,13,11,2,371.57982231650897,0.44233870967741934,0.031721118499855594,0.2064038700065385,129267.58660210489,3406.6453721788002,132674.2319742837,81,1,42.67741935483871,31,0,19,36.32148954332053,0.6243279569892473,45.76822916666666,1016.9270833333321,32.80409946236555,0
83,4,0,2,28,0.0,0.06666666666666667,0.9333333333333333,30,800,500,300,0.625,11,5,6,394.8151099611489,0.441977969348659,-0.03451774319423406,0.20788633164814382,127127.02787422846,4075.786147882916,131202.8140221114,82,2,44.1,29,1,18,37.92794266170866,0.608117816091954,47.88194444444445,1008.4722222222227,34.774904214559406,8
84,4,1,0,29,0.034482758620689655,0.0,1.0,29,1050,600,450,0.5714285714285714,15,6,9,396.50983518135774,0.4413485221674877,0.009966115208291937,0.20968271196708496,127302.17013888899,4295.312500000017,131597.48263888902,83,0,46.310344827586206,29,0,20,37.70472061657034,0.6099137931034483,47.70833333333334,1009.1666666666675,34.798850574712674,0
85,4,0,1,28,0.0,0.034482758620689655,0.9655172413793104,29,600,400,200,0.6666666666666666,8,4,4,397.31027058117905,0.44129720853858784,0.011952758146373643,0.21083545015512206,127442.37075617291,4326.8325617284045,131769.20331790132,84,1,47.310344827586206,29,0,19,37.54011921137092,0.6113505747126438,47.56944444444445,1009.7222222222229,34.81800766283527,0
86,4,0,0,28,0.0,0.0,1.0,28,800,400,400,0.5,12,4,8,403.068033215637,0.44138558201058203,0.02429871422477725,0.21491868670246958,127635.87753088248,4689.188424824936,132325.06595570743,85,2,49.0,28,0,19,37.195483198255836,0.6164434523809523,47.37787356321839,1010.4885057471258,36.088875205254496,0
87,4,1,0,29,0.034482758620689655,0.0,1.0,29,650,200,450,0.3076923076923077,11,2,9,392.9277779595094,0.44504310344827586,0.022714044377564413,0.21162340857287087,128039.08420138883,4262.02256944444,132301.10677083328,86,0,48.275862068965516,29,0,20,37.03727528475367,0.6174568965517242,46.979166666666664,1012.0833333333328,34.8994252873563,0
88,4,1,0,30,0.03333333333333333,0.0,1.0,30,950,700,250,0.7368421052631579,12,7,5,381.40318264729837,0.44734195402298854,0.024260512004244728,0.20701213779539104,128348.74561004159,3790.5240128916626,132139.26962293324,87,0,47.63333333333333,30,0,21,37.01142945571917,0.6177083333333333,46.67338709677419,1013.306451612903,33.7768817204301,0
89,4,1,2,29,0.03225806451612903,0.06451612903225806,0.935483870967742,31,900,600,300,0.6666666666666666,12,6,6,372.3953772534036,0.44852150537634405,0.016151787081053026,0.2046206311800412,128837.60452270495,3395.705668131498,132233.31019083643,88,0,47.064516129032256,31,0,18,36.73969154803129,0.6199596774193548,46.19140624999999,1015.234374999999,32.7494959677419,0
90,4,0,0,29,0.0,0.0,1.0,29,1200,1000,200,0.8333333333333334,14,10,4,395.00779179647986,0.4425800492610838,0.024644030668126815,0.21595336162286596,128637.19135802466,4362.538580246909,132999.72993827157,89,1,50.827586206896555,29,0,18,36.371052391383714,0.6235632183908046,46.388888888888886,1014.4444444444442,34.98084291187739,0
91,4,0,0,29,0.0,0.0,1.0,29,950,800,150,0.8421052631578947,11,8,3,397.89031681843505,0.4422721674876848,0.028024023287303024,0.21849589223335408,128813.37046682107,4450.718557098781,133264.08902391986,90,2,51.827586206896555,29,0,18,36.11742942490994,0.6253591954022988,46.215277777777786,1015.1388888888895,35.00478927203067,0
92,4,0,0,29,0.0,0.0,1.0,29,1050,800,250,0.7619047619047619,13,8,5,397.3564382582198,0.4415024630541872,0.025462449959213096,0.21898022855933397,128954.4005594136,4448.172260802476,133402.57282021607,91,3,52.827586206896555,29,0,19,35.98657071881125,0.6267959770114943,46.07638888888889,1015.6944444444446,35.02394636015326,0
93,4,2,0,31,0.06451612903225806,0.0,1.0,31,850,600,250,0.7058823529411765,11,6,5,377.5551680656244,0.44345878136200717,0.031940474570119504,0.2116744780961469,129631.97708129892,3588.6445787218026,133220.62166002073,92,0,50.354838709677416,31,0,16,35.79798512551678,0.6280241935483871,45.41015625000001,1018.3593750000007,32.85030241935486,0
94,4,0,0,31,0.0,0.0,1.0,31,1050,800,250,0.7619047619047619,13,8,5,375.303297851517,0.4435483870967742,0.029029371621314803,0.21076796116959226,129698.28499688058,3535.238817003059,133233.52381388363,93,1,51.354838709677416,31,0,16,35.787767906600195,0.6286962365591398,45.34505208333334,1018.619791666668,32.85870295698929,0
95,4,1,3,29,0.03125,0.09375,0.90625,32,950,700,250,0.7368421052631579,12,7,5,379.4663112903381,0.44541750672043007,0.042781394045098065,0.20622722279807354,128400.34060618824,3344.720723650662,131745.0613298389,94,0,50.71875,32,0,18,37.00765126032974,0.6129557291666667,46.622474747474755,1013.5101010101018,31.672190656565682,7
96,4,1,0,30,0.03333333333333333,0.0,1.0,30,1250,1000,250,0.8,15,10,5,386.9399206521455,0.446455938697318,0.06355602686461603,0.21091580645952218,128519.04844490699,3945.830081512319,132464.8785264193,95,0,52.53333333333333,30,0,21,36.69665738776952,0.6194444444444445,46.505376344086024,1013.9784946236564,33.79928315412188,0
97,4,0,0,30,0.0,0.0,1.0,30,750,400,350,0.5333333333333333,11,4,7,388.5676701609449,0.44571360153256706,0.06394152201757852,0.2123475891893303,128621.28434284314,3995.6145580413963,132616.89890088452,96,1,53.53333333333333,30,0,21,36.550671348438684,0.6204861111111111,46.40456989247312,1014.3817204301077,33.81272401433692,0
98,4,0,1,29,0.0,0.03333333333333333,0.9666666666666667,30,1250,1000,250,0.8,15,10,5,390.09166264637526,0.44516283524904215,0.06487417218543046,0.2137294668345525,128723.56088854202,4042.7975777546576,132766.3584662967,97,2,54.53333333333333,30,0,22,36.40728476821191,0.6215277777777778,46.303763440860216,1014.7849462365591,33.82616487455197,0
99,4,0,1,28,0.0,0.034482758620689655,0.9655172413793104,29,950,600,350,0.631578947368421,13,6,7,441.07841183493133,0.44186165845648606,0.11333982281741939,0.23122002844620385,126947.17969678952,5407.877828134817,132355.05752492434,98,3,57.06896551724138,28,1,19,36.947830529417345,0.609375,48.060344827586206,1007.7586206896551,35.991379310344826,8
100,4,0,0,28,0.0,0.0,1.0,28,850,600,250,0.7058823529411765,11,6,5,440.20217198278823,0.43871252204585537,0.14669421487603307,0.23158462091268409,127092.01388888876,5589.318684766791,132681.33257365556,99,4,59.57142857142857,27,1,19,36.819903581267226,0.6141975308641976,47.91666666666666,1008.3333333333322,37.34567901234564,0
101,4,1,0,29,0.034482758620689655,0.0,1.0,29,850,700,150,0.8235294117647058,10,7,3,425.0929585490142,0.4405275041050903,0.13395621813399572,0.22544363922444688,127418.19273104101,5032.915304201339,132451.10803524236,100,0,58.48275862068966,28,1,20,36.86376357857786,0.6142113095238095,47.593390804597696,1009.6264367816086,36.058087027914596,0
102,4,0,0,29,0.0,0.0,1.0,29,950,800,150,0.8421052631578947,11,8,3,424.71385693329415,0.4408866995073892,0.13278977242066126,0.2256472940577567,127490.73368757419,5029.416245541002,132520.1499331152,101,1,59.48275862068966,28,1,20,36.79844216816048,0.6149553571428572,47.52155172413792,1009.9137931034471,36.06834975369454,0
103,4,1,0,30,0.03333333333333333,0.0,1.0,30,700,600,100,0.8571428571428571,8,6,2,411.5865421514602,0.441977969348659,0.1261522266465287,0.22089792089086835,127898.5556520061,4528.264853395052,132426.82050540115,102,0,58.46666666666667,29,1,21,36.7097750469129,0.6160201149425287,47.11805555555555,1011.5277777777773,34.8802681992337,0
104,4,5,2,33,0.14285714285714285,0.05714285714285714,0.9428571428571428,35,1000,800,200,0.8,12,8,4,361.4807696225139,0.44544817927170866,0.10681493467371284,0.20093294756177077,129294.84941188463,2354.1223794800867,131648.97179136472,103,0,50.97142857142857,33,2,21,36.55046290717757,0.6196338383838385,45.74142156862744,1017.0343137254883,30.819221628045103,0
105,4,1,0,34,0.029411764705882353,0.0,1.0,34,1250,1000,250,0.8,15,10,5,368.7195488066677,0.444555852644088,0.11862574679735371,0.20480463766130327,129265.58036169756,2732.549293439417,131998.129655137,104,0,53.44117647058823,32,2,22,36.3962523797699,0.6217447916666667,45.77020202020201,1016.9191919191901,31.77872474747469,0
106,4,0,1,33,0.0,0.029411764705882353,0.9705882352941176,34,750,300,450,0.4,12,3,9,370.1193536205958,0.44420306001188353,0.12406821981616312,0.20608511624886902,129361.89746263114,2775.8683744005457,132137.76583703168,105,1,54.44117647058823,32,2,22,36.2624632824459,0.6227213541666667,45.67550505050504,1017.297979797978,31.79056186868681,0
107,4,2,2,33,0.05714285714285714,0.05714285714285714,0.9428571428571428,35,950,500,450,0.5263157894736842,14,5,9,357.8644528917866,0.4448179271708683,0.11861575999175233,0.20130480793926325,129762.65889321404,2287.488586120707,132050.14747933476,106,0,53.68571428571428,33,2,16,36.16640606206398,0.6243686868686869,45.28186274509803,1018.872549019607,30.87492572786688,0
108,4,1,2,32,0.029411764705882353,0.058823529411764705,0.9411764705882353,34,850,600,250,0.7058823529411765,11,6,5,370.1690136952224,0.44273618538324416,0.13293242947736705,0.20831687172388047,129779.68606519747,2808.08367768595,132587.76974288342,107,0,56.11764705882353,32,2,18,35.83565675340767,0.626953125,45.265151515151516,1018.9393939393942,31.84185606060607,0
109,4,0,0,32,0.0,0.0,1.0,32,1000,800,200,0.8,12,8,4,387.7535899964349,0.4393271169354838,0.13950335892514443,0.21629509677531317,129433.15505981441,3637.634107801649,133070.78916761605,108,1,60.375,31,1,18,35.74122947323525,0.626008064516129,45.60546875,1017.5781249999997,32.8251008064516,0
110,4,0,0,32,0.0,0.0,1.0,32,1200,700,500,0.5833333333333334,17,7,10,381.775654593713,0.4379620295698925,0.1391024051574512,0.21414481432217583,129651.06398581772,3499.523964391381,133150.5879502091,109,2,61.375,32,0,18,35.67107818828001,0.6256510416666667,45.39141414141414,1018.434343434343,31.826073232323218,0
111,4,1,0,33,0.030303030303030304,0.0,1.0,33,950,900,50,0.9473684210526315,10,9,1,372.44481719573986,0.438604797979798,0.1438265402705574,0.21118737454614,130075.00120146078,3089.1520088427255,133164.1532103035,110,0,60.484848484848484,33,0,19,35.47723450264294,0.6275252525252526,44.97549019607842,1020.0980392156847,30.912061794414686,0
112,4,0,0,33,0.0,0.0,1.0,33,850,600,250,0.7058823529411765,11,6,5,374.9410378115303,0.438604797979798,0.15045616486711766,0.2131149502973796,130168.77710796313,3161.1232759034824,133329.90038386662,111,1,61.484848484848484,33,0,19,35.31821684480205,0.6284722222222222,44.88357843137254,1020.4656862745086,30.923202614379047,0
113,4,1,1,33,0.029411764705882353,0.029411764705882353,0.9705882352941176,34,1200,1100,100,0.9166666666666666,13,11,2,360.96621202974643,0.43948677956030896,0.13990025962638497,0.20760997070994147,130627.42524092946,2630.4173752834195,133257.84261621287,112,0,60.64705882352941,34,0,17,35.20947362291838,0.6308210784313726,44.434523809523796,1022.2619047619028,30.0665266106442,0
114,4,1,1,33,0.029411764705882353,0.029411764705882353,0.9705882352941176,34,800,400,400,0.5,12,4,8,353.2928731339324,0.4408793820558527,0.11256945775052696,0.20464323028701378,130901.38888888896,2449.305555555565,133350.69444444453,113,0,58.5,34,0,18,35.128257328990216,0.633578431372549,44.16666666666667,1023.3333333333339,30.098039215686292,0
115,4,0,1,32,0.0,0.030303030303030304,0.9696969696969697,33,1100,700,400,0.6363636363636364,15,7,8,362.03879688403873,0.43970959595959597,0.09817108117323547,0.210324903280199,131014.28086553258,2886.450523836997,133900.73138936958,114,1,58.09090909090909,33,0,18,34.79022025377065,0.6369949494949495,44.05637254901961,1023.7745098039223,31.023469994058253,0
116,4,0,0,32,0.0,0.0,1.0,32,750,300,450,0.4,12,3,9,365.42626685770716,0.43560987903225806,0.09742692402565356,0.2122404134442901,131004.77629833693,3174.517268646061,134179.293566983,115,2,60.65625,32,0,18,34.71314339746753,0.6393229166666667,44.06565656565657,1023.737373737374,31.991792929292938,0
117,4,1,1,32,0.030303030303030304,0.030303030303030304,0.9696969696969697,33,1050,700,350,0.6666666666666666,14,7,7,357.8493962248974,0.43742108585858586,0.09899183034938264,0.21028678002878828,131453.76778162265,2808.1302864283225,134261.89806805097,116,0,59.78787878787879,33,0,20,34.4531747928617,0.6414141414141414,43.62745098039217,1025.490196078433,31.075460487225243,0
118,4,1,2,31,0.030303030303030304,0.06060606060606061,0.9393939393939394,33,1100,600,500,0.5454545454545454,16,6,10,356.1687822554811,0.43848642676767674,0.08410636982065545,0.21120581928653068,131799.5951827423,2788.580263600549,134588.17544634285,117,0,58.484848484848484,33,0,16,34.147248080518764,0.6448863636363636,43.290441176470594,1026.8382352941185,31.116310160427833,0
119,4,1,0,32,0.03125,0.0,1.0,32,1250,900,350,0.72,16,9,7,366.76109563573414,0.4337617607526882,0.09663213231677359,0.21738347155319168,131781.48275686151,3266.464200081626,135047.94695694314,118,0,61.15625,32,0,19,33.89361985571406,0.6471354166666667,43.30808080808081,1026.7676767676767,32.086489898989896,0
120,4,0,0,32,0.0,0.0,1.0,32,900,700,200,0.7777777777777778,11,7,4,364.6563895420502,0.43380376344086025,0.0961012417014997,0.21650474982007575,131846.31191970222,3215.720015814726,135062.03193551695,119,1,62.15625,32,0,20,33.882212523563645,0.6477864583333333,43.2449494949495,1027.020202020203,32.09438131313134,0
121,4,0,0,32,0.0,0.0,1.0,32,1300,1100,200,0.8461538461538461,15,11,4,364.0638616053288,0.4317666330645162,0.0953618138278276,0.21782307311184373,132138.240437838,3221.351615906545,135359.59205374453,120,2,63.15625,32,0,20,33.60299234516353,0.6507161458333333,42.96085858585859,1028.1565656565658,32.12989267676768,0
122,4,0,0,32,0.0,0.0,1.0,32,1350,1200,150,0.8888888888888888,15,12,3,367.0750122323007,0.4301495295698925,0.10932515337423321,0.22094987811619302,132365.51914345485,3317.614911743714,135683.13405519855,121,3,64.15625,32,0,21,33.296523517382425,0.6529947916666667,42.739898989899,1029.0404040404048,32.15751262626265,0
123,4,1,0,33,0.030303030303030304,0.0,1.0,33,850,400,450,0.47058823529411764,13,4,9,357.07006673968255,0.43110795454545453,0.10784805051618696,0.21735741646502846,132788.12629132243,2882.9370089786867,135671.06330030112,122,0,63.18181818181818,32,1,18,33.12890481440646,0.6572265625,42.32954545454546,1030.6818181818192,32.20880681818185,0
124,4,0,0,33,0.0,0.0,1.0,33,1150,1000,150,0.8695652173913043,13,10,3,355.38772923598725,0.42956912878787884,0.1103519899113532,0.21765500358755774,133015.96297571706,2854.448206815666,135870.41118253273,123,1,64.18181818181819,32,1,19,32.94344145246838,0.6595052083333333,42.108585858585876,1031.5656565656589,32.23642676767684,0
125,4,0,2,31,0.0,0.06060606060606061,0.9393939393939394,33,900,600,300,0.6666666666666666,12,6,6,390.62834327500565,0.4287405303030303,0.19699483668851903,0.22162006296594258,130096.4885287814,3589.3827572439004,133685.8712860253,124,2,65.18181818181819,31,2,21,34.99162412252712,0.632728494623656,44.95442708333333,1020.1822916666661,32.90910618279568,8
126,4,0,0,31,0.0,0.0,1.0,31,700,500,200,0.7142857142857143,9,5,4,406.86167511355154,0.42553763440860215,0.19159734764095648,0.22992852632860522,129943.77170138886,4373.828124999996,134317.59982638885,125,3,66.54838709677419,29,2,21,34.7334320937202,0.6368534482758621,45.104166666666664,1019.583333333333,35.15804597701148,0
127,4,1,0,32,0.03125,0.0,1.0,32,900,700,200,0.7777777777777778,11,7,4,393.0076177285319,0.42588625672043007,0.1807894736842106,0.2249139980976538,130434.15423748411,3852.323245461906,134286.477482946,126,0,65.4375,30,2,22,34.587171052631575,0.6388888888888888,44.623655913978496,1021.5053763440861,34.05017921146954,0
128,4,0,0,32,0.0,0.0,1.0,32,800,600,200,0.75,10,6,4,393.7071547358183,0.4256552419354838,0.18039156032101067,0.22551379677068248,130468.48127312418,3873.2749089490326,134341.7561820732,127,1,66.4375,30,2,22,34.53438144103847,0.6392361111111111,44.59005376344087,1021.6397849462376,34.05465949820792,0
129,4,0,1,31,0.0,0.03125,0.96875,32,1250,1000,250,0.8,15,10,5,396.9998228161538,0.4251512096774193,0.17673277901932427,0.22861299410768215,130674.53833174349,3975.5537128569686,134650.09204460046,128,2,67.4375,30,2,18,34.24066649138951,0.6413194444444444,44.38844086021505,1022.4462365591393,34.08154121863797,0
130,4,0,0,31,0.0,0.0,1.0,31,1350,900,450,0.6666666666666666,18,9,9,402.5518395864377,0.42414874551971327,0.15359147959675212,0.23274700552540806,130830.33371913579,4333.198302469129,135163.53202160491,129,3,66.61290322580645,29,2,20,33.94028871391075,0.6458333333333333,44.23611111111111,1023.0555555555554,35.27777777777777,0
131,4,0,0,31,0.0,0.0,1.0,31,1050,900,150,0.8571428571428571,12,9,3,403.0605575796852,0.42396953405017923,0.15669453319910698,0.2339020716033291,130972.4633487653,4357.966820987639,135330.43016975294,130,4,67.61290322580645,29,2,21,33.782790592492084,0.6472701149425287,44.097222222222214,1023.6111111111102,35.296934865900354,0
132,4,1,1,31,0.03125,0.03125,0.96875,32,1050,700,350,0.6666666666666666,14,7,7,397.8711461483302,0.42508820564516125,0.1522707260904903,0.23347255968735875,131399.31520061722,4056.48148148147,135455.79668209868,131,0,66.46875,29,3,22,33.482344441434115,0.6515804597701149,43.68055555555555,1025.2777777777771,35.354406130268174,0
133,4,0,0,31,0.0,0.0,1.0,31,850,500,350,0.5882352941176471,12,5,7,397.24200562423607,0.4238799283154122,0.12016751311152563,0.23419207466450348,131577.37509645047,4253.612075617266,135830.98717206775,132,1,65.38709677419355,29,2,16,33.317962862686706,0.6533764367816092,43.506944444444436,1025.972222222221,35.37835249042141,0
134,4,0,1,30,0.0,0.03225806451612903,0.967741935483871,31,1150,900,250,0.782608695652174,14,9,5,395.4993376637043,0.42343189964157707,0.11680667865937755,0.23338251650634545,131613.00154320977,4210.570987654304,135823.57253086407,133,2,66.38709677419355,29,2,16,33.3265656018769,0.6537356321839081,43.472222222222214,1026.1111111111104,35.383141762452084,0
135,4,0,0,30,0.0,0.0,1.0,30,1000,700,300,0.7,13,7,6,407.46628477038354,0.4225095785440613,0.11799505066068994,0.2398105364365842,131512.27715434655,4717.363794754907,136229.64094910145,134,3,68.23333333333333,28,2,22,33.12176075080544,0.6558779761904762,43.57040229885057,1025.7183908045968,36.63279967159274,0
136,4,0,0,30,0.0,0.0,1.0,30,900,600,300,0.6666666666666666,12,6,6,409.74700474356945,0.42193486590038315,0.11917565233627414,0.24161877463863152,131585.97414205963,4783.391754194731,136369.36589625437,135,4,69.23333333333333,28,2,16,32.988493675022184,0.6566220238095238,43.4985632183908,1026.005747126436,36.64306239737272,0
137,4,0,1,29,0.0,0.03333333333333333,0.9666666666666667,30,1050,700,350,0.6666666666666666,14,7,7,408.12148549071526,0.42052203065134103,0.12479015109121416,0.2422967091601025,131844.07616594006,4761.680043598899,136605.75620953896,136,5,70.23333333333333,28,2,17,32.768490020518556,0.6592261904761905,43.24712643678161,1027.011494252874,36.67898193760264,0
138,4,0,0,29,0.0,0.0,1.0,29,950,500,450,0.5263157894736842,14,5,9,421.892916166472,0.41830870279146143,0.1352508200656053,0.24909020118869774,131633.36167800438,5307.0365646258315,136940.3982426302,137,11,73.48275862068965,27,2,17,32.62881863882444,0.6604938271604939,43.45238095238094,1026.190476190475,38.0070546737213,0
139,4,0,0,29,0.0,0.0,1.0,29,1000,600,400,0.6,14,6,8,419.8815374921235,0.41743637110016424,0.13153423288355826,0.24889884954429997,131786.112882653,5266.911139455773,137053.02402210876,138,12,74.48275862068965,27,2,18,32.52536231884057,0.662037037037037,43.30357142857142,1026.7857142857138,38.02910052910051,0
140,4,1,1,29,0.03333333333333333,0.03333333333333333,0.9666666666666667,30,750,400,350,0.5333333333333333,11,4,7,408.55568594186536,0.419492337164751,0.11931516422082433,0.24421185738630297,132102.43107164087,4794.239868212446,136896.6709398533,139,0,72.96666666666667,28,2,19,32.49563242487771,0.6618303571428572,42.99568965517241,1028.0172413793102,36.714901477832505,0
141,4,1,2,28,0.03333333333333333,0.06666666666666667,0.9333333333333333,30,700,600,100,0.8571428571428571,8,6,2,408.95605566391856,0.4191091954022988,0.11160593792172757,0.24637108719265327,132398.00347222216,4828.993055555547,137226.9965277777,140,0,69.73333333333333,28,2,20,32.18623481781378,0.6648065476190477,42.70833333333333,1029.166666666666,36.75595238095236,0
142,4,0,0,28,0.0,0.0,1.0,28,950,800,150,0.8421052631578947,11,8,3,433.714945787295,0.4158123897707231,0.13475318044322404,0.25855933965958805,132001.24611816037,5850.182660798669,137851.42877895903,141,1,73.57142857142857,26,2,20,31.951744506182116,0.6678685897435898,43.09413580246914,1027.6234567901238,39.52397910731246,0
143,4,1,0,29,0.034482758620689655,0.0,1.0,29,600,400,200,0.6666666666666666,8,4,4,417.1515678014719,0.4204125615763547,0.11447717436828153,0.2513083835291795,132398.00347222228,5246.006944444451,137644.01041666672,142,0,72.0,27,2,21,31.975371120107965,0.6682098765432098,42.708333333333336,1029.166666666667,38.11728395061729,0
144,4,0,0,29,0.0,0.0,1.0,29,650,300,350,0.46153846153846156,10,3,7,419.03983369513054,0.41948891625615764,0.11851423616129475,0.2532171711211013,132512.89073572148,5305.635939271556,137818.52667499305,143,1,73.0,27,2,21,31.81050368550368,0.6693672839506173,42.5967261904762,1029.613095238096,38.133818342151706,0
145,4,0,0,29,0.0,0.0,1.0,29,700,300,400,0.42857142857142855,11,3,8,418.5249581313084,0.4186678981937602,0.11417868066833359,0.2536803642893974,132627.82782383793,5301.611217403635,137929.43904124157,144,2,74.0,27,2,18,31.70747857074063,0.6705246913580247,42.48511904761905,1030.0595238095243,38.150352733686084,0
146,4,0,0,29,0.0,0.0,1.0,29,550,300,250,0.5454545454545454,8,3,5,418.5577105028397,0.4183600164203613,0.1123129942827541,0.25421873574751436,132704.48022959195,5308.896683673482,138013.37691326544,145,3,75.0,27,2,18,31.629116117850952,0.6712962962962963,42.41071428571429,1030.3571428571438,38.16137566137569,0
147,4,0,0,29,0.0,0.0,1.0,29,600,400,200,0.6666666666666666,8,4,4,418.88287348981476,0.4180008210180624,0.11570272625420142,0.2546763739172052,132742.81473657172,5320.738334396259,138063.553070968,146,4,76.0,27,2,18,31.581979542719612,0.6716820987654322,42.373511904761905,1030.5059523809525,38.16688712522046,0
148,4,0,1,28,0.0,0.034482758620689655,0.9655172413793104,29,800,700,100,0.875,9,7,2,416.84445487468577,0.41774425287356326,0.10524010512064996,0.2542164069869564,132857.851473923,5276.2117346938885,138134.06320861686,147,5,77.0,27,2,18,31.518235180908377,0.6728395061728395,42.261904761904766,1030.9523809523816,38.183421516754876,0
149,4,0,0,28,0.0,0.0,1.0,28,900,500,400,0.5555555555555556,13,5,8,430.9375078904179,0.41228505291005296,0.1186998394863561,0.261263203012583,132636.34366426605,5831.5950788751625,138467.93874314122,148,8,80.57142857142857,26,2,18,31.379213483146067,0.6742788461538461,42.47685185185185,1030.0925925925922,39.61894586894585,0
150,4,0,1,27,0.0,0.03571428571428571,0.9642857142857143,28,1000,900,100,0.9,11,9,2,427.6705342158224,0.4115961199294533,0.116673084328071,0.2601078167115903,132755.5941358024,5755.131172839498,138510.7253086419,149,9,81.57142857142857,26,2,18,31.342654986522916,0.6754807692307692,42.36111111111111,1030.555555555555,39.636752136752115,0
151,4,0,0,27,0.0,0.0,1.0,27,600,400,200,0.6666666666666666,8,4,4,439.04255224401334,0.41043447293447294,0.10071677153195502,0.26624203073816194,132645.51487508215,6247.405078895456,138892.9199539776,150,10,80.33333333333333,25,2,19,31.16119580999792,0.6783333333333333,42.467948717948715,1030.1282051282049,41.2051282051282,0
152,4,0,0,27,0.0,0.0,1.0,27,600,400,200,0.6666666666666666,8,4,4,438.5825155074333,0.40948480531813863,0.1003888417397476,0.2664618249356807,132715.83802488176,6241.369217725938,138957.2072426077,151,11,81.33333333333333,26,1,19,31.101792222055806,0.6750801282051282,42.39969135802468,1030.4012345679005,39.630816714150015,0
153,4,0,0,27,0.0,0.0,1.0,27,600,300,300,0.5,9,3,6,440.78982753056766,0.4079415954415955,0.09871368374362399,0.26865657371388596,132835.12421886896,6310.474298887348,139145.59851775633,152,12,82.33333333333333,26,1,19,30.924089321357286,0.6762820512820513,42.28395061728394,1030.8641975308633,39.64862298195628,0
154,4,0,0,27,0.0,0.0,1.0,27,600,400,200,0.6666666666666666,8,4,4,441.60846725566086,0.4077635327635328,0.10005155582165015,0.26944165933653585,132874.89819101495,6335.736025377208,139210.63421639215,153,13,83.33333333333333,26,1,19,30.862707678491244,0.6766826923076923,42.24537037037036,1031.0185185185173,39.65455840455836,0
155,4,0,0,27,0.0,0.0,1.0,27,650,300,350,0.46153846153846156,10,3,7,440.5950147561192,0.40693257359924023,0.10033196446483927,0.26939583564639913,132954.46399653243,6315.814805288811,139270.27880182123,154,14,84.33333333333333,26,1,19,30.808269739139106,0.6774839743589743,42.1682098765432,1031.327160493826,39.666429249762544,0
156,4,0,1,26,0.0,0.037037037037037035,0.962962962962963,27,600,200,400,0.3333333333333333,10,2,8,438.5538124682183,0.40693257359924023,0.10150973711183142,0.2687197283547237,133034.05361701705,6268.518280368819,139302.57189738587,155,15,85.33333333333333,26,1,19,30.78035402642733,0.6782852564102564,42.09104938271604,1031.6358024691344,39.67830009496671,0
157,4,0,0,26,0.0,0.0,1.0,26,450,300,150,0.6666666666666666,6,3,3,452.78504863740983,0.4038141025641026,0.11588691159586673,0.2757872568973314,132810.65088757395,6826.935404339246,139637.5862919132,156,16,89.0,25,1,19,30.63976990049751,0.6799999999999999,42.30769230769231,1030.7692307692307,41.230769230769226,0
158,4,0,0,26,0.0,0.0,1.0,26,650,400,250,0.6153846153846154,9,4,5,456.1358009386142,0.4029807692307692,0.12021472465985972,0.2784419111232488,132893.2574169954,6923.474482248517,139816.7318992439,157,17,90.0,25,1,19,30.469640451766658,0.6808333333333334,42.2275641025641,1031.0897435897434,41.24358974358974,0
159,4,0,0,26,0.0,0.0,1.0,26,1000,800,200,0.8,12,8,4,453.17904625922915,0.4030128205128205,0.11269666814005985,0.2781715804445355,133099.886099811,6863.615887984881,139963.50198779587,158,18,91.0,25,1,19,30.336458818657142,0.6829166666666666,42.02724358974359,1031.8910256410259,41.275641025641036,0
160,4,0,0,26,0.0,0.0,1.0,26,1200,900,300,0.75,15,9,6,453.0808481924508,0.40294871794871795,0.11733127918502828,0.2787291063235508,133182.58251664205,6868.495490220254,140051.0780068623,159,19,92.0,25,1,19,30.25523340061067,0.6837500000000001,41.94711538461539,1032.2115384615388,41.288461538461554,0
161,4,0,0,26,0.0,0.0,1.0,26,900,500,400,0.5555555555555556,13,5,8,455.53614789697406,0.4022435897435897,0.11823804009121419,0.28086310056461267,133265.30461559,6941.4327025805305,140206.73731817052,160,20,93.0,25,1,19,30.108095348957526,0.6845833333333333,41.866987179487175,1032.5320512820506,41.30128205128202,0
162,4,0,0,26,0.0,0.0,1.0,26,400,300,100,0.75,5,3,2,455.983403158913,0.40134615384615385,0.11666169362057666,0.2817653915013608,133348.0523966551,6960.899747287963,140308.95214394308,161,21,94.0,25,1,19,30.012768295836576,0.6854166666666667,41.78685897435897,1032.8525641025635,41.31410256410254,0
163,4,0,0,26,0.0,0.0,1.0,26,500,400,100,0.8,6,4,2,455.983403158913,0.40134615384615385,0.11666169362057666,0.2817653915013608,133348.0523966551,6960.899747287963,140308.95214394308,162,22,95.0,25,1,19,30.012768295836576,0.6854166666666667,41.78685897435897,1032.8525641025635,41.31410256410254,0
164,4,0,0,26,0.0,0.0,1.0,26,450,200,250,0.4444444444444444,7,2,5,456.37804754612336,0.4006410256410256,0.11849876507856916,0.2826387389557981,133430.82585983735,6978.9799576758805,140409.80581751323,163,23,96.0,25,1,19,29.918792978646394,0.68625,41.706730769230774,1033.1730769230776,41.3269230769231,0
165,4,0,0,26,0.0,0.0,1.0,26,850,700,150,0.8235294117647058,10,7,3,456.37804754612336,0.4006410256410256,0.11849876507856916,0.2826387389557981,133430.82585983735,6978.9799576758805,140409.80581751323,164,24,97.0,25,1,19,29.918792978646394,0.68625,41.706730769230774,1033.1730769230776,41.3269230769231,0
166,4,0,0,26,0.0,0.0,1.0,26,500,300,200,0.6,7,3,4,453.79444731869404,0.39961538461538465,0.1132018082708115,0.28166702509704117,133513.6250051364,6917.548333744241,140431.17333888062,165,25,98.0,25,1,20,29.901761254974943,0.6870833333333333,41.62660256410256,1033.4935897435894,41.33974358974358,0
167,4,0,0,26,0.0,0.0,1.0,26,1050,900,150,0.8571428571428571,12,9,3,452.1366981421135,0.39961538461538465,0.10697804752989981,0.28126652263401863,133596.44983255255,6880.77154215976,140477.2213747123,166,26,99.0,25,1,20,29.860841988322225,0.6879166666666667,41.54647435897436,1033.8141025641023,41.352564102564095,0
168,4,0,0,26,0.0,0.0,1.0,26,650,400,250,0.6153846153846154,9,4,5,451.40308005946713,0.39961538461538465,0.10726674534205927,0.28144000730664165,133679.3003420858,6868.649582922419,140547.94992500823,167,27,100.0,25,1,21,29.79605738932796,0.68875,41.46634615384615,1034.1346153846152,41.36538461538461,0
169,4,0,1,25,0.0,0.038461538461538464,0.9615384615384616,26,700,500,200,0.7142857142857143,9,5,4,447.3736725864159,0.39955128205128204,0.10321754155991192,0.279554410120553,133762.17653373594,6768.3352338099785,140530.51176754592,168,28,101.0,25,1,18,29.816518202943445,0.6895833333333333,41.38621794871794,1034.4551282051275,41.3782051282051,0
170,4,0,0,25,0.0,0.0,1.0,25,700,500,200,0.7142857142857143,9,5,4,459.5424267908828,0.39805555555555555,0.10077704336611282,0.2859119030475272,133601.42013888896,7279.104166666676,140880.52430555565,169,29,102.28,24,1,21,29.664409694233967,0.6922743055555556,41.54166666666667,1033.833333333334,43.076388888888914,0
171,4,0,0,25,0.0,0.0,1.0,25,850,600,250,0.7058823529411765,11,6,5,460.12980691188085,0.3979861111111111,0.10219787302610372,0.2872802396071564,133730.68055555562,7306.694444444455,141037.3750000001,170,30,103.28,24,1,18,29.51847674293694,0.6935763888888888,41.41666666666667,1034.333333333334,43.09722222222225,0
172,4,0,0,25,0.0,0.0,1.0,25,350,300,50,0.8571428571428571,4,3,1,460.73090482951255,0.3976388888888889,0.10202674399871103,0.2879916139251545,133773.78125,7326.743055555557,141100.52430555556,171,31,104.28,24,1,18,29.459346973846728,0.6940104166666667,41.375,1034.5,43.104166666666664,0
173,4,0,0,25,0.0,0.0,1.0,25,750,500,250,0.6666666666666666,10,5,5,463.74737125979857,0.3963888888888889,0.09829307568438028,0.2908960783356918,133903.125,7419.444444444445,141322.56944444444,172,32,105.28,24,1,18,29.250536768652715,0.6953125,41.25,1035.0,43.125,0
174,4,0,0,25,0.0,0.0,1.0,25,1150,900,250,0.782608695652174,14,9,5,461.9602796886376,0.3952777777777778,0.10340521403282898,0.291138050505598,134075.68055555565,7387.527777777797,141463.20833333346,173,33,106.28,24,1,19,29.122411758395018,0.6970486111111112,41.08333333333334,1035.6666666666677,43.15277777777782,0
175,4,0,0,25,0.0,0.0,1.0,25,750,700,50,0.9333333333333333,8,7,1,463.5185349374774,0.39423611111111106,0.10658089417819228,0.29349880348688756,134248.34722222228,7445.319444444456,141693.66666666674,174,34,107.28,24,1,19,28.907673957328182,0.6987847222222222,40.91666666666667,1036.333333333334,43.18055555555558,0
176,4,0,0,25,0.0,0.0,1.0,25,850,600,250,0.7058823529411765,11,6,5,464.4625164605597,0.39256944444444447,0.11153190805336766,0.29514007302360995,134377.92013888885,7482.701388888883,141860.62152777772,175,35,108.28,24,1,19,28.75241118791192,0.7000868055555556,40.791666666666664,1036.833333333333,43.20138888888888,0
177,4,0,0,25,0.0,0.0,1.0,25,1000,600,400,0.6,14,6,8,462.27439656113893,0.3925,0.1091096110575378,0.2940972694686511,134421.1250000001,7427.888888888904,141849.013888889,176,36,109.28,24,1,19,28.765536269152467,0.7005208333333333,40.75000000000001,1037.0000000000007,43.208333333333364,0
178,4,0,0,25,0.0,0.0,1.0,25,400,100,300,0.25,7,1,6,462.6564938261072,0.39194444444444443,0.10861642294713136,0.29468898271032395,134464.3368055556,7442.159722222226,141906.4965277778,177,37,110.28,24,1,19,28.71203599550056,0.7009548611111112,40.708333333333336,1037.166666666667,43.21527777777779,0
179,4,0,0,25,0.0,0.0,1.0,25,200,0,200,0.0,4,0,4,462.6564938261072,0.39194444444444443,0.10861642294713136,0.29468898271032395,134464.3368055556,7442.159722222226,141906.4965277778,178,38,111.28,24,1,19,28.71203599550056,0.7009548611111112,40.708333333333336,1037.166666666667,43.21527777777779,0
180,4,0,0,25,0.0,0.0,1.0,25,500,300,200,0.6,7,3,4,445.8520189556236,0.3915972222222222,0.05244513618677016,0.26948252321635774,132521.7302812706,6817.016200279429,139338.74648155004,179,39,112.28,25,0,22,31.11138132295719,0.6770833333333333,42.58814102564103,1029.6474358974365,41.18589743589746,8
181,4,1,0,26,0.038461538461538464,0.0,1.0,26,800,700,100,0.875,9,7,2,432.1357935400721,0.39605769230769233,0.046164208490207415,0.2636620307434904,132874.89819101506,6283.999914266112,139158.89810528117,180,0,108.92307692307692,26,0,21,31.106870229007633,0.6766826923076923,42.24537037037037,1031.0185185185182,39.654558404558394,0
182,4,0,0,26,0.0,0.0,1.0,26,750,500,250,0.6666666666666666,10,5,5,431.5847915706417,0.39557692307692305,0.04785250655986717,0.26416783396137067,132994.25582990397,6279.659636488335,139273.9154663923,181,1,109.92307692307692,26,0,21,31.000336624775585,0.6778846153846154,42.129629629629626,1031.4814814814813,39.672364672364665,0
183,4,1,0,27,0.037037037037037035,0.0,1.0,27,550,300,250,0.5454545454545454,8,3,5,417.53381893860546,0.39868233618233617,0.054659498207885404,0.2588709677419354,133472.2222222222,5745.833333333331,139218.05555555553,182,0,106.81481481481481,27,0,22,30.88037634408601,0.6790123456790124,41.666666666666664,1033.3333333333333,38.2716049382716,0
184,4,1,0,28,0.03571428571428571,0.0,1.0,28,800,400,400,0.5,12,4,8,406.8173903164809,0.398451278659612,0.07169114004319987,0.2565832516877962,134103.95455558857,5311.164164684897,139415.11872027346,183,0,103.96428571428571,28,0,21,30.521743653766123,0.6819196428571428,41.05603448275862,1035.7758620689654,36.99199507389162,0
185,4,0,0,28,0.0,0.0,1.0,28,400,200,200,0.5,6,2,4,405.83870837429134,0.3982032627865961,0.06923915197146813,0.25622566439392663,134141.16172876215,5287.935163165558,139429.0968919277,184,1,104.96428571428571,28,0,21,30.50970873786408,0.6822916666666667,41.02011494252874,1035.9195402298858,36.997126436781635,0
186,4,0,0,28,0.0,0.0,1.0,28,400,400,0,1.0,4,4,0,405.83870837429134,0.3982032627865961,0.06923915197146813,0.25622566439392663,134141.16172876215,5287.935163165558,139429.0968919277,185,2,105.96428571428571,28,0,21,30.50970873786408,0.6822916666666667,41.02011494252874,1035.9195402298858,36.997126436781635,0
187,4,0,0,28,0.0,0.0,1.0,28,350,200,150,0.5714285714285714,5,2,3,407.08212940225036,0.3978174603174603,0.07266658743364207,0.2575330102850026,134215.59155766948,5327.353762055759,139542.94531972523,186,3,106.96428571428571,28,0,21,30.402743113329628,0.6830357142857143,40.94827586206897,1036.2068965517244,37.00738916256159,0
188,4,0,1,27,0.0,0.03571428571428571,0.9642857142857143,28,950,800,150,0.8421052631578947,11,8,3,405.95010491060384,0.3981205908289242,0.06588951588951564,0.2576015837229557,134327.27500743163,5306.034276324481,139633.3092837561,187,4,107.96428571428571,28,0,22,30.319935319935315,0.6841517857142857,40.84051724137931,1036.6379310344828,37.02278325123153,0
189,4,0,0,27,0.0,0.0,1.0,27,1150,900,250,0.782608695652174,14,9,5,418.8439701875339,0.3937559354226021,0.06760695215606205,0.26516630985327144,134242.1786422903,5845.305413832206,140087.4840561225,188,5,112.70370370370371,27,0,23,30.07131916523072,0.6867283950617284,40.92261904761905,1036.309523809524,38.38183421516756,0
190,4,0,0,27,0.0,0.0,1.0,27,600,300,300,0.5,9,3,6,417.4965497514634,0.39256885090218424,0.06965174129353224,0.2654302881996531,134396.43565759642,5822.009637188212,140218.44529478464,189,6,113.70370370370371,27,0,24,29.951205510907002,0.6882716049382716,40.773809523809526,1036.9047619047622,38.40388007054675,0
191,4,0,0,27,0.0,0.0,1.0,27,950,900,50,0.9473684210526315,10,9,1,439.6738612223607,0.39144112060778724,0.05665880934698131,0.2559928521939329,131099.43000637757,6128.1985189909265,137227.6285253685,190,7,114.70370370370371,27,0,21,32.71638574057929,0.6550925925925926,43.973214285714285,1024.107142857143,37.929894179894184,8
192,4,1,0,28,0.03571428571428571,0.0,1.0,28,1150,1000,150,0.8695652173913043,13,10,3,426.81852147697725,0.3961364638447972,0.05775924583031178,0.25174625368552217,131595.18771701373,5633.651989441585,137228.83970645533,191,0,111.57142857142857,27,1,18,32.541243654822345,0.660108024691358,43.48958333333332,1026.0416666666654,38.001543209876495,0
193,4,0,0,28,0.0,0.0,1.0,28,450,300,150,0.6666666666666666,6,3,3,428.81986374627064,0.3946759259259259,0.06292714244294384,0.2536877718800832,131709.72620819145,5695.949369331035,137405.6755775225,192,1,112.57142857142857,27,1,18,32.373514062046965,0.6612654320987654,43.377976190476176,1026.4880952380938,38.01807760141088,0
194,4,0,0,28,0.0,0.0,1.0,28,750,600,150,0.8,9,6,3,425.8097038437306,0.3949514991181658,0.05815734989648047,0.2524129687733453,131786.11288265296,5623.16113945577,137409.27402210873,193,2,113.57142857142857,27,1,18,32.373188405797116,0.662037037037037,43.30357142857142,1026.7857142857135,38.0291005291005,0
195,4,0,0,28,0.0,0.0,1.0,28,550,200,350,0.36363636363636365,9,2,7,427.0332319820284,0.3943452380952381,0.06034482758620663,0.2536474498399275,131862.5217013888,5661.935763888866,137524.45746527766,194,3,114.57142857142857,27,1,18,32.26419878296145,0.6628086419753086,43.22916666666666,1027.0833333333323,38.040123456790084,0
196,4,0,0,28,0.0,0.0,1.0,28,800,500,300,0.625,11,5,6,426.2328319250667,0.39445546737213405,0.06195166363184912,0.25368202341471213,131938.95266439908,5647.342687074831,137586.2953514739,195,4,115.57142857142857,27,1,19,32.20717458478177,0.6635802469135803,43.154761904761905,1027.3809523809523,38.051146384479715,0
197,4,0,1,27,0.0,0.03571428571428571,0.9642857142857143,28,1000,700,300,0.7,13,7,6,425.0558721230165,0.39451058201058203,0.060371933308509984,0.253491869851602,132015.40577168364,5622.784686791373,137638.190458475,196,5,116.57142857142857,27,1,19,32.159836856839455,0.6643518518518519,43.08035714285714,1027.678571428571,38.0621693121693,0
198,4,0,0,27,0.0,0.0,1.0,27,450,200,250,0.4444444444444444,7,2,5,422.72734381852024,0.3933998100664768,0.05161926504713388,0.2533797634978137,132206.63542109547,5777.47196534863,137984.1073864441,197,6,116.25925925925925,27,0,19,32.02578618627309,0.6662808641975309,42.894345238095234,1028.4226190476186,38.08972663139328,0
199,4,0,0,27,0.0,0.0,1.0,27,800,500,300,0.625,11,5,6,423.9298704598605,0.39256885090218424,0.05908786588468429,0.2551327288276703,132359.7187898595,5822.247688137728,138181.96647799722,198,7,117.25925925925925,27,0,19,31.83975054229934,0.6678240740740741,42.7455357142857,1029.0178571428557,38.11177248677244,0
200,4,0,0,27,0.0,0.0,1.0,27,700,500,200,0.7142857142857143,9,5,4,435.96835197448706,0.3926282051282051,0.054918113170540295,0.23410054160525806,127918.62643494915,5753.694550736986,133672.32098568615,199,8,118.25925925925925,27,0,18,36.072496812788074,0.6226851851851851,47.0982142857143,1011.6071428571444,37.46693121693127,8
201,4,3,1,29,0.1,0.03333333333333333,0.9666666666666667,30,1000,700,300,0.7,13,7,6,399.82183875776724,0.4101532567049808,0.029273673991704552,0.21981471397206487,128859.99284599363,4304.207856399572,133164.2007023932,200,0,107.33333333333333,30,0,20,36.020651310563956,0.6229166666666667,46.16935483870967,1015.3225806451603,33.84408602150534,0
202,4,2,0,31,0.06451612903225806,0.0,1.0,31,700,300,400,0.42857142857142855,11,3,8,390.4629447045541,0.4128584229390681,0.03674947799036943,0.2176586517977522,129406.44330269398,3906.135824950863,133312.57912764483,201,0,104.80645161290323,30,1,23,35.699581682078374,0.6284722222222222,45.63172043010753,1017.47311827957,33.915770609319004,0
203,4,0,4,27,0.0,0.12903225806451613,0.8709677419354839,31,850,600,250,0.7058823529411765,11,6,5,384.61183351627596,0.412410394265233,0.005301787696538662,0.20975889071601914,128540.34423828113,3687.6274956597053,132227.97173394085,202,1,105.80645161290323,31,0,17,36.73386406437254,0.6169354838709677,46.48437499999999,1014.0624999999991,32.71169354838707,8
204,4,0,0,27,0.0,0.0,1.0,27,550,500,50,0.9090909090909091,6,5,1,430.2827788152853,0.3961894586894587,0.036333245359373656,0.2182518673267894,125595.94671201815,5408.3545918367345,131004.30130385488,194,2,114.81481481481481,27,0,19,38.62208036421218,0.5987654320987654,49.404761904761905,1002.3809523809524,37.12522045855379,8
205,4,3,1,29,0.1,0.03333333333333333,0.9666666666666667,30,1000,800,200,0.8,12,8,4,392.5423898017325,0.4099377394636015,0.023876942255464995,0.20395314867769404,126584.28945904152,3937.939899121288,130522.22935816282,195,0,104.23333333333333,30,0,20,38.54514491785761,0.5996527777777778,48.420698924731184,1006.3172043010754,33.54390681003585,0
206,4,0,0,29,0.0,0.0,1.0,29,600,300,300,0.5,9,3,6,407.72980384612003,0.4061986863711002,0.03341647784611301,0.21157555150868854,126532.44598765428,4518.209876543209,131050.6558641975,196,1,108.82758620689656,29,0,20,38.216685072703854,0.6020114942528736,48.47222222222222,1006.1111111111109,34.693486590038304,0
207,4,4,2,31,0.12121212121212122,0.06060606060606061,0.9393939393939394,33,850,600,250,0.7058823529411765,11,6,5,364.8029391191525,0.42250631313131315,0.030714317190323026,0.19547752296176912,127834.51677239512,2726.8814878892576,130561.39826028438,197,0,96.51515151515152,33,0,18,37.95847471320084,0.6047979797979798,47.1813725490196,1011.2745098039206,30.64468211527032,0
208,4,1,0,32,0.03125,0.0,1.0,32,950,600,350,0.631578947368421,13,6,7,370.69674143275955,0.4162046370967742,0.03991104868913853,0.19874704811756386,127857.05061983468,3079.2384067952207,130936.28902662991,198,0,100.5,32,0,19,37.786360799001244,0.607421875,47.15909090909091,1011.3636363636361,31.60511363636363,0
209,4,1,1,32,0.030303030303030304,0.030303030303030304,0.9696969696969697,33,850,600,250,0.7058823529411765,11,6,5,360.21859857333743,0.41844223484848486,0.05358373282901585,0.19542568064333024,128330.72015570932,2645.422433679348,130976.14258938866,199,0,98.42424242424242,33,0,21,37.56652152878568,0.6098484848484849,46.69117647058823,1013.2352941176468,30.704099821746873,0
210,4,1,1,32,0.030303030303030304,0.030303030303030304,0.9696969696969697,33,700,200,500,0.2857142857142857,12,2,10,360.69572634863385,0.41714015151515155,0.06227653713146908,0.19629441107604584,128454.92118415989,2666.6282199154066,131121.54940407528,200,0,99.27272727272727,33,0,18,37.427466150870394,0.6111111111111112,46.56862745098039,1013.725490196078,30.718954248366,0
211,4,0,0,32,0.0,0.0,1.0,32,1250,900,350,0.72,16,9,7,369.5278408976652,0.4156586021505377,0.07013733183856474,0.200987093951657,128432.33471074387,3091.864669421494,131524.19938016537,201,2,103.375,32,0,18,37.22673766816143,0.61328125,46.59090909090909,1013.6363636363642,31.67613636363638,0
212,4,0,0,32,0.0,0.0,1.0,32,600,300,300,0.5,9,3,6,369.04380172131374,0.41593161962365593,0.0705139182961767,0.20088492773019842,128464.33280086209,3081.793152484438,131546.12595334652,202,3,104.375,32,0,18,37.20627309336989,0.6136067708333333,46.55934343434343,1013.7626262626256,31.68008207070705,0
213,4,1,1,32,0.030303030303030304,0.030303030303030304,0.9696969696969697,33,1150,800,350,0.6956521739130435,15,8,7,362.96453042613996,0.4210069444444444,0.0721274300031094,0.19954619340282462,128858.98940611773,2754.248516195684,131613.23792231342,203,0,102.18181818181819,33,0,21,36.95722691611346,0.6152146464646464,46.170343137254896,1015.3186274509795,30.767231134878166,0
214,4,0,1,31,0.0,0.03125,0.96875,32,1250,1000,250,0.8,15,10,5,354.40646380192135,0.4191028225806452,-0.026416003481720907,0.19494779629925116,128880.67065860632,2735.2285481073436,131615.89920671366,204,1,105.71875,32,0,17,37.152346016745426,0.6178385416666667,46.1489898989899,1015.4040404040409,31.731376262626277,8
215,4,1,1,31,0.03125,0.03125,0.96875,32,650,300,350,0.46153846153846156,10,3,7,355.6931726171683,0.41513356854838707,-0.022154010927604384,0.19740848511964532,129233.48263251194,2793.493489184773,132026.9761216967,205,0,106.65625,32,0,18,36.76011010389502,0.6214192708333333,45.801767676767675,1016.7929292929289,31.774779040404027,0
216,4,0,1,30,0.0,0.03225806451612903,0.967741935483871,31,850,500,350,0.5882352941176471,12,5,7,371.8800175550403,0.412410394265233,0.03135363280072356,0.18948172323042503,125782.47070312477,3155.197482638861,128937.66818576363,206,1,110.83870967741936,31,0,19,39.8926964347525,0.5887096774193548,49.218749999999986,1003.1249999999982,32.35887096774188,8
217,4,3,0,33,0.09090909090909091,0.0,1.0,33,600,500,100,0.8333333333333334,7,5,2,354.6245215162311,0.4174558080808081,0.05872388481084134,0.18417596117455856,126567.38281249988,2376.7795138888746,128944.16232638876,207,0,105.0,33,0,17,39.51647688060732,0.5918560606060606,48.43749999999999,1006.2499999999991,30.492424242424214,0
218,4,2,0,35,0.05714285714285714,0.0,1.0,35,900,600,300,0.6666666666666666,12,6,6,341.2965496881937,0.4283963585434174,0.07952932693095627,0.18019879004433573,127237.93730977783,1685.1737986539633,128923.1111084318,208,0,99.94285714285714,35,0,19,39.163535811250036,0.5943452380952381,47.77199074074073,1008.912037037036,28.826058201058174,0
219,4,1,2,34,0.027777777777777776,0.05555555555555555,0.9444444444444444,36,1150,800,350,0.6956521739130435,15,8,7,336.824808602476,0.4310846560846561,-0.04836918586204719,0.18282090510320373,128349.69142500426,1449.4904192386805,129799.18184424294,209,0,98.13888888888889,35,1,20,38.13975347420523,0.6056547619047619,46.6724537037037,1013.310185185185,28.951719576719572,8
220,4,0,3,31,0.0,0.08823529411764706,0.9117647058823529,34,1250,700,550,0.56,18,7,11,352.9859004981554,0.42528223410576355,-0.03268358142880867,0.19046904174088264,128114.39909297042,2244.515306122435,130358.91439909286,210,1,104.79411764705883,34,0,20,37.97085685167763,0.6053921568627452,46.9047619047619,1012.3809523809515,29.77591036414563,0
221,4,2,1,32,0.06060606060606061,0.030303030303030304,0.9696969696969697,33,850,500,350,0.5882352941176471,12,5,7,353.26229287400525,0.4119318181818182,0.008967821346931748,0.19224905833248507,128454.92118415996,2475.6559976931985,130930.57718185316,211,0,108.39393939393939,33,0,17,37.61585267569309,0.6111111111111112,46.568627450980394,1013.7254901960786,30.718954248366018,0
222,4,0,0,32,0.0,0.0,1.0,32,750,500,250,0.6666666666666666,10,5,5,362.4630972137303,0.4098412298387097,0.01786214953271026,0.1966711531534948,128336.36435376508,2903.439221763103,131239.80357552817,212,1,112.78125,32,0,21,37.503894080996886,0.6123046875,46.68560606060607,1013.257575757577,31.66429924242428,0
223,4,1,0,33,0.030303030303030304,0.0,1.0,33,900,400,500,0.4444444444444444,14,4,10,351.7141590235478,0.4142203282828283,0.016922851705460262,0.19260537279860945,128703.50346020758,2453.368896578233,131156.8723567858,213,0,110.33333333333333,33,0,19,37.40136876006439,0.6136363636363636,46.3235294117647,1014.7058823529409,30.74866310160427,0
224,4,2,0,35,0.05714285714285714,0.0,1.0,35,1100,800,300,0.7272727272727273,14,8,6,339.65708682324424,0.4207983193277311,0.03932124049151553,0.18907946624785804,129352.72285997724,1788.0749726361,131140.79783261335,214,0,104.97142857142858,34,1,21,37.04651843183147,0.617953431372549,45.6845238095238,1017.261904761904,29.919467787114826,0
225,4,1,0,36,0.027777777777777776,0.0,1.0,36,1300,1000,300,0.7692307692307693,16,10,6,332.9802797084717,0.42232142857142857,0.0344414155181989,0.18743979428090687,129790.4074502743,1443.5292352537654,131233.93668552808,215,0,103.02777777777777,35,1,18,36.7721111615932,0.6202380952380953,45.254629629629626,1018.9814814814811,29.113756613756603,0
226,4,1,1,36,0.02702702702702703,0.02702702702702703,0.972972972972973,37,900,400,500,0.4444444444444444,14,4,10,326.53960804787073,0.42279779779779775,0.04195320168385619,0.18522995048877036,130090.20580969495,1095.9209631929339,131186.1267728879,216,0,101.21621621621621,36,1,19,36.63253854362144,0.6212384259259259,44.96058558558559,1020.1576576576585,28.337712712712737,0
227,4,0,1,35,0.0,0.027777777777777776,0.9722222222222222,36,1100,800,300,0.7272727272727273,14,8,6,337.0410388735815,0.41909722222222223,0.04986635904030656,0.1910188215815352,130055.90284475726,1566.8353212877064,131622.73816604496,217,1,104.94444444444444,35,1,19,36.399471424789134,0.6229166666666667,44.994212962962955,1020.0231481481472,29.143518518518494,0
228,4,0,0,35,0.0,0.0,1.0,35,1150,800,350,0.6956521739130435,15,8,7,346.4706194711952,0.41656162464985996,0.05857642940490049,0.1966392853555063,130110.7213718821,2015.9084467120163,132126.6298185941,218,2,108.4,34,1,19,36.1034130688448,0.6256127450980392,44.94047619047619,1020.2380952380954,30.007002801120453,0
229,4,1,0,36,0.027777777777777776,0.0,1.0,36,1250,900,350,0.72,16,9,7,338.19706994328897,0.419510582010582,0.07057669082125573,0.19446331521739124,130617.2839506173,1634.876543209873,132252.16049382716,219,0,106.36111111111111,35,1,18,35.80163043478259,0.6285714285714286,44.44444444444444,1022.2222222222224,29.206349206349213,0
230,4,0,0,36,0.0,0.0,1.0,36,900,600,300,0.6666666666666666,12,6,6,362.6353885906629,0.41937830687830685,0.060601595347558046,0.19262592369534065,127482.44224773224,2057.9853237591055,129540.42757149134,220,1,107.36111111111111,34,2,13,38.3742976148375,0.5989583333333333,47.52976190476189,1009.8809523809508,29.702380952380906,8
231,4,2,1,37,0.05263157894736842,0.02631578947368421,0.9736842105263158,38,1250,1100,150,0.88,14,11,3,349.63049184503365,0.42540896159317215,0.07418663481132759,0.18839801323160427,128059.03031409773,1354.6683507832004,129413.69866488094,221,0,102.65789473684211,36,2,17,38.11239059486723,0.6006944444444444,46.95945945945945,1012.1621621621609,28.11561561561558,0
232,4,1,2,36,0.02631578947368421,0.05263157894736842,0.9473684210526316,38,1300,1000,300,0.7692307692307693,16,10,6,350.4425463735575,0.422445471787577,0.08449369310336774,0.18991452693834482,128287.09621783945,1391.45133308985,129678.5475509293,222,0,103.44736842105263,36,2,19,37.85872424781385,0.6030092592592593,46.734234234234236,1013.063063063063,28.14064064064064,0
233,4,1,1,36,0.02702702702702703,0.02702702702702703,0.972972972972973,37,1350,1200,150,0.8888888888888888,15,12,3,355.19450242445316,0.4194507007007007,0.08591340111961587,0.19250882227376076,128291.057487247,1713.6556659379169,130004.71315318492,223,0,106.67567567567568,35,2,21,37.73432442210291,0.6050595238095238,46.73032407407407,1013.078703703703,28.945105820105802,0
234,4,2,3,35,0.05263157894736842,0.07894736842105263,0.9210526315789473,38,800,600,200,0.75,10,6,4,348.5740470515324,0.4233345187292556,0.08924942182353379,0.19107964185087625,128743.83674214747,1375.3520412304158,130119.18878337789,224,0,99.44736842105263,36,2,16,37.439894954874994,0.6076388888888888,46.28378378378378,1014.8648648648642,28.190690690690673,0
235,4,0,2,33,0.0,0.05714285714285714,0.9428571428571428,35,1000,500,500,0.5,15,5,10,359.704827383482,0.4184873949579832,0.06594438667695335,0.1961565761621318,128536.57171201806,2247.045068027201,130783.61678004527,225,1,103.8,34,1,17,37.36914964389137,0.6096813725490196,46.488095238095234,1014.0476190476185,29.82492997198878,0
236,4,0,0,33,0.0,0.0,1.0,33,800,500,300,0.625,11,5,6,369.4032112694144,0.41283933080808083,0.07048851869352357,0.20118978056825965,128485.98082768645,2892.6267841695517,131378.60761185602,226,2,109.42424242424242,33,0,18,37.17502216044159,0.6114267676767677,46.53799019607843,1013.8480392156861,30.72266785502079,0
237,4,0,0,33,0.0,0.0,1.0,33,700,500,200,0.7142857142857143,9,5,4,372.70360102579025,0.41264204545454547,0.0791679022922227,0.20362163073864478,128610.25694744819,2986.70117863323,131596.95812608142,227,3,110.42424242424242,33,0,18,36.964253352664,0.6126893939393939,46.415441176470594,1014.3382352941185,30.737522281639954,0
238,4,1,0,34,0.029411764705882353,0.0,1.0,34,1300,900,400,0.6923076923076923,17,9,8,362.2427674224068,0.4163138740344623,0.08000234439104426,0.19950245635123007,128929.21095521552,2540.7348356009174,131469.94579081645,228,0,108.1470588235294,34,0,19,36.90388973547454,0.6136642156862745,46.10119047619048,1015.5952380952389,29.870448179271733,0
239,4,1,0,35,0.02857142857142857,0.0,1.0,35,500,200,300,0.4,8,2,6,354.2286500797362,0.4197829131652661,0.08242621351329382,0.19658235571386504,129230.80800165045,2155.4509334276486,131386.2589350781,229,0,106.02857142857142,35,0,20,36.80006165812938,0.6145833333333333,45.80439814814815,1016.7824074074081,29.050925925925945,0
240,4,0,0,35,0.0,0.0,1.0,35,750,400,350,0.5333333333333333,11,4,7,356.2114876119698,0.419327731092437,0.076060458313018,0.19842198834659155,129377.95380015431,2217.182677469134,131595.13647762345,230,1,107.02857142857142,35,0,22,36.59982935153583,0.6160714285714286,45.65972222222222,1017.3611111111111,29.067460317460316,0
241,4,0,0,35,0.0,0.0,1.0,35,1350,1100,250,0.8148148148148148,16,11,5,355.87923599779026,0.4185574229691877,0.08117222781766786,0.19883113096344135,129495.73072059326,2216.96834276406,131712.69906335732,231,2,108.02857142857142,35,0,16,36.4884201349405,0.6172619047619048,45.54398148148148,1017.8240740740739,29.080687830687825,0
242,4,0,0,35,0.0,0.0,1.0,35,1200,800,400,0.6666666666666666,16,8,8,357.707046910039,0.4185574229691877,0.08020916221439123,0.2003022846382951,129584.09857521014,2270.62904556757,131854.7276207777,232,3,109.02857142857142,35,0,17,36.35199973475806,0.6181547619047619,45.45717592592593,1018.171296296297,29.090608465608486,0
243,4,0,0,35,0.0,0.0,1.0,35,700,400,300,0.5714285714285714,10,4,6,357.44084044121104,0.4187324929971989,0.08344506306101596,0.2007553820499745,129701.96926708259,2272.156180341233,131974.1254474238,233,4,110.02857142857142,35,0,18,36.238898041889186,0.6193452380952381,45.34143518518519,1018.6342592592601,29.103835978836003,0
244,4,0,1,34,0.0,0.02857142857142857,0.9714285714285714,35,550,300,250,0.5454545454545454,8,3,5,357.7686610544452,0.4184173669467787,0.0848378615249783,0.2010906612133607,129731.44531250012,2282.7690972222385,132014.21440972236,234,5,111.02857142857142,35,0,18,36.2005794137696,0.6196428571428572,45.31250000000001,1018.7500000000009,29.107142857142883,0
245,4,0,0,34,0.0,0.0,1.0,34,1000,600,400,0.6,14,6,8,366.3682832308383,0.4155525846702317,0.08710777438605222,0.2056855007429821,129685.9693877549,2702.5651927437443,132388.53458049864,235,6,115.11764705882354,34,0,18,36.02783621630046,0.6213235294117647,45.35714285714285,1018.5714285714268,29.95798319327726,0
246,4,0,0,34,0.0,0.0,1.0,34,950,600,350,0.631578947368421,13,6,7,366.7947140403862,0.4160167855020796,0.09224895706617708,0.2064034160073415,129776.92920918357,2720.2983276643777,132497.22753684793,236,7,116.11764705882354,34,0,18,35.92441679323906,0.6222426470588236,45.26785714285713,1018.9285714285705,29.968487394957958,0
247,4,0,1,33,0.0,0.029411764705882353,0.9705882352941176,34,950,500,450,0.5263157894736842,14,5,9,365.91521592481035,0.41597964943553184,0.09126545139723974,0.2062277922009412,129837.58680555534,2701.909722222201,132539.49652777755,237,8,117.11764705882354,34,0,18,35.885118560915764,0.6228553921568627,45.20833333333332,1019.1666666666649,29.97549019607838,0
248,4,0,0,33,0.0,0.0,1.0,33,800,500,300,0.625,11,5,6,375.7050485965366,0.4105508207070707,0.09991869118328034,0.21083623625157405,129669.02941476816,3143.4617995482254,132812.49121431637,238,9,121.27272727272727,33,0,18,35.80733866762924,0.6234217171717171,45.37377450980391,1018.5049019607827,30.863784907902506,0
249,4,0,0,33,0.0,0.0,1.0,33,1000,400,600,0.4,16,4,12,376.7548646919345,0.410748106060606,0.09964677449340043,0.21176221705098358,129731.44531249977,3175.3906249999714,132906.83593749974,239,10,122.27272727272727,33,0,18,35.71702453987729,0.6240530303030303,45.312499999999986,1018.7499999999982,30.871212121212068,0
250,4,0,0,33,0.0,0.0,1.0,33,700,500,200,0.7142857142857143,9,5,4,374.9228399928735,0.41027462121212116,0.09963478907428946,0.2109004392219719,129762.65889321385,3130.1969194540266,132892.85581266787,240,11,123.27272727272727,33,0,18,35.73189800336784,0.6243686868686869,45.281862745098024,1018.8725490196055,30.87492572786683,0
251,4,0,0,33,0.0,0.0,1.0,33,850,600,250,0.7058823529411765,11,6,5,378.39566536343744,0.4099589646464647,0.10727935845165715,0.21336384737814917,129856.3221627495,3227.413885284459,133083.73604803396,241,12,124.27272727272727,33,0,18,35.54804917638572,0.6253156565656566,45.18995098039213,1019.240196078428,30.88606654783115,0
252,4,1,0,34,0.029411764705882353,0.0,1.0,34,1200,900,300,0.75,15,9,6,367.83211308417935,0.41274881164587046,0.10890895492689179,0.20925180527343476,130201.83000283416,2778.48285147389,132980.31285430805,242,0,121.58823529411765,34,0,19,35.46599790038494,0.626531862745098,44.85119047619046,1020.5952380952356,30.017507002801047,0
253,4,1,0,35,0.02857142857142857,0.0,1.0,35,1050,800,250,0.7619047619047619,13,8,5,358.67005747035716,0.41810224089635856,0.10939403014874771,0.2061272498956146,130597.00255102018,2368.2610544217428,132965.26360544193,243,0,119.08571428571429,34,1,18,35.29898478142712,0.6305147058823529,44.4642857142857,1022.1428571428553,30.06302521008398,0
254,4,0,0,35,0.0,0.0,1.0,35,1250,1000,250,0.8,15,10,5,358.6009138736064,0.4177170868347339,0.1045046243928407,0.20641183970150984,130657.8514739227,2370.8049886621047,133028.6564625848,244,1,120.08571428571429,34,1,18,35.23909330849247,0.6311274509803921,44.40476190476189,1022.3809523809507,30.070028011204432,0
255,4,0,0,35,0.0,0.0,1.0,35,1250,800,450,0.64,17,8,9,358.58932644709677,0.4164915966386555,0.10613954880218213,0.2072197768769264,130810.03578514708,2381.4165249432795,133191.45231009036,245,2,121.08571428571429,34,1,18,35.08524380309556,0.6326593137254901,44.255952380952365,1022.9761904761879,30.087535014005525,0
256,4,0,1,34,0.0,0.02857142857142857,0.9714285714285714,35,850,400,450,0.47058823529411764,13,4,9,359.71033120234114,0.41628151260504204,0.10730491149339372,0.20819597957468805,130870.93431122432,2415.1254251700507,133286.05973639438,246,3,122.08571428571429,34,1,19,34.99490983129728,0.6332720588235294,44.19642857142856,1023.2142857142843,30.09453781512601,0
257,4,0,0,34,0.0,0.0,1.0,34,1000,700,300,0.7,13,7,6,364.7321854480449,0.4164438502673797,0.09386605966215456,0.21068647418234102,130794.81336805543,2741.015624999991,133535.82899305542,247,4,119.61764705882354,33,1,19,34.94356754921928,0.6347853535353536,44.27083333333333,1022.9166666666656,30.997474747474715,0
258,4,0,0,34,0.0,0.0,1.0,34,1300,900,400,0.6923076923076923,17,9,8,364.4675008440862,0.4151997920380273,0.09661652017128675,0.21139115048956994,130951.55709342562,2745.5173490965008,133697.07444252213,248,5,120.61764705882354,33,1,19,34.791566890166024,0.6363636363636364,44.11764705882353,1023.5294117647061,31.01604278074867,0
259,4,0,0,34,0.0,0.0,1.0,34,500,300,200,0.6,7,3,4,364.68905928236904,0.4153112002376708,0.10068442028475255,0.21186456197808842,131014.28086553248,2755.8949682814273,133770.1758338139,249,6,121.61764705882354,33,1,20,34.72238847657809,0.6369949494949495,44.056372549019606,1023.7745098039215,31.023469994058228,0
260,4,0,0,34,0.0,0.0,1.0,34,1000,700,300,0.7,13,7,6,366.4350632998327,0.4156454248366013,0.10330706445257531,0.21392438052979068,131202.54229142642,2815.4423779315694,134017.984669358,250,7,122.61764705882354,33,1,20,34.48714114832536,0.6388888888888888,43.872549019607845,1024.509803921569,31.045751633986942,0
261,4,0,0,34,0.0,0.0,1.0,34,600,200,400,0.3333333333333333,10,2,8,364.51101871365887,0.41516265597147956,0.1004333328643583,0.21314972996388912,131265.32613658204,2769.5315503652328,134034.85768694727,251,8,123.61764705882354,33,1,20,34.472913178665394,0.639520202020202,43.811274509803916,1024.7549019607839,31.05317884729648,0
262,4,0,1,33,0.0,0.029411764705882353,0.9705882352941176,34,700,400,300,0.5714285714285714,10,4,6,360.5208951942558,0.4148098633392751,-0.028625203663127152,0.21325727529287336,131705.23356401385,2855.826485005767,134561.0600490196,252,9,124.61764705882354,33,1,17,34.13075055714741,0.6439393939393939,43.38235294117647,1026.4705882352941,31.10516934046346,8
263,4,0,0,33,0.0,0.0,1.0,33,750,500,250,0.6666666666666666,10,5,5,359.4618711088728,0.41015625,-0.003442950811371581,0.21315860000150336,131799.59518274205,2875.385819156078,134674.98100189812,253,10,128.6969696969697,33,0,17,34.06271134184669,0.6448863636363636,43.29044117647058,1026.8382352941164,31.11631016042777,0
264,4,0,0,33,0.0,0.0,1.0,33,850,600,250,0.7058823529411765,11,6,5,361.75087164028594,0.4106691919191919,-0.004178731126124546,0.2152276477615695,131925.46323829758,2944.8302636005164,134870.2935018981,254,11,129.6969696969697,33,0,18,33.87696826911607,0.6461489898989898,43.167892156862735,1027.3284313725476,31.131164587046896,0
265,4,0,0,33,0.0,0.0,1.0,33,700,300,400,0.42857142857142855,11,3,8,384.11034578402376,0.4103140782828283,-0.009411421911422302,0.21710584761705667,129950.01922337548,3383.0293637062464,133333.04858708172,255,12,130.6969696969697,33,0,17,35.30699118589743,0.6262626262626263,45.09803921568626,1019.6078431372538,30.89720736779557,8
266,4,0,0,33,0.0,0.0,1.0,33,900,600,300,0.6666666666666666,12,6,6,385.1244677075331,0.4103535353535353,-0.009901999330158562,0.21837711643034732,130075.00120146063,3419.0131199538237,133494.01432141446,256,13,131.6969696969697,33,0,17,35.15387233701746,0.6275252525252526,44.97549019607841,1020.0980392156835,30.91206179441465,0
267,4,0,0,33,0.0,0.0,1.0,33,1200,600,600,0.5,18,6,12,388.9949295424956,0.4098011363636364,0.0009896055039526619,0.22145856241691322,130231.31315179233,3531.864096741606,133763.17724853393,257,14,132.6969696969697,33,0,18,34.89602093088405,0.6291035353535354,44.82230392156861,1020.7107843137235,30.93062982768859,0
268,4,1,0,34,0.029411764705882353,0.0,1.0,34,550,400,150,0.7272727272727273,7,4,3,381.2381664597367,0.4116161616161616,0.009726364476031257,0.21950793807961227,130669.4859699393,3163.24280324873,133832.72877318802,258,0,129.76470588235293,33,1,16,34.64868252826721,0.6335227272727273,44.39338235294117,1022.4264705882341,30.982620320855577,0
269,4,0,0,34,0.0,0.0,1.0,34,1000,700,300,0.7,13,7,6,383.628473044876,0.4109477124183007,0.01050143377509083,0.22196217057877132,130857.49959450695,3240.1325511822392,134097.6321456892,259,1,130.76470588235293,33,1,16,34.396709186728955,0.6354166666666667,44.20955882352941,1023.1617647058827,31.004901960784323,0
270,4,0,0,34,0.0,0.0,1.0,34,900,500,400,0.5555555555555556,13,5,8,384.46505562089527,0.4106134878193702,0.008144308842895409,0.22317141136909946,130982.9171021964,3271.6709018166225,134254.58800401303,260,2,131.76470588235293,33,1,16,34.248049602937066,0.6366792929292929,44.087009803921575,1023.6519607843147,31.019756387403476,0
271,4,0,0,34,0.0,0.0,1.0,34,850,500,350,0.5882352941176471,12,5,7,366.36006611498453,0.4100564468211527,-0.044335691442968894,0.19679695586884605,127933.68055555581,2573.958333333367,130507.63888888918,261,3,132.76470588235293,34,0,18,37.817476661175206,0.6035539215686274,47.08333333333335,1011.6666666666687,29.754901960784373,8
272,4,0,0,34,0.0,0.0,1.0,34,800,200,600,0.25,14,2,12,367.7750887266312,0.4098521984551396,-0.04297791091033587,0.19830003674334512,128084.27047902522,2621.24078798189,130705.51126700711,262,4,133.76470588235293,34,0,18,37.627406013563835,0.6050857843137255,46.934523809523824,1012.261904761907,29.772408963585498,0
273,4,1,1,34,0.02857142857142857,0.02857142857142857,0.9714285714285714,35,700,500,200,0.7142857142857143,9,5,4,357.1144301648951,0.41474089635854344,-0.04699355470343458,0.19383365381857812,128349.69142500464,2167.1053830161595,130516.7968080208,263,0,130.9142857142857,35,0,19,37.62576146963639,0.6056547619047619,46.672453703703724,1013.3101851851881,28.951719576719658,0
274,4,0,0,34,0.0,0.0,1.0,34,900,800,100,0.8888888888888888,10,8,2,366.1305642799829,0.41237745098039214,-0.03180257184513624,0.19890679602523903,128385.7160572563,2601.1869331065864,130986.90299036288,264,1,135.61764705882354,34,0,15,37.360507459180084,0.6081495098039216,46.636904761904766,1013.4523809523814,29.807422969187687,0
275,4,0,2,32,0.0,0.058823529411764705,0.9411764705882353,34,1350,1100,250,0.8148148148148148,16,11,5,367.1335389042035,0.4118761140819964,-0.029971133792798477,0.20020764944852812,128536.5717120183,2638.0172902494533,131174.58900226775,265,2,136.61764705882354,34,0,15,37.18082296313688,0.6096813725490196,46.48809523809525,1014.0476190476203,29.824929971988833,0
276,4,1,0,33,0.030303030303030304,0.0,1.0,33,900,600,300,0.6666666666666666,12,6,6,375.47065594576014,0.40778882575757575,-0.00348453736544041,0.2054541679163879,128672.41753472229,3062.5434027777887,131734.9609375001,266,0,141.0,33,0,16,36.830509924709105,0.6133207070707071,46.35416666666667,1014.5833333333339,30.744949494949513,0
277,4,1,0,34,0.029411764705882353,0.0,1.0,34,1300,1000,300,0.7692307692307693,16,10,6,368.4203040982743,0.4110034165181224,0.0034960699351764823,0.20414931711195086,129171.13272392283,2717.8535997732356,131888.98632369607,267,0,137.8235294117647,34,0,19,36.50017566459773,0.6161151960784313,45.863095238095234,1016.5476190476185,29.898459383753483,0
278,4,0,0,34,0.0,0.0,1.0,34,1150,700,450,0.6086956521739131,16,7,9,367.7385901994589,0.410223559120618,0.005663391424695741,0.20439757814404544,129292.1786422902,2709.1446995464744,132001.32334183666,268,1,138.8235294117647,34,0,20,36.394075071208384,0.6173406862745099,45.74404761904761,1017.0238095238091,29.912464985994383,0
279,4,1,0,35,0.02857142857142857,0.0,1.0,35,400,300,100,0.75,5,3,2,361.72631577913626,0.4129201680672269,0.015199987008557958,0.20255292170013098,129584.0985752099,2374.795712234207,131958.8942874441,269,0,135.82857142857142,35,0,14,36.24969212989275,0.6181547619047619,45.45717592592592,1018.171296296295,29.09060846560843,0
280,4,0,0,35,0.0,0.0,1.0,35,1200,800,400,0.6666666666666666,16,8,8,347.11341945609377,0.4119747899159664,0.05143465117457291,0.18113710149161608,126762.11911848068,1801.9381352399382,128564.05725372062,270,1,136.82857142857142,34,1,17,39.505260669109816,0.5916053921568627,48.24404761904761,1007.0238095238092,29.618347338935564,8
281,4,0,0,35,0.0,0.0,1.0,35,1050,800,250,0.7619047619047619,13,8,5,348.8161022687886,0.4121148459383754,0.06051849851471802,0.18269675059424648,126912.01814058944,1853.791099773227,128765.80924036267,271,2,137.82857142857142,34,1,18,39.30839437618148,0.5931372549019608,48.09523809523809,1007.6190476190465,29.63585434173666,0
282,4,0,0,35,0.0,0.0,1.0,35,550,200,350,0.36363636363636365,9,2,7,353.11795642374176,0.4121498599439776,0.0623376623376628,0.18577075098814216,127092.01388888873,1975.821995464833,129067.83588435357,272,3,138.82857142857142,33,2,18,39.01515151515152,0.5972222222222222,47.91666666666666,1008.333333333332,30.555555555555515,0
283,4,2,0,37,0.05405405405405406,0.0,1.0,37,1100,700,400,0.6363636363636364,15,7,8,337.7460451636275,0.42095220220220225,0.08167508167508153,0.1807934712346475,127793.2098765431,1232.330246913563,129025.54012345667,273,0,132.27027027027026,35,2,16,38.684752747252745,0.6,47.222222222222214,1011.1111111111103,28.888888888888864,0
284,4,0,0,37,0.0,0.0,1.0,37,1200,1000,200,0.8333333333333334,14,10,4,338.7527329497889,0.42038913913913917,0.08895017887124035,0.18199370858722205,127939.53517500423,1267.9734385716608,129207.50861357589,274,1,133.27027027027026,35,2,17,38.509729054646655,0.6014880952380952,47.07754629629629,1011.6898148148144,28.90542328042327,0
285,4,1,0,38,0.02631578947368421,0.0,1.0,38,1100,800,300,0.7272727272727273,14,8,6,332.88151114660786,0.4246088193456614,0.09204384600086546,0.1806554787272121,128344.1443977761,944.6785467900273,129288.82294456613,275,0,130.73684210526315,36,2,18,38.2453045121138,0.603587962962963,46.677927927927925,1013.2882882882878,28.146896896896884,0
286,4,0,0,38,0.0,0.0,1.0,38,1350,900,450,0.6666666666666666,18,9,9,335.5674141178276,0.4234234234234234,0.09798357637569732,0.18302753265481755,128543.9128951587,1027.0296901631384,129570.94258532184,276,1,131.73684210526315,36,2,15,37.97357949287433,0.6056134259259259,46.48085585585586,1014.0765765765768,28.1687937937938,0
287,4,1,0,39,0.02564102564102564,0.0,1.0,39,1400,900,500,0.6428571428571429,19,9,10,328.94153012310534,0.4270973909131804,0.09720561534033023,0.1813877580393123,128978.53185595559,685.27912434594,129663.81098030152,277,0,129.33333333333334,37,2,16,37.699247985031654,0.6081081081081081,46.05263157894736,1015.7894736842098,27.453769559032697,0
288,4,0,1,38,0.0,0.02564102564102564,0.9743589743589743,39,1200,1000,200,0.8333333333333334,14,10,4,331.67077333382264,0.4273504273504274,0.09328839374166376,0.1831502613653874,129034.22807979374,759.376442751608,129793.60452254536,278,1,130.33333333333334,37,2,16,37.573296640046046,0.6086711711711712,45.997807017543856,1016.0087719298242,27.459696538643897,0
289,4,0,0,38,0.0,0.0,1.0,38,750,500,250,0.6666666666666666,10,5,5,339.2298144519179,0.4239568515884305,0.09609816466632415,0.1864936589694203,128858.1486892298,1142.5051740930176,130000.65386332282,279,2,134.6315789473684,36,2,16,37.560540520556046,0.6087962962962963,46.171171171171174,1015.3153153153156,28.203203203203213,0
290,4,0,0,38,0.0,0.0,1.0,38,900,400,500,0.4444444444444444,14,4,10,338.7003677951085,0.42391239924134666,0.09693436960276314,0.18676905995558832,128978.53185595559,1137.0152354570514,130115.54709141263,280,3,135.6315789473684,37,1,16,37.45142487046631,0.6081081081081081,46.05263157894736,1015.7894736842098,27.453769559032697,0
291,4,1,0,39,0.02564102564102564,0.0,1.0,39,750,500,250,0.6666666666666666,10,5,5,333.73834831191294,0.4252699055330634,0.10782776971456243,0.1854657388012578,129285.00987082558,829.6654980378537,130114.67536886343,281,0,133.12820512820514,37,2,17,37.26583557951483,0.611204954954955,45.75109649122807,1016.9956140350872,27.486367946894248,0
292,4,1,1,39,0.025,0.025,0.975,40,900,600,300,0.6666666666666666,12,6,6,327.07048388098707,0.42751068376068374,0.11872049102927296,0.18326330287299747,129609.02829142011,478.2575197238636,130087.28581114397,282,0,130.775,38,2,15,37.106547056971976,0.6126644736842105,45.43269230769231,1018.2692307692307,26.79655870445344,0
293,4,1,0,40,0.025,0.0,1.0,40,1000,700,300,0.7,13,7,6,323.1850655208601,0.42610844017094013,0.13251149718957622,0.18226892600124586,129864.12896050341,394.02940538193934,130258.15836588535,283,0,130.175,39,1,16,36.94696389030829,0.6135149572649572,45.182291666666664,1019.2708333333328,26.13514957264956,0
294,4,0,0,40,0.0,0.0,1.0,40,950,600,350,0.631578947368421,13,6,7,322.1971753973076,0.42520032051282053,0.13696240678312388,0.18220613229140636,129970.32470703128,375.21430121527794,130345.53900824656,284,1,131.175,39,1,16,36.864614192801454,0.6145833333333333,45.078125,1019.6875000000002,26.14583333333334,0
295,4,0,0,40,0.0,0.0,1.0,40,850,500,350,0.5882352941176471,12,5,7,320.5068260093162,0.42471955128205124,0.13411310413552613,0.18140360964486682,130003.35784131469,333.392718454626,130336.75055976931,285,2,132.175,40,0,16,36.874273376515525,0.61328125,45.045731707317074,1019.8170731707318,25.495426829268293,0
296,4,0,1,39,0.0,0.025,0.975,40,1300,1100,200,0.8461538461538461,15,11,4,323.37581943143726,0.42467948717948717,0.13108565737051747,0.183636494745002,130132.9400489129,416.36922466787746,130549.30927358079,286,3,133.175,40,0,16,36.66998671978752,0.6145833333333333,44.91869918699188,1020.3252032520343,25.508130081300855,0
297,4,0,1,38,0.0,0.02564102564102564,0.9743589743589743,39,1000,700,300,0.7,13,7,6,331.81817911879017,0.41883153396311296,0.13295540497745306,0.18867224032656904,130182.84640842005,839.4070095486061,131022.25341796866,287,4,137.35897435897436,39,0,17,36.40410754993026,0.6167200854700854,44.869791666666664,1020.5208333333326,26.167200854700834,0
298,4,0,0,38,0.0,0.0,1.0,38,950,500,450,0.5263157894736842,14,5,9,352.5992109122652,0.41336237553342814,0.07910582656462739,0.18732877508656384,127489.75326678039,1450.2849278226843,128940.03819460307,288,5,141.6578947368421,36,2,16,38.620186589354745,0.5949074074074074,47.52252252252253,1009.9099099099108,28.053053053053077,8
299,4,2,1,39,0.05,0.025,0.975,40,1000,800,200,0.8,12,8,4,339.88721231519565,0.4215544871794872,0.094753086419753,0.18353909465020585,128144.53125000015,710.9375000000157,128855.46875000016,289,0,135.525,38,2,18,38.271604938271615,0.5978618421052632,46.87500000000001,1012.5000000000011,26.644736842105292,0
300,4,1,1,39,0.025,0.025,0.975,40,950,800,150,0.8421052631578947,11,8,3,340.07187880425784,0.42363782051282056,0.08744840321529446,0.1801324347682392,127368.57133925823,684.5952600800247,128053.16659933825,290,0,134.625,37,3,17,39.060576435657914,0.5917792792792793,47.64254385964912,1009.4298245614034,27.2818871503082,7
301,4,0,0,39,0.0,0.0,1.0,39,1350,700,650,0.5185185185185185,20,7,13,346.47126745028993,0.4210807467386415,0.10385072851620558,0.18407312360747632,127489.75326678029,1034.3072802532229,128524.06054703351,291,1,138.89743589743588,36,3,18,38.77490336009515,0.5949074074074074,47.52252252252252,1009.90990990991,28.053053053053056,0
302,4,2,1,40,0.04878048780487805,0.024390243902439025,0.975609756097561,41,1100,500,600,0.45454545454545453,17,5,12,332.4357736794863,0.4263973577235773,0.09675800461708306,0.17951531778692278,128144.53125000013,319.96527777779124,128464.49652777793,292,0,133.0731707317073,38,3,21,38.460219478738004,0.5978618421052632,46.87500000000001,1012.500000000001,26.64473684210529,0
303,4,0,0,40,0.0,0.0,1.0,40,750,500,250,0.6666666666666666,10,5,5,338.81390410815817,0.4247729700854701,0.10407651715039545,0.18271267737192953,128090.4504186757,679.7651170648044,128770.2155357405,293,1,137.15,38,2,22,38.354001759014935,0.5973135964912281,46.92841880341881,1012.2863247863257,26.639113810166467,0
304,4,2,1,41,0.047619047619047616,0.023809523809523808,0.9761904761904762,42,1450,1100,350,0.7586206896551724,18,11,7,323.78794149538396,0.4300716221447929,0.10910641583945457,0.17752762599828564,128751.69406467052,-62.33938867711558,128689.3546759934,294,0,131.57142857142858,39,3,16,38.0607658489856,0.6022970085470085,46.276041666666686,1014.8958333333364,26.022970085470167,0
305,4,0,2,39,0.0,0.04878048780487805,0.9512195121951219,41,1550,1200,350,0.7741935483870968,19,12,7,330.2335734072022,0.4277693089430894,0.11769961489088532,0.18113273368177954,128767.2812111915,304.655882460372,129071.93709365187,295,1,135.78048780487805,38,3,18,37.88135964912281,0.6041666666666667,46.26068376068376,1014.9572649572652,26.709401709401718,0
306,4,0,1,38,0.0,0.02564102564102564,0.9743589743589743,39,1300,1000,300,0.7692307692307693,16,10,6,343.98241058381905,0.4223178137651822,0.11523934852084183,0.1872146106454376,128458.27880245101,1037.4776803830764,129495.75648283408,296,2,143.53846153846155,36,3,19,37.84760793897652,0.6047453703703703,46.56531531531531,1013.738738738738,28.15940940940939,0
307,4,0,0,38,0.0,0.0,1.0,38,750,600,150,0.8,9,6,3,354.34278311739376,0.4199561403508772,0.13280489417194508,0.1927536704684554,128437.66744898827,1502.1921081961543,129939.85955718442,297,3,147.92105263157896,35,3,20,37.606093476440584,0.6065476190476191,46.585648148148145,1013.6574074074069,28.961640211640198,0
308,4,2,0,40,0.05,0.0,1.0,40,1000,800,200,0.8,12,8,4,341.07704167830445,0.4250667735042735,0.1490474905558561,0.1882119589725721,129006.37846500822,800.2227848953294,129806.60124990356,298,0,141.475,37,3,22,37.36272261198059,0.6083896396396397,46.0252192982456,1015.8991228070156,27.45673304883826,0
309,4,2,2,40,0.047619047619047616,0.047619047619047616,0.9523809523809523,42,1000,600,400,0.6,14,6,8,326.7684900092089,0.42776084010840104,0.1396159282546181,0.1824301798508553,129466.28146701373,61.100260416647814,129527.38172743037,299,0,135.6904761904762,39,3,16,37.2590412828386,0.6095085470085471,45.57291666666666,1017.708333333332,26.095085470085436,0
310,4,1,0,41,0.024390243902439025,0.0,1.0,41,1400,1000,400,0.7142857142857143,18,10,8,331.5793424619205,0.4268292682926829,0.1406778879882018,0.18514799626566528,129473.07715136219,386.1195576740216,129859.19670903622,300,0,139.97560975609755,38,3,18,37.12974140947581,0.6112938596491229,45.566239316239304,1017.735042735041,26.78250112460634,0
311,4,2,1,42,0.046511627906976744,0.023255813953488372,0.9767441860465116,43,1150,800,350,0.6956521739130435,15,8,7,319.6958466459766,0.43074012550756735,0.15195992102848344,0.1810647582922696,130029.2691189105,-286.03654405448833,129743.23257485601,301,0,134.41860465116278,40,3,20,36.868730902085815,0.6135416666666667,45.02032520325202,1019.9186991869901,25.497967479674752,0
312,4,1,0,43,0.023255813953488372,0.0,1.0,43,1000,600,400,0.6,14,6,8,323.36526447313594,0.42947120708748615,0.1682012339819643,0.18424299952539164,130262.58680555566,-174.8934166170834,130087.69338893858,302,0,135.32558139534885,37,6,23,36.53911564625851,0.6210585585585586,44.79166666666667,1020.8333333333343,27.590090090090115,0
313,4,0,0,43,0.0,0.0,1.0,43,1650,1200,450,0.7272727272727273,21,12,9,327.41354307237293,0.4288252122554448,0.1676495997523113,0.18708771412123193,130374.54433094795,-62.7217028316378,130311.82262811631,303,1,136.32558139534885,37,6,23,36.32256101925418,0.6221846846846847,44.68201754385965,1021.2719298245611,27.60194404931246,0
314,4,0,0,43,0.0,0.0,1.0,43,1000,600,400,0.6,14,6,8,327.8836615113523,0.42914820967146544,0.17097866136778928,0.1876267930368404,130430.5411280396,-46.79132040625677,130383.74980763334,304,2,137.32558139534885,37,6,24,36.253935880921716,0.6227477477477478,44.62719298245615,1021.491228070177,27.607871028923704,0
315,4,0,0,43,0.0,0.0,1.0,43,1350,1000,350,0.7407407407407407,17,10,7,329.22163995338803,0.4289405684754522,0.17606758257648836,0.18943607172062396,130644.58832137148,2.205123639454314,130646.79344501093,305,3,138.32558139534885,38,5,18,36.00341380151183,0.6230811403508771,44.41773504273506,1022.3290598290623,26.903396311291115,0
316,4,1,1,43,0.022727272727272728,0.022727272727272728,0.9772727272727273,44,1250,1000,250,0.8,15,10,5,323.74933917946305,0.4308161557434813,0.18041225480903678,0.1877075184154508,130937.79047070233,-321.79537229820215,130615.99509840412,306,0,136.1590909090909,40,4,19,35.847358752854724,0.62265625,44.131097560975626,1023.4756097561005,25.586890243902513,0
317,4,1,0,44,0.022727272727272728,0.0,1.0,44,1200,800,400,0.6666666666666666,16,8,8,322.1239106805738,0.43059593023255816,0.18149788877259976,0.18739725889246353,131067.83743142353,-355.9831284288068,130711.85430299472,307,0,137.0,40,4,20,35.75782387190682,0.6239583333333334,44.004065040650424,1023.9837398374018,25.599593495935046,0
318,4,0,1,43,0.0,0.022727272727272728,0.9772727272727273,44,900,400,500,0.4444444444444444,14,4,10,323.6323115844001,0.43033165961945036,0.17885748044990035,0.188657609511809,131145.89659139773,-311.39006626341904,130834.5065251343,308,1,138.0,40,4,20,35.64052320005295,0.6247395833333333,43.92784552845531,1024.2886178861822,25.607215447154555,0
319,4,0,0,43,0.0,0.0,1.0,43,1850,1400,450,0.7567567567567568,23,14,9,332.23702016890223,0.427671650055371,0.16761537343359523,0.19367362211002728,131145.8965913976,114.3043781810095,131260.2009695786,309,2,141.88372093023256,40,3,21,35.42018057346961,0.6247395833333333,43.9278455284553,1024.2886178861813,25.607215447154534,0
320,4,0,0,43,0.0,0.0,1.0,43,1400,1000,400,0.7142857142857143,18,10,8,339.17754777996987,0.4270487264673311,0.08730590965689111,0.19337817973427548,130287.90632283017,258.7247499007671,130546.63107273093,310,3,142.88372093023256,41,2,17,36.10993019790755,0.6145833333333333,44.76686507936508,1020.9325396825406,24.900793650793673,8
321,4,0,0,43,0.0,0.0,1.0,43,850,500,350,0.5882352941176471,12,5,7,342.4542853019187,0.4270487264673311,0.08593331661391002,0.195500940577518,130338.55273880386,326.99918509070386,130665.55192389457,311,4,143.88372093023256,41,2,17,35.974995142329746,0.6150914634146342,44.717261904761905,1021.1309523809524,24.905632984901278,0
322,4,0,0,43,0.0,0.0,1.0,43,950,800,150,0.8421052631578947,11,8,3,342.8108410625894,0.4271179401993355,0.09061093944814891,0.19608780108780102,130414.54081632645,341.50368480724813,130756.0445011337,312,5,144.88372093023256,41,2,20,35.88893745143745,0.6158536585365854,44.64285714285714,1021.4285714285708,24.9128919860627,0
323,4,1,0,44,0.022727272727272728,0.0,1.0,44,1350,1000,350,0.7407407407407407,17,10,7,342.76880419240587,0.42785412262156447,0.11060433786414459,0.19768207428670256,130732.8708085454,162.22995913709252,130895.1007676825,313,0,142.5681818181818,42,2,17,35.567873160255196,0.6175595238095238,44.33139534883722,1022.674418604653,24.349390919158406,0
324,4,0,1,43,0.0,0.022727272727272728,0.9772727272727273,44,800,400,400,0.5,12,4,8,342.92635393053956,0.4270502995066949,0.10963288534554727,0.19840873266589454,130856.77059859717,174.84704570041293,131031.61764429758,314,1,143.5681818181818,42,2,17,35.43856741484359,0.6187996031746033,44.21027131782947,1023.1589147286847,24.36092654115916,0
325,4,0,2,41,0.0,0.046511627906976744,0.9534883720930233,43,1550,1200,350,0.7741935483870968,19,12,7,338.0611141157376,0.42504152823920266,0.10616549486208693,0.19644091766184807,131023.24263038588,258.77267573699856,131282.0153061229,315,2,145.62790697674419,41,2,18,35.394864341085274,0.6219512195121951,44.047619047619065,1023.8095238095269,24.970963995354314,0
326,4,0,0,41,0.0,0.0,1.0,41,1350,1200,150,0.8888888888888888,15,12,3,349.1738819374138,0.42040142276422765,0.12771871308456606,0.20281802078492406,131008.00781250057,948.9149305556141,131956.92274305617,316,3,152.6829268292683,39,2,20,35.1258309591643,0.625,44.06250000000003,1023.7500000000045,26.250000000000117,0
327,4,0,0,41,0.0,0.0,1.0,41,900,400,500,0.4444444444444444,14,4,10,347.15319930089635,0.4197154471544715,0.1308039379590371,0.20234483750597043,131141.34250217053,905.2273220486504,132046.5698242192,317,4,153.6829268292683,39,2,20,35.0428192481101,0.6263354700854701,43.932291666666686,1024.2708333333364,26.26335470085478,0
328,4,0,0,41,0.0,0.0,1.0,41,1300,900,400,0.6923076923076923,17,9,8,343.66069406023155,0.4198678861788618,0.1265298129147565,0.2011467917227024,131301.43364800385,824.6283637153169,132126.06201171916,318,5,154.6829268292683,39,2,21,34.97063133109733,0.6279380341880342,43.776041666666686,1024.8958333333364,26.279380341880422,0
329,4,0,0,41,0.0,0.0,1.0,41,1450,1100,350,0.7586206896551724,18,11,7,344.59951435496066,0.4191819105691057,0.12814661591083487,0.20241530837080257,131437.65637555713,858.6732236678531,132296.329599225,319,6,155.6829268292683,38,3,21,34.809118219073426,0.6310307017543859,43.6431623931624,1025.4273504273513,26.98493027440398,0
330,4,0,0,41,0.0,0.0,1.0,41,950,500,450,0.5263157894736842,14,5,9,339.20741621358474,0.4188516260162602,0.10904566482423483,0.1895383609540655,129500.26167223661,620.2377365037337,130120.49940874035,320,7,156.6829268292683,38,3,17,36.90804205591127,0.6115679824561404,45.5395299145299,1017.8418803418786,26.78531264057575,8
331,4,1,1,41,0.023809523809523808,0.023809523809523808,0.9761904761904762,42,1350,800,550,0.5925925925925926,19,8,11,331.20626948999836,0.42038085559427024,0.11454607392267135,0.18679270011294719,129864.1289605034,202.36273871527357,130066.49169921866,321,0,153.92857142857142,39,3,18,36.7425694089593,0.6135149572649572,45.182291666666664,1019.2708333333327,26.135149572649556,0
332,4,1,0,42,0.023809523809523808,0.0,1.0,42,1100,800,300,0.7272727272727273,14,8,6,326.08494803137916,0.4216511807975223,0.1128383401110673,0.18591963790899044,130289.17236328124,97.67795138888869,130386.85031467013,322,0,149.3095238095238,39,3,21,36.442816209230365,0.6177884615384616,44.765625,1020.9374999999999,26.177884615384613,0
333,4,0,0,42,0.0,0.0,1.0,42,1000,600,400,0.6,14,6,8,326.1959706035939,0.42142131242741,0.11656078179946028,0.1863651104777176,130368.94531249999,105.1649305555552,130474.11024305555,323,1,150.3095238095238,39,3,21,36.359309125526984,0.6185897435897436,44.6875,1021.2499999999999,26.185897435897434,0
334,4,0,0,42,0.0,0.0,1.0,42,1050,700,350,0.6666666666666666,14,7,7,328.51497514965797,0.4207196089818041,0.12069802436774957,0.18846385416480393,130528.5644531251,176.1176215277913,130704.6820746529,324,2,151.3095238095238,39,3,16,36.138718994223595,0.6201923076923077,44.53125000000001,1021.8750000000008,26.201923076923098,0
335,4,0,0,42,0.0,0.0,1.0,42,1250,700,550,0.56,18,7,11,330.1048708795055,0.4206833139759969,0.11761108846310608,0.18963635790806282,130581.79253472247,221.13715277780076,130802.92968750026,325,3,152.3095238095238,39,3,17,36.0442994972143,0.6207264957264957,44.47916666666668,1022.0833333333353,26.207264957265007,0
336,4,0,1,41,0.0,0.023809523809523808,0.9761904761904762,42,1150,800,350,0.6956521739130435,15,8,7,328.60335981319173,0.42033246225319393,0.11744657108895495,0.1891637522912892,130661.65500217039,187.17176649307825,130848.82676866346,326,4,153.3095238095238,39,3,18,36.001974019358116,0.6215277777777778,44.40104166666668,1022.3958333333353,26.21527777777783,0
337,4,0,1,40,0.0,0.024390243902439025,0.975609756097561,41,1200,800,400,0.6666666666666666,16,8,8,341.71117470976276,0.42090955284552845,0.03911407857694482,0.1933729711218834,129996.88042534742,695.7383897569645,130692.61881510439,327,5,152.609756097561,39,2,16,36.34022812393599,0.6148504273504274,45.05208333333334,1019.7916666666682,26.14850427350431,8
338,4,0,0,40,0.0,0.0,1.0,40,1300,1000,300,0.7692307692307693,16,10,6,346.4073465452252,0.4198717948717949,0.042885199539121954,0.19627008530963017,130044.55133912282,1009.6775924099808,131054.2289315328,328,6,156.55,38,2,17,36.17213959009811,0.6170504385964912,45.00534188034189,1019.9786324786338,26.84154295996405,0
339,4,1,0,41,0.024390243902439025,0.0,1.0,41,1850,1400,450,0.7567567567567568,23,14,9,340.13664754432733,0.42200203252032525,0.0540374511067081,0.1813455816051838,127631.95363860454,503.93121586920796,128135.88485447374,329,0,153.70731707317074,36,5,15,38.78928452022737,0.5963541666666667,47.381756756756744,1010.4729729729706,28.06869369369363,8
340,4,1,1,41,0.023809523809523808,0.023809523809523808,0.9761904761904762,42,1150,700,450,0.6086956521739131,16,7,9,335.8938393267531,0.4259823848238482,0.06700669215567889,0.18075593254499125,128005.79415060382,199.2715306632549,128205.06568126708,330,0,151.02380952380952,37,5,17,38.514352403655145,0.5982545045045045,47.01206140350876,1011.9517543859632,27.350047415836844,0
341,4,1,0,42,0.023809523809523808,0.0,1.0,42,1000,700,300,0.7,13,7,6,334.25468780473705,0.4259944831591173,0.07972603029869796,0.18075480501671684,128201.54772593538,170.4688055566544,128372.01653149203,331,0,151.3095238095238,36,6,18,38.35598984395271,0.6021412037037037,46.818693693693696,1012.7252252252251,28.131256256256254,0
342,4,0,0,42,0.0,0.0,1.0,42,1350,900,450,0.6666666666666666,18,9,9,350.6218647118871,0.4264300232288037,0.14076988820219438,0.1796727354576225,126017.68798828124,436.9113498263881,126454.59933810763,332,1,152.3095238095238,39,3,17,40.18321834906801,0.5745192307692308,48.984375,1004.0624999999999,25.745192307692303,8
343,4,3,1,44,0.06666666666666667,0.022222222222222223,0.9777777777777777,45,1050,900,150,0.8571428571428571,12,9,3,332.77647577268993,0.43282828282828284,0.16259546368073519,0.17450473729543495,126960.75439453124,-550.0813802083344,126410.6730143229,333,0,143.0888888888889,39,6,17,39.6624677002584,0.5841346153846154,48.046875,1007.8124999999999,25.84134615384615,0
344,4,2,0,46,0.043478260869565216,0.0,1.0,46,1300,1000,300,0.7692307692307693,16,10,6,325.730067155003,0.43481280193236715,0.17801047120418856,0.17244941508440761,127348.32523630101,-903.7642937405105,126444.5609425605,334,0,140.93478260869566,40,6,14,39.44321385420862,0.5864583333333333,47.662601626016254,1009.3495934959338,25.233739837398346,0
345,4,1,1,46,0.02127659574468085,0.02127659574468085,0.9787234042553191,47,1200,900,300,0.75,15,9,6,319.02851183860423,0.435649861239593,0.19021559654668097,0.16455906281958424,126287.21160274312,-1306.7054281775208,124980.5061745656,335,0,138.91489361702128,42,5,14,40.69941193483079,0.5726686507936508,48.71608527131782,1005.1356589147277,23.93180140273161,8
346,4,1,0,47,0.02127659574468085,0.0,1.0,47,1050,500,550,0.47619047619047616,16,5,11,336.4848166144241,0.43684474252235583,0.2652821662830964,0.1717057232713563,125844.67612276379,-785.588020049189,125059.0881027146,336,0,139.85106382978722,41,6,15,40.7162514006987,0.5696138211382114,49.156746031746025,1003.3730158730148,24.472512582268653,8
347,4,1,0,48,0.020833333333333332,0.0,1.0,48,1100,700,400,0.6363636363636364,15,7,8,331.02210360868,0.4392638150118204,0.2681266653175485,0.16994760779036805,126094.86669847644,-1251.6474534517142,124843.21924502472,337,0,137.91666666666666,40,8,16,40.59580424297613,0.5736979166666667,48.90752032520325,1004.369918699187,25.109247967479675,0
348,4,3,1,50,0.058823529411764705,0.0196078431372549,0.9803921568627451,51,1150,800,350,0.6956521739130435,15,8,7,301.3169351535297,0.44287581699346407,0.20923509456020573,0.1559683883920576,126430.70098357732,-2510.006120440393,123920.69486313693,338,0,130.7450980392157,45,6,15,40.997459395358625,0.5701388888888889,48.573369565217384,1005.7065217391289,22.349033816425088,8
349,4,1,1,50,0.0196078431372549,0.0196078431372549,0.9803921568627451,51,1450,900,550,0.6206896551724138,20,9,11,304.9298826688264,0.4445751633986928,0.23885725574864747,0.15898689379674807,126726.93827452196,-2471.433916194093,124255.50435832787,339,0,131.7058823529412,45,6,16,40.60325956579104,0.5731481481481482,48.27898550724637,1006.8840579710129,22.37520128824473,0
350,4,3,3,50,0.05660377358490566,0.05660377358490566,0.9433962264150944,53,1200,700,500,0.5833333333333334,17,7,10,294.20924164632595,0.4465711175616836,0.2502683053487966,0.1556738220361629,127325.5315500687,-3106.3550847809115,124219.17646528779,340,0,127.52830188679245,44,9,11,40.2618501529052,0.5804924242424243,47.68518518518519,1009.2592592592601,22.937710437710457,0
351,4,3,4,49,0.05660377358490566,0.07547169811320754,0.9245283018867925,53,1750,1200,550,0.6857142857142857,23,12,11,292.66913909263246,0.4483248669569424,0.1728436092462633,0.15932426832248286,128467.59813619367,-3033.0925116434937,125434.50562455018,341,0,128.47169811320754,48,5,15,39.138602303864,0.5872395833333333,46.55612244897961,1013.775510204085,21.12032312925177,8
352,4,0,2,47,0.0,0.04081632653061224,0.9591836734693877,49,1250,1000,250,0.8,15,10,5,306.0129184955923,0.4444798752834467,0.12541130707200732,0.16107999156555206,127114.84854973992,-1958.9312214970528,125155.91732824287,342,1,136.79591836734693,45,4,14,40.17925312135096,0.5770833333333334,47.89402173913043,1008.4239130434771,22.409420289855046,8
353,4,2,2,47,0.04081632653061224,0.04081632653061224,0.9591836734693877,49,1450,900,550,0.6206896551724138,20,9,11,316.19213669325745,0.4451884920634921,0.17867797831689836,0.16871141411222731,127663.49576146023,-1726.7612994906576,125936.73446196958,343,0,137.6122448979592,45,4,13,39.361966329060984,0.5826388888888889,47.35054347826087,1010.5978260869559,22.45772946859902,0
354,4,0,1,46,0.0,0.02127659574468085,0.9787234042553191,47,1000,700,300,0.7,13,7,6,322.9982132788376,0.43911887141535616,0.19929383460288408,0.1721973376410337,127629.42493998643,-1155.1847565157586,126474.24018347068,344,1,144.19148936170214,44,3,14,39.224815968722325,0.5835700757575757,47.38425925925927,1010.4629629629642,22.965067340067367,0
355,4,1,2,45,0.02127659574468085,0.0425531914893617,0.9574468085106383,47,1300,900,400,0.6923076923076923,17,9,8,320.62425293332933,0.4403715695343817,0.20338802207873097,0.17205242827998532,127892.44746540929,-1198.915915117602,126693.5315502917,345,0,142.25531914893617,45,2,16,39.01627936479508,0.5849537037037037,47.12409420289856,1011.5036231884077,22.477858293075727,0
356,4,2,3,44,0.0425531914893617,0.06382978723404255,0.9361702127659575,47,1050,600,450,0.5714285714285714,15,6,9,316.98692953236934,0.4405642923219242,0.2276375143580891,0.17215775570913372,128373.91369985323,-1261.4294528460143,127112.48424700722,346,0,141.51063829787233,45,2,13,38.61764092480039,0.5898148148148148,46.648550724637694,1013.4057971014514,22.520128824476696,0
357,4,0,0,44,0.0,0.0,1.0,44,1550,1000,550,0.6451612903225806,21,10,11,331.76144717230113,0.4362667371388302,0.22253769761900588,0.17970125226628197,128267.19867345739,-289.1777086713237,127978.02096478606,347,1,150.9090909090909,42,2,17,38.35214590906193,0.5927579365079365,46.75387596899226,1012.9844961240331,24.118678479143643,0
358,4,0,0,44,0.0,0.0,1.0,44,1750,1400,350,0.8,21,14,7,331.502094847983,0.4350004404510219,0.22223380594940223,0.180668641692151,128512.70957274224,-279.5535124090849,128233.15606033316,348,2,151.9090909090909,42,2,16,38.10843527013254,0.5952380952380952,46.511627906976756,1013.9534883720947,24.141749723145114,0
359,4,1,2,43,0.022222222222222223,0.044444444444444446,0.9555555555555556,45,1600,1200,400,0.75,20,12,8,325.19306081546074,0.43762626262626264,0.2265489659745532,0.17902312033803933,128912.72454660256,-615.6953053259718,128297.02924127658,349,0,149.51111111111112,43,2,18,37.8613390525923,0.5978682170542635,46.11742424242425,1015.5303030303045,23.61698379140243,0
360,4,0,0,43,0.0,0.0,1.0,43,1900,1700,200,0.8947368421052632,21,17,4,333.7419207490605,0.43634643779992616,0.22986332806943777,0.18354908967579972,128873.8024868511,2.1180752393412376,128875.92056209044,350,1,155.74418604651163,41,2,18,37.68390734408075,0.6003556910569106,46.15575396825396,1015.3769841269832,24.76529229578008,0
361,4,0,1,42,0.0,0.023255813953488372,0.9767441860465116,43,850,500,350,0.5882352941176471,12,5,7,333.4255048839047,0.4358388704318937,0.22284152930995726,0.1838418817720139,128974.55401431395,0.6811578798079552,128975.23517219376,351,2,156.74418604651163,41,2,18,37.58942523683952,0.6013719512195121,46.05654761904761,1015.7738095238087,24.774970963995333,0
362,4,1,0,43,0.023255813953488372,0.0,1.0,43,1600,1200,400,0.75,20,12,8,337.4406621178281,0.43383167220376523,0.23512270182310901,0.18700673146140506,129176.17517203621,117.8588159800749,129294.03398801628,352,0,157.53488372093022,41,2,19,37.28235499821086,0.6034044715447154,45.85813492063491,1016.5674603174587,24.79432830042582,0
363,4,0,1,42,0.0,0.023255813953488372,0.9767441860465116,43,1300,900,400,0.6923076923076923,17,9,8,340.36040552050787,0.4332087486157254,0.23493763129031686,0.18924038546940217,129304.72932778085,202.0444824195165,129506.77381020036,353,1,158.53488372093022,40,3,19,37.077421396216344,0.60625,45.73170731707316,1017.0731707317054,25.426829268292636,0
364,4,0,1,41,0.0,0.023809523809523808,0.9761904761904762,42,950,800,150,0.8421052631578947,11,8,3,345.21181193794047,0.43229771583430116,0.22506278497061882,0.1920793927962387,129333.80126953128,529.5111762152774,129863.31244574656,354,2,161.3095238095238,39,3,19,36.9244965011094,0.6081730769230769,45.703125,1017.1875000000002,26.081730769230774,0
365,4,0,0,41,0.0,0.0,1.0,41,1350,1000,350,0.7407407407407407,17,10,7,349.93085359186125,0.4330538617886179,0.21588516452272266,0.19485623321062578,129364.36760355024,853.7167159763244,130218.08431952656,355,3,159.90243902439025,38,3,20,36.77339319470701,0.6101973684210527,45.67307692307692,1017.3076923076918,26.77125506072873,0
366,4,0,0,41,0.0,0.0,1.0,41,1450,900,550,0.6206896551724138,20,9,11,351.7473836240829,0.4323932926829268,0.21289056001064766,0.19681742915759767,129554.63927469142,914.1010802469204,130468.74035493835,356,4,160.90243902439025,38,3,17,36.53365165984538,0.6121162280701755,45.486111111111114,1018.0555555555561,26.790935672514635,0
367,4,1,1,41,0.023809523809523808,0.023809523809523808,0.9761904761904762,42,1500,1100,400,0.7333333333333333,19,11,8,342.4140616375703,0.434971447928765,0.20912876797633628,0.19350743852820676,129943.77170138899,498.9149305555654,130442.68663194455,357,0,158.04761904761904,39,3,19,36.37617490805067,0.6143162393162394,45.10416666666667,1019.5833333333342,26.143162393162413,0
368,4,0,0,41,0.0,0.0,1.0,41,950,900,50,0.9473684210526315,10,9,1,350.71199715201135,0.4333079268292683,0.217794140205553,0.19774187073464472,129853.92011834323,908.2655325443812,130762.18565088761,358,1,162.78048780487805,38,3,19,36.255896226415096,0.6151315789473684,45.19230769230769,1019.2307692307695,26.821862348178144,0
369,4,0,1,40,0.0,0.024390243902439025,0.975609756097561,41,1400,1100,300,0.7857142857142857,17,11,6,353.1469949027418,0.4319359756097561,0.22559187468707553,0.20022847430708898,130071.79578493677,986.892760610706,131058.68854554747,359,2,163.78048780487805,38,3,19,35.97262952101662,0.6173245614035088,44.97863247863248,1020.0854700854698,26.844354475933415,0
370,4,2,2,40,0.047619047619047616,0.047619047619047616,0.9523809523809523,42,950,700,250,0.7368421052631579,12,7,5,348.84788489302014,0.43330187766163375,0.2385041607884033,0.1996232736893965,130430.54112803945,700.363329312479,131130.90445735192,360,0,160.5952380952381,37,5,21,35.71856662372979,0.6227477477477478,44.627192982456144,1021.4912280701758,27.60787102892367,0
371,4,1,1,40,0.024390243902439025,0.024390243902439025,0.975609756097561,41,800,500,300,0.625,11,5,6,344.76295868521635,0.43389227642276423,0.22055690887038382,0.19879946027318646,130726.51855504441,813.9322631310046,131540.45081817542,361,0,153.29268292682926,38,3,17,35.52331452848586,0.6239035087719298,44.33760683760685,1022.6495726495743,26.911830859199323,0
372,4,1,1,40,0.024390243902439025,0.024390243902439025,0.975609756097561,41,1050,900,150,0.8571428571428571,12,9,3,349.14988344080643,0.4332317073170732,0.22686822546271124,0.20232950595762184,130917.78897518099,941.9861522025211,131859.7751273835,362,0,154.2439024390244,38,3,19,35.217663639210784,0.6258223684210527,44.150641025641036,1023.3974358974374,26.931511470985196,0
373,4,0,0,40,0.0,0.0,1.0,40,1250,900,350,0.72,16,9,7,357.5325530246898,0.4344951923076923,0.2286005143591947,0.20697852263191088,130878.94833025541,1358.6969067405328,132237.64523699594,363,1,153.325,37,3,19,35.042506072296035,0.6272522522522522,44.18859649122807,1023.2456140350873,27.65528686581317,0
374,4,0,0,40,0.0,0.0,1.0,40,1000,600,400,0.6,14,6,8,358.3231001769246,0.43377403846153845,0.23334464043419278,0.20794025577196343,130972.46334876554,1386.0918209876681,132358.5551697532,364,2,154.325,38,2,19,34.92763455450023,0.6263706140350878,44.09722222222223,1023.611111111112,26.937134502924,0
375,4,0,0,40,0.0,0.0,1.0,40,1100,500,600,0.45454545454545453,17,5,12,353.15231265731796,0.4327991452991453,0.22643944925419834,0.20581587972314327,131136.55495516464,1262.235531265967,132398.7904864306,365,3,155.325,38,2,19,34.89404054101039,0.628015350877193,43.936965811965806,1024.252136752136,26.95400359874042,0
376,4,0,0,40,0.0,0.0,1.0,40,950,600,350,0.631578947368421,13,6,7,349.31774970063526,0.4331730769230769,0.2208242101970601,0.20416249466049927,131246.0064308021,1169.311924720577,132415.3183555227,366,4,156.325,38,2,20,34.88165988947972,0.6291118421052632,43.830128205128204,1024.679487179487,26.96524966261808,0
377,4,0,0,40,0.0,0.0,1.0,40,1550,1200,350,0.7741935483870968,19,12,7,347.52746718522127,0.4328659188034188,0.2225187165775402,0.20385080415193338,131384.32618690358,1131.9581036313293,132516.2842905349,367,5,157.325,37,3,20,34.78787878787879,0.6323198198198199,43.695175438596486,1025.2192982456133,27.708629682313873,0
378,4,0,0,40,0.0,0.0,1.0,40,800,600,200,0.75,10,6,4,347.0125007226169,0.43246527777777777,0.2245081266039346,0.20384804690690397,131440.5393967374,1122.3020544782946,132562.8414512157,368,6,158.325,37,3,20,34.74435058454519,0.6328828828828829,43.64035087719298,1025.4385964912278,27.714556661925076,0
379,4,0,0,40,0.0,0.0,1.0,40,1050,800,250,0.7619047619047619,13,8,5,347.5264950819066,0.43190438034188033,0.22726592560923464,0.20475175617042302,131553.00188519535,1143.6307325330738,132696.63261772844,369,7,159.325,37,3,21,34.61771412284452,0.634009009009009,43.53070175438596,1025.8771929824554,27.726410621147444,0
380,4,0,1,39,0.0,0.025,0.975,40,1150,900,250,0.782608695652174,14,9,5,314.32535778982407,0.430982905982906,0.11503990339178904,0.17515040270523627,129391.54071015022,167.98087648065564,129559.52158663087,370,8,160.325,38,2,20,37.6513878679688,0.6104714912280702,45.64636752136751,1017.4145299145277,26.7740665766981,8
381,4,1,0,40,0.025,0.0,1.0,40,950,700,250,0.7368421052631579,12,7,5,315.81678627769685,0.4314903846153846,0.04032773990561078,0.17744920784666082,129717.84056770008,193.4143061947208,129911.25487389481,371,0,161.1,38,2,14,37.282817689215165,0.6137609649122807,45.325854700854684,1018.696581196579,26.807804768331028,8
382,4,0,0,40,0.0,0.0,1.0,40,1200,900,300,0.75,15,9,6,314.74805730608574,0.4307959401709402,0.04514463892673759,0.17758788969588182,129881.14458917729,175.9675880268668,130057.11217720415,372,1,162.1,38,2,17,37.144735003319,0.6154057017543859,45.16559829059828,1019.3376068376056,26.824673864147513,0
383,4,0,1,39,0.0,0.025,0.975,40,1350,900,450,0.6666666666666666,18,9,9,314.76396610853067,0.4297676282051282,0.043975272422464684,0.17796844150117377,129962.83512309138,181.5234860106509,130144.35860910204,373,2,163.1,38,2,17,37.06167924001118,0.6162280701754386,45.08547008547008,1019.6581196581185,26.83310841205575,0
384,4,2,1,40,0.04878048780487805,0.024390243902439025,0.975609756097561,41,1300,900,400,0.6923076923076923,17,9,8,301.9315370721157,0.4327235772357723,0.07049772608032945,0.17309447382468612,130501.95448133661,-319.4688585069638,130182.48562282964,374,0,159.78048780487805,39,2,12,36.84467071057191,0.6199252136752137,44.55729166666666,1021.7708333333318,26.199252136752097,0
385,4,0,0,40,0.0,0.0,1.0,40,700,500,200,0.7142857142857143,9,5,4,310.33117441181435,0.4296875,0.06731091118317845,0.17731355028108362,130371.67302441722,91.67887994007614,130463.3519043573,375,1,164.775,38,2,21,36.761603375527415,0.6203399122807017,44.68482905982905,1021.2606837606821,26.875281151596898,0
386,4,0,1,39,0.0,0.025,0.975,40,1650,1300,350,0.7878787878787878,20,13,7,313.2750679590813,0.4299011752136752,0.056471418121015526,0.18026032022251642,130644.5883213711,185.53845697274363,130830.12677834385,376,2,165.775,38,2,16,36.41097990037272,0.6230811403508771,44.41773504273504,1022.3290598290594,26.903396311291036,0
387,4,0,1,38,0.0,0.02564102564102564,0.9743589743589743,39,1750,1400,350,0.8,21,14,7,318.7319432242241,0.42830634278002694,0.05267875308621628,0.1837140978064967,130710.70545744855,532.3354301323619,131243.04088758092,377,3,168.23076923076923,37,2,17,36.20478590320967,0.6255630630630631,44.3530701754386,1022.5877192982465,27.637505926979635,0
388,4,0,0,38,0.0,0.0,1.0,38,800,500,300,0.625,11,5,6,326.2208913296341,0.42643136557610245,0.07402836682194214,0.18851085094391842,130809.2129291455,934.5396071747591,131743.75253632027,378,4,173.21052631578948,36,2,18,35.91387788052253,0.6284722222222222,44.256756756756765,1022.9729729729742,28.41591591591595,0
389,4,0,2,36,0.0,0.05263157894736842,0.9473684210526316,38,900,600,300,0.6666666666666666,12,6,6,325.2399166993956,0.42574976292081557,0.08271925126152246,0.1886957503038446,130963.11034404821,918.8862197984022,131881.99656384662,379,5,174.21052631578948,37,1,18,35.783677021960365,0.6280968468468469,44.10635964912281,1023.574561403509,27.664177335229976,0
390,4,0,0,36,0.0,0.0,1.0,36,1150,800,350,0.6956521739130435,15,8,7,339.24197214975163,0.4219080687830688,0.09819801133863826,0.19611247821004935,130824.41332572441,1676.226396390597,132500.639722115,380,6,182.80555555555554,35,1,19,35.56550986159822,0.6306547619047619,44.241898148148145,1023.032407407407,29.229497354497344,0
391,4,0,0,36,0.0,0.0,1.0,36,850,700,150,0.8235294117647058,10,7,3,340.77809529184145,0.4217261904761905,0.09380105054160759,0.19745477841221867,130913.2332926095,1722.4724579903739,132635.70575059988,381,7,183.80555555555554,35,1,20,35.436458568951224,0.631547619047619,44.15509259259258,1023.3796296296277,29.239417989417934,0
392,4,0,0,36,0.0,0.0,1.0,36,1050,700,350,0.6666666666666666,14,7,7,339.90773196189286,0.4209821428571428,0.09008542176998979,0.19740537683538673,131002.0834003129,1705.724210176613,132707.80761048952,382,8,184.80555555555554,35,1,21,35.36897022800076,0.6324404761904762,44.06828703703704,1023.7268518518516,29.249338624338616,0
393,4,0,0,36,0.0,0.0,1.0,36,850,500,350,0.5882352941176471,12,5,7,338.29122099087994,0.42027116402116405,0.08614627285513343,0.19692110021890158,131090.9636488339,1669.3844307270065,132760.3480795609,383,9,185.80555555555554,35,1,21,35.32059975889089,0.6333333333333333,43.981481481481474,1024.074074074073,29.259259259259228,0
394,4,0,0,36,0.0,0.0,1.0,36,1050,700,350,0.6666666666666666,14,7,7,338.24613240397497,0.419890873015873,0.0860511681040439,0.19735112181328812,131179.87403817291,1674.2170085305154,132854.09104670343,384,10,186.80555555555554,35,1,21,35.23201239031373,0.6342261904761906,43.894675925925924,1024.4212962962956,29.269179894179874,0
395,4,1,0,37,0.02702702702702703,0.0,1.0,37,600,400,200,0.6666666666666666,8,4,4,329.7803550887838,0.4209834834834835,0.08637912260528235,0.19390734747456614,131476.45968632115,1271.754436728398,132748.21412304955,385,0,182.72972972972974,35,2,22,35.14993134710155,0.637202380952381,43.605324074074076,1025.5787037037037,29.302248677248677,0
396,4,0,0,37,0.0,0.0,1.0,37,1300,800,500,0.6153846153846154,18,8,10,327.49917907749875,0.42082707707707706,0.08544716797570162,0.19327542226387104,131616.85333982628,1220.8822843113312,132837.73562413763,386,1,183.72972972972974,36,1,15,35.06708187006146,0.6365740740740741,43.468468468468465,1026.1261261261259,28.503503503503495,0
397,4,1,1,37,0.02631578947368421,0.02631578947368421,0.9736842105263158,38,1150,800,350,0.6956521739130435,15,8,7,322.1763358640963,0.42158605974395447,0.094188736887032,0.1920761208472207,132003.3327562326,905.6700138504057,132909.002770083,387,0,179.8684210526316,37,1,17,34.81514084507043,0.6385135135135135,43.09210526315789,1027.6315789473676,27.773826458036964,0
398,4,0,0,37,0.0,0.0,1.0,37,850,600,250,0.7058823529411765,11,6,5,331.5364533683618,0.4205455455455456,0.10318548685671947,0.19760092338251461,131992.67415641985,1352.076612085045,133344.7507685049,388,1,185.67567567567568,36,1,19,34.58538812785386,0.6403356481481481,43.10247747747747,1027.5900900900895,28.54416916916915,0
399,4,0,0,37,0.0,0.0,1.0,37,1500,1100,400,0.7333333333333333,19,11,8,334.50599471735916,0.41985735735735735,0.10590641007809531,0.2005937787100221,132224.21481870368,1445.9585007304372,133670.1733194341,389,2,186.67567567567568,36,1,20,34.27634220227015,0.642650462962963,42.87725225225224,1028.4909909909895,28.569194194194154,0
400,4,0,0,37,0.0,0.0,1.0,37,950,500,450,0.5263157894736842,14,5,9,334.8924579270703,0.4197947947947948,0.1019725943105978,0.20128799313300755,132311.09487866238,1461.9975549874102,133773.09243364978,390,3,187.67567567567568,36,1,20,34.17911741097489,0.6435185185185186,42.79279279279279,1028.8288288288284,28.578578578578565,0
401,4,0,0,37,0.0,0.0,1.0,37,800,500,300,0.625,11,5,6,336.4241206680468,0.41963838838838835,0.09927559166915634,0.20236387034522324,132340.06123944875,1504.477746327395,133844.53898577616,391,4,188.67567567567568,36,1,20,34.110621648243416,0.6438078703703703,42.76463963963963,1028.9414414414402,28.581706706706672,0
402,4,0,0,37,0.0,0.0,1.0,37,800,300,500,0.375,13,3,10,336.21139261024496,0.419263013013013,0.1087279522355411,0.20302785724834538,132487.35592689033,1508.764369486309,133996.12029637664,392,5,189.67567567567568,35,2,21,33.968170320404724,0.6473214285714286,42.62152777777777,1029.513888888888,29.414682539682513,0
403,4,0,1,36,0.0,0.02702702702702703,0.972972972972973,37,1500,1200,300,0.8,18,12,6,339.9916038244846,0.4185122622622623,0.11534608074711405,0.20645329176299862,132695.96220207465,1623.1026020233026,134319.06480409796,393,6,190.67567567567568,35,2,18,33.66144312139593,0.6494047619047619,42.418981481481474,1030.3240740740732,29.437830687830665,0
404,4,0,0,36,0.0,0.0,1.0,36,900,400,500,0.4444444444444444,14,4,10,349.48110949948074,0.4180224867724868,0.1121575122615106,0.21209042928530883,132673.81660997716,2073.3985260770805,134747.21513605423,394,7,191.91666666666666,34,2,18,33.43925737616516,0.6513480392156863,42.44047619047618,1030.238095238094,30.301120448179237,0
405,4,0,0,36,0.0,0.0,1.0,36,900,700,200,0.7777777777777778,11,7,4,381.86054526681926,0.4178406084656085,0.0769822168739136,0.21412018428928925,129637.82709775081,2735.7624544915902,132373.5895522424,395,8,192.91666666666666,33,3,16,35.682410750100274,0.6231060606060606,45.40441176470588,1018.382352941176,30.860071301247757,8
406,4,0,0,36,0.0,0.0,1.0,36,950,600,350,0.631578947368421,13,6,7,362.3999968672539,0.4174437830687831,-0.03380287542591187,0.19616550437713298,128240.42986685032,2187.739209887489,130428.1690767378,396,9,193.91666666666666,32,4,22,37.603621291448526,0.611328125,46.78030303030303,1012.8787878787879,31.65246212121212,8
407,4,0,0,36,0.0,0.0,1.0,36,1150,900,250,0.782608695652174,14,9,5,360.19744853177264,0.4167989417989418,-0.03339980059820524,0.19528542750128006,128304.38220589742,2042.9822212019292,130347.36442709935,397,10,194.91666666666666,32,4,22,37.593988866733156,0.6119791666666667,46.71717171717172,1013.1313131313136,31.66035353535355,0
408,4,0,0,36,0.0,0.0,1.0,36,800,500,300,0.625,11,5,6,359.75753340903134,0.4170469576719577,-0.029543094496365496,0.19520312411139126,128336.36435376493,2033.9947773186434,130370.35913108358,398,11,195.91666666666666,32,4,23,37.57242990654206,0.6123046875,46.68560606060606,1013.2575757575759,31.664299242424246,0
409,4,0,0,36,0.0,0.0,1.0,36,1200,900,300,0.75,15,9,6,355.70461845878657,0.4159887566137566,-0.021858473598024286,0.19448631648625048,128641.33536380215,1951.6634227219965,130592.99878652414,399,12,196.91666666666666,33,3,20,37.363594265925734,0.6130050505050505,46.38480392156861,1014.4607843137236,30.741235888294653,0
410,4,0,0,36,0.0,0.0,1.0,36,1300,1000,300,0.7692307692307693,16,10,6,354.2522515092936,0.41514550264550265,-0.015067675426241323,0.19445138497359007,128796.78376405682,1925.3101271145317,130722.09389117135,400,13,197.91666666666666,33,3,20,37.24181556601875,0.6145833333333333,46.231617647058805,1015.0735294117625,30.75980392156856,0
411,4,1,0,37,0.02702702702702703,0.0,1.0,37,850,400,450,0.47058823529411764,13,4,9,345.23562185919087,0.41835585585585583,-0.009748593891936386,0.19130220474079304,129171.13272392245,1518.8952664398557,130690.0279903623,401,0,193.54054054054055,34,3,22,37.08938400281062,0.6161151960784313,45.86309523809521,1016.5476190476154,29.898459383753394,0
412,4,0,0,37,0.0,0.0,1.0,37,1350,1100,250,0.8148148148148148,16,11,5,346.58978577281937,0.4185122622622623,-0.00819384291232561,0.19264258554698688,129292.1786422899,1562.269699546444,130854.44834183635,402,1,194.54054054054055,34,3,22,36.93179601232979,0.6173406862745099,45.7440476190476,1017.0238095238067,29.912464985994315,0
413,4,0,0,37,0.0,0.0,1.0,37,650,500,150,0.7692307692307693,8,5,3,346.36785051157597,0.41769894894894893,-0.007527714958961207,0.19281519756491294,129352.72285997709,1560.7249149659576,130913.44777494305,403,2,195.54054054054055,34,3,22,36.8758533255315,0.617953431372549,45.684523809523796,1017.2619047619029,29.91946778711479,0
414,4,0,1,36,0.0,0.02702702702702703,0.972972972972973,37,1300,600,700,0.46153846153846156,20,6,14,347.1128041152609,0.4173861361361361,-0.007525953471899882,0.19352727571905642,129413.28124999991,1584.2013888888732,130997.48263888879,404,3,196.54054054054055,34,3,22,36.795318045318034,0.6185661764705883,45.62499999999999,1017.4999999999993,29.926470588235276,0
415,4,1,1,36,0.02702702702702703,0.02702702702702703,0.972972972972973,37,1000,700,300,0.7,13,7,6,343.06066231130984,0.4177302302302302,-0.02707516064595339,0.184333552045742,127945.07345183016,1378.584327570805,129323.65777940096,405,0,195.6216216216216,36,1,15,38.39510982487383,0.599537037037037,47.07207207207207,1011.7117117117114,28.103103103103095,8
416,4,1,0,37,0.02702702702702703,0.0,1.0,37,1200,800,400,0.6666666666666666,16,8,8,343.11512689128523,0.4182932932932933,-0.013103101989519361,0.1850187087957866,128087.52745566513,1389.7536472283048,129477.28110289344,406,0,196.48648648648648,36,1,17,38.248136611413926,0.6009837962962963,46.931306306306304,1012.2747747747749,28.118743743743746,0
417,4,1,1,37,0.02631578947368421,0.02631578947368421,0.9736842105263158,38,1250,1000,250,0.8,15,10,5,335.8734223864251,0.42216394025604553,-0.016575263976426058,0.18280124234114842,128458.27880245095,1029.1570286502617,129487.43583110122,407,0,192.28947368421052,36,2,16,38.05311782566837,0.6047453703703703,46.56531531531531,1013.7387387387375,28.159409409409378,0
418,4,0,0,37,0.0,0.0,1.0,37,1200,1000,200,0.8333333333333334,14,10,4,343.866992503667,0.4181994494494494,-0.009665294433505611,0.18705510064267755,128437.66744898801,1433.0948859739017,129870.76233496191,408,2,198.48648648648648,35,2,17,37.871565045291945,0.6065476190476191,46.58564814814813,1013.6574074074047,28.961640211640134,0
419,4,0,0,37,0.0,0.0,1.0,37,950,600,350,0.631578947368421,13,6,7,347.51362508396085,0.41735485485485485,-0.004052666154686468,0.18973594371406527,128584.3611352238,1536.9634934413568,130121.32462866516,409,3,199.48648648648648,35,2,17,37.6294505306402,0.6080357142857142,46.44097222222222,1014.2361111111113,28.978174603174608,0
420,4,2,0,39,0.05128205128205128,0.0,1.0,39,1400,900,500,0.6428571428571429,19,9,10,337.89588376375195,0.4217273954116059,0.01979278135861806,0.18751098325202092,129229.25954380186,933.2069723376356,130162.4665161395,410,0,190.2051282051282,37,2,19,37.21680775728819,0.6106418918918919,45.805921052631575,1016.776315789473,27.48044096728305,0
421,4,0,0,39,0.0,0.0,1.0,39,1650,1200,450,0.7272727272727273,21,12,9,340.28632766223336,0.4207152496626181,0.017208259743562104,0.1893723012431036,129340.77222077938,1002.5792792012791,130343.35149998066,411,1,191.2051282051282,37,2,19,37.04266375624303,0.6117680180180181,45.696271929824555,1017.214912280701,27.492294926505433,0
422,4,0,1,38,0.0,0.02564102564102564,0.9743589743589743,39,750,500,250,0.6666666666666666,10,5,5,336.9509884066587,0.4203778677462888,0.017948717948717663,0.18791497430371348,129424.43828870419,921.9384810710908,130346.37676977528,412,2,192.2051282051282,37,2,19,37.04247485632182,0.6126126126126126,45.614035087719294,1017.5438596491225,27.50118539592223,0
423,4,0,1,37,0.0,0.02631578947368421,0.9736842105263158,38,1300,900,400,0.6923076923076923,17,9,8,343.67325710006844,0.41965979137031767,0.02513299189521412,0.19127544863739512,129344.54038075249,1290.4518961529193,130634.99227690541,413,3,197.26315789473685,36,2,19,36.952701206686584,0.6137152777777778,45.69256756756757,1017.2297297297307,28.25638138138141,0
424,4,0,1,36,0.0,0.02702702702702703,0.972972972972973,37,1200,900,300,0.75,15,9,6,349.71332649689214,0.4194194194194194,0.030853836234108423,0.19463712127211535,129344.54038075259,1646.7018961529336,130991.24227690553,414,4,201.56756756756758,36,1,19,36.79909775268459,0.6137152777777778,45.69256756756758,1017.2297297297315,28.25638138138143,0
425,4,0,0,36,0.0,0.0,1.0,36,850,600,250,0.7058823529411765,11,6,5,355.5210891287266,0.41964285714285715,0.029200333826486125,0.1975941688914689,129289.65627411277,1993.039882330264,131282.69615644304,415,5,201.47222222222223,35,1,20,36.707280641857295,0.6151785714285714,45.746527777777786,1017.0138888888898,29.05753968253971,0
426,4,0,0,36,0.0,0.0,1.0,36,1150,700,450,0.6086956521739131,16,7,9,356.8147222347356,0.41904761904761906,0.027720914363698723,0.19920456207047832,129466.28146701407,2039.095052083358,131505.37651909742,416,6,202.47222222222223,35,1,16,36.49458375980895,0.6169642857142856,45.57291666666668,1017.7083333333348,29.077380952380995,0
427,4,0,0,36,0.0,0.0,1.0,36,750,500,250,0.6666666666666666,10,5,5,358.3360165571972,0.4187665343915344,0.028687282097923372,0.2005040459056686,129554.63927469152,2084.8186728395285,131639.45794753105,417,7,203.47222222222223,35,1,17,36.36596180081855,0.6178571428571429,45.48611111111112,1018.0555555555569,29.087301587301624,0
428,4,0,0,36,0.0,0.0,1.0,36,950,700,250,0.7368421052631579,12,7,5,356.09917355371874,0.41807208994708994,0.03164141414141386,0.19985157699443418,129672.49657064493,2035.253772290832,131707.75034293576,418,8,204.47222222222223,35,1,17,36.30303030303029,0.6190476190476191,45.37037037037038,1018.5185185185202,29.100529100529148,0
429,4,0,0,36,0.0,0.0,1.0,36,650,400,250,0.6153846153846154,9,4,5,376.21605784610244,0.41762566137566143,0.09565055952472412,0.1931836065081937,126101.95500042856,2288.316079389558,128390.2710798181,419,9,205.47222222222223,35,1,19,39.453695167857404,0.5827380952380952,48.900462962962955,1004.3981481481472,28.69708994708992,8
430,4,0,1,35,0.0,0.027777777777777776,0.9722222222222222,36,850,700,150,0.8235294117647058,10,7,3,374.2831829927261,0.41785714285714287,0.044366005047404844,0.18509632820132066,124540.86356509506,2176.749303078457,126717.61286817351,420,10,206.47222222222223,33,3,18,41.119679762635556,0.5710227272727273,50.459558823529406,998.1617647058815,30.24732620320853,8
431,4,5,0,40,0.125,0.0,1.0,40,1400,1200,200,0.8571428571428571,16,12,4,352.4388354195005,0.42743055555555554,0.11607883817427389,0.18071863688531808,126043.83680555537,885.3933883602215,126929.23019391559,421,0,186.35,36,4,21,40.11065006915628,0.580150462962963,48.95833333333332,1004.1666666666652,27.893518518518476,0
432,4,2,3,39,0.047619047619047616,0.07142857142857142,0.9285714285714286,42,800,500,300,0.625,11,5,6,335.01676980155935,0.43206784746418897,0.1234464905095618,0.17393538798186745,126553.94500146057,79.53877200667233,126633.48377346725,422,0,178.42857142857142,38,4,18,40.02353649040842,0.5816885964912281,48.45085470085468,1006.1965811965774,26.47885739990993,0
433,4,1,1,39,0.025,0.025,0.975,40,850,600,250,0.7058823529411765,11,6,5,342.8783832998944,0.4267895299145299,0.08120033575825425,0.1780138497841112,126553.21865361973,679.6140300937042,127232.83268371344,423,0,188.275,36,4,15,39.8265249020705,0.5853587962962963,48.45157657657657,1006.1936936936928,27.949824824824802,8
434,4,2,1,40,0.04878048780487805,0.024390243902439025,0.975609756097561,41,1200,800,400,0.6666666666666666,16,8,8,345.30516610765994,0.42827743902439025,0.11749974797986029,0.18141346841107553,127036.7384676053,573.2884156663504,127610.02688327165,424,0,184.6341463414634,37,4,18,39.26881661953449,0.5884009009009009,47.97149122807017,1008.1140350877183,27.246325272641037,0
435,4,4,2,42,0.09090909090909091,0.045454545454545456,0.9545454545454546,44,1350,800,550,0.5925925925925926,19,8,11,320.12064127202706,0.4353528012684989,0.13183066669227705,0.1715890141721972,127847.2279293591,-614.6686362202622,127232.55929313884,425,0,172.88636363636363,38,6,16,39.075154940488765,0.5948464912280702,47.16880341880341,1011.3247863247843,26.61381016644169,0
436,4,0,1,41,0.0,0.023809523809523808,0.9761904761904762,42,1250,800,450,0.64,17,8,9,334.4814518819685,0.4281237901664731,0.12092054649157702,0.17858245274483484,127688.85598013584,141.91078747670275,127830.76676761254,426,1,182.0952380952381,36,6,16,38.87395543175489,0.5969328703703703,47.32545045045047,1010.6981981982005,28.074949949950014,0
437,4,0,1,40,0.0,0.024390243902439025,0.975609756097561,41,1400,1000,400,0.7142857142857143,18,10,8,334.96345222670266,0.4274390243902439,0.11925205424398921,0.17972770178615585,127888.1140430974,367.56883572765014,128255.68287882506,427,2,183.0487804878049,36,5,17,38.65810324352408,0.5989583333333333,47.12837837837839,1011.4864864864885,28.0968468468469,0
438,4,1,0,41,0.024390243902439025,0.0,1.0,41,1250,1000,250,0.8,15,10,5,330.10988948679545,0.4275914634146341,0.14360650371305095,0.17887890140577736,128283.34349270938,269.5200686749878,128552.86356138437,428,0,183.4878048780488,37,4,20,38.3775074863802,0.6010698198198199,46.73793859649123,1013.0482456140357,27.379682313892857,0
439,4,0,0,41,0.0,0.0,1.0,41,1500,1000,500,0.6666666666666666,20,10,10,329.11900985169945,0.42662601626016255,0.1525992955981481,0.17908800742077471,128450.0173731341,255.06850665590278,128705.08587979001,429,1,184.4878048780488,37,4,16,38.23271588245898,0.602759009009009,46.573464912280706,1013.7061403508777,27.397463252726425,0
440,4,1,0,42,0.023809523809523808,0.0,1.0,42,1150,800,350,0.6956521739130435,15,8,7,326.81838885263215,0.4283536585365854,0.16433633019615002,0.17950452779639964,128821.50472094398,20.247324494142504,128841.75204543812,430,0,181.07142857142858,38,4,18,37.91285168034803,0.6047149122807017,46.20726495726497,1015.1709401709414,26.715024741340564,0
441,4,0,2,40,0.0,0.047619047619047616,0.9523809523809523,42,900,600,300,0.6666666666666666,12,6,6,355.12989019160204,0.42841415021293067,0.13874904652936726,0.19065327028713752,127910.26341735241,792.1315954212893,128702.3950127737,431,1,182.07142857142858,35,7,18,38.12547673531655,0.6011904761904762,47.106481481481474,1011.574074074073,28.90211640211637,8
442,4,2,0,42,0.047619047619047616,0.0,1.0,42,850,500,350,0.5882352941176471,12,5,7,346.8556012115072,0.42831736353077815,0.1684075299333323,0.1875842720601582,128204.8061933105,493.9253607821571,128698.73155409266,432,0,182.85714285714286,34,8,20,38.03362916813606,0.6063112745098039,46.81547619047618,1012.7380952380939,29.78641456582629,0
443,4,0,0,42,0.0,0.0,1.0,42,1050,600,450,0.5714285714285714,15,6,9,347.4104564892896,0.4283657568718544,0.1687650383302559,0.18830974424992697,128295.24518140586,514.2219387755065,128809.46712018136,433,1,183.85714285714286,34,8,20,37.927193497845664,0.6072303921568627,46.726190476190474,1013.0952380952378,29.796918767506995,0
444,4,0,2,40,0.0,0.047619047619047616,0.9523809523809523,42,1450,1100,350,0.7586206896551724,18,11,7,350.8110139840902,0.42851093689508324,0.17685438217065985,0.1917421841025293,128627.12762188198,624.7626133786737,129251.89023526065,434,2,184.85714285714286,34,8,17,37.50220044595704,0.6106004901960784,46.39880952380952,1014.4047619047611,29.835434173669444,0
445,4,0,0,40,0.0,0.0,1.0,40,1300,1000,300,0.7692307692307693,16,10,6,367.623102960978,0.4234775641025641,0.17490325311404042,0.19959786200816318,128361.7647809736,1437.750054065736,129799.51483503933,435,7,195.0,33,7,22,37.34719534808723,0.6101641414141414,46.66053921568627,1013.3578431372543,30.707813428401646,0
446,4,2,0,42,0.047619047619047616,0.0,1.0,42,1300,900,400,0.6923076923076923,17,9,8,354.4074173609242,0.4285835269066976,0.2062841530054642,0.1965350223546945,129201.38888888895,760.7231893983123,129962.11207828726,436,0,186.66666666666666,34,8,20,36.8254781420765,0.616421568627451,45.833333333333336,1016.6666666666672,29.90196078431374,0
447,4,2,1,43,0.045454545454545456,0.022727272727272728,0.9772727272727273,44,1200,800,400,0.6666666666666666,16,8,8,337.68177653274887,0.43161997885835096,0.1990551442148305,0.19014825114155864,129803.15778193745,-33.567816126921144,129769.58996581053,437,0,179.13636363636363,36,8,19,36.63940766935574,0.6183449074074074,45.242117117117125,1019.0315315315324,28.306431431431456,0
448,4,1,0,44,0.022727272727272728,0.0,1.0,44,1600,1200,400,0.75,20,12,8,334.2132363788863,0.4317411028893587,0.19457545986412317,0.18958282456833633,130090.20580969493,-104.42625902928816,129985.77955066564,438,0,180.11363636363637,36,8,20,36.43683077602384,0.6212384259259259,44.96058558558559,1020.1576576576584,28.337712712712733,0
449,4,0,0,44,0.0,0.0,1.0,44,1550,1300,250,0.8387096774193549,18,13,5,336.3291825055095,0.43148784355179703,0.19520073834794593,0.19120546122113743,130176.38204082476,-43.576769336893705,130132.80527148786,439,1,181.11363636363637,36,8,20,36.295565732362235,0.6221064814814814,44.87612612612613,1020.4954954954967,28.34709709709713,0
450,4,1,1,44,0.022222222222222223,0.022222222222222223,0.9777777777777777,45,900,800,100,0.8888888888888888,10,8,2,329.16096777222276,0.4324915824915825,0.19534393867029176,0.18865934684759184,130492.60567577722,-409.3569921272482,130083.24868364997,440,0,178.06666666666666,36,9,16,36.15856570777768,0.6252893518518519,44.56644144144145,1021.7342342342349,28.381506506506526,0
451,4,0,0,44,0.0,0.0,1.0,44,1500,900,600,0.6,21,9,12,338.20902013502314,0.43143278717406625,0.19915393884466104,0.1937294627340587,130469.43486636208,25.18794474449186,130494.62281110657,441,3,183.11363636363637,35,9,21,35.95089403723426,0.6270833333333333,44.58912037037036,1021.6435185185167,29.189814814814763,0
452,4,0,0,44,0.0,0.0,1.0,44,1400,1100,300,0.7857142857142857,17,11,6,337.4872498865544,0.43119053911205074,0.19650044780267906,0.19390695535121388,130587.70743580656,14.337250300047543,130602.0446861066,442,4,184.11363636363637,35,9,17,35.849681991469446,0.6282738095238095,44.47337962962962,1022.1064814814799,29.203042328042283,0
453,4,0,1,43,0.0,0.022727272727272728,0.9772727272727273,44,1300,800,500,0.6153846153846154,18,8,10,339.93951460349615,0.43094829105003524,0.1965984959930871,0.19621459768459115,130765.21675936616,90.45286243995838,130855.66962180611,443,5,185.11363636363637,35,9,18,35.60750726113689,0.6300595238095238,44.299768518518505,1022.8009259259238,29.222883597883538,0
454,4,0,0,43,0.0,0.0,1.0,43,1250,1000,250,0.8,15,10,5,350.2489822514213,0.4291020671834625,0.19722901385493063,0.20176314611384677,130688.2812499999,554.6874999999857,131242.96874999988,444,6,189.65116279069767,34,9,18,35.42176039119804,0.6314338235294117,44.37499999999999,1022.4999999999992,30.07352941176468,0
455,4,0,1,42,0.0,0.023255813953488372,0.9767441860465116,43,1000,700,300,0.7,13,7,6,348.05746933616314,0.42884828349944626,0.1966567060759603,0.2009751193908812,130779.59183673454,503.76275510202333,131283.35459183657,445,7,190.65116279069767,34,9,19,35.385387569832396,0.6323529411764706,44.28571428571428,1022.8571428571416,30.084033613445342,0
456,4,0,0,42,0.0,0.0,1.0,42,1250,700,550,0.56,18,7,11,353.9344854340451,0.4274341850561363,0.20127691623018684,0.20428334823184943,130763.47588667826,856.3407103037352,131619.816596982,446,8,194.42857142857142,33,9,20,35.25141784487578,0.634469696969697,44.3014705882353,1022.7941176470594,30.99376114081998,0
457,4,1,1,42,0.023255813953488372,0.023255813953488372,0.9767441860465116,43,1200,1000,200,0.8333333333333334,14,10,4,347.9952082094071,0.4301633444075304,0.1203252789185294,0.19184843386944453,128969.02394614673,376.12046814068805,129345.14441428741,447,0,190.88372093023256,40,3,18,37.22507086876774,0.6028645833333333,46.061991869918714,1015.7520325203272,25.39380081300818,8
458,4,1,0,43,0.023255813953488372,0.0,1.0,43,1200,1000,200,0.8333333333333334,14,10,4,349.9667030734058,0.4303940568475452,0.025187880628154025,0.19156390657568478,128685.96734832702,407.57902275200746,129093.54637107902,448,0,191.62790697674419,38,5,17,37.463584991751766,0.6033442982456141,46.34081196581196,1014.6367521367513,26.700967161493455,8
459,4,1,0,44,0.022727272727272728,0.0,1.0,44,1150,800,350,0.6956521739130435,15,8,7,343.512426841472,0.4311244714587738,0.0390495444297454,0.19023803979109427,129148.44292534704,72.81901041664801,129221.26193576369,449,0,188.25,39,5,19,37.156264945002384,0.6063034188034189,45.88541666666666,1016.4583333333319,26.063034188034152,0
460,4,1,0,45,0.022222222222222223,0.0,1.0,45,750,400,350,0.5333333333333333,11,4,7,341.3009045290989,0.4330808080808081,0.051923390953413806,0.19057634329098425,129473.0771513622,-162.12262982597872,129310.95452153623,450,0,185.04444444444445,38,7,17,36.88239204982853,0.6112938596491229,45.566239316239304,1017.7350427350411,26.782501124606345,0
461,4,0,0,45,0.0,0.0,1.0,45,1400,1000,400,0.7142857142857143,18,10,8,340.15275846215656,0.43289141414141413,0.05833191276578842,0.19080169360209437,129651.86767578125,-179.71191406249983,129472.15576171875,451,1,186.04444444444445,39,6,18,36.73001687634244,0.6113782051282051,45.390625,1018.4375,26.11378205128205,0
462,4,0,0,45,0.0,0.0,1.0,45,1300,900,400,0.6923076923076923,17,9,8,340.48776194063777,0.4321759259259259,0.06670656293636501,0.1915673569706417,129770.27253123143,-162.96206788287566,129607.31046334855,452,2,187.04444444444445,40,5,18,36.601294966420625,0.6109375,45.27439024390244,1018.9024390243904,25.47256097560976,0
463,4,1,2,44,0.021739130434782608,0.043478260869565216,0.9565217391304348,46,1400,1100,300,0.7857142857142857,17,11,6,332.60308067680666,0.43548711755233493,0.07095023083557384,0.1887687683046512,130110.72137188207,-544.9546485260787,129565.76672335599,453,0,183.95652173913044,41,5,19,36.457117852975486,0.6128048780487805,44.94047619047619,1020.2380952380952,24.883855981416957,0
464,4,0,2,42,0.0,0.045454545454545456,0.9545454545454546,44,850,500,350,0.5882352941176471,12,5,7,335.0003623757011,0.4356941508104299,0.056586180686900356,0.1903764490274287,130161.33334120679,-79.18123267826269,130082.15210852852,454,1,177.52272727272728,41,3,19,36.34470801736988,0.6133130081300813,44.89087301587301,1020.4365079365074,24.888695315524572,0
465,4,0,1,41,0.0,0.023809523809523808,0.9761904761904762,42,1250,900,350,0.72,16,9,7,347.8773203799784,0.42953929539295393,0.05355562686581705,0.1973992164427296,130103.13042534744,651.9856770833572,130755.1161024308,455,2,186.42857142857142,39,3,19,36.07523313593355,0.6159188034188035,44.94791666666668,1020.2083333333351,26.15918803418808,0
466,4,1,1,41,0.023809523809523808,0.023809523809523808,0.9761904761904762,42,1500,1100,400,0.7333333333333333,19,11,8,344.1490102130191,0.43077332559039877,0.060134652657350074,0.19648763815481848,130342.35161675369,571.4382595486352,130913.78987630233,456,0,183.73809523809524,39,3,20,35.927883471046265,0.6183226495726496,44.71354166666668,1021.1458333333351,26.18322649572654,0
467,4,0,0,41,0.0,0.0,1.0,41,1000,700,300,0.7,13,7,6,343.53215588619474,0.42896341463414633,0.05825204081125057,0.19653887518203214,130422.14084201411,760.8398437500236,131182.98068576414,457,1,186.46341463414635,39,2,20,35.86282208171869,0.6191239316239316,44.63541666666668,1021.4583333333351,26.19123931623936,0
468,4,0,0,41,0.0,0.0,1.0,41,1200,700,500,0.5833333333333334,17,7,10,340.1530195009978,0.4288363821138212,0.055145322095423,0.19514041645057273,130528.56445312526,679.9370659722508,131208.5015190975,458,2,187.46341463414635,39,2,18,35.841403329935446,0.6201923076923077,44.531250000000014,1021.875000000002,26.20192307692313,0
469,4,0,1,40,0.0,0.024390243902439025,0.975609756097561,41,1350,1000,350,0.7407407407407407,17,10,7,336.49966224496484,0.4282520325203252,0.0558570377879819,0.19384276318055046,130688.28125000026,595.3125000000292,131283.5937500003,459,3,188.46341463414635,39,2,18,35.77322738386311,0.6217948717948718,44.375000000000014,1022.500000000002,26.21794871794877,0
470,4,1,0,41,0.024390243902439025,0.0,1.0,41,1400,1300,100,0.9285714285714286,15,13,2,337.72060492606516,0.4272611788617886,0.05797741984342375,0.1954878905237915,130874.74093967033,639.8193359375206,131514.56027560786,460,0,189.3658536585366,39,2,19,35.55356900471682,0.6236645299145299,44.19270833333334,1023.2291666666682,26.23664529914534,0
471,4,0,0,41,0.0,0.0,1.0,41,1000,600,400,0.6,14,6,8,337.26304417814384,0.4264481707317073,0.053665486787169536,0.1956284930398137,130954.6929253473,633.2356770833389,131587.92860243065,461,1,190.3658536585366,39,2,19,35.48451387475404,0.624465811965812,44.114583333333336,1023.5416666666673,26.244658119658137,0
472,4,0,2,39,0.0,0.04878048780487805,0.9512195121951219,41,750,400,350,0.5333333333333333,11,4,7,337.19725672133296,0.42571138211382115,0.0565218470089075,0.1961330789095089,131061.33355034718,638.7044270833287,131700.0379774305,462,2,191.3658536585366,39,2,19,35.37851814174297,0.625534188034188,44.010416666666664,1023.9583333333329,26.25534188034187,0
473,4,1,1,39,0.025,0.025,0.975,40,1350,1100,250,0.8148148148148148,16,11,5,393.1631505700243,0.422008547008547,0.03642151069087807,0.22352898242854108,130178.65022170286,2258.2623078735805,132436.91252957645,463,0,187.725,37,3,17,34.843285519859606,0.6202139639639639,44.87390350877193,1020.5043859649126,27.581199620673313,7
474,4,1,0,40,0.025,0.0,1.0,40,950,700,250,0.7368421052631579,12,7,5,389.1677605541303,0.42293002136752134,0.05024932003626503,0.22241038336331917,130380.7656035666,2148.052217040203,132528.8178206068,464,0,188.625,35,5,18,34.7395361136295,0.6261904761904762,44.67592592592593,1021.2962962962969,29.179894179894195,0
475,4,0,0,40,0.0,0.0,1.0,40,1100,500,600,0.45454545454545453,17,5,12,388.15683026428496,0.42234241452991456,0.04936377657816493,0.22313486689733458,130607.69120049098,2139.253484903819,132746.9446853948,465,1,189.625,36,4,17,34.534629650031206,0.6264467592592593,44.453828828828826,1022.1846846846843,28.39401901901901,0
476,4,0,0,40,0.0,0.0,1.0,40,900,400,500,0.4444444444444444,14,4,10,385.8092447736432,0.42140758547008544,0.04925393679110268,0.2224465874152033,130722.82745160689,2086.815066755936,132809.64251836282,466,2,190.625,36,4,17,34.47766398707925,0.6276041666666667,44.34121621621621,1022.6351351351341,28.406531531531503,0
477,4,0,0,40,0.0,0.0,1.0,40,1250,1000,250,0.8,15,10,5,394.61937269539595,0.4212740384615385,0.04705348299768941,0.2285472428096282,130895.626940285,2330.7900383491788,133226.41697863417,467,3,191.625,36,4,18,34.076840541432816,0.6293402777777778,44.172297297297305,1023.3108108108117,28.425300300300325,0
478,4,1,0,41,0.024390243902439025,0.0,1.0,41,1200,700,500,0.5833333333333334,17,7,10,383.9557435786326,0.42317073170731706,0.046953112151264964,0.22406611569363943,131187.67463306032,1874.0522324176877,133061.726865478,468,0,187.9268292682927,37,4,20,34.053458025616344,0.6303490990990991,43.88706140350878,1024.451754385966,27.687885253674757,0
479,4,1,0,42,0.023809523809523808,0.0,1.0,42,950,800,150,0.8421052631578947,11,8,3,377.4546364911261,0.4242039295392954,0.05611498002802384,0.22208377449361616,131501.32395909433,1527.3071732430144,133028.63113233735,469,0,184.42857142857142,36,6,21,33.90243009808227,0.6354166666666667,43.58108108108109,1025.6756756756765,28.490990990991016,0
480,4,0,1,41,0.0,0.023809523809523808,0.9761904761904762,42,850,700,150,0.8235294117647058,10,7,3,340.5974136483868,0.42436120789779325,0.02296424469338798,0.19709374202480964,130863.1260158704,520.421961639263,131383.54797750965,470,1,185.42857142857142,38,4,17,35.49171626466187,0.6252741228070176,44.20405982905983,1023.1837606837605,26.92588843904633,8
481,4,0,0,41,0.0,0.0,1.0,41,1150,800,350,0.6956521739130435,15,8,7,348.07424332760127,0.4212906504065041,0.018738399602646005,0.20121020385666155,130822.8553497229,907.2132771621973,131730.0686268851,471,2,190.90243902439025,37,4,18,35.34119328331548,0.6266891891891893,44.243421052631575,1023.0263157894728,27.649359886201967,0
482,4,0,0,41,0.0,0.0,1.0,41,1500,1100,400,0.7333333333333333,19,11,8,345.59404022385934,0.4210365853658537,0.02124345289745233,0.20006721981197587,130878.9483302553,846.196906740518,131725.14523699583,472,3,191.90243902439025,37,4,18,35.34790684383483,0.6272522522522522,44.18859649122806,1023.2456140350864,27.655286865813146,0
483,4,0,0,41,0.0,0.0,1.0,41,1250,900,350,0.72,16,9,7,340.11966075710035,0.42057926829268294,0.014824993320355473,0.19793849109634515,131081.84633875728,716.7026216304878,131798.54896038776,473,4,192.90243902439025,38,3,18,35.28299426186748,0.627467105263158,43.990384615384606,1024.0384615384605,26.948380566801593,0
484,4,0,2,39,0.0,0.04878048780487805,0.9512195121951219,41,800,300,500,0.375,13,3,10,340.8484511433477,0.42022357723577236,0.01666047538839699,0.19850384281045746,131109.19922017667,737.6734969683607,131846.87271714504,474,5,193.90243902439025,38,3,18,35.236716739689825,0.6277412280701755,43.96367521367521,1024.1452991452984,26.951192082771012,0
485,4,0,0,39,0.0,0.0,1.0,39,1150,700,450,0.6086956521739131,16,7,9,352.7803676317311,0.4176225820962663,0.024518596229991196,0.2050817840478069,131039.71370018672,1445.6476747017355,132485.36137488845,475,6,204.30769230769232,36,3,18,35.00146649068779,0.630787037037037,44.031531531531535,1023.8738738738742,28.44094094094095,0
486,4,0,0,39,0.0,0.0,1.0,39,1350,700,650,0.5185185185185185,20,7,13,350.0903500589391,0.4160200179937022,0.01597420678537409,0.2044365856762661,131212.72243527306,1387.2615859102264,132599.98402118328,476,7,205.30769230769232,36,3,19,34.895489851249366,0.6325231481481481,43.86261261261261,1024.549549549549,28.459709709709696,0
487,4,0,1,38,0.0,0.02564102564102564,0.9743589743589743,39,1200,700,500,0.5833333333333334,17,7,10,351.54643159038756,0.4159356725146199,0.015908706677937534,0.20559592078872277,131270.4173768364,1429.529360441533,132699.94673727793,477,8,206.30769230769232,36,3,19,34.79990842490842,0.6331018518518519,43.80630630630631,1024.7747747747756,28.46596596596599,0
488,4,0,0,38,0.0,0.0,1.0,38,1450,1100,350,0.7586206896551724,18,11,7,371.2890277542532,0.415881341868184,-0.0032736607611185686,0.20417305723507598,128868.76594387768,2050.477441554916,130919.2433854326,478,9,208.94736842105263,34,4,21,36.73594012584515,0.6130514705882353,46.16071428571429,1015.3571428571438,29.863445378151287,8
489,4,1,0,39,0.02564102564102564,0.0,1.0,39,1000,800,200,0.8,12,8,4,371.4343758391751,0.41942195231668916,0.06508922445460463,0.1919911100573854,126372.79620181426,1643.0130385487805,128015.80924036304,479,0,204.56410256410257,34,5,17,39.29424185018549,0.5876225490196079,48.630952380952394,1005.4761904761922,29.57282913165271,8
490,4,1,1,39,0.025,0.025,0.975,40,850,400,450,0.47058823529411764,13,4,9,361.53045671048096,0.4215544871794872,0.07569548223933831,0.1884333998157266,126713.00482521017,1162.1221011231337,127875.12692633331,480,0,200.425,35,5,18,39.192843047093554,0.5889880952380953,48.29282407407408,1006.8287037037047,28.76653439153442,0
491,4,3,2,40,0.07142857142857142,0.047619047619047616,0.9523809523809523,42,950,600,350,0.631578947368421,13,6,7,347.3709886450432,0.42584930313588854,0.1043269766923165,0.18442129397158735,127461.32270361604,455.8391138926102,127917.16181750865,481,0,188.88095238095238,36,6,17,38.7813185383443,0.5946180555555556,47.55067567567569,1009.7972972972993,28.04992492492498,0
492,4,0,3,37,0.0,0.075,0.925,40,1300,900,400,0.6923076923076923,17,9,8,352.69759787482184,0.42279647435897433,0.10513981205592504,0.18743235317026163,127500.81045310361,993.8459147805261,128494.65636788413,482,1,195.95,35,5,17,38.60636794254718,0.5970238095238095,47.511574074074076,1009.953703703704,28.855820105820115,0
493,4,2,0,39,0.05128205128205128,0.0,1.0,39,950,800,150,0.8421052631578947,11,8,3,346.89459984997586,0.4235267656320288,0.12014115617822285,0.18636789780507929,127939.53517500433,1076.3067719050105,129015.84194690935,483,0,196.97435897435898,35,4,19,38.30380295923425,0.6014880952380952,47.0775462962963,1011.6898148148152,28.905423280423292,0
494,4,0,1,38,0.0,0.02564102564102564,0.9743589743589743,39,900,600,300,0.6666666666666666,12,6,6,349.0561603381493,0.42327372919478184,0.11955058552336384,0.18780295445147327,127998.08873724709,1135.7042770490364,129133.79301429613,484,1,197.97435897435898,35,4,19,38.18924186968622,0.6020833333333333,47.019675925925924,1011.9212962962963,28.912037037037038,0
495,4,2,1,39,0.05,0.025,0.975,40,950,700,250,0.7368421052631579,12,7,5,333.6413625142217,0.4274839743589744,0.12475563700988523,0.1817164662259853,128486.8203296202,573.7035599788976,129060.52388959909,485,0,192.5,36,4,19,38.080593505868414,0.6050347222222222,46.53716216216216,1013.8513513513516,28.162537537537546,0
496,4,0,0,39,0.0,0.0,1.0,39,650,200,450,0.3076923076923077,11,2,9,344.12170747912046,0.4240609536662168,0.12891664690225868,0.18705610132803566,128408.33875868034,1037.6193576388653,129445.9581163192,486,1,198.43589743589743,35,4,19,37.89504110996918,0.60625,46.61458333333332,1013.5416666666649,28.958333333333282,0
497,4,0,0,39,0.0,0.0,1.0,39,1400,1200,200,0.8571428571428571,16,12,4,344.27844256316723,0.42459514170040485,0.12790360683955915,0.1874167109018506,128466.99948827557,1045.6837009173223,129512.68318919289,487,2,199.43589743589743,35,4,19,37.83120694904289,0.606845238095238,46.55671296296295,1013.7731481481455,28.964947089947014,0
498,4,0,1,38,0.0,0.02564102564102564,0.9743589743589743,39,1100,800,300,0.7272727272727273,14,8,6,345.17938488997805,0.42411718398560505,0.13314149354295335,0.18915830291970795,128731.13854595329,1087.0670438957354,129818.20558984902,488,3,200.43589743589743,35,4,19,37.53896745742091,0.6095238095238096,46.29629629629629,1014.8148148148143,28.99470899470898,0
499,4,2,1,39,0.05,0.025,0.975,40,1150,700,450,0.6086956521739131,16,7,9,330.5864400736179,0.4272702991452992,0.12641149119893758,0.1839918245955015,129344.5403807523,552.7675683065398,129897.30794905884,489,0,192.4,36,4,21,37.28550869035759,0.6137152777777778,45.692567567567565,1017.229729729729,28.25638138138136,0
500,4,0,0,39,0.0,0.0,1.0,39,1250,1100,150,0.88,14,11,3,340.1087956761293,0.42611336032388664,0.1259823225693537,0.18945223789563834,129377.95380015415,1000.516010802454,130378.46981095661,490,1,198.10256410256412,35,4,22,37.00938566552902,0.6160714285714286,45.659722222222214,1017.3611111111098,29.06746031746028,0
501,4,1,2,38,0.025,0.05,0.95,40,1200,900,300,0.75,15,9,6,339.74445092516976,0.42851228632478633,0.15260715863897523,0.19173109537248342,129889.23890106312,825.8296303059689,130715.06853136909,491,0,194.125,36,4,16,36.49953049049933,0.619212962962963,45.15765765765765,1019.3693693693684,28.31581581581579,0
502,4,1,0,39,0.02564102564102564,0.0,1.0,39,950,700,250,0.7368421052631579,12,7,5,348.6879655123103,0.42780026990553305,0.17524374981809765,0.1971720780592714,129967.37423911154,1263.6118612825505,131230.98610039408,492,0,199.97435897435898,35,4,18,36.192300416193724,0.6220238095238095,45.081018518518505,1019.6759259259238,29.133597883597822,0
503,4,0,0,39,0.0,0.0,1.0,39,1150,800,350,0.6956521739130435,15,8,7,348.9358704814408,0.4276034637876743,0.17116126442198643,0.1979099589719058,130085.41907793198,1278.2937885802335,131363.7128665122,493,1,200.97435897435898,35,4,18,36.066201497617435,0.6232142857142857,44.96527777777777,1020.1388888888879,29.146825396825367,0
504,4,0,1,38,0.0,0.02564102564102564,0.9743589743589743,39,1250,800,450,0.64,17,8,9,350.19728315205,0.4268162393162393,0.16915110440453462,0.1993795894201373,130233.05047850215,1321.4520908350391,131554.5025693372,494,2,201.97435897435898,35,4,19,35.88428865706618,0.624702380952381,44.82060185185185,1020.7175925925919,29.16335978835977,0
505,4,1,0,39,0.02564102564102564,0.0,1.0,39,1150,1000,150,0.8695652173913043,13,10,3,349.0062460968389,0.42954340980656774,0.17852008677696762,0.20021937276081828,130528.5644531251,1311.0568576389032,131839.621310764,495,0,201.25641025641025,35,4,18,35.61523105674483,0.6276785714285714,44.53125000000001,1021.8750000000008,29.196428571428594,0
506,4,0,1,38,0.0,0.02564102564102564,0.9743589743589743,39,1250,800,450,0.64,17,8,9,347.9051426693687,0.42889676113360325,0.1817073701623788,0.2005050186225617,130706.0335889274,1294.6602527006107,132000.693841628,496,1,202.25641025641025,35,4,19,35.46370967741936,0.6294642857142857,44.357638888888886,1022.5694444444439,29.216269841269824,0
507,4,0,0,38,0.0,0.0,1.0,38,1300,900,400,0.6923076923076923,17,9,8,355.61123513946643,0.42761676149834044,0.1816794548084233,0.20469097100386974,130657.85147392288,1692.679988662132,132350.53146258503,497,2,208.23684210526315,34,4,19,35.315508073280554,0.6311274509803921,44.404761904761905,1022.3809523809522,30.070028011204474,0
508,4,0,0,38,0.0,0.0,1.0,38,1150,600,550,0.5217391304347826,17,6,11,355.0268926271547,0.4272315078236131,0.18159487405664998,0.20499939929116356,130779.59183673469,1686.0544217687052,132465.6462585034,498,3,209.23684210526315,34,4,19,35.20716945996275,0.6323529411764706,44.285714285714285,1022.8571428571428,30.084033613445374,0
509,4,0,1,37,0.0,0.02631578947368421,0.9736842105263158,38,1200,800,400,0.6666666666666666,16,8,8,369.97434798758457,0.42649063537221427,0.13143368467536654,0.20971387009208609,130061.48674011827,2023.8827509942091,132085.36949111248,499,4,210.23684210526315,36,2,17,35.55397622727606,0.6209490740740741,44.988738738738725,1020.0450450450433,28.334584584584533,8
510,4,0,0,37,0.0,0.0,1.0,37,950,700,250,0.7368421052631579,12,7,5,375.916349152742,0.4232982982982983,0.05829117256712135,0.20738012548797075,128995.54887099189,2342.4518091156347,131338.0006801075,500,8,216.8108108108108,35,2,19,36.48895313508792,0.6122023809523809,46.035879629629626,1015.856481481481,29.024470899470884,8
511,4,1,1,37,0.02631578947368421,0.02631578947368421,0.9736842105263158,38,1100,800,300,0.7272727272727273,14,8,6,372.1723958231047,0.4242383831199621,0.06376771658260116,0.2066944797535902,129260.23046339164,2021.5820312499989,131281.81249464164,501,0,212.07894736842104,35,3,20,36.31392746035358,0.6148809523809524,45.77546296296296,1016.8981481481482,29.054232804232804,0
512,4,1,0,38,0.02631578947368421,0.0,1.0,38,800,600,200,0.75,10,6,4,367.0464126382636,0.4259275723091513,0.0866302864938604,0.2053778782166772,129554.6392746913,1910.5131172839433,131465.15239197525,502,0,212.52631578947367,35,3,15,36.14427012278306,0.6178571428571429,45.48611111111111,1018.0555555555552,29.087301587301578,0
513,4,0,1,37,0.0,0.02631578947368421,0.9736842105263158,38,850,500,350,0.5882352941176471,12,5,7,368.80909664981334,0.42569049312470364,0.08508233774620577,0.20729614742730887,129731.44531249999,1969.2274305555554,131700.67274305553,503,1,213.52631578947367,35,3,16,35.91939331970006,0.6196428571428572,45.3125,1018.7499999999999,29.107142857142854,0
514,4,0,1,36,0.0,0.02702702702702703,0.972972972972973,37,1100,900,200,0.8181818181818182,13,9,4,375.4588177485508,0.4237987987987988,0.08750526131451464,0.21024259832807135,129584.09857521,2330.6984900119987,131914.797065222,504,2,220.24324324324326,35,2,16,35.90014114660301,0.6181547619047619,45.457175925925924,1018.1712962962958,29.090608465608454,0
515,4,1,0,37,0.02702702702702703,0.0,1.0,37,1150,900,250,0.782608695652174,14,9,5,375.8348283923202,0.4246121121121121,0.09738572928756994,0.21124509319982138,129731.44531249999,2351.5190972222226,132082.96440972222,505,0,220.7027027027027,35,2,17,35.7404567143831,0.6196428571428572,45.3125,1018.7499999999999,29.107142857142854,0
516,4,1,0,38,0.02631578947368421,0.0,1.0,38,1050,900,150,0.8571428571428571,12,9,3,360.7562623443668,0.4253496917970602,0.1010606474247644,0.20494122213807564,130147.65346004788,1790.3162030273515,131937.96966307523,506,0,215.8684210526316,36,2,19,35.70154140455432,0.6218171296296297,44.90427927927928,1020.3828828828828,28.343968968968966,0
517,4,0,1,37,0.0,0.02631578947368421,0.9736842105263158,38,850,500,350,0.5882352941176471,12,5,7,360.2381500326602,0.4245791844476055,0.10321608390390069,0.20494904919937232,130205.11379200149,1780.9698634445303,131986.083655446,507,1,216.8684210526316,36,2,19,35.656423553643016,0.6223958333333333,44.847972972972975,1020.6081081081084,28.35022522522523,0
518,4,2,3,36,0.05128205128205128,0.07692307692307693,0.9230769230769231,39,1050,900,150,0.8571428571428571,12,9,3,347.9525371386821,0.4260571300044984,0.09850596897562336,0.2005565736313566,130710.70545744848,1296.2243190212366,132006.9297764697,508,0,204.35897435897436,37,2,16,35.4577703910215,0.6255630630630631,44.353070175438596,1022.5877192982459,27.63750592697962,0
519,4,0,1,35,0.0,0.027777777777777776,0.9722222222222222,36,750,500,250,0.6666666666666666,10,5,5,371.1656129110883,0.4220238095238095,0.09851666083440258,0.2111481618770246,130201.83000283445,2465.288407029476,132667.11840986394,509,3,220.72222222222223,34,2,20,35.38094404914654,0.626531862745098,44.851190476190474,1020.595238095238,30.017507002801118,0
520,4,1,0,36,0.027777777777777776,0.0,1.0,36,1100,800,300,0.7272727272727273,14,8,6,365.29903662770795,0.42627314814814815,0.09330484330484334,0.20895104895104893,130414.54081632647,2328.0612244897884,132742.60204081624,510,0,210.58333333333334,34,2,21,35.31468531468531,0.6286764705882353,44.64285714285714,1021.4285714285709,30.04201680672267,0
521,4,0,0,36,0.0,0.0,1.0,36,1100,800,300,0.7272727272727273,14,8,6,367.6800077710927,0.4258267195767196,0.09896500834983901,0.21080811667997923,130505.75573979596,2396.871456916104,132902.62719671207,511,1,211.58333333333334,34,2,16,35.16131694434735,0.6295955882352942,44.55357142857143,1021.7857142857147,30.052521008403374,0
522,4,1,1,36,0.02702702702702703,0.02702702702702703,0.972972972972973,37,700,500,200,0.7142857142857143,9,5,4,360.06203475516855,0.42783408408408413,0.1074294518475043,0.20846813682190213,130883.62328800153,2025.2447434413607,132908.8680314429,512,0,206.83783783783784,35,2,17,34.97306582965728,0.63125,44.18402777777778,1023.2638888888888,29.236111111111107,0
523,4,1,0,37,0.02702702702702703,0.0,1.0,37,700,500,200,0.7142857142857143,9,5,4,361.2480324209421,0.4269894894894895,0.11751120398119341,0.2101223762543114,131061.33355034734,2069.129774305566,133130.4633246529,513,0,207.75675675675674,35,2,18,34.76284333672431,0.6330357142857144,44.01041666666667,1023.9583333333343,29.255952380952408,0
524,4,0,0,37,0.0,0.0,1.0,37,1300,1000,300,0.7692307692307693,16,10,6,364.9874546006443,0.4270207707707708,0.11397836982648824,0.21262501552081006,131120.5970963007,2171.474595979098,133292.0716922798,514,1,208.75675675675674,35,2,18,34.60713545786719,0.6336309523809525,43.952546296296305,1024.189814814816,29.262566137566168,0
525,4,0,1,36,0.0,0.02702702702702703,0.972972972972973,37,950,700,250,0.7368421052631579,12,7,5,361.7444103045458,0.4263638638638639,0.1156958200436462,0.2117149209019667,131298.46810967525,2099.297384044949,133397.7654937202,515,2,209.75675675675674,35,2,18,34.5102813852814,0.6354166666666667,43.7789351851852,1024.8842592592607,29.282407407407447,0
526,4,1,0,37,0.02702702702702703,0.0,1.0,37,1200,1000,200,0.8333333333333334,14,10,4,362.79217932053484,0.4237987987987988,0.119826631732737,0.21331794963233328,131476.4596863213,2139.7262677897984,133616.1859541111,516,0,210.45945945945945,35,2,20,34.30352574953918,0.637202380952381,43.60532407407408,1025.5787037037048,29.30224867724871,0
527,4,0,1,36,0.0,0.02702702702702703,0.972972972972973,37,1300,800,500,0.6153846153846154,18,8,10,363.85709394072006,0.42317317317317316,0.1152763047215013,0.2151123139377538,131684.2689043211,2182.85108024693,133867.11998456804,517,1,211.45945945945945,35,2,16,34.06630581867389,0.6392857142857142,43.402777777777786,1026.3888888888898,29.32539682539685,0
528,4,0,0,36,0.0,0.0,1.0,36,1250,900,350,0.72,16,9,7,376.320613463745,0.42071759259259256,0.12281329362777305,0.22200597997563448,131602.8220663266,2704.9709467120256,134307.7930130386,518,5,218.30555555555554,34,2,16,33.828847120702314,0.640625,43.48214285714286,1026.0714285714291,30.178571428571445,0
529,4,0,0,36,0.0,0.0,1.0,36,900,500,400,0.5555555555555556,13,5,8,374.31834453948886,0.4207837301587301,0.12077855117298264,0.2210016527349587,131633.3616780047,2654.556405895714,134287.9180839004,519,6,219.30555555555554,34,2,16,33.84933294663574,0.6409313725490196,43.45238095238096,1026.1904761904775,30.18207282913169,0
530,4,2,0,38,0.05263157894736842,0.0,1.0,38,1200,800,400,0.6666666666666666,16,8,8,363.44528181198035,0.422475106685633,0.12403667044084932,0.21913165317617717,132428.6352040815,2030.5413832199447,134459.17658730145,520,0,208.71052631578948,34,4,20,33.326345516231015,0.6488970588235294,42.67857142857142,1029.2857142857133,30.27310924369745,0
531,4,0,1,37,0.0,0.02631578947368421,0.9736842105263158,38,1050,600,450,0.5714285714285714,15,6,9,363.8836556297737,0.4219713134186818,0.12761743067345788,0.2199321968932154,132520.55165816317,2044.4125566893304,134564.9642148525,521,1,209.71052631578948,34,4,21,33.22253054303002,0.6498161764705883,42.58928571428571,1029.6428571428564,30.28361344537813,0
532,4,1,1,37,0.02631578947368421,0.02631578947368421,0.9736842105263158,38,1150,800,350,0.6956521739130435,15,8,7,365.85944872032337,0.41740753911806544,0.13111059748064258,0.22184876032073964,132643.1565334466,2105.7504251700534,134748.90695861666,522,0,210.47368421052633,34,4,18,33.04826842328288,0.6510416666666667,42.47023809523809,1030.1190476190466,30.297619047619015,0
533,4,0,0,37,0.0,0.0,1.0,37,750,300,450,0.4,12,3,9,371.1782006101409,0.4173861361361361,0.13183115266200618,0.22417455523549926,132492.61289227704,2435.6739294982717,134928.2868217753,523,3,217.16216216216216,33,4,21,33.062904217751864,0.6518308080808081,42.61642156862745,1029.5343137254904,31.198009506833042,0
534,4,0,1,36,0.0,0.02702702702702703,0.972972972972973,37,1200,800,400,0.6666666666666666,16,8,8,371.5036714255688,0.4164164164164164,0.13285233841979038,0.22531456435810476,132650.3703503461,2456.0199202230015,135106.3902705691,524,4,218.16216216216216,33,4,19,32.89564993258784,0.6534090909090908,42.46323529411765,1030.14705882353,31.216577540106968,0
535,4,0,0,36,0.0,0.0,1.0,36,1350,1000,350,0.7407407407407407,17,10,7,370.62758361220875,0.4146990740740741,0.12914206849188403,0.22611239020518598,132871.38848339595,2649.1603289600316,135520.54881235596,525,5,222.36111111111111,33,3,19,32.69580312215223,0.6556186868686869,42.24877450980393,1031.0049019607854,31.242572786690467,0
536,4,0,1,35,0.0,0.027777777777777776,0.9722222222222222,36,850,500,350,0.5882352941176471,12,5,7,368.1460896499874,0.41435185185185186,0.12625422475707637,0.22516842227429493,132966.16685890066,2590.1948769704236,135556.3617358711,526,6,223.36111111111111,33,3,19,32.664468472750315,0.6565656565656566,42.15686274509805,1031.3725490196098,31.25371360665484,0
537,4,0,0,35,0.0,0.0,1.0,35,950,600,350,0.631578947368421,13,6,7,378.3955622322699,0.4122198879551821,0.13937778984707805,0.23163312344065584,132997.76715986652,3065.1529760188523,136062.92013588536,527,7,230.57142857142858,33,2,19,32.368396301136585,0.6568813131313131,42.126225490196084,1031.4950980392166,31.257427213309594,0
538,4,0,0,35,0.0,0.0,1.0,35,900,700,200,0.7777777777777778,11,7,4,379.4073382701262,0.4114495798319328,0.13954387452310302,0.23383371067489508,133250.70473195412,3111.259040993853,136361.96377294796,528,8,231.57142857142858,33,2,20,32.08790801186943,0.6594065656565656,41.881127450980394,1032.475490196079,31.287136066547845,0
539,4,0,0,35,0.0,0.0,1.0,35,1550,1200,350,0.7741935483870968,19,12,7,379.1623309053069,0.4098039215686275,0.13778801843317967,0.2350806451612905,133472.22222222242,3121.527777777803,136593.75000000023,529,9,232.57142857142858,33,2,20,31.87163978494624,0.6616161616161615,41.66666666666668,1033.3333333333348,31.313131313131358,0
540,4,0,0,35,0.0,0.0,1.0,35,1000,700,300,0.7,13,7,6,385.4525552148113,0.41011904761904766,0.07963674467341963,0.22204238744064503,130688.28125000012,3074.826388888903,133763.10763888902,530,10,233.57142857142858,34,1,18,34.52186905732138,0.6314338235294117,44.37500000000001,1022.5000000000009,30.07352941176473,7
541,4,1,0,36,0.027777777777777776,0.0,1.0,36,750,400,350,0.5333333333333333,11,4,7,375.77623170689014,0.41400462962962964,0.07896125433438828,0.21806856910864428,130972.46334876555,2643.2677469135924,133615.73109567913,531,0,228.05555555555554,35,1,19,34.48100407055631,0.6321428571428571,44.09722222222223,1023.6111111111121,29.246031746031775,0
542,4,1,0,37,0.02702702702702703,0.0,1.0,37,800,500,300,0.625,11,5,6,366.63973904250315,0.4176363863863864,0.07766892263101477,0.21458445434249657,131299.26960321813,2227.905988759034,133527.17559197717,532,0,222.86486486486487,36,1,20,34.38404204666155,0.6333912037037037,43.778153153153156,1024.8873873873877,28.469094094094103,0
543,4,0,0,37,0.0,0.0,1.0,37,800,500,300,0.625,11,5,6,364.7886951296647,0.41741741741741745,0.07887815564492007,0.21399326234824956,131387.4488275891,2185.7343732464874,133573.1832008356,533,1,223.86486486486487,35,2,20,34.34230827124258,0.6363095238095238,43.692129629629626,1025.231481481481,29.29232804232803,0
544,4,0,1,36,0.0,0.02702702702702703,0.972972972972973,37,950,700,250,0.7368421052631579,12,7,5,369.01359356687215,0.41669794794794796,0.07881720781051138,0.2172815012152965,131530.20154867697,2307.2864672104465,133837.48801588741,534,2,224.86486486486487,36,1,20,34.08968236542614,0.6357060185185186,43.552927927927925,1025.7882882882877,28.494119119119105,0
545,4,0,1,35,0.0,0.027777777777777776,0.9722222222222222,36,800,600,200,0.75,10,6,4,368.02803473421125,0.4158730158730159,0.0806824591088553,0.2170704276725736,131595.18771701382,2486.143663194434,134081.33138020826,535,3,229.75,35,1,16,34.04928087986464,0.6383928571428572,43.48958333333333,1026.041666666666,29.315476190476172,0
546,4,0,0,35,0.0,0.0,1.0,35,1000,700,300,0.7,13,7,6,382.03375358407794,0.4142857142857143,0.08371985157699435,0.2262815309690312,131755.5555555558,3067.0138888889232,134822.56944444473,536,4,230.97142857142856,34,1,16,33.52780032467535,0.642156862745098,43.33333333333335,1026.6666666666688,30.196078431372612,0
547,4,0,1,34,0.0,0.02857142857142857,0.9714285714285714,35,850,400,450,0.47058823529411764,13,4,9,388.3676170719162,0.41414565826330535,0.08362450115087161,0.23058826101028398,131847.23816610003,3241.039540816358,135088.2777069164,537,5,231.97142857142856,34,1,16,33.272477879525525,0.6430759803921569,43.244047619047635,1027.0238095238117,30.206582633053284,0
548,4,0,0,34,0.0,0.0,1.0,34,1100,900,200,0.8181818181818182,13,9,4,398.64962846422935,0.4103535353535353,0.08810190742963897,0.2363966905096801,131799.59518274228,3708.371930267218,135507.9671130095,538,7,239.64705882352942,33,1,16,33.05672415164898,0.6448863636363636,43.290441176470594,1026.8382352941182,31.116310160427826,0
549,4,0,1,33,0.0,0.029411764705882353,0.9705882352941176,34,950,600,350,0.631578947368421,13,6,7,400.0406535895344,0.4103721033868093,0.08455882352941191,0.2382060255464956,131956.93963860057,3757.628075740106,135714.56771434066,539,8,240.64705882352942,33,1,16,32.861700858778626,0.6464646464646464,43.13725490196079,1027.4509803921571,31.13487819370173,0
550,4,0,0,33,0.0,0.0,1.0,33,650,400,250,0.6153846153846154,9,4,5,411.14596228593297,0.4055397727272727,0.09779665120783743,0.24431500388576102,131878.73247946653,4244.281674063891,136123.0141535304,540,20,248.6969696969697,32,1,16,32.65570579799222,0.6481119791666667,43.21338383838385,1027.1464646464658,32.098327020202056,0
551,4,0,1,32,0.0,0.030303030303030304,0.9696969696969697,33,900,800,100,0.8888888888888888,10,8,2,412.8542651038537,0.405105744949495,0.09989273263609544,0.24553964187755534,131911.15702479347,4292.016758494042,136203.17378328752,541,21,249.6969696969697,32,1,16,32.57897000983284,0.6484375,43.18181818181819,1027.272727272728,32.10227272727275,0
552,4,0,0,32,0.0,0.0,1.0,32,800,400,400,0.5,12,4,8,421.60609904362826,0.40616599462365593,0.0989405033599593,0.2502037097936112,131829.0901184081,4715.989685058578,136545.07980346665,542,22,251.15625,31,1,17,32.43747622670217,0.6502016129032258,43.26171874999999,1026.953124999999,33.12752016129029,0
553,4,0,0,32,0.0,0.0,1.0,32,1000,700,300,0.7,13,7,6,421.68499530355643,0.40501092069892475,0.09671110970357244,0.25179889205191164,132063.20020887573,4737.813991970468,136801.0142008462,543,23,252.15625,31,1,17,32.197977366776456,0.6525537634408602,43.03385416666666,1027.8645833333321,33.15692204301072,0
554,4,0,0,32,0.0,0.0,1.0,32,750,700,50,0.9333333333333333,8,7,1,419.6354865013052,0.40503192204301075,0.09646532615579506,0.25079653035032573,132096.66146172408,4686.489359537751,136783.15082126184,544,24,253.15625,31,1,17,32.21672472028711,0.6528897849462365,43.00130208333333,1027.9947916666658,33.16112231182793,0
555,4,0,0,32,0.0,0.0,1.0,32,1000,700,300,0.7,13,7,6,422.73263455029615,0.40452788978494625,0.09698698872989775,0.25309473957874806,132163.5966830783,4773.97308349609,136937.5697665744,545,25,254.15625,31,1,17,32.069272086446325,0.6535618279569892,42.936197916666664,1028.255208333333,33.16952284946235,0
556,4,0,0,32,0.0,0.0,1.0,32,900,600,300,0.6666666666666666,12,6,6,421.1889819696545,0.40452788978494625,0.09269765160146881,0.25261744636129846,132230.54885864258,4738.810051812066,136969.35891045464,546,26,255.15625,31,1,17,32.04110752415918,0.654233870967742,42.87109375,1028.515625,33.177923387096776,0
557,4,0,0,32,0.0,0.0,1.0,32,1000,500,500,0.5,15,5,10,420.43698941494205,0.40408686155913975,0.09904929131865337,0.25283813473035543,132331.00891113273,4727.370198567695,137058.3791097004,547,27,256.15625,31,1,17,31.958681346494547,0.655241935483871,42.77343749999999,1028.9062499999993,33.19052419354836,0
558,4,1,3,30,0.030303030303030304,0.09090909090909091,0.9090909090909091,33,650,300,350,0.46153846153846156,10,3,7,411.79339160956243,0.406802398989899,0.09967056271750452,0.24980091317044006,132658.02158261905,4325.539326344242,136983.5609089633,548,0,249.36363636363637,32,1,16,31.850308452833264,0.6559244791666667,42.455808080808076,1030.1767676767672,32.193023989898975,0
559,4,0,0,30,0.0,0.0,1.0,30,500,300,200,0.6,7,3,4,445.0825315064718,0.4034243295019157,0.09068962375876821,0.24637775836341627,129130.79668209888,5494.7723765432265,134625.5690586421,549,29,267.43333333333334,29,1,20,34.593354286234856,0.6285919540229885,45.902777777777786,1016.3888888888898,35.04789272030654,8
560,4,2,0,32,0.0625,0.0,1.0,32,900,600,300,0.6666666666666666,12,6,6,391.6098409481299,0.41362147177419356,0.05400625077746013,0.21489088814894264,128784.5329079938,3686.658089735704,132471.19099772949,550,0,251.65625,32,0,20,36.30633992619314,0.6168619791666667,46.24368686868685,1015.0252525252502,31.719539141414067,6
561,4,0,0,32,0.0,0.0,1.0,32,1000,800,200,0.8,12,8,4,394.8827816971848,0.41334845430107525,0.0594853306812535,0.217564184655627,128944.78242016112,3783.6148734822896,132728.39729364341,551,1,252.65625,32,0,21,36.059226338471746,0.6184895833333333,46.08585858585858,1015.6565656565649,31.739267676767653,0
562,4,0,0,32,0.0,0.0,1.0,32,1050,600,450,0.5714285714285714,15,6,9,394.5638498958425,0.4125714045698925,0.06189806760283356,0.2179173164112453,129040.97995421378,3782.98116901336,132823.96112322714,552,2,253.65625,32,0,21,35.96889109813181,0.6194661458333333,45.99116161616161,1016.0353535353529,31.751104797979778,0
563,4,0,0,32,0.0,0.0,1.0,32,700,500,200,0.7142857142857143,9,5,4,396.79242691461366,0.41269741263440857,0.06212349397590389,0.21986069023327984,129169.29913082857,3850.6799369962405,133019.9790678248,553,3,254.65625,32,0,21,35.781010640500156,0.6207682291666667,45.864898989899,1016.5404040404047,31.766887626262648,0
564,4,0,0,32,0.0,0.0,1.0,32,900,700,200,0.7777777777777778,11,7,4,396.74543267031254,0.41221438172043007,0.05902777777777768,0.22075322792168672,129333.80126953125,3862.5229742779766,133196.3242438092,554,4,255.65625,31,1,22,35.61401263014167,0.625,45.703125,1017.1875,32.8125,0
565,4,0,0,32,0.0,0.0,1.0,32,950,800,150,0.8421052631578947,11,8,3,400.20029847508545,0.41042926747311825,0.06044171249520347,0.2239918492324049,129565.68611992743,3970.445251464854,133536.1313713923,555,5,256.65625,31,1,19,35.28917274161229,0.6273521505376345,45.47526041666667,1018.0989583333344,32.84190188172047,0
566,4,0,0,32,0.0,0.0,1.0,32,1100,800,300,0.7272727272727273,14,8,6,400.6574282802355,0.41042926747311825,0.053977272727272485,0.22462664850033845,129631.97708129883,3987.6029120551216,133619.57999335395,556,6,257.65625,31,1,19,35.209825043685825,0.6280241935483871,45.41015625,1018.359375,32.85030241935484,0
567,4,0,0,32,0.0,0.0,1.0,32,550,400,150,0.7272727272727273,7,4,3,402.7106311545414,0.4102822580645162,0.05202473791869111,0.2259686195760991,129665.1289198133,4043.505181206593,133708.63410101988,557,7,258.65625,31,1,19,35.12368959345436,0.6283602150537635,45.377604166666664,1018.4895833333328,32.854502688172026,0
568,4,0,0,32,0.0,0.0,1.0,32,950,700,250,0.7368421052631579,12,7,5,402.44536663747556,0.4088541666666667,0.051886340403782594,0.22658542728812092,129797.7786593966,4047.3029242621437,133845.08158365876,558,8,259.65625,31,1,19,34.99499531476276,0.6297043010752688,45.24739583333333,1019.0104166666658,32.871303763440835,0
569,4,0,1,31,0.0,0.03125,0.96875,32,1100,700,400,0.6363636363636364,15,7,8,398.615980308444,0.40895917338709675,0.05081965904737529,0.2253835192632078,129963.68620130763,3961.1204359266594,133924.8066372343,559,9,260.65625,31,1,20,34.92330162175965,0.6313844086021505,45.08463541666667,1019.6614583333344,32.892305107526916,0
570,4,0,1,30,0.0,0.03225806451612903,0.967741935483871,31,1200,900,300,0.75,15,9,6,407.86843237057604,0.4054659498207885,0.05335216684677602,0.2297517425136486,129817.03990345717,4389.654512082332,134206.6944155395,560,10,269.7741935483871,30,1,20,34.83716917260176,0.6326388888888889,45.22849462365592,1019.0860215053774,33.96953405017925,0
571,4,0,0,30,0.0,0.0,1.0,30,900,700,200,0.7777777777777778,11,7,4,436.5034030140984,0.4021072796934866,0.0834402852049907,0.22548656454043164,126347.69915597152,5030.2401289165955,131377.93928488813,561,11,278.1666666666667,30,0,16,37.684659090909065,0.5972222222222222,48.6559139784946,1005.3763440860193,33.51254480286731,8
572,4,1,0,31,0.03225806451612903,0.0,1.0,31,900,500,400,0.5555555555555556,13,5,8,434.7714495625551,0.40394265232974913,0.09340494379023934,0.2272562117443192,126829.56271701382,4828.374565972211,131657.93728298604,562,0,270.16129032258067,31,0,17,37.22854188210961,0.5994623655913979,48.17708333333333,1007.2916666666661,32.49327956989245,0
573,4,3,0,34,0.08823529411764706,0.0,1.0,34,1300,900,400,0.6923076923076923,17,9,8,399.71756957231446,0.4183934937611408,0.10668295079471646,0.21519943375137682,128024.02388038527,3434.6903344670927,131458.71421485237,563,0,247.23529411764707,34,0,17,36.88095518174333,0.6044730392156863,46.994047619047606,1012.0238095238077,29.76540616246493,0
574,4,1,0,35,0.02857142857142857,0.0,1.0,35,800,500,300,0.625,11,5,6,392.8377366177165,0.42100840336134454,0.10328405296101795,0.21341593183322374,128385.71605725607,3087.007511337847,131472.7235685939,564,0,241.14285714285714,34,1,17,36.68384627432553,0.6081495098039216,46.63690476190475,1013.4523809523796,29.807422969187634,0
575,4,4,2,37,0.10256410256410256,0.05128205128205128,0.9487179487179487,39,1150,900,250,0.782608695652174,14,9,5,359.26457957457507,0.4307242465137202,0.1082053552173079,0.20038979882937394,129430.46932067192,1505.1224452527485,130935.59176592468,565,0,217.30769230769232,36,3,17,36.46870849933602,0.6145833333333333,45.608108108108105,1017.5675675675667,28.265765765765742,0
576,4,0,0,37,0.0,0.0,1.0,37,1150,900,250,0.782608695652174,14,9,5,375.5380637042381,0.4268330830830831,0.11403159392079054,0.20780079858557607,129115.53603857226,2297.5596796120344,131413.09571818428,566,1,230.05405405405406,36,1,20,36.376038781163444,0.611400462962963,45.91779279279279,1016.3288288288281,28.231356356356336,0
577,4,0,0,37,0.0,0.0,1.0,37,1200,1000,200,0.8333333333333334,14,10,4,368.2407730621799,0.4269894894894895,0.061717581263187604,0.19716361963776494,127802.69870799869,2084.7212076941987,129887.41991569288,567,2,231.05405405405406,36,1,16,37.90418383635892,0.5980902777777778,47.212837837837846,1011.1486486486498,28.087462462462494,8
578,4,3,2,38,0.075,0.05,0.95,40,850,600,250,0.7058823529411765,11,6,5,343.9956023803841,0.433079594017094,0.081467242468928,0.18791106150744366,128604.67916757992,848.3453534562489,129453.02452103616,568,0,214.65,38,2,16,37.69793202724528,0.6025219298245614,46.42094017094018,1014.3162393162403,26.69253261358527,0
579,4,0,1,37,0.0,0.02631578947368421,0.9736842105263158,38,850,700,150,0.8235294117647058,10,7,3,344.3591233705903,0.42883179231863444,0.09894371820318026,0.18518333277761093,127978.05574792234,1224.7003462123162,129202.75609413465,569,1,226.8684210526316,37,1,17,38.32854717526369,0.597972972972973,47.03947368421052,1011.842105263157,27.34708392603127,8
580,4,1,2,36,0.02631578947368421,0.05263157894736842,0.9473684210526316,38,1000,600,400,0.6,14,6,8,350.6335932598157,0.431513750592698,0.11870032342774905,0.19042557065450105,128372.67324334476,1402.4625455076289,129775.13578885239,570,0,220.05263157894737,36,2,15,37.76646479238434,0.6038773148148149,46.64977477477478,1013.4009009009014,28.15002502502504,0
581,4,1,1,36,0.02702702702702703,0.02702702702702703,0.972972972972973,37,1150,800,350,0.6956521739130435,15,8,7,359.3319735637128,0.42964839839839836,0.13988500319435593,0.19532402808798452,128408.33875868046,1828.2443576388796,130236.58311631934,571,0,226.86486486486487,35,2,15,37.50963514902365,0.60625,46.61458333333333,1013.5416666666658,28.95833333333331,0
582,4,0,0,36,0.0,0.0,1.0,36,850,500,350,0.5882352941176471,12,5,7,366.06493513180874,0.4279431216931217,0.14002467395135687,0.19857097915276142,128325.39859693889,2195.085742630397,130520.48433956929,572,2,234.16666666666666,34,2,19,37.423873027063,0.6075367647058824,46.69642857142858,1013.2142857142867,29.800420168067255,0
583,4,0,0,36,0.0,0.0,1.0,36,850,700,150,0.8235294117647058,10,7,3,366.80669522524175,0.4274801587301587,0.1410881397078978,0.19927411591911198,128385.71605725633,2218.548044217697,130604.26410147402,573,3,235.16666666666666,34,2,15,37.343376796272366,0.6081495098039216,46.636904761904766,1013.4523809523816,29.807422969187694,0
584,4,0,0,36,0.0,0.0,1.0,36,1150,900,250,0.782608695652174,14,9,5,369.1903161723047,0.4271660052910053,0.14127711220734462,0.20072071212586234,128415.8801020409,2281.979875283456,130697.85997732436,574,4,236.16666666666666,34,2,15,37.25212395270534,0.6084558823529411,46.60714285714286,1013.5714285714292,29.81092436974792,0
585,4,0,0,36,0.0,0.0,1.0,36,650,400,250,0.6153846153846154,9,4,5,371.90078370214,0.42721560846560847,0.1414660403210024,0.2023472954136564,128446.04768990936,2353.8371598639537,130799.88484977331,575,5,237.16666666666666,34,2,15,37.15257388921511,0.6087622549019608,46.577380952380956,1013.6904761904767,29.814425770308137,0
586,4,1,0,37,0.02702702702702703,0.0,1.0,37,800,600,200,0.75,10,6,4,366.3589743589741,0.4279904904904905,0.15379071379071374,0.20180790960451986,128936.76757812513,2047.4283854166813,130984.19596354182,576,0,231.72972972972974,35,2,16,36.79166666666666,0.6116071428571428,46.09375000000001,1015.625000000001,29.01785714285717,0
587,4,1,4,34,0.02631578947368421,0.10526315789473684,0.8947368421052632,38,1100,500,600,0.45454545454545453,17,5,12,362.22659204741495,0.427305595068753,0.16025902330510888,0.20233646099657251,129487.77113261938,1780.7828098368927,131268.5539424563,577,0,226.60526315789474,36,2,14,36.33501143320793,0.615162037037037,45.551801801801815,1017.792792792795,28.272022022022085,0
588,4,1,0,35,0.02857142857142857,0.0,1.0,35,800,200,600,0.25,14,2,12,386.4519468464388,0.4244047619047619,0.17362716887502816,0.21346256437733674,129045.69644187328,2973.992124423296,132019.68856629657,578,0,243.8,33,2,18,36.170119205564276,0.6171085858585859,45.986519607843135,1016.0539215686272,30.789512774806884,0
589,4,0,0,35,0.0,0.0,1.0,35,1300,900,400,0.6923076923076923,17,9,8,384.316235878947,0.42377450980392156,0.17642177034728568,0.2132890842199078,129232.53864198858,2933.2325607939147,132165.7712027825,579,1,244.8,33,2,18,36.03348097705998,0.6190025252525253,45.80269607843137,1016.7892156862739,30.811794414735573,0
590,4,0,0,35,0.0,0.0,1.0,35,900,700,200,0.7777777777777778,11,7,4,383.6454564461049,0.4240546218487395,0.17532624040216183,0.21308500653211385,129263.69214965405,2918.2856353325674,132181.9777849866,580,2,245.8,33,2,18,36.018719370129325,0.6193181818181819,45.77205882352941,1016.9117647058829,30.81550802139039,0
591,4,0,0,35,0.0,0.0,1.0,35,800,400,400,0.5,12,4,8,383.3005139386105,0.4240546218487395,0.1749332966106072,0.21306168554430857,129294.84941188474,2911.756445838127,132206.60585772287,581,3,246.8,33,2,19,35.9956771900229,0.6196338383838385,45.741421568627445,1017.0343137254894,30.81922162804513,0
592,4,0,0,35,0.0,0.0,1.0,35,1050,700,350,0.6666666666666666,14,7,7,384.9293045233795,0.4243347338935574,0.17508389694873294,0.21430571139158772,129357.17520004322,2958.6734969723184,132315.84869701555,582,4,247.8,33,2,19,35.890630646910026,0.6202651515151515,45.68014705882353,1017.2794117647056,30.826648841354714,0
593,4,1,0,36,0.027777777777777776,0.0,1.0,36,750,500,250,0.6666666666666666,10,5,5,374.7351825150628,0.4271825396825397,0.16735494260038464,0.2103828229395588,129685.96938775507,2519.579081632647,132205.54846938772,583,0,241.88888888888889,34,2,17,35.814779102384286,0.6213235294117647,45.357142857142854,1018.5714285714283,29.957983193277304,0
594,4,0,0,36,0.0,0.0,1.0,36,1200,900,300,0.75,15,9,6,378.8346044085849,0.4271825396825397,0.17404356687567368,0.21317852591275976,129776.92920918361,2632.798327664391,132409.727536848,584,1,242.88888888888889,34,2,17,35.61772208591346,0.6222426470588236,45.26785714285714,1018.9285714285709,29.968487394957968,0
595,4,1,0,37,0.02702702702702703,0.0,1.0,37,550,300,250,0.5454545454545454,8,3,5,368.28747136764747,0.42911661661661665,0.1679392121869998,0.20888582835485495,130085.41907793212,2181.7660108024706,132267.18508873458,585,0,237.2972972972973,35,2,18,35.57266848196051,0.6232142857142857,44.96527777777778,1020.138888888889,29.146825396825403,0
596,4,0,0,37,0.0,0.0,1.0,37,950,300,650,0.3157894736842105,16,3,13,368.34529530535167,0.429054054054054,0.16807279148476972,0.2092353172301531,130144.4615912207,2187.620027434822,132332.0816186555,586,1,238.2972972972973,35,2,18,35.511191772534794,0.6238095238095238,44.9074074074074,1020.3703703703691,29.153439153439116,0
597,4,1,1,37,0.02631578947368421,0.02631578947368421,0.9736842105263158,38,850,500,350,0.5882352941176471,12,5,7,369.61904031169945,0.43066915599810335,0.12214702282381706,0.20315151764500156,128848.62075617276,1986.3876028806458,130835.0083590534,587,0,233.0,35,3,17,36.79890560875512,0.6107142857142858,46.18055555555555,1015.2777777777771,29.00793650793649,8
598,4,3,1,39,0.075,0.025,0.975,40,1500,1300,200,0.8666666666666667,17,13,4,352.1913671280415,0.43601762820512824,0.13861575047008068,0.19716174304672598,129573.7476285408,1127.433317326348,130701.18094586715,588,0,222.225,36,4,19,36.50292187442393,0.6160300925925926,45.46734234234235,1018.1306306306315,28.28140640640643,0
599,4,1,0,40,0.025,0.0,1.0,40,1000,800,200,0.8,12,8,4,404.04648258084353,0.4365251068376068,0.19408869987849364,0.21288748730091805,127153.80652873886,2310.6008315900212,129464.40736032889,589,0,223.2,33,7,21,37.667577966788194,0.5978535353535354,47.85539215686274,1008.5784313725483,30.562982768865098,8
600,4,1,1,40,0.024390243902439025,0.024390243902439025,0.975609756097561,41,1400,1200,200,0.8571428571428571,16,12,4,394.64342650653657,0.43869410569105693,0.18677395021372956,0.21033193610513193,127617.73003472213,1872.6996527777674,129490.4296874999,590,0,218.73170731707316,35,6,20,37.42697594501719,0.5982142857142857,47.39583333333333,1010.4166666666658,28.869047619047596,0
601,4,1,0,41,0.024390243902439025,0.0,1.0,41,550,400,150,0.7272727272727273,7,4,3,394.2578648066228,0.4409552845528455,0.19091586999690002,0.21058433843157395,127705.45488522365,1869.775993441345,129575.230878665,591,0,219.6341463414634,35,6,21,37.34648746135349,0.5991071428571428,47.30902777777777,1010.7638888888879,28.878968253968225,0
602,4,0,0,41,0.0,0.0,1.0,41,1150,700,450,0.6086956521739131,16,7,9,390.65332017202337,0.44039634146341466,0.1952142973545552,0.20931186247880457,127831.16731596446,1787.5339866893733,129618.70130265383,592,1,220.6341463414634,36,5,21,37.308370452858185,0.5983796296296297,47.184684684684676,1011.26126126126,28.090590590590555,0
603,4,1,0,42,0.023809523809523808,0.0,1.0,42,850,500,350,0.5882352941176471,12,5,7,384.84562442848124,0.44282326751838946,0.2046757113752884,0.20828667764869696,128234.9489795917,1471.28265796821,129706.23163755992,593,0,216.35714285714286,34,8,23,37.040873295721674,0.6066176470588236,46.78571428571428,1012.8571428571418,29.789915966386523,0
604,4,0,0,42,0.0,0.0,1.0,42,1100,800,300,0.7272727272727273,14,8,6,384.40333093235705,0.44311362756484707,0.20296116097642813,0.20914979954562424,128446.04768990923,1475.017715419493,129921.06540532873,594,1,217.35714285714286,34,8,17,36.8357310628303,0.6087622549019608,46.57738095238095,1013.6904761904757,29.81442577030811,0
605,4,1,0,43,0.023255813953488372,0.0,1.0,43,1200,900,300,0.75,15,9,6,376.4152346403423,0.4447443706164636,0.20747548077305544,0.2067337522248241,128819.24518014828,1097.9052801354583,129917.15046028374,595,0,213.27906976744185,35,8,18,36.65642933150916,0.6104166666666666,46.20949074074074,1015.1620370370367,29.00462962962962,0
606,4,2,1,44,0.044444444444444446,0.022222222222222223,0.9777777777777777,45,1700,1100,600,0.6470588235294118,23,11,12,361.08583343734256,0.44772727272727275,0.2177517120971808,0.20155235804652677,129459.11864144563,349.7367277226422,129808.85536916828,596,0,204.75555555555556,36,9,18,36.393207554129326,0.6148726851851851,45.579954954954964,1017.6801801801812,28.26889389389392,0
607,4,0,1,43,0.0,0.022727272727272728,0.9772727272727273,44,1350,1000,350,0.7407407407407407,17,10,7,371.7590648397314,0.44565935517970406,0.21189018082509192,0.20677333302604814,129319.0854338135,815.108453360772,130134.19388717428,597,1,210.4090909090909,35,9,20,36.26441359429525,0.6154761904761905,45.717592592592595,1017.1296296296301,29.060846560846574,0
608,4,0,1,42,0.0,0.023255813953488372,0.9767441860465116,43,1400,1000,400,0.7142857142857143,18,10,8,372.2826247616202,0.4451827242524917,0.21016748103731575,0.20772009637482572,129443.56575963719,1037.9180839002252,130481.48384353741,598,2,215.51162790697674,34,9,19,36.12419084386211,0.6188725490196079,45.595238095238095,1017.6190476190477,29.929971988795522,0
609,4,1,0,43,0.023255813953488372,0.0,1.0,43,1650,1200,450,0.7272727272727273,21,12,9,376.4085623719078,0.4447443706164636,0.23405307848701296,0.21132228737887412,129685.96938775509,1162.9818594104238,130848.95124716552,599,0,216.13953488372093,34,9,20,35.77216767960105,0.6213235294117647,45.357142857142854,1018.5714285714284,29.957983193277308,0
610,4,0,0,43,0.0,0.0,1.0,43,1550,1000,550,0.6451612903225806,21,10,11,377.1219599698703,0.44437523071244,0.23670002007544144,0.21228783475541813,129790.4074502744,1189.3625685871116,130979.77001886151,600,1,217.13953488372093,35,8,20,35.64762229289717,0.6202380952380953,45.25462962962963,1018.9814814814819,29.113756613756625,0
611,4,0,0,43,0.0,0.0,1.0,43,1200,900,300,0.75,15,9,6,376.8340273773133,0.44442137320044295,0.23678226484032305,0.21250621693408528,129860.54202428808,1187.1742096826902,131047.71623397077,601,2,218.13953488372093,36,7,21,35.583545096306146,0.6189236111111112,45.18581081081083,1019.256756756759,28.312687687687752,0
612,4,1,0,44,0.022727272727272728,0.0,1.0,44,1250,800,450,0.64,17,8,9,368.34661796378,0.4445912614517266,0.24320132452851717,0.2097248860563744,130235.32238476185,794.3481079699459,131029.67049273179,602,0,214.1590909090909,38,6,22,35.41884725420419,0.6189692982456141,44.81837606837609,1020.7264957264987,26.861223571749964,0
613,4,0,0,44,0.0,0.0,1.0,44,1550,1000,550,0.6451612903225806,21,10,11,372.31378773057025,0.44317080690627203,0.24930607790997028,0.2131303944306887,130444.94224773247,913.3015219839908,131358.24376971647,603,1,215.1590909090909,34,10,23,35.104688653226134,0.6289828431372548,44.61309523809524,1021.5476190476194,30.045518207282925,0
614,4,0,0,44,0.0,0.0,1.0,44,1200,700,500,0.5833333333333334,17,7,10,400.4853158890028,0.4434571000704722,0.3007986781851517,0.22193062543974576,129173.52123970843,1549.3994251959818,130722.9206649044,604,2,216.1590909090909,37,7,22,35.6828416567792,0.6100788288288288,45.86074561403509,1016.5570175438601,27.474513987671894,8
615,4,0,0,44,0.0,0.0,1.0,44,1500,1200,300,0.8,18,12,6,401.0313469615494,0.4430606941508104,0.2991608299193873,0.22296871436135499,129303.89577190993,1571.0041378846863,130874.8999097946,605,3,217.1590909090909,30,14,22,35.53560415840712,0.6274305555555555,45.732526881720425,1017.0698924731173,33.90232974910391,0
616,4,0,0,44,0.0,0.0,1.0,44,1100,700,400,0.6363636363636364,15,7,8,356.3955510117152,0.44284046863988724,0.13568714376187452,0.19206436008447042,128063.4142833662,331.7870913694563,128395.20137473565,606,4,218.1590909090909,38,6,19,37.93672155372599,0.5970394736842105,46.955128205128204,1012.1794871794872,26.63630229419703,8
617,4,2,1,45,0.043478260869565216,0.021739130434782608,0.9782608695652174,46,1100,900,200,0.8181818181818182,13,9,4,344.8829134782295,0.44704106280193234,0.1338353796772236,0.18202675842161609,127223.341200087,-419.53498995827215,126803.80621012874,607,0,209.6304347826087,39,7,17,39.08804422646704,0.5868055555555556,47.78645833333334,1008.8541666666682,25.868055555555596,8
618,4,0,0,45,0.0,0.0,1.0,45,1150,700,450,0.6086956521739131,16,7,9,349.3823371514864,0.4466119528619528,0.1371315612976105,0.18441684794418617,127226.70945878093,-109.84698023959027,127116.86247854134,608,1,215.17777777777778,38,7,17,38.97110734582936,0.5885416666666667,47.783119658119666,1008.8675213675226,26.549145299145334,0
619,4,1,0,46,0.021739130434782608,0.0,1.0,46,1350,1000,350,0.7407407407407407,17,10,7,342.4380911892866,0.4479166666666667,0.14706409681757027,0.1825082134360486,127617.73003472241,-459.7656249999805,127157.96440972242,609,0,211.47826086956522,39,7,17,38.74570446735396,0.5908119658119658,47.39583333333334,1010.4166666666682,25.9081196581197,0
620,4,0,0,46,0.0,0.0,1.0,46,1800,1300,500,0.7222222222222222,23,13,10,345.182635333728,0.4468397745571659,0.14195677759394143,0.18523590262435227,127893.53820231809,-370.67428823379635,127522.86391408429,610,1,212.47826086956522,41,5,18,38.39414149339612,0.5904471544715447,47.12301587301588,1011.5079365079375,24.670925280681402,0
621,4,0,1,45,0.0,0.021739130434782608,0.9782608695652174,46,900,700,200,0.7777777777777778,11,7,4,345.46712802768155,0.4468599033816425,0.14421994884910472,0.18585256887565155,127993.90589569166,-356.46258503400963,127637.44331065765,611,2,213.47826086956522,41,5,18,38.2843137254902,0.5914634146341464,47.023809523809526,1011.9047619047623,24.68060394889664,0
622,4,1,0,46,0.021739130434782608,0.0,1.0,46,1250,800,450,0.64,17,8,9,340.8583794847856,0.4464875201288245,0.15679545548326757,0.18481189323351765,128306.84222961872,-452.8418048679009,127854.00042475082,612,0,214.1086956521739,38,8,19,38.08130338500474,0.5995065789473684,46.71474358974359,1013.141025641026,26.661605937921735,0
623,4,0,0,46,0.0,0.0,1.0,46,1350,1000,350,0.7407407407407407,17,10,7,338.40531160790187,0.4461755233494364,0.15767917306502288,0.18373064571270456,128360.96871803998,-512.3932765359101,127848.57544150407,613,1,215.1086956521739,38,8,19,38.088209453523106,0.6000548245614035,46.66132478632478,1013.3547008547004,26.667228969860535,0
624,4,1,0,47,0.02127659574468085,0.0,1.0,47,1200,700,500,0.5833333333333334,17,7,10,336.8061453673819,0.4466350601295097,0.17084163085630433,0.18478823651237444,128778.12500000001,-725.347222222222,128052.7777777778,614,0,211.51063829787233,39,8,18,37.703544061302665,0.6025641025641026,46.25,1015.0000000000001,26.02564102564103,0
625,4,2,0,49,0.04081632653061224,0.0,1.0,49,1350,1100,250,0.8148148148148148,16,11,5,329.61233432412206,0.44789895124716556,0.17888641850966458,0.1833703344452099,129327.49438027505,-1274.4125370055674,128053.08184326948,615,0,203.83673469387756,41,8,20,37.32759111154457,0.6049288617886179,45.709325396825385,1017.1626984126967,24.8088463027487,0
626,4,0,0,49,0.0,0.0,1.0,49,1100,600,500,0.5454545454545454,16,6,10,330.72328379141044,0.44784580498866217,0.17389020539482214,0.18446050689768836,129428.42306193277,-1239.0013818027564,128189.42168013002,616,1,204.83673469387756,41,8,17,37.19685336843129,0.6059451219512195,45.61011904761903,1017.5595238095211,24.81852497096393,0
627,4,1,2,48,0.02,0.04,0.96,50,1650,1300,350,0.7878787878787878,20,13,7,328.7281874828322,0.4482057823129251,0.19311026615969595,0.18552685259224197,129891.90853915016,-1460.1736674478827,128431.73487170227,617,0,201.72,42,8,18,36.777566539923946,0.6091269841269842,45.155038759689916,1019.3798449612392,24.270948689553315,0
628,4,0,0,48,0.0,0.0,1.0,48,1600,1300,300,0.8125,19,13,6,339.6037459020938,0.4473533540189125,0.18657721468475708,0.19081771014140045,129718.50419723698,-789.4220123603768,128929.0821848766,618,1,210.22916666666666,40,8,18,36.67635175578613,0.6104166666666666,45.325203252032516,1018.6991869918689,25.467479674796724,0
629,4,0,0,48,0.0,0.0,1.0,48,1250,800,450,0.64,17,8,9,339.9428668406768,0.44744570035460995,0.1888307367737747,0.19119459159111418,129756.71315980068,-778.0261873268153,128978.68697247386,619,2,211.22916666666666,41,7,18,36.62893541058097,0.6092479674796748,45.2876984126984,1018.8492063492041,24.849980642663514,0
630,4,1,1,48,0.02040816326530612,0.02040816326530612,0.9795918367346939,49,1300,600,700,0.46153846153846156,20,6,14,331.80403977977176,0.44874929138322,0.12671693871950063,0.1787555425743064,128050.79839677611,-1249.9980753618559,126800.80032141425,620,0,207.89795918367346,44,5,17,38.57187509529473,0.5878314393939394,46.96759259259258,1012.1296296296273,23.002946127946075,8
631,4,2,1,49,0.04,0.02,0.98,50,1350,1000,350,0.7407407407407407,17,10,7,328.3986634706641,0.45062925170068024,0.1593942868061533,0.1793087538105077,128586.40861614351,-1554.3761733347444,127032.03244280876,621,0,204.54,42,8,15,38.11204261010797,0.5959821428571428,46.43895348837208,1014.2441860465088,24.14867109634545,0
632,4,2,0,51,0.0392156862745098,0.0,1.0,51,1650,1200,450,0.7272727272727273,21,12,9,321.2070520479691,0.4527777777777778,0.1745408934486865,0.17748873057272965,129060.22376543206,-1908.9891975308662,127151.23456790119,622,0,201.05882352941177,44,7,18,37.812670858392565,0.5980113636363636,45.97222222222222,1016.1111111111109,23.09343434343434,0
633,4,0,1,50,0.0,0.0196078431372549,0.9803921568627451,51,1400,1200,200,0.8571428571428571,16,12,4,319.1220464453826,0.45243464052287585,0.17038888976244548,0.17686452974106298,129178.36757147913,-1955.2669968231519,127223.10057465598,623,1,202.05882352941177,45,6,18,37.74568222994446,0.5979166666666667,45.85597826086956,1016.5760869565212,22.590579710144915,0
634,4,1,0,51,0.0196078431372549,0.0,1.0,51,1500,1000,500,0.6666666666666666,20,10,10,315.7590653356481,0.45218954248366017,0.17503847955564567,0.17588860483525606,129377.95380015395,-2029.5394419210797,127348.41435823287,624,0,202.86274509803923,41,10,19,37.628697383390225,0.6054369918699187,45.65972222222221,1017.3611111111081,24.813685636856295,0
635,4,0,0,51,0.0,0.0,1.0,51,1100,600,500,0.5454545454545454,16,6,10,316.7310490153425,0.45210784313725494,0.18084785093604694,0.17676970080518908,129453.66138353458,-1999.6012062232558,127454.06017731132,625,1,203.86274509803923,41,10,16,37.52721453174759,0.6061991869918699,45.58531746031745,1017.6587301587276,24.820944638017746,0
636,4,0,1,50,0.0,0.0196078431372549,0.9803921568627451,51,1400,1100,300,0.7857142857142857,17,11,6,309.91264454950107,0.45215686274509803,0.08938186299764683,0.16571362068060136,127749.32861328156,-2268.2999852863286,125481.02862799523,626,2,204.86274509803923,47,4,13,39.43306714751848,0.5811170212765957,47.265625000000014,1010.9375000000024,21.50930851063835,8
637,4,0,1,49,0.0,0.02,0.98,50,900,400,500,0.4444444444444444,14,4,10,316.3577190037502,0.4505017006802721,0.11164015457895249,0.16596474961596985,126977.87135219724,-1948.892024103744,125028.9793280935,627,3,209.88,45,5,16,40.0586224199395,0.5756944444444445,48.029891304347814,1007.8804347826062,22.397342995169026,7
638,4,0,0,49,0.0,0.0,1.0,49,1250,900,350,0.72,16,9,7,320.0516987624863,0.4499893707482993,0.10806824976979801,0.16780844488366733,126955.04899837213,-1673.5641803192648,125281.48481805286,628,4,214.40816326530611,45,4,16,39.9889148540955,0.575462962962963,48.052536231884055,1007.7898550724633,22.395330112721407,0
639,4,3,4,48,0.057692307692307696,0.07692307692307693,0.9230769230769231,52,1050,500,550,0.47619047619047616,16,5,11,337.6072953976336,0.45317213423831076,0.17462172225303085,0.1811141899619348,127880.99500868046,-1765.2147863172165,126115.78022236325,629,0,202.98076923076923,47,5,16,38.598523858565045,0.5824468085106382,47.135416666666664,1011.4583333333326,21.52039007092197,0
640,4,2,1,49,0.04,0.02,0.98,50,1300,900,400,0.6923076923076923,17,9,8,346.6229659732052,0.4531122448979592,0.21082319255547666,0.18696227160794088,128098.67937408084,-1119.6111636211078,126979.06821045972,630,0,210.32,45,5,18,38.14796587926508,0.587037037037037,46.920289855072454,1012.3188405797082,22.495974235104626,0
641,4,0,0,49,0.0,0.0,1.0,49,1550,1200,350,0.7741935483870968,19,12,7,354.78201643162515,0.4516369047619047,0.22265498613653767,0.19195209423222448,128221.71512492561,-701.8154527959393,127519.89967212967,631,1,214.77551020408163,40,9,18,37.81565656565655,0.5953125,46.798780487804876,1012.8048780487803,25.32012195121951,0
642,4,2,1,50,0.0392156862745098,0.0196078431372549,0.9803921568627451,51,1150,700,450,0.6086956521739131,16,7,9,346.9034672692603,0.45336601307189545,0.2426302071630786,0.1899985935796913,128709.28730244593,-1270.0603930052139,127439.22690944071,632,0,207.31372549019608,42,9,16,37.51750700280112,0.5972222222222222,46.31782945736435,1014.728682170544,24.160206718346284,0
643,4,0,1,49,0.0,0.02,0.98,50,1450,1100,350,0.7586206896551724,18,11,7,353.6778914582671,0.45260204081632655,0.2419765110283585,0.1938288099027961,128733.87008180105,-893.9352540412153,127839.93482775983,633,1,212.16,42,8,17,37.320570355517376,0.5974702380952381,46.293604651162795,1014.8255813953496,24.162513842746417,0
644,4,1,0,50,0.02,0.0,1.0,50,1250,900,350,0.72,16,9,7,359.8714537113848,0.45200680272108845,0.2609101081685936,0.1981140384805388,128912.72454660255,-721.5980831037489,128191.1264634988,634,0,213.08,43,7,18,36.98091508143726,0.5978682170542635,46.11742424242425,1015.5303030303044,23.616983791402426,0
645,4,0,0,50,0.0,0.0,1.0,50,1700,1300,400,0.7647058823529411,21,13,8,357.40643812873014,0.4511904761904762,0.2667207156835334,0.19759549137348842,129081.07284672023,-773.1187048037004,128307.95414191653,635,1,214.08,43,7,19,36.8718549063461,0.5995639534883721,45.951704545454554,1016.1931818181833,23.632399577167053,0
646,4,0,1,49,0.0,0.02,0.98,50,1600,1300,300,0.8125,19,13,6,361.6614268904262,0.4505952380952381,0.2725285621901272,0.2014102472202505,129368.6579043552,-642.1330356296821,128726.52486872552,636,2,215.08,37,13,19,36.470683336926086,0.6120495495495495,45.66885964912281,1017.3245614035088,27.49525841631105,0
647,4,0,1,48,0.0,0.02040816326530612,0.9795918367346939,49,1700,1300,400,0.7647058823529411,21,13,8,358.8865483570106,0.44855442176870747,0.27171901506194485,0.2006731826728632,129527.4490466795,-502.8681788297509,129024.58086784974,637,3,218.9795918367347,38,11,16,36.37961796809404,0.611842105263158,45.5128205128205,1017.9487179487154,26.78812415654514,0
648,4,0,1,47,0.0,0.020833333333333332,0.9791666666666666,48,1550,1200,350,0.7741935483870968,19,12,7,362.63013350756734,0.4485723256501182,0.26380441023432777,0.20353300967684546,129675.5988020352,-195.1440587488495,129480.45474328635,638,4,220.64583333333334,37,11,16,36.133576452434795,0.6151463963963963,45.36732456140351,1018.5307017543856,27.527856804172586,0
649,4,0,0,47,0.0,0.0,1.0,47,1350,800,550,0.5925925925925926,19,8,11,370.4514617497896,0.4472517730496454,0.268300391635939,0.2080709842597063,129703.52055440123,209.77175669435115,129913.29231109557,639,5,225.3404255319149,37,10,16,35.905992106207385,0.615427927927928,45.339912280701746,1018.640350877192,27.53082029397816,0
650,4,0,1,46,0.0,0.02127659574468085,0.9787234042553191,47,1500,1000,500,0.6666666666666666,20,10,10,371.01472277818823,0.4474637681159421,0.2700835937970598,0.20875323959501915,129772.26382725153,229.4840976331082,130001.74792488464,640,6,226.3404255319149,38,9,17,35.82166823948831,0.6143092105263157,45.272435897435884,1018.9102564102542,26.813427800269846,0
651,4,1,1,46,0.02127659574468085,0.02127659574468085,0.9787234042553191,47,1250,900,350,0.72,16,9,7,369.6281322666111,0.4491404563675609,0.2778989389548163,0.210012985798834,130153.54624379048,221.6824411936413,130375.22868498412,641,0,224.7659574468085,38,9,18,35.46923533312392,0.6181469298245614,44.898504273504265,1020.4059829059817,26.852789023841623,0
652,4,1,0,47,0.02127659574468085,0.0,1.0,47,1150,800,350,0.6956521739130435,15,8,7,367.0137442732199,0.44856228800493375,0.2725141120277901,0.20911248220218318,130262.58680555536,161.76891573524168,130424.3557212906,642,0,225.3404255319149,35,12,20,35.42517006802721,0.625,44.79166666666666,1020.8333333333318,29.16666666666662,0
653,4,0,0,47,0.0,0.0,1.0,47,1300,1200,100,0.9230769230769231,14,12,2,366.74557927944244,0.44823465926611167,0.2749565580363533,0.21020105121935445,130492.60567577711,171.5172520493471,130664.12292782647,643,1,226.3404255319149,36,11,16,35.19852860134466,0.6252893518518519,44.56644144144144,1021.7342342342341,28.381506506506504,0
654,4,0,0,47,0.0,0.0,1.0,47,1750,1100,650,0.6285714285714286,24,11,13,363.5655866243887,0.44771430773974713,0.27149283083969533,0.20899840593980853,130607.69120049101,96.89237379270608,130704.58357428372,644,2,227.3404255319149,36,11,16,35.163049465682484,0.6264467592592593,44.453828828828826,1022.1846846846845,28.394019019019012,0
655,4,0,1,46,0.0,0.02127659574468085,0.9787234042553191,47,1050,700,350,0.6666666666666666,14,7,7,362.1666925420638,0.44779139685476416,0.2685068891180056,0.20865949037321932,130694.03863322767,66.60554135214184,130760.64417457981,645,3,228.3404255319149,36,11,16,35.11127936857562,0.6273148148148149,44.36936936936936,1022.5225225225213,28.40340340340337,0
656,4,1,0,47,0.02127659574468085,0.0,1.0,47,1200,800,400,0.6666666666666666,16,8,8,362.7917095442374,0.44806120875732347,0.27597299220857074,0.2102711132868641,130924.43795146493,99.66013310607582,131024.09808457101,646,0,229.25531914893617,36,11,18,34.86190580985915,0.6296296296296297,44.14414414414414,1023.4234234234231,28.42842842842842,0
657,4,0,0,47,0.0,0.0,1.0,47,1300,800,500,0.6153846153846154,18,8,10,361.4070236267423,0.4481575701510947,0.2700596182245809,0.20983183909074998,130991.17036011058,68.22580024620544,131059.39616035679,647,1,230.25531914893617,37,10,19,34.829780776920884,0.6283783783783784,44.07894736842104,1023.684210526314,27.667140825035514,0
658,4,0,2,45,0.0,0.0425531914893617,0.9574468085106383,47,1400,1000,400,0.7142857142857143,18,10,8,363.45690247978956,0.4473866790009251,0.26742204351183685,0.21197231027835886,131163.91354372105,134.4859467455442,131298.3994904666,648,2,231.25531914893617,38,9,20,34.602497914059235,0.6282894736842105,43.9102564102564,1024.358974358973,26.956815114709816,0
659,4,0,0,45,0.0,0.0,1.0,45,1300,900,400,0.6923076923076923,17,9,8,367.50611408553095,0.4452651515151515,0.26757000903342365,0.2152535811072397,131328.12500000015,652.8805062459068,131981.00550624606,649,3,237.7111111111111,36,9,20,34.33265582655826,0.6336805555555556,43.75000000000001,1025.0000000000011,28.472222222222253,0
660,4,0,0,45,0.0,0.0,1.0,45,1000,600,400,0.6,14,6,8,366.6364715605462,0.44537037037037036,0.26563451514682357,0.21508673658579194,131389.14399092982,634.4104308390165,132023.55442176884,650,4,238.7111111111111,34,11,20,34.29323424678744,0.6384803921568627,43.6904761904762,1025.238095238096,30.154061624649884,0
661,4,0,0,45,0.0,0.0,1.0,45,1150,800,350,0.6956521739130435,15,8,7,366.7461731939827,0.4453282828282828,0.26607338621267806,0.21566677693284397,131480.69905045364,644.0086451247296,132124.70769557837,651,5,239.7111111111111,34,11,20,34.197862255755446,0.6393995098039216,43.60119047619048,1025.595238095239,30.16456582633056,0
662,4,0,0,45,0.0,0.0,1.0,45,1400,900,500,0.6428571428571429,19,9,10,368.0755817280457,0.44515993265993264,0.2654548735996698,0.21714191915907088,131602.82206632654,687.9570578231239,132290.77912414967,652,6,240.7111111111111,34,11,18,34.040346907993964,0.640625,43.482142857142854,1026.0714285714284,30.178571428571423,0
663,4,1,1,45,0.021739130434782608,0.021739130434782608,0.9782608695652174,46,1450,1000,450,0.6896551724137931,19,10,9,361.7338026666665,0.4452596618357488,0.28109681159420274,0.21614113448056096,132087.85545792957,356.1284481763885,132443.98390610598,653,0,236.45652173913044,37,9,20,33.713666666666676,0.6393581081081081,43.009868421052644,1027.9605263157912,27.782716927453816,0
664,4,0,0,45,0.0,0.0,1.0,45,1350,800,550,0.5925925925925926,19,8,11,362.4011561514113,0.4439183501683502,0.27872196751608214,0.21718597083348817,132200.59447378054,581.9296562404024,132782.52413002093,654,1,240.86666666666667,37,8,20,33.582893520986616,0.6404842342342343,42.900219298245624,1028.3991228070188,27.794570886676183,0
665,4,0,1,44,0.0,0.022222222222222223,0.9777777777777777,45,1450,1000,450,0.6896551724137931,19,10,9,357.6756412527707,0.44328703703703703,0.27520544614636466,0.2156434934729769,132426.97934420937,473.32823211564244,132900.307576325,655,2,241.86666666666667,36,9,20,33.47647702407002,0.6446759259259259,42.680180180180194,1029.2792792792816,28.591091091091155,0
666,4,0,0,44,0.0,0.0,1.0,44,1350,1000,350,0.7407407407407407,17,10,7,369.29893160509477,0.44238900634249473,0.2796489345393225,0.22300841796519466,132487.35592689036,985.487798996902,133472.84372588727,656,3,247.27272727272728,35,9,21,33.116568296795954,0.6473214285714286,42.62152777777777,1029.5138888888882,29.41468253968252,0
667,4,0,0,44,0.0,0.0,1.0,44,1600,1200,400,0.75,20,12,8,369.8374988802293,0.44140900281888656,0.283705911574764,0.22470206605272902,132716.9124360848,1016.7381908936056,133733.6506269784,657,4,248.27272727272728,36,8,18,32.871584699453564,0.6475694444444444,42.39864864864865,1030.4054054054059,28.622372372372386,0
668,4,0,0,44,0.0,0.0,1.0,44,950,500,450,0.5263157894736842,14,5,9,395.9111837160393,0.4405721458773784,0.26434996787320664,0.23020041304734584,131047.2994094336,1708.2120845858924,132755.5114940195,658,5,249.27272727272728,37,7,18,33.88975155279503,0.6289414414414414,44.02412280701754,1023.9035087719293,27.673067804646738,8
669,4,1,1,44,0.022222222222222223,0.022222222222222223,0.9777777777777777,45,1250,800,450,0.64,17,8,9,391.41179343613516,0.44057239057239056,0.2702275894101258,0.22962114203487677,131389.1439909295,1286.654390518875,132675.79838144837,659,0,244.7111111111111,34,11,19,33.65821915157144,0.6384803921568627,43.690476190476176,1025.2380952380934,30.154061624649806,0
670,4,0,0,44,0.0,0.0,1.0,44,700,300,400,0.42857142857142855,11,3,8,393.0634815611744,0.4409134954193094,0.263955157708061,0.23059010239814914,131389.1439909295,1528.8548752834183,132917.99886621293,660,1,245.0909090909091,34,10,20,33.615884811890375,0.6384803921568627,43.690476190476176,1025.2380952380934,30.154061624649806,0
671,4,1,0,45,0.022222222222222223,0.0,1.0,45,1150,700,450,0.6086956521739131,16,7,9,385.6276566532657,0.44187710437710437,0.2758501484237028,0.22851723060595305,131773.38023244587,1163.091965663565,132936.47219810943,661,0,240.62222222222223,35,10,20,33.417526208995604,0.6401785714285715,43.315972222222214,1026.7361111111102,29.335317460317434,0
672,4,0,1,44,0.0,0.022222222222222223,0.9777777777777777,45,1200,800,400,0.6666666666666666,16,8,8,385.94384334744655,0.4417508417508418,0.27642520789500113,0.2288832739424157,131803.09070644694,1173.7182784636234,132976.80898491055,662,1,241.62222222222223,35,10,20,33.379358280733406,0.6404761904761904,43.287037037037024,1026.8518518518497,29.338624338624278,0
673,4,0,2,42,0.0,0.045454545454545456,0.9545454545454546,44,1700,1300,400,0.7647058823529411,21,13,8,388.4787733532051,0.44037394291754756,0.28588849440048913,0.23102572951514846,131908.37762188198,1448.720946712007,133357.098568594,663,2,247.36363636363637,34,10,20,33.20778769266427,0.6436887254901961,43.1845238095238,1027.261904761904,30.213585434173645,0
674,4,0,1,41,0.0,0.023809523809523808,0.9761904761904762,42,1200,1000,200,0.8333333333333334,14,10,4,391.69644644021326,0.4392663569492838,0.2849088662341679,0.23350301972872364,132000.11337868468,1940.7950680271979,133940.90844671187,664,3,253.83333333333334,34,8,20,33.03236986407167,0.6446078431372548,43.09523809523809,1027.6190476190466,30.224089635854313,0
675,4,0,0,41,0.0,0.0,1.0,41,1350,900,450,0.6666666666666666,18,9,9,400.04065358953477,0.4396849593495935,0.2892268665053066,0.23820602554649545,131956.93963860034,2357.628075740078,134314.5677143404,665,4,259.6829268292683,33,8,20,32.86170085877862,0.6464646464646464,43.13725490196077,1027.4509803921553,31.134878193701677,0
676,4,0,0,41,0.0,0.0,1.0,41,1100,700,400,0.6363636363636364,15,7,8,400.1938406788937,0.43874491869918697,0.2881182966079274,0.23928910402389436,132114.37795859756,2374.2720648308214,134488.65002342837,666,5,260.6829268292683,33,8,20,32.698449358286645,0.6480429292929293,42.984068627450974,1028.0637254901953,31.153446226975618,0
677,4,0,0,41,0.0,0.0,1.0,41,1350,1100,250,0.8148148148148148,16,11,5,400.69142976060556,0.4384908536585366,0.295635797158734,0.2401858913250715,132208.88600538252,2394.993512110724,134603.87951749325,667,6,261.6829268292683,33,8,21,32.59006593581189,0.648989898989899,42.8921568627451,1028.4313725490194,31.16458704693998,0
678,4,0,1,40,0.0,0.024390243902439025,0.975609756097561,41,1150,1100,50,0.9565217391304348,12,11,1,401.69002914952034,0.43836382113821143,0.2951388888888893,0.24101401748971188,132244.8979591835,2424.2913832199356,134669.18934240344,668,7,262.6829268292683,34,7,21,32.52797067901234,0.6470588235294117,42.85714285714285,1028.571428571427,30.25210084033609,0
679,4,0,0,40,0.0,0.0,1.0,40,1350,900,450,0.6666666666666666,18,9,9,406.5892924947012,0.43604433760683764,0.29565278559369723,0.24359715871985296,132189.63162562152,2749.377759559321,134939.00938518083,669,8,269.35,35,5,21,32.457911273682235,0.6443452380952381,42.910879629629626,1028.356481481481,29.381613756613746,0
680,4,0,0,40,0.0,0.0,1.0,40,650,300,350,0.46153846153846156,10,3,7,404.095282137255,0.43591079059829063,0.2918345560056934,0.24232450504002323,132224.2148187039,2686.236278508244,134910.45109721215,670,9,270.35,36,4,21,32.48704332274902,0.642650462962963,42.877252252252255,1028.4909909909916,28.56919419419421,0
681,4,0,1,39,0.0,0.025,0.975,40,1000,700,300,0.7,13,7,6,401.81176408795267,0.4355902777777778,0.29384303852889726,0.24151001820444287,132311.09487866232,2632.830888320744,134943.92576698307,671,10,271.35,36,4,21,32.457904626386465,0.6435185185185186,42.79279279279279,1028.828828828828,28.578578578578554,0
682,4,0,0,39,0.0,0.0,1.0,39,1100,800,300,0.7272727272727273,14,8,6,399.44926158435675,0.4342386414754836,0.2852693864839617,0.24064382344228302,132398.00347222213,2777.3425452479423,135175.34601747006,672,11,274.43589743589746,33,6,21,32.430836707152515,0.6508838383838385,42.70833333333333,1029.1666666666658,31.18686868686866,0
683,4,0,0,39,0.0,0.0,1.0,39,1050,800,250,0.7619047619047619,13,8,5,397.33288018557613,0.43370445344129555,0.287196577127546,0.24017200426756907,132524.15687475973,2731.240989042677,135255.3978638024,673,12,275.43589743589746,33,6,21,32.357871141791634,0.6521464646464646,42.58578431372549,1029.6568627450981,31.201723113487823,0
684,4,0,0,39,0.0,0.0,1.0,39,950,700,250,0.7368421052631579,12,7,5,395.96319217691587,0.43359199280251914,0.2794288034089263,0.2401029784097304,132643.15653344672,2704.361536281178,135347.5180697279,674,13,276.43589743589746,34,5,19,32.273007434801045,0.6510416666666667,42.470238095238095,1030.1190476190475,30.297619047619044,0
685,4,0,0,39,0.0,0.0,1.0,39,2000,1700,300,0.85,23,17,6,395.07176028312534,0.43286099865047234,0.27606896837666084,0.24054369202048534,132796.49234693887,2692.828798185951,135489.32114512482,675,14,277.43589743589746,34,5,20,32.141275891275896,0.6525735294117647,42.32142857142858,1030.7142857142865,30.31512605042019,0
686,4,0,0,39,0.0,0.0,1.0,39,1100,800,300,0.7272727272727273,14,8,6,395.9010317842541,0.4317926225820963,0.2822436711389733,0.24203885944580056,132949.91673752837,2727.0018424036357,135676.918579932,676,15,278.43589743589746,34,5,20,31.965206433491105,0.6541053921568627,42.17261904761905,1031.309523809524,30.332633053221297,0
687,4,0,0,39,0.0,0.0,1.0,39,1100,500,600,0.45454545454545453,17,5,12,398.761878166097,0.4311178587494377,0.282879748146307,0.24438970552951902,133042.01388888896,2810.416666666671,135852.43055555562,677,16,279.43589743589746,34,5,20,31.798599892299396,0.6550245098039216,42.083333333333336,1031.6666666666672,30.343137254901976,0
688,4,0,0,39,0.0,0.0,1.0,39,1450,1300,150,0.896551724137931,16,13,3,400.3035280871721,0.4305555555555556,0.2849784747847479,0.24655058207187172,133226.30385487518,2866.191893424023,136092.4957482992,678,17,280.43589743589746,34,5,20,31.573118465559656,0.6568627450980392,41.9047619047619,1032.3809523809516,30.364145658263283,0
689,4,0,0,39,0.0,0.0,1.0,39,900,700,200,0.7777777777777778,11,7,4,397.44861422776756,0.4298245614035088,0.2776181863318794,0.24560286161254352,133349.23469387754,2799.8937074829914,136149.12840136053,679,18,281.43589743589746,34,5,20,31.523023282618723,0.6580882352941176,41.785714285714285,1032.8571428571427,30.378151260504197,0
690,4,0,0,39,0.0,0.0,1.0,39,950,600,350,0.631578947368421,13,6,7,368.68014682202534,0.4284750337381917,0.21211661951591876,0.2215961724582911,132311.0948786625,2029.56416496475,134340.65904362724,680,19,282.43589743589746,36,3,19,33.31007370110917,0.6435185185185186,42.792792792792795,1028.8288288288293,28.57857857857859,8
691,4,0,1,38,0.0,0.02564102564102564,0.9743589743589743,39,1300,900,400,0.6923076923076923,17,9,8,364.4952436193417,0.4276315789473684,0.21036424499822748,0.21975974247503754,132427.78427479844,1853.8880318436177,134281.67230664205,681,20,283.43589743589746,35,4,19,33.30018460212153,0.6467261904761905,42.679398148148145,1029.2824074074067,29.408068783068764,0
692,4,0,0,38,0.0,0.0,1.0,38,1000,600,400,0.6,14,6,8,371.9666429245761,0.42717223802750115,0.2043963134762652,0.22426942780515235,132428.63520408166,2251.80697278912,134680.44217687077,682,21,279.86842105263156,34,4,19,33.1070726347444,0.6488970588235294,42.67857142857143,1029.2857142857144,30.273109243697483,0
693,4,1,0,39,0.02564102564102564,0.0,1.0,39,1100,800,300,0.7272727272727273,14,8,6,364.5745001027231,0.42917791273054434,0.2097572350182655,0.22226318086344649,132845.06715374222,1886.3847897376436,134731.45194347986,683,0,273.6666666666667,35,4,17,32.8782839339845,0.6508928571428572,42.27430555555555,1030.9027777777771,29.45436507936506,0
694,4,0,1,38,0.0,0.02564102564102564,0.9743589743589743,39,1250,1100,150,0.88,14,11,3,364.0543359996671,0.4291216824111561,0.20478662343698373,0.22256405935146553,132949.08717839472,1880.1383308984782,134829.2255092932,684,1,274.6666666666667,36,3,17,32.78713510955812,0.6498842592592593,42.17342342342343,1031.306306306307,28.64739739739742,0
695,4,0,1,37,0.0,0.02631578947368421,0.9736842105263158,38,1000,700,300,0.7,13,7,6,368.0857000228681,0.4271574205784732,0.195014316497919,0.2258419831867771,133083.80922335837,2197.249415937948,135281.05863929633,685,2,265.42105263157896,35,3,18,32.547789306412405,0.6532738095238095,42.04282407407408,1031.828703703705,29.480820105820143,0
696,4,0,0,37,0.0,0.0,1.0,37,1200,700,500,0.5833333333333334,17,7,10,371.99927400585455,0.4272084584584585,0.20540540540540464,0.2282431884213489,133083.8092233584,2501.416082604615,135585.22530596302,686,3,272.72972972972974,35,2,18,32.44683585716956,0.6532738095238095,42.04282407407408,1031.8287037037053,29.48082010582015,0
697,4,0,0,37,0.0,0.0,1.0,37,1200,900,300,0.75,15,9,6,375.8721010665555,0.42586336336336333,0.20793515694333764,0.2321042738973618,133322.76562767924,2622.4616072959593,135945.2272349752,687,4,273.72972972972974,35,2,18,32.106751279465044,0.6556547619047619,41.811342592592595,1032.7546296296302,29.50727513227515,0
698,4,0,1,36,0.0,0.02702702702702703,0.972972972972973,37,1300,800,500,0.6153846153846154,18,8,10,395.3626116207767,0.4249562062062062,0.21988553903447583,0.23649872586042786,132130.12695312474,3067.718514231797,135197.84546735653,688,5,274.72972972972974,35,2,20,32.80669537318473,0.64375,42.968749999999986,1028.124999999998,29.374999999999943,8
699,4,0,0,36,0.0,0.0,1.0,36,950,700,250,0.7368421052631579,12,7,5,401.20998927119,0.4239583333333334,0.21342828469970732,0.2399480240544316,132122.47732426287,3401.771541950097,135524.24886621296,689,6,266.22222222222223,34,2,20,32.66413849004168,0.6458333333333333,42.97619047619047,1028.095238095237,30.238095238095205,0
700,4,0,0,36,0.0,0.0,1.0,36,1200,900,300,0.75,15,9,6,402.99982391470337,0.4227513227513227,0.21534263531000364,0.24182710568061874,132249.14969403695,3459.2768079132084,135708.42650195016,690,7,267.22222222222223,35,1,20,32.48999006038784,0.6449404761904762,42.853009259259245,1028.587962962961,29.388227513227456,0
701,4,0,0,36,0.0,0.0,1.0,36,1150,800,350,0.6956521739130435,15,8,7,404.4387027549567,0.4223710317460318,0.21197975253093393,0.24326522784110705,132338.45191400877,3504.5583633401757,135843.01027734895,691,8,268.22222222222223,35,1,20,32.362673415823025,0.6458333333333333,42.766203703703695,1028.935185185184,29.398148148148117,0
702,4,0,0,36,0.0,0.0,1.0,36,900,600,300,0.6666666666666666,12,6,6,402.2208699847694,0.42162698412698413,0.21122004357298474,0.24252906004802458,132431.5071105957,3453.3967843598634,135884.90389495555,692,9,269.22222222222223,31,5,20,32.325664136622386,0.65625,42.67578125,1029.296875,33.203125,0
703,4,0,1,35,0.0,0.027777777777777776,0.9722222222222222,36,950,700,250,0.7368421052631579,12,7,5,404.4524553799818,0.4221891534391535,0.21508016806486552,0.24430905765389738,132498.52710300026,3517.8709242079053,136016.39802720817,693,10,270.22222222222223,31,5,20,32.20050271910965,0.6569220430107527,42.610677083333336,1029.557291666667,33.211525537634415,0
704,4,0,0,35,0.0,0.0,1.0,35,800,600,200,0.75,10,6,4,410.32918018331446,0.42111344537815126,0.23576465321046158,0.24742526471211224,132432.58794369307,3868.191048098071,136300.77899179113,694,11,278.0285714285714,30,5,21,32.11592452337427,0.6590277777777778,42.67473118279571,1029.3010752688185,34.31003584229395,0
705,4,0,0,35,0.0,0.0,1.0,35,1250,800,450,0.64,17,8,9,407.5164851021957,0.4207983193277311,0.23438109690006548,0.24637923273609819,132532.04345703125,3801.798502604167,136333.8419596354,695,12,279.0285714285714,31,4,21,32.08775923115832,0.657258064516129,42.578125,1029.6875,33.215725806451616,0
706,4,0,0,35,0.0,0.0,1.0,35,1100,800,300,0.7272727272727273,14,8,6,403.43317474048445,0.4209033613445378,0.23126050420168087,0.24494157037815126,132690.54178145083,3706.35330578512,136396.89508723596,696,13,280.0285714285714,32,3,20,32.0327818627451,0.65625,42.42424242424242,1030.30303030303,32.19696969696969,0
707,4,0,0,35,0.0,0.0,1.0,35,1350,1000,350,0.7407407407407407,17,10,7,401.63248648097095,0.4198529411764706,0.22868686868686883,0.2454420750717047,132934.57031250015,3678.1684027777924,136612.73871527793,697,14,281.0285714285714,33,2,20,31.832912457912457,0.65625,42.18750000000001,1031.2500000000011,31.250000000000036,0
708,4,0,0,35,0.0,0.0,1.0,35,850,600,250,0.7058823529411765,11,6,5,398.74447953764786,0.41988795518207284,0.2278654583715165,0.24429629030188665,133029.37121539802,3608.945477700896,136638.31669309892,698,15,282.0285714285714,33,2,20,31.81179219133602,0.6571969696969697,42.09558823529412,1031.6176470588243,31.261140819964375,0
709,4,0,0,35,0.0,0.0,1.0,35,750,500,250,0.6666666666666666,10,5,5,396.91568976387623,0.4200280112044818,0.20233708811453854,0.2372751502244846,132105.78799357207,3488.4437823500803,135594.23177592215,699,16,283.0285714285714,32,3,18,32.791390321788256,0.650390625,42.99242424242424,1028.030303030303,32.12594696969697,8
710,4,0,0,35,0.0,0.0,1.0,35,900,500,400,0.5555555555555556,13,5,8,398.18212033956354,0.4200280112044818,0.1979689555380162,0.23864557543530138,132203.1572830579,3528.186696510563,135731.34397956845,700,17,284.0285714285714,32,3,18,32.66037446286064,0.6513671875,42.89772727272727,1028.4090909090912,32.1377840909091,0
711,4,1,0,36,0.027777777777777776,0.0,1.0,36,1100,900,200,0.8181818181818182,13,9,4,390.3243191689729,0.4226686507936508,0.1953963720979428,0.2363318139982744,132587.2561034218,3150.406093810071,135737.66219723187,701,0,277.1111111111111,33,3,19,32.47461526257336,0.6527777777777778,42.52450980392157,1029.9019607843138,31.20915032679739,0
712,4,0,0,36,0.0,0.0,1.0,36,900,500,400,0.5555555555555556,13,5,8,390.92509421954173,0.4218419312169312,0.19715350459879488,0.2374926439449356,132713.49961553255,3176.207468281438,135889.707083814,702,1,278.1111111111111,33,3,18,32.3318070091976,0.654040404040404,42.40196078431373,1030.3921568627454,31.224004753416526,0
713,4,0,1,35,0.0,0.027777777777777776,0.9722222222222222,36,1100,800,300,0.7272727272727273,14,8,6,391.859999317025,0.420734126984127,0.20815999049090728,0.23906585745135106,132871.3884833958,3213.396440071129,136084.78492346694,703,2,279.1111111111111,33,3,19,32.14853500534887,0.6556186868686869,42.24877450980392,1031.0049019607843,31.242572786690435,0
714,4,0,0,35,0.0,0.0,1.0,35,1000,600,400,0.6,14,6,8,391.77165554245346,0.4199579831932773,0.1916253817441469,0.24043129297867782,133092.59059015766,3428.3809111880128,136520.9715013457,699,3,268.0,33,2,19,31.92794932699922,0.6578282828282829,42.0343137254902,1031.8627450980396,31.268568033273926,0
715,4,0,0,35,0.0,0.0,1.0,35,850,600,250,0.7058823529411765,11,6,5,388.74593148351784,0.4203081232492997,0.18945404589474424,0.23918239451319728,133187.44781153888,3355.215692281819,136542.6635038207,700,4,269.0,33,2,19,31.910517828168903,0.6587752525252526,41.942401960784316,1032.230392156863,31.279708853238272,0
716,4,0,0,35,0.0,0.0,1.0,35,850,700,150,0.8235294117647058,10,7,3,389.5434254592376,0.4198529411764706,0.19189583262690335,0.2402849855724402,133282.33882400987,3383.851763744701,136666.19058775457,701,5,270.0,33,2,19,31.79444576311417,0.6597222222222222,41.850490196078425,1032.5980392156855,31.29084967320259,0
717,4,0,0,35,0.0,0.0,1.0,35,800,300,500,0.375,13,3,10,388.2980205417866,0.4198529411764706,0.1853923063887477,0.24033423738379298,133408.91273788922,3360.483347750862,136769.39608564007,702,6,271.0,33,2,20,31.699288256227746,0.6609848484848485,41.72794117647059,1033.0882352941173,31.30570409982174,0
718,4,1,0,36,0.027777777777777776,0.0,1.0,36,900,600,300,0.6666666666666666,12,6,6,378.33943532265636,0.4213955026455027,0.18729594523433368,0.23618231021621464,133725.61034217614,2918.7493992695127,136644.35974144566,703,0,264.44444444444446,33,3,18,31.638526856240123,0.6641414141414141,41.42156862745098,1034.3137254901965,31.34284016636959,0
719,4,0,0,36,0.0,0.0,1.0,36,850,500,350,0.5882352941176471,12,5,7,376.81932504196413,0.42142857142857143,0.18746874095132782,0.23563768459290843,133788.9949178201,2882.8557525951533,136671.85067041524,704,1,265.44444444444446,33,3,18,31.614250177683,0.6647727272727273,41.36029411764706,1034.558823529412,31.35026737967915,0
720,4,0,0,36,0.0,0.0,1.0,36,850,500,350,0.5882352941176471,12,5,7,375.72072899302094,0.42123015873015873,0.18442299340676738,0.23515271422446804,133820.69283749032,2855.8416534505927,136676.53449094092,705,2,266.44444444444446,33,3,18,31.610875873504693,0.6650883838383839,41.3296568627451,1034.681372549019,31.35398098633391,0
721,4,0,0,36,0.0,0.0,1.0,36,1000,600,400,0.6,14,6,8,376.23411778460274,0.4208498677248677,0.18786515079741029,0.23567662392976158,133852.39451172628,2871.9675124951896,136724.36202422145,706,3,267.44444444444446,33,3,18,31.565806095057617,0.6654040404040404,41.299019607843135,1034.8039215686276,31.357694592988715,0
722,4,0,0,36,0.0,0.0,1.0,36,600,300,300,0.5,9,3,6,399.42890684058784,0.4204861111111111,0.19012798795407493,0.23377018969421048,131298.46810967507,3288.880717378255,134587.34882705333,707,4,268.44444444444446,35,1,18,33.544725202333886,0.6354166666666667,43.77893518518518,1024.8842592592591,29.282407407407405,8
723,4,0,0,36,0.0,0.0,1.0,36,1050,900,150,0.8571428571428571,12,9,3,396.7365152342152,0.42075066137566136,0.18620109137350482,0.2329305798031557,131419.65880102038,3227.7988421770438,134647.45764319744,708,5,269.44444444444446,34,2,19,33.49079879252293,0.6387867647058824,43.660714285714285,1025.3571428571427,30.157563025210077,0
724,4,0,1,35,0.0,0.027777777777777776,0.9722222222222222,36,950,600,350,0.631578947368421,13,6,7,401.07567633972553,0.4199074074074074,0.1860124803383103,0.23642066885743862,131572.28599773237,3354.0887188208562,134926.37471655323,709,6,270.44444444444446,34,2,15,33.22479113483407,0.6403186274509804,43.51190476190476,1025.9523809523805,30.17507002801119,0
725,4,0,0,35,0.0,0.0,1.0,35,1050,800,250,0.7619047619047619,13,8,5,410.6288534508381,0.4173669467787115,0.1865520124208766,0.242297067649321,131610.90573637528,3808.647064830811,135419.5528012061,710,14,279.0,33,2,17,32.94057784943667,0.6429924242424243,43.47426470588234,1026.1029411764694,31.094028520499073,0
726,4,1,0,36,0.027777777777777776,0.0,1.0,36,1400,900,500,0.6428571428571429,19,9,10,403.37768453165756,0.41780753968253964,0.1816189814278546,0.24066064620330313,132030.69905045338,3451.64753401359,135482.34658446696,711,0,272.22222222222223,34,2,19,32.701310861423224,0.6449142156862745,43.06547619047618,1027.7380952380943,30.227591036414537,0
727,4,0,1,35,0.0,0.027777777777777776,0.9722222222222222,36,1250,1000,250,0.8,15,10,5,402.00143250932905,0.417146164021164,0.17809360245970218,0.24061582623583305,132153.0771683672,3425.1452664398907,135578.22243480707,712,1,273.22222222222223,34,2,19,32.612838176836085,0.6461397058823529,42.94642857142856,1028.2142857142844,30.241596638655423,0
728,4,1,0,36,0.027777777777777776,0.0,1.0,36,700,500,200,0.7142857142857143,9,5,4,400.04902906378646,0.42046957671957674,0.17235725308642014,0.24002941743827155,132244.8979591835,3380.888605442158,135625.78656462565,713,0,270.30555555555554,34,2,20,32.57016782407407,0.6470588235294117,42.85714285714285,1028.571428571427,30.25210084033609,0
729,4,0,0,36,0.0,0.0,1.0,36,1050,700,350,0.6666666666666666,14,7,7,398.0827664399094,0.419130291005291,0.16505291005291034,0.24022235905856587,132461.0726643598,3346.1826274627388,135807.25529182254,714,1,271.30555555555554,33,3,21,32.40228174603174,0.6515151515151515,42.647058823529406,1029.4117647058818,31.194295900178236,0
730,4,0,0,36,0.0,0.0,1.0,36,850,400,450,0.47058823529411764,13,4,9,397.38511242525726,0.41850198412698414,0.16520189395442353,0.24000232419012105,132492.6128922769,3330.118373942701,135822.7312662196,715,2,272.30555555555554,33,3,21,32.38838134349085,0.6518308080808081,42.616421568627445,1029.5343137254895,31.198009506833014,0
731,4,0,1,35,0.0,0.027777777777777776,0.9722222222222222,36,700,400,300,0.5714285714285714,10,4,6,388.6282864065031,0.4181547619047619,0.10771989429973594,0.2231201410253201,130558.13426997603,2947.7167995541877,133505.8510695302,716,3,273.30555555555554,35,1,17,34.57295205738014,0.6279761904761905,44.50231481481482,1021.990740740741,29.199735449735456,8
732,4,1,0,36,0.027777777777777776,0.0,1.0,36,1000,700,300,0.7,13,7,6,389.2440236739806,0.41721230158730155,0.13638163103721324,0.22536387775387445,130883.62328800155,2989.1336323302485,133872.7569203318,717,0,274.19444444444446,35,1,18,34.226543942992876,0.63125,44.18402777777778,1023.2638888888889,29.23611111111111,0
733,4,0,0,36,0.0,0.0,1.0,36,850,500,350,0.5882352941176471,12,5,7,388.7346332204959,0.41668320105820106,0.138606307222787,0.2261101446483714,131061.33355034732,2989.615885416676,134050.949435764,718,1,275.19444444444446,35,1,18,34.05921498813157,0.6330357142857144,44.01041666666667,1023.9583333333342,29.255952380952404,0
734,4,1,0,37,0.02702702702702703,0.0,1.0,37,950,700,250,0.7368421052631579,12,7,5,379.5336867319516,0.418480980980981,0.1344790652682717,0.22247054026372567,131357.78523930468,2571.212169924557,133928.99740922923,719,0,268.72972972972974,35,2,19,33.99441590455762,0.6360119047619048,43.72106481481482,1025.1157407407406,29.28902116402116,0
735,4,0,0,37,0.0,0.0,1.0,37,1050,700,350,0.6666666666666666,14,7,7,375.53366406088236,0.41747997997998,0.13924362294464387,0.2214554830588154,131587.96623904307,2483.142221613504,134071.10846065657,720,1,269.72972972972974,36,1,18,33.864056268978885,0.6362847222222222,43.49662162162162,1026.0135135135133,28.50037537537537,0
736,4,0,0,37,0.0,0.0,1.0,37,850,600,250,0.7058823529411765,11,6,5,377.9753269304933,0.4173861361361361,0.1375247559977708,0.22374175846093358,131732.43344696047,2558.3219198928678,134290.75536685332,721,2,270.72972972972974,36,1,19,33.65534042708792,0.6377314814814814,43.35585585585586,1026.5765765765766,28.516016016016017,0
737,4,0,1,36,0.0,0.02702702702702703,0.972972972972973,37,900,600,300,0.6666666666666666,12,6,6,379.1676285010768,0.4167292292292292,0.12952821242294887,0.22513077942251467,131848.06428049688,2598.5035711387186,134446.5678516356,722,3,271.72972972972974,36,1,20,33.50785818713449,0.6388888888888888,43.24324324324325,1027.0270270270282,28.52852852852856,0
738,4,0,0,36,0.0,0.0,1.0,36,1200,800,400,0.6666666666666666,16,8,8,381.5698789922636,0.416385582010582,0.11739906103286435,0.22682067488655996,131892.24222232934,2865.221380958503,134757.46360328785,723,4,267.47222222222223,35,1,20,33.40152582159625,0.6413690476190477,43.20023148148148,1027.1990740740737,29.34854497354496,0
739,4,0,0,36,0.0,0.0,1.0,36,1000,600,400,0.6,14,6,8,385.4197300918212,0.41582341269841266,0.12422075540887456,0.2048810144172312,127512.49999999997,2639.541805984224,130152.04180598419,724,5,268.47222222222223,34,2,18,37.768151815181525,0.5992647058823529,47.5,1009.9999999999998,29.70588235294117,8
740,4,1,0,37,0.02702702702702703,0.0,1.0,37,950,700,250,0.7368421052631579,12,7,5,377.76584517985106,0.41804304304304307,0.13671513865999563,0.20295336525612043,127939.53517500433,2266.2373274605643,130205.7725024649,725,0,262.18918918918916,35,2,20,37.522999847462145,0.6014880952380952,47.0775462962963,1011.6898148148152,28.905423280423292,0
741,4,0,0,37,0.0,0.0,1.0,37,1100,800,300,0.7272727272727273,14,8,6,376.3950750387773,0.41735485485485485,0.1332558542073643,0.20266000838294754,128027.37054183809,2237.7743484224948,130265.14489026058,726,1,263.18918918918916,35,2,21,37.46759682830133,0.6023809523809525,46.99074074074074,1012.0370370370366,28.915343915343904,0
742,4,2,0,39,0.05128205128205128,0.0,1.0,39,1350,1000,350,0.7407407407407407,17,10,7,356.75611949192336,0.4211369770580297,0.13448978179706805,0.19528788737505842,128687.51594387743,1382.172514067343,130069.68845794477,727,0,250.64102564102564,34,5,19,37.28978450467365,0.6112132352941176,46.33928571428571,1014.6428571428562,29.842436974789887,0
743,4,0,0,39,0.0,0.0,1.0,39,450,200,250,0.4444444444444444,7,2,5,355.64724457385284,0.42127755285650026,0.13420957962990587,0.1947507428593982,128701.77636584776,1354.4864272547861,130056.26279310255,728,1,251.64102564102564,35,4,19,37.30335823732939,0.6092261904761904,46.325231481481474,1014.6990740740729,28.99140211640208,0
744,4,0,0,39,0.0,0.0,1.0,39,950,700,250,0.7368421052631579,12,7,5,356.58153573717794,0.4211088618983356,0.1291114814489953,0.19569587411858885,128789.87295310355,1384.8181370027396,130174.6910901063,729,2,252.64102564102564,35,4,19,37.189756746484214,0.6101190476190477,46.238425925925924,1015.0462962962962,29.00132275132275,0
745,4,0,0,39,0.0,0.0,1.0,39,1150,800,350,0.6956521739130435,15,8,7,413.90615395123325,0.42175551057130006,0.2314049586776865,0.21775062881782245,127092.01388888872,2982.2546939300214,130074.26858281874,730,3,253.64102564102564,34,5,18,37.48278236914601,0.5949754901960784,47.91666666666666,1008.3333333333319,29.656862745097996,8
746,4,2,2,39,0.04878048780487805,0.04878048780487805,0.9512195121951219,41,950,500,450,0.5263157894736842,14,5,9,398.1043779661982,0.4270071138211382,0.22532379495567234,0.212851876176448,127745.77100326677,1971.230140613582,129717.00114388035,731,0,242.21951219512195,36,5,18,37.20781812780808,0.5975115740740741,47.26914414414414,1010.9234234234233,28.081206206206204,0
747,4,1,0,40,0.025,0.0,1.0,40,900,600,300,0.6666666666666666,12,6,6,398.79940178017927,0.4251201923076923,0.2145021162842511,0.2133743163994307,127774.23327043248,2191.2575582339005,129965.49082866638,732,0,233.375,36,4,19,37.16097683225664,0.5978009259259259,47.24099099099099,1011.0360360360351,28.084334334334308,0
748,4,0,0,40,0.0,0.0,1.0,40,950,700,250,0.7368421052631579,12,7,5,400.49974950521107,0.4243456196581197,0.21426503340757286,0.2145875746155604,127831.16731596456,2239.270097800499,130070.43741376506,733,1,234.375,36,4,20,37.059437639198215,0.5983796296296297,47.18468468468468,1011.2612612612608,28.090590590590576,0
749,4,0,1,39,0.0,0.025,0.975,40,1050,800,250,0.7619047619047619,13,8,5,399.78519596406,0.42413194444444446,0.2148519260743711,0.21450840084523218,127888.11404309716,2225.5549468387303,130113.66898993589,734,2,235.375,36,4,20,37.018945298003416,0.5989583333333333,47.12837837837838,1011.4864864864866,28.096846846846848,0
750,4,2,0,41,0.04878048780487805,0.0,1.0,41,1050,900,150,0.8571428571428571,12,9,3,373.03784633650974,0.43066565040650406,0.22107977817857027,0.1920945778110066,126218.2315779318,1308.6565838078754,127526.88816173968,735,0,229.21951219512195,35,6,20,39.41344160331721,0.5839285714285714,48.78472222222221,1004.8611111111087,28.71031746031739,8
751,4,2,1,42,0.046511627906976744,0.023255813953488372,0.9767441860465116,43,1800,1500,300,0.8333333333333334,21,15,6,365.4743050833391,0.436000369139904,0.24536363613366152,0.19187922824849418,127009.10526556235,683.7128972376001,127692.81816279994,736,0,219.51162790697674,37,6,20,38.78891094673486,0.5881193693693694,47.998903508771924,1008.0043859649112,27.24336178283544,0
752,4,1,0,43,0.023255813953488372,0.0,1.0,43,1200,900,300,0.75,15,9,6,367.0569595025509,0.4384920634920635,0.2575010382059797,0.1939168842654986,127262.39753266788,742.5367910620066,128004.93432372989,737,0,220.27906976744185,36,7,22,38.48865327380952,0.5925925925925926,47.74774774774775,1009.0090090090097,28.028028028028046,0
753,4,1,1,43,0.022727272727272728,0.022727272727272728,0.9772727272727273,44,1000,700,300,0.7,13,7,6,359.75538413816406,0.4396471987315011,0.26377500172680834,0.19147465939138686,127562.34039560256,378.24775411665263,127940.58814971922,738,0,216.25,37,7,15,38.36505933644485,0.59375,47.45065789473684,1010.1973684210532,27.302631578947384,0
754,4,2,0,45,0.044444444444444446,0.0,1.0,45,1400,1000,400,0.7142857142857143,18,10,8,355.4165850836488,0.4392676767676768,0.28013481541002627,0.19106520092293777,127964.52591050304,96.14296219181972,128060.66887269486,739,0,212.37777777777777,40,5,18,38.06268414356503,0.5927083333333334,47.052845528455286,1011.7886178861792,25.29471544715448,0
755,4,1,0,46,0.021739130434782608,0.0,1.0,46,1200,800,400,0.6666666666666666,16,8,8,350.6662566968242,0.4411433172302737,0.28509259995230907,0.1899152895179828,128261.74554183803,-203.8276659208317,128057.91787591719,740,0,208.7391304347826,35,11,19,37.87896099939061,0.6047619047619048,46.75925925925925,1012.962962962962,28.941798941798915,0
756,4,1,0,47,0.02127659574468085,0.0,1.0,47,1100,800,300,0.7272727272727273,14,8,6,343.3253836327531,0.44391766882516187,0.2942062617727359,0.1876020746595745,128616.79945992987,-568.517596760548,128048.28186316932,741,0,205.27659574468086,37,10,17,37.70256819082623,0.6044481981981982,46.40899122807017,1014.3640350877184,27.415244191559957,0
757,4,1,1,47,0.020833333333333332,0.020833333333333332,0.9791666666666666,48,1450,1000,450,0.6896551724137931,19,10,9,335.4947039842871,0.4460050975177305,0.2948889941077435,0.18452208719135807,128875.73964497057,-952.5743754108987,127923.16526955967,742,0,201.97916666666666,38,10,18,37.63744212962962,0.6052631578947368,46.15384615384616,1015.3846153846166,26.720647773279385,0
758,4,1,2,46,0.020833333333333332,0.041666666666666664,0.9583333333333334,48,1600,800,800,0.5,24,8,16,350.8657972851796,0.44845227541371163,0.2858895679698288,0.18193926282482933,126503.47764434198,-715.0182457003906,125788.45939864159,743,0,192.0,40,8,13,39.67677711553357,0.5778645833333333,48.5010162601626,1005.9959349593495,25.14989837398374,8
759,4,1,1,46,0.02127659574468085,0.02127659574468085,0.9787234042553191,47,1150,700,450,0.6086956521739131,16,7,9,357.1517503104329,0.44750231267345053,0.2944010654408371,0.18589532773646006,126656.87715851997,-352.8549267962283,126304.02223172375,744,0,196.70212765957447,40,7,15,39.3608026249369,0.5794270833333333,48.34857723577235,1006.6056910569098,25.165142276422745,0
760,4,0,0,46,0.0,0.0,1.0,46,1600,1200,400,0.75,20,12,8,362.08366261180544,0.4464975845410628,0.31055065266869963,0.18877565710926153,126724.65820312487,-23.01432291668212,126701.64388020818,745,1,201.8913043478261,39,7,15,39.166925305193445,0.5817307692307692,48.28124999999999,1006.874999999999,25.817307692307665,0
761,4,1,0,47,0.02127659574468085,0.0,1.0,47,1400,800,600,0.5714285714285714,20,8,12,360.2895977050752,0.44966080789392543,0.31668718129066353,0.1895436579231044,127092.01388888858,-240.95052083336833,126851.06336805521,746,0,198.5744680851064,38,9,16,38.83436639118459,0.587171052631579,47.91666666666665,1008.3333333333309,26.53508771929818,0
762,4,0,0,47,0.0,0.0,1.0,47,1350,900,450,0.6666666666666666,18,9,9,364.7508971371432,0.4495644465001542,0.31942835767755673,0.19240100395357002,127199.7646376651,-120.75434655565155,127079.01029110944,747,1,199.5744680851064,38,9,16,38.61116994986936,0.5882675438596492,47.80982905982905,1008.7606837606822,26.54633378317585,0
763,4,3,0,50,0.06,0.0,1.0,50,1650,1300,350,0.7878787878787878,20,13,7,352.2019614584885,0.45562074829931976,0.3370008820935022,0.1898318337433148,128069.20750070829,-978.7547831633015,127090.45271754499,748,0,188.54,41,9,17,38.03691316279524,0.5922256097560976,46.949404761904745,1012.2023809523783,24.68786295005801,0
764,4,2,4,48,0.038461538461538464,0.07692307692307693,0.9230769230769231,52,1550,1100,450,0.7096774193548387,20,11,9,343.16348127115975,0.4576263197586727,0.3380684445814708,0.18735074086904654,128582.2137946988,-1574.9895441086023,127007.2242505902,749,0,182.25,40,12,14,37.74194221776887,0.5989583333333333,46.443089430894304,1014.2276422764218,25.355691056910544,0
765,4,1,2,47,0.02040816326530612,0.04081632653061224,0.9591836734693877,49,1100,900,200,0.8181818181818182,13,9,4,356.7277509400549,0.45429421768707484,0.34499763915849146,0.19326893470150594,128276.40109592005,-648.0495876736172,127628.35150824643,750,0,194.0204081632653,39,10,19,37.71047557840618,0.5974893162393162,46.744791666666664,1013.0208333333326,25.974893162393144,0
766,4,0,0,47,0.0,0.0,1.0,47,1400,1000,400,0.7142857142857143,18,10,8,372.74128266355075,0.45056660499537465,0.35425969704929505,0.2012802926383172,128144.53124999988,152.95138888887203,128297.48263888876,751,1,202.72340425531914,37,10,19,37.439986282578865,0.5996621621621622,46.87499999999999,1012.4999999999991,27.364864864864842,0
767,4,0,0,47,0.0,0.0,1.0,47,1400,1000,400,0.7142857142857143,18,10,8,370.3241092560017,0.4506822386679001,0.35388889138210367,0.20065218308373753,128279.78326576078,101.01929468915668,128380.80256044994,752,2,203.72340425531914,38,9,20,37.36267840821205,0.5992324561403508,46.74145299145299,1013.0341880341877,26.658794421952308,0
768,4,0,2,45,0.0,0.0425531914893617,0.9574468085106383,47,1600,800,800,0.5,24,8,16,371.81803594263636,0.45087496145544254,0.3478834880152477,0.20264707513245406,128513.9377170141,156.75998263891242,128670.69769965301,753,3,204.72340425531914,39,8,14,37.085216765974934,0.5998931623931624,46.51041666666668,1013.9583333333351,25.998931623931668,0
769,4,1,2,44,0.021739130434782608,0.043478260869565216,0.9565217391304348,46,1150,800,350,0.6956521739130435,15,8,7,387.1829274299058,0.4499899355877617,0.3610816542948041,0.19868729063080454,126075.53597847155,767.8720403211382,126843.40801879269,754,0,199.45652173913044,32,14,20,39.20564076774789,0.5891927083333333,48.926767676767675,1004.292929292929,31.38415404040403,8
770,4,1,0,45,0.022222222222222223,0.0,1.0,45,1250,1000,250,0.8,15,10,5,391.50869475825783,0.4487794612794613,0.36987929273310627,0.2025198693649044,126403.6581251355,897.6262410481576,127301.28436618365,755,0,198.8,31,14,16,38.75774202598298,0.5950940860215054,48.60026041666666,1005.5989583333322,32.43867607526878,0
771,4,0,0,45,0.0,0.0,1.0,45,1100,500,600,0.45454545454545453,17,5,12,389.45673763752063,0.4487373737373737,0.36865248838847964,0.20210424524681783,126534.62939792189,855.9527926974604,127390.58219061935,756,1,199.8,31,14,16,38.67404878995731,0.5964381720430108,48.47005208333332,1006.119791666665,32.45547715053758,0
772,4,0,0,45,0.0,0.0,1.0,45,1150,700,450,0.6086956521739131,16,7,9,391.122844775994,0.4489057239057239,0.36850248818634257,0.20336857114869186,126615.03170913672,904.4062786960388,127519.43798783276,757,2,200.8,32,13,16,38.54911554384644,0.5947265625,48.39015151515151,1006.4393939393931,31.451231060606034,0
773,4,3,2,46,0.0625,0.041666666666666664,0.9583333333333334,48,1700,1200,500,0.7058823529411765,22,12,10,360.65584101771196,0.4529864804964539,0.35702331836751244,0.19162893525641284,127493.93449935115,-401.9200624819341,127092.01443686921,758,0,189.1875,33,15,18,38.412485337539955,0.6013257575757576,47.518382352941174,1009.9264705882347,30.603832442067716,0
774,4,0,0,46,0.0,0.0,1.0,46,1050,500,550,0.47619047619047616,16,5,11,377.8639413452741,0.4514190821256039,0.3550960351176842,0.19988527353889984,127314.91246110093,421.5429229160315,127736.45538401697,759,1,197.47826086956522,32,14,20,38.16203761624754,0.6018880208333333,47.69570707070707,1009.2171717171719,31.538036616161623,0
775,4,2,0,48,0.041666666666666664,0.0,1.0,48,1200,800,400,0.6666666666666666,16,8,8,362.11037190275,0.4550088652482269,0.35485808716802025,0.1943684036675722,127903.57320011342,-336.9579081632612,127566.61529195016,760,0,190.20833333333334,34,14,22,37.955798124828384,0.6032475490196079,47.11309523809524,1011.5476190476194,29.7514005602241,0
776,4,0,0,48,0.0,0.0,1.0,48,1350,800,550,0.5925925925925926,19,8,11,364.77567268355705,0.45447325650118203,0.3596637894897299,0.19683484324263242,128115.23604948985,-253.33571780693194,127861.90033168292,761,1,191.20833333333334,35,13,22,37.67160645554667,0.6032738095238095,46.90393518518518,1012.384259259259,28.925264550264544,0
777,4,0,1,47,0.0,0.020833333333333332,0.9791666666666666,48,1150,800,350,0.6956521739130435,15,8,7,366.79982702765557,0.4543809101654846,0.35923086512091684,0.19854711284857346,128240.42986685057,-192.2764544380799,128048.15341241249,762,2,192.20833333333334,32,16,22,37.492208925454996,0.611328125,46.780303030303045,1012.8787878787899,31.652462121212185,0
778,4,2,0,49,0.04081632653061224,0.0,1.0,49,850,500,350,0.5882352941176471,12,5,7,348.5134170101623,0.4580498866213152,0.34573266454799545,0.19150273326434708,128838.54875283454,-819.6074263038402,128018.9413265307,763,0,187.0408163265306,34,15,19,37.34487374921828,0.6127450980392157,46.1904761904762,1015.2380952380959,29.859943977591055,0
779,4,0,3,46,0.0,0.061224489795918366,0.9387755102040817,49,1700,1400,300,0.8235294117647058,20,14,6,353.165392631435,0.45790816326530615,0.3510070147829434,0.19480027765507674,128989.67013888896,-689.0624999999902,128300.60763888898,764,1,188.0408163265306,34,15,19,37.072737216297504,0.6142769607843137,46.04166666666667,1015.8333333333339,29.877450980392176,0
780,4,1,2,45,0.02127659574468085,0.0425531914893617,0.9574468085106383,47,1950,1400,550,0.717948717948718,25,14,11,355.5647666855153,0.45754316990440946,0.2877286819870781,0.19186838250316818,128116.02776763252,-268.2839511809054,127847.74381645162,765,0,178.04255319148936,36,11,21,37.903921023359295,0.6012731481481481,46.903153153153156,1012.3873873873875,28.121871871871875,8
781,4,1,2,44,0.021739130434782608,0.043478260869565216,0.9565217391304348,46,1250,800,450,0.64,17,8,9,368.49702258838977,0.45708534621578095,0.3224454670350716,0.20019241565379453,128385.71605725618,261.95399239558805,128647.67004965177,766,0,182.69565217391303,34,12,18,37.30055013900309,0.6081495098039216,46.63690476190476,1013.4523809523805,29.807422969187662,0
782,4,2,0,46,0.043478260869565216,0.0,1.0,46,1100,700,400,0.6363636363636364,15,7,8,370.3194641630775,0.45416666666666666,0.3403875391569644,0.20255856698316743,128657.320011338,328.86196145126405,128986.18197278926,767,0,183.58695652173913,34,12,20,36.976599780959084,0.610906862745098,46.36904761904763,1014.5238095238105,29.838935574229723,0
783,4,1,0,47,0.02127659574468085,0.0,1.0,47,650,300,350,0.46153846153846156,10,3,7,364.44186155115426,0.4559435707678076,0.34703630107109973,0.20149871186518495,129083.74592764073,8.704132373131586,129092.45006001386,768,0,180.6595744680851,35,12,21,36.6903948367502,0.6130952380952381,45.94907407407408,1016.2037037037047,29.034391534391563,0
784,4,1,0,48,0.020833333333333332,0.0,1.0,48,1400,1200,200,0.8571428571428571,16,12,4,352.3086349136825,0.4562924793144208,0.33789744670600985,0.19645524484139046,129419.51600646372,-480.71664588586066,128938.79936057786,769,0,177.875,33,15,22,36.65680577301376,0.6208964646464646,45.6188725490196,1017.5245098039204,30.834076054664255,0
785,4,1,1,48,0.02040816326530612,0.02040816326530612,0.9795918367346939,49,1350,900,450,0.6666666666666666,18,9,9,342.378962951811,0.4571995464852608,0.33395935061141024,0.19244058952119028,129731.4453125,-916.5364583333329,128814.90885416667,770,0,175.22448979591837,35,14,18,36.592535787321054,0.6196428571428572,45.3125,1018.75,29.107142857142858,0
786,4,0,0,48,0.0,0.0,1.0,48,1250,800,450,0.64,17,8,9,334.93720110587793,0.45679114952718675,0.2554476612404699,0.1792117130062651,127775.65646701379,-1040.6358506944543,126735.02061631934,771,1,179.85416666666666,39,9,17,38.77369668246445,0.5924145299145299,47.23958333333333,1011.0416666666658,25.924145299145277,8
787,4,0,1,47,0.0,0.020833333333333332,0.9791666666666666,48,1450,1300,150,0.896551724137931,16,13,3,331.40215411469103,0.4564032949172577,0.2512507294133799,0.1779019523829609,127907.33642578113,-1122.2466362847372,126785.0897894964,772,2,180.85416666666666,39,9,18,38.728525211958925,0.59375,47.10937499999999,1011.5624999999991,25.937499999999975,0
788,4,1,2,46,0.020833333333333332,0.041666666666666664,0.9583333333333334,48,1700,1400,300,0.8235294117647058,20,14,6,334.88117131514275,0.45644023345153667,0.2597359438784266,0.18047922028115587,128065.4418945312,-1022.6589626736122,127042.7829318576,773,0,181.72916666666666,39,9,19,38.47906161023635,0.5953525641025641,46.953125,1012.1874999999997,25.95352564102563,0
789,4,2,2,46,0.041666666666666664,0.041666666666666664,0.9583333333333334,48,1850,1400,450,0.7567567567567568,23,14,9,331.388822378185,0.4551750886524823,0.2725289452951045,0.18025403189279607,128434.7344292536,-1087.6329210069357,127347.10150824666,774,0,182.20833333333334,39,9,12,38.19076919124447,0.5990918803418803,46.58854166666667,1013.6458333333344,25.99091880341883,0
790,4,0,0,46,0.0,0.0,1.0,46,1100,700,400,0.6363636363636364,15,7,8,346.349981743603,0.45316022544283413,0.28488637486646895,0.1876790311629999,128283.34349270926,-313.8132646583614,127969.5302280509,775,1,190.7826086956522,37,9,21,37.96620756214596,0.6010698198198199,46.737938596491226,1013.0482456140348,27.379682313892832,0
791,4,2,0,48,0.041666666666666664,0.0,1.0,48,1600,1300,300,0.8125,19,13,6,333.3365647759138,0.45324505023640665,0.28610298895386643,0.18325050743772317,128857.43408203125,-1009.4211154513897,127848.01296657986,776,0,183.79166666666666,39,9,18,37.710855476898864,0.6033653846153846,46.171875,1015.3125,26.033653846153847,0
792,4,2,1,49,0.04,0.02,0.98,50,1800,1300,500,0.7222222222222222,23,13,10,322.0969683370403,0.45359693877551016,0.2887475614514232,0.17907473532490983,129302.26836104809,-1670.426272360803,127631.84208868729,777,0,177.4,41,9,21,37.54430029912862,0.6046747967479675,45.73412698412698,1017.0634920634918,24.806426635694923,0
793,4,0,0,49,0.0,0.0,1.0,49,1150,700,450,0.6086956521739131,16,7,9,325.3370298233241,0.4529124149659864,0.2850169541290397,0.18100602176218175,129330.57089240852,-1384.7952401017972,127945.77565230672,778,1,181.24489795918367,40,9,22,37.43318513337995,0.6065104166666666,45.70630081300813,1017.1747967479666,25.429369918699166,0
794,4,1,1,49,0.02,0.02,0.98,50,1100,900,200,0.8181818181818182,13,9,4,324.7316051704177,0.4538180272108843,0.23063761742954236,0.1803143419164929,129253.05394441148,-1547.5375313966442,127705.51641301483,779,0,178.6,40,10,18,37.52727530148578,0.6057291666666667,45.78252032520326,1016.8699186991877,25.421747967479693,8
795,4,0,1,48,0.0,0.02040816326530612,0.9795918367346939,49,1400,900,500,0.6428571428571429,19,9,10,333.30551623196095,0.4522923752834467,0.23193508527271178,0.18495708606823025,129227.86593967008,-1185.5278862847276,128042.33805338535,780,1,183.14285714285714,39,10,19,37.33490847932248,0.6071047008547008,45.807291666666664,1016.7708333333328,26.071047008546994,0
796,4,1,0,49,0.02040816326530612,0.0,1.0,49,1650,1300,350,0.7878787878787878,20,13,7,334.2971624155153,0.4516723356009071,0.24072787009540653,0.18648008285607545,129433.96297053665,-1146.1186917509465,128287.8442787857,781,0,184.0612244897959,40,9,15,37.10031126202604,0.6075520833333333,45.604674796747965,1017.5813008130076,25.43953252032519,0
797,4,1,1,49,0.02,0.02,0.98,50,2200,1700,500,0.7727272727272727,27,17,10,325.9019492223601,0.45328231292517,0.23725971370143117,0.1831793714594645,129731.44531250003,-1544.053819444443,128187.39149305559,782,0,181.36,41,9,16,37.012184730743,0.6089939024390244,45.3125,1018.7500000000002,24.847560975609763,0
798,4,0,0,49,0.0,0.0,1.0,49,1550,1100,450,0.7096774193548387,20,11,9,335.19940796388136,0.45202664399092973,0.24586289378594417,0.18846741810644452,129744.38707325309,-1101.9516532817963,128642.4354199713,783,1,185.9387755102041,40,9,17,36.762261014131354,0.6106770833333333,45.29979674796747,1018.800813008128,25.4700203252032,0
799,4,2,2,49,0.0392156862745098,0.0392156862745098,0.9607843137254902,51,1600,1200,400,0.75,20,12,8,343.2529516596127,0.45357843137254905,0.20624817091015535,0.18850776853437715,128816.57483930195,-1354.6005233094747,127461.97431599247,784,0,179.6078431372549,43,8,15,37.50077736318408,0.5968992248062015,46.212121212121204,1015.1515151515138,23.608174770965437,8
800,4,0,0,49,0.0,0.0,1.0,49,1400,1000,400,0.7142857142857143,18,10,8,349.81817923945823,0.45071570294784585,0.2107693013660643,0.19165989048957752,128722.74900990463,-794.0884629314955,127928.66054697313,785,1,187.42857142857142,41,8,16,37.42983592400691,0.5988313008130082,46.30456349206348,1014.781746031744,24.75077429345717,0
801,4,1,1,49,0.02,0.02,0.98,50,1100,600,500,0.5454545454545454,16,6,10,347.42612667530966,0.45100340136054423,0.21707626328547458,0.19149499664539438,128960.81285152676,-1039.1288596189017,127921.68399190786,786,0,184.66,43,7,17,37.247886754925744,0.5983527131782946,46.070075757575765,1015.719696969698,23.621388301620883,0
802,4,0,2,47,0.0,0.04081632653061224,0.9591836734693877,49,1700,1200,500,0.7058823529411765,22,12,10,352.78969193357455,0.44968820861678,0.21818928913847424,0.19468764480778727,129008.91012396681,-697.3972681359193,128311.5128558309,787,1,189.28571428571428,43,6,17,37.06267089236887,0.5988372093023255,46.022727272727266,1015.9090909090897,23.625792811839297,0
803,4,2,1,48,0.04081632653061224,0.02040816326530612,0.9795918367346939,49,1300,800,500,0.6153846153846154,18,8,10,346.94420295102236,0.44933390022675734,0.23839898560562967,0.19328093576753927,129382.26176754896,-821.8844222400983,128560.37734530887,788,0,189.0408163265306,40,9,19,36.831152399027744,0.60703125,45.65548780487804,1017.3780487804869,25.434451219512173,0
804,4,0,1,47,0.0,0.020833333333333332,0.9791666666666666,48,1550,1200,350,0.7741935483870968,19,12,7,346.0689287045272,0.4486739066193854,0.24195709340256988,0.19317359264476777,129459.8174449732,-639.5959333068963,128820.22151166631,789,1,193.14583333333334,40,8,14,36.77455728646561,0.6078125,45.579268292682926,1017.682926829268,25.4420731707317,0
805,4,1,2,46,0.020833333333333332,0.041666666666666664,0.9583333333333334,48,900,600,300,0.6666666666666666,12,6,6,344.6372338690458,0.4505577718676123,0.24041411042944816,0.1937098935194978,129731.4453124997,-657.9427083333637,129073.50260416634,790,0,192.625,41,7,16,36.53502044989776,0.6089939024390244,45.312499999999986,1018.7499999999976,24.8475609756097,0
806,4,1,1,46,0.02127659574468085,0.02127659574468085,0.9787234042553191,47,1600,1000,600,0.625,22,10,12,348.72093943613925,0.4492560900400864,0.2553389172124363,0.19660992515197315,129852.0640083362,-343.5732502582627,129508.49075807793,791,0,196.9787234042553,43,4,17,36.30851450958531,0.6073158914728682,45.19412878787879,1019.2234848484848,23.702871740662435,0
807,4,0,1,45,0.0,0.021739130434782608,0.9782608695652174,46,1100,700,400,0.6363636363636364,15,7,8,358.1438667323167,0.4490338164251208,0.25783778421655223,0.20200082220682247,129867.2154336427,102.22933943271357,129969.44477307542,792,1,201.93478260869566,42,4,17,36.05301517888265,0.6088789682539683,45.17926356589147,1019.2829457364332,24.26864156515317,0
808,4,0,0,45,0.0,0.0,1.0,45,1350,700,650,0.5185185185185185,20,7,13,363.79989121009885,0.44768518518518513,0.26238903340352593,0.205238051833622,129876.19447314065,449.78908402205315,130325.9835571627,793,2,207.2888888888889,43,2,17,35.89975845410628,0.6075581395348837,45.170454545454554,1019.3181818181831,23.705073995771702,0
809,4,0,1,44,0.0,0.022222222222222223,0.9777777777777777,45,1500,1100,400,0.7333333333333333,19,11,8,361.15279549833457,0.4474747474747475,0.25826628708173494,0.20475462700568722,130069.31889921938,394.97962580347934,130464.29852502285,794,3,208.2888888888889,43,2,17,35.77098031934645,0.6094961240310077,44.9810606060606,1020.0757575757568,23.72269203664551,0
810,4,1,0,45,0.022222222222222223,0.0,1.0,45,1600,1400,200,0.875,18,14,4,362.4351057104653,0.4481271043771044,0.27316902206966254,0.20637548887760715,130238.42047068694,440.5951381714824,130679.01560885842,795,0,208.9777777777778,43,2,18,35.566553019760654,0.6111918604651163,44.81534090909091,1020.7386363636359,23.73810782241014,0
811,4,0,0,45,0.0,0.0,1.0,45,1500,1000,500,0.6666666666666666,20,10,10,331.54052097867464,0.44793771043771047,0.23631680198245908,0.18095775472317016,128571.7841100555,-474.64201696189,128097.1420930936,796,1,209.9777777777778,41,4,12,38.047274935602736,0.5973069105691057,46.45337301587299,1014.1865079365034,24.73625629113423,8
812,4,0,1,44,0.0,0.022222222222222223,0.9777777777777777,45,1200,900,300,0.75,15,9,6,331.9102801472375,0.44823232323232326,0.23265519040166982,0.18127407608041388,128596.93877550983,-463.4708049887022,128133.46797052113,797,2,210.9777777777778,41,4,13,38.012275039123615,0.5975609756097561,46.42857142857141,1014.2857142857113,24.73867595818808,0
813,4,0,1,43,0.0,0.022727272727272728,0.9772727272727273,44,1350,900,450,0.6666666666666666,18,9,9,336.02359622997614,0.44889667019027485,0.22721352980820053,0.18369044564992437,128633.75491605511,-155.2046153083677,128478.55030074675,798,3,199.9090909090909,40,4,13,37.87045849195218,0.5994791666666667,46.39227642276422,1014.4308943089419,25.360772357723548,0
814,4,1,0,44,0.022727272727272728,0.0,1.0,44,900,600,300,0.6666666666666666,12,6,6,337.93735327300294,0.44780655391120505,0.23759544589958037,0.18557758228939122,128814.23017259897,-93.77199831450088,128720.45817428446,799,0,200.70454545454547,40,4,14,37.63806854206292,0.6013020833333333,46.21443089430894,1015.1422764227641,25.378556910569102,0
815,4,0,0,44,0.0,0.0,1.0,44,850,600,250,0.7058823529411765,11,6,5,343.55671105268584,0.44778453136011276,0.2427221782520499,0.18915494289528842,128917.41569378322,58.08866663359743,128975.50436041682,800,1,201.70454545454547,40,4,14,37.3903399045999,0.60234375,46.11280487804877,1015.5487804878029,25.388719512195074,0
816,4,1,0,45,0.022222222222222223,0.0,1.0,45,1250,700,550,0.56,18,7,11,343.7947909025948,0.4488215488215488,0.26132924812113534,0.19127526748994264,129330.57089240858,-107.05226716901973,129223.51862523955,801,0,198.2,40,5,15,36.9638158990242,0.6065104166666666,45.70630081300813,1017.1747967479671,25.429369918699177,0
817,4,0,0,45,0.0,0.0,1.0,45,1250,800,450,0.64,17,8,9,343.4142844644665,0.448253367003367,0.2611904365673712,0.19181785046913719,129485.67450137144,-106.5539485425466,129379.1205528289,802,1,199.2,40,5,14,36.81581793975702,0.6080729166666667,45.55386178861788,1017.7845528455277,25.444613821138194,0
818,4,0,0,45,0.0,0.0,1.0,45,1350,1100,250,0.8148148148148148,16,11,5,339.74227194314005,0.44806397306397305,0.25895320470170846,0.19039248125672584,129614.99851278975,-192.86118547163426,129422.13732731812,803,2,200.2,40,5,14,36.777902528276776,0.609375,45.42682926829267,1018.2926829268272,25.457317073170678,0
819,4,0,0,45,0.0,0.0,1.0,45,1150,600,550,0.5217391304347826,17,6,11,351.9288350326582,0.4477483164983165,0.23518110269763737,0.18819444058922163,127752.38985224708,-8.050053332165476,127744.33979891492,804,3,201.2,42,3,18,38.36803891498132,0.5875496031746033,47.26259689922479,1010.9496124030977,24.070228866740422,8
820,4,2,0,47,0.0425531914893617,0.0,1.0,47,650,300,350,0.46153846153846156,10,3,7,341.2420193398703,0.45008479802651863,0.24025917170125233,0.18427069044352998,128144.53124999999,-651.9365760771601,127492.59467392282,805,0,193.59574468085106,40,7,20,38.237311385459535,0.59453125,46.875,1012.4999999999999,25.312499999999996,0
821,4,0,0,47,0.0,0.0,1.0,47,2050,1400,650,0.6829268292682927,27,14,13,338.6893841099043,0.4496993524514339,0.2424007696055781,0.18427732304765687,128446.04768990904,-699.3374433106783,127746.71024659836,806,1,194.59574468085106,41,6,16,37.994225875905265,0.5960365853658536,46.57738095238094,1013.6904761904741,24.724157955865223,0
822,4,1,2,46,0.020833333333333332,0.041666666666666664,0.9583333333333334,48,1350,900,450,0.6666666666666666,18,9,9,330.45945283975374,0.4503453752955083,0.24522474144789164,0.18132858923501405,128783.04268260612,-1088.4852360134748,127694.55744659265,807,0,191.52083333333334,42,6,17,37.85958631662689,0.5979662698412698,46.245155038759684,1015.0193798449604,24.167128091546676,0
823,4,1,0,47,0.02127659574468085,0.0,1.0,47,1550,1100,450,0.7096774193548387,20,11,9,338.9479784404477,0.44948735738513723,0.2588375226656465,0.18605771005379057,128798.26467624068,-668.8177122701125,128129.44696397056,808,0,196.48936170212767,41,6,18,37.62868126140212,0.5995934959349594,46.23015873015872,1015.0793650793636,24.758033294618624,0
824,4,0,1,46,0.0,0.02127659574468085,0.9787234042553191,47,1300,1000,300,0.7692307692307693,16,10,6,339.06774780396273,0.4492368177613321,0.26174495282128496,0.1869777590862148,128979.82698042491,-653.4201107205039,128326.40686970441,809,1,197.48936170212767,42,5,19,37.44077713122833,0.5999503968253967,46.05135658914729,1015.7945736434114,24.18558508674789,0
825,4,2,1,47,0.041666666666666664,0.020833333333333332,0.9791666666666666,48,1600,1100,500,0.6875,21,11,10,332.4398583742003,0.4501606826241135,0.29267364414843033,0.1864430582450824,129645.08311549776,-979.9712494742009,128665.11186602357,810,0,193.66666666666666,42,6,17,36.93327783063749,0.6066468253968254,45.39728682170542,1018.4108527131775,24.247877445551847,0
826,4,0,0,47,0.0,0.0,1.0,47,1450,1200,250,0.8275862068965517,17,12,5,337.21924940221885,0.449468085106383,0.2957177484513869,0.18876732304044302,129571.08126201855,-661.2274465176367,128909.85381550092,811,1,198.7872340425532,42,5,18,36.88671837822403,0.6059027777777778,45.46996124031008,1018.12015503876,24.24095607235143,0
827,4,0,1,46,0.0,0.02127659574468085,0.9787234042553191,47,1400,1100,300,0.7857142857142857,17,11,6,339.0108332779411,0.44950662966389143,0.2939950380242764,0.19060748134140462,129743.7851165793,-603.0902589988825,129140.69485758041,812,2,199.7872340425532,42,5,18,36.66579481326485,0.6076388888888888,45.30038759689921,1018.7984496124012,24.25710594315241,0
828,4,0,0,46,0.0,0.0,1.0,46,1050,600,450,0.5714285714285714,15,6,9,341.4903514445866,0.4478663446054751,0.28978595187514333,0.19256157358626108,129857.80915375378,-330.96222285213264,129526.84693090165,813,3,203.58695652173913,41,5,19,36.486924923755765,0.6102642276422765,45.18849206349205,1019.2460317460293,24.859659310878765,0
829,4,0,1,45,0.0,0.021739130434782608,0.9782608695652174,46,1650,1200,450,0.7272727272727273,21,12,9,344.1562846244421,0.4474033816425121,0.2963344429546102,0.19469358556161986,129984.23450688117,-253.02175847193735,129731.21274840923,814,4,204.58695652173913,41,5,19,36.29071813081687,0.6115345528455285,45.06448412698411,1019.7420634920611,24.87175764614783,0
830,4,0,0,45,0.0,0.0,1.0,45,1450,900,550,0.6206896551724138,20,9,11,348.6140999519245,0.4457070707070707,0.3050549353180938,0.19691985645933002,129925.63950029721,58.78197501484681,129984.42147531206,815,5,209.62222222222223,40,5,19,36.236543062200944,0.6125,45.121951219512184,1019.5121951219494,25.487804878048735,0
831,4,0,0,45,0.0,0.0,1.0,45,1300,500,800,0.38461538461538464,21,5,16,351.41576573674354,0.44539141414141414,0.31412189236457033,0.19929443256866844,130081.09941998808,142.50983211051312,130223.6092520986,816,6,210.62222222222223,40,5,21,36.0073387793053,0.6140625,44.96951219512195,1020.121951219512,25.5030487804878,0
832,4,0,0,45,0.0,0.0,1.0,45,1550,1000,550,0.6451612903225806,21,10,11,352.8555479607535,0.44507575757575757,0.3219079096594415,0.20065367727320418,130186.64301658137,187.41585175734443,130374.0588683387,817,7,211.62222222222223,41,4,21,35.863529211626336,0.6135670731707317,44.866071428571416,1020.5357142857122,24.891114982578344,0
833,4,1,0,46,0.021739130434782608,0.0,1.0,46,1500,900,600,0.6,21,9,12,346.5080925754817,0.4461352657004831,0.32435280817061685,0.1990447752034856,130578.91506371235,-150.53697649317996,130428.37808721917,818,0,208.0,36,10,19,35.62807587777287,0.6261574074074074,44.48198198198198,1022.072072072072,28.39089089089089,0
834,4,0,0,46,0.0,0.0,1.0,46,750,300,450,0.4,12,3,9,347.3822451145665,0.4460144927536232,0.32500454993917427,0.19984385431875978,130636.47050766961,-123.84191624059386,130512.62859142902,819,1,209.0,36,10,19,35.54747741793346,0.6267361111111112,44.42567567567566,1022.2972972972956,28.3971471471471,0
835,4,0,0,46,0.0,0.0,1.0,46,450,400,50,0.8888888888888888,5,4,1,346.0106548909639,0.4458031400966183,0.32353160614030174,0.19914835470390999,130654.64854570609,-158.41989843032246,130496.22864727577,820,2,210.0,37,9,19,35.56413556413554,0.625,44.40789473684209,1022.3684210526293,27.63157894736836,0
836,4,0,0,46,0.0,0.0,1.0,46,1050,800,250,0.7619047619047619,13,8,5,347.1043822161449,0.4457024959742351,0.32612782808512164,0.2004328923605169,130781.15297866901,-121.05773796478968,130660.09524070422,821,3,211.0,38,8,19,35.40818014065872,0.6244517543859649,44.284188034188034,1022.8632478632479,26.917453891138102,0
837,4,0,0,46,0.0,0.0,1.0,46,900,600,300,0.6666666666666666,12,6,6,345.6696101156521,0.44507850241545893,0.32706734444439634,0.1998768503753171,130833.7993774374,-154.94631585035052,130678.85306158705,822,4,212.0,40,6,19,35.39162610509585,0.6216145833333333,44.232723577235774,1023.0691056910572,25.57672764227643,0
838,4,1,1,46,0.02127659574468085,0.02127659574468085,0.9787234042553191,47,1550,1200,350,0.7741935483870968,19,12,7,345.08159102213733,0.4435707678075856,0.339447713897691,0.20172680072189628,131253.64428407254,-341.3567205997117,130912.28756347283,823,0,208.46808510638297,42,5,20,34.982466509062256,0.6227678571428572,43.822674418604656,1024.709302325582,24.397840531561478,0
839,4,0,1,45,0.0,0.021739130434782608,0.9782608695652174,46,450,300,150,0.6666666666666666,6,3,3,352.54424601080734,0.44189814814814815,0.3439095059211963,0.20539880337559682,131124.83071932485,45.460915847832666,131170.29163517267,824,1,213.67391304347825,41,5,20,34.921461319901844,0.6229674796747968,43.9484126984127,1024.2063492063498,24.98064266356951,0
840,4,0,0,45,0.0,0.0,1.0,45,1200,800,400,0.6666666666666666,16,8,8,325.00878158227954,0.4428661616161616,0.24641141580733605,0.18011708950100713,129176.17517203651,-603.3217395754518,128572.85343246107,825,2,215.04444444444445,41,4,17,37.59830112878566,0.6034044715447154,45.858134920634924,1016.5674603174613,24.794328300425885,8
841,4,1,0,46,0.021739130434782608,0.0,1.0,46,1350,1100,250,0.8148148148148148,16,11,5,317.1872199174698,0.44459541062801927,0.22044270290549783,0.16930720080548695,127678.93024006991,-1100.3750150231162,126578.55522504679,826,0,211.34782608695653,42,4,18,39.32106903163951,0.5868055555555556,47.335271317829466,1010.6589147286838,24.06330749354009,8
842,4,0,0,46,0.0,0.0,1.0,46,1700,1000,700,0.5882352941176471,24,10,14,314.14376623948544,0.44462560386473426,0.21293519906713265,0.16870683742490902,127923.87777176868,-1162.7022489633891,126761.17552280528,827,1,212.34782608695653,42,4,19,39.1481082375479,0.5892857142857143,47.09302325581396,1011.6279069767454,24.08637873754156,0
843,4,1,1,46,0.02127659574468085,0.02127659574468085,0.9787234042553191,47,1850,1300,550,0.7027027027027027,24,13,11,311.8983302095633,0.44703977798334876,0.22095904083414353,0.16895458088964752,128270.12004165113,-1398.1724755251353,126871.947566126,828,0,208.80851063829786,41,6,20,38.85219779322951,0.5942581300813008,46.75099206349207,1012.9960317460334,24.70722028648862,0
844,4,0,0,46,0.0,0.0,1.0,46,1700,1300,400,0.7647058823529411,21,13,8,316.5460272492498,0.4483695652173913,0.21726483799223706,0.17170641412813,128324.66310562535,-1075.8675391631568,127248.7955664622,829,1,210.02173913043478,40,6,21,38.67895352724841,0.5963541666666667,46.697154471544735,1013.2113821138244,25.330284552845608,0
845,4,2,1,47,0.041666666666666664,0.020833333333333332,0.9791666666666666,48,1450,1100,350,0.7586206896551724,18,11,7,305.87195722625523,0.4494219119385343,0.22448930889652496,0.16794101802422717,128807.6325040564,-1720.2714680607976,127087.3610359956,830,0,202.22916666666666,42,6,17,38.45854015527554,0.5982142857142857,46.220930232558146,1015.1162790697687,24.169435215946873,0
846,4,0,0,47,0.0,0.0,1.0,47,1400,1000,400,0.7142857142857143,18,10,8,312.6932171405098,0.4463459759481961,0.21930844305063646,0.17153696003027125,128773.09032698744,-1346.7056209057573,127426.38470608168,831,1,207.48936170212767,41,6,17,38.32052503828234,0.599339430894309,46.25496031746032,1014.98015873016,24.75561362756488,0
847,4,0,0,47,0.0,0.0,1.0,47,1250,1100,150,0.88,14,11,3,313.13521410537817,0.44596053037311134,0.2161083534957977,0.1723253791173468,128898.98667800461,-1327.4376417233443,127571.54903628127,832,2,208.48936170212767,41,6,17,38.18141852286051,0.600609756097561,46.13095238095239,1015.476190476191,24.76771196283393,0
848,4,1,1,47,0.020833333333333332,0.020833333333333332,0.9791666666666666,48,1500,1100,400,0.7333333333333333,19,11,8,306.8731525782719,0.44669769503546103,0.2306790093342439,0.170283862521641,129226.60506621633,-1668.4105528785574,127558.19451333777,833,0,205.125,41,7,19,38.008078023872244,0.6039126016260163,45.80853174603175,1016.7658730158732,24.799167634533493,0
849,4,2,0,49,0.04081632653061224,0.0,1.0,49,1600,1100,500,0.6875,21,11,10,313.50730201138543,0.4485189909297052,0.2737587926165723,0.17653857022210998,129803.80980436473,-1661.1115594869113,128142.69824487783,834,0,201.59183673469389,43,6,18,37.2546115602639,0.6068313953488372,45.24147727272727,1019.0340909090914,23.69846723044399,0
850,4,0,1,48,0.0,0.02040816326530612,0.9795918367346939,49,1050,500,550,0.47619047619047616,16,5,11,312.07257668396835,0.4482001133786848,0.2639678200836342,0.17627352364006296,129924.46212838605,-1690.827665863188,128233.63446252285,835,1,202.59183673469389,43,6,18,37.16909715771875,0.6080426356589148,45.123106060606055,1019.5075757575751,23.709478505990116,0
851,4,0,0,48,0.0,0.0,1.0,48,1350,900,450,0.6666666666666666,18,9,9,315.7941563664671,0.4468085106382979,0.25442200557103023,0.1788171957974159,130021.02434142558,-1388.0240616391281,128633.00027978646,836,2,200.29166666666666,43,5,20,36.97655524605384,0.6090116279069768,45.028409090909086,1019.8863636363634,23.718287526427055,0
852,4,0,1,47,0.0,0.020833333333333332,0.9791666666666666,48,1950,1700,250,0.8717948717948718,22,17,5,322.03248646397367,0.4462082594562648,0.2687925170068033,0.183483626008543,130262.58680555545,-1209.5704918503286,129053.01631370511,837,3,201.29166666666666,40,8,20,36.573129251700685,0.6158854166666667,44.791666666666664,1020.8333333333325,25.52083333333331,0
853,4,0,0,47,0.0,0.0,1.0,47,1400,900,500,0.6428571428571429,19,9,10,325.51515132524486,0.4457678075855689,0.271222308642902,0.18523771388508353,130214.25637769721,-922.6573261019486,129291.59905159526,838,4,206.4255319148936,43,4,20,36.53313849198986,0.6109496124031008,44.83901515151514,1020.6439393939376,23.735905567300872,0
854,4,0,0,47,0.0,0.0,1.0,47,1350,700,650,0.5185185185185185,20,7,13,331.79827555112644,0.445131822386679,0.28147615297320483,0.1894176178728641,130338.5527388037,-750.7606576549485,129587.79208114876,839,5,207.4255319148936,41,6,20,36.247024676964934,0.6150914634146342,44.7172619047619,1021.1309523809512,24.90563298490125,0
855,4,0,2,45,0.0,0.0425531914893617,0.9574468085106383,47,1650,1100,550,0.6666666666666666,22,11,11,330.6019250028079,0.44520891150169595,0.2788376701332145,0.18922779442767695,130439.87509645047,-775.2652391975412,129664.60985725293,840,6,208.4255319148936,41,6,21,36.17507931112622,0.6161077235772358,44.61805555555555,1021.5277777777766,24.9153116531165,0
856,4,0,0,45,0.0,0.0,1.0,45,900,800,100,0.8888888888888888,10,8,2,337.5153414929352,0.4458754208754209,0.2657418740650077,0.1928321916082014,130368.94531249999,-199.69618055555543,130169.24913194442,841,7,209.26666666666668,39,6,21,36.070311437508494,0.6185897435897436,44.6875,1021.2499999999999,26.185897435897434,0
857,4,0,0,45,0.0,0.0,1.0,45,1300,800,500,0.6153846153846154,18,8,10,339.1808727654462,0.4453282828282828,0.2681211132633292,0.19444916311842592,130501.95448133702,-147.24663628469966,130354.70784505231,842,8,210.26666666666668,39,6,17,35.89316359125973,0.6199252136752137,44.55729166666668,1021.7708333333351,26.199252136752182,0
858,4,0,2,43,0.0,0.044444444444444446,0.9555555555555556,45,700,500,200,0.7142857142857143,9,5,4,340.4855350538933,0.44530723905723907,0.2699739494846527,0.1953311753730232,130528.56445312513,-111.38237847220876,130417.18207465293,843,9,211.26666666666668,39,6,17,35.83290859667006,0.6201923076923077,44.53125000000001,1021.875000000001,26.2019230769231,0
859,4,0,0,43,0.0,0.0,1.0,43,1050,700,350,0.6666666666666666,14,7,7,350.7998810567573,0.44449058693244736,0.27378236527339284,0.20085918938112063,130453.51765103376,552.6156950836521,131006.13334611742,844,10,216.4418604651163,38,5,21,35.64543679843825,0.6211622807017544,44.60470085470086,1021.5811965811973,26.883715699505192,0
860,4,0,1,42,0.0,0.023255813953488372,0.9767441860465116,43,1250,1000,250,0.8,15,10,5,346.8249391345201,0.4436830933923957,0.2717667708794227,0.19914329938540345,130562.68376981522,456.47897034115545,131019.16274015637,845,11,217.4418604651163,38,5,17,35.636411945083275,0.6222587719298245,44.49786324786325,1022.0085470085473,26.894961763382824,0
861,4,1,0,43,0.023255813953488372,0.0,1.0,43,1450,1000,450,0.6896551724137931,19,10,9,343.87310333586265,0.4428525286083425,0.30386839689165246,0.19973905789508636,131008.00781250013,410.02604166668243,131418.0338541668,846,0,217.6046511627907,39,4,19,35.261497761497765,0.625,44.06250000000001,1023.750000000001,26.250000000000025,0
862,4,0,1,42,0.0,0.023255813953488372,0.9767441860465116,43,1550,1200,350,0.7741935483870968,19,12,7,344.6063718123535,0.44236803248431156,0.30527216917102984,0.20099994427062204,131168.01757812512,440.26692708334775,131608.28450520846,847,1,218.6046511627907,39,4,19,35.08109619686802,0.6266025641025641,43.90625000000001,1024.375000000001,26.266025641025664,0
863,4,0,0,42,0.0,0.0,1.0,42,1650,1100,550,0.6666666666666666,22,11,11,349.9914962496551,0.44231513743708867,0.3082678025338583,0.20470234341626156,131273.37643363274,788.9130871502615,132062.289520783,848,2,222.14285714285714,38,4,19,34.83675632471507,0.6293859649122807,43.8034188034188,1024.786324786324,26.968061178587476,0
864,4,0,1,41,0.0,0.023809523809523808,0.9761904761904762,42,1250,900,350,0.72,16,9,7,349.17921587691956,0.4420731707317073,0.3071606824548001,0.20481967807084053,131384.32618690358,775.3466135663137,132159.67280046988,849,3,223.14285714285714,37,5,19,34.74554367201426,0.6323198198198199,43.695175438596486,1025.2192982456133,27.708629682313873,0
865,4,0,0,41,0.0,0.0,1.0,41,1550,900,650,0.5806451612903226,22,9,13,355.84614303622897,0.44123475609756097,0.3001674234205274,0.20889614006091967,131414.71021274658,1152.683553485919,132567.3937662325,850,4,226.97560975609755,36,5,20,34.543977667948,0.6345486111111112,43.66554054054054,1025.3378378378382,28.481606606606615,0
866,4,0,0,41,0.0,0.0,1.0,41,700,400,300,0.5714285714285714,10,4,6,356.6774300718353,0.4410060975609756,0.3031236440192211,0.20954223730542784,131443.5782911289,1176.5915408651845,132620.1698319941,851,5,227.97560975609755,36,5,20,34.493511604070584,0.634837962962963,43.637387387387385,1025.45045045045,28.484734734734722,0
867,4,0,0,41,0.0,0.0,1.0,41,1050,700,350,0.6666666666666666,14,7,7,359.2625018319496,0.4407012195121951,0.3000323847197648,0.21218141148376912,131645.7436110097,1259.0758410437513,132904.81945205346,852,6,228.97560975609755,36,5,19,34.22308789641172,0.6368634259259259,43.44031531531532,1026.2387387387391,28.50663163163164,0
868,4,0,0,41,0.0,0.0,1.0,41,950,500,450,0.5263157894736842,14,5,9,358.8699484287881,0.4404979674796748,0.2986118166212104,0.21253000171655498,131749.9269606991,1256.217898776504,133006.14485947558,853,7,229.97560975609755,37,4,19,34.12801719534338,0.6359797297297297,43.338815789473664,1026.6447368421022,27.747155049786546,0
869,4,0,0,41,0.0,0.0,1.0,41,1650,1300,350,0.7878787878787878,20,13,7,360.29771774415894,0.4402439024390244,0.3009944095384163,0.2140081624673134,131862.52170138873,1301.9531249999811,133164.4748263887,854,8,230.97560975609755,37,4,19,33.97777214334009,0.6371058558558558,43.22916666666666,1027.083333333332,27.75900900900897,0
870,4,0,0,41,0.0,0.0,1.0,41,1050,900,150,0.8571428571428571,12,9,3,362.3662251162137,0.4385670731707317,0.29957276743665684,0.216358025110789,132059.67821829798,1370.793417205303,133430.4716355033,855,9,231.97560975609755,37,4,19,33.72581964298415,0.6390765765765766,43.03728070175439,1027.8508771929828,27.779753437648186,0
871,4,0,0,41,0.0,0.0,1.0,41,900,600,300,0.6666666666666666,12,6,6,363.41707206878283,0.43874491869918697,0.261735068061111,0.20922407085050607,130665.25298524885,1385.986071232584,132051.23905648143,856,10,232.97560975609755,36,5,17,35.10849212468334,0.627025462962963,44.39752252252253,1022.4099099099107,28.400275275275295,8
872,4,0,0,41,0.0,0.0,1.0,41,1000,800,200,0.8,12,8,4,363.895831568181,0.4385162601626016,0.26595330373521797,0.20981193945845425,130722.82745160715,1313.8984000892947,132036.72585169645,857,11,233.97560975609755,36,5,17,35.037899643945245,0.6276041666666667,44.341216216216225,1022.6351351351362,28.406531531531563,0
873,4,0,0,41,0.0,0.0,1.0,41,1300,500,800,0.38461538461538464,21,5,16,365.77530073708084,0.4378048780487805,0.2699781003091719,0.21200037838638983,130924.43795146508,1377.7851331060906,132302.22308457116,858,12,234.97560975609755,36,5,19,34.785568882042256,0.6296296296296297,44.14414414414415,1023.4234234234242,28.42842842842845,0
874,4,0,0,41,0.0,0.0,1.0,41,1000,900,100,0.9,11,9,2,367.97357568938077,0.43737296747967475,0.2699852204724622,0.2140744544941484,131068.54056336741,1445.95190629819,132514.4924696656,859,13,235.97560975609755,36,5,19,34.58337915612743,0.6310763888888888,44.00337837837838,1023.9864864864865,28.44406906906907,0
875,4,0,0,41,0.0,0.0,1.0,41,1200,800,400,0.6666666666666666,16,8,8,383.96760068197415,0.4361534552845528,0.22089782883045395,0.2063662416832173,127955.29827781403,1632.8463415304793,129588.1446193445,860,14,236.97560975609755,38,3,16,37.349964801126355,0.5959429824561404,47.0619658119658,1011.7521367521344,26.625056230319327,8
876,4,2,1,42,0.046511627906976744,0.023255813953488372,0.9767441860465116,43,1250,800,450,0.64,17,8,9,366.74798273597327,0.44033776301218164,0.22166294998407166,0.1997955428337763,128496.33487654306,825.4339707063932,129321.76884724945,861,0,226.90697674418604,38,5,15,37.23173515981736,0.6014254385964912,46.52777777777777,1013.8888888888877,26.68128654970757,0
877,4,2,0,44,0.045454545454545456,0.0,1.0,44,1450,800,650,0.5517241379310345,21,8,13,362.2611999511722,0.44154113812544044,0.23074396306818246,0.19986824824892238,128999.74804736694,546.3207042075946,129546.06875157454,862,0,222.70454545454547,41,3,20,36.83146158854167,0.6016260162601625,46.031746031746025,1015.8730158730147,24.777390631049137,0
878,4,1,0,45,0.022222222222222223,0.0,1.0,45,1450,1000,450,0.6896551724137931,19,10,9,360.74728703502296,0.44322390572390574,0.23574821325520534,0.20110255221573742,129408.11107806179,337.0399391386519,129745.15101720043,863,0,218.73333333333332,40,5,21,36.453755493407904,0.6072916666666667,45.630081300812996,1017.4796747967463,25.436991869918657,0
879,4,0,0,45,0.0,0.0,1.0,45,1350,1000,350,0.7407407407407407,17,10,7,363.87606506905246,0.44347643097643097,0.24404952076677322,0.2033807292260953,129511.53413973158,425.2294847643517,129936.76362449593,864,1,219.73333333333332,40,5,16,36.26884484824281,0.6083333333333334,45.52845528455284,1017.8861788617882,25.447154471544703,0
880,4,0,0,45,0.0,0.0,1.0,45,1500,1000,500,0.6666666666666666,20,10,10,372.2891148134496,0.4426767676767677,0.15500050155481992,0.20181349568109225,128298.92223750764,614.6835134510118,128913.60575095865,865,2,220.73333333333332,40,5,15,37.29331761794899,0.59609375,46.72256097560977,1013.1097560975627,25.327743902439067,8
881,4,0,1,44,0.0,0.022222222222222223,0.9777777777777777,45,1500,1000,500,0.6666666666666666,20,10,10,378.629480970597,0.44257154882154887,0.16659426343636863,0.20604632147745247,128453.40617563951,727.2493018375324,129180.65547747705,866,3,221.73333333333332,40,5,14,36.97451963241436,0.59765625,46.57012195121951,1013.719512195122,25.34298780487805,0
882,4,1,0,45,0.022222222222222223,0.0,1.0,45,1100,500,600,0.45454545454545453,17,5,12,387.8138690258725,0.44223484848484845,0.18892783619874254,0.2124147823490584,128711.08596280316,983.1888467512653,129694.27480955442,867,0,222.6,40,5,15,36.47784176264397,0.6002604166666667,46.3160569105691,1014.735772357723,25.368394308943074,0
883,4,1,1,45,0.021739130434782608,0.021739130434782608,0.9782608695652174,46,1500,1300,200,0.8666666666666667,17,13,4,382.74470063105485,0.4447564412238325,0.1981777587238791,0.2115733388323745,129075.34490937597,680.5808492378646,129755.92575861384,868,0,218.7391304347826,41,5,17,36.23399313352209,0.6023882113821138,45.95734126984128,1016.1706349206363,24.78464963221064,0
884,4,0,0,45,0.0,0.0,1.0,45,1600,1300,300,0.8125,19,13,6,382.4527480819477,0.44433922558922556,0.20557670408329232,0.21168170740678346,129125.75511975653,876.8999787415269,130002.65509849806,869,1,223.11111111111111,41,4,17,36.189909712054664,0.6028963414634146,45.90773809523811,1016.36904761905,24.78948896631829,0
885,4,1,1,45,0.021739130434782608,0.021739130434782608,0.9782608695652174,46,1000,900,100,0.9,11,9,2,374.9043338086678,0.44519927536231885,0.20990756590208837,0.20919530049956414,129445.89548405647,506.0540192408279,129951.94950329729,870,0,219.2391304347826,38,8,14,36.05511811023623,0.6110197368421053,45.592948717948715,1017.6282051282046,26.779689608636964,0
886,4,0,1,44,0.0,0.022222222222222223,0.9777777777777777,45,1350,1100,250,0.8148148148148148,16,11,5,383.53941557959865,0.44349747474747475,0.21155667529801514,0.21416157519409446,129473.0771513622,931.6056687851321,130404.68282014734,871,3,225.11111111111111,38,7,14,35.80770172860242,0.6112938596491229,45.566239316239304,1017.7350427350411,26.782501124606345,0
887,4,0,0,44,0.0,0.0,1.0,44,700,400,300,0.5714285714285714,10,4,6,387.31213566758674,0.44154113812544044,0.21944232238349892,0.2163075356959408,129480.23069598323,1229.8529355186033,130710.08363150184,872,4,230.20454545454547,37,7,14,35.704409969115844,0.6131756756756757,45.55921052631578,1017.7631578947356,27.507112375533396,0
888,4,0,0,44,0.0,0.0,1.0,44,950,500,450,0.5263157894736842,14,5,9,379.54254275086873,0.4413319238900634,0.23065406096494145,0.20221599024196987,127604.23657909637,899.3402543168589,128503.57683341323,873,5,231.20454545454547,38,6,16,37.82229212928695,0.5923793859649122,47.409188034188034,1010.363247863248,26.588506522717054,8
889,4,1,1,44,0.022222222222222223,0.022222222222222223,0.9777777777777777,45,1500,1000,500,0.6666666666666666,20,10,10,374.6693264470764,0.44452861952861955,0.2333161777320294,0.2016572025724849,128012.72922092032,592.4886067708537,128605.21782769117,874,0,227.04444444444445,39,6,18,37.52626951449649,0.5948183760683761,47.00520833333334,1011.9791666666681,25.948183760683797,0
890,4,1,1,44,0.022222222222222223,0.022222222222222223,0.9777777777777777,45,1150,800,350,0.6956521739130435,15,8,7,331.0990915932838,0.4430345117845118,0.17590752096990192,0.1765239689001848,127631.2242037402,-494.91166814196504,127136.31253559823,875,0,227.88888888888889,38,7,13,39.0183354479453,0.5926535087719298,47.38247863247863,1010.4700854700853,26.591318038686456,8
891,4,0,0,44,0.0,0.0,1.0,44,1950,1400,550,0.717948717948718,25,14,11,336.88939249974567,0.4396251761804087,0.1808814204185163,0.1800930752447791,127739.20323800117,-193.2034845496609,127545.9997534515,876,1,234.04545454545453,38,6,16,38.76162544916507,0.59375,47.275641025641015,1010.8974358974347,26.60256410256407,0
892,4,1,0,45,0.022222222222222223,0.0,1.0,45,1000,600,400,0.6,14,6,8,327.5234635871309,0.44137205387205386,0.18102490224325996,0.17663002325969718,128091.80230034741,-609.385850694424,127482.41644965298,877,0,229.82222222222222,39,6,17,38.63835151265693,0.5956196581196581,46.92708333333334,1012.2916666666682,25.95619658119662,0
893,4,3,2,46,0.0625,0.041666666666666664,0.9583333333333334,48,950,600,350,0.631578947368421,13,6,7,307.55768103833265,0.44774120862884165,0.1861646636621601,0.16845657954842325,128711.08596280341,-1682.7616740820404,127028.32428872137,878,0,216.39583333333334,40,8,16,38.51381238524455,0.6002604166666667,46.31605691056912,1014.735772357725,25.368394308943124,0
894,4,1,0,47,0.02127659574468085,0.0,1.0,47,1200,1000,200,0.8333333333333334,14,10,4,309.8433190160724,0.4463652482269504,0.2000139747755303,0.1699951182709804,128778.12500000015,-1419.7916666666513,127358.33333333349,879,0,221.29787234042553,39,8,18,38.38772577996716,0.6025641025641026,46.25000000000001,1015.0000000000011,26.025641025641054,0
895,4,1,0,48,0.020833333333333332,0.0,1.0,48,1300,1000,300,0.7692307692307693,16,10,6,302.71500078122136,0.4464391252955083,0.20359635848872393,0.1673345792229925,129075.34490937585,-1785.3913729843734,127289.95353639148,880,0,217.66666666666666,41,7,21,38.2670889062449,0.6023882113821138,45.95734126984127,1016.1706349206354,24.78464963221062,0
896,4,2,1,49,0.04,0.02,0.98,50,1050,800,250,0.7619047619047619,13,8,5,296.24800078886665,0.44875,0.21425090424519277,0.16572851417933093,129546.41867225534,-2324.3649799240975,127222.05369233125,881,0,209.92,42,8,12,37.9545021892252,0.6056547619047619,45.49418604651163,1018.023255813954,24.238648947951287,0
897,4,0,0,49,0.0,0.0,1.0,49,850,600,250,0.7058823529411765,11,6,5,302.7868774657381,0.44641085600907027,0.21582189818204944,0.16877077257003303,129403.1872008061,-1963.6826026707163,127439.50459813539,882,1,215.20408163265307,41,8,22,37.93307982319293,0.6056910569105691,45.634920634920626,1017.4603174603163,24.816105303910156,0
898,4,2,1,50,0.0392156862745098,0.0196078431372549,0.9803921568627451,51,1400,1100,300,0.7857142857142857,17,11,6,293.5225436465378,0.4479901960784314,0.23424713147155063,0.1659276309361227,129955.57270233182,-2571.0219478738077,127384.550754458,883,0,207.72549019607843,44,7,15,37.61048553093596,0.6070075757575757,45.09259259259259,1019.6296296296284,23.173400673400646,0
899,4,0,1,49,0.0,0.02,0.98,50,1900,1500,400,0.7894736842105263,23,15,8,300.4338916738823,0.44749149659863946,0.22842261628446758,0.17022479995893658,130045.17049938293,-2186.004666695372,127859.16583268756,884,1,212.82,43,7,15,37.34381286169651,0.6092538759689923,45.004734848484844,1019.9810606060598,23.720489781536276,0
900,4,1,4,46,0.02,0.08,0.92,50,1450,1100,350,0.7586206896551724,18,11,7,300.70803831736794,0.4454676870748299,0.23208163265306148,0.17133364973896506,130262.58680555523,-2165.435426710321,128097.15137884491,885,0,213.7,41,9,17,37.117346938775505,0.6143292682926829,44.79166666666665,1020.8333333333308,24.898373983739774,0
901,4,0,1,45,0.0,0.021739130434782608,0.9782608695652174,46,1300,1000,300,0.7692307692307693,16,10,6,317.60054694879875,0.4378623188405797,0.23346369296404834,0.17892686993272752,129822.0511930727,-953.6891070130462,128868.36208605964,886,1,232.32608695652175,40,6,17,37.13186411381464,0.6114583333333333,45.223577235772346,1019.1056910569089,25.47764227642272,0
902,4,1,0,46,0.021739130434782608,0.0,1.0,46,1000,300,700,0.3,17,3,14,319.1713904175449,0.4371678743961353,0.24026125950477728,0.18064776665764573,130003.35784131452,-901.3295037676121,129102.0283375469,887,0,232.8913043478261,40,6,19,36.90832087693076,0.61328125,45.04573170731707,1019.8170731707303,25.495426829268258,0
903,4,1,0,47,0.02127659574468085,0.0,1.0,47,1550,1100,450,0.7096774193548387,20,11,9,315.5118186740485,0.4378083564600678,0.2435685124614484,0.18013758639846794,130342.35161675325,-1174.573125870143,129167.77849088311,888,0,228.91489361702128,39,8,22,36.65895219150601,0.6183226495726496,44.71354166666666,1021.1458333333316,26.18322649572645,0
904,4,0,0,47,0.0,0.0,1.0,47,1150,900,250,0.782608695652174,14,9,5,352.3097705193846,0.43709528214616095,0.2646123746637319,0.19329427950117622,128778.12500000028,-153.90082465274895,128624.22417534752,889,1,229.91489361702128,39,8,17,37.310139573070614,0.6025641025641026,46.250000000000014,1015.0000000000022,26.025641025641082,8
905,4,1,1,47,0.020833333333333332,0.020833333333333332,0.9791666666666666,48,1700,1200,500,0.7058823529411765,22,12,10,355.36294893384763,0.43767545803782504,0.2622300215982718,0.19540741728785208,128867.17547706985,-246.63165589412404,128620.54382117573,890,0,226.10416666666666,37,11,18,37.1418286537077,0.6069819819819819,46.16228070175438,1015.3508771929822,27.44191559981033,8
906,4,0,0,47,0.0,0.0,1.0,47,1150,700,450,0.6086956521739131,16,7,9,355.36294893384763,0.4367869256860932,0.28600707688065796,0.19540741728785208,128867.17547706985,-241.07610033856997,128626.09937673128,891,1,231.85106382978722,37,10,18,37.1418286537077,0.6069819819819819,46.16228070175438,1015.3508771929822,27.44191559981033,0
907,4,0,0,47,0.0,0.0,1.0,47,1150,500,650,0.43478260869565216,18,5,13,361.06842193041433,0.4357076780758557,0.29914719163697656,0.1998163989426429,129119.93805473372,-75.77354536488747,129044.16450936883,892,2,232.85106382978722,38,9,18,36.739198990854646,0.6077302631578947,45.91346153846154,1016.3461538461538,26.745951417004047,0
908,4,0,1,46,0.0,0.02127659574468085,0.9787234042553191,47,1200,900,300,0.75,15,9,6,360.609889898087,0.43547641073080484,0.2965451264849417,0.20012368179120008,129230.80800165057,-79.54146466569475,129151.26653698487,893,3,233.85106382978722,35,12,19,36.637853348510724,0.6145833333333333,45.80439814814816,1016.782407407409,29.05092592592597,0
909,4,1,1,46,0.02127659574468085,0.02127659574468085,0.9787234042553191,47,1250,700,550,0.56,18,7,11,356.8847389020847,0.4373072772124576,0.293149584581363,0.1993929093967558,129495.73072059343,-156.98999056925857,129338.74073002418,894,0,233.3404255319149,35,12,15,36.46283450837692,0.6172619047619048,45.54398148148149,1017.8240740740754,29.080687830687868,0
910,4,0,0,46,0.0,0.0,1.0,46,1500,1000,500,0.6666666666666666,20,10,10,365.5845029843924,0.4353059581320451,0.2995188860126028,0.20413990307077526,129473.85381235824,266.7268990929717,129740.58071145121,895,5,239.41304347826087,34,12,16,36.263744297578675,0.6191789215686274,45.56547619047619,1017.738095238095,29.933473389355733,0
911,4,1,0,47,0.02127659574468085,0.0,1.0,47,1700,1100,600,0.6470588235294118,23,11,12,359.93064189459113,0.4364207523897626,0.3063858777713089,0.20306913281010025,129878.87577428427,-50.52257480279158,129828.35319948148,896,0,235.29787234042553,35,12,20,35.99563320843269,0.6211309523809524,45.16782407407408,1019.3287037037048,29.123677248677282,0
912,4,1,0,48,0.020833333333333332,0.0,1.0,48,1100,700,400,0.6363636363636364,15,7,8,355.497949165712,0.43701979905437355,0.31426661754147256,0.20270506849326111,130292.12648158883,-335.7172710905198,129956.40921049831,897,0,231.375,35,13,21,35.68909893058232,0.625297619047619,44.76273148148149,1020.9490740740755,29.169973544973587,0
913,4,0,1,47,0.0,0.020833333333333332,0.9791666666666666,48,1150,700,450,0.6086956521739131,16,7,9,358.64876533797684,0.4366873522458629,0.31639990557129294,0.20512477991624428,130410.31867551885,-245.70004393860086,130164.61863158025,898,1,232.375,35,13,21,35.4887865911237,0.6264880952380952,44.64699074074075,1021.4120370370384,29.1832010582011,0
914,4,0,0,47,0.0,0.0,1.0,47,1250,700,550,0.56,18,7,11,366.96306801201905,0.4352065988282454,0.3223478649010565,0.20990287490287504,130414.54081632658,171.46400226758036,130586.00481859416,899,2,238.14893617021278,34,13,22,35.27219308469309,0.6286764705882353,44.642857142857146,1021.4285714285718,30.0420168067227,0
915,4,0,1,46,0.0,0.02127659574468085,0.9787234042553191,47,1450,1100,350,0.7586206896551724,18,11,7,365.89719779857677,0.4349367869256861,0.32247491058431077,0.20974938066011922,130498.99798525375,149.8435356652927,130648.84152091904,900,3,239.14893617021278,35,12,16,35.21371394049238,0.6273809523809524,44.56018518518518,1021.7592592592591,29.19312169312169,0
916,4,2,0,48,0.041666666666666664,0.0,1.0,48,1150,900,250,0.782608695652174,14,9,5,347.5869567935585,0.43746306146572106,0.32447676908253964,0.20254583676909718,131131.51552641182,-484.07911568945724,130647.43641072237,901,0,232.79166666666666,37,11,18,35.04163990293688,0.6297860360360361,43.941885964912274,1024.2324561403498,27.681958274063508,0
917,4,0,4,44,0.0,0.08333333333333333,0.9166666666666666,48,1000,800,200,0.8,12,8,4,348.9030119339136,0.43762005023640665,0.32765556982801725,0.20346141931876519,131159.5935768697,-447.604551400443,130711.98902546926,902,1,233.79166666666666,37,11,18,34.979572539784485,0.6300675675675675,43.91447368421052,1024.342105263157,27.68492176386911,0
918,4,0,1,43,0.0,0.022727272727272728,0.9772727272727273,44,1200,900,300,0.75,15,9,6,372.2742533591683,0.43611257928118397,0.32567189652690676,0.21570438716918505,130913.23329260964,947.1252357681669,131860.3585283778,890,2,225.25,35,9,18,34.63064540450878,0.631547619047619,44.15509259259259,1023.3796296296289,29.23941798941797,0
919,4,1,1,43,0.022727272727272728,0.022727272727272728,0.9772727272727273,44,1050,600,450,0.5714285714285714,15,6,9,329.02288447110806,0.43589235377026075,0.21368083793203585,0.1839002907847443,129511.5341397316,-252.779238658147,129258.75490107345,891,0,225.77272727272728,40,4,17,37.15575911874333,0.6083333333333334,45.52845528455284,1017.8861788617883,25.447154471544707,8
920,4,0,1,42,0.0,0.023255813953488372,0.9767441860465116,43,1750,1300,450,0.7428571428571429,22,13,9,333.12271447071487,0.4342469545957918,0.22826710052781696,0.18685833501894306,129651.86767578122,37.99641927083178,129689.86409505205,892,1,231.48837209302326,39,4,18,36.90900838703078,0.6113782051282051,45.390625,1018.4374999999998,26.113782051282044,0
921,4,0,1,41,0.0,0.023809523809523808,0.9761904761904762,42,1150,800,350,0.6956521739130435,15,8,7,326.3378716251086,0.43278164924506385,0.16964735697726363,0.17157382217237444,127066.39695493769,-106.68449253088181,126959.71246240681,893,2,237.9047619047619,40,2,15,39.71646843396165,0.58359375,47.94207317073172,1008.2317073170744,25.205792682926862,8
922,4,2,2,41,0.046511627906976744,0.046511627906976744,0.9534883720930233,43,1100,700,400,0.6363636363636364,15,7,8,328.69471821877937,0.4359080841638981,0.19213520452302846,0.17557452563931164,127707.59489226001,-204.6350345363108,127502.95985772369,894,0,225.93023255813952,40,3,13,39.00102218647362,0.5901041666666667,47.306910569105696,1010.7723577235781,25.269308943089452,0
923,4,0,0,41,0.0,0.0,1.0,41,1300,1000,300,0.7692307692307693,16,10,6,338.38466327065265,0.4343241869918699,0.21596036428260867,0.18070150730408038,127696.68104383668,442.11968315971274,128138.8007269964,895,1,237.41463414634146,39,2,13,38.76732711532517,0.5916132478632479,47.31770833333333,1010.7291666666656,25.916132478632452,0
924,4,3,4,40,0.06818181818181818,0.09090909090909091,0.9090909090909091,44,1150,600,550,0.5217391304347826,17,6,11,320.5128611001189,0.43856809372797745,0.21575985418090715,0.17441984667068647,128453.40617563936,-564.238328370817,127889.16784726855,896,0,222.1590909090909,40,4,12,38.44736842105262,0.59765625,46.570121951219505,1013.7195121951208,25.34298780487802,0
925,4,2,1,41,0.047619047619047616,0.023809523809523808,0.9761904761904762,42,1100,800,300,0.7272727272727273,14,8,6,324.2947485894976,0.43950832365466513,0.15438695163104632,0.17018773996225653,126992.00050390493,-163.43222474178555,126828.56827916314,897,0,230.5952380952381,41,1,19,39.844160104986855,0.5813008130081301,48.015873015873,1007.9365079365052,24.58381726674403,8
926,4,1,1,41,0.023809523809523808,0.023809523809523808,0.9761904761904762,42,1100,600,500,0.5454545454545454,16,6,10,324.1739770608303,0.4395204219899342,0.17794602617597732,0.17154132516342918,127328.45187717026,-144.60713719804176,127183.84473997222,898,0,231.54761904761904,39,3,18,39.5028081673375,0.5878739316239316,47.68229166666667,1009.2708333333344,25.878739316239344,0
927,4,0,0,41,0.0,0.0,1.0,41,1100,700,400,0.6363636363636364,15,7,8,330.2183986119966,0.4388465447154472,0.1746569597745491,0.1752326830590669,127442.37075617294,216.7631172839611,127659.1338734569,899,1,233.65853658536585,38,3,18,39.2337230628152,0.590734649122807,47.56944444444445,1009.7222222222231,26.571637426900608,0
928,4,3,0,44,0.06818181818181818,0.0,1.0,44,1700,1600,100,0.9411764705882353,18,16,2,311.811007851306,0.4448885658914729,0.18262370540851558,0.16871965493324084,128225.6738987508,-797.7776408064866,127427.89625794432,900,0,218.6590909090909,38,6,21,38.899657172995795,0.5986842105263157,46.794871794871796,1012.8205128205127,26.653171390013494,0
929,4,0,1,43,0.0,0.022727272727272728,0.9772727272727273,44,1000,700,300,0.7,13,7,6,310.1122335320064,0.44466834038054964,0.17366775993047967,0.16845795198396954,128381.94580078137,-837.4376085069314,127544.50819227443,901,1,219.6590909090909,39,5,14,38.78364083324769,0.5985576923076923,46.64062500000001,1013.4375000000009,25.985576923076945,0
930,4,1,2,42,0.022727272727272728,0.045454545454545456,0.9545454545454546,44,1850,1300,550,0.7027027027027027,24,13,11,316.40484525330396,0.44350114517265676,0.19517887036902204,0.17409235758650987,128891.61544054486,-643.6136724171936,128248.00176812767,902,0,220.3409090909091,40,4,16,38.105901387776896,0.6020833333333333,46.13821138211383,1015.4471544715465,25.38617886178866,0
931,4,0,0,42,0.0,0.0,1.0,42,1100,700,400,0.6363636363636364,15,7,8,329.2070301049918,0.4389638985675571,0.1896136719220125,0.18007776255051844,128658.86843450935,71.0807947987339,128729.94922930808,903,1,231.73809523809524,38,4,16,38.01776186464477,0.6030701754385965,46.36752136752136,1014.5299145299136,26.698155645524043,0
932,4,0,0,42,0.0,0.0,1.0,42,1250,600,650,0.48,19,6,13,330.04652394458196,0.43880662020905925,0.19325033455125018,0.18115378532625492,128794.39153928336,101.62824621958885,128896.01978550295,904,2,232.73809523809524,38,4,17,37.85851489316913,0.6044407894736843,46.23397435897436,1015.0641025641025,26.71221322537112,0
933,4,2,1,43,0.045454545454545456,0.022727272727272728,0.9772727272727273,44,850,700,150,0.8235294117647058,10,7,3,318.09450718982856,0.44102360817477093,0.2011718927361721,0.17720890993196298,129382.2617675491,-568.8426407892102,128813.4191267599,905,0,223.11363636363637,40,4,20,37.56492857856358,0.60703125,45.65548780487805,1017.378048780488,25.4344512195122,0
934,4,1,2,42,0.022727272727272728,0.045454545454545456,0.9545454545454546,44,1100,800,300,0.7272727272727273,14,8,6,323.3257299502907,0.4402748414376321,0.2016092433923904,0.18071598834721572,129511.53413973142,-425.1177374578858,129086.41640227353,906,0,223.9090909090909,40,4,16,37.30073548988287,0.6083333333333334,45.528455284552834,1017.8861788617868,25.44715447154467,0
935,4,0,1,41,0.0,0.023809523809523808,0.9761904761904762,42,1500,800,700,0.5333333333333333,22,8,14,333.4909625267365,0.4355037746806039,0.19475200288054717,0.18570180965962463,129364.36760355013,228.36949375408676,129592.73709730421,907,2,235.54761904761904,38,4,20,37.19150388573829,0.6101973684210527,45.67307692307691,1017.3076923076909,26.77125506072871,0
936,4,1,0,42,0.023809523809523808,0.0,1.0,42,1200,600,600,0.5,18,6,12,331.29939850553546,0.4356247580332946,0.1979048018703915,0.18576152156204484,129636.22708013728,189.68081123529163,129825.90789137257,908,0,235.76190476190476,38,4,17,36.97129843334733,0.6129385964912281,45.4059829059829,1018.3760683760679,26.79937022042284,0
937,4,0,0,42,0.0,0.0,1.0,42,1800,1400,400,0.7777777777777778,22,14,8,331.7064702969801,0.43555216802168023,0.19476979300841735,0.18676601615658792,129799.47973738049,211.0654540141823,130010.54519139467,909,1,236.76190476190476,38,4,18,36.79536241000909,0.6145833333333333,45.2457264957265,1019.0170940170949,26.81623931623934,0
938,4,0,0,42,0.0,0.0,1.0,42,1050,800,250,0.7619047619047619,13,8,5,334.56790253634665,0.43493515292295776,0.1964681039474132,0.18894495453682766,129917.22140842007,293.22645399304616,130210.44786241312,910,2,237.76190476190476,39,3,18,36.603083171554104,0.6140491452991452,45.13020833333333,1019.4791666666661,26.140491452991437,0
939,4,0,0,42,0.0,0.0,1.0,42,950,500,450,0.5263157894736842,14,5,9,336.3022769020461,0.4344149245063879,0.19603952692187954,0.1905712902444929,130050.00000000001,347.22222222222274,130397.22222222223,911,3,238.76190476190476,39,3,18,36.42429193899782,0.6153846153846154,45.0,1020.0000000000001,26.153846153846157,0
940,4,1,1,42,0.023255813953488372,0.023255813953488372,0.9767441860465116,43,800,600,200,0.75,10,6,4,331.56972933715934,0.43710778885197493,0.19712499001038908,0.18918978673943815,130318.55955678683,42.45873730380134,130361.01829409064,912,0,234.1860465116279,37,6,19,36.27308848797252,0.6216216216216216,44.736842105263165,1021.0526315789484,27.596017069701308,0
941,4,0,0,42,0.0,0.0,1.0,42,1700,1300,400,0.7647058823529411,21,13,8,339.9651496977187,0.4358183313975997,0.20099961609299277,0.19356876826774838,130236.00396050367,455.14051649307476,130691.14447699675,913,1,240.47619047619048,39,3,19,36.142399734666796,0.6172542735042735,44.81770833333334,1020.7291666666682,26.172542735042775,0
942,4,0,0,42,0.0,0.0,1.0,42,1550,1100,450,0.7096774193548387,20,11,9,341.4829657562597,0.4359998064266357,0.19899219217376607,0.19498656407652054,130346.55044100122,502.23074948543376,130848.78119048665,914,2,241.47619047619048,37,5,19,35.991691721249865,0.6219031531531531,44.70942982456141,1021.1622807017557,27.59898055950691,0
943,4,0,0,42,0.0,0.0,1.0,42,1050,800,250,0.7619047619047619,13,8,5,342.85810678397195,0.4355763646922184,0.20585168373918838,0.19619570778866618,130430.54112803961,543.8336795937436,130974.37480763336,915,3,242.47619047619048,37,5,20,35.87152926864176,0.6227477477477478,44.62719298245615,1021.4912280701772,27.607871028923707,0
944,4,0,0,42,0.0,0.0,1.0,42,1300,1000,300,0.7692307692307693,16,10,6,342.6765836126377,0.4352618079752226,0.2052488498536178,0.1964843432656635,130508.09500328731,544.413625904009,131052.50862919132,916,4,243.47619047619048,38,4,17,35.79765265579257,0.6217105263157895,44.55128205128205,1021.7948717948717,26.889338731443992,0
945,4,0,0,42,0.0,0.0,1.0,42,1150,800,350,0.6956521739130435,15,8,7,342.40369032739414,0.43478997289972904,0.205281548179008,0.19674330963136238,130589.9824334321,542.8983809993583,131132.88081443147,917,5,244.47619047619048,38,4,17,35.721751855336045,0.622532894736842,44.471153846153854,1022.1153846153859,26.89777327935226,0
946,4,0,1,41,0.0,0.023809523809523808,0.9761904761904762,42,1200,1000,200,0.8333333333333334,14,10,4,341.9569838229179,0.433894696089818,0.19799825935596194,0.1976003693484875,130808.47447083422,546.1742777047225,131354.64874853895,918,6,245.47619047619048,38,4,17,35.51218450826805,0.6247258771929824,44.25747863247863,1022.9700854700852,26.920265407107507,0
947,4,0,1,40,0.0,0.024390243902439025,0.975609756097561,41,1050,600,450,0.5714285714285714,15,6,9,341.6888574417449,0.43366361788617885,0.18644568316464305,0.19795047216038517,130906.99932912046,745.8926063788844,131652.89193549936,919,7,248.14634146341464,37,4,18,35.4194569448909,0.6275337837837838,44.161184210526315,1023.3552631578943,27.658250355618765,0
948,4,0,0,40,0.0,0.0,1.0,40,1700,1500,200,0.8823529411764706,19,15,4,351.967040564164,0.4310096153846154,0.18763795135540562,0.2039049279692949,130906.99932912037,1214.9898286010907,132121.98915772146,920,12,255.175,37,3,19,35.15650112504017,0.6275337837837838,44.16118421052631,1023.3552631578937,27.658250355618748,0
949,4,1,1,40,0.024390243902439025,0.024390243902439025,0.975609756097561,41,1600,1100,500,0.6875,21,11,10,346.3545778696595,0.43333333333333335,0.18347098191582445,0.20257518969059582,131273.37643363274,893.4269760391492,132166.8034096719,921,0,249.9268292682927,38,3,21,34.92993293021965,0.6293859649122807,43.8034188034188,1024.786324786324,26.968061178587476,0
950,4,0,0,40,0.0,0.0,1.0,40,1300,800,500,0.6153846153846154,18,8,10,354.73348839481974,0.43072916666666666,0.1933393965332768,0.20746803395106284,131271.93583602642,1313.3103454909165,132585.24618151734,922,1,256.85,37,3,21,34.71672373207789,0.6311936936936937,43.80482456140351,1024.7807017543855,27.696775723091502,0
951,4,0,0,40,0.0,0.0,1.0,40,1100,800,300,0.7272727272727273,14,8,6,357.0653656993446,0.4298744658119658,0.18854860562267106,0.20930032720046987,131357.78523930497,1380.6871706459624,132738.47240995092,923,2,257.85,35,5,21,34.57023164352113,0.6360119047619048,43.72106481481483,1025.115740740743,29.289021164021225,0
952,4,0,0,40,0.0,0.0,1.0,40,1100,700,400,0.6363636363636364,15,7,8,353.7857263876758,0.4292735042735043,0.1840027075812274,0.20850775789231135,131565.50068587132,1309.1992455418685,132874.6999314132,924,3,258.85,35,5,18,34.4445697954272,0.638095238095238,43.51851851851853,1025.925925925928,29.31216931216937,0
953,4,0,0,40,0.0,0.0,1.0,40,950,900,50,0.9473684210526315,10,9,1,352.9071003220161,0.4291933760683761,0.18285021430182713,0.20831387160153125,131624.87809713668,1290.2708118998855,132915.14890903656,925,4,259.85,35,5,18,34.407192270095486,0.6386904761904761,43.46064814814816,1026.157407407409,29.318783068783112,0
954,4,0,0,40,0.0,0.0,1.0,40,950,700,250,0.7368421052631579,12,7,5,349.97525659074523,0.42893963675213675,0.1819956210616256,0.2072623863035514,131749.92696069946,1221.8428987765478,132971.76985947601,926,5,260.85,37,3,18,34.35630940937734,0.6359797297297297,43.338815789473685,1026.6447368421054,27.747155049786635,0
955,4,1,0,41,0.024390243902439025,0.0,1.0,41,1050,800,250,0.7619047619047619,13,8,5,342.64090799971854,0.4302591463414634,0.18242107584780154,0.2046274472914521,132068.3478180474,850.4037228796826,132918.75154092707,927,0,255.46341463414635,38,3,19,34.22396320548797,0.6373355263157895,43.02884615384615,1027.8846153846157,27.04959514170041,0
956,4,0,2,39,0.0,0.04878048780487805,0.9512195121951219,41,1050,600,450,0.5714285714285714,15,6,9,340.0140531161515,0.429395325203252,0.1823313890732925,0.20379671701719018,132205.65440317048,790.3560796990348,132996.01048286952,928,1,256.4634146341463,38,3,20,34.15337800401691,0.6387061403508771,42.89529914529915,1028.4188034188037,27.063652721547466,0
957,4,0,0,39,0.0,0.0,1.0,39,1450,1300,150,0.896551724137931,16,13,3,350.834177594436,0.425157444894287,0.19958677917950962,0.2105466082882774,132253.17166829002,1479.7865433000725,133732.9582115901,929,2,268.7435897435897,36,3,20,33.82736661557551,0.6429398148148149,42.84909909909911,1028.6036036036046,28.57232232232235,0
958,4,0,0,39,0.0,0.0,1.0,39,1450,1200,250,0.8275862068965517,17,12,5,352.1690562895673,0.42504498425551057,0.1785111844517786,0.20441996945543836,130982.06948502548,1436.7515319373306,132418.82101696281,930,3,269.7435897435897,36,3,18,35.07540337367069,0.6302083333333333,44.08783783783783,1023.648648648648,28.434684684684665,8
959,4,1,1,39,0.025,0.025,0.975,40,1100,700,400,0.6363636363636364,15,7,8,345.0327186198692,0.4264823717948718,0.17113821138211405,0.20209059233449483,131328.12500000012,1062.5000000000146,132390.62500000012,931,0,263.975,37,3,19,34.90853658536586,0.6317567567567568,43.75000000000001,1025.000000000001,27.702702702702727,0
960,4,0,0,39,0.0,0.0,1.0,39,1050,700,350,0.6666666666666666,14,7,7,343.58154034130536,0.42720985155195684,0.15560381615528285,0.20139232206869964,131356.98356718212,1226.3669497199999,132583.3505169021,932,1,263.4102564102564,36,3,19,34.91660258522831,0.6339699074074074,43.72184684684685,1025.1126126126132,28.475350350350368,0
961,4,0,1,38,0.0,0.02564102564102564,0.9743589743589743,39,1550,1000,550,0.6451612903225806,21,10,11,345.584775045053,0.4271255060728745,0.15385178366844854,0.2034862130501221,131530.2015486771,1290.9670227660185,132821.16857144312,933,2,264.4102564102564,36,3,19,34.69050755662898,0.6357060185185186,43.55292792792793,1025.7882882882889,28.494119119119134,0
962,4,0,0,38,0.0,0.0,1.0,38,1400,1100,300,0.7857142857142857,17,11,6,343.2985419138458,0.42726114272166904,0.13564973871871122,0.20306075337733337,131703.53366457685,1442.726214390074,133146.25987896693,934,3,266.39473684210526,36,2,15,34.574419455110615,0.6374421296296297,43.38400900900901,1026.4639639639647,28.51288788788791,0
963,4,0,1,37,0.0,0.02631578947368421,0.9736842105263158,38,950,700,250,0.7368421052631579,12,7,5,342.33472645735566,0.426075746799431,0.13212136250064876,0.20341596351905816,131876.97991488117,1429.2139690366112,133306.1938839178,935,4,267.39473684210526,36,2,16,34.424450900851525,0.6391782407407407,43.215090090090094,1027.13963963964,28.53165665665667,0
964,4,1,0,38,0.02631578947368421,0.0,1.0,38,750,400,350,0.5333333333333333,11,4,7,342.7171085849002,0.42697961119013755,0.1362283393710053,0.20410906649664684,131963.74584043506,1445.2466824933113,133408.99252292837,936,0,268.2631578947368,36,2,17,34.32727787520094,0.6400462962962963,43.130630630630634,1027.4774774774778,28.54104104104105,0
965,4,0,0,38,0.0,0.0,1.0,38,650,400,250,0.6153846153846154,9,4,5,343.9746509089539,0.4270092460881934,0.14205567599981506,0.20548433334404015,132079.4781267756,1486.398476178898,133565.8766029545,937,1,269.2631578947368,36,2,19,34.17848926380367,0.6412037037037037,43.018018018018026,1027.9279279279292,28.553553553553588,0
966,4,0,0,38,0.0,0.0,1.0,38,1050,800,250,0.7619047619047619,13,8,5,341.8008115364106,0.4263276434329066,0.1350831085598354,0.20481135242457377,132195.261139518,1436.889507751005,133632.150647269,938,2,270.2631578947368,36,2,19,34.1178912979997,0.6423611111111112,42.90540540540541,1028.3783783783792,28.56606606606609,0
967,4,1,0,39,0.02564102564102564,0.0,1.0,39,1000,700,300,0.7,13,7,6,336.06602707032573,0.42861560953666217,0.14256230791663915,0.20323993065681598,132542.91453615774,1108.7894905040132,133651.70402666176,939,0,264.3076923076923,36,3,21,33.9161380869058,0.6458333333333333,42.567567567567565,1029.7297297297293,28.60360360360359,0
968,4,0,1,38,0.0,0.02564102564102564,0.9743589743589743,39,1450,1100,350,0.7586206896551724,18,11,7,380.3399821363517,0.4283344579397211,0.14154910049855962,0.216225904524443,130176.3820408247,2105.503053729415,132281.8850945541,940,1,265.3076923076923,36,3,19,35.17274516295152,0.6221064814814814,44.87612612612613,1020.4954954954962,28.34709709709712,8
969,4,0,0,38,0.0,0.0,1.0,38,1250,800,450,0.64,17,8,9,384.0322077755865,0.42546823138928397,0.14757493643384967,0.21847716181710425,130203.51750042842,2400.4688571673255,132603.98635759574,941,2,273.1842105263158,35,3,19,35.05093747637408,0.6244047619047619,44.849537037037024,1020.6018518518498,29.16005291005285,0
970,4,0,0,38,0.0,0.0,1.0,38,850,600,250,0.7058823529411765,11,6,5,385.23147639698834,0.4253496917970602,0.13325867861142182,0.2159416808060178,129625.34722222199,2405.50518689983,132030.8524091218,942,3,274.1842105263158,34,4,17,35.60931533006,0.6207107843137255,45.41666666666665,1018.3333333333314,29.950980392156808,8
971,4,0,0,38,0.0,0.0,1.0,38,900,600,300,0.6666666666666666,12,6,6,386.44884151297845,0.4255275011853959,0.1314682217465124,0.21695907401476622,129685.96938775481,2423.3985260770633,132109.36791383187,943,4,275.1842105263158,34,4,17,35.516499142901665,0.6213235294117647,45.35714285714284,1018.5714285714262,29.95798319327724,0
972,4,0,0,38,0.0,0.0,1.0,38,850,700,150,0.8235294117647058,10,7,3,384.63518458223433,0.42539414414414417,0.1238757154538026,0.21677826301570122,129837.58680555523,2388.0208333332957,132225.60763888853,944,5,276.1842105263158,34,4,18,35.4081493594985,0.6228553921568627,45.208333333333314,1019.166666666664,29.975490196078354,0
973,4,0,0,38,0.0,0.0,1.0,38,1000,500,500,0.5,15,5,10,384.04257627439347,0.42475699383594123,0.127036761587491,0.21678026240195278,129898.25857426271,2377.292375283407,132275.55094954613,945,6,277.1842105263158,34,4,18,35.361438748102294,0.623468137254902,45.148809523809504,1019.4047619047593,29.982492997198804,0
974,4,1,0,39,0.02564102564102564,0.0,1.0,39,1400,1200,200,0.8571428571428571,16,12,4,370.8586735754879,0.4256354026090868,0.1321338075644518,0.21194669272215652,130380.7656035661,1870.5675582989916,132251.3331618651,946,0,271.05128205128204,35,4,20,35.207011181625866,0.6261904761904762,44.6759259259259,1021.2962962962929,29.17989417989408,0
975,4,0,0,39,0.0,0.0,1.0,39,1200,900,300,0.75,15,9,6,366.89497046613513,0.4255229419703104,0.1290532455009128,0.21032135060227478,130498.99798525333,1775.885202331914,132274.88318758525,947,1,272.05128205128204,35,4,15,35.188226853949566,0.6273809523809524,44.56018518518516,1021.7592592592557,29.193121693121594,0
976,4,0,0,39,0.0,0.0,1.0,39,1300,1000,300,0.7692307692307693,16,10,6,365.96453929450684,0.42560728744939275,0.13027000182963544,0.2099480778057952,130528.56445312448,1753.7651909721637,132282.32964409664,948,2,273.05128205128204,35,4,15,35.18199966021066,0.6276785714285714,44.53124999999997,1021.8749999999958,29.196428571428452,0
977,4,0,1,38,0.0,0.02564102564102564,0.9743589743589743,39,1350,900,450,0.6666666666666666,18,9,9,367.13530481170534,0.42633828160143955,0.12614699538734486,0.2112642441304095,130646.86381440719,1793.015233839121,132439.8790482463,949,3,274.05128205128204,35,4,16,35.032100267934645,0.6288690476190476,44.41550925925924,1022.3379629629599,29.209656084655997,0
978,4,1,0,39,0.02564102564102564,0.0,1.0,39,950,700,250,0.7368421052631579,12,7,5,365.810661147084,0.42670377867746284,0.13347955506815024,0.2113094524979033,130794.8133680552,1769.2274305555163,132564.04079861072,950,0,274.94871794871796,35,4,17,34.91598778004072,0.6303571428571428,44.270833333333314,1022.9166666666638,29.226190476190393,0
979,4,0,1,38,0.0,0.02564102564102564,0.9743589743589743,39,1150,600,550,0.5217391304347826,17,6,11,362.3280981800126,0.4266194331983806,0.13437034201567144,0.20994135282487975,130913.23329260941,1686.7085691014713,132599.9418617109,951,1,275.94871794871796,35,4,17,34.88511271959587,0.631547619047619,44.155092592592574,1023.3796296296271,29.239417989417916,0
980,4,0,0,38,0.0,0.0,1.0,38,1300,1100,200,0.8461538461538461,15,11,4,365.47695833161634,0.42370495495495497,0.14062528690606602,0.21220367080982905,130992.77388038543,1974.9681122448912,132967.74199263033,952,2,282.7894736842105,34,4,19,34.723998914602475,0.6344975490196079,44.07738095238095,1023.6904761904758,30.108543417366935,0
981,4,1,0,39,0.02564102564102564,0.0,1.0,39,1250,800,450,0.64,17,8,9,357.19083172797207,0.4248200629779577,0.12416995212208559,0.20953618459909779,131387.4488275891,1586.0784250685801,132973.5272526577,953,0,276.5128205128205,35,4,20,34.53704749002786,0.6363095238095238,43.692129629629626,1025.231481481481,29.29232804232803,0
982,4,0,0,39,0.0,0.0,1.0,39,800,700,100,0.875,9,7,2,360.6455935372564,0.42535425101214575,0.1223177890220648,0.2123855080080201,131535.817003708,1687.5625589420413,133223.37956265005,954,1,277.5128205128205,35,4,20,34.29860562638685,0.6377976190476191,43.5474537037037,1025.8101851851852,29.308862433862434,0
983,4,0,0,39,0.0,0.0,1.0,39,850,700,150,0.8235294117647058,10,7,3,361.1507504596727,0.42459514170040485,0.12866207407150365,0.21317993033125548,131624.87809713642,1707.284700788745,133332.16279792515,955,2,278.5128205128205,35,4,17,34.195710203774716,0.6386904761904761,43.460648148148145,1026.157407407407,29.318783068783056,0
984,4,0,1,38,0.0,0.02564102564102564,0.9743589743589743,39,1350,1100,250,0.8148148148148148,16,11,5,360.25843150678804,0.42290823211875844,0.12406649557235694,0.2136505885246138,131803.0907064472,1696.6349451303172,133499.72565157752,956,3,279.5128205128205,35,4,17,34.03873609858732,0.6404761904761904,43.28703703703704,1026.851851851852,29.338624338624342,0
985,4,0,0,38,0.0,0.0,1.0,38,750,500,250,0.6666666666666666,10,5,5,365.2934918115492,0.4207562825983879,0.1259086775270546,0.21619257240157783,131725.001771542,2023.6571712018197,133748.65894274384,957,7,287.7894736842105,34,4,18,33.988316131276804,0.6418504901960784,43.36309523809524,1026.5476190476195,30.192577030812338,0
986,4,0,1,37,0.0,0.02631578947368421,0.9736842105263158,38,800,600,200,0.75,10,6,4,364.75493535119836,0.42001541014698907,0.12314056646368932,0.21639450291192835,131816.67375283453,2016.1564625850376,133832.83021541956,958,8,288.7894736842105,34,4,18,33.90959502279928,0.6427696078431373,43.273809523809526,1026.9047619047624,30.203081232493012,0
987,4,0,0,37,0.0,0.0,1.0,37,1150,700,450,0.6086956521739131,16,7,9,372.7938218043563,0.4196071071071071,0.126061637872662,0.22161402938752572,131893.99059256038,2433.8529652056695,134327.84355776606,959,9,294.64864864864865,33,4,18,33.62512924520799,0.6458333333333333,43.198529411764696,1027.2058823529399,31.127450980392116,0
988,4,0,1,36,0.0,0.02702702702702703,0.972972972972973,37,850,700,150,0.8235294117647058,10,7,3,372.93669133135563,0.41991991991991995,0.12734910742783834,0.22188277384178512,131925.46323829758,2439.9691524894047,134365.432390787,960,10,295.64864864864865,33,4,18,33.589680504194995,0.6461489898989898,43.167892156862735,1027.3284313725476,31.131164587046896,0
989,4,0,0,36,0.0,0.0,1.0,36,1000,400,600,0.4,16,4,12,381.58203222819554,0.41696428571428573,0.13427064546100453,0.2261680091894814,131781.48275686143,2857.089200081613,134638.57195694305,961,22,304.5833333333333,32,4,18,33.513178389899984,0.6471354166666667,43.3080808080808,1026.767676767676,32.086489898989875,0
990,4,0,0,36,0.0,0.0,1.0,36,750,500,250,0.6666666666666666,10,5,5,370.32094096234226,0.4158564814814815,0.10708183837348417,0.20467313195964004,129069.04432508674,2360.832776849137,131429.87710193588,962,23,305.5833333333333,31,5,18,36.55603963779259,0.6223118279569892,45.963541666666664,1016.1458333333328,32.778897849462346,7
991,4,0,0,36,0.0,0.0,1.0,36,1050,500,550,0.47619047619047616,16,5,11,371.8758398280034,0.416005291005291,0.10678506375227692,0.20622205663189266,129201.38888888879,2409.37499999999,131610.7638888888,963,24,306.5833333333333,31,5,18,36.38148907103826,0.6236559139784946,45.83333333333333,1016.6666666666658,32.795698924731155,0
992,4,0,0,36,0.0,0.0,1.0,36,550,200,350,0.36363636363636365,9,2,7,372.0870289825128,0.4157903439153439,0.10320559325168177,0.20685920166422847,129300.69181654195,2422.2220526801266,131722.91386922207,964,25,307.5833333333333,31,5,18,36.274831434302044,0.6246639784946236,45.735677083333336,1017.0572916666672,32.808299731182814,0
993,4,0,0,36,0.0,0.0,1.0,36,1000,600,400,0.6,14,6,8,369.98111723890077,0.4165509259259259,0.10268358569702163,0.20638132985167817,129433.15505981453,2377.5646633572187,131810.71972317176,965,26,308.5833333333333,31,5,18,36.193351460865856,0.626008064516129,45.60546875000001,1017.5781250000006,32.82510080645163,0
994,4,1,0,37,0.02702702702702703,0.0,1.0,37,800,700,100,0.875,9,7,2,372.5589124146176,0.42085835835835833,0.13785489908772486,0.21122129497527722,130069.31889921974,2291.696797520697,132361.01569674045,966,0,301.2162162162162,32,5,19,35.48010273548706,0.6298828125,44.98106060606062,1020.0757575757598,31.877367424242493,0
995,4,1,0,38,0.02631578947368421,0.0,1.0,38,800,500,300,0.625,11,5,6,363.6090538341038,0.4231418918918919,0.14802828907902565,0.20800833656192586,130419.01139285389,1884.3066669069776,132303.31805976087,967,0,294.2631578947368,33,5,21,35.35330433913215,0.6309974747474747,44.63848039215687,1021.4460784313741,30.952911467617398,0
996,4,0,0,38,0.0,0.0,1.0,38,1300,800,500,0.6153846153846154,18,8,10,363.85424821704476,0.42271218587008064,0.1404949551675614,0.20915977149402976,130606.84479827482,1904.3710652153136,132511.21586349013,968,1,295.2631578947368,33,5,17,35.15653099148781,0.6328914141414141,44.454656862745104,1022.1813725490206,30.97519310754608,0
997,4,0,0,38,0.0,0.0,1.0,38,1100,800,300,0.7272727272727273,14,8,6,364.7457662970813,0.42251955903271693,0.1416358566038689,0.20984201258277604,130638.16350682438,1929.9434111880155,132568.1069180124,969,2,296.2631578947368,33,5,17,35.101993926316645,0.6332070707070707,44.42401960784314,1022.3039215686281,30.97890671420085,0
998,4,1,0,39,0.02564102564102564,0.0,1.0,39,950,700,250,0.7368421052631579,12,7,5,355.53684259269534,0.42498875393612234,0.14476936793485207,0.20643222886256501,130992.77388038556,1514.5514455782395,132507.3253259638,970,0,289.64102564102564,34,5,18,34.97838895995658,0.6344975490196079,44.077380952380956,1023.6904761904768,30.108543417366967,0
999,4,0,0,39,0.0,0.0,1.0,39,800,500,300,0.625,11,5,6,354.7187669010278,0.42496063877642826,0.1422182468694102,0.20612036455059723,131023.2426303855,1495.2806122449058,132518.5232426304,971,1,290.64102564102564,34,5,18,34.968507751938,0.6348039215686274,44.04761904761905,1023.8095238095239,30.11204481792717,0
1000,4,0,0,39,0.0,0.0,1.0,39,950,500,450,0.5263157894736842,14,5,9,362.8240762233095,0.42425775978407554,0.05960505792196158,0.20474699226767226,129887.5507617263,1625.6204319963372,131513.17119372264,972,2,291.64102564102564,33,6,19,35.91308006732388,0.6256313131313131,45.1593137254902,1019.3627450980396,30.889780154486047,8
1001,4,1,0,40,0.025,0.0,1.0,40,1600,1300,300,0.8125,19,13,6,355.3218982222241,0.4268162393162393,0.07965562754979594,0.2031037516998641,130387.71896626313,1266.463019031162,131654.1819852943,973,0,285.325,33,7,20,35.59665226781858,0.6306818181818181,44.66911764705883,1021.323529411766,30.949197860962606,0
1002,4,2,0,42,0.047619047619047616,0.0,1.0,42,1650,1200,450,0.7272727272727273,21,12,9,338.9921000646207,0.43042247386759586,0.0886799767396782,0.19672218720285473,130972.46334876542,479.7260802469124,131452.18942901233,974,0,272.6904761904762,35,7,19,35.42232021709633,0.6321428571428571,44.09722222222222,1023.6111111111111,29.246031746031747,0
1003,4,1,1,42,0.023255813953488372,0.023255813953488372,0.9767441860465116,43,900,700,200,0.7777777777777778,11,7,4,335.9449316290131,0.4309708379475821,0.12742582197273444,0.18735390417771874,129424.43828870416,95.89681440442433,129520.33510310858,975,0,267.3255813953488,37,6,19,37.068067528735625,0.6126126126126126,45.614035087719294,1017.5438596491223,27.501185395922224,8
1004,4,0,0,42,0.0,0.0,1.0,42,1050,700,350,0.6666666666666666,14,7,7,343.12086251254266,0.42829316686024005,0.13098135912917952,0.19166417524031878,129487.77113261899,485.991143170182,129973.76227578917,976,1,274.6666666666667,36,6,13,36.82115327874899,0.615162037037037,45.551801801801794,1017.7927927927918,28.272022022021996,0
1005,4,0,1,41,0.0,0.023809523809523808,0.9761904761904762,42,1650,1300,350,0.7878787878787878,20,13,7,353.6058155746685,0.4280874951606659,0.08011201376681987,0.1950995756757847,129001.10995708525,723.1085392825078,129724.21849636776,977,2,275.6666666666667,36,6,20,37.049892842626484,0.6102430555555556,46.030405405405396,1015.8783783783766,28.218843843843796,8
1006,4,1,0,42,0.023809523809523808,0.0,1.0,42,950,600,350,0.631578947368421,13,6,7,346.90363649127494,0.4272164150212931,0.09770369549968616,0.1925133948297307,129230.0128464612,566.0722800503065,129796.08512651152,978,0,276.54761904761904,36,6,21,36.98706944290617,0.6125578703703703,45.80518018018017,1016.7792792792783,28.24386886886884,0
1007,4,1,0,43,0.023255813953488372,0.0,1.0,43,950,500,450,0.5263157894736842,14,5,9,339.7551642914914,0.42930970837947585,0.10500686352113653,0.19001728586037375,129536.03512619257,202.1073791935844,129738.14250538615,979,0,271.09302325581393,37,6,15,36.85776604911674,0.6137387387387387,45.504385964912274,1017.98245614035,27.513039355144596,0
1008,4,0,1,42,0.0,0.023255813953488372,0.9767441860465116,43,1050,800,250,0.7619047619047619,13,8,5,338.91388717159396,0.42958656330749356,0.10162242294179613,0.18995131382996924,129619.76431450044,185.9876356186294,129805.75195011907,980,1,272.09302325581393,37,6,15,36.79415221994902,0.6145833333333333,45.42214912280701,1018.3114035087706,27.52192982456137,0
1009,4,0,0,42,0.0,0.0,1.0,42,1650,1100,550,0.6666666666666666,22,11,11,349.703125674672,0.42778503677893925,0.0945614339952503,0.1960548893661536,129631.081144489,666.4788521629614,130297.55999665197,981,2,279.5238095238095,36,6,17,36.50798038998855,0.6166087962962963,45.41103603603603,1018.3558558558551,28.28766266266264,0
1010,4,0,1,41,0.0,0.023809523809523808,0.9761904761904762,42,1200,900,300,0.75,15,9,6,363.6896254804666,0.42728900503290745,0.021856589525762526,0.20078412153883837,129024.94454089491,1015.7596328028305,130040.70417369774,982,3,280.5238095238095,35,7,20,36.76948051948052,0.6125,46.006944444444436,1015.9722222222209,29.02777777777774,8
1011,4,0,1,40,0.0,0.024390243902439025,0.975609756097561,41,1150,800,350,0.6956521739130435,15,8,7,369.61764319290364,0.4272611788617886,0.026147713146726925,0.2041868339580217,129050.14349489806,1339.8419784580594,130389.98547335612,983,4,285.9756097560976,34,7,20,36.59319468853739,0.6148897058823529,45.98214285714286,1016.0714285714294,29.88445378151263,0
1012,4,0,0,40,0.0,0.0,1.0,40,1000,900,100,0.9,11,9,2,376.4256820922945,0.426295405982906,0.03334539315002383,0.20808811706062064,129076.82742214546,1717.5665609381122,130794.39398308357,984,5,292.725,33,7,21,36.39300932625823,0.6174242424242424,45.95588235294118,1016.1764705882364,30.793226381461707,0
1013,4,0,1,39,0.0,0.025,0.975,40,1050,900,150,0.8571428571428571,12,9,3,376.4792922961168,0.4264022435897436,0.03330821174484533,0.20828170587136077,129107.96215698293,1721.2948445309603,130829.25700151389,985,6,293.725,33,7,21,36.35985670645927,0.617739898989899,45.92524509803922,1016.2990196078435,30.79693998811647,0
1014,4,0,0,39,0.0,0.0,1.0,39,1000,700,300,0.7,13,7,6,386.15513008582985,0.4236673414304993,0.04056297457565061,0.2132731868085568,129040.9799542139,2165.9672801244856,131206.94723433838,986,11,302.1025641025641,32,7,21,36.182480013255464,0.6194661458333333,45.99116161616162,1016.0353535353538,31.751104797979806,0
1015,4,1,0,40,0.025,0.0,1.0,40,1350,900,450,0.6666666666666666,18,9,9,377.15303766191585,0.4268563034188034,0.06387993053832819,0.21086045697852748,129522.50567544138,1770.0609312825393,131292.5666067239,987,0,295.525,32,8,18,35.91979864384357,0.6243489583333333,45.517676767676775,1017.9292929292938,31.81029040404043,0
1016,4,1,0,41,0.024390243902439025,0.0,1.0,41,1100,600,500,0.5454545454545454,16,6,10,368.7027945459647,0.430005081300813,0.07746695718730656,0.2078983825246635,129856.3221627499,1375.6777741733922,131231.9999369233,988,0,289.2926829268293,33,8,19,35.795033265199784,0.6253156565656566,45.189950980392155,1019.2401960784314,30.886066547831255,0
1017,4,0,0,41,0.0,0.0,1.0,41,1600,1500,100,0.9375,17,15,2,356.74849895375337,0.430005081300813,0.05649758261232396,0.19160814161049888,127928.2764103479,927.6441166265075,128855.92052697441,989,1,290.2926829268293,38,3,20,38.06610166508257,0.5956688596491229,47.088675213675224,1011.6452991453006,26.622244714350014,8
1018,4,1,0,42,0.023809523809523808,0.0,1.0,42,1100,700,400,0.6363636363636364,15,7,8,347.87839949375837,0.4322493224932249,0.05945895868074835,0.18839049990646367,128258.57688347163,524.2255746771452,128782.80245814877,990,0,284.35714285714283,36,6,23,37.952797850657795,0.6027199074074074,46.762387387387406,1012.9504504504531,28.137512512512586,0
1019,4,0,0,42,0.0,0.0,1.0,42,1300,1000,300,0.7692307692307693,16,10,6,348.9430941574288,0.43203155245838176,0.06570835912985062,0.18950747762961398,128372.67324334485,558.951561358673,128931.62480470352,991,1,285.35714285714283,36,6,14,37.80929362521763,0.6038773148148149,46.649774774774784,1013.4009009009021,28.15002502502506,0
1020,4,0,1,41,0.0,0.023809523809523808,0.9761904761904762,42,1350,1100,250,0.8148148148148148,16,11,5,368.9187695989963,0.43180168408826947,0.06144521921356483,0.19394772426422857,127063.62771132612,991.7080086843455,128055.33572001047,992,2,286.35714285714283,36,6,17,38.646031125507264,0.5905671296296297,47.94481981981981,1008.2207207207201,28.006131131131113,8
1021,4,0,1,40,0.0,0.024390243902439025,0.975609756097561,41,1250,1100,150,0.88,14,11,3,378.6211085999732,0.4294461382113821,0.06141815207770818,0.1986164225113591,126975.33543381326,1415.1084533607477,128390.44388717401,993,5,294.2926829268293,35,6,17,38.492382483540055,0.5916666666666667,48.0324074074074,1007.8703703703688,28.79629629629625,0
1022,4,0,0,40,0.0,0.0,1.0,40,800,400,400,0.5,12,4,8,380.74557003905676,0.4281517094017094,0.06805396096440863,0.20001772708324386,127033.66796339155,1673.5012645747474,128707.1692279663,994,6,297.05,35,5,17,38.37877918101798,0.5922619047619048,47.97453703703703,1008.1018518518512,28.802910052910033,0
1023,4,1,0,41,0.024390243902439025,0.0,1.0,41,1300,700,600,0.5384615384615384,19,7,12,371.820984337083,0.43274898373983745,0.07042362910950728,0.19691880863173802,127362.24666950104,1271.2179766453792,128633.46464614641,995,0,290.780487804878,34,7,16,38.26586271966034,0.5977328431372548,47.64880952380952,1009.4047619047611,29.688375350140035,0
1024,4,2,0,43,0.046511627906976744,0.0,1.0,43,1350,1100,250,0.8148148148148148,16,11,5,356.2379704963372,0.43775378368401624,0.08667320151090974,0.19170380348167304,128005.79415060382,520.1048639965887,128525.8990146004,996,0,278.2093023255814,37,6,18,37.999670422942174,0.5982545045045045,47.01206140350876,1011.9517543859632,27.350047415836844,0
1025,4,1,0,44,0.022727272727272728,0.0,1.0,44,1150,800,350,0.6956521739130435,15,8,7,348.30326610490033,0.44010967230443976,0.08881659831026889,0.1892632033279009,128394.44739006225,144.11621845182077,128538.56360851407,997,0,272.8636363636364,37,7,16,37.80327004219408,0.6021959459459459,46.628289473684205,1013.4868421052627,27.391536273115207,0
1026,4,1,1,44,0.022222222222222223,0.022222222222222223,0.9777777777777777,45,1050,600,450,0.5714285714285714,15,6,9,340.18567891442694,0.44063552188552185,0.0913130462251237,0.18620999381269795,128685.96734832697,-244.57536616993207,128441.39198215705,998,0,267.77777777777777,38,7,17,37.7116896563827,0.6033442982456141,46.34081196581196,1014.6367521367509,26.700967161493445,0
1027,4,0,1,43,0.0,0.022727272727272728,0.9772727272727273,44,1300,900,400,0.6923076923076923,17,9,8,341.20013807671273,0.44195956659619445,0.07354123400549328,0.18702020263073832,128740.17373666818,-14.766989005764515,128725.40674766242,999,1,259.52272727272725,38,6,17,37.63071551391374,0.6038925438596492,46.287393162393165,1014.8504273504277,26.70659019343231,0
1028,4,0,1,42,0.0,0.023255813953488372,0.9767441860465116,43,1250,800,450,0.64,17,8,9,345.40172092008066,0.43835363602805466,0.06763134483642586,0.1891329896683091,128700.23108071709,290.6562596183411,128990.88734033542,1000,2,266.48837209302326,37,6,17,37.564836827317926,0.6052927927927928,46.32675438596491,1014.6929824561398,27.42413466097675,0
1029,4,2,1,43,0.045454545454545456,0.022727272727272728,0.9772727272727273,44,1650,1300,350,0.7878787878787878,20,13,7,342.3640776867067,0.4379074171952079,0.08171445233702057,0.1889460252305799,129011.3768924866,33.772212177651994,129045.14910466425,1001,0,261.09090909090907,38,6,19,37.32494654187261,0.6066337719298245,46.02029914529914,1015.9188034188029,26.73470535312639,0
1030,4,1,0,44,0.022727272727272728,0.0,1.0,44,1100,600,500,0.5454545454545454,16,6,10,341.3153852735739,0.4372026955602537,0.08657609303365765,0.1887683049166093,129095.5078125,12.456597222221802,129107.96440972222,1002,0,261.9318181818182,39,5,20,37.26595599289325,0.6057692307692308,45.9375,1016.25,26.057692307692307,0
1031,4,1,0,45,0.022222222222222223,0.0,1.0,45,1200,800,400,0.6666666666666666,16,8,8,335.7233842046238,0.43768939393939393,0.09288357222401888,0.1870977346567387,129396.5465936632,-311.580486303503,129084.9661073597,1003,0,257.0888888888889,37,8,21,37.1020359593347,0.6123310810810811,45.64144736842104,1017.4342105263139,27.49822190611659,0
1032,4,1,3,43,0.021739130434782608,0.06521739130434782,0.9347826086956522,46,1100,700,400,0.6363636363636364,15,7,8,326.04426470425176,0.43947262479871174,0.09700928597147129,0.18338349356367337,129757.9766167531,-738.6311848958724,129019.34543185723,1004,0,252.47826086956522,39,7,17,36.98166939304093,0.6124465811965811,45.286458333333314,1018.8541666666637,26.124465811965734,0
1033,4,0,0,43,0.0,0.0,1.0,43,1000,800,200,0.8,12,8,4,343.9874498711966,0.4382152085640458,0.1026220370518105,0.19200831281568861,129459.11864144528,306.462416808674,129765.58105825396,1005,1,261.06976744186045,36,7,17,36.82822470583895,0.6148726851851851,45.57995495495494,1017.6801801801784,28.268893893893843,0
1034,4,1,0,44,0.022727272727272728,0.0,1.0,44,800,600,200,0.75,10,6,4,335.2282065746619,0.4400876497533474,0.11029054305241814,0.1886177820709467,129772.26382725152,-99.33534681133756,129672.92848044018,1006,0,256.1136363636364,38,6,18,36.733249449512435,0.6143092105263157,45.272435897435884,1018.9102564102541,26.813427800269846,0
1035,4,1,3,42,0.022222222222222223,0.06666666666666667,0.9333333333333333,45,1250,900,350,0.72,16,9,7,326.9575804177882,0.4404040404040404,0.11702977487291188,0.1852759622367463,130049.99999999975,-495.8333333333632,129554.1666666664,1007,0,251.4,39,6,19,36.66258169934638,0.6153846153846154,44.999999999999986,1019.9999999999981,26.153846153846104,0
1036,4,0,1,41,0.0,0.023809523809523808,0.9761904761904762,42,850,600,250,0.7058823529411765,11,6,5,350.951623383438,0.43809281842818426,0.11553491115534964,0.19661118826722723,129602.41280131487,696.835433406386,130299.24823472126,1008,1,269.73809523809524,36,6,20,36.50533620880338,0.6163194444444444,45.43918918918919,1018.2432432432436,28.284534534534544,0
1037,4,1,0,42,0.023809523809523808,0.0,1.0,42,1050,700,350,0.6666666666666666,14,7,7,351.1959274935439,0.43712495160665893,0.1173576561636267,0.1971798363860401,129688.42734203815,709.2095051132419,130397.63684715139,1009,0,270.45238095238096,36,6,21,36.411691542288565,0.6171875,45.35472972972974,1018.5810810810824,28.293918918918955,0
1038,4,0,0,42,0.0,0.0,1.0,42,1550,1100,450,0.7096774193548387,20,11,9,349.0294430690818,0.43658052651955087,0.11332902901825759,0.19645854721023487,129787.30384589492,659.9180757540818,130447.221921649,1010,1,271.45238095238096,37,5,21,36.366418271817494,0.6162725225225225,45.25767543859649,1018.9692982456143,27.53971076339498,0
1039,4,0,1,41,0.0,0.023809523809523808,0.9761904761904762,42,1000,600,400,0.6,14,6,8,360.39709337747763,0.4368829849012776,0.09027325549110721,0.1889730840372287,126957.38965821087,751.8834998242646,127709.27315803514,1011,2,272.45238095238096,38,4,18,38.9700166083607,0.5858004385964912,48.05021367521367,1007.7991452991446,26.521030139451174,8
1040,4,0,1,40,0.0,0.024390243902439025,0.975609756097561,41,1050,800,250,0.7619047619047619,13,8,5,367.86269216616984,0.4347306910569106,0.10342036615883465,0.19287085018250275,126953.84787867447,1140.3168523007366,128094.1647309752,1012,5,280.0487804878049,37,4,19,38.78556468284192,0.5875563063063063,48.05372807017545,1007.7850877193003,27.237434803224335,0
1041,4,1,1,40,0.024390243902439025,0.024390243902439025,0.975609756097561,41,1000,800,200,0.8,12,8,4,374.41894979195547,0.43645833333333334,0.1144892645889386,0.1972527126080447,127148.79575521493,1321.458858109232,128470.25461332416,1013,0,280.9024390243902,36,5,20,38.41977445288076,0.5914351851851851,47.860360360360374,1008.5585585585607,28.015515515515574,0
1042,4,2,1,41,0.047619047619047616,0.023809523809523808,0.9761904761904762,42,1350,1100,250,0.8148148148148148,16,11,5,363.9809712922484,0.4405487804878048,0.12249767585993143,0.19465803685119107,127756.25673284105,900.1692828562792,128656.42601569733,1014,0,268.26190476190476,37,5,20,38.05947216196674,0.5957207207207207,47.25877192982457,1010.9649122807032,27.32337600758657,0
1043,4,0,0,41,0.0,0.0,1.0,41,1200,800,400,0.6666666666666666,16,8,8,375.4325660798448,0.4380081300813008,0.10686664547239944,0.19468894093174013,126505.73284614092,1373.0558601641892,127878.7887063051,1015,1,275.8048780487805,33,8,19,39.05659946400293,0.5912247474747474,48.49877450980392,1006.0049019607844,30.48499702911468,8
1044,4,3,2,42,0.06818181818181818,0.045454545454545456,0.9545454545454546,44,1050,800,250,0.7619047619047619,13,8,5,348.64779945642044,0.4434350775193798,0.11615059666126992,0.18464613938731986,127362.24666950117,83.62420335781803,127445.87087285898,1016,0,257.9318181818182,34,10,18,38.850640798836345,0.5977328431372548,47.648809523809526,1009.4047619047622,29.688375350140063,0
1045,4,2,0,44,0.045454545454545456,0.0,1.0,44,800,600,200,0.75,10,6,4,355.15041458511564,0.4429836152219873,0.14296995594083217,0.1791464910326392,125366.25888980179,117.95957913233929,125484.21846893412,1017,0,258.8863636363636,36,8,18,40.74225045916265,0.5732060185185186,49.634009009009,1001.4639639639624,27.8184434434434,8
1046,4,0,0,44,0.0,0.0,1.0,44,1350,800,550,0.5925925925925926,19,8,11,357.08034360135844,0.4442939570119803,0.14210204264379644,0.18055578857142254,125466.44310028052,160.32012253766754,125626.76322281819,1018,1,259.8863636363636,37,7,19,40.59034238079603,0.5723536036036037,49.53399122807016,1001.8640350877166,27.077406353722072,0
1047,4,2,1,45,0.043478260869565216,0.021739130434782608,0.9782608695652174,46,1700,1300,400,0.7647058823529411,21,13,8,338.69873245812573,0.4473832528180354,0.14567992599444923,0.17378646752764088,126070.65892322295,-658.6799964616511,125411.9789267613,1019,0,249.54347826086956,38,8,21,40.42796985815603,0.5767543859649122,48.931623931623925,1004.2735042735036,26.42825011246062,0
1048,4,1,1,45,0.021739130434782608,0.021739130434782608,0.9782608695652174,46,1000,500,500,0.5,15,5,10,337.6794658193167,0.44787640901771336,0.1509119988166665,0.17394375988480223,126231.65155416737,-674.8326667397425,125556.81888742762,1020,0,249.84782608695653,38,8,22,40.287892479977316,0.5783991228070176,48.77136752136751,1004.9145299145282,26.44511920827706,0
1049,4,2,2,45,0.0425531914893617,0.0425531914893617,0.9574468085106383,47,800,300,500,0.375,13,3,10,329.7628547840095,0.45064369411039157,0.1627997630305662,0.17137379989609006,126593.58859592007,-1050.8273654513978,125542.76123046866,1021,0,245.10638297872342,39,8,18,40.11500276023876,0.5803952991452992,48.41145833333333,1006.3541666666661,25.803952991452977,0
1050,4,2,0,47,0.0425531914893617,0.0,1.0,47,1550,1200,350,0.7741935483870968,19,12,7,325.91262838808603,0.4511062288004934,0.16437726775017714,0.17016829016469615,126784.78109095112,-1135.847751008002,125648.93333994312,1022,0,245.9787234042553,40,7,20,40.015766902119076,0.5807291666666667,48.22154471544715,1007.113821138211,25.177845528455276,0
1051,4,3,1,49,0.06,0.02,0.98,50,1500,1100,400,0.7333333333333333,19,11,8,304.2968628689015,0.456828231292517,0.1730773008545332,0.16177787785212938,127517.50996984403,-2238.620746067515,125278.88922377651,1023,0,232.16,41,9,16,39.811392954195725,0.5866361788617886,47.49503968253966,1010.0198412698381,24.6346302748741,0
1052,4,1,5,45,0.02,0.1,0.9,50,1250,900,350,0.72,16,9,7,305.74432807905384,0.4577210884353742,0.18781866352664123,0.16356117834402284,127768.13394628672,-2187.1235473356155,125581.0103989511,1024,0,233.14,41,9,17,39.519244921989994,0.5891768292682926,47.2470238095238,1011.0119047619037,24.658826945412287,0
1053,4,5,5,45,0.1,0.1,0.9,50,650,300,350,0.46153846153846156,10,3,7,302.3148461945005,0.46022959183673473,0.20095926148906296,0.16356513339708978,128221.7151249256,-2246.7807757831993,125974.9343491424,1025,0,230.84,40,10,19,39.14413171449595,0.5953125,46.798780487804876,1012.8048780487802,25.320121951219505,0
1054,4,0,1,44,0.0,0.022222222222222223,0.9777777777777777,45,1300,800,500,0.6153846153846154,18,8,10,337.96023486421296,0.45321969696969694,0.20619982158786798,0.17955138544207763,127489.75326678067,-382.70660863562114,127107.04665814505,1026,1,257.1333333333333,36,9,19,38.9897877639013,0.5949074074074074,47.52252252252254,1009.9099099099129,28.053053053053137,0
1055,4,0,1,43,0.0,0.022727272727272728,0.9772727272727273,44,1200,700,500,0.5833333333333334,17,7,10,342.22591136042666,0.453400281888654,0.2043371385717856,0.18213096063132964,127559.26354595345,-69.18295610424047,127490.08058984921,1027,2,262.79545454545456,35,9,20,38.810915062633676,0.5976190476190476,47.45370370370371,1010.1851851851859,28.862433862433882,0
1056,4,4,0,47,0.0851063829787234,0.0,1.0,47,950,700,250,0.7368421052631579,12,7,5,327.2881067293456,0.45771662041319766,0.25968507145559827,0.17988541805951277,128848.62075617303,-965.8757716049194,127882.74498456811,1028,0,243.59574468085106,38,9,18,37.873347013223885,0.6049890350877193,46.180555555555564,1015.2777777777793,26.717836257309983,0
1057,4,2,3,46,0.04081632653061224,0.061224489795918366,0.9387755102040817,49,1700,1200,500,0.7058823529411765,22,12,10,322.76931430899316,0.46129180839002265,0.2673679368856805,0.1741861899800779,128119.42087309448,-1505.2838207042182,126614.13705239026,1029,0,234.6122448979592,41,8,16,38.730503837987925,0.5927337398373984,46.89980158730158,1012.4007936507926,24.692702284165673,8
1058,4,1,0,47,0.02127659574468085,0.0,1.0,47,1550,1100,450,0.7096774193548387,20,11,9,331.08096665481196,0.4586995066296639,0.27037912617108817,0.1787837219935986,128144.53125000015,-914.7569444444308,127229.77430555571,1030,0,243.51063829787233,39,8,18,38.494513031550085,0.5961538461538461,46.87500000000001,1012.5000000000011,25.961538461538492,0
1059,4,3,3,47,0.06,0.06,0.94,50,1100,500,600,0.45454545454545453,17,5,12,315.63046462483123,0.46185374149659864,0.2644563245823388,0.17319167715794187,128783.04268260636,-1870.4296804578862,126912.61300214847,1031,0,229.84,42,8,15,38.23587907716788,0.5979662698412698,46.2451550387597,1015.0193798449624,24.167128091546722,0
1060,4,1,1,47,0.020833333333333332,0.020833333333333332,0.9791666666666666,48,1400,900,500,0.6428571428571429,19,9,10,328.32280788955325,0.46054964539007087,0.27102122791194816,0.17913249316182925,128556.44710696371,-1158.3972627073526,127398.04984425635,1032,0,240.375,40,8,16,38.14447840464977,0.5986979166666666,46.468495934959364,1014.1260162601648,25.35315040650412,0
1061,4,0,0,47,0.0,0.0,1.0,47,1400,900,500,0.6428571428571429,19,9,10,338.8776669902042,0.4583911501695961,0.27613905283422047,0.18506179716677626,128593.1654188369,-684.5296223958242,127908.63579644107,1033,1,246.25531914893617,39,8,16,37.83944832426141,0.6006944444444444,46.43229166666667,1014.2708333333342,26.006944444444464,0
1062,4,2,1,48,0.04081632653061224,0.02040816326530612,0.9795918367346939,49,1350,1000,350,0.7407407407407407,17,10,7,329.5327677756889,0.4589356575963719,0.2863118309982591,0.18250771560160584,129150.96391565882,-1288.1050799949635,127862.85883566386,1034,0,237.16326530612244,41,8,19,37.5089465807795,0.603150406504065,45.882936507936506,1016.4682539682537,24.791908633372042,0
1063,4,2,2,48,0.04,0.04,0.96,50,1250,800,450,0.64,17,8,9,316.2247931224811,0.4592517006802721,0.27886461139379404,0.17756420736507705,129692.62390318252,-1797.5658416417132,127895.05806154081,1035,0,229.1,40,10,15,37.29796468123317,0.61015625,45.350609756097555,1018.5975609756089,25.464939024390222,0
1064,4,0,0,48,0.0,0.0,1.0,48,1700,1000,700,0.5882352941176471,24,10,14,326.95625631643304,0.4576776743498818,0.2893076398362888,0.1829457525801109,129554.6392746913,-1128.260030864206,128426.3792438271,1036,2,239.64583333333334,38,10,17,37.16462028194632,0.6121162280701755,45.48611111111111,1018.0555555555552,26.79093567251461,0
1065,4,1,0,49,0.02040816326530612,0.0,1.0,49,850,500,350,0.5882352941176471,12,5,7,319.8683715463894,0.4587230725623583,0.2860103886246439,0.18064349407527464,129917.22140841992,-1488.7179904514148,128428.5034179685,1037,0,235.73469387755102,39,10,18,36.977729811654925,0.6140491452991452,45.13020833333332,1019.4791666666649,26.14049145299141,0
1066,4,2,3,48,0.0392156862745098,0.058823529411764705,0.9411764705882353,51,1300,800,500,0.6153846153846154,18,8,10,314.2403619568294,0.4588235294117647,0.2869217589948603,0.1802157977814775,130515.89269967214,-1997.3277273872854,128518.56497228486,1038,0,227.45098039215685,41,10,14,36.51618122977346,0.6168699186991871,44.54365079365078,1021.8253968253943,24.92257065427791,0
1067,4,1,3,46,0.02040816326530612,0.061224489795918366,0.9387755102040817,49,1050,700,350,0.6666666666666666,14,7,7,307.0351482293646,0.4559594671201814,0.22401363024247312,0.16945621963644786,129013.18587105606,-1877.6834705075578,127135.5024005485,1039,0,237.57142857142858,44,5,17,38.2203943371005,0.5975378787878788,46.01851851851851,1015.9259259259245,23.089225589225556,8
1068,4,3,1,48,0.061224489795918366,0.02040816326530612,0.9795918367346939,49,1400,1000,400,0.7142857142857143,18,10,8,308.1236071340597,0.45546343537414963,0.26070578943271405,0.1722319632388979,129514.47289837291,-1818.5695126861378,127695.90338568678,1040,0,238.0408163265306,43,6,14,37.68461019629732,0.6039244186046512,45.52556818181818,1017.8977272727271,23.67204016913319,0
1069,4,0,0,48,0.0,0.0,1.0,48,1750,1200,550,0.6857142857142857,23,12,11,313.6532156420463,0.4533928043735225,0.2630260401789961,0.17513555150921917,129472.4449871552,-1478.1102585481663,127994.33472860703,1041,1,244.0,42,6,14,37.586483227014504,0.6049107142857143,45.56686046511628,1017.7325581395348,24.231727574750828,0
1070,4,0,2,46,0.0,0.041666666666666664,0.9583333333333334,48,1150,600,550,0.5217391304347826,17,6,11,318.63747580442106,0.4529587765957446,0.2728474799378309,0.17858993243886187,129620.41348363976,-1339.6157269695389,128280.79775667022,1042,2,245.0,42,6,14,37.309686935008074,0.6063988095238095,45.42151162790697,1018.3139534883717,24.245570321151707,0
1071,4,1,1,46,0.02127659574468085,0.02127659574468085,0.9787234042553191,47,1850,1300,550,0.7027027027027027,24,13,11,326.0670254142475,0.4512218624730188,0.28718745146762004,0.1839834533844802,129883.08930342935,-929.8814838435715,128953.20781958579,1043,0,250.61702127659575,41,6,19,36.854318734793196,0.6105182926829269,45.16369047619046,1019.3452380952352,24.862078977932565,0
1072,4,0,2,44,0.0,0.043478260869565216,0.9565217391304348,46,1300,900,400,0.6923076923076923,17,9,8,323.93591834833705,0.45028180354267305,0.2631341901269977,0.18349229622805768,130034.82187145665,-775.4101119614722,129259.41175949517,1044,1,243.2391304347826,41,5,19,36.75499708199594,0.6120426829268293,45.01488095238094,1019.940476190474,24.876596980255464,0
1073,4,1,0,45,0.022222222222222223,0.0,1.0,45,1300,800,500,0.6153846153846154,18,8,10,328.12886334903396,0.44802188552188554,0.26785463284136934,0.18721298710985063,130315.76063368068,-447.5289204223302,129868.23171325834,1045,0,226.88888888888889,39,6,20,36.36375229544988,0.6180555555555556,44.739583333333336,1021.0416666666677,26.180555555555582,0
1074,4,0,1,44,0.0,0.022222222222222223,0.9777777777777777,45,1550,1300,250,0.8387096774193549,18,13,5,326.3479260926743,0.4471380471380471,0.2672855469354376,0.18706397086292742,130496.1136311058,-482.572790666933,130013.54084043887,1046,1,227.88888888888889,40,5,14,36.22687487567138,0.6182291666666666,44.5630081300813,1021.7479674796747,25.543699186991866,0
1075,4,0,0,44,0.0,0.0,1.0,44,1000,800,200,0.8,12,8,4,331.1428107218685,0.445725422832981,0.2760931607379469,0.19010193774091605,130555.17713758699,-153.51833767359176,130401.65879991339,1047,2,233.4090909090909,39,5,15,36.04468198960351,0.6204594017094017,44.50520833333334,1021.9791666666681,26.204594017094053,0
1076,4,0,0,44,0.0,0.0,1.0,44,1150,800,350,0.6956521739130435,15,8,7,329.0189038794925,0.44525193798449614,0.27618567010500206,0.18979480600992113,130741.54188368063,-196.71223958332382,130544.8296440973,1048,3,234.4090909090909,39,5,16,35.91065729612278,0.6223290598290598,44.32291666666667,1022.708333333334,26.223290598290617,0
1077,4,0,1,43,0.0,0.022727272727272728,0.9772727272727273,44,1450,1200,250,0.8275862068965517,17,12,5,367.1157278011753,0.44497665609584214,0.3028317593363379,0.20150008837891187,128794.39153928333,684.7120135807027,129479.10355286404,1049,4,235.4090909090909,38,6,14,36.91782443953269,0.6044407894736843,46.23397435897436,1015.0641025641023,26.712213225371112,8
1078,4,0,0,43,0.0,0.0,1.0,43,1200,700,500,0.5833333333333334,17,7,10,373.615438779942,0.44264488741232927,0.31240150900148067,0.20443900975936138,128672.41753472216,1014.8003472222184,129687.21788194438,1050,5,241.67441860465115,37,6,14,36.87756673511295,0.6050112612612613,46.354166666666664,1014.5833333333328,27.421171171171157,0
1079,4,3,0,46,0.06521739130434782,0.0,1.0,46,1650,1200,450,0.7272727272727273,21,12,9,351.94465362596287,0.4471417069243156,0.30422986008787367,0.1960891860789949,129386.78521050354,-91.51746961804525,129295.2677408855,1051,0,226.84782608695653,39,7,17,36.699366062591736,0.6087072649572649,45.65104166666667,1017.3958333333339,26.087072649572665,0
1080,4,0,4,42,0.0,0.08695652173913043,0.9130434782608696,46,1150,800,350,0.6956521739130435,15,8,7,348.7330133285632,0.44691022544283415,0.2977064260994118,0.19521858374990725,129572.31445312516,-162.77126736109508,129409.54318576407,1052,1,227.84782608695653,39,7,13,36.5924050201214,0.6105769230769231,45.46875000000001,1018.1250000000013,26.105769230769262,0
1081,4,0,0,42,0.0,0.0,1.0,42,1500,900,600,0.6,21,9,12,370.7412650231355,0.44192799070847855,0.314103172844586,0.2052951323987011,129144.15048494468,1175.813144225337,130319.96362917002,1053,8,249.57142857142858,36,6,15,36.468719994091146,0.6116898148148149,45.889639639639654,1016.4414414414437,28.234484484484547,0
1082,4,1,0,43,0.023255813953488372,0.0,1.0,43,1150,700,450,0.6086956521739131,16,7,9,362.2403419949729,0.4426910299003322,0.3143920589150715,0.2027873022895699,129573.7476285409,787.3804125071298,130361.12804104804,1054,0,244.74418604651163,36,7,16,36.24714264646242,0.6160300925925926,45.467342342342356,1018.1306306306324,28.281406406406454,0
1083,4,0,0,43,0.0,0.0,1.0,43,800,600,200,0.75,10,6,4,361.08692677712173,0.4425987449243263,0.3143276696095394,0.20243701666742206,129631.08114448938,761.6177410518952,130392.69888554128,1055,1,245.74418604651163,36,7,16,36.218161377124105,0.6166087962962963,45.41103603603605,1018.3558558558582,28.287662662662726,0
1084,4,0,1,42,0.0,0.023255813953488372,0.9767441860465116,43,1050,400,650,0.38095238095238093,17,4,13,356.3729956588729,0.4418835363602805,0.30741471840108536,0.2005262975573064,129774.47041636253,649.6233564645948,130424.09377282712,1056,2,246.74418604651163,36,7,16,36.19239058355438,0.6180555555555556,45.27027027027028,1018.9189189189207,28.303303303303352,0
1085,4,0,0,42,0.0,0.0,1.0,42,1800,1400,400,0.7777777777777778,22,14,8,357.45451868508894,0.4417949090205188,0.3028060097216083,0.20172557999609908,129889.23890106339,885.8990747504436,130775.13797581384,1057,3,249.85714285714286,36,6,16,36.048202975401374,0.619212962962963,45.157657657657666,1019.3693693693707,28.315815815815853,0
1086,4,1,0,43,0.023255813953488372,0.0,1.0,43,1350,1100,250,0.8148148148148148,16,11,5,348.57219886703894,0.44252953119232186,0.309856179164844,0.18980556835834117,128477.80687326829,357.2941271078946,128835.10100037618,1058,0,245.02325581395348,37,6,19,37.7113526570048,0.6030405405405406,46.546052631578924,1013.8157894736809,27.400426742531916,7
1087,4,0,0,43,0.0,0.0,1.0,43,950,800,150,0.8421052631578947,11,8,3,346.55228634039486,0.44252953119232186,0.3063431803896923,0.18923309614218686,128588.99493113231,312.5620383194435,128901.55696945176,1059,1,246.02325581395348,37,6,19,37.649099099099104,0.6041666666666667,46.43640350877191,1014.2543859649095,27.41228070175431,0
1088,4,1,0,44,0.022727272727272728,0.0,1.0,44,1400,1000,400,0.7142857142857143,18,10,8,337.91330251043905,0.4442829457364341,0.3017793628332137,0.18636193041004898,128984.24373584581,-82.90164548182184,128901.34209036399,1060,0,241.4090909090909,38,6,20,37.465599144580025,0.606359649122807,46.047008547008524,1015.8119658119618,26.73189383715689,0
1089,4,1,1,44,0.022222222222222223,0.022222222222222223,0.9777777777777777,45,1000,600,400,0.6,14,6,8,332.2979291114394,0.4474537037037037,0.3027057792348238,0.18439795827497174,129227.86593966983,-411.5695529514236,128816.29638671842,1061,0,237.0222222222222,39,6,21,37.36052060922719,0.6071047008547008,45.80729166666665,1016.7708333333309,26.071047008546945,0
1090,4,0,0,44,0.0,0.0,1.0,44,1250,1000,250,0.8,15,10,5,330.4713327659082,0.44681553911205074,0.2909225844275498,0.18437318388293256,129439.78000216976,-244.77267795142734,129195.00732421833,1041,1,219.29545454545453,39,5,16,37.19173320367148,0.6092414529914529,45.598958333333314,1017.6041666666637,26.092414529914453,0
1091,4,1,2,43,0.022222222222222223,0.044444444444444446,0.9555555555555556,45,1650,1300,350,0.7878787878787878,20,13,7,321.4838713689598,0.44724326599326597,0.2841474092546423,0.1807557941937081,129744.38707325308,-657.854431059575,129086.5326421935,1042,0,215.4,40,5,18,37.11159600997508,0.6106770833333333,45.29979674796747,1018.8008130081279,25.470020325203198,0
1092,4,0,0,43,0.0,0.0,1.0,43,1350,1100,250,0.8148148148148148,16,11,5,332.4284782552917,0.4441675895164267,0.2818806684674011,0.18626548067320284,129609.0282914199,17.146408612737815,129626.17470003264,1043,1,224.93023255813952,38,5,19,36.97015003672229,0.6126644736842105,45.4326923076923,1018.269230769229,26.796558704453396,0
1093,4,1,1,43,0.022727272727272728,0.022727272727272728,0.9772727272727273,44,1400,900,500,0.6428571428571429,19,9,10,328.8885382902265,0.44342406624383374,0.2807690164132379,0.18573757208577316,129917.22140842021,-254.34299045138553,129662.87841796882,1044,0,220.79545454545453,39,5,20,36.747833009774865,0.6140491452991452,45.130208333333336,1019.4791666666673,26.14049145299147,0
1094,4,0,0,43,0.0,0.0,1.0,43,400,0,400,0.0,8,0,8,335.73190326449276,0.4410068290882245,0.2856689948493838,0.18877001353362044,129745.0507706918,111.91056687852006,129856.96133757032,1045,1,226.8139534883721,38,5,20,36.74802502796423,0.6140350877192983,45.2991452991453,1018.8034188034188,26.810616284300494,0
1095,4,1,0,44,0.022727272727272728,0.0,1.0,44,900,600,300,0.6666666666666666,12,6,6,338.81954956412324,0.4422899048625793,0.31094166117642663,0.19265322850143463,130182.84640842026,21.698676215287946,130204.54508463554,1046,0,222.63636363636363,39,5,21,36.22548143989656,0.6167200854700854,44.86979166666667,1020.5208333333343,26.16720085470088,0
1096,4,0,0,44,0.0,0.0,1.0,44,1350,1000,350,0.7407407407407407,17,10,7,341.56127112339203,0.44157417195207893,0.3105962980318644,0.19489084293511222,130318.55955678686,102.40339876213443,130420.962955549,1047,1,223.63636363636363,37,7,21,36.0180412371134,0.6216216216216216,44.736842105263165,1021.0526315789486,27.596017069701315,0
1097,4,0,0,44,0.0,0.0,1.0,44,1650,1300,350,0.7878787878787878,20,13,7,340.48596898034776,0.44126585623678644,0.3127911619858912,0.19495370271796925,130453.51765103372,83.51847286143186,130537.03612389514,1048,2,224.63636363636363,38,6,21,35.90884926444957,0.6211622807017544,44.60470085470086,1021.581196581197,26.883715699505185,0
1098,4,0,0,44,0.0,0.0,1.0,44,950,700,250,0.7368421052631579,12,7,5,344.8359916978136,0.44138698026779427,0.31565234326755887,0.19842066172918715,130644.58832137135,210.19123475054937,130854.7795561219,1049,3,225.63636363636363,38,6,19,35.604338663043855,0.6230811403508771,44.41773504273505,1022.3290598290613,26.903396311291086,0
1099,4,0,0,44,0.0,0.0,1.0,44,1300,700,600,0.5384615384615384,19,7,12,343.282742192202,0.44094652924594785,0.3036879291188279,0.19808593676949696,130753.83434007251,177.10696088101656,130930.94130095353,1050,4,226.63636363636363,38,6,19,35.53353180821058,0.6241776315789473,44.310897435897445,1022.7564102564119,26.914642375168732,0
1100,4,1,0,45,0.022222222222222223,0.0,1.0,45,950,700,250,0.7368421052631579,12,7,5,338.2410260717136,0.4422138047138047,0.30244652466874644,0.19646765982463396,131008.00781250028,-137.54340277774946,130870.46440972252,1051,0,222.57777777777778,39,6,20,35.40564373897708,0.625,44.062500000000014,1023.7500000000022,26.250000000000057,0
1101,4,0,0,45,0.0,0.0,1.0,45,1050,900,150,0.8571428571428571,12,9,3,337.32514651718395,0.441729797979798,0.3010883938561695,0.19634360659623673,131088.00048828137,-156.14420572915247,130931.85628255221,1052,1,223.57777777777778,39,6,21,35.34832417861866,0.625801282051282,43.98437500000001,1024.062500000001,26.258012820512842,0
1102,4,0,2,43,0.0,0.044444444444444446,0.9555555555555556,45,1550,1200,350,0.7741935483870968,19,12,7,377.8971708696039,0.4415824915824916,0.34112767826367363,0.2080620621763058,128917.41569378339,831.8408367724984,129749.25653055588,1053,2,224.57777777777778,40,5,17,36.51847960238834,0.60234375,46.11280487804878,1015.5487804878044,25.38871951219511,8
1103,4,1,0,44,0.022727272727272728,0.0,1.0,44,1200,500,700,0.4166666666666667,19,5,14,378.61801981778365,0.4418934989429175,0.34916446190073613,0.20927593035699363,129072.27143441391,973.8175647762438,130046.08899919015,1054,0,228.04545454545453,40,4,18,36.34196753008632,0.60390625,45.96036585365853,1016.1585365853648,25.40396341463412,0
1104,4,2,1,45,0.043478260869565216,0.021739130434782608,0.9782608695652174,46,1300,900,400,0.6923076923076923,17,9,8,361.4918826845194,0.4454609500805153,0.33778976145002404,0.20274979507088248,129647.6800554015,173.63953500585316,129821.31959040737,1055,0,219.08695652173913,37,9,18,36.19096325007176,0.6148648648648649,45.39473684210525,1018.4210526315777,27.524893314366967,0
1105,4,1,0,46,0.021739130434782608,0.0,1.0,46,1250,900,350,0.72,16,9,7,357.2258419777766,0.4451590177133655,0.3366536473559887,0.2013592602294379,129843.17440221984,76.66746018004861,129919.84186239989,1056,0,220.06521739130434,37,9,19,36.1008382642998,0.6168355855855856,45.20285087719298,1019.1885964912275,27.545637743006147,0
1106,4,0,1,45,0.0,0.021739130434782608,0.9782608695652174,46,1200,700,500,0.5833333333333334,17,7,10,359.7958358509768,0.444585346215781,0.3414369006485032,0.20338853967040935,129954.9515836604,151.45008560326391,130106.40166926367,1057,1,221.06521739130434,37,9,19,35.92176130049826,0.6179617117117118,45.093201754385966,1019.6271929824564,27.557491702228553,0
1107,4,0,0,45,0.0,0.0,1.0,45,1250,900,350,0.72,16,9,7,364.7610611615394,0.4438762626262626,0.34246393517063134,0.20609323899731033,129935.60209155164,479.0896203155844,130414.69171186723,1058,2,219.62222222222223,38,7,19,35.81486429843866,0.615953947368421,45.11217948717949,1019.5512820512823,26.830296896086377,0
1108,4,0,2,43,0.0,0.044444444444444446,0.9555555555555556,45,1350,1100,250,0.8148148148148148,16,11,5,335.267369669006,0.44297138047138046,0.09657288160021449,0.19257800536655567,130576.95316983756,-98.9752097740793,130477.97796006348,1059,3,220.62222222222223,43,2,14,35.917280490441335,0.6145833333333333,44.483901515151516,1022.0643939393938,23.76893939393939,8
1109,4,0,1,42,0.0,0.023255813953488372,0.9767441860465116,43,1350,900,450,0.6666666666666666,18,9,9,341.30923455838683,0.43934569952011815,0.10989963565439997,0.19599597181831102,130566.58340419491,312.7161281179019,130879.29953231281,1060,6,231.72093023255815,41,2,14,35.773393515822164,0.6173780487804879,44.49404761904761,1022.0238095238087,24.927409988385577,0
1110,4,0,1,41,0.0,0.023809523809523808,0.9761904761904762,42,1650,1300,350,0.7878787878787878,20,13,7,350.34735734067664,0.4382742934572203,0.11441687145177282,0.20122463579527014,130574.00238160134,749.2513343578368,131323.25371595917,1061,7,237.85714285714286,40,2,14,35.53495078055087,0.6190104166666667,44.48678861788617,1022.0528455284535,25.55132113821134,0
1111,4,0,0,41,0.0,0.0,1.0,41,1400,1100,300,0.7857142857142857,17,11,6,353.9822521776814,0.4367378048780488,0.13348146933013205,0.2034931365330746,130608.41064453099,1046.611870659693,131655.02251519068,1062,8,244.41463414634146,39,2,14,35.40721916505316,0.6209935897435898,44.453124999999986,1022.187499999998,26.209935897435845,0
1112,4,1,0,42,0.023809523809523808,0.0,1.0,42,1100,900,200,0.8181818181818182,13,9,4,348.94153998912395,0.43740321331784743,0.13946456350388448,0.20231377370353848,130937.79047070183,737.9268499239761,131675.71732062582,1063,0,239.57142857142858,40,2,15,35.2027686757356,0.62265625,44.131097560975604,1023.4756097560966,25.586890243902413,0
1113,4,0,0,42,0.0,0.0,1.0,42,1050,700,350,0.6666666666666666,14,7,7,348.7636276314737,0.436955574912892,0.1309393831974477,0.20275785045511235,131041.82287535531,740.5243034899904,131782.34717884532,1064,1,240.57142857142858,40,2,15,35.1021505376344,0.6236979166666667,44.02947154471545,1023.8821138211384,25.59705284552846,0
1114,4,0,0,42,0.0,0.0,1.0,42,1600,1200,400,0.75,20,12,8,332.14281565239304,0.435866724738676,0.09698858040041713,0.18493196907989007,129360.29188368065,239.89243934455845,129600.18432302521,1065,2,241.57142857142858,39,3,19,37.22993037067377,0.608440170940171,45.677083333333336,1017.2916666666674,26.084401709401728,8
1115,4,0,1,41,0.0,0.023809523809523808,0.9761904761904762,42,850,500,350,0.5882352941176471,12,5,7,331.8194227285137,0.435515873015873,0.0964665964665965,0.18500069185000692,129413.28125,188.36805555555543,129601.64930555556,1066,3,242.57142857142858,39,3,19,37.18434343434343,0.608974358974359,45.625,1017.5,26.08974358974359,0
1116,4,1,0,42,0.023809523809523808,0.0,1.0,42,1450,900,550,0.6206896551724138,20,9,11,330.8366893748353,0.43655632984901277,0.10911481156879943,0.18595303575206262,129731.4453125,183.98437500000003,129915.4296875,1067,0,243.47619047619048,39,3,17,36.886503067484654,0.6121794871794872,45.3125,1018.75,26.121794871794872,0
1117,4,0,0,42,0.0,0.0,1.0,42,1150,800,350,0.6956521739130435,15,8,7,330.1480624909615,0.4357699380565234,0.10462999469439227,0.18594349426304407,129811.04736328125,171.37315538194454,129982.42051866319,1068,1,244.47619047619048,39,3,17,36.82333725169511,0.6129807692307692,45.234375,1019.0625,26.129807692307693,0
1118,4,0,0,42,0.0,0.0,1.0,42,800,500,300,0.625,11,5,6,329.0101348573169,0.4356368563685637,0.10086438500175188,0.18542829259469992,129837.58680555562,143.57638888889394,129981.16319444451,1069,2,245.47619047619048,39,3,17,36.82542927228127,0.6132478632478633,45.208333333333336,1019.1666666666672,26.132478632478644,0
1119,4,1,1,42,0.023255813953488372,0.023255813953488372,0.9767441860465116,43,1000,600,400,0.6,14,6,8,327.6967930029154,0.43646179401993357,0.12662553393450393,0.1867109634551496,130262.58680555563,-62.67361111110074,130199.91319444454,1070,0,240.74418604651163,40,3,18,36.42857142857144,0.6158854166666667,44.79166666666667,1020.833333333334,25.52083333333335,0
1120,4,0,0,42,0.0,0.0,1.0,42,1050,700,350,0.6666666666666666,14,7,7,330.19104268218405,0.43619337979094075,0.13917545802490627,0.18864760970024147,130368.94531250048,209.33159722226742,130578.27690972274,1071,1,245.78571428571428,39,3,18,36.25730994152046,0.6185897435897436,44.68750000000002,1021.2500000000039,26.185897435897534,0
1121,4,0,0,42,0.0,0.0,1.0,42,1400,800,600,0.5714285714285714,20,8,12,317.4241186984778,0.43544328300425866,0.15373850273605827,0.17347202638652745,128622.09590143898,-234.44891266694674,128387.64698877203,1072,2,246.78571428571428,41,1,13,38.354013854930734,0.5978150406504066,46.40376984126983,1014.3849206349182,24.741095625241908,8
1122,4,0,0,42,0.0,0.0,1.0,42,800,700,100,0.875,9,7,2,315.0886062191751,0.434971447928765,0.15710468369574926,0.17263210246469912,128722.74900990442,-288.1856851537319,128434.56332475069,1073,3,247.78571428571428,41,1,13,38.31090934271843,0.5988313008130082,46.30456349206347,1014.7817460317423,24.750774293457127,0
1123,4,2,0,44,0.045454545454545456,0.0,1.0,44,1100,700,400,0.6363636363636364,15,7,8,299.866809319695,0.4405501233262861,0.16236148774507742,0.166393571136518,129226.01861554278,-1048.9929918839603,128177.02562365882,1074,0,237.47727272727272,42,2,15,38.186767368722016,0.6024305555555556,45.80910852713178,1016.7635658914716,24.208656330749324,0
1124,4,1,2,43,0.022222222222222223,0.044444444444444446,0.9555555555555556,45,1400,1000,400,0.7142857142857143,18,10,8,291.49061968537393,0.440719696969697,0.15499338624338588,0.16323474702380955,129586.77685950427,-1445.334022038556,128141.44283746571,1075,0,233.17777777777778,43,2,12,38.03478422619047,0.6046511627906976,45.45454545454546,1018.1818181818194,23.678646934460915,0
1125,4,0,1,42,0.0,0.023255813953488372,0.9767441860465116,43,1350,1000,350,0.7407407407407407,17,10,7,304.4902705105846,0.43807678110003695,0.15321637426900625,0.17015632763826788,129504.14540816334,-713.4495464852491,128790.69586167809,1076,2,244.53488372093022,41,2,14,37.78752436647176,0.6067073170731707,45.53571428571429,1017.8571428571435,24.82578397212545,0
1126,4,0,0,42,0.0,0.0,1.0,42,750,500,250,0.6666666666666666,10,5,5,311.6533815834514,0.43442702284165696,0.15484039769754077,0.17350669352894066,129356.4150389982,-337.1271647167425,129019.28787428145,1077,3,251.3095238095238,40,2,17,37.754953379953406,0.6067708333333333,45.6808943089431,1017.2764227642296,25.43191056910574,0
1127,4,0,1,41,0.0,0.023809523809523808,0.9761904761904762,42,1300,1000,300,0.7692307692307693,16,10,6,312.91166096586505,0.433701122725513,0.16202125383353527,0.17478027242460362,129485.6745013717,-296.48450409807396,129189.18999727363,1078,4,252.3095238095238,40,2,14,37.591945415210525,0.6080729166666667,45.553861788617894,1017.7845528455298,25.444613821138244,0
1128,4,2,2,41,0.046511627906976744,0.046511627906976744,0.9534883720930233,43,1600,1000,600,0.625,22,10,12,306.8348368140575,0.4364156515319306,0.14869050722684451,0.17382903618432555,130040.11646685893,-619.8324169220648,129420.28404993688,1079,0,222.97674418604652,42,1,17,37.185698904300466,0.6106150793650793,45.00968992248062,1019.9612403100773,24.284791435954222,0
1129,4,0,0,41,0.0,0.0,1.0,41,1100,900,200,0.8181818181818182,13,9,4,312.5444991051485,0.4348323170731707,0.12899448249388357,0.17736767815243548,130107.01844346938,-67.15341810431559,130039.86502536507,1080,1,210.97560975609755,40,1,18,36.97247401799647,0.6143229166666666,44.944105691056905,1020.2235772357715,25.505589430894286,0
1130,4,0,0,41,0.0,0.0,1.0,41,950,500,450,0.5263157894736842,14,5,9,312.32793587387056,0.4345274390243902,0.1301023506152208,0.17759893159940027,130184.79100568446,-67.93058860466766,130116.86041707979,1081,2,211.97560975609755,40,1,18,36.89939753037242,0.6151041666666667,44.86788617886179,1020.5284552845529,25.513211382113823,0
1131,4,1,0,42,0.023809523809523808,0.0,1.0,42,1050,800,250,0.7619047619047619,13,8,5,313.12679558580146,0.4352497096399535,0.16062551487089172,0.1799673891429706,130599.97046235677,-221.10671144824164,130378.86375090852,1082,0,207.9047619047619,40,2,12,36.45978325710877,0.6192708333333333,44.461382113821124,1022.154471544713,25.553861788617827,0
1132,4,0,0,42,0.0,0.0,1.0,42,1500,1100,400,0.7333333333333333,19,11,8,312.28815974851994,0.434245547812621,0.15127622832540855,0.18033163097354288,130781.8193225758,-231.67726303787754,130550.14205953792,1083,1,208.9047619047619,40,2,13,36.29781420765029,0.62109375,44.28353658536585,1022.8658536585363,25.571646341463406,0
1133,4,0,0,42,0.0,0.0,1.0,42,900,600,300,0.6666666666666666,12,6,6,314.79947836550565,0.4333260743321719,0.15343678927235693,0.18251845403678776,130937.79047070185,-156.1703722982453,130781.6200984036,1084,2,209.9047619047619,40,2,15,36.07635785919968,0.62265625,44.131097560975604,1023.4756097560967,25.586890243902417,0
1134,4,0,2,40,0.0,0.047619047619047616,0.9523809523809523,42,1050,700,350,0.6666666666666666,14,7,7,315.2041644131965,0.4329631242740999,0.15329457364341148,0.18315917661847878,131023.24263038528,-140.1856575963925,130883.0569727889,1085,3,210.9047619047619,41,1,15,35.97989341085271,0.6219512195121951,44.04761904761904,1023.8095238095221,24.9709639953542,0
1135,4,0,0,40,0.0,0.0,1.0,40,1450,1200,250,0.8275862068965517,17,12,5,325.26804205928704,0.4301816239316239,0.15340920664018753,0.18776054702999065,130768.17626953126,506.941731770834,131275.1180013021,1086,4,222.15,39,1,15,35.979669518280865,0.6225961538461539,44.296875,1022.8125000000001,26.22596153846154,0
1136,4,0,0,40,0.0,0.0,1.0,40,1250,900,350,0.72,16,9,7,322.32437479442734,0.43026175213675216,0.14853420195439737,0.18670487370167801,130901.38888888911,438.54166666669244,131339.9305555558,1087,5,223.15,39,1,16,35.92053474484255,0.6239316239316239,44.16666666666668,1023.3333333333351,26.239316239316285,0
1137,4,1,0,41,0.024390243902439025,0.0,1.0,41,1050,400,650,0.38095238095238093,17,4,13,317.64835572857777,0.43282520325203255,0.15039642311907708,0.18542056016790934,131197.94894118918,134.96255122613405,131332.91149241533,1088,0,218.6829268292683,40,1,17,35.741328571900944,0.6252604166666667,43.87703252032521,1024.4918699186999,25.6122967479675,0
1138,4,0,0,41,0.0,0.0,1.0,41,1300,800,500,0.6153846153846154,18,8,10,317.4955368214991,0.43224085365853654,0.15813874747572476,0.18583531566133624,131302.08462431442,137.56516871573766,131439.64979303017,1089,1,219.6829268292683,40,1,19,35.64039001817882,0.6263020833333333,43.77540650406505,1024.8983739837415,25.622459349593537,0
1139,4,0,1,40,0.0,0.024390243902439025,0.975609756097561,41,1550,1400,150,0.9032258064516129,17,14,3,340.0640322469468,0.43191056910569103,0.15645796120955335,0.18673266966442656,128811.515322022,565.3924045795954,129376.9077266016,1090,2,220.6829268292683,37,4,17,37.58686181320659,0.6064189189189189,46.21710526315788,1015.1315789473671,27.43598862019911,8
1140,4,0,0,40,0.0,0.0,1.0,40,1000,800,200,0.8,12,8,4,345.5956784796309,0.4284321581196581,0.17284017278617703,0.19003657854640024,128867.17547706973,907.1877885503038,129774.36326562004,1091,9,227.15,37,3,17,37.38975881929444,0.6069819819819819,46.162280701754376,1015.3508771929813,27.441915599810308,0
1141,4,0,0,40,0.0,0.0,1.0,40,1050,600,450,0.5714285714285714,15,6,9,347.4496705355252,0.4282184829059829,0.17793609671847999,0.19159367546673234,128978.5318559556,962.7096799014976,129941.2415358571,1092,10,228.15,37,3,17,37.229238629821516,0.6081081081081081,46.05263157894736,1015.78947368421,27.4537695590327,0
1142,4,2,1,41,0.047619047619047616,0.023809523809523808,0.9761904761904762,42,1450,1000,450,0.6896551724137931,19,10,9,338.19560180232224,0.4308338172667441,0.1887403655472475,0.18975978057572312,129663.42872242302,370.5126285885873,130033.94135101161,1093,0,218.23809523809524,38,4,15,36.768112521416825,0.6132127192982456,45.3792735042735,1018.4829059829052,26.802181736392242,0
1143,4,0,0,41,0.0,0.0,1.0,41,1450,1100,350,0.7586206896551724,18,11,7,342.4747177071118,0.4295985772357724,0.19000898224279728,0.19189456404858773,129609.02829141993,677.5630752794041,130286.59136669934,1094,1,224.5609756097561,38,3,16,36.71440562375407,0.6126644736842105,45.4326923076923,1018.2692307692292,26.7965587044534,0
1144,4,1,1,41,0.023809523809523808,0.023809523809523808,0.9761904761904762,42,1350,1000,350,0.7407407407407407,17,10,7,334.73178586691756,0.4317411924119241,0.19071944266059537,0.1891659769090869,129943.77170138869,299.26215277775793,130243.03385416644,1095,0,220.1904761904762,39,3,17,36.5719929164964,0.6143162393162394,45.10416666666666,1019.5833333333317,26.14316239316235,0
1145,4,0,0,41,0.0,0.0,1.0,41,1700,1200,500,0.7058823529411765,22,12,10,341.6590256079827,0.42873475609756095,0.20444267296224194,0.19344466538871888,130017.30974687698,684.317472057847,130701.62721893484,1096,1,226.0487804878049,38,3,17,36.32084119002724,0.6167763157894737,45.03205128205128,1019.8717948717942,26.838731443994586,0
1146,4,0,0,41,0.0,0.0,1.0,41,1150,1000,150,0.8695652173913043,13,10,3,341.859918122598,0.42804878048780487,0.19768127935756308,0.19396437065672523,130099.04308431942,695.1296433267502,130794.17272764618,1097,2,227.0487804878049,38,3,18,36.23285160749819,0.6175986842105263,44.95192307692307,1020.1923076923068,26.847165991902813,0
1147,4,0,0,41,0.0,0.0,1.0,41,1150,700,450,0.6086956521739131,16,7,9,338.9485567130094,0.4275406504065041,0.19377360562423562,0.1925816576541315,130153.54624379048,623.0713300825323,130776.61757387301,1098,3,228.0487804878049,38,3,18,36.251875894321714,0.6181469298245614,44.898504273504265,1020.4059829059817,26.852789023841623,0
1148,4,1,0,42,0.023809523809523808,0.0,1.0,42,1100,500,600,0.45454545454545453,17,5,12,334.2818785490857,0.42912795199380566,0.20292982849177266,0.1918060088975409,130535.38795976709,327.1685979618757,130862.55655772897,1099,0,223.5952380952381,38,4,15,35.98449207178951,0.621984649122807,44.524572649572654,1021.9017094017104,26.89215024741343,0
1149,4,0,1,41,0.0,0.023809523809523808,0.9761904761904762,42,900,600,300,0.6666666666666666,12,6,6,337.31096408317586,0.4293578203639179,0.19791666666666652,0.19395380434782605,130617.28395061725,411.72839506172414,131029.01234567897,1100,1,224.5952380952381,38,4,15,35.82427536231884,0.6228070175438596,44.44444444444444,1022.222222222222,26.90058479532163,0
1150,4,1,0,42,0.023809523809523808,0.0,1.0,42,950,800,150,0.8421052631578947,11,8,3,334.62743552097055,0.4288859852884243,0.20131813819816324,0.19363909063349474,130863.12601587057,358.07845258968587,131221.20446846026,1101,0,223.64285714285714,38,4,16,35.64442588145209,0.6252741228070176,44.20405982905984,1023.183760683762,26.925888439046368,0
1151,4,0,0,42,0.0,0.0,1.0,42,800,500,300,0.625,11,5,6,331.4806257352683,0.4282326751838947,0.20078180525941747,0.19236316627314398,130972.46334876554,282.966820987667,131255.4301697532,1102,1,224.64285714285714,38,4,16,35.61454093170512,0.6263706140350878,44.09722222222223,1023.611111111112,26.937134502924,0
1152,4,0,0,42,0.0,0.0,1.0,42,1550,1200,350,0.7741935483870968,19,12,7,332.50408379681676,0.4278213317847464,0.1967583277442435,0.19350647499650814,131081.84633875746,317.0498438527382,131398.8961826102,1103,2,225.64285714285714,38,4,16,35.47796035472091,0.627467105263158,43.99038461538462,1024.0384615384621,26.948380566801635,0
1153,4,0,0,42,0.0,0.0,1.0,42,1500,1200,300,0.8,18,12,6,331.63900878472407,0.42773664343786294,0.19891271414167,0.1932780046941733,131136.55495516476,297.9994201548689,131434.55437531963,1104,3,226.64285714285714,38,4,16,35.44491672751295,0.628015350877193,43.93696581196581,1024.252136752137,26.954003598740446,0
1154,4,0,0,42,0.0,0.0,1.0,42,1750,1200,550,0.6857142857142857,23,12,11,354.7843963829228,0.4272406116918312,-0.0010988277581529537,0.1948291003556359,128814.23017259903,859.9487126578256,129674.17888525686,1105,4,227.64285714285714,40,2,14,37.210514899723044,0.6013020833333333,46.21443089430895,1015.1422764227646,25.378556910569113,8
1155,4,1,1,42,0.023255813953488372,0.023255813953488372,0.9767441860465116,43,1150,700,450,0.6086956521739131,16,7,9,350.04415043379953,0.42974806201550386,0.0012022549611343525,0.19424899006871527,129228.54487407762,448.88206466029936,129677.42693873792,1106,0,223.32558139534885,38,5,16,36.90873349444851,0.6088267543859649,45.806623931623925,1016.7735042735035,26.757197480881672,0
1156,4,1,1,42,0.023255813953488372,0.023255813953488372,0.9767441860465116,43,1050,900,150,0.8571428571428571,12,9,3,356.8760349980015,0.43242432631967515,0.01612383574483034,0.19954899421719224,129527.44904667977,645.0484878369459,130172.49753451672,1107,0,224.1860465116279,38,5,15,36.43078295549959,0.611842105263158,45.51282051282051,1017.9487179487176,26.788124156545198,0
1157,4,0,0,42,0.0,0.0,1.0,42,1300,900,400,0.6923076923076923,17,9,8,362.20101923933595,0.43188637243515293,0.003215285683517699,0.20285878556432294,129591.85157933211,987.6601454293664,130579.51172476148,1108,1,217.6904761904762,37,5,16,36.22971857276188,0.6143018018018018,45.449561403508774,1018.2017543859649,27.51896633475581,0
1158,4,0,2,40,0.0,0.047619047619047616,0.9523809523809523,42,1000,700,300,0.7,13,7,6,358.8013248731347,0.43229771583430116,0.001678204321376331,0.2014612385948449,129690.63321827743,906.6342044707419,130597.26742274818,1109,2,218.6904761904762,38,4,16,36.215780365009444,0.6134868421052632,45.3525641025641,1018.5897435897434,26.80499325236167,0
1159,4,0,0,40,0.0,0.0,1.0,40,1000,800,200,0.8,12,8,4,356.6332256122846,0.4316372863247863,-0.00025951557093417676,0.20066142021618652,129772.26382725194,1256.220208744262,131028.4840359962,1110,3,225.425,38,2,17,36.188004613610154,0.6143092105263157,45.272435897435905,1018.9102564102575,26.813427800269935,0
1160,4,0,1,39,0.0,0.025,0.975,40,1000,500,500,0.5,15,5,10,353.29536933231384,0.43092948717948715,-0.007970027247956146,0.19947600083839873,129908.37191358028,1179.2052469135876,131087.57716049388,1111,4,226.425,38,2,19,36.13476385104451,0.6156798245614035,45.13888888888889,1019.4444444444447,26.827485380116965,0
1161,4,0,0,39,0.0,0.0,1.0,39,650,200,450,0.3076923076923077,11,2,9,361.30784510058925,0.4283625730994152,-0.005571737499448393,0.20380568738198276,129871.11418898118,1584.6904816866686,131455.80467066786,1112,5,232.92307692307693,37,2,20,35.96842728055076,0.6171171171171171,45.175438596491226,1019.2982456140348,27.54860123281175,0
1162,4,0,0,39,0.0,0.0,1.0,39,350,200,150,0.5714285714285714,5,2,3,361.70366295594823,0.42805330634278005,-0.008257419680459455,0.20417479990901355,129899.05698147506,1596.9929449445956,131496.04992641966,1113,6,233.92307692307693,37,2,20,35.929937076476264,0.6173986486486487,45.14802631578947,1019.4078947368421,27.551564722617353,0
1163,4,2,0,41,0.04878048780487805,0.0,1.0,41,750,500,250,0.6666666666666666,10,5,5,347.3155664948146,0.4315548780487805,-0.0027100271002709064,0.1983059847405878,130344.39718934921,854.6355986468852,131199.0327879961,1114,0,223.46341463414635,38,3,22,35.84497279765642,0.6200657894736843,44.71153846153847,1021.1538461538469,26.87246963562755,0
1164,4,1,2,40,0.023809523809523808,0.047619047619047616,0.9523809523809523,42,1100,600,500,0.5454545454545454,16,6,10,339.22482755831675,0.43214043747580333,0.01723730032553572,0.19575451058181764,130755.83316808772,471.12499173771414,131226.95815982544,1115,0,219.11904761904762,40,2,14,35.63526762056171,0.6208333333333333,44.30894308943089,1022.764227642276,25.569105691056897,0
1165,4,0,0,40,0.0,0.0,1.0,40,1300,1000,300,0.7692307692307693,16,10,6,350.1492257166111,0.42844551282051285,0.009314237925987845,0.20105207042047435,130562.68376981522,1143.2845258967104,131705.96829571194,1116,1,231.025,38,2,14,35.55147571259321,0.6222587719298245,44.49786324786325,1022.0085470085473,26.894961763382824,0
1166,4,0,0,40,0.0,0.0,1.0,40,1100,700,400,0.6363636363636364,15,7,8,349.35977437328654,0.4276308760683761,0.004341692789968654,0.2011656462546542,130671.89554569362,1130.3007889546375,131802.19633464827,1117,2,232.025,38,2,15,35.461076280041816,0.6233552631578947,44.39102564102564,1022.4358974358975,26.90620782726046,0
1167,4,0,0,40,0.0,0.0,1.0,40,850,400,450,0.47058823529411764,13,4,9,346.2702262837517,0.42731036324786326,0.005147289251018927,0.19980981773443973,130753.83434007231,1055.2319608810033,131809.0663009533,1118,3,233.025,38,2,15,35.45714509558134,0.6241776315789473,44.31089743589744,1022.7564102564102,26.91464237516869,0
1168,4,0,1,39,0.0,0.025,0.975,40,1000,800,200,0.8,12,8,4,347.3380494116726,0.42732371794871793,0.003489259900233632,0.20105490037541918,130874.74093967024,1091.5554470486163,131966.29638671887,1119,4,234.025,39,1,15,35.30754776205503,0.6236645299145299,44.192708333333336,1023.2291666666675,26.236645299145323,0
1169,4,1,0,40,0.025,0.0,1.0,40,1400,1100,300,0.7857142857142857,17,11,6,348.4954602451594,0.4295940170940171,-0.0004701636677841847,0.20369280109516574,131248.0590820315,1147.8705512153083,132395.92963324682,1120,0,229.125,39,1,17,34.90065145200097,0.6274038461538461,43.828125000000014,1024.687500000002,26.274038461538513,0
1170,4,0,1,39,0.0,0.025,0.975,40,800,500,300,0.625,11,5,6,350.214644138892,0.4292334401709402,-0.0018042285017276782,0.20484017057303364,131274.7450086807,1194.8676215277978,132469.61263020852,1121,1,230.125,39,1,17,34.82965711187912,0.6276709401709402,43.80208333333334,1024.791666666668,26.27670940170944,0
1171,4,0,0,39,0.0,0.0,1.0,39,1500,900,600,0.6,21,9,12,358.8186032681742,0.42411718398560505,0.0009743871358367517,0.21064109495530148,131414.71021274658,1630.830254874807,133045.54046762138,1122,2,236.66666666666666,36,3,19,34.46778326926595,0.6345486111111112,43.66554054054054,1025.3378378378382,28.481606606606615,0
1172,4,0,0,39,0.0,0.0,1.0,39,1150,900,250,0.782608695652174,14,9,5,354.1643423910713,0.4235267656320288,-0.002032365848371853,0.20853800871624223,131530.201548677,1516.6614672104483,133046.86301588744,1123,3,237.66666666666666,36,3,19,34.47048706407582,0.6357060185185186,43.552927927927925,1025.788288288288,28.49411911911911,0
1173,4,0,1,38,0.0,0.02564102564102564,0.9743589743589743,39,1100,700,400,0.6363636363636364,15,7,8,348.56188415224005,0.42302069275753484,0.009509804736071548,0.19153320387926356,128839.3438966798,1195.9288184959667,130035.27271517577,1124,4,238.66666666666666,37,2,17,37.342833099326796,0.6067004504504505,46.189692982456144,1015.2412280701758,27.438952110004752,8
1174,4,2,1,39,0.05,0.025,0.975,40,700,400,300,0.5714285714285714,10,4,6,337.58363639573463,0.424732905982906,0.039275210084033674,0.187721741734077,129310.02995105575,730.590026663762,130040.61997771951,1125,0,233.2,38,2,19,37.142638305322144,0.6096491228070176,45.726495726495735,1017.0940170940183,26.765632028789955,0
1175,4,0,1,38,0.0,0.02564102564102564,0.9743589743589743,39,950,600,350,0.631578947368421,13,6,7,345.5590095866063,0.42271142600089967,0.043264046714553084,0.1918990571800113,129257.13320444764,1133.1933864266025,130390.32659087425,1126,1,239.4102564102564,37,2,19,36.9936560994896,0.6109234234234234,45.77850877192983,1016.8859649122817,27.483404457088692,0
1176,4,0,1,37,0.0,0.02631578947368421,0.9736842105263158,38,900,600,300,0.6666666666666666,12,6,6,347.11684565659664,0.4233197012802276,0.043544908783586855,0.19277153236648656,129258.6399744341,1373.570276357462,130632.21025079157,1127,2,241.97368421052633,36,2,19,36.95251937984495,0.6128472222222222,45.77702702702704,1016.8918918918936,28.246996996997044,0
1177,4,2,0,39,0.05128205128205128,0.0,1.0,39,1150,1000,150,0.8695652173913043,13,10,3,350.5705590535992,0.4279970760233918,0.0489104988294613,0.19209772196809088,128728.04763244436,1225.6527248768552,129953.70035732121,1128,0,220.92307692307693,37,2,17,37.405343958220755,0.6055743243243243,46.29934210526314,1014.8026315789455,27.42709815078231,8
1178,4,1,0,40,0.025,0.0,1.0,40,800,700,100,0.875,9,7,2,341.61476667169916,0.43112980769230774,0.0526924694993689,0.18840331795327794,128984.24373584615,812.5844656293187,129796.82820147547,1129,0,216.375,38,2,18,37.37159935492917,0.606359649122807,46.04700854700854,1015.8119658119646,26.731893837156964,0
1179,4,0,0,40,0.0,0.0,1.0,40,800,500,300,0.625,11,5,6,340.52245810877844,0.43062232905982906,0.05688078216989112,0.1883168384610871,129092.79348381903,791.799072247783,129884.59255606681,1130,1,217.375,38,2,18,37.288863190356054,0.6074561403508771,45.94017094017094,1016.2393162393154,26.743139901034613,0
1180,4,0,0,40,0.0,0.0,1.0,40,1650,1200,450,0.7272727272727273,21,12,9,338.10262930376854,0.4297542735042735,0.05764690026954189,0.18789106571554545,129285.0098708256,742.3660104748989,130027.3758813005,1131,2,218.375,37,3,19,37.15487421383649,0.611204954954955,45.75109649122807,1016.9956140350873,27.48636794689425,0
1181,4,1,0,41,0.024390243902439025,0.0,1.0,41,1000,800,200,0.8,12,8,4,329.6253765613859,0.4320376016260163,0.06516688330962173,0.18482288761077234,129636.22708013731,346.2780334575152,129982.50511359483,1132,0,214.02439024390245,38,3,16,37.01391803049377,0.6129385964912281,45.4059829059829,1018.3760683760681,26.799370220422844,0
1182,4,1,2,40,0.023809523809523808,0.047619047619047616,0.9523809523809523,42,1500,1200,300,0.8,18,12,6,323.74335406865737,0.4317290940766551,0.059160333182593616,0.1835795406134547,130076.56385633688,22.28461371528263,130098.84847005217,1133,0,209.9047619047619,39,3,17,36.71765972293134,0.6156517094017093,44.973958333333336,1020.1041666666673,26.15651709401711,0
1183,4,1,1,40,0.024390243902439025,0.024390243902439025,0.975609756097561,41,1100,700,400,0.6363636363636364,15,7,8,329.7494321571195,0.4299542682926829,0.0658260131054278,0.186985303365065,130076.56385633691,378.5346137152823,130455.0984700522,1134,0,213.09756097560975,39,2,18,36.56448909084719,0.6156517094017093,44.973958333333336,1020.1041666666675,26.156517094017115,0
1184,4,1,1,40,0.024390243902439025,0.024390243902439025,0.975609756097561,41,1100,800,300,0.7272727272727273,14,8,6,331.0287380258223,0.42817581300813007,0.07227476356396156,0.18860939724727102,130262.58680555568,424.1319444444533,130686.71875000013,1135,0,213.9512195121951,39,2,20,36.343537414965986,0.6175213675213675,44.79166666666667,1020.8333333333344,26.1752136752137,0
1185,4,0,0,40,0.0,0.0,1.0,40,950,300,650,0.3157894736842105,16,3,13,335.7362524633262,0.4282852564102564,0.07086643762078615,0.19184340217444293,130374.54433094797,754.2921860572517,131128.83651700523,1136,1,217.025,37,3,20,36.11006728222748,0.6221846846846847,44.68201754385965,1021.2719298245613,27.60194404931247,0
1186,4,0,0,40,0.0,0.0,1.0,40,1000,700,300,0.7,13,7,6,333.4991253156831,0.42823183760683764,0.07008993934323349,0.19095321175260857,130453.51765103376,701.2268061947631,131154.74445722852,1137,2,218.025,38,2,20,36.087289967231385,0.6211622807017544,44.60470085470086,1021.5811965811973,26.883715699505192,0
1187,4,0,0,40,0.0,0.0,1.0,40,1300,1100,200,0.8461538461538461,15,11,4,333.54050320184643,0.4278979700854701,0.05336764552199824,0.19192117108469428,130644.5883213711,715.0523458616325,131359.64066723274,1138,3,219.025,38,2,14,35.89303131640366,0.6230811403508771,44.41773504273504,1022.3290598290594,26.903396311291036,0
1188,4,0,1,39,0.0,0.025,0.975,40,1000,600,400,0.6,14,6,8,335.134609598374,0.4273904914529914,0.0563361888842453,0.19324749898046,130726.51855504418,762.1961520198637,131488.71470706403,1139,4,220.025,38,2,15,35.769475205460374,0.6239035087719298,44.337606837606835,1022.6495726495725,26.911830859199277,0
1189,4,0,0,39,0.0,0.0,1.0,39,1200,800,400,0.6666666666666666,16,8,8,342.35651352768497,0.4252980206927575,0.059884059884060425,0.19704519334148962,130654.64854570618,1146.093990458582,131800.74253616476,1140,6,226.56410256410257,37,2,17,35.65753253253252,0.625,44.407894736842096,1022.36842105263,27.63157894736838,0
1190,4,1,1,39,0.025,0.025,0.975,40,850,700,150,0.8235294117647058,10,7,3,335.345905919169,0.42736378205128206,0.06281837160751635,0.19446814641075286,130945.12473518869,782.3822960040791,131727.50703119277,1141,0,221.875,38,2,18,35.54323242867084,0.6260964912280702,44.12393162393162,1023.5042735042723,26.934322986954534,0
1191,4,0,0,39,0.0,0.0,1.0,39,1150,900,250,0.782608695652174,14,9,5,346.50399135225905,0.4255229419703104,0.0987522437721644,0.19229548730445964,129230.80800165044,1180.5100593681852,130411.31806101862,1142,1,228.3846153846154,35,4,17,36.996419085562515,0.6145833333333333,45.80439814814815,1016.782407407408,29.05092592592594,8
1192,4,0,0,39,0.0,0.0,1.0,39,1000,800,200,0.8,12,8,4,345.6695266852734,0.42571974808816915,0.09855113039826446,0.1928379745315308,129436.83556241432,1148.4739368998692,130585.30949931419,1143,2,229.3846153846154,35,4,16,36.80808310585381,0.6166666666666667,45.601851851851855,1017.592592592593,29.074074074074083,0
1193,4,0,2,37,0.0,0.05128205128205128,0.9487179487179487,39,900,500,400,0.5555555555555556,13,5,8,347.8352127634314,0.4252980206927575,0.10080299504907164,0.19433690349692628,129495.73072059342,1208.6350094307404,130704.36573002416,1144,3,230.3846153846154,35,4,16,36.69310514744901,0.6172619047619048,45.54398148148149,1017.8240740740753,29.080687830687864,0
1194,4,0,0,37,0.0,0.0,1.0,37,950,600,350,0.631578947368421,13,6,7,361.7542897571855,0.419044044044044,0.10461585180686317,0.20122582367743452,129322.44897959185,1956.590136054424,131279.03911564627,1145,4,243.0810810810811,34,3,19,36.51539091760299,0.6176470588235294,45.714285714285715,1017.1428571428572,29.915966386554626,0
1195,4,0,0,37,0.0,0.0,1.0,37,800,400,400,0.5,12,4,8,357.53907185116805,0.4192942942942943,0.1058005373794848,0.19980124603447608,129504.14540816312,1860.5583900226593,131364.70379818577,1146,5,244.0810810810811,34,3,16,36.43762183235868,0.6194852941176471,45.53571428571428,1017.8571428571418,29.936974789915933,0
1196,4,0,0,37,0.0,0.0,1.0,37,1150,700,450,0.6086956521739131,16,7,9,358.77970968683803,0.4190753253253254,0.10474631751227537,0.20111413084280536,129625.34722222204,1901.388888888869,131526.73611111092,1147,6,245.0810810810811,34,3,17,36.28273322422259,0.6207107843137255,45.41666666666666,1018.3333333333319,29.950980392156822,0
1197,4,0,0,37,0.0,0.0,1.0,37,1050,700,350,0.6666666666666666,14,7,7,356.9976089614815,0.41769894894894893,0.10681358929022466,0.20104602188883403,129807.25623582747,1868.1760204081384,131675.43225623562,1148,7,246.0810810810811,34,3,17,36.14315615264796,0.6225490196078431,45.23809523809523,1019.0476190476176,29.971988795518165,0
1198,4,0,0,37,0.0,0.0,1.0,37,1200,900,300,0.75,15,9,6,355.7804452830759,0.4173861361361361,0.10005343905708419,0.2009282826667302,129917.93894823876,1844.4524338527674,131762.39138209153,1149,8,247.0810810810811,36,1,17,36.06171066681396,0.6195023148148149,45.1295045045045,1019.4819819819818,28.31894394394394,0
1199,4,0,0,37,0.0,0.0,1.0,37,1000,600,400,0.6,14,6,8,353.04400612131525,0.4171671671671671,0.09715523827714656,0.1998229074646643,130004.05811216617,1779.430697589477,131783.48880975565,1150,9,248.0810810810811,36,1,17,36.044013177267374,0.6203703703703703,45.04504504504504,1019.8198198198194,28.328328328328315,0
1200,4,1,0,38,0.02631578947368421,0.0,1.0,38,1450,1000,450,0.6896551724137931,19,10,9,347.1025455158165,0.4192300853485064,0.09398164541164311,0.1980603385897986,130320.0725007098,1447.142581770916,131767.21508248072,1151,0,242.52631578947367,36,2,18,35.8750597404507,0.6235532407407407,44.73536036036034,1021.0585585585555,28.362737737737653,0
1201,4,1,2,37,0.02564102564102564,0.05128205128205128,0.9487179487179487,39,1150,1100,50,0.9565217391304348,12,11,1,341.10783877618417,0.42130566801619435,0.09296418173870791,0.1967540391011417,130738.73842191788,1119.2017014850287,131857.94012340292,1152,0,237.28205128205127,37,2,16,35.604405668131946,0.6258445945945945,44.32565789473682,1022.6973684210494,27.64046941678512,0
1202,4,0,1,36,0.0,0.02702702702702703,0.972972972972973,37,900,400,500,0.4444444444444444,14,4,10,343.64252542373936,0.4174486986986987,0.07682211448316534,0.1981344618014586,130722.8274516068,1584.3845112003623,132307.21196280717,1153,1,243.75675675675674,36,1,17,35.55569320559409,0.6276041666666667,44.3412162162162,1022.6351351351334,28.406531531531485,0
1203,4,0,0,36,0.0,0.0,1.0,36,1050,900,150,0.8571428571428571,12,9,3,351.4886578449909,0.41673280423280423,0.0832578502415462,0.2021059782608694,130617.283950617,1982.0987654320656,132599.38271604906,1154,2,249.22222222222223,35,1,17,35.46195652173914,0.6285714285714286,44.44444444444443,1022.2222222222199,29.20634920634914,0
1204,4,0,0,36,0.0,0.0,1.0,36,1000,700,300,0.7,13,7,6,353.20498235535905,0.41676587301587303,0.09033909390486339,0.20340370365888094,130676.44702717724,2031.1144332989995,132707.56146047625,1155,3,250.22222222222223,35,1,17,35.35818051467814,0.6291666666666667,44.386574074074055,1022.4537037037005,29.212962962962873,0
1205,4,0,1,35,0.0,0.027777777777777776,0.9722222222222222,36,800,700,100,0.875,9,7,2,359.14778789518806,0.4166501322751323,0.09682782114618327,0.2076198363116786,130824.4133257244,2197.059729723931,133021.47305544832,1156,4,251.22222222222223,35,1,17,35.05640249651167,0.6306547619047619,44.241898148148145,1023.0324074074069,29.22949735449734,0
1206,4,0,0,35,0.0,0.0,1.0,35,1050,700,350,0.6666666666666666,14,7,7,361.91365425627845,0.41544117647058826,0.0954862726849699,0.20963677708807096,130901.38888888908,2475.000000000024,133376.3888888891,1157,5,254.82857142857142,34,1,19,34.90770901194354,0.633578431372549,44.16666666666668,1023.3333333333348,30.09803921568632,0
1207,4,0,0,35,0.0,0.0,1.0,35,900,600,300,0.6666666666666666,12,6,6,394.50552508007405,0.41516106442577033,0.0926972758664788,0.22080448823200433,129565.68611992738,3232.7716403537424,132798.45776028113,1158,6,255.82857142857142,31,4,18,35.43411881314746,0.6273521505376345,45.47526041666667,1018.098958333334,32.84190188172045,8
1208,4,0,0,35,0.0,0.0,1.0,35,1000,800,200,0.8,12,8,4,396.05123775131557,0.4144257703081233,0.09837658187396126,0.2224198731463419,129698.28499688051,3273.433261447488,132971.718258328,1159,7,256.8285714285714,31,4,19,35.25941135114405,0.6286962365591398,45.345052083333336,1018.6197916666673,32.85870295698927,0
1209,4,0,1,34,0.0,0.02857142857142857,0.9714285714285714,35,1200,1000,200,0.8333333333333334,14,10,4,396.08400186027444,0.41414565826330535,0.10288196535800975,0.2231929073117615,129830.95169067373,3284.7925821939966,133115.7442728677,1160,8,257.8285714285714,31,4,19,35.123211319790464,0.6300403225806452,45.21484374999999,1019.1406249999992,32.875504032258036,0
1210,4,0,0,34,0.0,0.0,1.0,34,1000,500,500,0.5,15,5,10,404.19071366808106,0.4129344919786096,0.11469889987121196,0.2276800884867303,129817.03990345703,3694.1684009712058,133511.20830442823,1161,9,265.47058823529414,30,4,20,34.93086696562032,0.6326388888888889,45.22849462365591,1019.0860215053762,33.969534050179206,0
1211,4,0,0,34,0.0,0.0,1.0,34,900,600,300,0.6666666666666666,12,6,6,404.2933140605769,0.4122660427807487,0.11041712049396435,0.22859356984898016,129963.68620130738,3708.6898803710756,133672.37608167846,1162,10,266.47058823529414,31,3,20,34.77857766143106,0.6313844086021505,45.08463541666666,1019.6614583333323,32.89230510752685,0
1212,4,0,0,34,0.0,0.0,1.0,34,1100,800,300,0.7272727272727273,14,8,6,405.07038798234163,0.4126931075460487,0.11110693958461604,0.22961804771734182,130063.28158908417,3736.9567871093705,133800.23837619353,1163,11,267.47058823529414,31,3,20,34.65715683771594,0.6323924731182795,44.986979166666664,1020.052083333333,32.90490591397848,0
1213,4,0,0,34,0.0,0.0,1.0,34,1450,1200,250,0.8275862068965517,17,12,5,402.7527861037142,0.411968954248366,0.10278629619304303,0.2296779401834694,130296.89125910509,3695.6397829420757,133992.53104204717,1164,12,268.47058823529414,30,4,21,34.47812445146569,0.6375,44.75806451612903,1020.9677419354838,34.03225806451613,0
1214,4,0,0,34,0.0,0.0,1.0,34,650,300,350,0.46153846153846156,10,3,7,400.99376731301936,0.41126336898395727,0.10264705882352976,0.22948438490805326,130434.15423748411,3660.6565787952386,134094.81081627935,1165,13,269.47058823529414,30,4,21,34.38322368421052,0.6388888888888888,44.623655913978496,1021.5053763440861,34.05017921146954,0
1215,4,0,0,34,0.0,0.0,1.0,34,1250,1000,250,0.8,15,10,5,395.0029300822716,0.41105912061794414,0.100380618430024,0.22719179517039662,130628.37600708006,3519.7182549370655,134148.09426201714,1166,14,270.47058823529414,31,3,20,34.33864582006537,0.6381048387096775,44.43359375,1022.2656249999999,32.97631048387096,0
1216,4,1,0,35,0.02857142857142857,0.0,1.0,35,550,300,250,0.5454545454545454,8,3,5,385.2370232100465,0.4148809523809524,0.09542138098762831,0.22337133835054634,130940.1543847567,3088.5990587695205,134028.75344352622,1167,0,263.7142857142857,32,3,21,34.27168147051568,0.638671875,44.12878787878788,1023.4848484848487,31.983901515151523,0
1217,4,0,2,33,0.0,0.05714285714285714,0.9428571428571428,35,1200,1000,200,0.8333333333333334,14,10,4,388.63520055339234,0.41498599439775913,0.10223561122562241,0.22590988109587515,131037.09323347115,3185.125401744729,134222.2186352159,1168,1,264.7142857142857,32,3,22,34.08635466765322,0.6396484375,44.034090909090914,1023.8636363636369,31.995738636363654,0
1218,4,0,0,33,0.0,0.0,1.0,33,1150,1000,150,0.8695652173913043,13,10,3,399.44114670216476,0.4105508207070707,0.12298716081222016,0.23145699322604876,130915.143730489,3858.579026477041,134773.72275696605,1169,2,279.3333333333333,30,3,22,33.93365292005954,0.64375,44.15322580645161,1023.387096774193,34.112903225806434,0
1219,4,0,0,33,0.0,0.0,1.0,33,900,600,300,0.6666666666666666,12,6,6,399.3725194307647,0.4099589646464647,0.1161914537259161,0.23203817547705077,131018.32807622271,3865.0239550815163,134883.3520313042,1170,3,280.3333333333333,30,3,22,33.830576342392014,0.6447916666666667,44.05241935483871,1023.7903225806454,34.12634408602151,0
1220,4,0,0,33,0.0,0.0,1.0,33,1050,700,350,0.6666666666666666,14,7,7,401.36859170109256,0.409603851010101,0.11963711136830946,0.23361553095268334,131087.14022213552,3922.8521722164387,135009.99239435195,1171,4,281.3333333333333,30,3,22,33.70958568491053,0.6454861111111111,43.98521505376344,1024.0591397849464,34.13530465949821,0
1221,4,0,1,32,0.0,0.030303030303030304,0.9696969696969697,33,900,400,500,0.4444444444444444,14,4,10,393.3650133532542,0.40849905303030304,0.051547153090614195,0.23169011073581602,131541.7534722221,3776.809096427326,135318.56256864942,1172,5,282.3333333333333,29,4,22,33.45349309504469,0.6530172413793103,43.541666666666664,1025.8333333333326,35.37356321839078,8
1222,4,0,1,31,0.0,0.03125,0.96875,32,1000,600,400,0.6,14,6,8,395.91529306761356,0.40433887768817206,0.07497986412662816,0.2330123064476251,131512.27715434667,4013.5443503104743,135525.82150465713,1173,21,292.0,28,4,22,33.41796236634449,0.6558779761904762,43.570402298850574,1025.7183908045977,36.63279967159277,0
1223,4,0,0,31,0.0,0.0,1.0,31,550,200,350,0.36363636363636365,9,2,7,398.66794656635756,0.4044354838709678,0.07154406915926703,0.23531293176668808,131622.8303771965,4294.760701545785,135917.59107874226,1174,22,289.258064516129,28,3,20,33.235321571921965,0.6569940476190477,43.46264367816092,1026.1494252873565,36.648193760262735,0
1224,4,0,0,31,0.0,0.0,1.0,31,700,500,200,0.7142857142857143,9,5,4,401.3100618449877,0.4041666666666666,0.07659766586153216,0.2375609272479233,131733.43004772745,4373.190191901161,136106.62023962862,1175,23,290.258064516129,28,3,20,33.05545836249126,0.6581101190476191,43.35488505747126,1026.580459770114,36.66358784893264,0
1225,4,0,0,31,0.0,0.0,1.0,31,800,600,200,0.75,10,6,4,397.68203824147906,0.4031362007168459,0.07253778479584949,0.2365579512002141,131917.86604901566,4292.2731701677885,136210.13921918345,1176,24,291.258064516129,28,3,20,32.96182983682983,0.6599702380952381,43.17528735632184,1027.2988505747123,36.68924466338258,0
1226,4,0,0,31,0.0,0.0,1.0,31,1050,700,350,0.6666666666666666,14,7,7,398.9216640441498,0.40286738351254475,0.07520199422998175,0.23851519848584785,132112.27816358028,4340.489969135809,136452.7681327161,1177,25,292.258064516129,29,2,20,32.733270287309736,0.6587643678160919,42.986111111111114,1028.0555555555557,35.45019157088123,0
1227,4,0,0,31,0.0,0.0,1.0,31,850,700,150,0.8235294117647058,10,7,3,400.024692071481,0.40255376344086025,0.07769122183301103,0.23962644175544043,132183.6805555555,4375.347222222217,136559.02777777772,1178,26,293.258064516129,29,2,20,32.632698541329006,0.6594827586206897,42.916666666666664,1028.333333333333,35.459770114942515,0
1228,4,1,0,32,0.03125,0.0,1.0,32,800,500,300,0.625,11,5,6,388.60806401757117,0.406271001344086,0.07263274187019308,0.2343347731842328,132433.74083719138,3893.1375385802526,136326.87837577163,1179,0,285.0625,29,3,21,32.67370013043674,0.6619971264367817,42.673611111111114,1029.3055555555557,35.49329501915709,0
1229,4,0,1,31,0.0,0.03125,0.96875,32,1250,900,350,0.72,16,9,7,389.1259465884105,0.40553595430107525,0.07481622605880811,0.23531645742304044,132540.981867284,3915.0270061728515,136456.00887345686,1180,1,286.0625,29,3,21,32.55215358331086,0.6630747126436782,42.56944444444445,1029.7222222222226,35.50766283524906,0
1230,4,0,0,31,0.0,0.0,1.0,31,800,600,200,0.75,10,6,4,400.85220758079373,0.4045250896057348,0.06951214572165454,0.24243947440772545,132545.91353299632,4426.264409102905,136972.17794209922,1181,2,284.93548387096774,28,3,21,32.24530254406772,0.6662946428571428,42.56465517241379,1029.741379310344,36.776477832512285,0
1231,4,0,0,31,0.0,0.0,1.0,31,900,600,300,0.6666666666666666,12,6,6,398.90520519004156,0.40340501792114697,0.0692927693719303,0.2424532314934726,132730.91722816744,4389.410754392904,137120.32798256035,1182,3,285.93548387096774,28,3,19,32.108663320319764,0.6681547619047619,42.38505747126436,1030.4597701149419,36.80213464696221,0
1232,4,0,1,30,0.0,0.03225806451612903,0.967741935483871,31,800,400,400,0.5,12,4,8,398.30474204002957,0.4025985663082437,0.07037714563098096,0.24328792626564164,132916.04994467553,4388.218597238721,137304.26854191424,1183,4,286.93548387096774,28,3,20,31.937380985555702,0.6700148809523809,42.205459770114935,1031.1781609195393,36.82779146141212,0
1233,4,0,0,30,0.0,0.0,1.0,30,800,600,200,0.75,10,6,4,405.7587837000315,0.3984434865900383,0.05758217515993791,0.22327076553923814,128894.11212640196,4459.983632500875,133354.09575890284,1184,32,297.3666666666667,30,0,21,35.8349878667549,0.6232638888888888,46.13575268817205,1015.4569892473123,33.84856630824375,8
1234,4,2,1,31,0.0625,0.03125,0.96875,32,650,500,150,0.7692307692307693,8,5,3,385.0860371655764,0.4085601478494623,0.05199235807860236,0.2150846402705293,129483.95061728399,3573.5897735447916,133057.54039082877,1185,0,279.71875,29,3,20,35.75725527656476,0.632183908045977,45.55555555555556,1017.777777777778,35.095785440613035,0
1235,4,0,0,31,0.0,0.0,1.0,31,1050,800,250,0.7619047619047619,13,8,5,396.98143490300026,0.4021505376344086,0.05755126785087494,0.2203480482202772,129237.90966854942,4061.0101648170235,133298.91983336644,1186,1,289.741935483871,28,3,22,35.70604305025669,0.6328125,45.79741379310345,1016.8103448275868,36.314655172413815,0
1236,4,0,0,31,0.0,0.0,1.0,31,800,600,200,0.75,10,6,4,395.3220188936389,0.4012096774193548,0.057161730705714175,0.22020789265368107,129377.95380015437,4029.1907793209994,133407.14457947537,1187,2,290.741935483871,29,2,22,35.60509101251423,0.6311063218390804,45.65972222222223,1017.3611111111115,35.08141762452109,0
1237,4,1,0,32,0.03125,0.0,1.0,32,1300,1000,300,0.7692307692307693,16,10,6,386.0932270561812,0.4054309475806452,0.030640243902439135,0.21091628602858697,128606.37240939663,3533.8239504967114,132140.19635989334,1188,0,282.625,31,1,19,36.62869062901154,0.6176075268817205,46.41927083333333,1014.3229166666661,32.72009408602148,8
1238,4,0,0,32,0.0,0.0,1.0,32,500,500,0,1.0,5,5,0,385.8430064637454,0.4054729502688172,0.034586755646817346,0.21112982488521773,128672.41753472209,3529.4704861110918,132201.88802083317,1189,1,283.625,31,1,19,36.567419575633124,0.6182795698924731,46.35416666666666,1014.5833333333322,32.72849462365588,0
1239,4,1,0,33,0.030303030303030304,0.0,1.0,33,950,700,250,0.7368421052631579,12,7,5,376.40112974557337,0.4090909090909091,0.03179445461324648,0.20771766048922394,129008.91012396701,3111.819903581271,132120.73002754827,1190,0,276.0,32,1,21,36.46299403430274,0.619140625,46.02272727272727,1015.9090909090914,31.747159090909108,0
1240,4,0,0,33,0.0,0.0,1.0,33,650,400,250,0.6153846153846154,9,4,5,375.5710830421925,0.4090909090909091,0.039990064580228024,0.20827123695976144,129201.388888889,3105.0045913682343,132306.39348025725,1191,1,277.0,31,2,22,36.2875683060109,0.6236559139784946,45.833333333333336,1016.6666666666677,32.79569892473121,0
1241,4,0,0,33,0.0,0.0,1.0,33,900,600,300,0.6666666666666666,12,6,6,380.143185929799,0.40877525252525254,0.03694866990219747,0.2113379662133565,129300.69181654179,3230.5553860134473,132531.24720255524,1192,2,278.0,31,2,22,36.06999210515086,0.6246639784946236,45.73567708333333,1017.0572916666658,32.80829973118277,0
1242,4,1,1,33,0.029411764705882353,0.029411764705882353,0.9705882352941176,34,900,600,300,0.6666666666666666,12,6,6,371.5913904415498,0.4124702911467617,0.05213655279978435,0.20928919136453222,129811.85154894904,2847.393282573199,132659.24483152223,1193,0,270.79411764705884,32,2,17,35.76668525172428,0.6272786458333333,45.233585858585855,1019.0656565656561,31.845801767676754,0
1243,4,0,2,31,0.0,0.06060606060606061,0.9393939393939394,33,700,400,300,0.5714285714285714,10,4,6,375.00956304021395,0.4114583333333333,0.054040662114243965,0.21149674780106592,129864.12896050343,3140.0580512152737,133004.1870117187,1194,1,274.3636363636364,31,2,17,35.626383920967456,0.6303763440860215,45.182291666666664,1019.2708333333329,32.87970430107526,0
1244,4,1,0,32,0.03125,0.0,1.0,32,1100,1000,100,0.9090909090909091,12,10,2,372.9464884591212,0.4084971438172043,0.07202855775366901,0.21158839515403455,130096.48852878156,3303.805711534294,133400.29424031585,1195,0,279.15625,31,1,20,35.44259200170175,0.632728494623656,44.954427083333336,1020.1822916666674,32.909106182795725,0
1245,4,1,1,32,0.030303030303030304,0.030303030303030304,0.9696969696969697,33,950,600,350,0.631578947368421,13,6,7,361.34274584418813,0.4124842171717172,0.062067079498158595,0.2065654749917765,130391.51178770028,2823.205380828491,133214.71716852876,1196,0,271.6666666666667,32,1,21,35.43907363909837,0.6331380208333333,44.66540404040404,1021.3383838383842,31.916824494949505,0
1246,4,0,0,32,0.0,0.0,1.0,32,550,200,350,0.36363636363636365,9,2,7,369.6982504697304,0.41185735887096775,0.05227461106860498,0.21100245125062786,130329.05578613283,3236.4847819010433,133565.54056803387,1197,1,266.625,31,1,21,35.2891481764856,0.6350806451612903,44.7265625,1021.0937500000001,32.938508064516135,0
1247,4,0,0,32,0.0,0.0,1.0,32,1000,800,200,0.8,12,8,4,367.483114729659,0.41166834677419356,0.057532664117272425,0.21027753720307618,130428.79104614258,3186.0756768120664,133614.86672295464,1198,2,267.625,31,1,23,35.24444975568302,0.6360887096774194,44.62890625,1021.484375,32.951108870967744,0
1248,4,0,0,32,0.0,0.0,1.0,32,1100,1000,100,0.9090909090909091,12,10,2,365.2170066458501,0.41057627688172044,0.05998901693620229,0.21042180140791372,130694.93823581278,3146.402825249571,133841.34106106235,1199,3,268.625,31,1,18,35.032392079460074,0.6387768817204301,44.368489583333336,1022.5260416666672,32.98471102150539,0
1249,4,0,1,31,0.0,0.03125,0.96875,32,500,300,200,0.6,7,3,4,364.6492257788881,0.410177251344086,0.06141802443991895,0.2106385527734516,130794.81336805543,3138.8454861111018,133933.65885416654,1200,4,269.625,31,1,18,34.94568906992532,0.6397849462365591,44.27083333333333,1022.9166666666656,32.997311827956956,0
1250,4,0,0,31,0.0,0.0,1.0,31,750,600,150,0.8,9,6,3,377.40332053207567,0.40488351254480287,0.06885847924449884,0.21732831637301267,130674.53833174346,3663.4009350791903,134337.93926682265,1201,6,279.19354838709677,30,1,18,34.74157574164148,0.6413194444444444,44.38844086021505,1022.446236559139,34.081541218637966,0
1251,4,0,0,31,0.0,0.0,1.0,31,900,700,200,0.7777777777777778,11,7,4,376.76495529778595,0.40470430107526884,0.07556828776295466,0.2179281793105429,130846.376748757,3659.6658573245286,134506.04260608152,1202,7,280.19354838709677,30,1,19,34.58355228586441,0.6430555555555555,44.22043010752687,1023.1182795698918,34.10394265232973,0
1252,4,1,0,32,0.03125,0.0,1.0,32,1200,900,300,0.75,15,9,6,364.68098268805016,0.40700604838709675,0.06041560792783596,0.21341293789870958,131294.76123385967,3176.140509711376,134470.90174357104,1203,0,272.40625,31,1,21,34.438789014525895,0.6448252688172043,43.782552083333336,1024.8697916666672,33.06031586021507,0
1253,4,0,0,32,0.0,0.0,1.0,32,1100,900,200,0.8181818181818182,13,9,4,363.82878238909325,0.4059349798387097,0.056357922803454086,0.21384443955944,131461.6224500867,3165.9044053819393,134627.52685546863,1204,1,273.40625,31,1,22,34.29194176400882,0.646505376344086,43.619791666666664,1025.5208333333326,33.08131720430105,0
1254,4,0,0,32,0.0,0.0,1.0,32,650,300,350,0.46153846153846156,10,3,7,363.74397296780484,0.4054309475806452,0.05290841584158423,0.21416853655010212,131528.39660644528,3168.532307942708,134696.928914388,1205,2,274.40625,31,1,22,34.22664381822797,0.6471774193548387,43.5546875,1025.7812499999998,33.08971774193547,0
1255,4,0,0,32,0.0,0.0,1.0,32,850,600,250,0.7058823529411765,11,6,5,364.1804916444608,0.4054099462365592,0.051438158395734845,0.21461317080528866,131561.79004245345,3182.4474758572137,134744.23751831066,1206,3,275.40625,31,1,17,34.18171193467867,0.647513440860215,43.52213541666667,1025.9114583333342,33.093918010752716,0
1256,4,0,0,32,0.0,0.0,1.0,32,700,400,300,0.5714285714285714,10,4,6,364.9359684609241,0.40522093413978494,0.050475888324873264,0.2152466640323413,131595.18771701382,3204.763454861101,134799.9511718749,1207,4,276.40625,31,1,17,34.12859560067682,0.6478494623655914,43.48958333333333,1026.041666666666,33.098118279569874,0
1257,4,0,0,32,0.0,0.0,1.0,32,400,300,100,0.75,5,3,2,364.691213729103,0.405283938172043,0.05306671107727445,0.2152907457227761,131628.58963012695,3200.758022732204,134829.34765285917,1208,5,277.40625,31,1,18,34.101134585289515,0.6481854838709677,43.45703125,1026.171875,33.102318548387096,0
1258,4,0,0,32,0.0,0.0,1.0,32,750,400,350,0.5333333333333333,11,4,7,363.6392521918186,0.4046328965053763,0.05890977681968068,0.21561346938230685,131795.66277397997,3185.2152506510315,134980.878024631,1209,6,278.40625,31,1,19,33.95944289458113,0.6498655913978495,43.29427083333333,1026.822916666666,33.1233198924731,0
1259,4,0,1,31,0.0,0.03125,0.96875,32,800,400,400,0.5,12,4,8,362.6535805835439,0.40423387096774194,0.05688838550247133,0.2159773135384711,131962.84188164596,3171.3594224717845,135134.20130411774,1210,7,279.40625,31,1,20,33.81608266801842,0.6515456989247312,43.131510416666664,1027.4739583333328,33.14432123655912,0
1260,4,0,0,31,0.0,0.0,1.0,31,1050,800,250,0.7619047619047619,13,8,5,375.10819318932045,0.39999999999999997,0.07586259297093312,0.22290643952976588,131879.77837033191,3693.837076540653,135573.61544687257,1211,16,289.19354838709677,30,1,20,33.5800510337608,0.6534722222222222,43.212365591397855,1027.1505376344094,34.238351254480314,0
1261,4,0,0,31,0.0,0.0,1.0,31,650,400,250,0.6153846153846154,9,4,5,376.3310969329364,0.3996415770609319,0.07735520168148802,0.22383646489170686,131914.2950955313,3728.690274887273,135642.98537041858,1212,17,290.19354838709677,30,1,20,33.51378167386279,0.6538194444444445,43.178763440860216,1027.2849462365593,34.24283154121864,0
1262,4,0,0,31,0.0,0.0,1.0,31,1200,900,300,0.75,15,9,6,380.468551213038,0.39793906810035845,0.0776740792597812,0.2275374470858895,132121.49029150762,3853.614399063475,135975.1046905711,1213,18,291.19354838709677,30,1,21,33.198239421275126,0.6559027777777777,42.97715053763441,1028.091397849462,34.26971326164873,0
1263,4,0,0,31,0.0,0.0,1.0,31,1200,900,300,0.75,15,9,6,380.77224663768976,0.3973566308243728,0.07595043447830974,0.22813535309514194,132190.5914881778,3866.9017010637003,136057.4931892415,1214,19,292.19354838709677,30,1,21,33.12067050058816,0.6565972222222223,42.909946236559136,1028.360215053763,34.27867383512544,0
1264,4,1,0,32,0.03125,0.0,1.0,32,600,500,100,0.8333333333333334,7,5,2,372.02284960285675,0.4020287298387097,0.07593350828379886,0.22471999020701222,132498.52710300026,3458.495924207905,135957.02302720817,1215,0,284.03125,31,1,22,33.0352061464525,0.6569220430107527,42.610677083333336,1029.557291666667,33.211525537634415,0
1265,4,0,0,32,0.0,0.0,1.0,32,1050,700,350,0.6666666666666666,14,7,7,371.3042997341441,0.4015246975806452,0.07471486793883475,0.22548971019157976,132699.68880547426,3454.3930053710983,136154.08181084535,1216,1,285.03125,31,1,18,32.8511363157673,0.6589381720430108,42.415364583333336,1030.3385416666672,33.236727150537654,0
1266,4,0,1,31,0.0,0.03125,0.96875,32,800,600,200,0.75,10,6,4,372.1595456740507,0.4012096774193548,0.07723699166456144,0.2270230572147252,132867.44011772997,3489.5772298177035,136357.0173475477,1217,2,286.03125,31,1,18,32.660288793466364,0.6606182795698925,42.252604166666664,1030.989583333333,33.25772849462365,0
1267,4,0,0,31,0.0,0.0,1.0,31,850,600,250,0.7058823529411765,11,6,5,386.22841487571816,0.3951164874551971,0.08496671519823584,0.23461386913131962,132709.42630650935,4051.2302722858,136760.65657879514,1218,23,296.19354838709677,30,1,18,32.45689842595009,0.6618055555555555,42.40591397849462,1030.376344086021,34.345878136200696,0
1268,4,0,0,31,0.0,0.0,1.0,31,800,600,200,0.75,10,6,4,388.4454061061436,0.39448924731182794,0.08507075908257167,0.2363967757160245,132778.68106139437,4115.453737426288,136894.13479882065,1219,24,297.19354838709677,30,1,18,32.32997522170058,0.6625,42.33870967741935,1030.6451612903224,34.354838709677416,0
1269,4,0,0,31,0.0,0.0,1.0,31,850,500,350,0.5882352941176471,12,5,7,386.36928448432667,0.3939964157706093,0.0870000420574506,0.23556855421262196,132847.9538819516,4065.6737773152863,136913.6276592669,1220,25,298.19354838709677,30,1,19,32.31366797044764,0.6631944444444444,42.27150537634408,1030.913978494623,34.3637992831541,0
1270,4,0,0,31,0.0,0.0,1.0,31,450,300,150,0.6666666666666666,6,3,3,388.5819514606365,0.3937724014336918,0.0869214174877313,0.23713700474578703,132882.5970668574,4127.155776679379,137009.75284353676,1221,26,299.19354838709677,30,1,19,32.221733368096295,0.6635416666666667,42.23790322580645,1031.048387096774,34.368279569892465,0
1271,4,0,0,31,0.0,0.0,1.0,31,400,100,300,0.25,7,1,6,389.70662707720646,0.39404121863799285,0.08989208073554966,0.2382644581325421,132951.89698592311,4162.447067580055,137114.34405350318,1222,27,300.19354838709677,30,1,19,32.12292019635954,0.6642361111111111,42.17069892473118,1031.3172043010745,34.37724014336915,0
1272,4,1,0,32,0.03125,0.0,1.0,32,1300,1000,300,0.7692307692307693,16,10,6,377.21779421848584,0.3973034274193548,0.09163883287118701,0.23345132444067615,133404.95639377178,3664.5446777343805,137069.50107150615,1223,0,291.78125,31,1,20,31.989433661036877,0.665994623655914,41.731770833333336,1033.0729166666672,33.32493279569894,0
1273,4,1,1,32,0.030303030303030304,0.030303030303030304,0.9696969696969697,33,850,700,150,0.8235294117647058,10,7,3,372.03482105518873,0.399542297979798,0.08117794569643677,0.232500479702911,133765.94424357213,3353.117825987145,137119.06206955927,1224,0,283.90909090909093,32,1,16,31.761107042597338,0.6669921875,41.38257575757576,1034.4696969696972,32.32717803030304,0
1274,4,0,0,32,0.0,0.0,1.0,32,900,700,200,0.7777777777777778,11,7,4,380.85955860596613,0.39707241263440857,0.08910520846454162,0.23677713670890896,133573.15275404198,3774.5223999023538,137347.67515394432,1225,2,293.78125,31,1,20,31.72641915438552,0.6676747311827957,41.56901041666667,1033.7239583333342,33.34593413978497,0
1275,4,0,0,32,0.0,0.0,1.0,32,700,400,300,0.5714285714285714,10,4,6,379.29636792578344,0.3963583669354838,0.036762679162072764,0.2308871179252923,132788.1262913223,3673.210801193753,136461.33709251604,1226,3,294.78125,32,0,17,32.55619870145779,0.6572265625,42.32954545454545,1030.681818181818,32.20880681818181,8
1276,4,0,0,32,0.0,0.0,1.0,32,900,700,200,0.7777777777777778,11,7,4,379.6020273931473,0.3961273521505377,0.06208364174685421,0.22010400815800105,130940.15438475682,3541.0296143250916,134481.18399908193,1227,4,295.78125,32,0,19,34.41586479151248,0.638671875,44.12878787878789,1023.4848484848497,31.983901515151555,8
1277,4,0,1,31,0.0,0.03125,0.96875,32,1200,800,400,0.6666666666666666,16,8,8,378.6427315122336,0.395497311827957,0.05439672171555343,0.22102928945973127,131198.73769258242,3535.489682175296,134734.22737475773,1228,5,296.78125,32,0,20,34.17832347383125,0.6412760416666667,43.87626262626263,1024.4949494949499,32.015467171717184,0
1278,4,0,0,31,0.0,0.0,1.0,31,350,200,150,0.5714285714285714,5,2,3,391.64504445966793,0.39301075268817204,0.07347966392894834,0.2283967060610975,131161.34855482305,4073.738437228728,135235.08699205177,1229,6,306.2903225806452,31,0,20,33.88323058344987,0.643481182795699,43.912760416666664,1024.3489583333328,33.04351478494622,0
1279,4,0,0,31,0.0,0.0,1.0,31,1150,700,450,0.6086956521739131,16,7,9,390.61108967352277,0.3938620071684588,0.07502561790384088,0.2283885048834044,131261.40170627163,4054.4318305121483,135315.8335367838,1230,7,307.2903225806452,31,0,22,33.80823803473106,0.644489247311828,43.815104166666664,1024.7395833333328,33.056115591397834,0
1280,4,0,0,31,0.0,0.0,1.0,31,650,500,150,0.7692307692307693,8,5,3,375.3219452357029,0.39390681003584227,0.008241513657426092,0.21651438068980006,130743.2601492947,3614.1798993482344,134357.44004864292,1231,8,308.2903225806452,30,1,18,34.72505147413152,0.6420138888888889,44.321236559139784,1022.7150537634407,34.09050179211469,8
1281,4,0,0,31,0.0,0.0,1.0,31,1100,700,400,0.6363636363636364,15,7,8,381.75215744230826,0.3943100358422939,-0.0005422235401264519,0.22140462139552006,130949.53399598226,3798.05342380623,134747.5874197885,1232,9,309.2903225806452,30,1,18,34.35133508426351,0.6440972222222222,44.11962365591398,1023.5215053763446,34.11738351254482,0
1282,4,0,0,31,0.0,0.0,1.0,31,1300,1200,100,0.9230769230769231,14,12,2,386.29521703487865,0.3933243727598566,0.01034628735924148,0.22504354386894307,131121.55306971906,3930.325760203496,135051.87882992256,1233,10,310.2903225806452,30,1,18,34.0605861767279,0.6458333333333333,43.95161290322581,1024.1935483870968,34.13978494623656,0
1283,4,0,0,31,0.0,0.0,1.0,31,950,700,250,0.7368421052631579,12,7,5,385.4901514959665,0.39372759856630823,0.006507463696984184,0.22538166526113848,131259.24962423393,3919.829604578556,135179.07922881248,1234,11,311.2903225806452,30,1,20,33.941609828611405,0.6472222222222221,43.817204301075265,1024.7311827956983,34.157706093189944,0
1284,4,0,0,31,0.0,0.0,1.0,31,750,500,250,0.6666666666666666,10,5,5,420.18017381114447,0.39462365591397847,0.08156749284176579,0.227670594537354,128280.65609102199,4580.197674586647,132860.85376560863,1235,12,312.2903225806452,30,1,19,36.09913316527355,0.6170138888888889,46.74059139784946,1013.0376344086014,33.767921146953384,8
1285,4,1,0,32,0.03125,0.0,1.0,32,850,600,250,0.7058823529411765,11,6,5,409.4548613014351,0.4021547379032258,0.08925821355236185,0.22405001961100995,128672.41753472215,4137.109374999995,132809.52690972213,1236,0,303.5,31,1,17,35.96851471594798,0.6182795698924731,46.354166666666664,1014.5833333333327,32.72849462365589,0
1286,4,0,0,32,0.0,0.0,1.0,32,1000,800,200,0.8,12,8,4,410.4627870524157,0.40146169354838707,0.0960986597409259,0.22553758637404406,128837.60452270508,4176.608445909288,133014.21296861436,1237,1,304.5,31,1,17,35.773507973152064,0.6199596774193548,46.19140625,1015.234375,32.749495967741936,0
1287,4,0,0,32,0.0,0.0,1.0,32,900,500,400,0.5555555555555556,13,5,8,406.48645622320873,0.40076864919354843,0.0921638682389132,0.22428623277605889,129002.8974745008,4087.5861273871433,133090.48360188794,1238,2,305.5,31,1,18,35.70505425959156,0.6216397849462365,46.02864583333333,1015.8854166666661,32.77049731182794,0
1288,4,2,1,33,0.058823529411764705,0.029411764705882353,0.9705882352941176,34,950,800,150,0.8421052631578947,11,8,3,393.96461233883076,0.407995395127748,0.1072348131171661,0.22196542792748744,129825.09731833899,3429.2988273740693,133254.39614571305,1239,0,288.47058823529414,33,1,17,35.18318101651435,0.625,45.22058823529411,1019.1176470588226,30.882352941176443,0
1289,4,0,0,33,0.0,0.0,1.0,33,750,500,250,0.6666666666666666,10,5,5,406.43898454608325,0.4030539772727273,0.11451901263502662,0.22835304507784124,129715.36705438221,3944.276413121115,133659.6434675033,1240,1,298.2121212121212,32,1,18,34.97743141629485,0.6263020833333333,45.32828282828283,1018.6868686868687,31.833964646464647,0
1290,4,1,0,34,0.029411764705882353,0.0,1.0,34,750,400,350,0.5333333333333333,11,4,7,394.10019140837363,0.4060086155674391,0.07405475682948581,0.2138694344170128,128342.36145019533,3327.0655770287717,131669.4270272241,1241,0,290.4117647058824,31,3,19,36.69632913561209,0.6149193548387097,46.6796875,1013.2812500000001,32.68649193548387,8
1291,4,0,0,34,0.0,0.0,1.0,34,1050,800,250,0.7619047619047619,13,8,5,390.666751198533,0.40615715983363043,0.07915057915057888,0.21265514205918803,128464.33280086226,3237.348708040007,131701.68150890226,1242,1,291.4117647058824,32,2,16,36.6582596421306,0.6136067708333333,46.55934343434344,1013.7626262626271,31.680082070707098,0
1292,4,0,0,34,0.0,0.0,1.0,34,950,800,150,0.8421052631578947,11,8,3,389.28102642205266,0.4062685680332739,0.07963108061598834,0.2125829017843882,128592.3650169626,3211.713568768498,131804.0785857311,1243,2,292.4117647058824,32,2,16,36.56220175111,0.6149088541666667,46.43308080808081,1014.2676767676771,31.69586489898991,0
1293,4,0,0,34,0.0,0.0,1.0,34,1100,700,400,0.6363636363636364,15,7,8,387.2896753063181,0.40643568033273914,0.07884373261499711,0.21200680046059764,128688.43102744625,3167.9401336598376,131856.37116110607,1244,3,293.4117647058824,32,2,17,36.51433134229302,0.6158854166666667,46.33838383838384,1014.6464646464651,31.707702020202035,0
1294,4,0,0,34,0.0,0.0,1.0,34,950,600,350,0.631578947368421,13,6,7,385.6148362664289,0.4059714795008913,0.07932396839332734,0.2117720822118913,128816.57483930213,3134.716483011938,131951.29132231406,1245,4,294.4117647058824,32,2,19,36.42568407960197,0.6171875,46.21212121212121,1015.1515151515154,31.723484848484855,0
1295,4,0,0,34,0.0,0.0,1.0,34,700,500,200,0.7142857142857143,9,5,4,386.4677886739788,0.40474598930481287,0.07883844736303303,0.21292786932147167,128944.78242016125,3166.600984593416,132111.38340475466,1246,5,295.4117647058824,32,2,19,36.272894911321075,0.6184895833333333,46.08585858585859,1015.656565656566,31.73926767676769,0
1296,4,1,0,35,0.02857142857142857,0.0,1.0,35,850,600,250,0.7058823529411765,11,6,5,376.8918943959576,0.40847338935574234,0.07641091879789919,0.2088388953917479,129170.24289035461,2736.643508506337,131906.88639886095,1247,0,287.9428571428571,33,2,20,36.28578963230863,0.6183712121212122,45.86397058823529,1016.5441176470583,30.80436720142601,0
1297,4,0,0,35,0.0,0.0,1.0,35,1350,1200,150,0.8888888888888888,15,12,3,375.8230982060934,0.40899859943977596,0.0729020018085429,0.20926100222850677,129361.89746263127,2723.441573410557,132085.3390360418,1248,1,288.9428571428571,32,3,20,36.117403086343124,0.6227213541666667,45.675505050505045,1017.2979797979791,31.790561868686847,0
1298,4,1,0,36,0.027777777777777776,0.0,1.0,36,550,300,250,0.5454545454545454,8,3,5,365.86134035373107,0.41130952380952385,0.08057961715324558,0.20547563925812234,129700.23548635132,2290.4603998462007,131990.69588619753,1249,0,281.8888888888889,33,3,15,36.02622714148219,0.6237373737373737,45.343137254901954,1018.6274509803915,30.86749851455732,0
1299,4,0,1,35,0.0,0.027777777777777776,0.9722222222222222,36,1300,900,400,0.6923076923076923,17,9,8,364.54468873901294,0.410598544973545,0.07591790925124275,0.20538981243588286,129825.09731833907,2265.409938485195,132090.50725682426,1250,1,282.8888888888889,33,3,17,35.93274009940677,0.625,45.220588235294116,1019.1176470588233,30.882352941176464,0
1300,4,0,0,35,0.0,0.0,1.0,35,1100,900,200,0.8181818181818182,13,9,4,372.58149274370413,0.40693277310924375,0.08290319254957224,0.20958339179101185,129762.65889321406,2669.433030565152,132432.0919237792,1251,2,291.8857142857143,33,2,18,35.79153636436531,0.6243686868686869,45.28186274509803,1018.8725490196072,30.874925727866884,0
1301,4,0,0,35,0.0,0.0,1.0,35,1100,800,300,0.7272727272727273,14,8,6,366.4085613905326,0.40675770308123255,0.08064560439560409,0.20710049122073557,129950.01922337548,2522.959919261801,132472.97914263728,1252,3,292.8857142857143,33,2,18,35.75821314102562,0.6262626262626263,45.09803921568626,1019.6078431372538,30.89720736779557,0
1302,4,0,0,35,0.0,0.0,1.0,35,1700,1300,400,0.7647058823529411,21,13,8,365.89277593828587,0.4062675070028012,0.07302426134998807,0.20780513318295812,130137.51471789682,2523.2753027681515,132660.79002066498,1253,4,293.8857142857143,33,2,18,35.58081111378013,0.6281565656565656,44.9142156862745,1020.3431372549009,30.91948900772427,0
1303,4,0,0,35,0.0,0.0,1.0,35,650,500,150,0.7692307692307693,8,5,3,366.9386067385035,0.4061274509803921,0.07016075074199257,0.20856640124993267,130168.77710796303,2552.789942570135,132721.56705053317,1254,5,294.8857142857143,33,2,18,35.522372002722065,0.6284722222222222,44.883578431372534,1020.4656862745078,30.923202614379022,0
1304,4,1,0,36,0.027777777777777776,0.0,1.0,36,850,600,250,0.7058823529411765,11,6,5,356.3726680210436,0.41006944444444443,0.07626592109350727,0.20448549346875908,130536.1678004533,2103.904478458024,132640.07227891134,1255,0,287.6666666666667,34,2,15,35.419336362224286,0.6299019607843137,44.52380952380951,1021.9047619047602,30.056022408963535,0
1305,4,0,1,35,0.0,0.027777777777777776,0.9722222222222222,36,1300,900,400,0.6923076923076923,17,9,8,358.09212622603513,0.4091600529100529,0.08315226529054942,0.20660641077285885,130749.1514314059,2164.0483276643977,132913.1997590703,1256,1,288.6666666666667,34,2,16,35.15961471307181,0.632046568627451,44.31547619047619,1022.7380952380953,30.080532212885156,0
1306,4,0,0,35,0.0,0.0,1.0,35,300,100,200,0.3333333333333333,5,1,4,363.63384816654735,0.4043067226890756,0.08195750072772734,0.2093717871120433,130669.48596993952,2503.169604238763,133172.65557417826,1257,2,297.34285714285716,33,2,16,35.09866055375764,0.6335227272727273,44.39338235294118,1022.4264705882359,30.982620320855634,0
1307,4,1,0,36,0.027777777777777776,0.0,1.0,36,1100,800,300,0.7272727272727273,14,8,6,331.3701628774838,0.407473544973545,0.0508442635308306,0.1922990630241775,130972.4633487653,1480.0733024691199,132452.53665123443,1258,0,290.05555555555554,35,1,20,35.61736770691993,0.6321428571428571,44.097222222222214,1023.6111111111102,29.24603174603172,7
1308,4,0,0,36,0.0,0.0,1.0,36,750,300,450,0.4,12,3,9,333.7614316213888,0.4068287037037037,0.059992087713349296,0.19413460786025136,131061.33355034704,1548.6436631944248,132609.97721354148,1259,1,291.05555555555554,35,1,21,35.46647168531706,0.6330357142857144,44.01041666666666,1023.9583333333319,29.25595238095234,0
1309,4,0,1,35,0.0,0.027777777777777776,0.9722222222222222,36,1500,1200,300,0.8,18,12,6,336.966864938573,0.40591931216931215,0.0031394414305812024,0.1961501855905586,131090.96364883386,1634.6622085047848,132725.62585733863,1260,2,292.05555555555554,35,1,20,35.35450572634118,0.6333333333333333,43.981481481481474,1024.0740740740728,29.25925925925922,8
1310,4,0,0,35,0.0,0.0,1.0,35,1150,900,250,0.782608695652174,14,9,5,342.7481536379022,0.4018207282913165,0.010885302517101625,0.1997970944377041,131145.15306122453,1989.951814058961,133135.1048752835,1261,6,301.34285714285716,34,1,20,35.15177049434371,0.6360294117647058,43.92857142857143,1024.2857142857147,30.126050420168077,0
1311,4,0,0,35,0.0,0.0,1.0,35,1150,800,350,0.6956521739130435,15,8,7,342.46018247422643,0.40196078431372545,0.007671251057617567,0.20074367809976632,131358.63272392302,1997.0202664399226,133355.65299036293,1262,7,302.34285714285716,34,1,21,34.94367669260249,0.6381740196078431,43.7202380952381,1025.1190476190484,30.15056022408966,0
1312,4,0,0,35,0.0,0.0,1.0,35,1050,600,450,0.5714285714285714,15,6,9,344.33379240986113,0.4005252100840336,0.009098294069861845,0.2028109561993014,131541.75347222254,2058.854166666705,133600.60763888925,1263,8,303.34285714285716,34,1,21,34.71093961548876,0.6400122549019608,43.541666666666686,1025.833333333336,30.17156862745106,0
1313,4,0,0,35,0.0,0.0,1.0,35,900,600,300,0.6666666666666666,12,6,6,344.6431166929549,0.4007002801120448,0.013987404706662376,0.2034810730063887,131633.36167800482,2073.3064058957284,133706.66808390056,1264,9,304.34285714285716,34,1,17,34.610643851508144,0.6409313725490196,43.45238095238097,1026.1904761904784,30.18207282913172,0
1314,4,0,0,35,0.0,0.0,1.0,35,1150,900,250,0.782608695652174,14,9,5,342.5034786641931,0.4005252100840336,0.012152133580705993,0.20286744505494536,131755.55555555574,2025.3472222222563,133780.90277777798,1265,10,305.34285714285716,34,1,18,34.542410714285744,0.642156862745098,43.33333333333335,1026.6666666666683,30.196078431372598,0
1315,4,0,0,35,0.0,0.0,1.0,35,1300,1100,200,0.8461538461538461,15,11,4,342.3007670834847,0.40007002801120445,0.02307564972686671,0.20372797378830884,131938.95266439934,2032.5609410431134,133971.51360544245,1266,11,306.34285714285716,34,1,18,34.36292970258788,0.6439950980392157,43.15476190476192,1027.3809523809543,30.21708683473395,0
1316,4,0,0,35,0.0,0.0,1.0,35,1150,900,250,0.782608695652174,14,9,5,343.06810687356403,0.3994047619047619,0.023091432542440282,0.20484440074317792,132061.2882653062,2061.203231292528,134122.49149659873,1267,12,307.34285714285716,34,1,18,34.22008918230254,0.6452205882352942,43.03571428571429,1027.8571428571436,30.231092436974812,0
1317,4,0,0,35,0.0,0.0,1.0,35,750,400,350,0.5333333333333333,11,4,7,328.4592311421938,0.39894957983193274,0.05904221700024359,0.18643709739333128,130114.93866008645,1547.4905424811295,131662.42920256758,1268,13,308.34285714285716,35,0,19,36.558541312157324,0.6235119047619048,44.93634259259259,1020.2546296296285,29.150132275132243,8
1318,4,0,0,35,0.0,0.0,1.0,35,750,600,150,0.8,9,6,3,328.8494731422791,0.39835434173669465,0.06532834297380052,0.18694170243039807,130173.98787133487,1561.5294656635792,131735.51733699845,1269,14,309.34285714285716,35,0,20,36.48881422252467,0.6241071428571429,44.87847222222222,1020.4861111111111,29.15674603174603,0
1319,4,0,0,35,0.0,0.0,1.0,35,1550,1300,250,0.8387096774193549,18,13,5,332.3062801693838,0.3976190476190476,0.07635255524286899,0.18993041822605897,130384.1429280046,1665.5240467136002,132049.6669747182,1270,15,310.34285714285716,34,1,21,36.187929828651356,0.6283700980392157,44.67261904761905,1021.3095238095243,30.038515406162478,0
1320,4,0,1,34,0.0,0.02857142857142857,0.9714285714285714,35,1250,1000,250,0.8,15,10,5,332.75977271454053,0.39758403361344535,0.07969907291822742,0.19078671537801617,130505.75573979593,1685.4131235827713,132191.1688633787,1271,16,311.34285714285716,34,1,13,36.05334187735446,0.6295955882352942,44.55357142857143,1021.7857142857144,30.052521008403367,0
1321,4,0,0,34,0.0,0.0,1.0,34,1000,900,100,0.9,11,9,2,343.9741565784019,0.39241681521093286,0.08138254702000758,0.19677588161159806,130419.01139285392,2172.1538891291993,132591.16528198312,1272,23,321.02941176470586,33,1,21,35.85470405918814,0.6309974747474747,44.63848039215687,1021.4460784313743,30.952911467617405,0
1322,4,0,0,34,0.0,0.0,1.0,34,1100,700,400,0.6363636363636364,15,7,8,343.08858488040073,0.392825311942959,0.0812306455139915,0.1969040405586831,130544.21864487232,2157.646247837384,132701.8648927097,1273,24,322.02941176470586,33,1,13,35.75056461606107,0.632260101010101,44.515931372549026,1021.9362745098052,30.96776589423652,0
1323,4,0,0,34,0.0,0.0,1.0,34,700,500,200,0.7142857142857143,9,5,4,344.57990532177587,0.39330808080808083,0.08463155073802686,0.19808001311433052,130606.84479827482,2200.8988429930914,132807.7436412679,1274,25,323.02941176470586,33,1,13,35.649077848379484,0.6328914141414141,44.454656862745104,1022.1813725490206,30.97519310754608,0
1324,4,0,0,34,0.0,0.0,1.0,34,550,300,250,0.5454545454545454,8,3,5,344.31689325493784,0.39323380867498514,0.08510507137181889,0.19818991147945073,130657.85147392288,2197.5410997732442,132855.39257369612,1275,26,324.02941176470586,34,0,13,35.60418607359107,0.6311274509803921,44.404761904761905,1022.3809523809522,30.070028011204474,0
1325,4,0,0,34,0.0,0.0,1.0,34,1200,1000,200,0.8333333333333334,14,10,4,346.80567099256757,0.3924725193107546,0.08088149705231862,0.20009452783728326,130749.1514314059,2268.9094387755085,133018.06087018142,1276,27,325.02941176470586,34,0,14,35.44819190625848,0.632046568627451,44.31547619047619,1022.7380952380953,30.080532212885156,0
1326,4,0,0,34,0.0,0.0,1.0,34,950,600,350,0.631578947368421,13,6,7,346.1128590191205,0.39146984551396313,0.08850905108989471,0.20032592749288505,130870.93431122463,2259.2226473923015,133130.15695861692,1277,28,326.02941176470586,34,0,14,35.3427380259841,0.6332720588235294,44.19642857142858,1023.2142857142868,30.09453781512608,0
1327,4,0,0,34,0.0,0.0,1.0,34,800,500,300,0.625,11,5,6,344.78096268253057,0.3917855020796197,0.0869015047879611,0.20034569453174111,131023.24263038574,2234.8639455782536,133258.106575964,1278,29,327.02941176470586,34,0,16,35.22286821705426,0.6348039215686274,44.04761904761906,1023.8095238095258,30.112044817927227,0
1328,4,1,0,35,0.02857142857142857,0.0,1.0,35,1100,700,400,0.6363636363636364,15,7,8,336.62902730110693,0.3944677871148459,0.0896054137433453,0.19764047799212245,131419.65880102047,1848.288690476204,133267.94749149668,1279,0,318.65714285714284,34,1,18,35.03158984480825,0.6387867647058824,43.66071428571429,1025.3571428571433,30.1575630252101,0
1329,4,0,0,35,0.0,0.0,1.0,35,800,500,300,0.625,11,5,6,339.7144310827584,0.39509803921568626,0.09362887315771151,0.20009017447984484,131541.7534722223,1937.3263888888994,133479.0798611112,1280,1,319.65714285714284,34,1,19,34.82940698619008,0.6400122549019608,43.54166666666667,1025.8333333333342,30.171568627451006,0
1330,4,0,0,35,0.0,0.0,1.0,35,750,400,350,0.5333333333333333,11,4,7,340.3722750960962,0.39509803921568626,0.09436295228150438,0.20079867481541785,131602.82206632663,1958.7903911564717,133561.6124574831,1281,2,320.65714285714284,34,1,16,34.75098619329388,0.640625,43.48214285714286,1026.0714285714294,30.178571428571452,0
1331,4,0,0,35,0.0,0.0,1.0,35,750,400,350,0.5333333333333333,11,4,7,340.99072166611563,0.39499299719887954,0.09486469915654427,0.20148601860751117,131663.90483276668,1979.2339852607938,133643.13881802748,1282,3,321.65714285714284,34,1,17,34.6735684182036,0.6412377450980392,43.42261904761906,1026.3095238095257,30.18557422969193,0
1332,4,0,0,35,0.0,0.0,1.0,35,1050,800,250,0.7619047619047619,13,8,5,339.1497187809866,0.39292717086834733,0.09666763257026956,0.20144676067352582,131862.52170138896,1944.2274305555663,133806.74913194453,1283,4,322.65714285714284,35,0,18,34.52079107505071,0.6410714285714285,43.22916666666667,1027.083333333334,29.345238095238113,0
1333,4,1,0,36,0.027777777777777776,0.0,1.0,36,1200,800,400,0.6666666666666666,16,8,8,327.4450714799506,0.3959160052910053,0.09034543574773468,0.19666079736813608,132282.13168827622,1463.0264132375733,133745.15810151378,1284,0,314.6666666666667,36,0,20,34.399744572158376,0.6432291666666667,42.82094594594595,1028.716216216217,28.57545045045047,0
1334,4,0,0,36,0.0,0.0,1.0,36,1050,800,250,0.7619047619047619,13,8,5,326.6731138028813,0.39568452380952385,0.08040935672514626,0.19680063197393124,132398.0034722224,1450.1736111111309,133848.17708333352,1285,1,315.6666666666667,36,0,20,34.303306342780026,0.6443865740740741,42.70833333333334,1029.166666666668,28.587962962963005,0
1335,4,0,0,36,0.0,0.0,1.0,36,1000,700,300,0.7,13,7,6,322.9295981332351,0.39384920634920634,0.08135918555774269,0.19559696056467368,132600.90115453315,1364.1511443876593,133965.0522989208,1286,2,316.6666666666667,36,0,21,34.196187768787816,0.646412037037037,42.511261261261275,1029.9549549549567,28.60985985985991,0
1336,4,0,0,36,0.0,0.0,1.0,36,1050,800,250,0.7619047619047619,13,8,5,322.7447818686733,0.39404761904761904,0.08267152398299915,0.19608995711144508,132716.91243608494,1366.7381908936195,134083.65062697855,1287,3,317.6666666666667,36,0,18,34.084699453551906,0.6475694444444444,42.39864864864866,1030.405405405407,28.622372372372418,0
1337,4,0,0,36,0.0,0.0,1.0,36,700,400,300,0.5714285714285714,10,4,6,323.6549127462274,0.3939649470899471,0.07804059385508122,0.19710002770234347,132803.9541864501,1396.5304409139094,134200.48462736403,1288,4,318.6666666666667,36,0,19,33.97406132779781,0.6484375,42.3141891891892,1030.7432432432445,28.63175675675679,0
1338,4,0,0,36,0.0,0.0,1.0,36,1050,700,350,0.6666666666666666,14,7,7,324.5739959076748,0.393667328042328,0.0818047821814607,0.19858204599321305,132978.12328798417,1432.2481687769066,134410.3714567611,1289,5,319.6666666666667,36,0,20,33.775976271063065,0.6501736111111112,42.14527027027028,1031.4189189189208,28.650525525525577,0
1339,4,0,0,36,0.0,0.0,1.0,36,1000,500,500,0.5,15,5,10,334.5059947173589,0.39379960317460316,0.0626817280436025,0.20059377871002249,132224.21481870403,1645.9585007304802,133870.1733194345,1290,6,320.6666666666667,36,0,19,34.27634220227016,0.642650462962963,42.87725225225226,1028.4909909909925,28.569194194194235,6
1340,4,0,0,36,0.0,0.0,1.0,36,950,600,350,0.631578947368421,13,6,7,334.12837256577893,0.3931382275132275,0.06422908078265444,0.2009829453675789,132340.06123944905,1643.7138574385344,133983.77509688758,1291,7,321.6666666666667,36,0,20,34.169676407281756,0.6438078703703703,42.76463963963965,1028.9414414414425,28.581706706706736,0
1341,4,0,0,36,0.0,0.0,1.0,36,1300,1100,200,0.8461538461538461,15,11,4,335.413812690033,0.3917989417989418,0.06268464996788703,0.20289017341040455,132551.19756235817,1691.9258734051077,134243.12343576326,1292,8,322.6666666666667,34,2,21,33.924614643545276,0.6501225490196079,42.5595238095238,1029.761904761904,30.28711484593835,0
1342,4,0,0,36,0.0,0.0,1.0,36,1100,900,200,0.8181818181818182,13,9,4,334.11963224978524,0.39138558201058204,0.05916059940675722,0.20260246516169508,132643.1565334466,1663.7365362811638,134306.89306972775,1293,9,323.6666666666667,34,2,19,33.86566316113873,0.6510416666666667,42.47023809523809,1030.1190476190466,30.297619047619015,0
1343,4,0,0,36,0.0,0.0,1.0,36,800,600,200,0.75,10,6,4,333.4277812319678,0.39174933862433864,0.054191539893446716,0.2025135050219424,132704.4802295917,1649.4720804988506,134353.95231009054,1294,10,324.6666666666667,34,2,19,33.82197188523011,0.6516544117647058,42.41071428571428,1030.3571428571418,30.304621848739462,0
1344,4,0,0,36,0.0,0.0,1.0,36,1200,900,300,0.75,15,9,6,333.49289825003075,0.39130291005291,0.05783294842186315,0.20338369710177925,132857.85147392284,1661.4299886621266,134519.28146258497,1295,11,325.6666666666667,34,2,19,33.666522324865284,0.6531862745098039,42.26190476190476,1030.9523809523805,30.322128851540604,0
1345,4,0,0,36,0.0,0.0,1.0,36,800,700,100,0.875,9,7,2,334.39159101669935,0.39128637566137564,0.061524201721638416,0.20409905354444216,132888.53635204083,1687.3618197278852,134575.89817176873,1296,12,326.6666666666667,34,2,19,33.61260247084631,0.6534926470588236,42.232142857142854,1031.0714285714287,30.325630252100844,0
1346,4,0,0,36,0.0,0.0,1.0,36,1000,700,300,0.7,13,7,6,336.12502316258684,0.391005291005291,0.06336384850116672,0.20600137558182316,133042.01388888896,1743.7500000000045,134785.76388888896,1297,13,327.6666666666667,34,2,20,33.41410877759827,0.6550245098039216,42.083333333333336,1031.6666666666672,30.343137254901976,0
1347,4,1,0,37,0.02702702702702703,0.0,1.0,37,700,500,200,0.7142857142857143,9,5,4,328.99338556305395,0.3927052052052052,0.06243203867321245,0.20315626154872882,133322.76562767927,1372.4616072959589,134695.22723497523,1298,0,319.7837837837838,35,2,21,33.31710654114833,0.6556547619047619,41.811342592592595,1032.7546296296305,29.507275132275158,0
1348,4,0,0,37,0.0,0.0,1.0,37,850,500,350,0.5882352941176471,12,5,7,327.97884447378226,0.39182932932932935,0.0664973251508485,0.2031830079540217,133442.32420535397,1353.2518593535574,134795.57606470754,1299,1,320.7837837837838,35,2,23,33.22376404913931,0.6568452380952381,41.69560185185185,1033.2175925925917,29.52050264550262,0
1349,4,0,0,37,0.0,0.0,1.0,37,850,600,250,0.7058823529411765,11,6,5,327.7924393815805,0.39167292292292294,0.06641912318768228,0.203724027565546,133561.9363667053,1356.1185860339565,134918.05495273927,1300,2,321.7837837837838,35,2,23,33.10904433993954,0.6580357142857143,41.579861111111114,1033.6805555555559,29.53373015873017,0
1350,4,0,0,37,0.0,0.0,1.0,37,900,600,300,0.6666666666666666,12,6,6,332.70710890293975,0.3917354854854855,0.07111229403082575,0.20761667075116405,133711.52692043895,1497.3551097393654,135208.88203017833,1301,3,322.7837837837838,35,2,17,32.832549985079076,0.6595238095238095,41.43518518518518,1034.2592592592591,29.550264550264547,0
1351,4,0,0,37,0.0,0.0,1.0,37,1600,1300,300,0.8125,19,13,6,333.8003036338495,0.39048423423423423,0.0687960687960687,0.20948604318579073,133921.09435281644,1540.5803915895142,135461.67474440596,1302,4,323.7837837837838,35,2,19,32.59497651794699,0.6616071428571428,41.23263888888889,1035.0694444444453,29.57341269841272,0
1352,4,0,0,37,0.0,0.0,1.0,37,1150,800,350,0.6956521739130435,15,8,7,338.55784121699537,0.3886386386386386,0.06950755917351858,0.21386247259938795,134160.8009286052,1684.238227666333,135845.03915627152,1303,5,324.7837837837838,35,2,20,32.23254850482255,0.6639880952380952,41.00115740740741,1035.995370370371,29.59986772486774,0
1353,4,0,1,36,0.0,0.02702702702702703,0.972972972972973,37,1250,900,350,0.72,16,9,7,340.15665203100303,0.38757507507507505,0.06665727004710087,0.2156199604196523,134288.0295836377,1735.793310202096,136023.8228938398,1304,6,325.7837837837838,36,1,20,32.06418405041287,0.6631944444444444,40.87837837837838,1036.4864864864865,28.79129129129129,0
1354,4,0,0,36,0.0,0.0,1.0,36,600,400,200,0.6666666666666666,8,4,4,348.812972133775,0.3850198412698413,0.07350312779267232,0.22052074339982733,134190.77932098764,2161.496913580246,136352.2762345679,1305,21,335.6666666666667,35,1,21,31.936997319034848,0.6642857142857144,40.97222222222222,1036.111111111111,29.6031746031746,0
1355,4,0,0,36,0.0,0.0,1.0,36,600,400,200,0.6666666666666666,8,4,4,349.1123961516123,0.38503637566137566,0.07585147962032401,0.22125276061837854,134280.73459201385,2175.813802083329,136456.5483940972,1306,22,336.6666666666667,35,1,21,31.839405360134002,0.6651785714285714,40.885416666666664,1036.458333333333,29.61309523809523,0
1356,4,0,0,36,0.0,0.0,1.0,36,1100,800,300,0.7272727272727273,14,8,6,351.096412917664,0.3842757936507937,0.07652301737933098,0.222875306201525,134340.7215175969,2233.309086719825,136574.0306043167,1307,23,337.6666666666667,35,1,21,31.728094414052322,0.6657738095238095,40.8275462962963,1036.689814814815,29.619708994709,0
1357,4,0,0,36,0.0,0.0,1.0,36,1050,700,350,0.6666666666666666,14,7,7,349.39566904833697,0.38381283068783073,0.07318048272527866,0.2228920556356043,134520.76266986007,2200.1943747856476,136720.9570446457,1308,24,338.6666666666667,35,1,21,31.59249600208265,0.6675595238095238,40.653935185185176,1037.3842592592578,29.639550264550223,0
1358,4,0,0,36,0.0,0.0,1.0,36,1450,1100,350,0.7586206896551724,18,11,7,360.95482595254043,0.38369708994708995,0.05764910704256976,0.21935705224951954,132725.7764944485,2452.0142103909207,135177.79070483943,1309,25,339.6666666666667,35,1,19,33.09149069602007,0.649702380952381,42.39004629629628,1030.4398148148132,29.44113756613752,8
1359,4,2,0,38,0.05263157894736842,0.0,1.0,38,800,500,300,0.625,11,5,6,345.27521963929144,0.39101766239924135,0.059358587551681996,0.21341814757231772,133358.9421745151,1609.107610033844,134968.04978454896,1310,0,322.7368421052632,37,1,21,32.86049186128803,0.652027027027027,41.77631578947368,1032.8947368421043,27.916073968705522,0
1360,4,0,0,38,0.0,0.0,1.0,38,1250,1000,250,0.8,15,10,5,344.22954265184774,0.3907509483167378,0.0655070785144587,0.21392572593102951,133559.51126379738,1595.0739875487702,135154.58525134614,1311,1,323.7368421052632,36,2,22,32.68670334459092,0.6559606481481481,41.5822072072072,1033.6711711711696,28.713088088088043,0
1361,4,0,0,38,0.0,0.0,1.0,38,1050,700,350,0.6666666666666666,14,7,7,341.6019698766275,0.3910769321953533,0.06623805456348619,0.21262696172456372,133617.7198101817,1528.8152595162585,135146.53506969797,1312,2,324.7368421052632,36,2,22,32.696374759467005,0.6565393518518519,41.52590090090089,1033.8963963963954,28.719344344344318,0
1362,4,0,0,38,0.0,0.0,1.0,38,400,400,0,1.0,4,4,0,340.1131293927338,0.39076576576576577,0.06586112416742185,0.2118669439677121,133646.8288389739,1491.0082379676776,135137.83707694156,1313,3,325.7368421052632,36,2,22,32.705746750889425,0.6568287037037037,41.49774774774774,1034.0090090090073,28.722472472472425,0
1363,4,0,0,38,0.0,0.0,1.0,38,850,600,250,0.7058823529411765,11,6,5,340.1131293927338,0.39076576576576577,0.06586112416742185,0.2118669439677121,133646.8288389739,1491.0082379676776,135137.83707694156,1314,4,326.7368421052632,36,2,22,32.705746750889425,0.6568287037037037,41.49774774774774,1034.0090090090073,28.722472472472425,0
1364,4,0,0,38,0.0,0.0,1.0,38,800,500,300,0.625,11,5,6,340.7891200328102,0.39021752015173067,0.06579090622582617,0.2127904872536614,133734.17494775163,1515.030359751624,135249.20530750326,1315,5,327.7368421052632,36,2,18,32.60093449464707,0.6576967592592593,41.41328828828828,1034.3468468468454,28.73185685685682,0
1365,4,0,0,38,0.0,0.0,1.0,38,750,600,150,0.8,9,6,3,341.38313133539646,0.38940256045519206,0.06423710560685536,0.21366677184670427,133821.5495901305,1536.8839278467453,135358.43351797725,1316,6,328.7368421052632,36,2,19,32.49823138876794,0.6585648148148149,41.32882882882882,1034.6846846846834,28.741241241241205,0
1366,4,0,1,37,0.0,0.02631578947368421,0.9736842105263158,38,1300,800,500,0.6153846153846154,18,8,10,339.9471274326038,0.38840979137031767,0.06390977443608992,0.2138654713088657,134010.9592013887,1511.3281249999773,135522.28732638867,1317,7,329.7368421052632,37,1,20,32.34616029510394,0.6585022522522522,41.14583333333332,1035.4166666666652,27.984234234234194,0
1367,4,1,1,37,0.02631578947368421,0.02631578947368421,0.9736842105263158,38,1350,1000,350,0.7407407407407407,17,10,7,337.3769581084032,0.387594831673779,0.08324609662115501,0.2137323731930714,134266.5291243459,1459.6866343490258,135726.21575869492,1318,0,329.8421052631579,37,1,22,32.157656227958825,0.6610360360360361,40.89912280701754,1036.4035087719294,28.01090564248458,0
1368,4,0,0,37,0.0,0.0,1.0,37,900,500,400,0.5555555555555556,13,5,8,342.16435647397657,0.38385260260260257,0.08174474220198169,0.2160941737945273,134152.91243459514,1780.4689904585898,135933.38142505373,1319,1,339.5405405405405,37,0,22,32.147015241320915,0.6599099099099099,41.008771929824555,1035.964912280701,27.999051683262188,0
1369,4,0,0,37,0.0,0.0,1.0,37,1400,1200,200,0.8571428571428571,16,12,4,338.6699915415556,0.3830705705705706,0.07758117830060307,0.2145515254725725,134266.5291243459,1694.4088565712477,135960.93798091714,1320,2,340.5405405405405,37,0,22,32.12415361828186,0.6610360360360361,40.89912280701754,1036.4035087719294,28.01090564248458,0
1370,4,0,1,36,0.0,0.02702702702702703,0.972972972972973,37,1450,1100,350,0.7586206896551724,18,11,7,338.05720313414906,0.382225975975976,0.08620078852637025,0.21550007693052878,134493.90677900874,1693.326792859323,136187.23357186807,1321,3,341.5405405405405,37,0,24,31.913319238900634,0.6632882882882882,40.6798245614035,1037.2807017543846,28.034613560929312,0
1371,4,0,0,36,0.0,0.0,1.0,36,1200,900,300,0.75,15,9,6,338.5429267269884,0.3812003968253968,0.07641677822400705,0.21614663783338478,134550.78124999988,1910.255078485674,136461.03632848556,1322,4,343.77777777777777,35,1,24,31.844042838018723,0.6678571428571429,40.62499999999999,1037.499999999999,29.642857142857117,0
1372,4,0,0,36,0.0,0.0,1.0,36,1000,800,200,0.8,12,8,4,337.3609149294417,0.38138227513227513,0.07247629670942568,0.2155695368740157,134580.8031791193,1880.460578489344,136461.26375760866,1323,5,344.77777777777777,35,1,24,31.844789923777668,0.6681547619047619,40.5960648148148,1037.615740740739,29.646164021163973,0
1373,4,0,0,36,0.0,0.0,1.0,36,1650,1200,450,0.7272727272727273,21,12,9,336.7348698166395,0.38105158730158734,0.06898762403835446,0.21588098980596418,134700.92438539513,1871.699647419401,136572.62403281452,1324,6,345.77777777777777,35,1,25,31.741391645296755,0.669345238095238,40.48032407407407,1038.078703703703,29.659391534391514,0
1374,4,0,0,36,0.0,0.0,1.0,36,1000,900,100,0.9,11,9,2,335.88905411850936,0.3796957671957672,0.06196534856261593,0.2160089858494347,134813.7897187728,1856.4952621540451,136670.28498092687,1325,7,346.77777777777777,36,0,21,31.650988578038028,0.6684027777777778,40.37162162162162,1038.5135135135133,28.84759759759759,0
1375,4,0,0,36,0.0,0.0,1.0,36,950,800,150,0.8421052631578947,11,8,3,343.16267146726625,0.3795304232804233,-0.006279701289884754,0.19822690787109126,130794.81336805539,1843.0060022015014,132637.81937025688,1326,8,347.77777777777777,33,3,17,35.495162932790215,0.6347853535353536,44.27083333333332,1022.9166666666653,30.997474747474705,8
1376,4,1,0,37,0.02702702702702703,0.0,1.0,37,700,400,300,0.5714285714285714,10,4,6,335.5987036441187,0.38285160160160164,0.0041773324748339835,0.1957848708378059,131175.6395266438,1404.474914965961,132580.11444160974,1327,0,339.35135135135135,34,3,19,35.30408677125701,0.6363357843137255,43.89880952380951,1024.4047619047603,30.129551820728246,0
1377,4,0,0,37,0.0,0.0,1.0,37,1300,1000,300,0.7692307692307693,16,10,6,328.79448210321544,0.3838838838838839,0.055821489063995644,0.18564242297212308,129908.37191358011,1142.6311728394844,131051.00308641959,1328,1,340.35135135135135,35,2,19,36.759196185286086,0.6214285714285714,45.13888888888888,1019.4444444444433,29.126984126984095,7
1378,4,0,0,37,0.0,0.0,1.0,37,1450,1100,350,0.7586206896551724,18,11,7,329.6991105933182,0.38310185185185186,0.048092345153505356,0.1868577660230812,130055.90284475735,1175.8630990654983,131231.76594382286,1329,2,341.35135135135135,35,2,19,36.586694844736954,0.6229166666666667,44.99421296296296,1020.0231481481479,29.143518518518512,0
1379,4,0,0,37,0.0,0.0,1.0,37,900,500,400,0.5555555555555556,13,5,8,329.69686481717105,0.3830705705705706,0.04919911973665703,0.18756560993276222,130203.51750042867,1185.5383016117987,131389.05580204047,1330,3,342.35135135135135,35,2,21,36.437306267483194,0.6244047619047619,44.84953703703704,1020.6018518518518,29.16005291005291,0
1380,4,1,0,38,0.02631578947368421,0.0,1.0,38,750,300,450,0.4,12,3,9,326.77703515223357,0.3871354907539118,0.07719143708202436,0.1885507645014352,130751.61944038645,945.3253084165364,131696.94474880298,1331,0,334.3157894736842,36,2,16,35.95780114512222,0.6278935185185186,44.31306306306307,1022.7477477477487,28.409659659659685,0
1381,4,0,0,38,0.0,0.0,1.0,38,650,500,150,0.7692307692307693,8,5,3,328.9659188644248,0.3866761498340446,0.07939914163090078,0.19052347385092622,130895.62694028503,1012.0400383491765,131907.6669786342,1332,1,335.3157894736842,36,2,18,35.75643776824036,0.6293402777777778,44.172297297297305,1023.310810810812,28.425300300300332,0
1382,4,0,0,38,0.0,0.0,1.0,38,1000,800,200,0.8,12,8,4,325.9516689057585,0.3866761498340446,0.07560724292032295,0.18948545867590524,131039.71370018674,942.5226747017349,131982.23637488848,1333,2,336.3157894736842,36,2,19,35.6881965830767,0.630787037037037,44.031531531531535,1023.8738738738743,28.440940940940955,0
1383,4,0,0,38,0.0,0.0,1.0,38,800,400,400,0.5,12,4,8,323.8888661294789,0.3866761498340446,0.07302096234648592,0.18856884433940355,131097.3705969484,892.1957430403486,131989.56633998876,1334,3,337.3157894736842,36,2,19,35.6828678249395,0.6313657407407407,43.97522522522523,1024.0990990991,28.44719719719722,0
1384,4,1,0,39,0.02564102564102564,0.0,1.0,39,900,500,400,0.5555555555555556,13,5,8,318.0446938280273,0.3909412955465587,0.08125827760091453,0.18669403213972896,131412.43128895422,559.0052948984221,131971.43658385263,1335,0,329.64102564102564,37,2,20,35.51525237942465,0.6326013513513513,43.66776315789473,1025.3289473684206,27.711593172119475,0
1385,4,0,0,39,0.0,0.0,1.0,39,1050,800,250,0.7619047619047619,13,8,5,322.8439570925856,0.3913911381016644,0.037184723329870106,0.18317510078889448,130099.0430843193,600.3379766600697,130699.38106097937,1336,1,330.64102564102564,38,1,21,36.717850036653054,0.6175986842105263,44.951923076923066,1020.1923076923059,26.847165991902788,8
1386,4,1,1,39,0.025,0.025,0.975,40,1200,900,300,0.75,15,9,6,317.9075658640363,0.3954193376068376,0.033015500713849066,0.18187873925686904,130422.14084201367,292.4370659722023,130714.57790798588,1337,0,323.35,39,1,23,36.5171833571283,0.6191239316239316,44.63541666666666,1021.4583333333316,26.19123931623927,0
1387,4,1,1,39,0.025,0.025,0.975,40,1200,800,400,0.6666666666666666,16,8,8,327.14500825987153,0.39909188034188037,-0.014679911699779113,0.18571013626782207,130118.92804967146,599.011627759536,130717.939677431,1338,0,316.075,36,4,19,36.588024282560724,0.6215277777777778,44.93243243243244,1020.2702702702717,28.34084084084088,8
1388,4,1,0,40,0.025,0.0,1.0,40,1450,1100,350,0.7586206896551724,18,11,7,329.5800047509102,0.39959935897435894,-0.00630099728014466,0.18835582654935445,130380.7656035666,594.257929413408,130975.02353298,1339,0,317.025,35,5,21,36.26095497129043,0.6261904761904762,44.67592592592593,1021.2962962962969,29.179894179894195,0
1389,4,1,0,41,0.024390243902439025,0.0,1.0,41,1050,800,250,0.7619047619047619,13,8,5,322.3153466979758,0.40302337398373983,-0.004319329536907945,0.1856994510163467,130694.03863322803,224.9388746855188,130918.97750791356,1340,0,310.2682926829268,36,5,16,36.130001835535985,0.6273148148148149,44.36936936936938,1022.5225225225242,28.403403403403452,0
1390,4,0,1,40,0.0,0.024390243902439025,0.975609756097561,41,1400,1100,300,0.7857142857142857,17,11,6,320.2057694008769,0.40266768292682925,-0.006389041382375282,0.18510036112206849,130822.85534972319,178.04661049555824,131000.90196021875,1341,1,311.2682926829268,37,4,17,36.05394783851376,0.6266891891891893,44.24342105263159,1023.0263157894752,27.649359886202035,0
1391,4,0,0,40,0.0,0.0,1.0,40,1500,1000,500,0.6666666666666666,20,10,10,327.8310128270253,0.3987847222222222,-0.010731586480237754,0.18930000569026545,130780.41459956595,574.7751552228118,131355.18975478876,1342,2,319.9,36,4,18,35.90177621197109,0.6281828703703703,44.28490990990992,1022.8603603603617,28.412787787787824,0
1392,4,0,0,40,0.0,0.0,1.0,40,1250,900,350,0.72,16,9,7,327.28666215834016,0.3985042735042735,-0.012227602905569013,0.18940933836755938,130866.8190995051,566.1928820712817,131433.0119815764,1343,3,320.9,36,4,18,35.82847237508255,0.6290509259259259,44.20045045045046,1023.1981981981997,28.422172172172214,0
1393,4,0,1,39,0.0,0.025,0.975,40,400,200,200,0.5,6,2,4,327.28666215834016,0.3985042735042735,-0.012227602905569013,0.18940933836755938,130866.8190995051,566.1928820712817,131433.0119815764,1344,4,321.9,36,4,18,35.82847237508255,0.6290509259259259,44.20045045045046,1023.1981981981997,28.422172172172214,0
1394,4,0,0,39,0.0,0.0,1.0,39,850,400,450,0.47058823529411764,13,4,9,334.5672693024305,0.39538349077822765,-0.00431604594500512,0.19355855108857895,130854.0166323732,955.8942043895881,131809.91083676278,1345,5,330.28205128205127,35,4,18,35.65516591251886,0.6309523809523809,44.21296296296297,1023.1481481481488,29.232804232804252,0
1395,4,0,1,38,0.0,0.02564102564102564,0.9743589743589743,39,1100,800,300,0.7272727272727273,14,8,6,338.7295092527752,0.3956084120557805,-0.015118433528475306,0.19641869182441243,130942.84664619765,1070.8412369255789,132013.68788312323,1346,6,331.28205128205127,35,4,18,35.45895529420634,0.6318452380952381,44.126157407407405,1023.4953703703699,29.242724867724853,0
1396,4,0,0,38,0.0,0.0,1.0,38,1400,1100,300,0.7857142857142857,17,11,6,344.4761997644393,0.3968853722143196,-0.021850945653921316,0.1994442751877805,130883.62328800156,1417.25863233025,132300.8819203318,1347,7,332.86842105263156,35,3,19,35.371776382762135,0.63125,44.18402777777778,1023.263888888889,29.236111111111114,0
1397,4,0,0,38,0.0,0.0,1.0,38,1200,900,300,0.75,15,9,6,342.55824112334744,0.3975225225225225,-0.01775906697212304,0.19894469092160244,131002.08340031288,1375.1686546210449,132377.25205493392,1348,8,333.86842105263156,35,3,19,35.301135293009224,0.6324404761904762,44.06828703703703,1023.7268518518515,29.249338624338616,0
1398,4,1,0,39,0.02564102564102564,0.0,1.0,39,1000,500,500,0.5,15,5,10,333.13503866746015,0.401512595591543,-0.00875547217010575,0.19512195121951226,131328.12499999983,950.8104531035535,132278.9354531034,1349,0,326.28205128205127,34,5,21,35.21341463414636,0.6378676470588236,43.74999999999999,1024.9999999999986,30.14705882352937,0
1399,4,1,1,39,0.025,0.025,0.975,40,800,600,200,0.75,10,6,4,370.6429151327086,0.4052350427350427,-0.014524386216008267,0.21402095347427763,130780.4145995656,1694.5668218894357,132474.98142145504,1350,0,319.1,36,4,16,34.80701126646848,0.6281828703703703,44.2849099099099,1022.860360360359,28.41278778778775,8
1400,4,0,0,39,0.0,0.0,1.0,39,1000,700,300,0.7,13,7,6,379.7809733874,0.40429599640125957,-0.016366612111292644,0.21904338647852892,130735.6234996569,2130.180469821657,132865.80396947855,1351,1,327.46153846153845,35,4,16,34.618794326241144,0.6297619047619047,44.328703703703695,1022.6851851851839,29.219576719576683,0
1401,4,0,2,37,0.0,0.05128205128205128,0.9487179487179487,39,800,600,200,0.75,10,6,4,383.9888618169162,0.4040710751237067,-0.015802297250260722,0.22215062424486512,130854.01663237308,2249.296982167349,133103.31361454044,1352,2,328.46153846153845,35,4,17,34.391025641025635,0.6309523809523809,44.21296296296296,1023.1481481481479,29.232804232804227,0
1402,4,0,0,37,0.0,0.0,1.0,37,1050,900,150,0.8571428571428571,12,9,3,389.8665520665081,0.4024336836836837,-0.004723421050928822,0.22649131960803967,131014.2808655326,2815.617190503664,133829.89805603627,1353,3,330.27027027027026,33,4,18,34.07798659324875,0.6369949494949495,44.05637254901961,1023.7745098039225,31.023469994058257,0
1403,4,0,0,37,0.0,0.0,1.0,37,1050,800,250,0.7619047619047619,13,8,5,389.29376081792344,0.4018706206206206,-0.007660083782166316,0.22634303212482615,131045.64838343435,2803.050659602085,133848.69904303644,1354,4,331.27027027027026,33,4,18,34.06081687612208,0.6373106060606061,44.02573529411765,1023.8970588235302,31.027183600713037,0
1404,4,0,0,37,0.0,0.0,1.0,37,1100,600,500,0.5454545454545454,16,6,10,379.63372134135926,0.4017142142142142,-0.043400210265526096,0.2042938550588571,128005.79415060379,2319.0631973299214,130324.8573479337,1355,5,332.27027027027026,37,0,17,37.40778614512226,0.5982545045045045,47.01206140350876,1011.951754385963,27.350047415836837,8
1405,4,4,1,40,0.0975609756097561,0.024390243902439025,0.975609756097561,41,1000,700,300,0.7,13,7,6,356.4243813120189,0.41552337398373984,-0.001331840501123116,0.19700870031724005,129072.27143441391,1000.9760414229041,130073.24747583682,1356,0,300.7560975609756,40,1,19,36.905773910724385,0.60390625,45.96036585365853,1016.1585365853648,25.40396341463412,0
1406,4,0,0,40,0.0,0.0,1.0,40,850,700,150,0.8235294117647058,10,7,3,364.06742841837735,0.4129407051282051,0.00022559474979488847,0.20081366300543058,128989.6701388887,1392.1874999999807,130381.85763888869,1357,1,309.275,39,1,19,36.7958709324583,0.6047008547008548,46.04166666666666,1015.8333333333318,26.047008547008506,0
1407,4,0,1,39,0.0,0.025,0.975,40,1300,1000,300,0.7692307692307693,16,10,6,369.46135023447175,0.41260683760683764,-0.004352392663182769,0.20474578744680358,129174.91455078126,1545.0276692708333,130719.9422200521,1358,2,310.275,39,1,19,36.46986115380674,0.6065705128205128,45.859375,1016.5625000000001,26.06570512820513,0
1408,4,1,1,39,0.025,0.025,0.975,40,1300,800,500,0.6153846153846154,18,8,10,366.92986359954074,0.41402243589743587,0.0019771043026217683,0.20541256326956348,129573.74762854083,1508.903646705206,131082.65127524603,1359,0,308.325,36,4,16,36.12777900674704,0.6160300925925926,45.46734234234235,1018.1306306306317,28.281406406406436,0
1409,4,1,0,40,0.025,0.0,1.0,40,1050,800,250,0.7619047619047619,13,8,5,370.0453604305501,0.4156784188034188,0.0028876975793079573,0.20806714579336152,129745.7862211874,1602.365245312877,131348.15146650028,1360,0,309.3,36,4,17,35.87330975277254,0.6177662037037037,45.29842342342342,1018.8063063063063,28.300175175175173,0
1410,4,0,0,40,0.0,0.0,1.0,40,900,500,400,0.5555555555555556,13,5,8,372.4890885505103,0.415758547008547,0.006560048613413194,0.21005599629100724,129860.5420242877,1674.3269874604239,131534.86901174812,1361,1,310.3,36,4,17,35.69426030272898,0.6189236111111112,45.18581081081081,1019.256756756756,28.312687687687667,0
1411,4,0,1,39,0.0,0.025,0.975,40,1000,500,500,0.5,15,5,10,375.92054277069093,0.41602564102564105,0.043964941569282434,0.20213321824025482,127973.55791179693,1638.0702915753595,129611.6282033723,1362,2,311.3,36,4,20,37.53478018920425,0.5998263888888888,47.04391891891892,1011.8243243243243,28.10623123123123,8
1412,4,0,0,39,0.0,0.0,1.0,39,1000,600,400,0.6,14,6,8,336.7040186752508,0.41312415654520923,0.006421385327635365,0.17957547662680043,127645.42936288082,795.7458064019604,128441.17516928278,1363,3,320.12820512820514,37,2,20,38.8622142650463,0.5945945945945945,47.368421052631575,1010.5263157894731,27.311522048364136,8
1413,4,0,0,39,0.0,0.0,1.0,39,1050,900,150,0.8571428571428571,12,9,3,339.86006088810046,0.4132647323436797,-0.001090160743089097,0.1817581068090654,127756.25673284088,883.8498384118179,128640.10657125269,1364,4,321.12820512820514,37,2,20,38.66910701373824,0.5957207207207207,47.25877192982456,1010.9649122807017,27.323376007586532,0
1414,4,2,1,40,0.04878048780487805,0.024390243902439025,0.975609756097561,41,1450,1100,350,0.7586206896551724,18,11,7,330.72505699755595,0.41908028455284557,0.016497652805155028,0.1797114463156032,128394.44739006234,293.8304334025886,128688.27782346493,1365,0,306.4146341463415,37,4,14,38.248652133145804,0.6021959459459459,46.62828947368421,1013.4868421052633,27.391536273115225,0
1415,4,1,1,40,0.024390243902439025,0.024390243902439025,0.975609756097561,41,1100,900,200,0.8181818181818182,13,9,4,333.90406885457696,0.42022357723577236,0.02346990709608665,0.18219933527055943,128561.19340806788,385.4211151508173,128946.6145232187,1366,0,307.390243902439,37,4,17,37.998139438497844,0.6038851351351351,46.463815789473685,1014.1447368421054,27.409317211948796,0
1416,4,0,0,40,0.0,0.0,1.0,40,1200,1000,200,0.8333333333333334,14,10,4,342.00108671793225,0.417053952991453,0.032656537255326024,0.18635733935655385,128505.59937913585,789.8109274007368,129295.41030653659,1367,1,315.825,37,3,17,37.849550304603305,0.603322072072072,46.51864035087719,1013.925438596491,27.403390232337593,0
1417,4,0,0,40,0.0,0.0,1.0,40,1150,900,250,0.782608695652174,14,9,5,342.81573089261275,0.416920405982906,0.04359535386277691,0.18784840671469077,128728.04763244446,825.9999470990919,129554.04757954355,1368,2,316.825,37,3,18,37.60208445885106,0.6055743243243243,46.29934210526315,1014.8026315789463,27.42709815078233,0
1418,4,0,0,40,0.0,0.0,1.0,40,1500,1300,200,0.8666666666666667,17,13,4,344.1074078103138,0.41710737179487184,0.04633290127457301,0.18895292891505833,128811.51532202198,864.9993267158895,129676.51464873787,1369,3,317.825,37,3,20,37.48424785770863,0.6064189189189189,46.21710526315788,1015.131578947367,27.435988620199108,0
1419,4,0,1,39,0.0,0.025,0.975,40,1050,600,450,0.5714285714285714,15,6,9,341.43517007142106,0.41619925213675213,0.047675152535240795,0.18804650791998398,128929.98598327105,804.2463383008024,129734.23232157185,1370,4,318.825,38,2,21,37.431402973560566,0.6058114035087719,46.10042735042734,1015.598290598289,26.72627080521813,0
1420,4,1,0,40,0.025,0.0,1.0,40,1150,700,450,0.6086956521739131,16,7,9,343.88092534704424,0.4186698717948718,0.058580684461180255,0.19083594806136872,129230.01284646164,888.5179937620903,130118.53084022373,1371,0,305.45,36,4,22,37.06390519437367,0.6125578703703703,45.805180180180194,1016.7792792792818,28.24386886886894,0
1421,4,0,0,40,0.0,0.0,1.0,40,1350,900,450,0.6666666666666666,18,9,9,343.5037578278687,0.41812232905982905,0.05921868083222637,0.19159876269954484,129430.46932067226,891.9705178151376,130322.4398384874,1372,1,306.45,36,4,15,36.86965102552751,0.6145833333333333,45.60810810810812,1017.5675675675695,28.26576576576582,0
1422,4,0,1,39,0.0,0.025,0.975,40,700,100,600,0.14285714285714285,13,1,12,342.5804623524119,0.41742788461538466,0.06343898661356384,0.1915018428697252,129516.42679419302,873.9594746774044,130390.38626887042,1373,2,307.45,36,4,15,36.805786038278576,0.6154513888888888,45.52364864864866,1017.9054054054068,28.27515015015019,0
1423,4,0,0,39,0.0,0.0,1.0,39,1200,1100,100,0.9166666666666666,13,11,2,335.3152399480441,0.41784750337381915,0.05416356159090263,0.18833606887045518,129703.52055440139,898.313423361034,130601.83397776242,1374,3,309.15384615384613,37,2,15,36.800771438823105,0.615427927927928,45.33991228070175,1018.6403508771932,27.530820293978195,0
1424,4,0,0,39,0.0,0.0,1.0,39,1200,1000,200,0.8333333333333334,14,10,4,334.906135483661,0.41736954565901935,0.05134825014343125,0.18891307253981243,129871.11418898105,898.9265927977663,130770.04078177882,1375,4,310.15384615384613,37,2,15,36.64120768789443,0.6171171171171171,45.17543859649122,1019.2982456140337,27.548601232811723,0
1425,4,1,0,40,0.025,0.0,1.0,40,1500,1300,200,0.8666666666666667,17,13,4,331.64606007424067,0.42119391025641023,0.05526067839196003,0.1885644741564968,130180.80210387897,634.7900230111723,130815.59212689014,1376,0,303.375,38,2,17,36.41056846733667,0.618421052631579,44.87179487179487,1020.5128205128201,26.855600539811054,0
1426,4,0,1,39,0.0,0.025,0.975,40,1350,700,650,0.5185185185185185,20,7,13,328.4544354114742,0.42160790598290593,0.0041369920402174465,0.18622820364066228,130071.79578493668,585.623036744814,130657.4188216815,1377,1,304.375,38,2,17,36.60234254992318,0.6173245614035088,44.97863247863247,1020.0854700854691,26.844354475933397,8
1427,4,0,0,39,0.0,0.0,1.0,39,1450,1000,450,0.6896551724137931,19,10,9,329.51643812398595,0.4176788124156545,0.00770470797338052,0.18707446349869938,130122.70752779675,775.5142207217311,130898.22174851848,1378,7,313.15384615384613,37,2,17,36.52371037076839,0.6196509009009009,44.928728070175424,1020.2850877192961,27.575272641062057,0
1428,4,0,0,39,0.0,0.0,1.0,39,900,600,300,0.6666666666666666,12,6,6,330.78457723083756,0.4170602789023841,0.006556257093429219,0.18819944039514833,130206.6260772542,814.0687519236308,131020.69482917784,1379,8,314.15384615384613,37,2,17,36.406406675261415,0.6204954954954955,44.84649122807016,1020.6140350877166,27.584163110478826,0
1429,4,0,2,37,0.0,0.05128205128205128,0.9487179487179487,39,1150,900,250,0.782608695652174,14,9,5,330.36234902124136,0.41700404858299595,0.00607012035583443,0.18822971048884643,130262.58680555527,806.7708333333,131069.35763888857,1380,9,315.15384615384613,37,2,18,36.360544217687064,0.6210585585585586,44.79166666666665,1020.8333333333311,27.59009009009003,0
1430,4,0,0,37,0.0,0.0,1.0,37,1050,700,350,0.6666666666666666,14,7,7,345.52053718799186,0.41050425425425424,0.004266941320360873,0.19641873477669403,130173.98787133489,1595.5572434413557,131769.54511477624,1381,15,331.6216216216216,35,2,20,36.063499489622316,0.6241071428571429,44.87847222222222,1020.4861111111112,29.156746031746035,0
1431,4,1,1,37,0.02631578947368421,0.02631578947368421,0.9736842105263158,38,1250,800,450,0.64,17,8,9,337.5336344906659,0.4135253674727359,0.018777110250283835,0.19388957383780284,130578.91506371237,1214.955157860562,131793.87022157293,1382,0,323.86842105263156,36,2,15,35.85738945203465,0.6261574074074074,44.48198198198198,1022.0720720720722,28.390890890890894,0
1432,4,0,1,36,0.0,0.02702702702702703,0.972972972972973,37,1400,1100,300,0.7857142857142857,17,11,6,339.24197214975175,0.4129754754754755,0.02495696284586435,0.19611247821004923,130824.41332572428,1476.2263963905827,132300.63972211487,1383,1,326.5405405405405,35,2,17,35.56550986159822,0.6306547619047619,44.24189814814814,1023.032407407406,29.229497354497315,0
1433,4,0,1,35,0.0,0.027777777777777776,0.9722222222222222,36,1050,700,350,0.6666666666666666,14,7,7,341.23298654262004,0.4125496031746032,0.03986872683876608,0.19817503387849453,131002.08340031284,1740.4464323988213,132742.52983271168,1384,2,333.72222222222223,35,1,19,35.335052760504986,0.6324404761904762,44.06828703703703,1023.7268518518512,29.249338624338606,0
1434,4,2,0,37,0.05405405405405406,0.0,1.0,37,600,200,400,0.3333333333333333,10,2,8,330.9624633232286,0.4174486986986987,0.04555871215010909,0.19399963849462817,131357.7852393046,1295.3044624485483,132653.08970175314,1385,0,322.0,35,2,21,35.23919404614053,0.6360119047619048,43.72106481481481,1025.1157407407397,29.289021164021136,0
1435,4,0,0,37,0.0,0.0,1.0,37,1150,900,250,0.782608695652174,14,9,5,329.5554637128114,0.4171984484484485,0.04526656184175404,0.1941947137402143,131559.08230866014,1271.202875172488,132830.28518383263,1386,1,323.0,36,1,13,35.072493596780106,0.6359953703703703,43.524774774774784,1025.900900900902,28.497247247247273,0
1436,4,0,2,35,0.0,0.05405405405405406,0.9459459459459459,37,1550,1400,150,0.9032258064516129,17,14,3,334.2948520100162,0.4179491991991992,0.05382285114682528,0.1981859857364974,131790.24252292843,1411.3599241133084,133201.60244704175,1387,2,324.0,36,1,15,34.71818564012575,0.6383101851851851,43.29954954954955,1026.8018018018026,28.522272272272296,0
1437,4,1,0,36,0.027777777777777776,0.0,1.0,36,800,700,100,0.875,9,7,2,343.79137968069415,0.4165839947089947,0.07038080921959144,0.20356672481760724,131743.67310742452,1858.4678283607618,133602.14093578528,1388,0,333.8611111111111,35,1,16,34.52132656895904,0.6398809523809523,43.344907407407405,1026.62037037037,29.33201058201057,0
1438,4,0,0,36,0.0,0.0,1.0,36,600,400,200,0.6666666666666666,8,4,4,344.76801124001696,0.41623677248677243,0.06775548793468311,0.20462385041690112,131832.80452942822,1890.3467667609793,133723.1512961892,1389,1,334.8611111111111,35,1,17,34.406462489199434,0.6407738095238096,43.258101851851855,1026.967592592593,29.34193121693123,0
1439,4,0,0,36,0.0,0.0,1.0,36,1350,900,450,0.6666666666666666,18,9,9,343.3556845799548,0.4167493386243386,0.07076510940864233,0.2042644139632495,131921.96609224982,1859.2313957476163,133781.19748799744,1390,2,335.8611111111111,35,1,18,34.35293675829953,0.6416666666666666,43.171296296296305,1027.3148148148161,29.35185185185189,0
1440,4,0,1,35,0.0,0.027777777777777776,0.9722222222222222,36,1250,1000,250,0.8,15,10,5,341.53192802823764,0.4165674603174603,0.06791618175219938,0.20365762182422587,132011.15779588916,1817.2050486539918,133828.36284454315,1391,3,336.8611111111111,35,1,18,34.31000581897362,0.6425595238095239,43.08449074074075,1027.6620370370379,29.36177248677251,0
1441,4,1,0,36,0.027777777777777776,0.0,1.0,36,1200,900,300,0.75,15,9,6,339.93683435152303,0.4132275132275132,0.07280372663040113,0.20366411147763197,132189.6316256216,1787.2249817815573,133976.85660740317,1392,0,337.1388888888889,35,1,20,34.17147345713751,0.6443452380952381,42.91087962962963,1028.3564814814818,29.381613756613763,0
1442,4,0,0,36,0.0,0.0,1.0,36,1050,800,250,0.7619047619047619,13,8,5,345.2224045726268,0.4124669312169312,0.07566015571301832,0.20781126601592584,132368.2260186257,1939.2954550325799,134307.52147365827,1393,1,338.1388888888889,35,1,20,33.85598264162261,0.6461309523809524,42.73726851851852,1029.050925925926,29.401455026455032,0
1443,4,0,0,36,0.0,0.0,1.0,36,700,500,200,0.7142857142857143,9,5,4,345.93123345800916,0.41159060846560847,0.08180920970441985,0.20873218387893702,132457.5684263545,1964.2420053154842,134421.81043167,1394,2,339.1388888888889,35,1,21,33.74793868525597,0.6470238095238094,42.650462962962955,1029.3981481481474,29.41137566137564,0
1444,4,0,0,36,0.0,0.0,1.0,36,850,500,350,0.5882352941176471,12,5,7,344.07377811397185,0.4114748677248677,0.07958590968709034,0.20777571326027008,132487.35592689042,1917.0850212191376,134404.44094810955,1395,3,340.1388888888889,35,1,21,33.7658094435076,0.6473214285714286,42.62152777777778,1029.5138888888887,29.414682539682534,0
1445,4,1,0,37,0.02702702702702703,0.0,1.0,37,850,600,250,0.7058823529411765,11,6,5,336.89315301914036,0.4139139139139139,0.08213783901857252,0.2056395806028834,132891.02447041657,1554.0152483564864,134445.03971877304,1396,0,331.9189189189189,36,1,18,33.545625819135,0.6493055555555556,42.22972972972974,1031.0810810810826,28.641141141141183,0
1446,4,0,0,37,0.0,0.0,1.0,37,550,300,250,0.5454545454545454,8,3,5,365.76883454228283,0.41382007007007005,0.12598722548132324,0.2037995210986597,129388.34372597066,2122.5402087477287,131510.88393471838,1397,1,332.9189189189189,33,4,22,36.34616156749377,0.6205808080808081,45.64950980392156,1017.4019607843127,30.830362448009474,8
1447,4,2,0,39,0.05128205128205128,0.0,1.0,39,1600,1400,200,0.875,18,14,4,349.38882734493365,0.42065901934322986,0.1298897025664303,0.19801696047529901,130055.90284475735,1288.0158768432766,131343.91872160064,1398,0,316.79487179487177,35,4,21,36.08459567305874,0.6229166666666667,44.99421296296296,1020.0231481481479,29.143518518518512,0
1448,4,0,0,39,0.0,0.0,1.0,39,1050,900,150,0.8571428571428571,12,9,3,345.00051053850285,0.4211088618983356,0.12771650611940988,0.1959745168110465,130144.46159122081,1179.9811385459475,131324.44272976677,1399,1,317.79487179487177,35,4,21,36.10669993950394,0.6238095238095238,44.907407407407405,1020.37037037037,29.15343915343914,0
1449,4,0,0,39,0.0,0.0,1.0,39,1050,700,350,0.6666666666666666,14,7,7,348.53093280479516,0.42102451641925326,0.12303272945069055,0.19843087775374363,130233.05047850228,1278.0493130572768,131511.09979155957,1400,2,318.79487179487177,35,4,21,35.92681048493782,0.624702380952381,44.820601851851855,1020.717592592593,29.1633597883598,0
1450,4,0,1,38,0.0,0.02564102564102564,0.9743589743589743,39,1050,700,350,0.6666666666666666,14,7,7,350.09503933052395,0.42068713450292394,0.12543359654168662,0.20038513729774338,130439.87509645053,1333.2706404320886,131773.1457368826,1401,3,319.79487179487177,35,4,21,35.677260367097205,0.6267857142857143,44.61805555555555,1021.527777777777,29.186507936507915,0
1451,4,0,0,38,0.0,0.0,1.0,38,550,500,50,0.9090909090909091,6,5,1,357.93833797824095,0.4192300853485064,0.1341494837454984,0.20458047978116778,130384.14292800447,1733.8966836734635,132118.03961167793,1402,4,328.0263157894737,34,4,21,35.53347320977581,0.6283700980392157,44.672619047619044,1021.3095238095233,30.03851540616245,0
1452,4,1,0,39,0.02564102564102564,0.0,1.0,39,1200,800,400,0.6666666666666666,16,8,8,348.8871720387545,0.42217723796671164,0.13435270487568451,0.20091716282857597,130676.44702717755,1318.2672110768083,131994.71423825435,1403,0,320.5897435897436,35,4,18,35.4685495434307,0.6291666666666667,44.38657407407407,1022.453703703703,29.212962962962944,0
1453,4,0,1,38,0.0,0.02564102564102564,0.9743589743589743,39,850,500,350,0.5882352941176471,12,5,7,349.48194587351344,0.4215024741340531,0.13810874504325255,0.20210334043672,130838.01442912516,1345.1047753835057,132183.11920450866,1404,1,321.5897435897436,36,3,18,35.28985507246377,0.6287615740740741,44.22860360360361,1023.0855855855863,28.419044044044064,0
1454,4,1,0,39,0.02564102564102564,0.0,1.0,39,900,700,200,0.7777777777777778,11,7,4,349.79940110662307,0.42079959514170046,0.1408395095152688,0.20334885900648453,131039.71370018672,1367.522674701736,132407.23637488845,1405,0,322.0,36,3,20,35.077769834286556,0.630787037037037,44.031531531531535,1023.8738738738742,28.44094094094095,0
1455,4,0,2,37,0.0,0.05128205128205128,0.9487179487179487,39,1600,1400,200,0.875,18,14,4,349.09800472140853,0.4207152496626181,0.13325554785216265,0.20385710185849637,131212.72243527306,1361.2199192435594,132573.94235451662,1406,1,323.0,36,3,20,34.92090752546348,0.6325231481481481,43.86261261261261,1024.549549549549,28.459709709709696,0
1456,4,0,0,37,0.0,0.0,1.0,37,1350,900,450,0.6666666666666666,18,9,9,366.6298873087753,0.4157907907907908,0.14305284126256002,0.21337958664614917,131084.19075963713,2211.8764172335514,133296.06717687068,1407,2,340.86486486486484,34,3,20,34.60193365883902,0.6354166666666667,43.988095238095234,1024.0476190476186,30.119047619047606,0
1457,4,0,0,37,0.0,0.0,1.0,37,750,500,250,0.6666666666666666,10,5,5,342.8308643823558,0.41519644644644643,0.05632390818440047,0.19502913074651215,130201.83000283455,1527.6679421768818,131729.49794501145,1408,3,341.86486486486484,34,3,18,36.103901784672814,0.626531862745098,44.85119047619048,1020.5952380952388,30.01750700280114,8
1458,4,0,0,37,0.0,0.0,1.0,37,1100,600,500,0.5454545454545454,16,6,10,344.6897126197417,0.4146021021021021,0.061555432984004455,0.19639297579496925,130262.58680555563,1580.0347222222313,131842.62152777787,1409,4,342.86486486486484,34,3,18,35.994897959183675,0.6271446078431373,44.79166666666667,1020.833333333334,30.02450980392159,0
1459,4,0,0,37,0.0,0.0,1.0,37,1350,900,450,0.6666666666666666,18,9,9,343.3085668409208,0.4139451951951952,0.058982798034987516,0.1963951204268413,130419.01139285386,1554.7927780180883,131973.80417087194,1410,5,343.86486486486484,33,4,19,35.871700659868026,0.6309974747474747,44.63848039215687,1021.4460784313738,30.95291146761739,0
1460,4,2,0,39,0.05128205128205128,0.0,1.0,39,1050,800,250,0.7619047619047619,13,8,5,327.51655505296645,0.4176788124156545,0.0647608442225045,0.1897707326198121,130913.2332926099,775.2502357681956,131688.4835283781,1411,0,327.1794871794872,35,4,17,35.77574832240066,0.631547619047619,44.1550925925926,1023.379629629631,29.23941798941803,0
1461,4,0,2,37,0.0,0.05128205128205128,0.9487179487179487,39,1000,800,200,0.8,12,8,4,327.5639348279594,0.41711650922177235,0.06737508478408305,0.19038308590592193,131031.70680084037,784.2522933813641,131815.95909422173,1412,1,328.1794871794872,35,4,18,35.6550041449996,0.6327380952380952,44.03935185185186,1023.842592592594,29.252645502645542,0
1462,4,0,0,37,0.0,0.0,1.0,37,950,600,350,0.631578947368421,13,6,7,346.4803453015337,0.4121621621621621,0.07407263533745767,0.20046877359130355,130857.49959450714,1667.9103289600473,132525.4099234672,1413,2,346.2432432432432,33,4,18,35.346922785163905,0.6354166666666667,44.20955882352943,1023.1617647058841,31.004901960784366,0
1463,4,0,1,36,0.0,0.02702702702702703,0.972972972972973,37,1000,600,400,0.6,14,6,8,344.2495706169906,0.4125375375375375,0.0684348141244695,0.19966475095785458,130951.55709342567,1616.003460207626,132567.5605536333,1414,3,347.2432432432432,33,4,18,35.30890804597703,0.6363636363636364,44.117647058823536,1023.5294117647064,31.01604278074868,0
1464,4,0,0,36,0.0,0.0,1.0,36,1100,700,400,0.6363636363636364,15,7,8,381.9799915520104,0.4087301587301588,0.13231315286668655,0.19799834695477334,126487.98791258539,2487.205330386977,128975.19324297237,1415,4,357.44444444444446,32,4,17,38.910244341240954,0.5934244791666667,48.51641414141414,1005.934343434343,31.435448232323218,8
1465,4,1,1,36,0.02702702702702703,0.02702702702702703,0.972972972972973,37,1150,900,250,0.782608695652174,14,9,5,376.175388434861,0.4142267267267267,0.13927348898993475,0.19702651532875395,126912.01814058959,2148.235544217687,129060.25368480728,1416,0,348.7567567567568,34,3,18,38.61920092942658,0.5931372549019608,48.095238095238095,1007.6190476190478,29.6358543417367,0
1466,4,2,0,38,0.05263157894736842,0.0,1.0,38,800,600,200,0.75,10,6,4,368.4826043565237,0.4187707444286392,0.15770302395133018,0.19504002117482844,127339.27455786237,1784.7166072311293,129123.9911650935,1417,0,340.39473684210526,33,5,16,38.37370487291564,0.5997474747474747,47.67156862745098,1009.3137254901962,30.585264408793826,0
1467,4,1,0,39,0.02564102564102564,0.0,1.0,39,900,600,300,0.6666666666666666,12,6,6,358.53862577882137,0.42349865047233465,0.15858778049590794,0.19144609640642704,127692.92091836718,1356.568877551002,129049.48979591818,1418,0,332.64102564102564,34,5,17,38.26192579505301,0.6011029411764706,47.32142857142856,1010.7142857142843,29.72689075630248,0
1468,4,0,1,38,0.0,0.02564102564102564,0.9743589743589743,39,1600,1000,600,0.625,22,10,12,361.39835576617367,0.422795771479982,0.16410491164439422,0.1937361247045903,127851.72994898817,1441.0809970850257,129292.8109460732,1419,1,333.64102564102564,35,4,18,38.02691309987029,0.6005952380952381,47.16435185185184,1011.3425925925912,28.895502645502606,0
1469,4,1,1,38,0.02564102564102564,0.02564102564102564,0.9743589743589743,39,1450,1200,250,0.8275862068965517,17,12,5,349.84943392727325,0.4273504273504274,0.1442999920888166,0.18933409995655934,128232.43694540879,1172.7439932698726,129405.18093867866,1420,0,318.7435897435897,35,4,19,37.929593760713075,0.6044642857142857,46.788194444444436,1012.8472222222208,28.938492063492024,0
1470,4,2,3,37,0.05,0.075,0.925,40,1050,700,350,0.6666666666666666,14,7,7,337.39167460596525,0.4328258547008547,0.13194984868136617,0.18448863909304886,128644.60699445964,680.723876577387,129325.33087103702,1421,0,290.975,37,3,17,37.824704568381605,0.6047297297297297,46.38157894736841,1014.4736842105248,27.418207681365534,0
1471,4,1,1,37,0.02631578947368421,0.02631578947368421,0.9736842105263158,38,1000,700,300,0.7,13,7,6,356.83993244511163,0.4259127548601233,0.1543619322278298,0.19439787364547131,128496.33487654323,1570.5246913580268,130066.85956790127,1422,0,307.2368421052632,35,3,18,37.482876712328775,0.6071428571428572,46.52777777777778,1013.888888888889,28.968253968253972,0
1472,4,0,0,37,0.0,0.0,1.0,37,900,700,200,0.7777777777777778,11,7,4,366.49218413723924,0.42486236236236236,0.15976286290988062,0.19955546292280876,128476.2188208616,2017.1060090702872,130493.32482993188,1423,1,316.0810810810811,34,3,18,37.25878738061688,0.6090686274509804,46.547619047619044,1013.8095238095232,29.81792717086833,0
1473,4,0,0,37,0.0,0.0,1.0,37,1450,1100,350,0.7586206896551724,18,11,7,367.39706627873636,0.4239239239239239,0.15994163177261767,0.20065532081377155,128596.93877551025,2049.227607709756,130646.16638322,1424,2,317.0810810810811,34,3,19,37.11243153364633,0.6102941176470589,46.42857142857143,1014.2857142857147,29.831932773109255,0
1474,4,2,0,39,0.05128205128205128,0.0,1.0,39,1300,900,400,0.6923076923076923,17,9,8,357.9400850519737,0.43004948268106163,0.18261496454987713,0.19936071074966294,129373.18019032561,1461.5694241539024,130834.74961447952,1425,0,301.7692307692308,36,3,21,36.56072430078961,0.6140046296296297,45.66441441441442,1017.3423423423435,28.25950950950954,0
1475,4,0,2,37,0.0,0.05128205128205128,0.9487179487179487,39,1350,900,450,0.6666666666666666,18,9,9,359.88027438523756,0.42985267656320286,0.17958931236204934,0.20102582941247105,129487.77113261927,1520.018920947989,131007.79005356725,1426,1,302.7692307692308,36,3,17,36.39471306336208,0.615162037037037,45.55180180180181,1017.7927927927941,28.272022022022057,0
1476,4,1,0,38,0.02631578947368421,0.0,1.0,38,1100,700,400,0.6363636363636364,15,7,8,364.43577843049644,0.42616465149359883,0.1853591127170049,0.2042233107408604,129613.56122470848,1847.1638160150892,131460.72504072357,1427,0,305.42105263157896,35,3,18,36.150735015533854,0.618452380952381,45.42824074074074,1018.2870370370368,29.093915343915338,0
1477,4,0,0,38,0.0,0.0,1.0,38,1250,1000,250,0.8,15,10,5,362.78704087052165,0.4257053105737316,0.17646109137875365,0.20391133676515524,129731.44531250001,1812.9774305555566,131544.42274305556,1428,1,306.42105263157896,35,3,18,36.07276755282889,0.6196428571428572,45.3125,1018.7500000000001,29.10714285714286,0
1478,4,0,1,37,0.0,0.02631578947368421,0.9736842105263158,38,1150,900,250,0.782608695652174,14,9,5,366.75535324181476,0.42549786628733993,0.1739520313732994,0.20645231009852524,129790.40745027429,1920.2653463648765,131710.67279663918,1429,2,307.42105263157896,35,3,18,35.91170679993942,0.6202380952380953,45.254629629629626,1018.981481481481,29.1137566137566,0
1479,4,0,0,37,0.0,0.0,1.0,37,1150,600,550,0.5217391304347826,17,6,11,378.92819495264865,0.4211398898898899,0.17356922241241035,0.2130661952959769,129746.60572562364,2432.9294217687143,132179.53514739237,1430,3,316.43243243243245,34,3,19,35.646227701176294,0.6219362745098039,45.29761904761905,1018.8095238095242,29.96498599439777,0
1480,4,0,0,37,0.0,0.0,1.0,37,1250,1200,50,0.96,13,12,1,379.55610104189,0.42123373373373374,0.174268149513362,0.21441414573369033,129928.59977324256,2463.038548752823,132391.6383219954,1431,4,317.43243243243245,34,3,20,35.444885567491816,0.6237745098039216,45.11904761904761,1019.523809523809,29.985994397759086,0
1481,4,0,0,37,0.0,0.0,1.0,37,1300,800,500,0.6153846153846154,18,8,10,380.28469696342916,0.4203578578578579,0.18229289842870577,0.21599868374244882,130141.08737244905,2498.1327947845934,132639.22016723364,1432,5,318.43243243243245,34,3,20,35.21005911406682,0.6259191176470589,44.91071428571429,1020.3571428571433,30.010504201680686,0
1482,4,0,0,37,0.0,0.0,1.0,37,750,700,50,0.9333333333333333,8,7,1,380.5919883314997,0.4204517017017017,0.1848454472667207,0.2166796618827544,130232.20663265316,2513.0668934240466,132745.27352607722,1433,6,319.43243243243245,34,3,20,35.10953658346939,0.6268382352941176,44.82142857142858,1020.7142857142866,30.02100840336137,0
1483,4,0,0,37,0.0,0.0,1.0,37,1600,1200,400,0.75,20,12,8,380.28750356558953,0.42004504504504503,0.18878057322981734,0.21737421500107157,130387.718966263,2516.9675713422685,132904.68653760527,1434,7,320.43243243243245,33,4,20,34.95920326373891,0.6306818181818181,44.669117647058826,1021.323529411765,30.949197860962574,0
1484,4,0,0,37,0.0,0.0,1.0,37,450,200,250,0.4444444444444444,7,2,5,381.9127716148433,0.4202327327327327,0.18484735485335357,0.2184792691427397,130419.01139285363,2561.7372224625055,132980.74861531614,1435,8,321.43243243243245,33,4,20,34.885897820435915,0.6309974747474747,44.63848039215686,1021.4460784313719,30.95291146761733,0
1485,4,0,0,37,0.0,0.0,1.0,37,800,600,200,0.75,10,6,4,383.8931732311992,0.42020145145145144,0.19031693564067642,0.22050062429395323,130575.52984429065,2625.410899653979,133200.94074394464,1436,9,322.43243243243245,33,4,17,34.67625899280576,0.6325757575757576,44.48529411764706,1022.0588235294117,30.971479500891263,0
1486,4,0,0,37,0.0,0.0,1.0,37,1700,1400,300,0.8235294117647058,20,14,6,383.568340390264,0.4198260760760761,0.18999446373748063,0.22147978364470064,130779.59183673457,2632.5821995464694,133412.17403628104,1437,10,323.43243243243245,34,3,17,34.47732386716326,0.6323529411764706,44.28571428571428,1022.8571428571419,30.08403361344535,0
1487,4,0,0,37,0.0,0.0,1.0,37,700,400,300,0.5714285714285714,10,4,6,383.0388834961737,0.4194507007007007,0.1902961840127304,0.22152329507174393,130840.48327664383,2623.39852607708,133463.88180272092,1438,11,324.43243243243245,34,3,17,34.42905903343417,0.6329656862745099,44.22619047619047,1023.0952380952369,30.091036414565792,0
1488,4,0,0,37,0.0,0.0,1.0,37,1100,700,400,0.6363636363636364,15,7,8,381.67524347601636,0.41910660660660665,0.19195885428292092,0.22125839974128883,130931.84700963715,2594.688917233555,133526.5359268707,1439,12,325.43243243243245,34,3,18,34.37124384475204,0.6338848039215687,44.13690476190476,1023.4523809523806,30.10154061624649,0
1489,4,0,0,37,0.0,0.0,1.0,37,650,400,250,0.6153846153846154,9,4,5,382.3751550877819,0.41882507507507505,0.19534012440164306,0.222015122120178,130992.77388038544,2617.676445578225,133610.45032596367,1440,13,326.43243243243245,34,3,19,34.29153583750047,0.6344975490196079,44.07738095238095,1023.6904761904759,30.10854341736694,0
1490,4,1,0,38,0.02631578947368421,0.0,1.0,38,1100,700,400,0.6363636363636364,15,7,8,378.5286260608292,0.4205192034139402,0.1898269244872519,0.22206325120135267,131389.14399092953,2347.339143990914,133736.48313492045,1441,0,318.8157894736842,34,4,20,33.98842700108378,0.6384803921568627,43.69047619047618,1025.2380952380938,30.154061624649817,0
1491,4,1,0,39,0.02564102564102564,0.0,1.0,39,650,300,350,0.46153846153846156,10,3,7,370.11944239463423,0.4211369770580297,0.19409458381041622,0.21881461434370766,131684.26890432087,1947.7816358024554,133632.0505401233,1442,0,311.61538461538464,35,4,17,33.905615696887686,0.6392857142857142,43.40277777777777,1026.388888888888,29.3253968253968,0
1492,4,0,1,38,0.0,0.02564102564102564,0.9743589743589743,39,1100,600,500,0.5454545454545454,16,6,10,367.81382639421327,0.4211088618983356,0.18898588920002224,0.21830181147798336,131832.80452942807,1897.9856556498546,133730.79018507793,1443,1,312.61538461538464,35,4,18,33.81477985649348,0.6407738095238096,43.25810185185185,1026.967592592592,29.341931216931197,0
1493,4,0,1,37,0.0,0.02631578947368421,0.9736842105263158,38,900,500,400,0.5555555555555556,13,5,8,377.0199537912206,0.41954125177809387,0.18921434019832195,0.2234912097215997,131786.11288265296,2337.198837868471,134123.31172052142,1444,2,321.7894736842105,34,4,19,33.625603864734295,0.6424632352941176,43.30357142857142,1026.7857142857135,30.199579831932752,0
1494,4,0,1,36,0.0,0.02702702702702703,0.972972972972973,37,950,800,150,0.8421052631578947,11,8,3,386.6148772253675,0.4199512012012012,0.18853754685695523,0.2290706818524843,131768.13755526708,2788.7044646289737,134556.84201989605,1445,3,314.0810810810811,33,4,20,33.39748945651309,0.6445707070707071,43.32107843137254,1026.7156862745087,31.112596553772992,0
1495,4,0,0,36,0.0,0.0,1.0,36,1100,900,200,0.8181818181818182,13,9,4,389.3767838448987,0.4194113756613757,0.17845625111029095,0.2305915971917605,131749.07415378533,3060.006153708803,134809.08030749412,1446,4,312.3611111111111,32,4,20,33.34588816463738,0.6468098958333333,43.339646464646464,1026.6414141414143,32.0825441919192,0
1496,4,0,0,36,0.0,0.0,1.0,36,1000,600,400,0.6,14,6,8,389.16407793179644,0.4184358465608466,0.18291134054408387,0.23145021476996322,131911.15702479339,3067.0167584940277,134978.1737832874,1447,5,313.3611111111111,32,4,21,33.18737708947885,0.6484375,43.18181818181818,1027.2727272727273,32.10227272727273,0
1497,4,0,0,36,0.0,0.0,1.0,36,1350,1100,250,0.8148148148148148,16,11,5,386.90192057815517,0.4183201058201058,0.15251345057415855,0.21557447950602984,129388.3437259708,2812.11973760092,132200.4634635717,1448,6,314.3611111111111,33,3,20,35.80864048823576,0.6205808080808081,45.64950980392157,1017.4019607843139,30.830362448009513,7
1498,4,0,0,36,0.0,0.0,1.0,36,1250,900,350,0.72,16,9,7,385.7845512156546,0.4191137566137566,0.15030239777349585,0.21529266890422014,129450.69204152249,2788.0154267589346,132238.7074682814,1449,7,315.3611111111111,33,3,17,35.77342244701347,0.6212121212121212,45.588235294117645,1017.6470588235294,30.83778966131907,0
1499,4,0,0,36,0.0,0.0,1.0,36,950,600,350,0.631578947368421,13,6,7,387.21725042611735,0.4181216931216931,0.15756122681005325,0.2166069831171552,129544.24267409161,2832.353091359084,132376.5957654507,1450,8,316.3611111111111,33,3,17,35.641502146783836,0.6221590909090908,45.49632352941176,1018.0147058823524,30.848930481283404,0
1500,4,1,0,37,0.02702702702702703,0.0,1.0,37,1100,900,200,0.8181818181818182,13,9,4,376.15565395703055,0.4196696696696696,0.15166953919581783,0.21216368308169292,129867.92091836741,2370.1105442176895,132238.0314625851,1451,0,308.7837837837838,34,3,19,35.59331931791635,0.6231617647058824,45.17857142857143,1019.2857142857149,29.978991596638675,0
1501,4,0,0,37,0.0,0.0,1.0,37,750,500,250,0.6666666666666666,10,5,5,367.6850503449232,0.41951326326326327,0.14765985497692746,0.20851708778329903,130080.35891439911,2165.720663265306,132246.0795776644,1452,1,309.7837837837838,34,3,19,35.59317501069747,0.6253063725490196,44.970238095238095,1020.1190476190478,30.00350140056023,0
1502,4,0,0,37,0.0,0.0,1.0,37,1100,800,300,0.7272727272727273,14,8,6,366.4856239167052,0.419481981981982,0.14724526159765383,0.20799879450107023,130110.72137188194,2136.741780045336,132247.46315192728,1453,2,310.7837837837838,34,3,19,35.5929113185531,0.6256127450980392,44.94047619047618,1020.238095238094,30.007002801120414,0
1503,4,0,0,37,0.0,0.0,1.0,37,650,400,250,0.6153846153846154,9,4,5,399.3775023474913,0.419044044044044,0.1729162658349619,0.2136149406343599,127761.2954832417,2853.5376667885002,130614.8331500302,1454,3,311.7837837837838,32,5,18,37.15967278631199,0.6064453125,47.25378787878789,1010.98484848485,31.59327651515156,8
1504,4,1,0,38,0.02631578947368421,0.0,1.0,38,1550,1200,350,0.7741935483870968,19,12,7,389.6741053828997,0.4211711711711712,0.16838349047894896,0.21124169371806145,128299.67928501076,2399.0125492599236,130698.69183427068,1455,0,304.55263157894734,33,5,19,36.85221866053788,0.6095328282828283,46.72181372549021,1013.1127450980408,30.700386215092145,0
1505,4,0,1,37,0.0,0.02631578947368421,0.9736842105263158,38,900,600,300,0.6666666666666666,12,6,6,393.1325269651946,0.4211859886201992,0.16533900030540494,0.21394685941158526,128454.92118416021,2499.961553248783,130954.88273740899,1456,1,305.55263157894734,33,5,17,36.605415860735015,0.6111111111111112,46.56862745098041,1013.7254901960806,30.718954248366078,0
1506,4,0,0,37,0.0,0.0,1.0,37,1050,800,250,0.7619047619047619,13,8,5,405.6285052646924,0.41841841841841837,0.16640512927579976,0.220268902791233,128368.35048719536,3013.9724262830555,131382.32291347842,1457,6,314.7837837837838,32,5,17,36.37760611346457,0.6126302083333333,46.654040404040416,1013.3838383838398,31.668244949494994,0
1507,4,1,0,38,0.02631578947368421,0.0,1.0,38,750,600,150,0.8,9,6,3,391.5055160459763,0.42214912280701755,0.16077352279515456,0.21473170092005164,128765.68657487525,2482.4953143022126,131248.18188917745,1458,0,307.4736842105263,33,5,19,36.32828221846574,0.6142676767676767,46.262254901960794,1014.9509803921585,30.756090314913894,0
1508,4,1,0,39,0.02564102564102564,0.0,1.0,39,1050,700,350,0.6666666666666666,14,7,7,385.89281824946755,0.4254948268106163,0.16358728128256161,0.21383119889891022,129171.13272392307,2169.242488662152,131340.37521258523,1459,0,300.56410256410254,34,5,20,36.05613459811843,0.6161151960784313,45.86309523809525,1016.5476190476204,29.89845938375354,0
1509,4,2,1,40,0.04878048780487805,0.024390243902439025,0.975609756097561,41,950,700,250,0.7368421052631579,12,7,5,383.15741725720403,0.4285060975609756,0.15201657107209265,0.2128241267992772,129265.58036169768,1995.7579102194795,131261.33827191716,1460,0,286.8536585365854,32,9,21,36.02919874182602,0.6217447916666667,45.770202020202014,1016.9191919191911,31.778724747474723,8
1510,4,1,2,39,0.024390243902439025,0.04878048780487805,0.9512195121951219,41,1000,800,200,0.8,12,8,4,370.73280891264255,0.42789634146341465,0.17217816349942616,0.20837740638883012,129731.4453125,1419.1406250000005,131150.5859375,1461,0,287.609756097561,33,8,19,35.87039877300613,0.6240530303030303,45.3125,1018.75,30.87121212121212,0
1511,4,1,0,40,0.025,0.0,1.0,40,1200,700,500,0.5833333333333334,17,7,10,377.214111843065,0.4270032051282051,0.17628300483451076,0.21175965485302742,129683.21352731867,1783.667642332414,131466.88116965108,1462,0,294.65,32,8,20,35.75446262551134,0.6259765625,45.359848484848484,1018.5606060606063,31.83001893939395,0
1512,4,1,2,39,0.024390243902439025,0.04878048780487805,0.9512195121951219,41,850,500,350,0.5882352941176471,12,5,7,375.0621400477176,0.4288871951219512,0.19050112106347417,0.2131984525523232,130171.45691609973,1564.4770408163224,131735.93395691607,1463,0,288.4390243902439,34,7,22,35.312402784258836,0.6262254901960784,44.88095238095238,1020.4761904761901,30.014005602240886,0
1513,4,0,0,39,0.0,0.0,1.0,39,900,600,300,0.6666666666666666,12,6,6,388.78628883136105,0.4250168690958165,0.20970167652859972,0.21974877194816045,129950.01922337554,2304.557141484036,132254.57636485956,1464,1,303.56410256410254,33,6,22,35.18780048076923,0.6262626262626263,45.09803921568627,1019.6078431372542,30.897207367795584,0
1514,4,0,0,39,0.0,0.0,1.0,39,1100,700,400,0.6363636363636364,15,7,8,392.1316429903658,0.4234424201529465,0.2144062888897107,0.222350394840041,130075.00120146085,2401.3047866205166,132476.30598808138,1465,2,304.56410256410254,33,6,22,34.97517219285601,0.6275252525252526,44.975490196078425,1020.0980392156853,30.912061794414704,0
1515,4,2,1,40,0.04878048780487805,0.024390243902439025,0.975609756097561,41,1200,900,300,0.75,15,9,6,374.18149574401036,0.42576219512195124,0.21395381459206364,0.21596948571780844,130763.47588667825,1586.1249279123458,132349.6008145906,1466,0,290.6585365853659,33,8,22,34.733704768751494,0.634469696969697,44.3014705882353,1022.7941176470592,30.993761140819977,0
1516,4,1,0,41,0.024390243902439025,0.0,1.0,41,1100,800,300,0.7272727272727273,14,8,6,376.12848628561346,0.4277439024390244,0.21611460729255438,0.21886696597511032,131077.01965590153,1660.3601980007625,132737.3798539023,1467,0,280.4634146341463,33,8,23,34.36602441359501,0.6376262626262627,43.995098039215684,1024.019607843137,31.030897207367786,0
1517,4,0,2,39,0.0,0.04878048780487805,0.9512195121951219,41,1400,900,500,0.6428571428571429,19,9,10,376.92593598469,0.4273119918699187,0.2181056268566992,0.21968946812831497,131139.7734645328,1685.9963715878428,132825.76983612066,1468,1,281.4634146341463,33,8,23,34.282025205392046,0.6382575757575757,43.93382352941176,1024.2647058823525,31.03832442067735,0
1518,4,0,0,39,0.0,0.0,1.0,39,1100,700,400,0.6363636363636364,15,7,8,384.9446489030117,0.4250730994152047,0.21361722854260168,0.2233891387728501,130972.46334876544,2283.4297839506144,133255.89313271604,1469,2,293.4102564102564,32,7,23,34.24638172772501,0.6389973958333333,44.09722222222222,1023.6111111111112,31.987847222222225,0
1519,4,0,0,39,0.0,0.0,1.0,39,1050,700,350,0.6666666666666666,14,7,7,381.4216037533498,0.4250730994152047,0.19752419049678394,0.2111918062805512,129140.88010204076,2051.9065728143028,131192.78667485504,1470,3,294.4102564102564,34,5,22,36.200661747481846,0.6158088235294117,45.89285714285714,1016.4285714285709,29.89495798319326,8
1520,4,0,0,39,0.0,0.0,1.0,39,1500,1200,300,0.8,18,12,6,381.28191346412234,0.4256354026090868,0.19461958806221102,0.21143815201192265,129201.38888888904,2052.4589002267767,131253.84778911583,1471,4,295.4102564102564,32,7,23,36.14241803278688,0.62109375,45.83333333333334,1016.6666666666679,31.77083333333337,0
1521,4,0,0,39,0.0,0.0,1.0,39,1100,900,200,0.8181818181818182,13,9,4,383.07168939795866,0.42535425101214575,0.19848159289500034,0.2129497900690516,129297.68207644636,2106.0563016528995,131403.73837809925,1472,5,296.4102564102564,32,7,23,35.998603351955296,0.6220703125,45.73863636363637,1017.0454545454552,31.782670454545475,0
1522,4,0,1,38,0.0,0.02564102564102564,0.9743589743589743,39,1200,700,500,0.5833333333333334,17,7,10,387.6546035711533,0.4255510571300045,0.19676679361503813,0.21620127682906046,129426.1287910672,2234.5269296500355,131660.65572071724,1473,6,297.4102564102564,32,7,19,35.75092029614924,0.6233723958333333,45.61237373737374,1017.5505050505047,31.798453282828273,0
1523,4,0,0,38,0.0,0.0,1.0,38,1500,1100,400,0.7333333333333333,19,11,8,394.3858358915597,0.42580903271692744,0.20610986254115948,0.21941797610099475,129329.78777675744,2601.1672916028956,131930.95506836034,1474,7,306.05263157894734,32,6,23,35.6781177590202,0.6223958333333333,45.707070707070706,1017.1717171717169,31.786616161616152,0
1524,4,0,0,38,0.0,0.0,1.0,38,1350,700,650,0.5185185185185185,20,7,13,392.81012738040005,0.4253645092460882,0.19320629450371252,0.21991014408870346,129575.43372741232,2579.7085255670663,132155.1422529794,1475,8,307.05263157894734,33,5,21,35.46732065479056,0.6224747474747474,45.46568627450979,1018.1372549019591,30.852644087938152,0
1525,4,0,0,38,0.0,0.0,1.0,38,850,500,350,0.5882352941176471,12,5,7,392.1063135763829,0.42546823138928397,0.19103724296905145,0.2200402141886101,129669.02941476817,2568.809021770446,132237.83843653862,1476,9,308.05263157894734,33,5,21,35.38971944812096,0.6234217171717171,45.37377450980391,1018.5049019607828,30.86378490790251,0
1526,4,0,0,38,0.0,0.0,1.0,38,1300,1000,300,0.7692307692307693,16,10,6,388.8882882806842,0.42580903271692744,0.18791840143759253,0.21945541261321083,129887.55076172612,2502.349456939618,132389.90021866575,1477,10,309.05263157894734,33,5,23,35.24885789853329,0.6256313131313131,45.159313725490186,1019.3627450980381,30.889780154486004,0
1527,4,0,0,38,0.0,0.0,1.0,38,1050,600,450,0.5714285714285714,15,6,9,387.45030510355093,0.42601647700331907,0.18819585020242968,0.21899365071070218,129950.0192233753,2469.834919261785,132419.85414263708,1478,11,310.05263157894734,33,5,23,35.22185496794871,0.6262626262626263,45.098039215686256,1019.6078431372523,30.897207367795524,0
1528,4,0,0,38,0.0,0.0,1.0,38,850,400,450,0.47058823529411764,13,4,9,387.38945820632074,0.4255867709815078,0.1907618077995663,0.21948553169851648,130043.75007509124,2475.5155769415505,132519.2656520328,1479,12,311.05263157894734,33,5,23,35.127933637710754,0.627209595959596,45.00612745098039,1019.9754901960779,30.908348187759938,0
1529,4,0,0,38,0.0,0.0,1.0,38,1250,1000,250,0.8,15,10,5,390.1895408922436,0.4257349454717876,0.19619724988146015,0.22142657995418727,130106.2560823961,2553.220065599756,132659.47614799585,1480,13,312.05263157894734,33,5,23,34.99286786786786,0.6278409090909092,44.944852941176464,1020.2205882352933,30.915775401069496,0
1530,4,0,0,38,0.0,0.0,1.0,38,550,100,450,0.18181818181818182,10,1,9,390.73324494186056,0.42521633475580844,0.20140850259105614,0.22210645727066466,130171.45691609949,2572.463151927407,132743.9200680269,1481,14,313.05263157894734,34,4,23,34.912603048685654,0.6262254901960784,44.880952380952365,1020.4761904761881,30.014005602240825,0
1531,4,0,0,38,0.0,0.0,1.0,38,1100,800,300,0.7272727272727273,14,8,6,388.3381924198252,0.4250385253674727,0.20010741138560695,0.22126245847176088,130262.58680555549,2517.2512755102,132779.83808106568,1482,15,314.05263157894734,32,6,23,34.88095238095238,0.6318359375,44.791666666666664,1020.8333333333328,31.90104166666665,0
1532,4,0,1,37,0.0,0.02631578947368421,0.9736842105263158,38,900,800,100,0.8888888888888888,10,8,2,387.63908521041276,0.42465327169274536,0.2030144901132791,0.22159806079625644,130391.51178770026,2508.9692697173787,132900.48105741764,1483,16,315.05263157894734,32,6,23,34.76763712036923,0.6331380208333333,44.66540404040404,1021.3383838383841,31.916824494949502,0
1533,4,0,1,36,0.0,0.02702702702702703,0.972972972972973,37,1050,800,250,0.7619047619047619,13,8,5,394.55867535191385,0.4241741741741742,0.2062128404213548,0.22596404137307394,130462.04460991739,2894.9863009982455,133357.03091091564,1484,17,322.0,31,6,23,34.519181748661744,0.6364247311827957,44.59635416666666,1021.6145833333321,32.95530913978491,0
1534,4,0,0,36,0.0,0.0,1.0,36,950,600,350,0.631578947368421,13,6,7,395.854834273898,0.4239583333333334,0.19668818391585674,0.22729075305163288,130561.83073255737,3136.7063734266303,133698.537105984,1485,18,320.3611111111111,31,5,19,34.38455535737035,0.6374327956989247,44.49869791666666,1022.0052083333322,32.967909946236524,0
1535,4,0,0,36,0.0,0.0,1.0,36,550,300,250,0.5454545454545454,8,3,5,391.7377235349121,0.42390873015873015,0.19215203486726717,0.22550766900264863,130661.65500217,3037.0198567708144,133698.67485894082,1486,19,321.3611111111111,31,5,19,34.388266259127185,0.6384408602150538,44.40104166666666,1022.3958333333321,32.98051075268813,0
1536,4,0,1,35,0.0,0.027777777777777776,0.9722222222222222,36,1150,800,350,0.6956521739130435,15,8,7,388.4577280535529,0.42243716931216935,0.1934903673550159,0.22536281920509063,130961.35669284382,2974.590216742603,133935.94690958643,1487,20,322.3611111111111,31,5,20,34.167753254462966,0.6414650537634409,44.10807291666666,1023.5677083333321,33.01831317204297,0
1537,4,0,0,35,0.0,0.0,1.0,35,1100,800,300,0.7272727272727273,14,8,6,388.45574357224586,0.4235294117647059,0.17783361146007204,0.22609964173238642,131087.14022213535,3184.310505549758,134271.45072768512,1488,21,309.42857142857144,30,5,20,34.040173688585554,0.6454861111111111,43.98521505376343,1024.059139784945,34.13530465949817,0
1538,4,0,0,35,0.0,0.0,1.0,35,950,600,350,0.631578947368421,13,6,7,390.2673583124946,0.4230392156862745,0.18040494938132756,0.22735758947562756,131121.55306971903,3234.492426870161,134356.04549658918,1489,22,310.42857142857144,30,5,20,33.958880139982504,0.6458333333333333,43.95161290322581,1024.1935483870966,34.13978494623655,0
1539,4,1,0,36,0.027777777777777776,0.0,1.0,36,1150,900,250,0.782608695652174,14,9,5,378.55088939279415,0.42723214285714284,0.17401410934744277,0.22230337464341937,131428.24172973633,2750.455559624565,134178.6972893609,1490,0,302.77777777777777,31,5,21,33.94828042328043,0.6461693548387097,43.65234375,1025.390625,33.07711693548387,0
1540,4,0,0,36,0.0,0.0,1.0,36,900,500,400,0.5555555555555556,13,5,8,380.2433673562447,0.42683531746031744,0.17594002990042612,0.22388320239405798,131528.3966064453,2802.560085720485,134330.9566921658,1491,1,303.77777777777777,31,5,22,33.80352458322755,0.6471774193548387,43.5546875,1025.78125,33.08971774193548,0
1541,4,0,0,36,0.0,0.0,1.0,36,1400,1000,400,0.7142857142857143,18,10,8,376.9627635638869,0.426603835978836,0.16963404663227077,0.22273017259449446,131661.99578179244,2726.3339572482582,134388.3297390407,1492,2,304.77777777777777,31,5,17,33.752537427048985,0.648521505376344,43.424479166666664,1026.3020833333328,33.10651881720428,0
1542,4,0,1,35,0.0,0.027777777777777776,0.9722222222222222,36,1050,900,150,0.8571428571428571,12,9,3,377.470638053073,0.42567791005291006,0.1687448924958439,0.2238145452395889,131795.66277397997,2749.7985839843645,134545.46135796435,1493,3,305.77777777777777,31,5,17,33.604383295291235,0.6498655913978495,43.29427083333333,1026.822916666666,33.1233198924731,0
1543,4,0,0,35,0.0,0.0,1.0,35,750,600,150,0.8,9,6,3,390.9299941469939,0.42065826330532213,0.17668188281074682,0.23104809870792892,131672.77286391478,3294.96726500172,134967.7401289165,1494,27,315.42857142857144,30,5,18,33.383261306093935,0.6513888888888889,43.41397849462365,1026.3440860215044,34.211469534050146,0
1544,4,0,0,35,0.0,0.0,1.0,35,1100,700,400,0.6363636363636364,15,7,8,389.2086404432681,0.42051820728291317,0.17578274043317288,0.23044772059733964,131741.75663371483,3255.0059978032095,134996.76263151804,1495,28,316.42857142857144,30,5,18,33.35760888539758,0.6520833333333333,43.346774193548384,1026.6129032258061,34.22043010752687,0
1545,4,1,0,36,0.027777777777777776,0.0,1.0,36,450,400,50,0.8888888888888888,5,4,1,378.3029883735016,0.4225033068783069,0.17462629845452304,0.2258943865522255,132063.2002088758,2791.9806586371487,134855.18086751294,1496,0,308.6111111111111,31,5,19,33.31274807870958,0.6525537634408602,43.033854166666664,1027.8645833333328,33.15692204301074,0
1546,4,0,0,36,0.0,0.0,1.0,36,1050,800,250,0.7619047619047619,13,8,5,377.7415726785903,0.4229001322751323,0.17812319727604065,0.22615808941947152,132163.5966830784,2784.736972384992,134948.3336554634,1497,1,309.6111111111111,31,5,19,33.225829428897065,0.6535618279569892,42.93619791666667,1028.2552083333337,33.169522849462375,0
1547,4,0,0,36,0.0,0.0,1.0,36,1050,800,250,0.7619047619047619,13,8,5,379.43868322152633,0.42251984126984127,0.1847703816192805,0.22818298895102765,132331.00891113293,2842.300754123278,135173.3096652562,1498,2,310.6111111111111,31,5,19,33.01326668354003,0.655241935483871,42.77343750000001,1028.906250000001,33.19052419354842,0
1548,4,0,0,36,0.0,0.0,1.0,36,1050,1000,50,0.9523809523809523,11,10,1,381.5734042897934,0.4219246031746032,0.18870967741935507,0.23007915796421183,132431.5071105958,2906.4682006836083,135337.9753112794,1499,3,311.6111111111111,31,5,19,32.856973434535114,0.65625,42.67578125000001,1029.2968750000007,33.20312500000002,0
1549,4,0,0,36,0.0,0.0,1.0,36,1250,1000,250,0.8,15,10,5,382.29983709984003,0.42151124338624335,0.18882425673017522,0.2311335712374263,132532.0434570313,2933.3957248264023,135465.4391818577,1500,4,312.6111111111111,31,5,19,32.736890912156476,0.657258064516129,42.57812500000001,1029.6875000000005,33.21572580645163,0
1550,4,0,0,36,0.0,0.0,1.0,36,1050,800,250,0.7619047619047619,13,8,5,382.5317083079095,0.42071759259259256,0.18624622727591755,0.23272394091138424,132766.7766147192,2957.5003729926475,135724.27698771184,1501,5,313.6111111111111,31,5,18,32.49434091387659,0.6596102150537635,42.35026041666668,1030.598958333335,33.2451276881721,0
1551,4,0,0,36,0.0,0.0,1.0,36,1200,800,400,0.6666666666666666,16,8,8,381.31232791873737,0.4196263227513228,0.18153596834617125,0.23281513683797092,132901.00309583885,2935.358174641933,135836.3612704808,1502,6,314.6111111111111,31,5,19,32.39058488024581,0.6609543010752688,42.220052083333336,1031.1197916666674,33.261928763440885,0
1552,4,0,0,36,0.0,0.0,1.0,36,950,600,350,0.631578947368421,13,6,7,379.98754300153195,0.4193287037037037,0.17817264935684318,0.23242326858031948,132968.14176771385,2905.2474975586047,135873.38926527245,1503,7,315.6111111111111,31,5,19,32.357157135041874,0.6616263440860215,42.15494791666667,1031.3802083333342,33.27032930107529,0
1553,4,0,0,36,0.0,0.0,1.0,36,1050,800,250,0.7619047619047619,13,8,5,377.54182049776557,0.41909722222222223,0.17234840518752126,0.23175979298565402,133102.46997409407,2850.349765353738,135952.81973944782,1504,8,316.6111111111111,31,5,19,32.28509463722398,0.6629704301075269,42.024739583333336,1031.9010416666674,33.28713037634411,0
1554,4,1,0,37,0.02702702702702703,0.0,1.0,37,1200,1000,200,0.8333333333333334,14,10,4,368.51197586534965,0.41985735735735735,0.16255025651675092,0.22910074991347,133573.15275404198,2445.174153645845,136018.32690768782,1505,0,309.02702702702703,31,6,20,32.04551895704749,0.6676747311827957,41.56901041666667,1033.7239583333342,33.34593413978497,0
1555,4,0,0,37,0.0,0.0,1.0,37,1050,500,550,0.47619047619047616,16,5,11,371.09575776685165,0.4190753253253254,0.16337364813819089,0.2313377164979856,133674.1214328343,2521.1798773871637,136195.30131022146,1506,1,310.02702702702703,31,6,20,31.877465793670765,0.6686827956989247,41.47135416666667,1034.1145833333342,33.35853494623659,0
1556,4,0,0,37,0.0,0.0,1.0,37,550,400,150,0.7272727272727273,7,4,3,371.8983539357578,0.41898148148148145,0.1640673906534933,0.23226104745799225,133741.45507812512,2547.645399305573,136289.10047743068,1507,2,311.02702702702703,31,6,14,31.7891910036925,0.6693548387096775,41.40625000000001,1034.375000000001,33.366935483870996,0
1557,4,1,1,37,0.02631578947368421,0.02631578947368421,0.9736842105263158,38,600,400,200,0.6666666666666666,8,4,4,360.82736571051424,0.42037102892366046,0.1618705035971224,0.22710247323038593,134027.3015030354,2072.1436269258247,136099.44512996124,1508,0,303.8157894736842,32,6,15,31.789314311262842,0.6695963541666667,41.130050505050505,1035.4797979797981,32.35874368686869,0
1558,4,0,0,37,0.0,0.0,1.0,37,850,500,350,0.5882352941176471,12,5,7,370.80123996541613,0.4187937937937938,0.1636241852621272,0.23263607391358282,133909.86336602116,2530.788675944032,136440.6520419652,1509,1,312.94594594594594,31,6,15,31.648766092170938,0.6710349462365591,41.24348958333334,1035.0260416666677,33.38793682795702,0
1559,4,0,0,37,0.0,0.0,1.0,37,950,800,150,0.8421052631578947,11,8,3,369.5125094986188,0.41841841841841837,0.16235931567336426,0.2322524871955351,133977.2563510472,2501.25444200305,136478.51079305026,1510,2,313.94594594594594,31,6,16,31.61460298494948,0.6717069892473118,41.17838541666667,1035.2864583333342,33.39633736559143,0
1560,4,0,1,36,0.0,0.02702702702702703,0.972972972972973,37,1050,800,250,0.7619047619047619,13,8,5,373.28625308687583,0.4175738238238238,0.1630930742181531,0.2354870851154718,134112.09318372948,2612.4401516384755,136724.53333536795,1511,3,314.94594594594594,31,6,17,31.381861512675478,0.6730510752688172,41.04817708333334,1035.8072916666677,33.413138440860244,0
1561,4,0,0,36,0.0,0.0,1.0,36,1350,1000,350,0.7407407407407407,17,10,7,380.8112317858114,0.41526124338624343,0.17756751470444443,0.23979348585847637,134044.66629028317,3009.1428968641503,137053.80918714733,1512,4,323.3611111111111,31,5,19,31.254584223982576,0.6723790322580645,41.11328125,1035.5468749999998,33.4047379032258,0
1562,4,0,0,36,0.0,0.0,1.0,36,1050,800,250,0.7619047619047619,13,8,5,382.3071163407448,0.4139054232804233,0.17795847376186025,0.24234433343947306,134288.91383851145,3067.9214812264217,137356.83531973787,1513,5,324.3611111111111,32,4,20,30.971088642546807,0.6722005208333333,40.87752525252526,1036.4898989898998,32.39030934343437,0
1563,4,1,0,37,0.02702702702702703,0.0,1.0,37,750,600,150,0.8,9,6,3,371.2565070310019,0.4153215715715716,0.16706630083465313,0.2372528552149201,134584.55615573455,2593.588595764448,137178.144751499,1514,0,316.56756756756755,31,6,21,30.961773748274567,0.677755376344086,40.592447916666664,1037.630208333333,33.471942204301065,0
1564,4,0,0,37,0.0,0.0,1.0,37,800,400,400,0.5,12,4,8,369.7959401140178,0.415477977977978,0.16618662458078504,0.2367385224094414,134649.04729109278,2558.534205693298,137207.58149678606,1515,1,317.56756756756755,32,5,21,30.935218978102196,0.67578125,40.53030303030303,1037.878787878788,32.433712121212125,0
1565,4,0,0,37,0.0,0.0,1.0,37,1250,900,350,0.72,16,9,7,370.2163638660153,0.4142267267267267,0.1744092457596773,0.23850979056583457,134878.47421500355,2586.843657534942,137465.3178725385,1516,2,318.56756756756755,32,5,16,30.695170373971884,0.6780598958333333,40.30934343434343,1038.762626262626,32.461332070707066,0
1566,4,0,0,37,0.0,0.0,1.0,37,550,400,150,0.7272727272727273,7,4,3,376.30900197688266,0.4137575075075075,0.17842435388000388,0.24309443377313542,134976.85982297725,2758.6014819916318,137735.4613049689,1517,3,319.56756756756755,32,5,16,30.43868975293641,0.6790364583333333,40.214646464646464,1039.141414141414,32.47316919191919,0
1567,4,0,1,36,0.0,0.02702702702702703,0.972972972972973,37,800,500,300,0.625,11,5,6,375.5545936195809,0.4129754754754755,0.1789699331300203,0.2432683689433524,135075.28130101511,2745.6284754106573,137820.90977642577,1518,4,320.56756756756755,32,5,17,30.360034819223436,0.6800130208333333,40.11994949494949,1039.5202020202014,32.485006313131294,0
1568,4,0,1,35,0.0,0.027777777777777776,0.9722222222222222,36,1050,700,350,0.6666666666666666,14,7,7,387.4769235247204,0.41149140211640217,0.1877340628436981,0.2504010790810361,134990.18563164613,3261.1163669162434,138251.30199856238,1519,11,330.3611111111111,31,5,18,30.135243077308616,0.6817876344086021,40.20182291666667,1039.1927083333342,33.522345430107556,0
1569,4,0,0,35,0.0,0.0,1.0,35,950,600,350,0.631578947368421,13,6,7,397.3237138496215,0.4106792717086835,0.19700454864834893,0.2553846100833756,134794.92752052261,3711.444242108917,138506.37176263152,1520,12,339.14285714285717,30,5,18,30.07485546639054,0.6826388888888889,40.38978494623656,1038.4408602150538,34.6146953405018,0
1570,4,0,0,35,0.0,0.0,1.0,35,1150,1000,150,0.8695652173913043,13,10,3,393.265647259873,0.41018907563025214,0.1965314306546535,0.2538182753961958,134944.06063475672,3613.7726698806327,138557.83330463734,1521,13,340.14285714285717,32,3,20,30.030987969376596,0.6787109375,40.246212121212125,1039.015151515152,32.4692234848485,0
1571,4,0,0,35,0.0,0.0,1.0,35,850,700,150,0.8235294117647058,10,7,3,394.1358405086316,0.40941876750700285,0.19598084131611837,0.2550728175367183,135042.4701561066,3645.0154958677795,138687.4856519744,1522,14,341.14285714285717,32,3,20,29.90995505344996,0.6796875,40.151515151515156,1039.39393939394,32.48106060606062,0
1572,4,0,1,34,0.0,0.02857142857142857,0.9714285714285714,35,1150,900,250,0.782608695652174,14,9,5,397.16258406574644,0.4098039215686275,0.19497267759562864,0.2577331662554312,135140.91554752062,3734.5830463728166,138875.49859389343,1523,15,342.14285714285717,32,3,20,29.73284760170006,0.6806640625,40.05681818181818,1039.772727272727,32.49289772727272,0
1573,4,0,0,34,0.0,0.0,1.0,34,750,600,150,0.8,9,6,3,406.76844945663373,0.4072526737967914,0.20442300463601093,0.26286793482699555,134990.1856316461,4181.949700249577,139172.13533189567,1524,16,352.4117647058824,31,3,20,29.63405275028193,0.6817876344086021,40.20182291666667,1039.192708333334,33.52234543010755,0
1574,4,0,1,33,0.0,0.029411764705882353,0.9705882352941176,34,950,700,250,0.7368421052631579,12,7,5,407.62701198121533,0.4067513368983957,0.21202622564367002,0.2644111852697001,135125.53109063057,4216.163296169727,139341.69438680029,1525,17,353.4117647058824,31,3,20,29.476231475683573,0.6831317204301075,40.07161458333334,1039.7135416666679,33.53914650537639,0
1575,4,0,0,33,0.0,0.0,1.0,33,1050,900,150,0.8571428571428571,12,9,3,403.90831615475287,0.40601325757575757,0.20266763782036668,0.2627377548407303,135227.08468967027,4323.868815104188,139550.95350477446,1526,18,359.4848484848485,31,2,20,29.471290268736446,0.6841397849462365,39.97395833333334,1040.1041666666679,33.551747311827995,0
1576,4,0,0,33,0.0,0.0,1.0,33,950,600,350,0.631578947368421,13,6,7,403.90831615475287,0.40601325757575757,0.20266763782036668,0.2627377548407303,135227.08468967027,4323.868815104188,139550.95350477446,1527,19,360.4848484848485,31,2,20,29.471290268736446,0.6841397849462365,39.97395833333334,1040.1041666666679,33.551747311827995,0
1577,4,0,0,33,0.0,0.0,1.0,33,1150,800,350,0.6956521739130435,15,8,7,403.90831615475287,0.4059343434343434,0.20266763782036668,0.2627377548407303,135227.08468967027,4323.868815104188,139550.95350477446,1528,20,361.4848484848485,31,2,20,29.471290268736446,0.6841397849462365,39.97395833333334,1040.1041666666679,33.551747311827995,0
1578,4,0,0,33,0.0,0.0,1.0,33,750,500,250,0.6666666666666666,10,5,5,386.6650447654343,0.4059343434343434,0.12584419325992346,0.22288969377617487,130714.10323245097,3508.5149155698664,134222.61814802085,1529,21,362.4848484848485,32,1,16,34.464645841050334,0.6363932291666667,44.34974747474749,1022.6010101010118,31.956281565656617,8
1579,4,0,0,33,0.0,0.0,1.0,33,1050,800,250,0.7619047619047619,13,8,5,386.1227414782555,0.40459280303030304,0.12077836608932357,0.2235099069242704,130875.54841342737,3506.8051091725583,134382.35352259994,1530,22,363.4848484848485,32,1,16,34.314587446528485,0.6380208333333333,44.191919191919204,1023.2323232323246,31.976010101010143,0
1580,4,0,0,33,0.0,0.0,1.0,33,1250,900,350,0.72,16,9,7,384.6132603296579,0.4030539772727273,0.12154105505530222,0.22319682902595134,130972.46334876561,3474.7492283950883,134447.2125771607,1531,23,364.4848484848485,32,1,17,34.25486205336953,0.6389973958333333,44.097222222222236,1023.6111111111126,31.987847222222268,0
1581,4,0,0,33,0.0,0.0,1.0,33,1000,700,300,0.7,13,7,6,386.98657941589204,0.4034090909090909,0.12180996151403067,0.22514068572904508,131069.41415416815,3544.420849913303,134613.83500408145,1532,24,365.4848484848485,32,1,17,34.09576654336211,0.6399739583333333,44.00252525252527,1023.9898989899006,31.999684343434392,0
1582,4,0,0,33,0.0,0.0,1.0,33,700,500,200,0.7142857142857143,9,5,4,386.9050426015782,0.40356691919191917,0.12301021943323698,0.22569010824191169,131171.15600069694,3550.1563401095927,134721.31234080653,1533,25,366.4848484848485,33,0,17,33.99467141205089,0.6385732323232323,43.903186274509814,1024.3872549019616,31.04203802733217,0
1583,4,0,0,33,0.0,0.0,1.0,33,1450,1000,450,0.6896551724137931,19,10,9,386.9317216802298,0.4026594065656566,0.1257713803884699,0.22739938086011782,131457.57607642087,3573.1151119706674,135030.69118839153,1534,26,367.4848484848485,32,1,17,33.70372650414513,0.6438802083333333,43.623737373737384,1025.5050505050515,32.04703282828286,0
1584,4,0,0,33,0.0,0.0,1.0,33,750,500,250,0.6666666666666666,10,5,5,387.3532231614923,0.40277777777777773,0.12491143281199846,0.22842034045067403,131587.09092184482,3594.136759004197,135181.22768084903,1535,27,368.4848484848485,32,1,14,33.56176675691197,0.6451822916666667,43.497474747474755,1026.010101010102,32.06281565656569,0
1585,4,0,0,33,0.0,0.0,1.0,33,650,500,150,0.7692307692307693,8,5,3,387.4782328458342,0.40222537878787884,0.1267888629187679,0.22907713125845744,131684.26890432113,3604.9575617284104,135289.22646604953,1536,28,369.4848484848485,32,1,14,33.46019395579613,0.6461588541666667,43.402777777777786,1026.38888888889,32.074652777777814,0
1586,4,1,0,34,0.029411764705882353,0.0,1.0,34,1000,600,400,0.6,14,6,8,377.77245646243034,0.407568330362448,0.12046621223596721,0.22569482655319564,132082.88278546729,3179.455017301053,135262.33780276834,1537,0,359.5882352941176,33,1,16,33.30650929899855,0.6477272727272727,43.01470588235295,1027.9411764705894,31.14973262032089,0
1587,4,0,0,34,0.0,0.0,1.0,34,650,200,450,0.3076923076923077,11,2,9,379.3526178184137,0.40689988116458703,0.12796500869175165,0.22739479776658042,132208.8860053825,3230.757400999613,135439.6434063821,1538,1,360.5882352941176,33,1,16,33.13870352716874,0.648989898989899,42.8921568627451,1028.4313725490192,31.164587046939975,0
1588,4,0,0,34,0.0,0.0,1.0,34,1200,800,400,0.6666666666666666,16,8,8,380.6699331927916,0.406027183600713,0.1277925301622127,0.2295282023215705,132430.49178655221,3282.596456574923,135713.08824312713,1539,2,361.5882352941176,32,2,18,32.88124591102388,0.6536458333333333,42.67676767676767,1029.292929292928,32.165404040404,0
1589,4,0,0,34,0.0,0.0,1.0,34,800,500,300,0.625,11,5,6,379.1419154780412,0.4058972073677956,0.12474570402112306,0.2290017169487368,132495.48037190072,3246.918044077127,135742.39841597783,1540,3,362.5882352941176,32,2,19,32.85504047093452,0.654296875,42.61363636363636,1029.5454545454538,32.17329545454543,0
1590,4,1,0,35,0.02857142857142857,0.0,1.0,35,1100,700,400,0.6363636363636364,15,7,8,369.64762596429455,0.40994397759103646,0.12117301455230911,0.2255145378707475,132871.38848339568,2823.118662293337,135694.50714568901,1541,0,353.2,33,2,16,32.72106165062007,0.6556186868686869,42.248774509803916,1031.0049019607834,31.242572786690406,0
1591,4,0,0,35,0.0,0.0,1.0,35,600,300,300,0.5,9,3,6,368.35907243233476,0.40983893557422973,0.12074488264304706,0.2248314253936891,132888.53635204065,2790.139597505648,135678.6759495463,1542,1,354.2,34,1,16,32.73702998114152,0.6534926470588236,42.23214285714285,1031.0714285714273,30.325630252100805,0
1592,4,0,0,35,0.0,0.0,1.0,35,550,400,150,0.7272727272727273,7,4,3,369.288055722984,0.4094537815126051,0.12072326237496811,0.22603675498648568,132994.2558299039,2822.638031550061,135816.89386145398,1543,2,355.2,35,0,17,32.60678485936566,0.6523809523809524,42.129629629629626,1031.4814814814808,29.470899470899454,0
1593,4,0,1,34,0.0,0.02857142857142857,0.9714285714285714,35,800,400,400,0.5,12,4,8,362.5642839615038,0.4080182072829132,0.11764328965495152,0.22298953685301326,133173.39275763032,2656.7831575788764,135830.1759152092,1544,3,356.2,35,0,17,32.60026538087762,0.6541666666666667,41.95601851851852,1032.175925925926,29.490740740740744,0
1594,4,0,0,34,0.0,0.0,1.0,34,600,300,300,0.5,9,3,6,369.5801353008642,0.40335338680926913,0.1200802231588376,0.22669150974186775,133072.72002551024,3036.2067743764214,136108.92679988666,1545,4,367.47058823529414,34,0,17,32.520383831391094,0.6553308823529411,42.05357142857143,1031.7857142857147,30.346638655462197,0
1595,4,0,0,34,0.0,0.0,1.0,34,1350,800,550,0.5925925925925926,19,8,11,370.65733462915813,0.40218360071301246,0.11918005209463867,0.22829122201023136,133226.30385487518,3076.2613378684673,136302.56519274364,1546,5,368.47058823529414,34,0,17,32.33827260147602,0.6568627450980392,41.9047619047619,1032.3809523809516,30.364145658263283,0
1596,4,0,0,34,0.0,0.0,1.0,34,950,600,350,0.631578947368421,13,6,7,372.71198099036246,0.40099524658348185,0.11485368697963283,0.2303168908171213,133349.23469387754,3140.1714852607683,136489.4061791383,1547,6,369.47058823529414,34,0,18,32.161758490856,0.6580882352941176,41.785714285714285,1032.8571428571427,30.378151260504197,0
1597,4,0,0,34,0.0,0.0,1.0,34,1350,800,550,0.5925925925925926,19,8,11,370.9709826003792,0.4008467023172906,0.1191605406687215,0.23039538050453606,133535.54672481748,3107.619285459288,136643.16601027676,1548,7,370.47058823529414,33,1,18,32.01970199984189,0.6622474747474747,41.60539215686275,1033.5784313725499,31.320558526440905,0
1598,4,0,0,34,0.0,0.0,1.0,34,900,600,300,0.6666666666666666,12,6,6,370.15497344596577,0.40079099821746883,0.11953300936351807,0.23047952110432576,133630.56163795176,3092.803398933106,136723.36503688488,1549,8,371.47058823529414,33,1,19,31.94547331199874,0.6631944444444444,41.513480392156865,1033.9460784313726,31.33169934640523,0
1599,4,0,0,34,0.0,0.0,1.0,34,1250,1100,150,0.88,14,11,3,371.0541837704024,0.400735294117647,0.1186300071106896,0.2312374595756763,133662.24078479435,3119.1867310649777,136781.42751585934,1550,9,372.47058823529414,33,1,19,31.890455874219796,0.663510101010101,41.4828431372549,1034.0686274509808,31.335412953060025,0
1600,4,0,0,34,0.0,0.0,1.0,34,1150,900,250,0.782608695652174,14,9,5,367.9366812155092,0.40064245395127746,0.1126969086817482,0.23028090433673454,133820.6928374906,3047.5083201172883,136868.2011576079,1551,10,373.47058823529414,33,1,16,31.812226104465243,0.6650883838383839,41.32965686274511,1034.6813725490213,31.353980986333976,0
1601,4,0,0,34,0.0,0.0,1.0,34,850,400,450,0.47058823529411764,13,4,9,350.2038136587579,0.4003825014854427,0.06024241258236773,0.19737293276712461,129837.58680555536,2293.923611111087,132131.51041666645,1552,11,374.47058823529414,34,0,17,36.28543199781956,0.6228553921568627,45.20833333333332,1019.166666666665,29.975490196078383,8
1602,4,0,0,34,0.0,0.0,1.0,34,750,600,150,0.8,9,6,3,350.2955453005375,0.40019682115270355,0.055900557116459026,0.19773109785158205,129898.25857426283,2300.55626417231,132198.81483843515,1553,12,375.47058823529414,34,0,17,36.22148584997469,0.623468137254902,45.14880952380951,1019.4047619047602,29.98249299719883,0
1603,4,1,0,35,0.02857142857142857,0.0,1.0,35,900,600,300,0.6666666666666666,12,6,6,343.50566657586023,0.4054621848739495,0.05480428198940901,0.19586706430935105,130292.12648158851,1951.2167513288591,132243.34323291737,1554,0,365.7142857142857,35,0,19,35.99518667573594,0.625297619047619,44.762731481481474,1020.9490740740729,29.169973544973512,0
1604,4,0,1,34,0.0,0.02857142857142857,0.9714285714285714,35,1300,1100,200,0.8461538461538461,15,11,4,361.46922344937036,0.404656862745098,-0.02907622412922739,0.19881940422077293,128877.99968117717,2317.086092892668,131195.08577406983,1555,1,366.7142857142857,35,0,16,36.97578270451006,0.6110119047619047,46.151620370370374,1015.3935185185189,29.011243386243397,8
1605,4,0,0,34,0.0,0.0,1.0,34,600,400,200,0.6666666666666666,8,4,4,369.3998073667054,0.399881164587047,-0.015450833241364093,0.20297948177984954,128838.5487528346,2718.5870181406053,131557.1357709752,1556,15,378.47058823529414,34,0,17,36.81475727016886,0.6127450980392157,46.1904761904762,1015.2380952380963,29.85994397759107,0
1606,4,0,1,33,0.0,0.029411764705882353,0.9705882352941176,34,1150,800,350,0.6956521739130435,15,8,7,368.7901056748885,0.4000297088532383,-0.013274946555409617,0.20295352267140648,128898.98667800463,2707.334183673482,131606.3208616781,1557,16,379.47058823529414,34,0,17,36.768513091051204,0.6133578431372548,46.13095238095239,1015.4761904761912,29.866946778711505,0
1607,4,3,2,34,0.08333333333333333,0.05555555555555555,0.9444444444444444,36,1050,800,250,0.7619047619047619,13,8,5,353.9743409589412,0.4129464285714286,0.006708583791226186,0.1978709998718533,129516.42679419288,1969.0983635662778,131485.52515775917,1558,0,358.8611111111111,36,0,15,36.5158387727256,0.6154513888888888,45.52364864864865,1017.9054054054058,28.27515015015016,0
1608,4,0,0,34,0.0,0.0,1.0,34,1200,800,400,0.6666666666666666,16,8,8,368.4666244090954,0.4026663695781343,0.008674818241903859,0.20495955982755928,129322.44897959185,2730.201247165536,132052.6502267574,1559,1,380.97058823529414,34,0,18,36.34470583645443,0.6176470588235294,45.714285714285715,1017.1428571428572,29.915966386554626,0
1609,4,1,0,35,0.02857142857142857,0.0,1.0,35,700,500,200,0.7142857142857143,9,5,4,361.4430660707617,0.40710784313725495,0.007715162437290424,0.20269837720564884,129643.02722318664,2371.714650848754,132014.7418740354,1560,0,371.0571428571429,35,0,16,36.19693999318105,0.61875,45.39930555555555,1018.402777777777,29.0972222222222,0
1610,4,0,0,35,0.0,0.0,1.0,35,1200,800,400,0.6666666666666666,16,8,8,362.4080665494042,0.4070378151260505,0.008645420912572366,0.20400515459724772,129790.40745027429,2407.4181241426536,132197.82557441693,1561,1,372.0571428571429,35,0,17,36.02245191579585,0.6202380952380953,45.254629629629626,1018.981481481481,29.1137566137566,0
1611,4,0,0,35,0.0,0.0,1.0,35,1250,700,550,0.56,18,7,11,362.2047828701677,0.40728291316526616,0.010042818217205207,0.20450639278977154,129908.3719135802,2410.686728395055,132319.05864197525,1562,2,373.0571428571429,35,0,19,35.90769754768392,0.6214285714285714,45.138888888888886,1019.444444444444,29.126984126984116,0
1612,4,0,0,35,0.0,0.0,1.0,35,650,200,450,0.3076923076923077,11,2,9,364.3836781286357,0.40682773109243703,0.00980703745743483,0.20604750990457502,129967.37423911181,2471.5979723936916,132438.97221150552,1563,3,374.0571428571429,35,0,19,35.792186908815744,0.6220238095238095,45.08101851851852,1019.6759259259261,29.13359788359789,0
1613,4,0,0,35,0.0,0.0,1.0,35,800,600,200,0.75,10,6,4,364.4064079181997,0.40675770308123255,0.017506605501613315,0.20652821048122788,130055.90284475735,2478.6408768432752,132534.54372160064,1564,4,375.0571428571429,35,0,19,35.70163867771095,0.6229166666666667,44.99421296296296,1020.0231481481479,29.143518518518512,0
1614,4,1,0,36,0.027777777777777776,0.0,1.0,36,1300,1200,100,0.9230769230769231,14,12,2,353.65081693753035,0.41051587301587306,0.026191401191401287,0.20228826728826704,130414.54081632636,2024.5699800624752,132439.11079638885,1565,0,365.6111111111111,34,2,20,35.61213092463092,0.6286764705882353,44.64285714285713,1021.4285714285701,30.04201680672265,0
1615,4,0,0,36,0.0,0.0,1.0,36,900,500,400,0.5555555555555556,13,5,8,350.71875074362475,0.4093088624338624,0.020890778929926412,0.20108343604759696,130505.7557397957,1954.1631235827406,132459.91886337844,1566,1,366.6111111111111,34,2,16,35.59458619752225,0.6295955882352942,44.553571428571416,1021.7857142857125,30.05252100840331,0
1616,4,0,0,36,0.0,0.0,1.0,36,1050,900,150,0.8571428571428571,12,9,3,352.28936987931087,0.41011904761904766,0.030404181545308884,0.20277889467315793,130657.8514739227,2005.8744331065473,132663.72590702923,1567,2,367.6111111111111,34,2,16,35.40041336748952,0.6311274509803921,44.40476190476189,1022.3809523809507,30.070028011204432,0
1617,4,0,0,36,0.0,0.0,1.0,36,1150,800,350,0.6956521739130435,15,8,7,350.22884187610777,0.4094907407407407,0.029123131278840475,0.20215364308681633,130765.21675936616,1959.5500846621808,132724.76684402835,1568,3,368.6111111111111,35,1,16,35.34440892459734,0.6300595238095238,44.299768518518505,1022.8009259259238,29.222883597883538,0
1618,4,0,2,34,0.0,0.05555555555555555,0.9444444444444444,36,1100,800,300,0.7272727272727273,14,8,6,348.5367738450952,0.4084656084656085,0.0330227895148667,0.20200906892246318,130924.43795146486,1926.3962442171717,132850.83419568202,1569,4,369.6111111111111,36,0,17,35.22662668720656,0.6296296296296297,44.144144144144136,1023.4234234234225,28.428428428428404,0
1619,4,0,0,34,0.0,0.0,1.0,34,1050,700,350,0.6666666666666666,14,7,7,364.0673084084595,0.40272207367795604,0.03726540086410557,0.21005387820934004,130749.15143140576,2720.298327664383,133469.44975907015,1570,5,390.29411764705884,34,0,17,35.006838551973,0.632046568627451,44.31547619047618,1022.738095238094,30.080532212885117,0
1620,4,0,0,34,0.0,0.0,1.0,34,850,700,150,0.8235294117647058,10,7,3,365.5571277160325,0.4025735294117647,0.03414201710010212,0.2112462944494865,130810.03578514725,2763.708191609961,133573.74397675722,1571,6,391.29411764705884,34,0,17,34.90704643314324,0.6326593137254901,44.25595238095237,1022.9761904761893,30.087535014005567,0
1621,4,0,0,34,0.0,0.0,1.0,34,1050,800,250,0.7619047619047619,13,8,5,365.1258496911512,0.4024435531788473,0.03641391394817162,0.21116363070294422,130840.48327664385,2754.6485260770796,133595.13180272092,1572,7,392.29411764705884,34,0,17,34.88722752307811,0.6329656862745099,44.22619047619047,1023.095238095237,30.091036414565796,0
1622,4,0,0,34,0.0,0.0,1.0,34,1050,800,250,0.7619047619047619,13,8,5,365.4321661828766,0.402276440879382,0.03221027855134162,0.21184223416548814,130931.84700963713,2769.3416950113333,133701.18870464846,1573,8,393.29411764705884,34,0,17,34.78684424799348,0.6338848039215687,44.13690476190476,1023.4523809523805,30.101540616246485,0
1623,4,1,0,35,0.02857142857142857,0.0,1.0,35,1250,1000,250,0.8,15,10,5,358.1081869545769,0.4066526610644258,0.03298862628055166,0.20958678093078503,131298.46810967507,2403.81127293381,133702.2793826089,1574,0,383.0285714285714,35,0,18,34.60344908714474,0.6354166666666667,43.77893518518518,1024.8842592592591,29.282407407407405,0
1624,4,1,0,36,0.027777777777777776,0.0,1.0,36,1150,500,650,0.43478260869565216,18,5,13,346.78592511384704,0.411276455026455,0.036300505050505194,0.2054039710289711,131755.55555555562,1938.2011424039845,133693.75669795962,1575,0,373.3611111111111,34,2,17,34.43249458874458,0.642156862745098,43.333333333333336,1026.6666666666672,30.196078431372566,0
1625,4,1,1,36,0.02702702702702703,0.02702702702702703,0.972972972972973,37,650,500,150,0.7692307692307693,8,5,3,337.837837837838,0.4149461961961962,0.04200146092038004,0.20161290322580644,132040.89506172828,1521.682098765422,133562.5771604937,1576,0,364.2432432432432,35,2,19,34.375,0.6428571428571428,43.05555555555555,1027.777777777777,29.36507936507934,0
1626,4,0,0,36,0.0,0.0,1.0,36,600,400,200,0.6666666666666666,8,4,4,346.46606696529227,0.4107473544973545,0.04549142327306477,0.20587529103144228,131877.806122449,1938.2369614512509,133816.04308390024,1577,1,375.30555555555554,34,2,19,34.31753206614124,0.6433823529411764,43.214285714285715,1027.1428571428573,30.21008403361345,0
1627,4,1,0,37,0.02702702702702703,0.0,1.0,37,750,400,350,0.5333333333333333,11,4,7,338.8179146068522,0.41331956956956956,0.05711991532383176,0.20315357551933125,132219.3889853395,1559.6595293209857,133779.04851466048,1578,0,366.13513513513516,35,2,21,34.170324105334224,0.6446428571428571,42.88194444444444,1028.4722222222222,29.384920634920633,0
1628,4,0,0,37,0.0,0.0,1.0,37,900,400,500,0.4444444444444444,14,4,10,338.85026666483026,0.41300675675675674,0.06178996278006177,0.2034933223052033,132278.91375171463,1564.5490397805115,133843.46279149514,1579,1,367.13513513513516,35,2,22,34.109660966096605,0.6452380952380952,42.82407407407407,1028.7037037037032,29.39153439153438,0
1629,4,0,0,37,0.0,0.0,1.0,37,550,400,150,0.7272727272727273,7,4,3,337.20526216562644,0.4124436936936937,0.05879670446599605,0.20282508664766022,132338.45191400888,1525.0444744513015,133863.4963884602,1580,2,368.13513513513516,35,2,22,34.09214473190852,0.6458333333333333,42.7662037037037,1028.935185185185,29.39814814814814,0
1630,4,0,0,37,0.0,0.0,1.0,37,1000,800,200,0.8,12,8,4,337.8811984741921,0.41147397397397395,0.06113122143656513,0.2037183292892514,132428.6352040817,1549.0425909304101,133977.6777950121,1581,3,369.13513513513516,34,3,22,33.98416416069088,0.6488970588235294,42.67857142857143,1029.2857142857147,30.27310924369749,0
1631,4,0,0,37,0.0,0.0,1.0,37,600,400,200,0.6666666666666666,8,4,4,337.8811984741921,0.41147397397397395,0.06113122143656513,0.2037183292892514,132428.6352040817,1549.0291950113426,133977.66439909302,1582,4,370.13513513513516,34,3,22,33.98416416069088,0.6488970588235294,42.67857142857143,1029.2857142857147,30.27310924369749,0
1632,4,0,0,37,0.0,0.0,1.0,37,1150,800,350,0.6956521739130435,15,8,7,338.03334558455003,0.41138013013013014,0.05311670051554418,0.20447471603540962,132551.1975623582,1561.3449546485144,134112.54251700672,1583,5,371.13513513513516,34,3,22,33.857177263969156,0.6501225490196079,42.5595238095238,1029.7619047619041,30.28711484593836,0
1633,4,0,0,37,0.0,0.0,1.0,37,1250,900,350,0.72,16,9,7,336.06659115122653,0.4106919419419419,0.048382689586913497,0.20406990412197948,132695.96220207476,1518.9359353566524,134214.89813743142,1584,6,372.13513513513516,35,2,18,33.76254399760354,0.6494047619047619,42.41898148148148,1030.3240740740741,29.43783068783069,0
1634,4,0,0,37,0.0,0.0,1.0,37,1250,1000,250,0.8,15,10,5,334.03915113514097,0.41056681681681684,0.052394396144396005,0.20326637707372416,132774.93709926156,1470.405456131821,134245.34255539338,1585,7,373.13513513513516,36,1,18,33.735567817599076,0.6481481481481481,42.34234234234235,1030.6306306306317,28.628628628628658,0
1635,4,0,1,36,0.0,0.02702702702702703,0.972972972972973,37,1200,900,300,0.75,15,9,6,339.275687037521,0.4104416916916917,0.0026913866452176194,0.1958314334650928,130765.21675936627,1474.9179018036607,132240.13466116993,1586,8,374.13513513513516,35,2,16,35.624481347365254,0.6300595238095238,44.29976851851851,1022.8009259259247,29.222883597883563,8
1636,4,0,0,36,0.0,0.0,1.0,36,800,400,400,0.5,12,4,8,347.9242179991219,0.40631613756613755,0.007629267409218432,0.20042395093188867,130688.2812500001,1893.9236111111263,132582.20486111124,1587,9,385.22222222222223,34,2,17,35.48118717739746,0.6314338235294117,44.37500000000001,1022.5000000000008,30.073529411764728,0
1637,4,0,0,36,0.0,0.0,1.0,36,1200,900,300,0.75,15,9,6,346.06620553873665,0.40608465608465605,0.00986705979722724,0.19982532513365775,130779.59183673482,1851.6794217687209,132631.27125850355,1588,10,386.22222222222223,34,2,17,35.43630702979517,0.6323529411764706,44.28571428571429,1022.8571428571438,30.084033613445406,0
1638,4,0,0,36,0.0,0.0,1.0,36,950,700,250,0.7368421052631579,12,7,5,346.64452427177724,0.40583664021164023,0.009933796242419746,0.2003171753239666,130810.03578514747,1868.9165249433222,132678.9523100908,1589,11,387.22222222222223,34,2,17,35.39072500872805,0.6326593137254901,44.25595238095239,1022.976190476191,30.08753501400562,0
1639,4,0,0,36,0.0,0.0,1.0,36,850,500,350,0.5882352941176471,12,5,7,345.84467967486336,0.4055059523809524,0.009175465057817966,0.2000829167752482,130854.0166323731,1851.0330932784623,132705.04972565157,1590,12,388.22222222222223,35,1,17,35.36670437405731,0.6309523809523809,44.21296296296296,1023.148148148148,29.23280423280423,0
1640,4,0,0,36,0.0,0.0,1.0,36,750,500,250,0.6666666666666666,10,5,5,348.4034809291938,0.40524140211640214,0.01557591294076266,0.20187310474285272,130913.2332926098,1922.1252357681815,132835.35852837798,1591,13,389.22222222222223,35,1,17,35.24136696071778,0.631547619047619,44.155092592592595,1023.3796296296302,29.23941798941801,0
1641,4,0,0,36,0.0,0.0,1.0,36,1400,1000,400,0.7142857142857143,18,10,8,352.94225797184714,0.4049107142857143,0.015160075329566869,0.2057667314262745,131150.23389274688,2057.6919367283876,133207.92582947528,1592,14,390.22222222222223,35,1,17,34.88559322033898,0.6339285714285714,43.92361111111111,1024.3055555555552,29.265873015873005,0
1642,4,1,0,37,0.02702702702702703,0.0,1.0,37,1100,900,200,0.8181818181818182,13,9,4,345.32365555138364,0.40803303303303307,0.028102838825828425,0.2033939808534702,131541.75347222207,1685.1369598765245,133226.8904320986,1593,0,380.64864864864865,34,3,18,34.685553750338485,0.6400122549019608,43.54166666666666,1025.8333333333321,30.171568627450945,0
1643,4,2,0,39,0.05128205128205128,0.0,1.0,39,650,400,250,0.6153846153846154,9,4,5,333.7084272567716,0.41183085919928025,0.05169208301738415,0.19965648367328476,132137.3632923464,1019.0703372291138,133156.4336295755,1594,0,362.0769230769231,36,3,18,34.38412741876597,0.6417824074074074,42.96171171171171,1028.153153153153,28.559809809809806,0
1644,4,0,0,39,0.0,0.0,1.0,39,1200,800,400,0.6666666666666666,16,8,8,332.69479368794254,0.41115609536662173,0.06217282079351061,0.1998137370374329,132282.1316882761,1001.9153021264474,133284.04699040254,1595,1,363.0769230769231,36,3,18,34.26473271300857,0.6432291666666667,42.820945945945944,1028.716216216216,28.575450450450447,0
1645,4,0,0,39,0.0,0.0,1.0,39,1150,900,250,0.782608695652174,14,9,5,333.8851644839286,0.4112966711650922,0.05896397799231834,0.20114545275007414,132398.00347222228,1041.145833333339,133439.14930555562,1596,2,364.0769230769231,36,3,18,34.11774628879892,0.6443865740740741,42.708333333333336,1029.166666666667,28.587962962962973,0
1646,4,1,0,40,0.025,0.0,1.0,40,1250,900,350,0.72,16,9,7,326.65856557689324,0.41169871794871793,0.07306894350462834,0.19872257979658361,132765.01092884337,673.7656057632993,133438.77653460667,1597,0,355.95,37,3,14,33.93568021420718,0.6461148648648649,42.35197368421052,1030.592105263157,27.85384068278803,0
1647,4,0,0,40,0.0,0.0,1.0,40,850,600,250,0.7058823529411765,11,6,5,329.9867720396587,0.4111778846153846,0.07570197830248926,0.20120205127865537,132849.77709487514,767.7338219451931,133617.51091682035,1598,1,356.95,37,3,15,33.76497908246472,0.6469594594594594,42.26973684210525,1030.9210526315774,27.862731152204795,0
1648,4,0,0,40,0.0,0.0,1.0,40,800,500,300,0.625,11,5,6,330.51911240686735,0.41060363247863246,0.08257865646258478,0.20244295634920637,133019.39058171754,793.0901815943434,133812.48076331188,1599,2,357.95,37,3,15,33.5813492063492,0.6486486486486487,42.10526315789474,1031.5789473684217,27.880512091038426,0
1649,4,0,1,39,0.0,0.025,0.975,40,1400,1100,300,0.7857142857142857,17,11,6,329.7189669705769,0.4100560897435897,0.07881427964300869,0.20256624785424748,133132.526354263,779.2638119421505,133911.79016620517,1600,3,358.95,37,3,16,33.48872007366481,0.6497747747747749,41.995614035087726,1032.0175438596505,27.892366050260822,0
1650,4,0,1,38,0.0,0.02564102564102564,0.9743589743589743,39,1300,1100,200,0.8461538461538461,15,11,4,337.61360049858604,0.4090755735492578,0.09029625836348498,0.20720384603942044,133094.2994303427,1186.889127302995,134281.1885576457,1601,4,369.0,36,3,17,33.32332933173268,0.6513310185185186,42.032657657657666,1031.8693693693708,28.663038038038078,0
1651,4,0,0,38,0.0,0.0,1.0,38,1200,1000,200,0.8333333333333334,14,10,4,342.7254845984482,0.4065167140825035,0.09067345275911332,0.21011382185079555,133053.95474322705,1520.1962234224966,134574.15096664955,1602,5,379.5,35,3,17,33.23190112930969,0.6529761904761905,42.07175925925926,1031.712962962963,29.47751322751323,0
1652,4,0,1,37,0.0,0.02631578947368421,0.9736842105263158,38,1600,1200,400,0.75,20,12,8,342.2762495850196,0.40593883357041255,0.09014765316432394,0.21088633442173818,133239.59094229384,1520.9494967941112,134760.54043908796,1603,6,380.5,36,2,17,33.057464368819076,0.6527777777777778,41.8918918918919,1032.4324324324339,28.67867867867872,0
1653,4,0,0,37,0.0,0.0,1.0,37,900,600,300,0.6666666666666666,12,6,6,349.2019008905287,0.40287162162162166,0.0873665771624954,0.2147712104925335,133173.39275763032,1900.8803798010977,135074.27313743142,1604,7,390.56756756756755,35,2,17,32.94507363384914,0.6541666666666667,41.95601851851852,1032.175925925926,29.490740740740744,0
1654,4,0,0,37,0.0,0.0,1.0,37,750,600,150,0.8,9,6,3,351.13055677304106,0.4029341841841842,0.09185493910362208,0.21682615626891671,133322.7656276792,1962.7393850737365,135285.50501275295,1605,8,391.56756756756755,35,2,17,32.7455498897979,0.6556547619047619,41.811342592592595,1032.75462962963,29.507275132275144,0
1655,4,0,0,37,0.0,0.0,1.0,37,1550,1100,450,0.7096774193548387,20,11,9,351.6600890979268,0.4020583083083083,0.09934393167926125,0.21875474310360982,133595.26643990923,1996.1083843581075,135591.37482426735,1606,9,392.56756756756755,34,3,17,32.458880316290504,0.6605392156862745,41.547619047619044,1033.8095238095232,30.406162464985975,0
1656,4,0,0,37,0.0,0.0,1.0,37,950,700,250,0.7368421052631579,12,7,5,352.31263810150267,0.4014326826826827,0.10714985735130789,0.21970853461505746,133687.58680555545,2019.9652777777676,135707.55208333323,1607,10,393.56756756756755,34,3,18,32.34958366908408,0.6614583333333333,41.45833333333333,1034.1666666666658,30.416666666666643,0
1657,4,0,0,37,0.0,0.0,1.0,37,1200,800,400,0.6666666666666666,16,8,8,354.21381509231134,0.401244994994995,0.11082667429772974,0.22126267716298295,133749.1514314058,2075.1594387754985,135824.3108701813,1608,11,394.56756756756755,34,3,15,32.238798097211024,0.6620710784313726,41.39880952380952,1034.4047619047612,30.423669467787096,0
1658,4,0,0,37,0.0,0.0,1.0,37,1150,900,250,0.782608695652174,14,9,5,356.3421855771235,0.40090090090090086,0.1101354460765418,0.22315030814382955,133841.52494331053,2138.6763038548615,135980.2012471654,1609,12,395.56756756756755,34,3,15,32.091290842153704,0.6629901960784313,41.3095238095238,1034.7619047619037,30.434173669467754,0
1659,4,0,1,36,0.0,0.02702702702702703,0.972972972972973,37,900,400,500,0.4444444444444444,14,4,10,355.7893351489574,0.40052552552552556,0.11183811758854922,0.22336377394369547,133933.9303429704,2130.4528061224332,136064.3831490928,1610,13,396.56756756756755,34,3,16,32.01313015142803,0.6639093137254901,41.22023809523809,1035.1190476190466,30.44467787114843,0
1660,4,0,0,36,0.0,0.0,1.0,36,850,600,250,0.7058823529411765,11,6,5,364.2800671057927,0.40008267195767194,0.11129868762258321,0.2276008916683933,133757.30075271518,2545.0236988177467,136302.3244515329,1611,14,395.8611111111111,33,3,16,31.97031848517159,0.6644570707070707,41.39093137254901,1034.4362745098028,31.34655377302433,0
1661,4,0,0,36,0.0,0.0,1.0,36,1000,900,100,0.9,11,9,2,361.8250785828689,0.4003472222222222,0.11212749161239421,0.22684578980195436,133884.09994052752,2488.5249963955966,136372.62493692312,1612,15,396.8611111111111,33,3,17,31.906823564239186,0.665719696969697,41.26838235294117,1034.926470588234,31.361408199643453,0
1662,4,0,0,36,0.0,0.0,1.0,36,950,800,150,0.8421052631578947,11,8,3,361.9977627786092,0.4003306878306878,0.10998631830978511,0.2271495619931746,133915.80912389446,2495.444660707399,136411.25378460187,1613,16,397.8611111111111,33,3,17,31.870609361433416,0.6660353535353536,41.237745098039206,1035.0490196078417,31.365121806298234,0
1663,4,0,0,36,0.0,0.0,1.0,36,900,600,300,0.6666666666666666,12,6,6,363.10417839026115,0.4003472222222222,0.10937849318131043,0.22843389450627805,134010.9592013887,2531.987847222198,136542.9470486109,1614,17,398.8611111111111,33,3,17,31.746730382293762,0.6669823232323233,41.14583333333332,1035.4166666666652,31.37626262626258,0
1664,4,0,1,35,0.0,0.027777777777777776,0.9722222222222222,36,1000,800,200,0.8,12,8,4,382.8328623052727,0.40019841269841266,0.052837072462641466,0.21778540998958862,130201.83000283431,2769.107851473905,132970.9378543082,1615,18,399.8611111111111,34,2,17,35.0832555698122,0.626531862745098,44.85119047619047,1020.5952380952368,30.017507002801082,8
1665,4,0,0,35,0.0,0.0,1.0,35,950,400,550,0.42105263157894735,15,4,11,388.30845977737016,0.3980392156862745,0.06168519280911222,0.22089022220122523,130200.04325259512,3111.555651672432,133311.59890426754,1616,22,411.77142857142854,33,2,17,34.94536503362152,0.6287878787878788,44.85294117647059,1020.5882352941173,30.92691622103386,0
1666,4,0,0,35,0.0,0.0,1.0,35,650,400,250,0.6153846153846154,9,4,5,386.00583090379035,0.3977941176470588,0.059708454810495803,0.21993355481727578,130262.58680555549,3056.4236111111068,133319.0104166666,1617,23,412.77142857142854,33,2,17,34.94047619047619,0.6294191919191919,44.791666666666664,1020.8333333333328,30.93434343434342,0
1667,4,0,0,35,0.0,0.0,1.0,35,900,700,200,0.7777777777777778,11,7,4,424.5684509789928,0.39723389355742295,0.11886829547282463,0.22459137185142902,127314.91246110103,3815.119311804936,131130.03177290596,1618,24,413.77142857142854,32,3,15,36.98366278827308,0.6018880208333333,47.69570707070708,1009.2171717171727,31.538036616161648,8
1668,4,3,0,38,0.07894736842105263,0.0,1.0,38,800,500,300,0.625,11,5,6,399.85503792636695,0.41056187766714086,0.13734338872717267,0.2160890894954595,128175.55334787125,2655.7166297965155,130831.26997766776,1619,0,382.0263157894737,33,5,18,36.72180705151478,0.608270202020202,46.84436274509805,1012.6225490196098,30.685531788473025,0
1669,4,0,0,38,0.0,0.0,1.0,38,850,600,250,0.7058823529411765,11,6,5,374.6296932066049,0.411065670934092,0.07128910759163842,0.19601116866199997,126869.31060924896,1948.1912272540912,128817.50183650306,1620,1,383.0263157894737,32,6,19,38.702113882274304,0.5973307291666667,48.137626262626256,1007.4494949494942,31.482796717171695,8
1670,4,2,2,38,0.05,0.05,0.95,40,1050,700,350,0.6666666666666666,14,7,7,361.908810713147,0.420178952991453,0.09603092783505174,0.19288546505041346,127617.73003472216,1237.3914731277323,128855.1215078499,1621,0,364.825,33,7,17,38.25386597938144,0.6025883838383839,47.39583333333333,1010.4166666666661,30.61868686868685,0
1671,4,1,0,39,0.02564102564102564,0.0,1.0,39,750,500,250,0.6666666666666666,10,5,5,372.34380482609913,0.4160762483130904,0.10690276148911493,0.19836851705848504,127601.78330017351,1702.3466993164059,129304.12999948992,1622,0,375.1025641025641,32,7,19,38.006644172290265,0.6048177083333333,47.411616161616166,1010.3535353535359,31.573547979797997,0
1672,4,1,0,40,0.025,0.0,1.0,40,950,800,150,0.8421052631578947,11,8,3,363.3100442636603,0.41860309829059833,0.11081203827055841,0.195430034885019,127989.47707912818,1299.9725165801533,129289.44959570833,1623,0,366.7,33,7,21,37.83746619030317,0.6063762626262627,47.0281862745098,1011.8872549019604,30.663250148544254,0
1673,4,2,1,41,0.047619047619047616,0.023809523809523808,0.9761904761904762,42,1150,800,350,0.6956521739130435,15,8,7,343.4935931589324,0.4242281262098335,0.11748348974626377,0.1882344890510949,128731.13854595335,443.6642661179723,129174.80281207133,1624,0,350.1904761904762,35,7,18,37.58173661800487,0.6095238095238096,46.2962962962963,1014.8148148148148,28.994708994708994,0
1674,4,0,0,41,0.0,0.0,1.0,41,1050,700,350,0.6666666666666666,14,7,7,353.38339312764197,0.4201981707317073,0.12779194317814357,0.19344166086235662,128687.51594387754,895.2062074829955,129582.72215136053,1625,1,359.7317073170732,34,7,19,37.375337322539025,0.6112132352941176,46.339285714285715,1014.6428571428571,29.842436974789916,0
1675,4,0,0,41,0.0,0.0,1.0,41,800,500,300,0.625,11,5,6,351.8978212482803,0.4207571138211382,0.12886860308904113,0.19298261379150533,128760.50407503857,862.1081693672761,129622.61224440584,1626,2,360.7317073170732,35,6,19,37.33856483065342,0.6098214285714285,46.26736111111111,1014.9305555555554,28.99801587301587,0
1676,4,0,1,40,0.0,0.024390243902439025,0.975609756097561,41,1200,700,500,0.5833333333333334,17,7,10,346.987935339209,0.42042682926829267,0.1254736678222821,0.19085424180130897,128877.99968117704,743.8222040037651,129621.8218851808,1627,3,361.7317073170732,35,6,20,37.34338785668149,0.6110119047619047,46.15162037037037,1015.3935185185179,29.01124338624337,0
1677,4,0,0,40,0.0,0.0,1.0,40,1550,1100,450,0.7096774193548387,20,11,9,353.45569063931543,0.4160924145299145,0.132512315270936,0.1939229870264353,128778.12500000001,1103.4722222222226,129881.59722222223,1628,4,371.65,34,6,20,37.281061850027356,0.6121323529411764,46.25,1015.0000000000001,29.85294117647059,0
1678,4,0,0,40,0.0,0.0,1.0,40,800,300,500,0.375,13,3,10,357.6783684643813,0.4155315170940171,0.13153575615474788,0.19683848277426902,128898.98667800441,1220.875850340118,130119.86252834453,1629,5,372.65,34,6,20,37.050605705353654,0.6133578431372548,46.13095238095237,1015.4761904761895,29.866946778711455,0
1679,4,1,0,41,0.024390243902439025,0.0,1.0,41,1350,1100,250,0.8148148148148148,16,11,5,347.17570080682293,0.41872459349593494,0.12750114524480538,0.19266825847049482,129230.80800165003,773.1592667609386,130003.96726841097,1630,0,364.5365853658537,35,6,22,36.979344526655304,0.6145833333333333,45.80439814814813,1016.7824074074045,29.050925925925846,0
1680,4,0,1,40,0.0,0.024390243902439025,0.975609756097561,41,1550,1100,450,0.7096774193548387,20,11,9,344.7459427633945,0.4194867886178862,0.12991487130838553,0.19246673490276345,129466.28146701373,726.5950520833135,130192.87651909704,1631,1,365.5365853658537,35,6,16,36.801646195837584,0.6169642857142856,45.57291666666666,1017.708333333332,29.077380952380913,0
1681,4,0,0,40,0.0,0.0,1.0,40,850,600,250,0.7058823529411765,11,6,5,349.1346834552458,0.41980502136752135,0.12269644527595891,0.1954057469181452,129564.7392290248,1047.1088435373977,130611.84807256219,1632,2,360.225,34,6,16,36.589881509198634,0.6200980392156863,45.47619047619047,1018.0952380952369,29.94397759103638,0
1682,4,2,0,42,0.047619047619047616,0.0,1.0,42,1050,700,350,0.6666666666666666,14,7,7,335.4102803888337,0.4250629113433992,0.140905626403532,0.1909684587241375,130234.60493853857,336.4050717528251,130571.0100102914,1633,0,344.0238095238095,37,5,19,36.260048519354044,0.620777027027027,44.81907894736841,1020.7236842105247,27.58712660028445,0
1683,4,0,0,42,0.0,0.0,1.0,42,1400,1000,400,0.7142857142857143,18,10,8,341.34227864760993,0.42359901277584205,0.14728989612842325,0.19522654627771585,130410.31867551853,502.9170786375469,130913.23575415608,1634,1,345.0238095238095,35,7,19,35.93071293673277,0.6264880952380952,44.64699074074073,1021.4120370370358,29.183201058201025,0
1684,4,1,0,43,0.023255813953488372,0.0,1.0,43,1250,900,350,0.72,16,9,7,333.2388052078318,0.42589516426725726,0.16221995698260105,0.192774413601629,130850.90033712279,120.91953774236197,130971.81987486515,1635,0,337.9767441860465,37,6,18,35.69229360911657,0.6269707207207207,44.216008771929815,1023.1359649122793,27.652323376007548,0
1685,4,1,0,44,0.022727272727272728,0.0,1.0,44,1550,1200,350,0.7741935483870968,19,12,7,323.85401194758657,0.4289442389006342,0.16173543378735777,0.18927994080373575,131246.00643080208,-299.0908530572019,130946.91557774488,1636,0,331.27272727272725,38,6,19,35.5339641330414,0.6291118421052632,43.830128205128204,1024.6794871794868,26.965249662618074,0
1686,4,0,0,44,0.0,0.0,1.0,44,1450,1000,450,0.6896551724137931,19,10,9,322.83552159996515,0.4285698555320648,0.15808378530708067,0.18895768572409616,131301.43364800335,-322.2466362847276,130979.18701171862,1637,1,332.27272727272725,39,5,19,35.50422214317175,0.6279380341880342,43.776041666666664,1024.8958333333326,26.279380341880323,0
1687,4,0,0,44,0.0,0.0,1.0,44,1500,1200,300,0.8,18,12,6,321.4844153169545,0.42847075405214935,0.15525961848112368,0.18883766329327592,131437.65637555695,-348.9656652210524,131088.6907103359,1638,2,333.27272727272725,38,6,19,35.40168958810864,0.6310307017543859,43.64316239316239,1025.42735042735,26.984930274403943,0
1688,4,0,0,44,0.0,0.0,1.0,44,1050,800,250,0.7619047619047619,13,8,5,323.24182097555604,0.42754580690627203,0.15143151994849546,0.19041521257713417,131547.23340821083,-295.68654576669496,131251.54686244414,1639,3,334.27272727272725,38,6,19,35.246346247309575,0.6321271929824561,43.536324786324776,1025.8547008546996,26.99617633828157,0
1689,4,1,0,45,0.022222222222222223,0.0,1.0,45,850,700,150,0.8235294117647058,10,7,3,317.4681773024721,0.4301557239057239,0.16191281028518612,0.18870124752137898,131889.27001953125,-625.8707682291652,131263.3992513021,1640,0,327.8222222222222,39,6,16,35.05064141567792,0.6338141025641026,43.203125,1027.1875,26.338141025641026,0
1690,4,0,1,44,0.0,0.022222222222222223,0.9777777777777777,45,1200,800,400,0.6666666666666666,16,8,8,316.06490608035716,0.4297558922558922,0.16047580427142516,0.1882647484043865,131969.53124999985,-657.8125000000143,131311.71874999985,1641,1,328.8222222222222,39,6,16,35.00608272506083,0.6346153846153846,43.12499999999999,1027.4999999999989,26.34615384615382,0
1691,4,0,0,44,0.0,0.0,1.0,44,1550,1000,550,0.6451612903225806,21,10,11,320.84303504475133,0.4264226568005638,0.15503086390577314,0.19105557077556473,131958.55391418276,-332.4034124114389,131626.15050177134,1642,2,337.1818181818182,38,6,16,34.89437107899207,0.6362390350877193,43.135683760683754,1027.4572649572638,27.03834907782273,0
1692,4,0,2,42,0.0,0.045454545454545456,0.9545454545454546,44,1350,1200,150,0.8888888888888888,15,12,3,360.2200290932624,0.42610332980972515,0.18210592952099636,0.19465025289315488,128171.57594601487,451.2578530206546,128622.83379903552,1643,3,338.1818181818182,38,6,15,37.72925898572131,0.5981359649122807,46.84829059829059,1012.6068376068362,26.647548358074637,8
1693,4,1,2,41,0.023255813953488372,0.046511627906976744,0.9534883720930233,43,1400,1000,400,0.7142857142857143,18,10,8,369.93871928936875,0.42271133259505356,0.19512735326688824,0.20060057313578444,128311.11495844871,893.4499076638945,129204.5648661126,1644,0,346.48837209302326,37,6,17,37.34036796536797,0.6013513513513513,46.71052631578947,1013.1578947368419,27.382645803698427,0
1694,4,2,1,42,0.046511627906976744,0.023255813953488372,0.9767441860465116,43,1100,700,400,0.6363636363636364,15,7,8,353.91120919962725,0.42561830933923955,0.1662449124900176,0.18475235262105796,126777.10503472204,452.36599242072543,127229.47102714278,1645,0,325.1162790697674,39,4,16,39.318714660046886,0.5822649572649572,48.22916666666666,1007.0833333333319,25.822649572649535,8
1695,4,4,2,44,0.08695652173913043,0.043478260869565216,0.9565217391304348,46,1300,1100,200,0.8461538461538461,15,11,4,333.75996869282926,0.43481280193236715,0.18450673140587082,0.17770463197969552,127577.25180802103,-682.4015861275442,126894.85022189349,1646,0,304.80434782608694,38,8,18,39.00631873942473,0.5921052631578947,47.43589743589744,1010.2564102564102,26.585695006747635,0
1696,4,1,0,45,0.022222222222222223,0.0,1.0,45,1400,1000,400,0.7142857142857143,18,10,8,334.63823037688877,0.4330176767676768,0.13899795295144135,0.1772779489244605,127373.97057183216,-473.90155461845467,126900.06901721371,1647,0,312.55555555555554,40,5,14,39.1921708782174,0.58671875,47.637195121951216,1009.4512195121945,25.236280487804862,8
1697,4,1,0,46,0.021739130434782608,0.0,1.0,46,1150,900,250,0.782608695652174,14,9,5,326.74106291118164,0.4356380837359098,0.14838503957684668,0.17451285341661732,127703.41443009736,-854.810126344568,126848.60430375279,1648,0,306.7391304347826,42,4,15,39.05466078675743,0.5870535714285714,47.31104651162791,1010.7558139534884,24.065614617940202,0
1698,4,2,1,47,0.041666666666666664,0.020833333333333332,0.9791666666666666,48,1050,800,250,0.7619047619047619,13,8,5,317.6590281416151,0.4380725472813239,0.1663279472768635,0.17164612561838663,128170.25662634664,-1454.0699837178277,126716.18664262882,1649,0,294.9166666666667,40,8,17,38.80804228556136,0.5947916666666666,46.849593495934954,1012.6016260162593,25.31504065040648,0
1699,4,0,1,46,0.0,0.02127659574468085,0.9787234042553191,47,1350,900,450,0.6666666666666666,18,9,9,323.4012262539219,0.43667129201356764,0.16457714713874916,0.17508636730433677,128247.4482471578,-1104.9235945865566,127142.52465257124,1650,1,302.1063829787234,40,7,18,38.583993846359654,0.5955729166666667,46.77337398373984,1012.9065040650408,25.32266260162602,0
1700,4,0,1,45,0.0,0.021739130434782608,0.9782608695652174,46,850,300,550,0.35294117647058826,14,3,11,323.26037773890033,0.436694847020934,0.1680882260905323,0.17525253254674172,128302.78320312515,-904.9587673610977,127397.82443576405,1651,2,305.67391304347825,39,7,19,38.53117074508191,0.5977564102564102,46.71875000000001,1013.1250000000011,25.97756410256413,0
1701,4,1,0,46,0.021739130434782608,0.0,1.0,46,950,600,350,0.631578947368421,13,6,7,320.71671587595324,0.4371074879227053,0.1832553320710224,0.17502791175831178,128566.75347222229,-953.2986111111074,127613.45486111118,1652,0,306.0652173913044,39,7,15,38.32682826622843,0.6004273504273504,46.458333333333336,1014.1666666666672,26.004273504273517,0
1702,4,2,1,47,0.041666666666666664,0.020833333333333332,0.9791666666666666,48,1000,800,200,0.8,12,8,4,311.5221992050034,0.4396701388888889,0.20519770914752344,0.1726455040602054,129176.76150959969,-1551.714233669856,127625.04727592983,1653,0,294.2708333333333,42,6,17,37.940456899564715,0.6019345238095238,45.85755813953488,1016.5697674418598,24.20404208194904,0
1703,4,0,1,46,0.0,0.02127659574468085,0.9787234042553191,47,1800,1400,400,0.7777777777777778,22,14,8,319.1225720290988,0.43771199506629666,0.19894159194946504,0.17731591217630163,129278.89034511537,-1148.835253434845,128130.05509168052,1654,1,301.4468085106383,40,7,18,37.64364944538821,0.6059895833333333,45.75711382113821,1016.9715447154474,25.424288617886184,0
1704,4,2,1,47,0.041666666666666664,0.020833333333333332,0.9791666666666666,48,1150,700,450,0.6086956521739131,16,7,9,316.5343068990176,0.44002105496453897,0.21008009543285633,0.17791411042944782,129731.44531250001,-1387.1093749999986,128344.33593750001,1655,0,295.9583333333333,41,7,17,37.25076687116564,0.6089939024390244,45.3125,1018.7500000000001,24.84756097560976,0
1705,4,0,0,47,0.0,0.0,1.0,47,1150,800,350,0.6956521739130435,15,8,7,351.5085030775334,0.4368640148011101,0.20234983117214167,0.18431237962925917,126957.38965821096,-435.61710132222794,126521.77255688873,1656,1,303.25531914893617,38,9,19,39.19396445104067,0.5858004385964912,48.050213675213676,1007.7991452991453,26.52103013945119,8
1706,4,3,0,50,0.06,0.0,1.0,50,1750,1400,350,0.8,21,14,7,334.5911662151964,0.44220238095238096,0.23855707395498382,0.1794100908498726,127861.72251966437,-1443.64809035836,126418.07442930601,1657,0,286.0,40,10,19,38.69448352090033,0.5916666666666667,47.154471544715456,1011.3821138211393,25.284552845528484,0
1707,4,0,0,50,0.0,0.0,1.0,50,1550,1200,350,0.7741935483870968,19,12,7,331.35312114859113,0.4420493197278912,0.2425185780277166,0.17835753407554983,128015.94309769328,-1516.3035395597751,126499.63955813351,1658,1,287.0,40,10,20,38.61886590346121,0.5932291666666667,47.00203252032521,1011.9918699187,25.2997967479675,0
1708,4,0,1,49,0.0,0.02,0.98,50,1050,800,250,0.7619047619047619,13,8,5,332.7432029099513,0.4415136054421769,0.25049000392003173,0.17945621789075797,128094.31295666403,-1475.4976064499956,126618.81535021403,1659,2,288.0,41,9,20,38.50369136286424,0.592479674796748,46.92460317460317,1012.3015873015863,24.690282617111862,0
1709,4,0,0,49,0.0,0.0,1.0,49,1450,1100,350,0.7586206896551724,18,11,7,342.521289979194,0.43934240362811794,0.26045815916728166,0.18460563031346158,128067.37061273042,-1026.8398026968193,127040.5308100336,1660,3,294.7959183673469,40,9,20,38.283760040160644,0.59375,46.95121951219512,1012.1951219512187,25.304878048780466,0
1710,4,1,1,49,0.02,0.02,0.98,50,1150,800,350,0.6956521739130435,15,8,7,336.25288283687667,0.44096088435374153,0.2726633165829153,0.18264455596275983,128379.01341735237,-1366.2979025953077,127012.71551475706,1661,0,289.88,35,15,15,38.12433379016295,0.605952380952381,46.64351851851851,1013.4259259259245,28.955026455026413,0
1711,4,1,0,50,0.02,0.0,1.0,50,1200,700,500,0.5833333333333334,17,7,10,333.6342280928454,0.44329931972789116,0.2780199778024417,0.1826272415016124,128686.69979100728,-1413.1424498823078,127273.55734112498,1662,0,290.3,36,14,19,37.87712726600074,0.6070601851851851,46.340090090090094,1014.6396396396401,28.184434434434447,0
1712,4,1,0,51,0.0196078431372549,0.0,1.0,51,1200,800,400,0.6666666666666666,16,8,8,325.6282528465577,0.44344771241830067,0.283073409802715,0.1798515276480933,129042.58355034745,-1796.0177951388669,127246.56575520859,1663,0,285.5882352941176,39,12,20,37.71828651493404,0.6052350427350428,45.98958333333334,1016.0416666666686,26.052350427350476,0
1713,4,2,1,52,0.03773584905660377,0.018867924528301886,0.9811320754716981,53,1400,1000,400,0.7142857142857143,18,10,8,312.42107214644454,0.44619315432994683,0.285562168356593,0.17529782700247548,129663.42872242325,-2497.7895473212784,127165.63917510197,1664,0,275.77358490566036,38,15,16,37.42438546802339,0.6132127192982456,45.37927350427351,1018.482905982907,26.80218173639229,0
1714,4,1,1,52,0.018867924528301886,0.018867924528301886,0.9811320754716981,53,1650,1200,450,0.7272727272727273,21,12,9,318.48130263222396,0.4456791243347847,0.297851511688632,0.1803499383500353,130023.43885633704,-2317.993164062473,127705.44569227457,1665,0,276.62264150943395,39,14,17,36.905597827937214,0.6151175213675213,45.02604166666668,1019.8958333333353,26.151175213675263,0
1715,4,0,0,52,0.0,0.0,1.0,52,1850,1400,450,0.7567567567567568,23,14,9,326.6369873593641,0.44496292106586227,0.30046414930135734,0.18493930494261537,130017.30974687733,-1906.3075279421223,128111.00221893522,1666,1,282.90384615384613,38,14,20,36.703855017808486,0.6167763157894737,45.03205128205129,1019.8717948717971,26.83873144399466,0
1716,4,1,1,52,0.018867924528301886,0.018867924528301886,0.9811320754716981,53,1650,1200,450,0.7272727272727273,21,12,9,329.79305917003074,0.44652576197387517,0.24918697576593485,0.1812996680998733,128856.81918905124,-2100.551941891392,126756.26724715985,1667,0,278.54716981132077,42,11,14,37.80142520837308,0.5987103174603174,46.17248062015504,1015.3100775193807,24.17404946474716,8
1717,4,0,0,52,0.0,0.0,1.0,52,1600,1400,200,0.875,18,14,4,332.72018529434257,0.4439259678230267,0.2583513128733512,0.18336345858334888,128955.22072742014,-1818.7990129799948,127136.42171444013,1668,1,284.84615384615387,42,10,15,37.627003434459084,0.5997023809523809,46.075581395348834,1015.6976744186038,24.18327796234771,0
1718,4,2,2,52,0.037037037037037035,0.037037037037037035,0.962962962962963,54,1950,1400,550,0.717948717948718,25,14,11,318.8483534811408,0.4447647332867459,0.261097842981159,0.1780084807720427,129466.28146701399,-2543.7431280891224,126922.53833892487,1669,0,275.25925925925924,43,11,14,37.46055100648243,0.6034399224806202,45.57291666666667,1017.7083333333342,23.667635658914747,0
1719,4,1,0,53,0.018867924528301886,0.0,1.0,53,1450,1000,450,0.6896551724137931,19,10,9,320.7904633769962,0.44344158200290273,0.2811645661418496,0.1800228809693331,129669.75509472103,-2280.6358354365575,127389.11925928447,1670,0,280.8679245283019,42,11,15,37.204872673072664,0.6068948412698413,45.37306201550388,1018.5077519379857,24.25018456995204,0
1720,4,1,0,54,0.018518518518518517,0.0,1.0,54,950,700,250,0.7368421052631579,12,7,5,316.35393633006447,0.44513597717214065,0.2867098636469154,0.1785105322940893,129884.7747342251,-2582.0880486968276,127302.68668552827,1671,0,276.64814814814815,44,10,16,37.100137766070205,0.6062973484848485,45.162037037037045,1019.3518518518529,23.167087542087565,0
1721,4,0,1,53,0.0,0.018518518518518517,0.9814814814814815,54,1550,1100,450,0.7096774193548387,20,11,9,315.56553022673484,0.44473561611926393,0.29159059583608826,0.1786300806849074,130008.42723594049,-2594.764345069308,127413.66289087117,1672,1,277.64814814814815,45,9,17,36.99512612132517,0.60625,45.04076086956522,1019.8369565217394,22.663043478260875,0
1722,4,1,2,52,0.018518518518518517,0.037037037037037035,0.962962962962963,54,1900,1400,500,0.7368421052631579,24,14,10,311.0370678883797,0.4473197647332867,0.2857898715041567,0.17721879449454206,130262.58680555565,-2696.70138888888,127565.88541666677,1673,0,272.48148148148147,45,9,18,36.85374149659864,0.6087962962962963,44.79166666666667,1020.8333333333342,22.685185185185205,0
1723,4,1,1,52,0.018867924528301886,0.018867924528301886,0.9811320754716981,53,1500,1000,500,0.6666666666666666,20,10,10,311.03636848975947,0.44785619254958875,0.2871370911906952,0.17851837748421584,130546.30594135784,-2479.0702160494025,128067.23572530845,1674,0,273.3207547169811,44,9,13,36.56734166893175,0.6129261363636364,44.51388888888888,1021.944444444443,23.22601010101007,0
1724,4,0,0,52,0.0,0.0,1.0,52,1600,900,700,0.5625,23,9,14,317.31915840551255,0.4470603946706888,0.2915273390989397,0.1818139352117406,130480.18470392848,-2119.2275202307146,128360.95718369776,1675,2,279.5769230769231,43,9,18,36.473588068094045,0.6136143410852712,44.578598484848484,1021.685606060606,23.760130373502466,0
1725,4,0,2,50,0.0,0.038461538461538464,0.9615384615384616,52,900,600,300,0.6666666666666666,12,6,6,351.11056713648924,0.44670688788335844,0.34615384615384626,0.18694265331321164,127577.25180802093,-1322.7657210850869,126254.48608693584,1676,3,280.5769230769231,38,14,15,38.5681049069374,0.5921052631578947,47.43589743589743,1010.2564102564094,26.585695006747613,8
1726,4,0,1,49,0.0,0.02,0.98,50,1750,1500,250,0.8571428571428571,20,15,5,350.4968183535585,0.4432227891156462,0.2955371043072139,0.17915314826719014,125913.11984592005,-1162.039150461257,124751.08069545879,1677,4,291.7,39,11,18,40.29417488323822,0.5734508547008548,49.088541666666664,1003.6458333333326,25.734508547008527,8
1727,4,1,1,49,0.02,0.02,0.98,50,2050,1500,550,0.7317073170731707,26,15,11,351.51322380207114,0.4433843537414966,0.3113220058019066,0.18162771071400355,126357.83420138866,-1116.71006944447,125241.12413194419,1678,0,292.52,39,11,16,39.81040198922504,0.5779914529914529,48.64583333333332,1005.4166666666647,25.77991452991448,0
1728,4,1,0,50,0.02,0.0,1.0,50,1350,1100,250,0.8148148148148148,16,11,5,349.47577385212213,0.44605442176870747,0.3148628222383276,0.18138562598805172,126541.17974175327,-1155.3846571180745,125385.79508463519,1679,0,293.32,39,11,18,39.6729518238603,0.5798611111111112,48.46354166666666,1006.1458333333317,25.798611111111068,0
1729,4,0,0,50,0.0,0.0,1.0,50,1800,1400,400,0.7777777777777778,22,14,8,332.5645756007402,0.44618197278911564,0.22366135582630453,0.16659455500750717,125078.13720703148,-1669.398328993026,123408.73887803845,1680,1,294.32,39,11,19,41.605162449234626,0.5649038461538461,49.921875000000014,1000.3125000000018,25.64903846153851,8
1730,4,5,1,54,0.09090909090909091,0.01818181818181818,0.9818181818181818,55,1350,900,450,0.6666666666666666,18,9,9,311.0970875084654,0.45397025813692476,0.2758619452194899,0.1605882214836108,126317.93986402435,-3129.430411125675,123188.50945289867,1681,0,268.4727272727273,41,14,14,40.86719546695613,0.5744410569105691,48.68551587301587,1005.2579365079367,24.51848625629114,0
1731,4,3,2,55,0.05263157894736842,0.03508771929824561,0.9649122807017544,57,1550,900,650,0.5806451612903226,22,9,13,303.54379571360334,0.45513523391812866,0.29625331244318076,0.15914116919782562,126952.00617283952,-3692.9012345678984,123259.10493827163,1682,0,260.0,44,13,18,40.40793825799341,0.5767045454545454,48.05555555555556,1007.7777777777778,22.904040404040405,0
1732,4,5,3,57,0.08333333333333333,0.05,0.95,60,1650,1300,350,0.7878787878787878,20,13,7,290.7003267641217,0.4600635593220339,0.32298716800954974,0.15626191770718167,127961.17297442739,-4560.174719655087,123400.9982547723,1683,0,247.66666666666666,45,15,16,39.7030737093405,0.5856481481481481,47.056159420289845,1011.7753623188386,22.483896940418635,0
1733,4,0,0,57,0.0,0.0,1.0,57,2200,1700,500,0.7727272727272727,27,17,10,307.0285037572596,0.4560750835421888,0.32194185011949905,0.16398434832012157,127703.41443009737,-3558.2823485667905,124145.13208153058,1684,1,261.6140350877193,42,15,17,39.55277538107564,0.5870535714285714,47.31104651162791,1010.7558139534885,24.065614617940202,0
1734,4,2,2,57,0.03389830508474576,0.03389830508474576,0.9661016949152542,59,1700,1200,500,0.7058823529411765,22,12,10,300.38798950553075,0.45645821157218003,0.3355785958068407,0.16262721843572123,128247.4482471579,-4092.159187399473,124155.28905975842,1685,0,253.71186440677965,40,19,21,39.1667502759105,0.5955729166666667,46.773373983739845,1012.9065040650416,25.322662601626043,0
1735,4,0,1,56,0.0,0.017543859649122806,0.9824561403508771,57,1950,1400,550,0.717948717948718,25,14,11,309.09528028451376,0.45454782790309106,0.33788257344174455,0.16671626538483408,128097.660536694,-3481.1235425240193,124616.53699416999,1686,1,263.3333333333333,44,13,21,39.098753010762515,0.5883049242424243,46.92129629629629,1012.3148148148141,23.007154882154865,0
1736,4,2,2,56,0.034482758620689655,0.034482758620689655,0.9655172413793104,58,1400,900,500,0.6428571428571429,19,9,10,298.61255585321226,0.4576590542448074,0.3396909371749641,0.16292261863636995,128556.44710696355,-3922.2347112670386,124634.21239569651,1687,0,255.29310344827587,40,18,17,38.8977268931423,0.5986979166666666,46.46849593495936,1014.1260162601634,25.353150406504085,0
1737,4,0,0,56,0.0,0.0,1.0,56,1500,1000,500,0.6666666666666666,20,10,10,306.02881365036757,0.45625,0.33236622803877536,0.16675311162150272,128504.9214773778,-3334.7582664088904,125170.16321096891,1688,1,256.5892857142857,40,16,18,38.76206942634728,0.5981770833333333,46.51930894308943,1013.9227642276414,25.348069105691035,0
1738,4,0,1,55,0.0,0.017857142857142856,0.9821428571428571,56,2200,1800,400,0.8181818181818182,26,18,8,306.6589647044936,0.4554450757575758,0.3306321501906726,0.16780102900122285,128672.41753472213,-3308.28993055556,125364.12760416657,1689,2,257.5892857142857,41,15,19,38.57588980150582,0.5983231707317074,46.354166666666664,1014.5833333333326,24.745934959349576,0
1739,4,1,0,56,0.017857142857142856,0.0,1.0,56,1300,900,400,0.6923076923076923,17,9,8,303.3267587113741,0.4552489177489178,0.3345970695970699,0.16708677386643495,128936.76757812499,-3378.0056423611095,125558.76193576388,1690,0,256.55357142857144,43,13,20,38.39209401709401,0.5981104651162791,46.09375,1015.6249999999999,23.619186046511626,0
1740,4,0,2,54,0.0,0.03571428571428571,0.9642857142857143,56,2050,1700,350,0.8292682926829268,24,17,7,298.4330085980096,0.45526920995670994,0.32374098325747247,0.1652930812327676,129153.25574638438,-3491.2810634756656,125661.97468290872,1691,1,257.55357142857144,43,13,21,38.29692255139432,0.6002906976744187,45.88068181818182,1016.4772727272734,23.63900634249473,0
1741,4,1,0,55,0.01818181818181818,0.0,1.0,55,1450,1100,350,0.7586206896551724,18,11,7,306.82399929470574,0.4527216610549944,0.32986779337603944,0.17025924087318503,129227.22012566903,-3069.979565628865,126157.24056004017,1692,0,262.8909090909091,40,15,22,38.00870398134267,0.60546875,45.80792682926828,1016.7682926829252,25.41920731707313,0
1742,4,0,1,54,0.0,0.01818181818181818,0.9818181818181818,55,1400,900,500,0.6428571428571429,19,9,10,304.78833523609984,0.45209034792368125,0.32261696158630215,0.1700192535219533,129433.96297053652,-3110.007580639853,126323.95538989667,1693,1,263.8909090909091,40,15,16,37.851002030693415,0.6075520833333333,45.60467479674796,1017.5813008130066,25.439532520325166,0
1743,4,0,0,54,0.0,0.0,1.0,54,1650,1300,350,0.7878787878787878,20,13,7,304.91211760412614,0.4513233752620545,0.320775052780643,0.1705362748208001,129537.39636005349,-2900.4956333862187,126636.90072666727,1694,2,268.7962962962963,40,14,18,37.74312834847426,0.60859375,45.5030487804878,1017.9878048780483,25.44969512195121,0
1744,4,0,0,54,0.0,0.0,1.0,54,1800,1500,300,0.8333333333333334,21,15,6,305.4770537907001,0.4513743303051479,0.3155831881360276,0.1714780159250472,129680.91699932262,-2877.0911084341365,126803.82589088849,1695,3,269.7962962962963,41,13,19,37.58349972403494,0.6084857723577235,45.36210317460316,1018.5515873015853,24.84272164150208,0
1745,4,1,1,54,0.01818181818181818,0.01818181818181818,0.9818181818181818,55,1400,800,600,0.5714285714285714,20,8,12,305.0060238693808,0.451108305274972,0.32837629192153606,0.17324406469122694,130141.77755000278,-3061.1947780360506,127080.58277196673,1696,0,265.8727272727273,43,12,21,37.12964037122971,0.6102228682170543,44.910037878787875,1020.3598484848477,23.7292988019732,0
1746,4,1,0,55,0.01818181818181818,0.0,1.0,55,2150,1700,450,0.7906976744186046,26,17,9,306.8540630924992,0.4505331088664422,0.33321895894577813,0.1751945474953854,130342.35161675335,-3000.5597747718675,127341.79184198148,1697,0,266.3272727272727,39,16,22,36.87997296745896,0.6183226495726496,44.713541666666664,1021.1458333333323,26.18322649572647,0
1747,4,0,0,55,0.0,0.0,1.0,55,1750,1300,450,0.7428571428571429,22,13,9,308.2315264230366,0.45056116722783385,0.33857844500046297,0.17682755989532117,130528.56445312513,-2953.396267361095,127575.16818576404,1698,1,267.3272727272727,39,16,17,36.6568977234115,0.6201923076923077,44.53125000000001,1021.875000000001,26.2019230769231,0
1748,4,0,0,55,0.0,0.0,1.0,55,1300,800,500,0.6153846153846154,18,8,10,309.16493011959494,0.4502665544332211,0.34036245043175306,0.17760692589774438,130581.7925347226,-2925.7378472221853,127656.05468750041,1699,2,268.3272727272727,39,16,18,36.579358608506595,0.6207264957264957,44.479166666666686,1022.0833333333363,26.207264957265036,0
1749,4,0,0,55,0.0,0.0,1.0,55,1550,1000,550,0.6451612903225806,21,10,11,308.34057158813465,0.4500420875420876,0.3374056407168988,0.17749927918695302,130661.65500217052,-2942.342122395793,127719.31287977472,1700,3,269.3272727272727,39,16,18,36.519888775683484,0.6215277777777778,44.401041666666686,1022.3958333333363,26.215277777777853,0
1750,4,0,0,55,0.0,0.0,1.0,55,1850,1400,450,0.7567567567567568,23,14,9,305.8608347218562,0.4496773288439955,0.3377732826426574,0.176858186280582,130833.7993774377,-2996.612982516988,127837.1863949207,1701,4,270.3272727272727,40,15,21,36.40980431111552,0.6216145833333333,44.23272357723579,1023.0691056910595,25.576727642276488,0
1751,4,2,1,56,0.03508771929824561,0.017543859649122806,0.9824561403508771,57,1450,1000,450,0.6896551724137931,19,10,9,294.61897615182346,0.45069705513784464,0.34315538192233697,0.17267713446266578,131353.54785722183,-3659.218355071066,127694.32950215077,1702,0,261.8070175438597,41,16,23,36.17485644698218,0.6252540650406504,43.725198412698425,1025.0992063492083,25.00241966705386,0
1752,4,1,1,56,0.017543859649122806,0.017543859649122806,0.9824561403508771,57,1750,1300,450,0.7428571428571429,22,13,9,295.4995873710905,0.45235484544695076,0.3453007755326416,0.17511821184474669,131775.45294753913,-3612.0816056727367,128163.3713418664,1703,0,257.87719298245617,42,15,20,35.72889140556186,0.6279761904761905,43.31395348837209,1026.744186046511,24.446290143964546,0
1753,4,1,1,56,0.017543859649122806,0.017543859649122806,0.9824561403508771,57,1750,1200,550,0.6857142857142857,23,12,11,294.99421592514483,0.45253759398496246,0.3520712603529941,0.1761992478904244,132074.09410492162,-3607.7812330989746,128466.31287182265,1704,0,257.89473684210526,42,15,21,35.442590497737555,0.6309523809523809,43.02325581395349,1027.9069767441863,24.47397563676634,0
1754,4,0,0,56,0.0,0.0,1.0,56,1600,1200,400,0.75,20,12,8,293.412388386144,0.45156926406926406,0.3379834031040101,0.1758320540904655,132198.62768350748,-3442.2569820022986,128756.37070150518,1705,1,249.94642857142858,42,14,21,35.35856182669053,0.6321924603174602,42.90213178294573,1028.3914728682162,24.48551125876705,0
1755,4,0,3,53,0.0,0.05357142857142857,0.9464285714285714,56,2100,1600,500,0.7619047619047619,26,16,10,329.7216060164914,0.4512175324675325,0.33319954463191115,0.1863345888966174,129943.7717013887,-2571.147058657852,127372.62464273085,1706,2,250.94642857142858,39,17,17,36.69970031330881,0.6143162393162394,45.10416666666666,1019.5833333333318,26.143162393162353,8
1756,4,0,2,51,0.0,0.03773584905660377,0.9622641509433962,53,1200,900,300,0.75,15,9,6,347.0707243368637,0.4497460087082728,0.36369019076409836,0.19557845923092268,129831.8483179125,-1587.833272461654,128244.01504545085,1707,3,265.3207547169811,36,17,19,36.37108655616942,0.6186342592592593,45.21396396396396,1019.1441441441442,28.30955955955956,0
1757,4,0,0,51,0.0,0.0,1.0,51,1450,1100,350,0.7586206896551724,18,11,7,362.0211841299561,0.44874183006535945,0.3710777626193722,0.2025660518834029,129554.6392746913,-819.6952160493908,128734.94405864191,1708,4,275.7843137254902,35,16,19,36.27216916780353,0.6178571428571429,45.48611111111111,1018.0555555555552,29.087301587301578,0
1758,4,1,2,50,0.019230769230769232,0.038461538461538464,0.9615384615384616,52,1050,600,450,0.5714285714285714,15,6,9,356.2105474107936,0.44976275766716944,0.3812355815741819,0.20193947121039685,130066.77685682132,-1133.7684431748269,128933.0084136465,1709,0,271.46153846153845,37,15,22,35.89959779999282,0.6190878378378378,44.983552631578945,1020.0657894736842,27.569345661450924,0
1759,4,0,0,50,0.0,0.0,1.0,50,1150,800,350,0.6956521739130435,15,8,7,366.8107808978769,0.44873299319727894,0.38631462660185556,0.20700568508027323,129889.23890106326,-471.0453696940181,129418.19353136924,1710,1,263.84,36,14,23,35.809765797613785,0.619212962962963,45.15765765765766,1019.3693693693697,28.315815815815824,0
1760,4,1,0,51,0.0196078431372549,0.0,1.0,51,1500,1200,300,0.8,18,12,6,359.26987344883077,0.4488888888888889,0.38669436768762755,0.20534152193987465,130384.14292800448,-829.7737012384775,129554.36922676601,1711,0,259.6470588235294,34,17,24,35.49947546334071,0.6283700980392157,44.672619047619044,1021.3095238095234,30.038515406162453,0
1761,4,0,1,50,0.0,0.0196078431372549,0.9803921568627451,51,2050,1600,450,0.7804878048780488,25,16,9,360.6641052783449,0.4483496732026144,0.38510023156712014,0.2072732267683982,130597.00255102041,-779.6697845804969,129817.33276643991,1712,1,260.6470588235294,34,17,19,35.248029738333734,0.6305147058823529,44.464285714285715,1022.1428571428572,30.063025210084035,0
1762,4,0,0,50,0.0,0.0,1.0,50,1450,1000,450,0.6896551724137931,19,10,9,357.3500337241521,0.4482568027210884,0.3656983240223466,0.20634082592459088,130779.59183673457,-653.1816893424195,130126.41014739215,1713,2,257.08,34,16,21,35.14776342333954,0.6323529411764706,44.28571428571428,1022.8571428571419,30.08403361344535,0
1763,4,1,1,50,0.0196078431372549,0.0196078431372549,0.9803921568627451,51,1800,1300,500,0.7222222222222222,23,13,10,350.18483875512885,0.4483006535947713,0.3585358236822349,0.20463276419136323,131239.1643759644,-1008.4068769290209,130230.75749903539,1714,0,253.01960784313727,35,16,22,34.8663588614029,0.6348214285714286,43.83680555555555,1024.652777777777,29.275793650793627,0
1764,4,0,0,50,0.0,0.0,1.0,50,1850,1300,550,0.7027027027027027,24,13,11,360.41435039895794,0.44635204081632657,0.3696339337594423,0.21026206679206993,131175.6395266439,-544.4834183673576,130631.15610827655,1715,1,258.86,34,16,22,34.66855510362191,0.6363357843137255,43.89880952380952,1024.4047619047612,30.12955182072827,0
1765,4,1,1,50,0.0196078431372549,0.0196078431372549,0.9803921568627451,51,900,600,300,0.6666666666666666,12,6,6,351.091361158185,0.4469771241830065,0.371056940277007,0.20682517834307995,131548.0392907775,-962.7468113470946,130585.2924794304,1716,0,254.76470588235293,33,18,23,34.53129355313982,0.6423611111111112,43.53553921568627,1025.8578431372543,31.086601307189525,0
1766,4,0,0,50,0.0,0.0,1.0,50,1700,1100,600,0.6470588235294118,23,11,12,360.58584013464673,0.4456547619047619,0.3735403726708073,0.2125932854653002,131579.47063629376,-510.8612072279825,131068.60942906578,1717,1,260.28,33,17,19,34.256051919095405,0.6426767676767677,43.504901960784316,1025.980392156863,31.090314913844335,0
1767,4,0,0,50,0.0,0.0,1.0,50,1450,1200,250,0.8275862068965517,17,12,5,360.3048875027846,0.4456037414965986,0.371364776119403,0.21295366498488516,131673.78720023547,-511.4581831507092,131162.32901708476,1718,2,261.28,33,17,20,34.16803482587066,0.6436237373737373,43.41299019607843,1026.3480392156862,31.101455733808674,0
1768,4,0,1,49,0.0,0.02,0.98,50,1950,1400,550,0.717948717948718,25,14,11,388.8479486951485,0.4448639455782313,0.3249049866088509,0.22174231023408422,130295.81917656785,168.11628975990124,130463.93546632775,1719,3,262.28,31,19,18,34.83412511159292,0.634744623655914,44.75911458333333,1020.963541666666,32.9343077956989,6
1769,4,0,2,47,0.0,0.04081632653061224,0.9591836734693877,49,1650,1500,150,0.9090909090909091,18,15,3,383.92977789528186,0.444515306122449,0.3121803343186016,0.2200254789467862,130488.2473727171,219.66476635037705,130707.91213906748,1720,4,265.48979591836735,32,17,15,34.764015900477844,0.6341145833333333,44.57070707070707,1021.7171717171719,31.928661616161623,0
1770,4,0,1,46,0.0,0.02127659574468085,0.9787234042553191,47,1300,900,400,0.6923076923076923,17,9,8,381.89348912473235,0.44295405488744993,0.29598062037908,0.2199554391843587,130681.82615294361,581.3077109478699,131263.13386389147,1721,5,268.0851063829787,32,15,15,34.61940190993662,0.6360677083333333,44.381313131313135,1022.4747474747478,31.95233585858587,0
1771,4,0,0,46,0.0,0.0,1.0,46,800,400,400,0.5,12,4,8,391.34307658435523,0.4419887278582931,0.29946919620347856,0.2243147642043416,130495.30241224503,1013.6866251627648,131508.9890374078,1722,6,274.0869565217391,31,15,15,34.56748332696147,0.636760752688172,44.563802083333336,1021.7447916666669,32.95950940860216,0
1772,4,0,1,45,0.0,0.021739130434782608,0.9782608695652174,46,900,500,400,0.5555555555555556,13,5,8,379.2201499695532,0.44221014492753624,0.2707073615510125,0.20986162226063756,129119.93805473375,655.0331020417932,129774.97115677554,1723,7,275.0869565217391,38,8,17,36.27798801639862,0.6077302631578947,45.91346153846154,1016.346153846154,26.745951417004054,8
1773,4,0,0,45,0.0,0.0,1.0,45,1050,700,350,0.6666666666666666,14,7,7,379.2663262563823,0.4412247474747475,0.30163934426229466,0.2103204172876306,129201.38888888918,800.3985864563115,130001.7874753455,1724,8,282.0,36,9,17,36.193647540983605,0.6122685185185186,45.83333333333335,1016.666666666669,28.240740740740804,0
1774,4,0,0,45,0.0,0.0,1.0,45,1050,700,350,0.6666666666666666,14,7,7,377.8806265726324,0.44082491582491584,0.303513164883527,0.20986467667933983,129260.23046339196,768.9873756859115,130029.21783907787,1725,9,283.0,35,10,17,36.16881022839367,0.6148809523809524,45.77546296296298,1016.8981481481508,29.05423280423288,0
1775,4,0,0,45,0.0,0.0,1.0,45,1600,1000,600,0.625,22,10,12,373.03691576392333,0.44059343434343434,0.3019949327232916,0.20776914284903167,129373.18019032589,652.194424153932,130025.37461447982,1726,10,284.0,36,9,17,36.176758172828585,0.6140046296296297,45.66441441441444,1017.3423423423458,28.259509509509606,0
1776,4,0,0,45,0.0,0.0,1.0,45,1500,1100,400,0.7333333333333333,19,11,8,376.2050669590409,0.4403619528619529,0.31344641101278214,0.21045134933847395,129545.0856261671,747.1035224414072,130292.18914860851,1727,11,285.0,36,9,17,35.92090707964602,0.6157407407407407,45.49549549549552,1018.0180180180212,28.278278278278364,0
1777,4,0,0,45,0.0,0.0,1.0,45,1400,1000,400,0.7142857142857143,18,10,8,377.5685767218726,0.44023569023569026,0.3159811292938217,0.21183189875140349,129659.75265806387,791.089653843072,130450.84231190693,1728,12,286.0,36,9,17,35.769340630989234,0.6168981481481481,45.3828828828829,1018.4684684684717,28.29079079079088,0
1778,4,1,0,46,0.021739130434782608,0.0,1.0,46,1950,1500,450,0.7692307692307693,24,15,9,374.8876399115671,0.4414855072463768,0.3220300782690657,0.21270362884822053,130099.04308431942,554.5046433267496,130653.54772764618,1729,0,280.7608695652174,38,8,18,35.390485914755494,0.6175986842105263,44.95192307692307,1020.1923076923068,26.847165991902813,0
1779,4,0,0,46,0.0,0.0,1.0,46,1550,1100,450,0.7096774193548387,20,11,9,379.082026899087,0.44161634460547505,0.33054327547047424,0.21615741108288342,130292.97052154176,678.7555850742474,130971.72610661601,1730,1,281.7608695652174,34,12,19,35.08628731343284,0.6274509803921569,44.76190476190475,1020.9523809523795,30.02801120448175,0
1780,4,0,0,46,0.0,0.0,1.0,46,1700,1400,300,0.8235294117647058,20,14,6,371.80831149430304,0.44087157809983896,0.31451179927199635,0.21297546823881974,130469.43486636225,501.9240558556164,130971.35892221787,1731,2,282.7608695652174,35,11,21,35.09273158113363,0.6270833333333333,44.58912037037037,1021.6435185185181,29.189814814814802,0
1781,4,0,1,45,0.0,0.021739130434782608,0.9782608695652174,46,1300,800,500,0.6153846153846154,18,8,10,372.6711547809451,0.44030797101449276,0.3180905017479938,0.2139587969256009,130558.13426997585,531.0501328875058,131089.18440286335,1732,3,283.7608695652174,35,11,19,34.980653076632706,0.6279761904761905,44.50231481481481,1021.9907407407396,29.199735449735417,0
1782,4,0,1,44,0.0,0.022222222222222223,0.9777777777777777,45,1250,1000,250,0.8,15,10,5,380.977385699483,0.44097222222222227,0.3235683959821889,0.21860360152702935,130536.16780045332,946.2655895691346,131482.43339002246,1733,4,290.02222222222224,34,11,19,34.7907444082013,0.6299019607843137,44.52380952380951,1021.9047619047603,30.05602240896354,0
1783,4,0,0,44,0.0,0.0,1.0,44,1050,800,250,0.7619047619047619,13,8,5,380.11296230224883,0.4389424770965469,0.307306885056998,0.21923486520252417,130735.62349965704,1138.8610253772247,131874.48452503426,1734,5,288.8863636363636,35,9,19,34.610306322619586,0.6297619047619047,44.3287037037037,1022.685185185185,29.219576719576715,0
1784,4,1,0,45,0.022222222222222223,0.0,1.0,45,1850,1700,150,0.918918918918919,20,17,3,371.0907015025979,0.438236531986532,0.3004901261004045,0.21608398703455484,131103.4404816865,730.2535395506136,131833.6940212371,1735,0,283.44444444444446,37,8,20,34.46823697359029,0.6295045045045045,43.96929824561403,1024.1228070175425,27.678994784257906,0
1785,4,0,0,45,0.0,0.0,1.0,45,1100,800,300,0.7272727272727273,14,8,6,373.33769967395415,0.4382154882154882,0.30056126331811317,0.2180292166095889,131215.75869498285,797.5579024314939,132013.31659741435,1736,1,284.44444444444446,37,8,21,34.296964183789946,0.6306306306306306,43.85964912280701,1024.5614035087701,27.690848743480274,0
1786,4,1,0,46,0.021739130434782608,0.0,1.0,46,1550,1000,550,0.6451612903225806,21,10,11,363.1682812542671,0.4392713365539453,0.301192501752958,0.214537851424489,131654.5718262386,362.69718904187266,132017.26901528047,1737,0,279.2391304347826,35,11,17,34.113966580203744,0.6389880952380953,43.43171296296295,1026.273148148146,29.322089947089886,0
1787,4,1,1,46,0.02127659574468085,0.02127659574468085,0.9787234042553191,47,1200,800,400,0.6666666666666666,16,8,8,371.0665954449101,0.44029448041936475,0.25711880642071416,0.20762733928329666,129554.63927469116,298.84299447014155,129853.4822691613,1738,0,274.27659574468083,35,12,17,36.04195088676672,0.6178571428571429,45.4861111111111,1018.0555555555538,29.08730158730154,8
1788,4,0,1,45,0.0,0.021739130434782608,0.9782608695652174,46,1150,600,550,0.5217391304347826,17,6,11,372.5474220974034,0.4393820450885668,0.24960579197353994,0.20901481919658293,129659.75265806346,460.8813205096975,130120.63397857315,1739,1,274.2391304347826,36,10,17,35.89718782249742,0.6168981481481481,45.38288288288288,1018.4684684684684,28.290790790790787,0
1789,4,0,2,43,0.0,0.044444444444444446,0.9555555555555556,45,950,500,450,0.5263157894736842,14,5,9,375.4365165917348,0.43899410774410774,0.24607034089792745,0.21125308470908052,129774.47041636227,744.415023131234,130518.8854394935,1740,2,279.4222222222222,36,9,17,35.70678603006188,0.6180555555555556,45.27027027027027,1018.9189189189185,28.30330330330329,0
1790,4,0,1,42,0.0,0.023255813953488372,0.9767441860465116,43,1100,700,400,0.6363636363636364,15,7,8,382.138059999575,0.438030638612034,0.2564584808173873,0.21511147571843056,129790.40745027417,1319.5709019204178,131109.9783521946,1741,3,291.5581395348837,35,8,19,35.519839466908984,0.6202380952380953,45.25462962962962,1018.98148148148,29.11375661375657,0
1791,4,1,1,42,0.023255813953488372,0.023255813953488372,0.9767441860465116,43,900,500,400,0.5555555555555556,13,5,8,377.6296235196098,0.4393918420081211,0.27777162125793553,0.21418452391903703,130085.41907793186,1224.821566357997,131310.24064428985,1742,0,291.95348837209303,35,8,20,35.33441116405718,0.6232142857142857,44.965277777777764,1020.138888888887,29.146825396825342,0
1792,4,0,0,42,0.0,0.0,1.0,42,1250,800,450,0.64,17,8,9,379.0981433872745,0.4389759969028262,0.2712120495477741,0.21536102051611858,130147.65346004778,1467.7467585828922,131615.40021863068,1743,1,296.3809523809524,36,6,20,35.233647868152886,0.6218171296296297,44.90427927927927,1020.382882882882,28.343968968968944,0
1793,4,0,1,41,0.0,0.023809523809523808,0.9761904761904762,42,1300,800,500,0.6153846153846154,18,8,10,378.4793974313501,0.43858885017421606,0.26527479360637907,0.21598255434256022,130323.35778061181,1465.0426376113608,131788.40041822317,1744,2,297.3809523809524,34,8,21,35.07078038164082,0.6277573529411764,44.73214285714283,1021.071428571425,30.03151260504191,0
1794,4,0,0,41,0.0,0.0,1.0,41,1300,900,400,0.6923076923076923,17,9,8,379.7397563864596,0.43948170731707314,0.2583996864195073,0.21776272962519258,130512.91120001921,1712.1882208765867,132225.0994208958,1745,3,302.6829268292683,33,8,17,34.84598624770129,0.6319444444444444,44.54656862745098,1021.813725490196,30.964052287581698,0
1795,4,0,0,41,0.0,0.0,1.0,41,850,500,350,0.5882352941176471,12,5,7,381.1351358891127,0.43874491869918697,0.2679150018884049,0.21955531067415085,130688.28125,1761.9791666666672,132450.26041666666,1746,4,303.6829268292683,34,7,18,34.63223308883455,0.6314338235294117,44.375,1022.5,30.073529411764707,0
1796,4,1,0,42,0.023809523809523808,0.0,1.0,42,1000,700,300,0.7,13,7,6,377.7627118644067,0.43833478513356566,0.28514931396287335,0.22023715415019762,131150.233892747,1508.7336033950698,132658.96749614205,1747,0,297.42857142857144,35,7,19,34.25,0.6339285714285714,43.923611111111114,1024.305555555556,29.26587301587303,0
1797,4,0,0,42,0.0,0.0,1.0,42,1500,1100,400,0.7333333333333333,19,11,8,374.15587828941943,0.4382379984514131,0.2864941323265242,0.2188095208965998,131268.81456832995,1422.9997213648912,132691.81428969486,1748,1,298.42857142857144,35,7,21,34.222291243129284,0.6351190476190476,43.807870370370374,1024.768518518519,29.279100529100543,0
1798,4,0,1,41,0.0,0.023809523809523808,0.9761904761904762,42,2150,1800,350,0.8372093023255814,25,18,7,376.6693216995821,0.43687088656600853,0.2863138756721213,0.22185642823549537,131541.75347222213,1509.5620070301734,133051.3154792523,1749,2,299.42857142857144,34,8,21,33.88166802057948,0.6400122549019608,43.541666666666664,1025.8333333333328,30.171568627450966,0
1799,4,0,0,41,0.0,0.0,1.0,41,1050,800,250,0.7619047619047619,13,8,5,379.05798889616614,0.4354166666666666,0.2791768147017353,0.22348404810131692,131579.47063629364,1775.2499038831124,133354.72054017676,1750,3,305.390243902439,33,8,16,33.78225035833732,0.6426767676767677,43.50490196078431,1025.980392156862,31.090314913844306,0
1800,4,0,0,41,0.0,0.0,1.0,41,800,500,300,0.625,11,5,6,381.7304165738468,0.435010162601626,0.2814706953039674,0.22561695404417578,131673.78720023565,1852.7779279604167,133526.56512819606,1751,4,306.390243902439,33,8,16,33.618283582089546,0.6436237373737373,43.41299019607844,1026.3480392156875,31.101455733808713,0
1801,4,1,0,42,0.023809523809523808,0.0,1.0,42,1100,800,300,0.7272727272727273,14,8,6,372.3185198671274,0.4349956445993031,0.2788036224450401,0.22230968883352542,132061.2882653061,1433.772675736959,133495.06094104305,1752,0,300.07142857142856,34,8,18,33.46845803412864,0.6452205882352942,43.035714285714285,1027.8571428571427,30.231092436974784,0
1802,4,0,0,42,0.0,0.0,1.0,42,1250,700,550,0.56,18,7,11,371.4572086458339,0.4346205962059621,0.2758930246268456,0.22254870524735215,132189.63162562152,1420.5583151148753,133610.1899407364,1753,1,301.07142857142856,35,7,19,33.361118927030574,0.6443452380952381,42.910879629629626,1028.356481481481,29.381613756613746,0
1803,4,0,0,42,0.0,0.0,1.0,42,1500,900,600,0.6,21,9,12,376.55300637036424,0.43446331784746417,0.2788080643816193,0.2263281754078718,132311.0948786626,1564.428110542995,133875.5229892056,1754,2,302.07142857142856,36,6,19,33.10757807939287,0.6435185185185186,42.7927927927928,1028.8288288288302,28.578578578578615,0
1804,4,0,0,42,0.0,0.0,1.0,42,950,600,350,0.631578947368421,13,6,7,377.21055745540434,0.43405197444831595,0.27988720355132557,0.22743113526913714,132428.63520408166,1590.7529288803462,134019.388132962,1755,3,303.07142857142856,34,8,20,32.97213547690648,0.6488970588235294,42.67857142857143,1029.2857142857144,30.273109243697483,0
1805,4,0,0,42,0.0,0.0,1.0,42,1250,700,550,0.56,18,7,11,376.67644252554874,0.4337132210607821,0.2813079688007445,0.22803554263740541,132581.84700963728,1588.091695011353,134169.93870464864,1756,4,304.07142857142856,34,8,22,32.83146457056988,0.6504289215686274,42.52976190476191,1029.8809523809532,30.290616246498622,0
1806,4,0,1,41,0.0,0.023809523809523808,0.9761904761904762,42,1000,600,400,0.6,14,6,8,373.9411466750488,0.43253968253968256,0.27483276120059874,0.22730579814741744,132735.14739229032,1527.0266439909424,134262.17403628127,1757,5,305.07142857142856,34,8,18,32.74751617375232,0.6519607843137255,42.38095238095239,1030.4761904761913,30.308123249299744,0
1807,4,0,0,41,0.0,0.0,1.0,41,900,600,300,0.6666666666666666,12,6,6,371.4357294529088,0.43216463414634143,0.25846931793141015,0.22641430117086012,132839.80320069208,1668.289840445986,134508.09304113808,1758,6,300.8780487804878,33,8,18,32.70674829608495,0.6553030303030303,42.279411764705884,1030.8823529411768,31.23885918003566,0
1808,4,0,2,39,0.0,0.04878048780487805,0.9512195121951219,41,800,500,300,0.625,11,5,6,371.11622343351235,0.43158028455284553,0.2611095328923334,0.2266017346857456,132902.97752066515,1664.4902201076527,134567.46774077282,1759,7,301.8780487804878,33,8,18,32.651434117740266,0.6559343434343434,42.21813725490196,1031.1274509803925,31.246286393345226,0
1809,4,0,0,39,0.0,0.0,1.0,39,1050,700,350,0.6666666666666666,14,7,7,380.6591683974891,0.42965587044534415,0.24344565650286132,0.23241634190745675,132901.00309583865,2317.9970635308064,135219.00015936946,1760,8,300.87179487179486,31,8,18,32.407422022982715,0.6609543010752688,42.22005208333333,1031.1197916666658,33.261928763440835,0
1810,4,0,2,37,0.0,0.05128205128205128,0.9487179487179487,39,1400,1200,200,0.8571428571428571,16,12,4,378.5915204065404,0.4297121007647324,0.24317539241493602,0.2315571392253957,132966.16685890045,2267.972654748173,135234.13951364864,1761,9,301.87179487179486,33,6,18,32.395140209125465,0.6565656565656566,42.15686274509804,1031.372549019608,31.253713606654788,0
1811,4,0,1,36,0.0,0.02702702702702703,0.972972972972973,37,850,500,350,0.5882352941176471,12,5,7,387.19029952208757,0.42864739739739743,0.2312404237223631,0.23651332656670818,132918.29476902864,2892.93487271706,135811.2296417457,1762,10,309.2972972972973,32,5,18,32.22164401453001,0.6585286458333333,42.20328282828282,1031.1868686868684,32.224589646464636,0
1812,4,0,0,36,0.0,0.0,1.0,36,1500,1200,300,0.8,18,12,6,404.4991090478363,0.42615740740740743,0.24823187673654967,0.24675068917109153,132867.44011772997,3548.9522298177044,136416.3923475477,1763,11,318.3333333333333,31,5,18,31.826744969268333,0.6606182795698925,42.252604166666664,1030.989583333333,33.25772849462365,0
1813,4,0,1,35,0.0,0.027777777777777776,0.9722222222222222,36,1350,900,450,0.6666666666666666,18,9,9,403.02716599075035,0.42547949735449736,0.24647762817897445,0.246831480220722,133015.96297571683,3521.80931792675,136537.7722936436,1764,12,319.3333333333333,32,4,19,31.714861281109744,0.6595052083333333,42.10858585858586,1031.565656565657,32.23642676767678,0
1814,4,0,0,35,0.0,0.0,1.0,35,750,400,350,0.5333333333333333,11,4,7,408.09186828993614,0.42314425770308123,0.24816264679883848,0.24916572898905187,132901.00309583868,3847.1637301974733,136748.16682603615,1765,13,328.45714285714286,31,4,19,31.700262028033848,0.6609543010752688,42.22005208333333,1031.119791666666,33.26192876344084,0
1815,4,0,0,35,0.0,0.0,1.0,35,1000,700,300,0.7,13,7,6,405.0901235289468,0.42205882352941176,0.24607061708803735,0.24800030591934416,133001.71746147994,3775.5364312065876,136777.25389268654,1766,14,329.45714285714286,31,4,19,31.676028780610963,0.6619623655913979,42.12239583333333,1031.5104166666658,33.274529569892444,0
1816,4,0,0,35,0.0,0.0,1.0,35,550,300,250,0.5454545454545454,8,3,5,405.64820616655817,0.4215686274509804,0.24544602293214113,0.24878919393682708,133068.8815646701,3795.8306206597176,136864.71218532982,1767,15,330.45714285714286,31,4,19,31.59389197375063,0.6626344086021505,42.057291666666664,1031.770833333333,33.28293010752687,0
1817,4,0,0,35,0.0,0.0,1.0,35,1450,1100,350,0.7586206896551724,18,11,7,410.54658424305126,0.42100840336134454,0.2492720196050171,0.2527028975061265,133203.26063368047,3937.2287326388796,137140.48936631935,1768,16,331.45714285714286,31,4,20,31.331987891019175,0.663978494623656,41.92708333333333,1032.291666666666,33.29973118279568,0
1818,4,0,0,35,0.0,0.0,1.0,35,750,600,150,0.8,9,6,3,409.87087580705116,0.4203781512605042,0.251793144442243,0.25297166661678766,133304.08944023974,3927.4927775065007,137231.58221774624,1769,17,332.45714285714286,31,4,20,31.247767200437107,0.664986559139785,41.82942708333333,1032.682291666666,33.31233198924729,0
1819,4,0,0,35,0.0,0.0,1.0,35,900,500,400,0.5555555555555556,13,5,8,408.2837085944589,0.41971288515406163,0.25485584628405733,0.25244853158845243,133371.3298373753,3890.6682332356877,137261.99807061098,1770,18,333.45714285714286,31,4,20,31.220980923568224,0.6656586021505376,41.76432291666667,1032.942708333334,33.32073252688174,0
1820,4,0,0,35,0.0,0.0,1.0,35,950,500,450,0.5263157894736842,14,5,9,408.2837085944589,0.419327731092437,0.25485584628405733,0.25244853158845243,133371.3298373753,3890.6682332356877,137261.99807061098,1771,19,334.45714285714286,31,4,20,31.220980923568224,0.6656586021505376,41.76432291666667,1032.942708333334,33.32073252688174,0
1821,4,1,1,35,0.027777777777777776,0.027777777777777776,0.9722222222222222,36,1000,600,400,0.6,14,6,8,396.41088842727373,0.4220568783068783,0.2398940571630106,0.24729638896479836,133700.6447843334,3400.078276451402,137100.7230607848,1772,0,326.1388888888889,32,4,16,31.196333374028406,0.6663411458333333,41.44570707070708,1034.217171717173,32.319286616161655,0
1822,4,0,0,35,0.0,0.0,1.0,35,1000,700,300,0.7,13,7,6,405.18830775197745,0.41817226890756304,0.24858797711983316,0.25259070173989057,133674.12143283428,3832.6382107204963,137506.75964355477,1773,21,336.45714285714286,31,4,20,30.996075715604807,0.6686827956989247,41.47135416666667,1034.114583333334,33.35853494623658,0
1823,4,0,0,35,0.0,0.0,1.0,35,1050,900,150,0.8571428571428571,12,9,3,404.61253192182005,0.41782212885154063,0.2482761101419042,0.2524616921488625,133707.78613620345,3819.969177246114,137527.75531344957,1774,22,337.45714285714286,31,4,16,30.977091988753205,0.669018817204301,41.43880208333334,1034.2447916666677,33.362735215053796,0
1824,4,0,0,35,0.0,0.0,1.0,35,1100,900,200,0.8181818181818182,13,9,4,402.856257549603,0.41715686274509806,0.24426827733735967,0.2522851598697162,133842.4873352053,3783.8567097982072,137626.34404500353,1775,23,338.45714285714286,31,4,16,30.887048571788085,0.6703629032258065,41.308593750000014,1034.7656250000018,33.37953629032264,0
1825,4,0,0,35,0.0,0.0,1.0,35,1000,600,400,0.6,14,6,8,401.59257814801583,0.4165966386554622,0.24433621479790824,0.25195417550896454,133909.86336602116,3755.441453721809,137665.30481974297,1776,24,339.45714285714286,31,4,16,30.852020170252032,0.6710349462365591,41.24348958333334,1035.0260416666677,33.38793682795702,0
1826,4,0,0,35,0.0,0.0,1.0,35,1150,700,450,0.6086956521739131,16,7,9,404.13667102880737,0.41551120448179274,0.2509603992388616,0.25565338855701486,134213.26531304247,3848.1004503038093,138061.3657633463,1777,25,340.45714285714286,31,4,17,30.481381419117024,0.6740591397849462,40.95052083333333,1036.197916666666,33.42573924731181,0
1827,4,0,0,35,0.0,0.0,1.0,35,1000,600,400,0.6,14,6,8,402.4266468932585,0.4153011204481793,0.2497298655610003,0.25480618000186517,134246.99783325195,3804.913838704427,138051.9116719564,1778,26,341.45714285714286,31,4,17,30.491817439376803,0.6743951612903225,40.91796875,1036.328125,33.42993951612903,0
1828,4,0,0,35,0.0,0.0,1.0,35,1400,1000,400,0.7142857142857143,18,10,8,404.34654410004896,0.41390056022408966,0.2566045860695445,0.25673103541663406,134348.22082519534,3864.647759331596,138212.86858452694,1779,27,342.45714285714286,31,4,17,30.340471405844426,0.6754032258064516,40.8203125,1036.7187500000002,33.442540322580655,0
1829,4,0,0,35,0.0,0.0,1.0,35,1200,800,400,0.6666666666666666,16,8,8,405.2880195458125,0.41295518207282916,0.25722633830741914,0.2580647901201013,134452.55107897162,3898.4016299357336,138350.95270890737,1780,28,343.45714285714286,32,3,17,30.211376917457997,0.673828125,40.719696969696976,1037.121212121213,32.410037878787904,0
1830,4,0,0,35,0.0,0.0,1.0,35,1200,1000,200,0.8333333333333334,14,10,4,403.9089458626554,0.41260504201680676,0.2560890357360224,0.2574175322158043,134485.29048375183,3863.9623826650527,138349.25286641688,1781,29,344.45714285714286,32,3,17,30.214292960032463,0.6741536458333333,40.68813131313132,1037.247474747476,32.413983585858624,0
1831,4,0,0,35,0.0,0.0,1.0,35,1150,800,350,0.6956521739130435,15,8,7,402.33120122668305,0.41200980392156866,0.24745653342892981,0.2573498935615298,134618.33530002163,3832.2472519296007,138450.58255195123,1782,30,345.45714285714286,31,4,17,30.12181095775827,0.6780913978494624,40.55989583333333,1037.760416666666,33.47614247311826,0
1832,4,0,1,34,0.0,0.02857142857142857,0.9714285714285714,35,800,600,200,0.75,10,6,4,399.3077628196429,0.41172969187675074,0.2397247509139131,0.2558907946300799,134685.9063042534,3756.2255859374955,138442.1318901909,1783,31,346.45714285714286,31,4,17,30.13254724870379,0.678763440860215,40.494791666666664,1038.020833333333,33.48454301075268,0
1833,4,0,0,34,0.0,0.0,1.0,34,1300,1100,200,0.8461538461538461,15,11,4,403.4890708178516,0.41070632798573975,0.22417022469010184,0.2597766196863602,134854.90798950195,4082.4963039822046,138937.40429348417,1784,32,337.02941176470586,31,3,16,29.854712506790353,0.6804435483870968,40.33203125,1038.671875,33.50554435483871,0
1834,4,0,0,34,0.0,0.0,1.0,34,1400,1100,300,0.7857142857142857,17,11,6,408.0220951797403,0.40923945335710044,0.21991216629455246,0.26417196965286843,135057.8498840332,4221.317376030816,139279.16726006402,1785,33,338.02941176470586,31,3,17,29.533722702409296,0.6824596774193548,40.13671875,1039.453125,33.530745967741936,0
1835,4,0,0,34,0.0,0.0,1.0,34,750,500,250,0.6666666666666666,10,5,5,408.3116132063725,0.4089609328579917,0.22356477661204766,0.26460713635062333,135091.68836805562,4231.901041666676,139323.5894097223,1786,34,339.02941176470586,31,3,17,29.49231796927187,0.6827956989247312,40.10416666666667,1039.583333333334,33.53494623655916,0
1836,4,0,0,34,0.0,0.0,1.0,34,1050,900,150,0.8571428571428571,12,9,3,408.15401652199625,0.4083853238265003,0.2234402963639439,0.2652502953589249,135193.22925143782,4235.931905110687,139429.1611565485,1787,35,340.02941176470586,31,3,17,29.39477171236592,0.6838037634408602,40.00651041666667,1039.9739583333342,33.54754704301078,0
1837,4,1,0,35,0.02857142857142857,0.0,1.0,35,800,700,100,0.875,9,7,2,399.1239786462,0.4086834733893558,0.216250303177298,0.2616197398979782,135502.18887103366,3816.4345474951665,139318.62341852882,1788,0,331.2857142857143,32,3,18,29.320781793192662,0.6842447916666667,39.709595959595966,1041.1616161616168,32.53630050505053,0
1838,4,0,0,35,0.0,0.0,1.0,35,1050,800,250,0.7619047619047619,13,8,5,404.35273132165986,0.40770308123249305,0.21690877296258493,0.2662661122214696,135666.56344059276,3971.4290952453784,139637.99253583813,1789,1,332.2857142857143,32,3,18,29.020472265987966,0.6858723958333333,39.551767676767675,1041.7929292929289,32.55602904040403,0
1839,4,0,0,35,0.0,0.0,1.0,35,1050,800,250,0.7619047619047619,13,8,5,400.6916745538128,0.4062324929971988,0.21368355481727552,0.2650729539355993,135831.03764921954,3885.2731864095576,139716.3108356291,1790,2,333.2857142857143,32,3,18,28.9516715116279,0.6875,39.3939393939394,1042.424242424243,32.57575757575759,0
1840,4,0,1,34,0.0,0.02857142857142857,0.9714285714285714,35,950,500,450,0.5263157894736842,14,5,9,398.9083055163398,0.4058823529411764,0.21185141611446556,0.26413679860853406,135863.94444763302,3839.4511720742926,139703.39561970733,1791,3,334.2857142857143,32,3,17,28.96532235275121,0.6878255208333333,39.362373737373744,1042.550505050506,32.57970328282831,0
1841,4,0,0,34,0.0,0.0,1.0,34,1000,1000,0,1.0,10,10,0,405.9651988463061,0.40474598930481287,0.20447164626530112,0.2686080480961593,135837.20737033425,4229.035780164935,140066.24315049918,1792,4,338.8529411764706,31,3,19,28.808081438920812,0.6901881720430108,39.388020833333336,1042.447916666667,33.62735215053765,0
1842,4,0,0,34,0.0,0.0,1.0,34,1150,800,350,0.6956521739130435,15,8,7,402.2801210855273,0.40335338680926913,0.2048252472085803,0.2679526691819061,136074.84817504883,4148.041280110678,140222.88945515951,1793,5,339.8529411764706,31,3,17,28.667087857231994,0.6925403225806452,39.16015625,1043.359375,33.656754032258064,0
1843,4,0,0,34,0.0,0.0,1.0,34,1050,900,150,0.8571428571428571,12,9,3,402.2801210855273,0.40335338680926913,0.2048252472085803,0.2679526691819061,136074.84817504883,4148.041280110678,140222.88945515951,1794,6,340.8529411764706,31,3,17,28.667087857231994,0.6925403225806452,39.16015625,1043.359375,33.656754032258064,0
1844,4,0,2,32,0.0,0.058823529411764705,0.9411764705882353,34,950,700,250,0.7368421052631579,12,7,5,399.84803461356375,0.40246212121212116,0.19390929232755738,0.2676111470393617,136244.7187635633,4095.4366048176985,140340.15536838098,1795,7,341.8529411764706,31,3,17,28.561258002826964,0.6942204301075269,38.99739583333333,1044.010416666666,33.67775537634407,0
1845,4,0,0,32,0.0,0.0,1.0,32,800,500,300,0.625,11,5,6,417.19211616732275,0.4011676747311828,0.20431328950760497,0.2766304647201785,135913.84300208115,4940.436755694296,140854.27975777545,1796,44,360.46875,30,2,17,28.438923262009112,0.69375,39.314516129032256,1042.7419354838707,34.758064516129025,0
1846,4,0,0,32,0.0,0.0,1.0,32,700,400,300,0.5714285714285714,10,4,6,416.74460622807965,0.40078965053763443,0.20020940721649505,0.2768782657816692,135983.9287778933,4934.113770378069,140918.04254827136,1797,45,361.46875,30,2,17,28.380584192439866,0.6944444444444444,39.247311827956985,1043.0107526881714,34.76702508960571,0
1847,4,0,0,32,0.0,0.0,1.0,32,800,500,300,0.625,11,5,6,413.9214132364457,0.39950856854838707,0.20004750096612134,0.2758173331291439,136089.0913147473,4866.037800612775,140955.12911536006,1798,46,362.46875,30,2,18,28.34922066211516,0.6954861111111111,39.14650537634408,1043.413978494623,34.780465949820766,0
1848,4,0,0,32,0.0,0.0,1.0,32,750,500,250,0.6666666666666666,10,5,5,414.6449407892581,0.39885752688172044,0.1994405988409529,0.27684591274536446,136159.22225474045,4891.546529945656,141050.7687846861,1799,47,363.46875,30,2,18,28.2603562996351,0.6961805555555556,39.079301075268816,1043.6827956989248,34.78942652329749,0
1849,4,0,0,32,0.0,0.0,1.0,32,700,500,200,0.7142857142857143,9,5,4,413.4136280121589,0.39931955645161293,0.20332415990729968,0.276570512383328,136229.3712604058,4863.815722915937,141093.18698332174,1800,48,364.46875,30,2,18,28.222501180206848,0.696875,39.012096774193544,1043.9516129032256,34.798387096774185,0
1850,4,0,0,32,0.0,0.0,1.0,32,1400,900,500,0.6428571428571429,19,9,10,409.4727385246583,0.3977654569892473,0.19427425061109016,0.2755698351993218,136439.92667143588,4773.686083651278,141213.61275508715,1801,49,365.46875,30,2,18,28.11548522663922,0.6989583333333333,38.81048387096774,1044.7580645161281,34.82526881720427,0
1851,4,0,0,32,0.0,0.0,1.0,32,900,700,200,0.7777777777777778,11,7,4,407.27588988072756,0.3966733870967742,0.19082310016715986,0.2751854557430422,136580.3872738176,4725.179753439681,141305.5670272573,1802,50,366.46875,30,2,18,28.03298186961552,0.7003472222222222,38.67607526881719,1045.29569892473,34.843189964157666,0
1852,4,0,0,32,0.0,0.0,1.0,32,850,500,350,0.5882352941176471,12,5,7,398.3599931768282,0.39560231854838707,0.1560286665038466,0.24807376305133447,133635.36126734532,4246.99632052854,137882.35758787385,1803,51,367.46875,32,0,20,31.211584646069948,0.6656901041666667,41.508838383838395,1033.9646464646476,32.311395202020236,8
1853,4,0,0,32,0.0,0.0,1.0,32,550,300,250,0.5454545454545454,8,3,5,398.20204215808576,0.39528729838709675,0.1521062271062268,0.24819442353688925,133668.00103305798,4245.374196510574,137913.37522956857,1804,52,368.46875,32,0,20,31.182844932844926,0.666015625,41.477272727272734,1034.0909090909101,32.31534090909094,0
1854,4,0,0,32,0.0,0.0,1.0,32,650,400,250,0.6153846153846154,9,4,5,399.8032212257385,0.39461525537634407,0.15483856201171897,0.24963323081411987,133733.29252117145,4293.400227017675,138026.69274818912,1805,53,369.46875,32,0,19,31.075795491536475,0.6666666666666667,41.414141414141426,1034.3434343434355,32.32323232323236,0
1855,4,0,0,32,0.0,0.0,1.0,32,950,600,350,0.631578947368421,13,6,7,406.8635339693552,0.394510248655914,0.16090871660363493,0.2551691192002151,133896.5909888025,4495.528039230728,138392.11902803322,1806,54,370.46875,32,0,19,30.728976048147697,0.6682942708333333,41.25631313131315,1034.97474747475,32.34296085858594,0
1856,4,0,0,32,0.0,0.0,1.0,32,1000,700,300,0.7,13,7,6,406.1643143825075,0.39396421370967744,0.16661458968418486,0.2556372634114311,134027.3015030355,4487.421404703618,138514.7229077391,1807,55,371.46875,32,0,20,30.61567694996545,0.6695963541666667,41.13005050505051,1035.4797979797988,32.35874368686871,0
1857,4,0,0,32,0.0,0.0,1.0,32,1100,900,200,0.8181818181818182,13,9,4,403.26442958946586,0.3937331989247312,0.12991059775515534,0.24406098416386146,132570.9709937565,4294.272007684979,136865.24300144147,1808,56,372.46875,30,2,21,32.15788958496476,0.6604166666666667,42.54032258064516,1029.8387096774193,34.32795698924731,8
1858,4,0,0,32,0.0,0.0,1.0,32,950,600,350,0.631578947368421,13,6,7,402.10312412643646,0.3922841061827957,0.12849854687894857,0.24441199111648376,132733.23059082043,4274.489339192723,137007.71993001315,1809,57,373.46875,31,1,16,32.0239449077584,0.6592741935483871,42.38281250000001,1030.468750000001,33.24092741935487,0
1859,4,0,0,32,0.0,0.0,1.0,32,1250,1100,150,0.88,14,11,3,396.9881564287074,0.3907930107526882,0.126771846192701,0.2423862151703111,132901.0030958388,4152.024841308599,137053.0279371474,1810,58,374.46875,31,1,17,31.98649345456076,0.6609543010752688,42.220052083333336,1031.119791666667,33.26192876344087,0
1860,4,0,0,32,0.0,0.0,1.0,32,700,400,300,0.5714285714285714,10,4,6,400.88648279393544,0.39104502688172044,0.12862289767621027,0.21881603465185434,128573.35620456267,3962.786187065967,132536.14239162864,1811,59,375.46875,31,1,16,36.28741922369153,0.617271505376344,46.451822916666664,1014.1927083333329,32.71589381720429,8
1861,4,0,0,32,0.0,0.0,1.0,32,1000,600,400,0.6,14,6,8,396.2097531024501,0.39089801747311825,0.09149513593609093,0.21133909923217276,127650.6233215331,3726.3088650173477,131376.93218655046,1812,60,376.46875,31,1,16,37.35356805394493,0.6078629032258065,47.36328124999999,1010.5468749999992,32.598286290322555,7
1862,4,0,0,32,0.0,0.0,1.0,32,800,600,200,0.75,10,6,4,396.5912502279374,0.39104502688172044,0.09478039670273009,0.21206160239460775,127749.32861328118,3732.853190104154,131482.18180338532,1813,61,377.46875,31,1,16,37.24240082431734,0.6088709677419355,47.26562499999999,1010.9374999999994,32.61088709677418,0
1863,4,2,1,33,0.058823529411764705,0.029411764705882353,0.9705882352941176,34,1100,900,200,0.8181818181818182,13,9,4,385.5260915294856,0.40262923351158647,0.1184077691990506,0.2101345771617235,128517.04422577853,3109.3347510572876,131626.3789768358,1814,0,356.20588235294116,33,1,17,36.73454999597132,0.6117424242424243,46.50735294117647,1013.970588235294,30.726381461675576,0
1864,4,0,0,33,0.0,0.0,1.0,33,850,600,250,0.7058823529411765,11,6,5,395.268058345707,0.39689867424242425,0.12379495893514592,0.21447100528899926,128336.36435376496,3545.4531106519794,131881.81746441693,1815,1,368.0,32,1,17,36.67289719626168,0.6123046875,46.68560606060606,1013.2575757575761,31.664299242424253,0
1865,4,0,0,33,0.0,0.0,1.0,33,800,500,300,0.625,11,5,6,398.2735972978046,0.3975694444444444,0.1259443752594438,0.2169699447965651,128496.33487654311,3635.339506172828,132131.67438271595,1816,2,369.0,32,1,17,36.432648401826484,0.6139322916666667,46.52777777777777,1013.8888888888881,31.684027777777754,0
1866,4,1,0,34,0.029411764705882353,0.0,1.0,34,650,400,250,0.6153846153846154,9,4,5,385.99141749321535,0.4024435531788473,0.1279763172466668,0.21237217034188438,128890.09785899633,3150.094314686633,132040.19217368297,1817,0,359.11764705882354,33,1,19,36.34091640518144,0.615530303030303,46.13970588235293,1015.4411764705866,30.770944741532926,0
1867,4,1,0,35,0.02857142857142857,0.0,1.0,35,900,700,200,0.7777777777777778,11,7,4,377.58667024993326,0.4062324929971988,0.12833723653395812,0.2093889716840535,129201.38888888857,2757.319900999577,131958.70878988816,1818,0,349.8285714285714,33,2,20,36.23633879781422,0.6186868686868687,45.833333333333314,1016.6666666666641,30.80808080808073,0
1868,4,2,1,36,0.05405405405405406,0.02702702702702703,0.972972972972973,37,600,300,300,0.5,9,3,6,349.89960173690696,0.4133508508508508,0.07999605444860958,0.19174498175182475,128731.13854595312,1612.935099451277,130344.0736454044,1819,0,331.86486486486484,35,2,19,37.419213807785894,0.6095238095238096,46.29629629629628,1014.8148148148128,28.99470899470894,8
1869,4,0,0,36,0.0,0.0,1.0,36,1200,700,500,0.5833333333333334,17,7,10,358.23449555259776,0.4106812169312169,0.0904008397553755,0.19579962390017214,128627.12762188201,2015.7348356008965,130642.86245748292,1820,1,342.05555555555554,34,2,19,37.31394006963187,0.6106004901960784,46.39880952380952,1014.4047619047614,29.83543417366945,0
1870,4,0,0,36,0.0,0.0,1.0,36,900,600,300,0.6666666666666666,12,6,6,363.45631270335224,0.40925925925925927,0.09270226600471698,0.19956162127633512,128808.33510487528,2163.2405045351466,130971.57560941043,1821,2,343.05555555555554,34,2,19,36.99645244517415,0.6124387254901961,46.220238095238095,1015.1190476190476,29.856442577030812,0
1871,4,0,0,36,0.0,0.0,1.0,36,950,700,250,0.7368421052631579,12,7,5,366.61909228262124,0.40922619047619047,0.09149962880475138,0.20191268407120977,128929.21095521527,2253.582057823111,131182.79301303838,1822,3,344.05555555555554,34,2,19,36.79277536826476,0.6136642156862745,46.10119047619047,1015.5952380952369,29.870448179271676,0
1872,4,1,1,36,0.02702702702702703,0.02702702702702703,0.972972972972973,37,950,600,350,0.631578947368421,13,6,7,358.10266057511444,0.41222472472472477,0.0892778023925569,0.19858420268256324,129201.38888888879,1854.0462018140488,131055.43509070284,1823,0,335.72972972972974,33,4,20,36.731557377049185,0.6186868686868687,45.83333333333333,1016.6666666666658,30.80808080808078,0
1873,4,1,0,37,0.02702702702702703,0.0,1.0,37,1150,900,250,0.782608695652174,14,9,5,353.7572223368096,0.4123811311311311,0.07192462511611475,0.19829877325485354,129625.34722222203,1771.180555555535,131396.52777777758,1824,0,324.18918918918916,34,3,18,36.41059738134207,0.6207107843137255,45.41666666666666,1018.3333333333318,29.95098039215682,0
1874,4,2,1,38,0.05128205128205128,0.02564102564102564,0.9743589743589743,39,1000,600,400,0.6,14,6,8,340.74253785429113,0.4161605937921728,0.08805374451523318,0.19400442109391988,130234.60493853847,1075.293960641699,131309.89889918017,1825,0,308.5128205128205,37,2,20,36.1239794822215,0.620777027027027,44.8190789473684,1020.7236842105239,27.587126600284428,0
1875,4,0,0,38,0.0,0.0,1.0,38,1150,800,350,0.6956521739130435,15,8,7,349.6657884542498,0.4142810573731626,0.09302001417138084,0.1987874137372905,130176.38204082458,1503.6454528853117,131680.0274937099,1826,1,317.57894736842104,36,2,21,35.95531707496506,0.6221064814814814,44.876126126126124,1020.4954954954952,28.34709709709709,0
1876,4,0,0,38,0.0,0.0,1.0,38,950,700,250,0.7368421052631579,12,7,5,352.6369871163068,0.4136142721669038,0.09700032216110444,0.201226617098322,130321.6695066014,1591.2767117561632,131912.94621835757,1827,2,318.57894736842104,35,3,21,35.73216579762714,0.6255952380952381,44.73379629629629,1021.0648148148141,29.173280423280403,0
1877,4,0,0,38,0.0,0.0,1.0,38,1000,600,400,0.6,14,6,8,351.65960725148284,0.41294748696064487,0.1033457581631132,0.2011274163314539,130410.31867551853,1572.008289394703,131982.32696491323,1828,3,319.57894736842104,35,3,21,35.66725684608121,0.6264880952380952,44.64699074074073,1021.4120370370358,29.183201058201025,0
1878,4,0,1,37,0.0,0.02631578947368421,0.9736842105263158,38,950,800,150,0.8421052631578947,11,8,3,351.3699690594726,0.4126363205310574,0.15200421435754996,0.1960180690336854,129436.83556241418,1648.3616790980702,131085.19724151224,1829,4,320.57894736842104,35,3,15,36.66306490749166,0.6166666666666667,45.60185185185185,1017.5925925925919,29.074074074074055,8
1879,4,0,0,37,0.0,0.0,1.0,37,1000,1000,0,1.0,10,10,0,355.8629992329111,0.41169294294294295,0.15084425869312956,0.19871148141359612,129473.85381235828,1814.9907879818577,131288.84460034015,1830,5,320.4594594594595,34,3,17,36.51109291535072,0.6191789215686274,45.56547619047619,1017.7380952380953,29.933473389355743,0
1880,4,2,0,39,0.05128205128205128,0.0,1.0,39,800,500,300,0.625,11,5,6,377.42257936161354,0.4152327935222672,0.1843540675316382,0.2033737495984519,128059.03031409765,1879.657721531485,129938.68803562914,1831,0,304.97435897435895,36,3,14,37.40913811007268,0.6006944444444444,46.959459459459445,1012.1621621621603,28.115615615615564,8
1881,4,1,2,38,0.025,0.05,0.95,40,1150,800,350,0.6956521739130435,15,8,7,369.56718320655017,0.416252670940171,0.18661240137793134,0.20070821253323712,128372.67324334447,1488.4939838486878,129861.16722719316,1832,0,298.325,36,4,14,37.28678186465162,0.6038773148148149,46.64977477477476,1013.400900900899,28.150025025024974,0
1882,4,1,1,38,0.02564102564102564,0.02564102564102564,0.9743589743589743,39,1200,1100,100,0.9166666666666666,13,11,2,376.8558765249846,0.4181286549707602,0.19598899878713305,0.20569478933236418,128572.46393352801,1890.6577185293227,130463.12165205734,1833,0,302.0,36,3,15,36.897623806351305,0.6059027777777778,46.452702702702695,1014.1891891891883,28.171921921921896,0
1883,4,0,1,37,0.0,0.02631578947368421,0.9736842105263158,38,1200,700,500,0.5833333333333334,17,7,10,384.9201149718729,0.4153034613560929,0.20179443586709067,0.20984972789474657,128525.6736137902,2294.4234128514995,130820.0970266417,1834,1,310.5263157894737,35,3,15,36.741073127116394,0.6074404761904761,46.49884259259259,1014.0046296296289,28.971560846560823,0
1884,4,0,0,37,0.0,0.0,1.0,37,1400,1100,300,0.7857142857142857,17,11,6,392.8509979798006,0.4142892892892893,0.20786846741045184,0.21374608612127818,128446.04768990938,2692.0316043083967,131138.07929421778,1835,2,319.6756756756757,34,3,16,36.62164807202975,0.6087622549019608,46.577380952380956,1013.6904761904768,29.81442577030814,0
1885,4,1,0,38,0.02631578947368421,0.0,1.0,38,1100,700,400,0.6363636363636364,15,7,8,381.0719719440604,0.41770388809862496,0.21106631146950794,0.20944632442940464,128848.62075617285,2220.119598765435,131068.74035493829,1836,0,312.2368421052632,35,3,17,36.50820793433652,0.6107142857142858,46.18055555555556,1015.2777777777778,29.00793650793651,0
1886,4,1,0,39,0.02564102564102564,0.0,1.0,39,1000,600,400,0.6,14,6,8,373.765985837305,0.4191408007197481,0.21328128994869466,0.2069700483538354,129144.15048494453,1853.9381442253211,130998.08862916986,1837,0,305.20512820512823,36,3,18,36.39185870448335,0.6116898148148149,45.88963963963965,1016.4414414414425,28.234484484484515,0
1887,4,1,0,40,0.025,0.0,1.0,40,750,500,250,0.6666666666666666,10,5,5,364.5526249948852,0.42112713675213675,0.2093161343161345,0.20325057311358685,129413.28125000012,1435.6283225793507,130848.90957257946,1838,0,298.55,34,6,19,36.3516926016926,0.6185661764705883,45.62500000000001,1017.5000000000009,29.926470588235322,0
1888,4,0,1,39,0.0,0.025,0.975,40,850,500,350,0.5882352941176471,12,5,7,362.90140556068536,0.4212873931623931,0.2081578947368421,0.20279784428391245,129504.14540816336,1399.4472789115775,130903.59268707494,1839,1,299.55,34,6,17,36.301169590643276,0.6194852941176471,45.53571428571429,1017.8571428571436,29.936974789915986,0
1889,4,2,0,41,0.04878048780487805,0.0,1.0,41,1050,500,550,0.47619047619047616,16,5,11,352.9396499751386,0.4232469512195122,0.2223181523850637,0.20018082849941254,130085.4190779321,982.4604552469144,131067.87953317902,1840,0,293.1707317073171,35,6,20,35.964091218515996,0.6232142857142857,44.96527777777778,1020.1388888888889,29.1468253968254,0
1890,4,0,0,41,0.0,0.0,1.0,41,1200,1000,200,0.8333333333333334,14,10,4,357.02226998662536,0.4234502032520325,0.2261161785885737,0.20374722969373732,130325.14537677825,1106.0369742940825,131431.18235107235,1841,1,294.1707317073171,33,8,20,35.61669867178748,0.630050505050505,44.73039215686275,1021.0784313725497,30.941770647653023,0
1891,4,0,0,41,0.0,0.0,1.0,41,1350,1000,350,0.7407407407407407,17,10,7,356.9396863752984,0.4232215447154472,0.22576967581075746,0.20400969816213751,130384.14292800447,1107.855017006795,131491.99794501127,1842,2,295.1707317073171,34,7,20,35.558971519602125,0.6283700980392157,44.672619047619044,1021.3095238095233,30.03851540616245,0
1892,4,0,0,41,0.0,0.0,1.0,41,1400,1100,300,0.7857142857142857,17,11,6,359.33474007301965,0.4223577235772358,0.23071591302915118,0.20650924218654246,130597.00255102031,1185.6079931972672,131782.61054421758,1843,3,296.1707317073171,34,7,18,35.281999767062665,0.6305147058823529,44.46428571428571,1022.1428571428564,30.063025210084014,0
1893,4,1,0,42,0.023809523809523808,0.0,1.0,42,1400,1000,400,0.7142857142857143,18,10,8,349.8100799698068,0.4259944831591173,0.22757783490431338,0.20309868822127564,130991.17036011058,764.4063558017614,131755.57671591235,1844,0,290.0952380952381,37,5,19,35.12657097972008,0.6283783783783784,44.07894736842104,1023.684210526314,27.667140825035514,0
1894,4,1,1,42,0.023255813953488372,0.023255813953488372,0.9767441860465116,43,1550,1100,450,0.7096774193548387,20,11,9,344.3074981337977,0.42693337024732375,0.23566661590888738,0.20197853102444877,131387.44882758902,448.8352348561937,131836.28406244522,1845,0,284.3255813953488,35,8,20,34.867257469707226,0.6363095238095238,43.69212962962962,1025.2314814814804,29.292328042328013,0
1895,4,0,1,41,0.0,0.023809523809523808,0.9761904761904762,42,1450,900,550,0.6206896551724138,20,9,11,342.98508478148426,0.42652680991095626,0.22364185489114985,0.2016715883376729,131476.45968632106,618.8929344564381,132095.3526207775,1846,1,287.6190476190476,35,7,21,34.8113691080766,0.637202380952381,43.60532407407407,1025.578703703703,29.302248677248656,0
1896,4,0,0,41,0.0,0.0,1.0,41,1250,800,450,0.64,17,8,9,349.9106856840081,0.4248475609756098,0.22903897059864353,0.20576659093295085,131480.69905045352,1001.3003117913803,132481.9993622449,1847,2,295.4146341463415,34,7,21,34.6295221512865,0.6393995098039216,43.601190476190474,1025.595238095238,30.16456582633053,0
1897,4,0,0,41,0.0,0.0,1.0,41,1250,1000,250,0.8,15,10,5,352.5284109375354,0.4244664634146342,0.22409827392555282,0.20830345652450288,131663.90483276665,1083.0534297052363,132746.9582624719,1848,3,296.4146341463415,34,7,18,34.37753740865328,0.6412377450980392,43.42261904761906,1026.3095238095254,30.185574229691923,0
1898,4,0,0,41,0.0,0.0,1.0,41,1100,700,400,0.6363636363636364,15,7,8,352.71546635182983,0.4234756097560976,0.2211355717453274,0.20891608391608393,131755.55555555562,1094.4444444444491,132850.00000000006,1849,4,297.4146341463415,34,7,19,34.280303030303024,0.642156862745098,43.333333333333336,1026.6666666666672,30.196078431372566,0
1899,4,0,0,41,0.0,0.0,1.0,41,1100,700,400,0.6363636363636364,15,7,8,349.8668714728998,0.423729674796748,0.21719469801882307,0.20823111040076722,131938.95266439905,1032.2137188208621,132971.1663832199,1850,5,298.4146341463415,34,7,20,34.16859791425263,0.6439950980392157,43.154761904761905,1027.380952380952,30.217086834733884,0
1900,4,0,1,40,0.0,0.024390243902439025,0.975609756097561,41,1350,1000,350,0.7407407407407407,17,10,7,349.93774914300377,0.4237042682926829,0.22076109315309989,0.208609299074752,132000.11337868482,1038.364512471654,133038.47789115648,1851,6,299.4146341463415,34,7,21,34.105170682730915,0.6446078431372548,43.095238095238095,1027.6190476190477,30.224089635854344,0
1901,4,0,0,40,0.0,0.0,1.0,40,1150,800,350,0.6956521739130435,15,8,7,359.4226422821935,0.4188434829059829,0.22603075363298375,0.21399026127022347,131951.69331114978,1485.2852527006244,133436.9785638504,1852,7,307.725,35,5,21,33.910315985130104,0.6419642857142858,43.142361111111114,1027.430555555556,29.355158730158745,0
1902,4,0,0,40,0.0,0.0,1.0,40,1400,1000,400,0.7142857142857143,18,10,8,362.51410176263056,0.4189770299145299,0.23173758865248262,0.21684934450891916,132130.1269531251,1579.8068576389032,133709.933810764,1853,8,308.725,35,5,21,33.651004728132406,0.64375,42.96875000000001,1028.1250000000007,29.375000000000018,0
1903,4,0,0,40,0.0,0.0,1.0,40,1450,1300,150,0.896551724137931,16,13,3,360.16302236686107,0.41833600427350426,0.23383014623172116,0.21663391534786156,132338.45191400888,1532.6833633401886,133871.13527734907,1854,9,309.725,35,5,21,33.501593550806156,0.6458333333333333,42.7662037037037,1028.935185185185,29.39814814814814,0
1904,4,0,0,40,0.0,0.0,1.0,40,1650,1100,550,0.6666666666666666,22,11,11,358.57685738523276,0.41793536324786323,0.23048745229559398,0.2163722320872372,132459.27047902494,1499.37918390093,133958.64966292586,1855,10,310.725,34,6,21,33.420791411279446,0.649203431372549,42.648809523809526,1029.404761904762,30.276610644257705,0
1905,4,1,0,41,0.024390243902439025,0.0,1.0,41,1450,1100,350,0.7586206896551724,18,11,7,348.8778873961618,0.41933434959349597,0.23128566265456052,0.2128633028030829,132874.89819101518,1071.422753772298,133946.32094478747,1856,0,304.1219512195122,35,6,19,33.25288130519383,0.6511904761904762,42.245370370370374,1031.0185185185192,29.457671957671977,0
1906,4,0,0,41,0.0,0.0,1.0,41,1300,1000,300,0.7692307692307693,16,10,6,348.40049232254853,0.41857215447154467,0.22518168188560295,0.2131596599320125,132978.12328798414,1065.9287243324627,134044.0520123166,1857,1,305.1219512195122,36,5,21,33.16159879171671,0.6501736111111112,42.14527027027028,1031.4189189189206,28.65052552552557,0
1907,4,1,0,42,0.023809523809523808,0.0,1.0,42,1200,900,300,0.75,15,9,6,344.9497613155366,0.41959446380178084,0.24331210191082753,0.213216978450942,133358.94217451528,800.4270544783028,134159.36922899357,1858,0,298.8333333333333,37,5,22,32.86889596602971,0.652027027027027,41.776315789473685,1032.8947368421057,27.916073968705557,0
1908,4,0,0,42,0.0,0.0,1.0,42,1400,1000,400,0.7142857142857143,18,10,8,343.0671175858478,0.4190137437088657,0.24251152073732696,0.21270161290322587,133472.2222222223,757.9861111111209,134230.20833333343,1859,1,299.8333333333333,37,5,22,32.80409946236558,0.6531531531531531,41.66666666666667,1033.3333333333342,27.92792792792795,0
1909,4,0,0,42,0.0,0.0,1.0,42,750,400,350,0.5333333333333333,11,4,7,343.7322302438284,0.41865079365079366,0.2467009025832556,0.2137846797857958,133588.61395178965,783.7424417660952,134372.35639355576,1860,2,300.8333333333333,36,6,22,32.67043391430647,0.65625,41.554054054054056,1033.783783783784,28.71621621621622,0
1910,4,0,0,42,0.0,0.0,1.0,42,1150,600,550,0.5217391304347826,17,6,11,346.72860740146,0.4184088269454123,0.24396338112863303,0.21666999915576934,133763.29665814454,875.9123143413585,134639.20897248588,1861,3,301.8333333333333,36,6,19,32.418217940344,0.6579861111111112,41.38513513513513,1034.4594594594587,28.734984984984962,0
1911,4,0,0,42,0.0,0.0,1.0,42,1400,1000,400,0.7142857142857143,18,10,8,348.82009366865765,0.41711430507162217,0.24120510629482927,0.2195346174731899,134025.5347196858,950.1599149825381,134975.69463466833,1862,4,302.8333333333333,36,6,20,32.10191227116186,0.6605902777777778,41.13175675675675,1035.4729729729722,28.763138138138117,0
1912,4,1,0,43,0.023255813953488372,0.0,1.0,43,800,500,300,0.625,11,5,6,340.26539561429115,0.41775101513473606,0.2409020913997273,0.21589725168708096,134323.35550361636,541.1179401354111,134864.47344375178,1863,0,296.7674418604651,37,6,21,32.02612650729849,0.6615990990990991,40.84429824561403,1036.6228070175428,28.01683262209575,0
1913,4,0,1,42,0.0,0.023255813953488372,0.9767441860465116,43,1100,800,300,0.7272727272727273,14,8,6,343.6702786480848,0.4174972314507199,0.2492488209808854,0.21873711274923163,134437.04433094777,640.4032971683373,135077.44762811612,1864,1,297.7674418604651,37,6,21,31.82446958483118,0.6627252252252251,40.73464912280701,1037.0614035087704,28.02868658131812,0
1914,4,0,0,42,0.0,0.0,1.0,42,900,600,300,0.6666666666666666,12,6,6,349.3333753157403,0.4182636469221835,0.24375555693401996,0.2228572751668003,134521.5739388036,998.5750953656276,135520.14903416924,1865,2,301.5238095238095,36,6,21,31.593302214502824,0.6655092592592593,40.65315315315315,1037.3873873873868,28.8163163163163,0
1915,4,0,1,41,0.0,0.023809523809523808,0.9761904761904762,42,950,600,350,0.631578947368421,13,6,7,350.9245980336962,0.416182733255904,0.24301413440335495,0.22549656574694868,134784.55387397538,1059.843077875177,135844.39695185056,1866,3,302.5238095238095,36,6,20,31.289764306112854,0.6681134259259259,40.39977477477478,1038.4009009009012,28.844469469469477,0
1916,4,0,1,40,0.0,0.024390243902439025,0.975609756097561,41,950,500,450,0.5263157894736842,14,5,9,358.8324936942278,0.4157520325203252,0.2508416128290092,0.23094990155909728,134843.0287339705,1477.2120515786153,136320.24078554913,1867,4,308.1219512195122,36,5,20,31.026148397123148,0.6686921296296297,40.34346846846847,1038.6261261261266,28.850725725725738,0
1917,4,0,0,40,0.0,0.0,1.0,40,1600,1200,400,0.75,20,12,8,361.4280063244703,0.4141559829059829,0.24390574214517802,0.23393972639374921,135047.7906115577,1762.0107438519772,136809.80135540967,1868,5,299.775,36,4,20,30.754559407728426,0.6707175925925926,40.146396396396405,1039.414414414416,28.872622622622664,0
1918,4,0,0,40,0.0,0.0,1.0,40,1200,800,400,0.6666666666666666,16,8,8,362.0837601690221,0.41372863247863245,0.24606489004441512,0.23455404842949115,135077.05498995644,1781.8415966642594,136858.89658662069,1869,6,300.775,36,4,20,30.708346874661473,0.6710069444444444,40.118243243243256,1039.527027027029,28.875750750750804,0
1919,4,0,0,40,0.0,0.0,1.0,40,900,500,400,0.5555555555555556,13,5,8,362.06912809020184,0.4135817307692307,0.2451267056530213,0.2351157755826251,135164.86714755313,1787.805119308525,136952.67226686166,1870,7,301.775,36,4,20,30.62120965995236,0.671875,40.0337837837838,1039.8648648648664,28.885135135135176,0
1920,4,0,1,39,0.0,0.025,0.975,40,1050,700,350,0.6666666666666666,14,7,7,362.120040853807,0.41247329059829063,0.24965909090909078,0.23629867072663688,135340.57706355012,1801.9070590861238,137142.48412263626,1871,8,302.775,36,4,20,30.444850288600282,0.6736111111111112,39.86486486486487,1040.5405405405413,28.903903903903924,0
1921,4,0,0,39,0.0,0.0,1.0,39,950,600,350,0.631578947368421,13,6,7,369.0076462849233,0.41031264057579847,0.25502425502425496,0.24094028669192058,135362.54882812503,2189.9631076388882,137552.5119357639,1872,14,311.3333333333333,35,4,20,30.243785452118786,0.6758928571428571,39.84375,1040.6250000000002,29.732142857142865,0
1922,4,0,0,39,0.0,0.0,1.0,39,1150,700,450,0.6086956521739131,16,7,9,367.03020157547235,0.40986279802069275,0.25355460367130944,0.24085855022425415,135543.27317226076,2149.6949749228334,137692.9681471836,1873,15,312.3333333333333,35,4,22,30.115246748916295,0.6776785714285714,39.670138888888886,1041.3194444444441,29.751984126984116,0
1923,4,0,0,39,0.0,0.0,1.0,39,1200,900,300,0.75,15,9,6,371.73978353495767,0.40899122807017546,0.2582559759694554,0.24500245268327203,135697.51567906575,2288.893302589284,137986.40898165503,1874,16,313.3333333333333,33,6,22,29.839057476672178,0.6837121212121212,39.52205882352941,1041.9117647058822,31.573083778966126,0
1924,4,0,0,39,0.0,0.0,1.0,39,1500,1200,300,0.8,18,12,6,368.849635003792,0.40856950067476383,0.25548815582897144,0.24462521779012228,135921.05688016638,2226.8864439158115,138147.94332408218,1875,17,314.3333333333333,33,6,19,29.691968308065967,0.6859217171717171,39.30759803921569,1042.769607843138,31.599079025549635,0
1925,4,0,0,39,0.0,0.0,1.0,39,1000,800,200,0.8,12,8,4,370.3284325078249,0.407838506522717,0.25374797467820676,0.24671175855802993,136080.84180363332,2278.920967896967,138359.76277153028,1876,18,315.3333333333333,33,6,20,29.494557982930072,0.6875,39.154411764705884,1043.382352941177,31.617647058823547,0
1926,4,0,0,39,0.0,0.0,1.0,39,650,500,150,0.7692307692307693,8,5,3,371.6718260086611,0.4074167791273054,0.25344183428015743,0.2482767797737857,136176.75781250003,2322.6128472222226,138499.37065972225,1877,19,316.3333333333333,33,6,20,29.36418829008648,0.6884469696969697,39.0625,1043.7500000000002,31.628787878787886,0
1927,4,0,0,39,0.0,0.0,1.0,39,1250,800,450,0.64,17,8,9,369.9119393495763,0.4073605488079172,0.25506534514516344,0.2476433364958611,136254.42885487515,2280.4280045351393,138534.8568594103,1878,20,317.3333333333333,34,5,20,29.332953249714944,0.6868872549019608,38.988095238095234,1044.0476190476181,30.70728291316524,0
1928,4,0,0,39,0.0,0.0,1.0,39,1450,1000,450,0.6896551724137931,19,10,9,368.68856583956267,0.4069950517318938,0.2456278763971067,0.24791127703005103,136409.83737244914,2258.5494614512645,138668.3868339004,1879,21,318.3333333333333,34,5,20,29.210588793922128,0.6884191176470589,38.83928571428572,1044.6428571428585,30.724789915966426,0
1929,4,0,0,39,0.0,0.0,1.0,39,1100,600,500,0.5454545454545454,16,6,10,368.67033467386,0.4060672514619883,0.2429558745348217,0.24855516111882844,136503.12500000015,2264.930555555571,138768.0555555557,1880,22,319.3333333333333,34,5,20,29.118487506645394,0.6893382352941176,38.75000000000001,1045.0000000000011,30.735294117647094,0
1930,4,0,1,38,0.0,0.02564102564102564,0.9743589743589743,39,1650,1300,350,0.7878787878787878,20,13,7,366.07974500750214,0.4053362573099415,0.23435465316585735,0.24768199696886656,136627.5581065762,2203.3163265306393,138830.87443310686,1881,23,320.3333333333333,34,5,20,29.062760950428913,0.6905637254901961,38.630952380952394,1045.4761904761924,30.74929971988801,0
1931,4,0,0,38,0.0,0.0,1.0,38,600,400,200,0.6666666666666666,8,4,4,374.62240410550265,0.4027530820293978,0.24064990435528233,0.2523454213993859,136472.0255810659,2625.0956632653215,139097.1212443312,1882,24,328.57894736842104,34,4,20,28.99386654513692,0.689031862745098,38.77976190476191,1044.8809523809534,30.731792717086865,0
1932,4,0,0,38,0.0,0.0,1.0,38,1050,900,150,0.8571428571428571,12,9,3,374.0215501563436,0.4017010431484116,0.23944911241894262,0.2530552583569347,136627.5581065761,2620.3302154195135,139247.88832199562,1883,25,329.57894736842104,34,4,21,28.855186745616027,0.6905637254901961,38.63095238095239,1045.4761904761915,30.749299719887986,0
1933,4,0,0,38,0.0,0.0,1.0,38,1000,700,300,0.7,13,7,6,375.3354411982228,0.40098980559506875,0.245968612215953,0.2548518687849507,136752.96347858993,2665.6786642352954,139418.6421428252,1884,26,330.57894736842104,33,5,21,28.69642159734427,0.6941287878787878,38.5110294117647,1045.9558823529408,31.695632798573964,0
1934,4,0,1,37,0.0,0.02631578947368421,0.9736842105263158,38,1200,800,400,0.6666666666666666,16,8,8,374.56135821705266,0.40063418681839735,0.2461884182166787,0.2547912601672495,136817.06142168885,2649.2768706747465,139466.3382923636,1885,27,331.57894736842104,33,5,21,28.65309339736831,0.694760101010101,38.44975490196079,1046.2009803921574,31.703060011883558,0
1935,4,0,0,37,0.0,0.0,1.0,37,900,600,300,0.6666666666666666,12,6,6,369.73074262987694,0.39905530530530525,0.23614552381675646,0.25242767968039803,136945.30236267304,2726.577668444831,139671.88003111788,1886,28,336.5945945945946,33,4,21,28.65235823283768,0.6960227272727273,38.32720588235294,1046.6911764705885,31.71791443850268,0
1936,4,0,0,37,0.0,0.0,1.0,37,1000,600,400,0.6,14,6,8,381.08084723361156,0.3987424924924925,0.17248471154108258,0.2353207197138765,133322.7656276791,2761.350496184833,136084.11612386393,1887,29,337.5945945945946,35,2,19,31.972267361500236,0.6556547619047619,41.81134259259259,1032.754629629629,29.50727513227512,8
1937,4,0,0,37,0.0,0.0,1.0,37,1100,800,300,0.7272727272727273,14,8,6,379.8126951092613,0.3983671171171171,0.16434176111595478,0.23548387096774193,133472.22222222216,2738.888888888884,136211.11111111104,1888,30,338.5945945945946,35,2,19,31.854838709677416,0.6571428571428571,41.666666666666664,1033.333333333333,29.523809523809515,0
1938,4,0,0,37,0.0,0.0,1.0,37,800,400,400,0.5,12,4,8,375.03386128353895,0.3980855855855856,0.09664304797305157,0.21948786619918345,131297.6208191611,2452.5510204081784,133750.17183956926,1889,31,339.5945945945946,34,3,21,34.17063538157743,0.6375612745098039,43.77976190476191,1024.8809523809532,30.143557422969213,8
1939,4,1,1,37,0.02631578947368421,0.02631578947368421,0.9736842105263158,38,900,500,400,0.5555555555555556,13,5,8,370.28046761980465,0.403256875296349,0.09590537716131453,0.21822912666103386,131565.50068587108,2143.227023319617,133708.7277091907,1890,0,331.63157894736844,35,3,17,34.021510228640196,0.638095238095238,43.51851851851852,1025.925925925926,29.312169312169317,0
1940,4,0,0,37,0.0,0.0,1.0,37,900,800,100,0.8888888888888888,10,8,2,380.61069231984453,0.39880505505505504,0.105661087669213,0.22381987128569703,131480.6990504536,2608.59197845806,134089.29102891166,1891,33,341.5945945945946,34,3,21,33.84237763590635,0.6393995098039216,43.60119047619048,1025.5952380952388,30.164565826330552,0
1941,4,0,0,37,0.0,0.0,1.0,37,900,800,100,0.8888888888888888,10,8,2,380.29881988516246,0.39877377377377377,0.10661514479548617,0.2239941853007825,131541.75347222228,2605.0347222222313,134146.7881944445,1892,34,342.5945945945946,34,3,21,33.78858651502842,0.6400122549019608,43.54166666666667,1025.833333333334,30.171568627451,0
1942,4,0,0,37,0.0,0.0,1.0,37,1050,800,250,0.7619047619047619,13,8,5,385.16358916240813,0.3982732732732733,0.10808302792991342,0.22758706663256498,131663.9048327665,2742.4284297052227,134406.33326247174,1893,35,343.5945945945946,34,3,18,33.54019255306808,0.6412377450980392,43.42261904761905,1026.3095238095243,30.18557422969189,0
1943,4,0,0,37,0.0,0.0,1.0,37,1200,900,300,0.75,15,9,6,385.327943160735,0.39908658658658663,0.10446647946647936,0.22823270479520474,131755.55555555565,2753.81944444445,134509.3750000001,1894,36,344.5945945945946,34,3,18,33.44324945887444,0.642156862745098,43.333333333333336,1026.6666666666674,30.19607843137257,0
1944,4,0,0,37,0.0,0.0,1.0,37,1200,800,400,0.6666666666666666,16,8,8,388.69680696153046,0.3987424924924925,0.10677351746089414,0.23078371325926508,131847.2381660997,2849.72009637187,134696.95826247157,1895,37,345.5945945945946,34,3,19,33.26402573316331,0.6430759803921569,43.24404761904761,1027.023809523809,30.206582633053205,0
1945,4,0,0,37,0.0,0.0,1.0,37,950,600,350,0.631578947368421,13,6,7,388.26349247493226,0.398460960960961,0.11010036462053163,0.23071194304915382,131877.80612244885,2840.6675170067906,134718.47363945565,1896,38,346.5945945945946,34,3,19,33.24423388966157,0.6433823529411764,43.21428571428571,1027.1428571428562,30.210084033613416,0
1946,4,0,0,37,0.0,0.0,1.0,37,900,700,200,0.7777777777777778,11,7,4,388.6842766012013,0.3988363363363363,0.10754439259653648,0.23133415910816316,131938.95266439897,2856.5192743764037,134795.47193877536,1897,39,347.5945945945946,34,3,20,33.17159134801082,0.6439950980392157,43.1547619047619,1027.3809523809514,30.217086834733863,0
1947,4,1,0,38,0.02631578947368421,0.0,1.0,38,1100,800,300,0.7272727272727273,14,8,6,377.72923505556344,0.39940433854907537,0.11384162555595734,0.22666304604583293,132249.14969403693,2390.874030135432,134640.02372417235,1898,0,339.42105263157896,35,3,21,33.13981564832528,0.6449404761904762,42.853009259259245,1028.5879629629608,29.388227513227452,0
1948,4,0,0,38,0.0,0.0,1.0,38,950,600,350,0.631578947368421,13,6,7,376.81207576616805,0.3991079895685159,0.1191839880687553,0.22719631187078543,132429.53619100802,2380.3771339652467,134809.91332497328,1899,1,340.42105263157896,33,5,21,32.981480930269484,0.651199494949495,42.67769607843136,1029.2892156862727,31.190582293523413,0
1949,4,0,0,38,0.0,0.0,1.0,38,1300,1100,200,0.8461538461538461,15,11,4,377.95234977324674,0.39858937885253676,0.12649304446406973,0.22864892693625555,132555.70461180783,2419.9480067762256,134975.65261858405,1900,2,341.42105263157896,33,5,21,32.82495834820898,0.6524621212121212,42.55514705882352,1029.779411764705,31.205436720142576,0
1950,4,0,0,38,0.0,0.0,1.0,38,1200,800,400,0.6666666666666666,16,8,8,381.3852745020426,0.39881164058795643,0.08664151200718284,0.21001132059678462,128922.84765504769,2233.8551285010753,131156.70278354877,1901,3,342.42105263157896,37,1,14,36.424368386957454,0.607545045045045,46.10745614035088,1015.5701754385964,27.447842579421525,8
1951,4,1,0,39,0.02564102564102564,0.0,1.0,39,950,700,250,0.7368421052631579,12,7,5,374.5013509879511,0.40106275303643724,0.0863896836844884,0.20753882363949036,129174.91455078167,1875.2360026042097,131050.15055338589,1902,0,334.61538461538464,39,0,15,36.34177425965776,0.6065705128205128,45.85937500000002,1016.5625000000034,26.065705128205217,0
1952,4,0,0,39,0.0,0.0,1.0,39,1400,1200,200,0.8571428571428571,16,12,4,371.4916132882075,0.4006129104813316,0.08761843110198808,0.20645789289881877,129287.27027280674,1805.8354602755396,131093.10573308228,1903,1,335.61538461538464,36,3,16,36.30365777138007,0.6131365740740741,45.74887387387388,1017.0045045045057,28.25012512512516,0
1953,4,0,0,39,0.0,0.0,1.0,39,750,500,250,0.6666666666666666,10,5,5,371.4916132882075,0.4006129104813316,0.08761843110198808,0.20645789289881877,129287.27027280674,1805.8273222547064,131093.09759506144,1904,2,336.61538461538464,36,3,16,36.30365777138007,0.6131365740740741,45.74887387387388,1017.0045045045057,28.25012512512516,0
1954,4,0,0,39,0.0,0.0,1.0,39,950,500,450,0.5263157894736842,14,5,9,369.5748100371138,0.4006129104813316,0.09055627425614499,0.2055261353659634,129312.8895429364,1758.1573176362092,131071.04686057262,1905,3,337.61538461538464,37,2,16,36.32627210004313,0.6114864864864865,45.72368421052632,1017.1052631578957,27.489331436699885,0
1955,4,1,1,39,0.025,0.025,0.975,40,1400,1300,100,0.9285714285714286,15,13,2,360.98112010430197,0.4030048076923077,0.09157754010695207,0.20310778421443834,129772.26382725193,1369.0674309664848,131141.33125821842,1906,0,330.15,38,2,14,36.077251756317516,0.6143092105263157,45.272435897435905,1018.9102564102574,26.81342780026993,0
1956,4,0,1,38,0.0,0.02564102564102564,0.9743589743589743,39,1100,800,300,0.7272727272727273,14,8,6,370.3282964473263,0.4027496626180837,0.09576256448901499,0.20785374898484676,129675.59880203521,1804.5087190289287,131480.10752106414,1907,1,335.3076923076923,37,2,14,35.937556069903486,0.6151463963963963,45.36732456140351,1018.5307017543857,27.527856804172586,0
1957,4,0,1,37,0.0,0.02631578947368421,0.9736842105263158,38,1050,800,250,0.7619047619047619,13,8,5,373.8863966639284,0.40324205784732103,0.0928734374636282,0.20976604041120187,129659.7526580637,2095.603542731949,131755.35620079565,1908,2,339.1842105263158,36,2,15,35.86309523809524,0.6168981481481481,45.382882882882896,1018.4684684684703,28.29079079079084,0
1958,4,0,0,37,0.0,0.0,1.0,37,1250,900,350,0.72,16,9,7,377.84762061305753,0.4012137137137137,0.10221063204356784,0.21189810157898623,129643.02722318674,2397.061873070992,132040.08909625773,1909,3,349.18918918918916,35,2,15,35.779278895329014,0.61875,45.39930555555556,1018.4027777777778,29.097222222222225,0
1959,4,0,0,37,0.0,0.0,1.0,37,600,300,300,0.5,9,3,6,377.1842869236294,0.4011511511511512,0.10253134625365035,0.21184421883949342,129701.96926708246,2384.3089581189956,132086.27822520144,1910,4,350.18918918918916,35,2,15,35.7361142673181,0.6193452380952381,45.34143518518518,1018.6342592592591,29.103835978835974,0
1960,4,0,0,37,0.0,0.0,1.0,37,950,700,250,0.7368421052631579,12,7,5,362.2259698808131,0.40065065065065064,0.08323938482314586,0.19217266544090963,127432.89531085148,1831.9008197386663,129264.79613059016,1911,5,351.18918918918916,36,1,15,38.43547847423601,0.5943287037037037,47.57882882882883,1009.6846846846854,28.046796796796816,8
1961,4,2,1,38,0.05128205128205128,0.02564102564102564,0.9743589743589743,39,1000,800,200,0.8,12,8,4,351.14008730517145,0.41079059829059833,0.10071229583424723,0.18884995836838614,127982.32299884941,1187.944814266927,129170.26781311634,1912,0,334.12820512820514,38,1,17,38.152650195333116,0.596217105263158,47.03525641025641,1011.8589743589741,26.627867746288793,0
1962,4,1,0,39,0.02564102564102564,0.0,1.0,39,1350,1000,350,0.7407407407407407,17,10,7,359.57789441836195,0.4103969860548808,0.1317862770376741,0.19549085870183397,128415.10662073575,1435.0467300387318,129850.15335077449,1913,0,333.2564102564103,38,1,14,37.496486420013355,0.6006030701754386,46.60790598290599,1013.5683760683771,26.6728520017994,0
1963,4,1,0,40,0.025,0.0,1.0,40,1200,900,300,0.75,15,9,6,350.6245938724279,0.41404914529914527,0.13788998357963855,0.19236970961108887,128778.12500000003,1030.555555555556,129808.68055555559,1914,0,325.9,39,1,16,37.352900930487124,0.6025641025641026,46.25,1015.0000000000002,26.025641025641033,0
1964,4,0,0,40,0.0,0.0,1.0,40,1050,800,250,0.7619047619047619,13,8,5,353.6364682518588,0.41340811965811963,0.14210418375717815,0.19506011529367226,128989.67013888883,1123.0902777777726,130112.7604166666,1915,1,326.9,39,1,16,37.06077385835385,0.6047008547008548,46.041666666666664,1015.8333333333328,26.047008547008534,0
1965,4,2,2,40,0.047619047619047616,0.047619047619047616,0.9523809523809523,42,800,600,200,0.75,10,6,4,341.7383161403676,0.419074235385211,0.15698119487435536,0.1908817198073497,129485.67450137141,450.2168847907857,129935.8913861622,1916,0,312.2857142857143,40,2,13,36.858462306540176,0.6080729166666667,45.55386178861788,1017.7845528455275,25.444613821138187,0
1966,4,1,0,41,0.024390243902439025,0.0,1.0,41,1000,800,200,0.8,12,8,4,346.44947477008037,0.420020325203252,0.16356756019636864,0.19364051000541987,129511.53413973156,773.8405958754611,130285.37473560702,1917,0,319.4146341463415,40,1,15,36.71230198349307,0.6083333333333334,45.52845528455284,1017.886178861788,25.4471544715447,0
1967,4,1,0,42,0.023809523809523808,0.0,1.0,42,1600,1100,500,0.6875,21,11,10,338.7654110501368,0.42226819589624465,0.16687521724018173,0.19114852270950822,129883.08930342931,399.9796272675402,130283.06893069686,1918,0,312.7857142857143,41,1,17,36.53071776155719,0.6105182926829269,45.16369047619046,1019.3452380952349,24.86207897793256,0
1968,4,0,2,40,0.0,0.047619047619047616,0.9523809523809523,42,1250,900,350,0.72,16,9,7,357.42147352789834,0.4218084591560201,0.19810741585020364,0.19119725291093875,127766.20513048815,765.939865666588,128532.14499615473,1919,1,313.7857142857143,38,4,17,38.215065694459135,0.5940241228070176,47.24893162393163,1011.0042735042748,26.605375618533547,8
1969,4,1,0,41,0.024390243902439025,0.0,1.0,41,1200,700,500,0.5833333333333334,17,7,10,354.854203015453,0.42253556910569107,0.19732122323932666,0.19069538329782082,127950.32035097336,880.741790743306,128831.06214171667,1920,0,315.4146341463415,37,4,18,38.09144810519851,0.5976914414414414,47.06688596491228,1011.7324561403507,27.344120436225694,0
1970,4,0,0,41,0.0,0.0,1.0,41,1200,800,400,0.6666666666666666,16,8,8,353.18670922107367,0.4220782520325203,0.1988742964352721,0.1901933095747088,128033.53555901808,843.9486188057788,128877.48417782386,1921,1,316.4146341463415,37,4,18,38.04848320693391,0.5985360360360361,46.984649122807014,1012.0614035087714,27.35301090564247,0
1971,4,0,0,41,0.0,0.0,1.0,41,1150,700,450,0.6086956521739131,16,7,9,353.81038556680005,0.4215955284552846,0.19701336404677816,0.19092526533829723,128116.77781865573,865.8093115189276,128982.58713017465,1922,2,317.4146341463415,37,4,18,37.94755677100256,0.5993806306306306,46.90241228070175,1012.3903508771929,27.36190137505927,0
1972,4,1,0,42,0.023809523809523808,0.0,1.0,42,1000,700,300,0.7,13,7,6,343.57067134523066,0.4242160278745644,0.1989897116479391,0.18669157643997453,128394.44739006225,422.5163030932487,128816.9636931555,1923,0,310.8333333333333,37,5,17,37.92318060514262,0.6021959459459459,46.628289473684205,1013.4868421052627,27.391536273115207,0
1973,4,1,1,42,0.023255813953488372,0.023255813953488372,0.9767441860465116,43,950,600,350,0.631578947368421,13,6,7,334.1146984019573,0.4269564414913252,0.19944119440410857,0.1828868755460164,128685.96734832697,-0.8253661699309305,128685.14198215705,1924,0,304.5813953488372,38,5,18,37.86568565511915,0.6033442982456141,46.34081196581196,1014.6367521367509,26.700967161493445,0
1974,4,0,0,42,0.0,0.0,1.0,42,1300,1000,300,0.7692307692307693,16,10,6,336.9707380435703,0.4269502516453736,0.19182953060195373,0.18451640295001168,128700.2310807171,273.6423707294539,128973.87345144656,1925,1,291.26190476190476,37,5,18,37.778708306318,0.6052927927927928,46.32675438596491,1014.6929824561399,27.424134660976755,0
1975,4,0,1,41,0.0,0.023809523809523808,0.9761904761904762,42,1050,800,250,0.7619047619047619,13,8,5,336.0975023166293,0.426853464963221,0.18896671963957834,0.18468408154003976,128839.3438966797,260.5163367574583,129099.86023343715,1926,2,292.26190476190476,37,5,18,37.659191957374816,0.6067004504504505,46.18969298245614,1015.241228070175,27.43895211000473,0
1976,4,0,1,40,0.0,0.024390243902439025,0.975609756097561,41,1200,900,300,0.75,15,9,6,325.59742002684123,0.42416158536585363,0.12652675363962906,0.17074011050188004,126960.75439453113,67.61881510415124,127028.37320963529,1927,3,300.2439024390244,39,2,19,39.84334625322997,0.5841346153846154,48.04687499999999,1007.8124999999991,25.841346153846132,8
1977,4,0,0,40,0.0,0.0,1.0,40,1150,700,450,0.6086956521739131,16,7,9,331.1691530561657,0.42136752136752137,0.1280219488919525,0.1734178946403494,126903.55994091941,405.30889308930784,127308.86883400872,1928,5,308.675,38,2,20,39.76160180963489,0.5852521929824561,48.10363247863246,1007.5854700854676,26.515407107512306,0
1978,4,1,0,41,0.024390243902439025,0.0,1.0,41,1150,700,450,0.6086956521739131,16,7,9,325.4753460603913,0.4238821138211382,0.1289162633521861,0.17189499465326868,127249.6148003471,83.32248263888339,127332.937282986,1929,0,302.1219512195122,39,2,21,39.55064009911214,0.5870726495726496,47.760416666666664,1008.9583333333323,25.87072649572647,0
1979,4,2,1,42,0.046511627906976744,0.023255813953488372,0.9767441860465116,43,1000,800,200,0.8,12,8,4,316.50665326246155,0.4299326319675157,0.15526072143648784,0.17005979188464604,127943.71712805485,-500.9924571680576,127442.72467088679,1930,0,289.0232558139535,41,2,15,39.06811793162059,0.5909552845528455,47.073412698412696,1011.7063492063487,24.675764614788992,0
1980,4,1,0,43,0.023255813953488372,0.0,1.0,43,550,200,350,0.36363636363636365,9,2,7,309.48716490080875,0.42898671096345514,0.10506636502785183,0.15860069251741735,126019.51223634393,-793.5644998314482,125225.94773651248,1931,0,289.69767441860466,42,1,18,41.213890497329984,0.5699404761904762,48.98255813953488,1004.0697674418601,23.906423034330004,8
1981,4,0,1,42,0.0,0.023255813953488372,0.9767441860465116,43,900,500,400,0.5555555555555556,13,5,8,308.50987616227275,0.4292866371354744,0.10141059855127721,0.15829151590008206,126069.35046103518,-821.267365551686,125248.0830954835,1932,1,290.69767441860466,40,3,18,41.18725966403562,0.5734375,48.9329268292683,1004.2682926829275,25.106707317073187,0
1982,4,5,2,45,0.10638297872340426,0.0425531914893617,0.9574468085106383,47,1650,1200,450,0.7272727272727273,21,12,9,295.8689762088053,0.43994757940178847,0.14747657284903593,0.1558402988047188,127140.8719427918,-1868.3297990535525,125272.54214373825,1933,0,266.6595744680851,42,5,18,40.40841980527797,0.5813492063492063,47.86821705426356,1008.5271317829449,24.012550756736783,0
1983,4,1,1,45,0.021739130434782608,0.021739130434782608,0.9782608695652174,46,1350,800,550,0.5925925925925926,19,8,11,299.2827311339174,0.4386372785829307,0.14914530628613387,0.15763839401021315,127140.87194279183,-1589.7865212427255,125551.0854215491,1934,0,273.3478260869565,42,4,20,40.32234819369713,0.5813492063492063,47.86821705426356,1008.5271317829452,24.01255075673679,0
1984,4,3,4,44,0.0625,0.08333333333333333,0.9166666666666666,48,1150,900,250,0.782608695652174,14,9,5,287.0397652376343,0.4444536790780142,0.17679236499068907,0.1535613521131664,127769.80559842242,-2264.9969993141385,125504.80859910828,1935,0,262.5625,44,4,14,39.99030741520895,0.5849905303030303,47.24537037037037,1011.0185185185179,22.977693602693588,0
1985,4,3,2,45,0.06382978723404255,0.0425531914893617,0.9574468085106383,47,1250,900,350,0.72,16,9,7,296.6504649196958,0.442163891458526,0.1823708206686936,0.15879524886877827,127793.20987654316,-1818.0169753086445,125975.19290123452,1936,0,269.02127659574467,44,3,16,39.72355769230771,0.5852272727272727,47.22222222222222,1011.1111111111107,22.979797979797972,0
1986,4,0,0,45,0.0,0.0,1.0,45,1600,1100,500,0.6875,21,11,10,304.64940179040696,0.43792087542087543,0.18725806623419516,0.16271366667054457,127703.41443009737,-1219.046237455682,126484.36819264169,1937,1,281.44444444444446,42,3,17,39.61289265970025,0.5870535714285714,47.31104651162791,1010.7558139534885,24.065614617940202,0
1987,4,0,0,45,0.0,0.0,1.0,45,1650,1400,250,0.8484848484848485,19,14,5,304.0227570632032,0.43768939393939393,0.18825658384960953,0.16307243259124943,127874.86948650914,-1224.6259239228489,126650.24356258629,1938,2,282.44444444444446,42,3,17,39.45399821166252,0.5887896825396826,47.14147286821705,1011.4341085271311,24.081764488741218,0
1988,4,0,0,45,0.0,0.0,1.0,45,800,300,500,0.375,13,3,10,303.8703412949656,0.4377525252525252,0.1909110757618293,0.16360011775412053,128024.70842121482,-1219.4176315714135,126805.2907896434,1939,3,283.44444444444446,43,2,17,39.30525014815507,0.5889050387596899,46.993371212121204,1012.0265151515136,23.53550035236078,0
1989,4,0,1,44,0.0,0.022222222222222223,0.9777777777777777,45,1350,900,450,0.6666666666666666,18,9,9,307.16114832580485,0.43743686868686865,0.1931250612085007,0.16638846077213756,128270.12004165092,-1119.9684324726618,127150.15160917827,1940,4,284.44444444444446,41,4,18,38.97216645447719,0.5942581300813008,46.75099206349206,1012.9960317460317,24.707220286488578,0
1990,4,2,0,46,0.043478260869565216,0.0,1.0,46,1450,900,550,0.6206896551724138,20,9,11,301.24145094368305,0.4406904186795491,0.20662624442469335,0.16473709361713515,128648.39916386885,-1449.1539148588054,127199.24524901004,1941,0,279.0,43,3,17,38.73769018948941,0.595203488372093,46.377840909090914,1014.4886363636367,23.592758985200852,0
1991,4,0,1,45,0.0,0.021739130434782608,0.9782608695652174,46,1300,1100,200,0.8461538461538461,15,11,4,298.6533493418495,0.4410628019323672,0.20639395734116528,0.16381610021729498,128768.51343692617,-1508.5704344582068,127259.94300246796,1942,1,280.0,43,3,18,38.68142377309199,0.5964147286821706,46.2594696969697,1014.9621212121218,23.60377026074702,0
1992,4,0,0,45,0.0,0.0,1.0,45,1450,1100,350,0.7586206896551724,18,11,7,303.44236381678854,0.4393518518518518,0.2029005803282522,0.16629784805092745,128733.87008180085,-1187.338031819007,127546.53204998185,1943,2,287.0888888888889,42,3,18,38.59507781915404,0.5974702380952381,46.29360465116279,1014.8255813953479,24.162513842746378,0
1993,4,1,0,46,0.021739130434782608,0.0,1.0,46,1000,700,300,0.7,13,7,6,297.5339223821662,0.44052938808373593,0.2061154928461022,0.1640174436448423,128966.15655006858,-1525.638717421122,127440.51783264746,1944,0,281.82608695652175,44,2,19,38.50938164691584,0.5970643939393939,46.06481481481482,1015.7407407407406,23.085016835016834,0
1994,4,2,1,47,0.041666666666666664,0.020833333333333332,0.9791666666666666,48,1950,1700,250,0.8717948717948718,22,17,5,285.2984774982526,0.4430592494089835,0.205829050474287,0.1597033086347438,129571.08126201852,-2205.856218808446,127365.22504321007,1945,0,271.0416666666667,42,6,14,38.20825798673899,0.6059027777777778,45.46996124031008,1018.1201550387598,24.240956072351423,0
1995,4,0,0,47,0.0,0.0,1.0,47,950,700,250,0.7368421052631579,12,7,5,294.8428531647933,0.44033302497687327,0.2021245492642043,0.16487098181601872,129529.39111118982,-1761.8369512156771,127767.55415997414,1946,1,277.8085106382979,41,6,15,38.007483838482266,0.6069613821138211,45.510912698412696,1017.956349206349,24.828203639179247,0
1996,4,0,1,46,0.0,0.02127659574468085,0.9787234042553191,47,1150,700,450,0.6086956521739131,16,7,9,293.3436021164194,0.4401788467468393,0.2005072699927326,0.16462010687910764,129669.75509472104,-1792.4413909921134,127877.31370372893,1947,2,278.8085106382979,42,5,15,37.90374369707924,0.6068948412698413,45.37306201550388,1018.5077519379859,24.250184569952044,0
1997,4,1,2,45,0.02127659574468085,0.0425531914893617,0.9574468085106383,47,1400,1000,400,0.7142857142857143,18,10,8,293.30734228099146,0.43942722787542404,0.2031501255074406,0.16543163182057644,129867.21543364285,-1781.7984383450466,128085.4169952978,1948,0,279.72340425531917,42,5,17,37.70518426973413,0.6088789682539683,45.179263565891475,1019.2829457364344,24.2686415651532,0
1998,4,0,0,45,0.0,0.0,1.0,45,950,700,250,0.7368421052631579,12,7,5,313.03243992655285,0.4388678451178451,0.10839309689884402,0.16621581669339458,127467.41470025478,-1019.1119076247669,126448.30279263001,1949,1,290.4222222222222,41,4,14,39.641971215247054,0.5861280487804879,47.54464285714284,1009.8214285714259,24.629790940766487,8
1999,4,0,0,45,0.0,0.0,1.0,45,1400,1000,400,0.7142857142857143,18,10,8,315.91331230647637,0.43829966329966324,0.10638381457474,0.1680579595561407,127542.56129535104,-941.521400226801,126601.03989512424,1950,2,291.4222222222222,41,4,14,39.49248674130819,0.586890243902439,47.470238095238074,1010.1190476190441,24.637049941927906,0
2000,4,0,1,44,0.0,0.022222222222222223,0.9777777777777777,45,1000,700,300,0.7,13,7,6,313.78785107124304,0.4387626262626263,0.1089378928305107,0.16749269634969577,127678.93024006928,-987.1805705787301,126691.74966949056,1951,3,292.4222222222222,42,3,14,39.406959092361774,0.5868055555555556,47.33527131782944,1010.6589147286787,24.06330749353997,0
2001,4,0,2,42,0.0,0.045454545454545456,0.9545454545454546,44,1300,900,400,0.6923076923076923,17,9,8,319.3867911392733,0.43685033474277657,0.12610524719171368,0.1706466709448373,127717.9894671985,-641.7122346624197,127076.27723253607,1952,4,299.84090909090907,41,3,14,39.22561504236598,0.5886686991869918,47.296626984126966,1010.8134920634886,24.6539876113046,0
2002,4,1,0,43,0.023255813953488372,0.0,1.0,43,1300,900,400,0.6923076923076923,17,9,8,321.01312990457114,0.43717700258397935,0.14139030135347386,0.17212945413848527,127861.72251966398,-390.9416517945925,127470.78086786938,1953,0,306.9767441860465,40,3,15,39.03779809753482,0.5916666666666667,47.154471544715435,1011.3821138211362,25.284552845528403,0
2003,4,4,3,44,0.0851063829787234,0.06382978723404255,0.9361702127659575,47,1250,600,650,0.48,19,6,13,298.24232030607124,0.445131822386679,0.15280157395587435,0.16349171082967584,128744.48609855642,-1720.2767304935487,127024.20936806286,1954,0,281.7659574468085,43,4,13,38.71623355416627,0.596172480620155,46.28314393939393,1014.8674242424229,23.60156800563774,0
2004,4,2,0,46,0.043478260869565216,0.0,1.0,46,1300,900,400,0.6923076923076923,17,9,8,351.7862593363975,0.44130434782608696,0.176713338246131,0.18531597590042373,127145.88355613998,-185.23446537086608,126960.6490907691,1955,0,288.8478260869565,38,8,17,38.993423375706215,0.5877192982456141,47.863247863247864,1008.5470085470087,26.54071075123707,8
2005,4,2,0,48,0.041666666666666664,0.0,1.0,48,1450,1200,250,0.8275862068965517,17,12,5,335.6724684382407,0.44348404255319146,0.18938092901537473,0.17945972997826196,127743.06047650531,-1024.0343127992041,126719.0261637061,1956,0,277.7708333333333,41,7,17,38.78843637553156,0.5889227642276422,47.27182539682539,1010.9126984126975,24.656407278358476,0
2006,4,0,0,48,0.0,0.0,1.0,48,1450,1100,350,0.7586206896551724,18,11,7,336.61393551503437,0.44359485815602834,0.19494047619047583,0.18018745959922416,127793.20987654309,-996.6049382716217,126796.60493827147,1957,1,278.7708333333333,41,7,17,38.71336996336996,0.589430894308943,47.222222222222214,1011.1111111111102,24.6612466124661,0
2007,4,0,1,47,0.0,0.020833333333333332,0.9791666666666666,48,1200,700,500,0.5833333333333334,17,7,10,312.7093991048456,0.4431608303782506,0.10770418886110811,0.1648489262100556,127174.94956380788,-1613.92863135241,125561.02093245547,1958,2,279.7708333333333,37,11,17,39.94897543211218,0.5898085585585586,47.83442982456139,1008.6622807017527,27.261142721668993,8
2008,4,3,2,48,0.06,0.04,0.96,50,1350,800,550,0.5925925925925926,19,8,11,298.30422035848926,0.4462840136054422,0.1422414503502265,0.15981994322517729,127828.32031250003,-2373.6545138888873,125454.66579861114,1959,0,269.48,39,11,15,39.645996429061945,0.592948717948718,47.1875,1011.2500000000002,25.929487179487186,0
2009,4,2,2,48,0.04,0.04,0.96,50,1200,1000,200,0.8333333333333334,14,10,4,307.6181317533579,0.44596938775510203,0.1644907827138109,0.1623458369971073,127220.13728807282,-1934.3273369852309,125285.80995108759,1960,0,270.28,40,10,17,40.03118599106815,0.58515625,47.78963414634148,1008.8414634146361,25.2210365853659,8
2010,4,2,2,48,0.04,0.04,0.96,50,850,600,250,0.7058823529411765,11,6,5,304.3810204901099,0.44767006802721093,0.19580280860257337,0.16202362423684238,127567.61508133367,-2234.167828010809,125333.44725332287,1961,0,264.94,41,9,14,39.75815493142166,0.5871443089430894,47.44543650793652,1010.2182539682557,24.639469608981845,0
2011,4,1,1,48,0.02040816326530612,0.02040816326530612,0.9795918367346939,49,1400,800,600,0.5714285714285714,20,8,12,315.2114835840157,0.4459325396825397,0.2087691069991955,0.16815788587765307,127656.23967215286,-1752.2574608368004,125903.98221131606,1962,0,271.2857142857143,40,9,15,39.39414890050952,0.5895833333333333,47.357723577235774,1010.5691056910573,25.26422764227643,0
2012,4,2,0,50,0.04,0.0,1.0,50,1400,1000,400,0.7142857142857143,18,10,8,311.20429564103966,0.4486309523809524,0.22732771822358377,0.16794744219305693,128120.0048074034,-2025.7008292770836,126094.30397812632,1963,0,265.54,42,8,19,39.02261995916285,0.5912698412698413,46.89922480620155,1012.4031007751937,24.104835732742707,0
2013,4,0,0,50,0.0,0.0,1.0,50,1800,1500,300,0.8333333333333334,21,15,6,314.4408112535762,0.448545918367347,0.2337064901193704,0.1704546192162535,128298.92223750748,-1931.5118670058473,126367.41037050163,1964,1,266.54,40,10,20,38.75848463570402,0.59609375,46.72256097560976,1013.1097560975612,25.327743902439032,0
2014,4,0,1,49,0.0,0.02,0.98,50,1800,1200,600,0.6666666666666666,24,12,12,313.8299868643275,0.4479761904761905,0.23227397260274008,0.17096708239623792,128496.33487654306,-1934.7993827160637,126561.53549382699,1965,2,267.54,41,9,15,38.573059360730596,0.5965447154471545,46.52777777777777,1013.8888888888877,24.72899728997287,0
2015,4,1,1,49,0.02,0.02,0.98,50,1300,900,400,0.6923076923076923,17,9,8,313.71223271022996,0.44924319727891154,0.23944254278728572,0.17144348366980774,128622.0959014393,-1929.93502377803,126692.16087766127,1966,0,268.32,41,9,16,38.44814588427057,0.5978150406504066,46.40376984126984,1014.3849206349208,24.74109562524197,0
2016,4,0,0,49,0.0,0.0,1.0,49,1750,1500,250,0.8571428571428571,20,15,5,318.4667638078635,0.44828869047619047,0.24245568387699246,0.174372487164177,128697.58204207603,-1602.8195074326125,127094.76253464342,1967,1,273.6938775510204,41,8,16,38.25079846173902,0.5985772357723578,46.329365079365076,1014.6825396825391,24.74835462640339,0
2017,4,1,1,49,0.02,0.02,0.98,50,1000,700,300,0.7,13,7,6,313.77913343652176,0.44784863945578235,0.24786341091186603,0.17314002289202587,129004.43558079428,-1904.2199987981633,127100.21558199612,1968,0,269.2,42,8,17,38.05799313239221,0.6001984126984127,46.02713178294573,1015.8914728682158,24.187892211147997,0
2018,4,0,1,48,0.0,0.02040816326530612,0.9795918367346939,49,1750,1300,450,0.7428571428571429,22,13,9,317.6972542643131,0.4465702947845805,0.2476966563144105,0.1750583686306801,128949.3624417359,-1606.628322625357,127342.73411911054,1969,1,275.57142857142856,41,8,17,38.01442338998501,0.6011178861788617,46.0813492063492,1015.6746031746028,24.772551296941533,0
2019,4,1,1,48,0.02040816326530612,0.02040816326530612,0.9795918367346939,49,1300,900,400,0.6923076923076923,17,9,8,316.1222289277806,0.4461451247165533,0.25249338991664816,0.17542479607613304,129228.54487407744,-1628.858728183392,127599.68614589405,1970,0,275.7551020408163,38,11,19,37.771006269482676,0.6088267543859649,45.80662393162392,1016.7735042735019,26.75719748088163,0
2020,4,0,1,47,0.0,0.020833333333333332,0.9791666666666666,48,1100,700,400,0.6363636363636364,15,7,8,318.3865550334934,0.4454971926713948,0.2606875895965599,0.1772726964912823,129360.29188368036,-1362.6844618055804,127997.60742187478,1971,1,281.6875,39,9,19,37.57978360297629,0.608440170940171,45.67708333333332,1017.291666666665,26.084401709401668,0
2021,4,0,2,45,0.0,0.0425531914893617,0.9574468085106383,47,1350,900,450,0.6666666666666666,18,9,9,305.8655556266486,0.4452667283379587,0.19600459204115395,0.1697247471368449,129226.60506621648,-1459.5526216852327,127767.05244453125,1972,2,285.4468085106383,41,6,16,38.0336902787264,0.6039126016260163,45.808531746031754,1016.7658730158744,24.79916763453352,8
2022,4,3,2,46,0.0625,0.041666666666666664,0.9583333333333334,48,1050,800,250,0.7619047619047619,13,8,5,303.38513672394737,0.4442043439716312,0.2226258998509496,0.17025526813162936,129669.75509472116,-1732.0247243254303,127937.73037039573,1973,0,280.2708333333333,42,6,13,37.648059176101235,0.6068948412698413,45.37306201550389,1018.5077519379868,24.250184569952065,0
2023,4,1,0,47,0.02127659574468085,0.0,1.0,47,1550,1200,350,0.7741935483870968,19,12,7,306.4975472668648,0.44364785692260256,0.22294739590131818,0.17227275932585853,129731.44531250001,-1447.5260416666663,128283.91927083334,1974,0,284.1914893617021,41,6,14,37.50639059304703,0.6089939024390244,45.3125,1018.7500000000001,24.84756097560976,0
2024,4,0,1,46,0.0,0.02127659574468085,0.9787234042553191,47,1450,1000,450,0.6896551724137931,19,10,9,303.5648831730058,0.44308896083872956,0.2198174398936692,0.1715083179971952,129933.65698420575,-1511.3409194696349,128422.31606473612,1975,1,285.1914893617021,41,6,15,37.37664607051345,0.6110264227642277,45.114087301587304,1019.543650793651,24.866918312040266,0
2025,4,1,1,46,0.02127659574468085,0.02127659574468085,0.9787234042553191,47,1200,900,300,0.75,15,9,6,303.914907638243,0.44202898550724634,0.22175327093522657,0.17248680519600953,130110.72137188206,-1491.482426303855,128619.2389455782,1976,0,285.70212765957444,41,6,16,37.188837028393614,0.6128048780487805,44.94047619047619,1020.2380952380951,24.883855981416954,0
2026,4,1,0,47,0.02127659574468085,0.0,1.0,47,1500,1100,400,0.7333333333333333,19,11,8,302.8730737191331,0.44148936170212766,0.22320883902039568,0.17245495603188507,130237.26974875608,-1510.927559681267,128726.34218907481,1977,0,286.40425531914894,41,6,18,37.0876461917258,0.6140752032520325,44.81646825396826,1020.7341269841278,24.895954316686044,0
2027,4,0,0,47,0.0,0.0,1.0,47,1700,1400,300,0.8235294117647058,20,14,6,301.843419717334,0.4407762873882208,0.22214459616809634,0.1725555385756089,130392.29811124326,-1528.3861061851253,128863.91200505814,1978,1,287.40425531914894,40,7,18,36.957504145936994,0.6171875,44.66463414634146,1021.3414634146337,25.533536585365844,0
2028,4,0,0,47,0.0,0.0,1.0,47,1200,700,500,0.5833333333333334,17,7,10,304.35320672711543,0.44081483194572924,0.2277673013877508,0.17433975995599393,130470.15587819762,-1458.1979352567803,129011.95794294083,1979,2,288.40425531914894,40,7,18,36.81488113001094,0.61796875,44.588414634146346,1021.6463414634156,25.541158536585392,0
2029,4,1,1,47,0.020833333333333332,0.020833333333333332,0.9791666666666666,48,1300,800,500,0.6153846153846154,18,8,10,299.6000205828568,0.44158170803782504,0.22841129423170137,0.17351904617137373,130896.31287989725,-1756.6923933925475,129139.6204865047,1980,0,283.375,41,7,14,36.50700840200355,0.620680894308943,44.17162698412698,1023.3134920634915,24.95886566008516,0
2030,4,0,1,46,0.0,0.02127659574468085,0.9787234042553191,47,1300,800,500,0.6153846153846154,18,8,10,305.86083472185635,0.44019811902559364,0.22657978776241716,0.17685818628058175,130833.79937743742,-1396.6129825170162,129437.1863949204,1981,1,290.3404255319149,40,7,15,36.40980431111552,0.6216145833333333,44.232723577235774,1023.0691056910573,25.57672764227643,0
2031,4,1,1,46,0.02127659574468085,0.02127659574468085,0.9787234042553191,47,1350,800,550,0.5925925925925926,19,8,11,303.6405667200859,0.439350138760407,0.22221189571447564,0.17628653766982297,130989.8015091052,-1445.2364870447375,129544.56502206046,1982,0,289.93617021276594,40,7,17,36.3095238095238,0.6231770833333333,44.080284552845534,1023.6788617886192,25.59197154471548,0
2032,4,0,0,46,0.0,0.0,1.0,46,900,600,300,0.6666666666666666,12,6,6,310.858087569713,0.43768115942028984,0.22841467894781053,0.17993865611062432,130874.74093967032,-1063.3056640624795,129811.43527560783,1983,1,297.10869565217394,39,7,17,36.24073178594455,0.6236645299145299,44.19270833333334,1023.2291666666681,26.236645299145337,0
2033,4,0,1,45,0.0,0.021739130434782608,0.9782608695652174,46,1350,900,450,0.6666666666666666,18,9,9,309.3880541783496,0.4375503220611916,0.22986844433956666,0.17954251647987693,130972.46334876542,-1095.73688271605,129876.72646604937,1984,2,298.10869565217394,41,5,18,36.179895974672085,0.6214430894308943,44.09722222222222,1023.6111111111111,24.96612466124661,0
2034,4,0,2,43,0.0,0.044444444444444446,0.9555555555555556,45,1350,900,450,0.6666666666666666,18,9,9,313.84522488161036,0.43562710437710433,0.23128666578448231,0.182581090410341,131067.83743142318,-772.9970173177273,130294.84041410545,1985,3,304.6,40,5,18,35.96975486304089,0.6239583333333334,44.00406504065041,1023.983739837399,25.599593495934975,0
2035,4,0,0,43,0.0,0.0,1.0,43,1450,1200,250,0.8275862068965517,17,12,5,326.4753164018556,0.4347083794758213,0.22884323085365232,0.18905565782932107,130890.45606874117,-53.49938819491882,130836.95668054625,1986,4,318.8139534883721,38,5,19,35.82537238115126,0.6255482456140351,44.17735042735042,1023.290598290597,26.928699955015713,0
2036,4,1,0,44,0.022727272727272728,0.0,1.0,44,1350,900,450,0.6666666666666666,18,9,9,354.07148615963416,0.4368943798449612,0.2565201192250366,0.19634873323397922,129201.38888888908,425.6784644605352,129627.06735334962,1987,0,312.54545454545456,36,8,18,36.83401639344262,0.6122685185185186,45.83333333333334,1016.6666666666682,28.240740740740783,8
2037,4,1,1,44,0.022222222222222223,0.022222222222222223,0.9777777777777777,45,1100,800,300,0.7272727272727273,14,8,6,348.09282803503135,0.43869949494949495,0.2560750796044917,0.19440418951992547,129480.23069598345,14.227935518632393,129494.45863150209,1988,0,306.5777777777778,37,8,17,36.70230912877974,0.6131756756756757,45.559210526315795,1017.7631578947373,27.507112375533442,0
2038,4,0,0,44,0.0,0.0,1.0,44,1150,900,250,0.782608695652174,14,9,5,355.9112132454881,0.43686134601832277,0.2545223147812785,0.1985193656102614,129430.46932067221,413.1510733706911,129843.62039404291,1989,2,314.54545454545456,36,8,17,36.554015419802276,0.6145833333333333,45.60810810810812,1017.5675675675692,28.26576576576581,0
2039,4,0,1,43,0.0,0.022727272727272728,0.9772727272727273,44,1350,1000,350,0.7407407407407407,17,10,7,355.6499113422535,0.4368173009161381,0.2555416427802746,0.19880764060746056,129516.4267941932,412.50114134408324,129928.92793553729,1990,3,315.54545454545456,36,8,17,36.4731994689678,0.6154513888888888,45.52364864864867,1017.9054054054084,28.275150150150232,0
2040,4,0,0,43,0.0,0.0,1.0,43,1200,1000,200,0.8333333333333334,14,10,4,358.4881891488868,0.4357004429678848,0.24351748043158428,0.20112699644308565,129659.75265806388,696.2979871764069,130356.05064524029,1561,4,277.6046511627907,36,7,17,36.25515995872031,0.6168981481481481,45.3828828828829,1018.4684684684718,28.290790790790883,0
2041,4,1,0,44,0.022727272727272728,0.0,1.0,44,1600,1200,400,0.75,20,12,8,349.47947739623055,0.43898652219873147,0.24521016617790758,0.1976982445124666,129982.90339335208,285.2714296707013,130268.17482302278,1562,0,272.27272727272725,37,7,19,36.15636200716847,0.6182432432432432,45.06578947368423,1019.7368421052654,27.5604551920342,0
2042,4,0,0,44,0.0,0.0,1.0,44,950,800,150,0.8421052631578947,11,8,3,343.1987573277219,0.43841393587033123,0.23357500195419312,0.19470251452299572,130094.74068944315,129.6706678978415,130224.41135734098,1563,1,273.27272727272725,37,7,19,36.2030667813127,0.6193693693693694,44.956140350877206,1020.1754385964932,27.572309151256572,0
2043,4,0,0,44,0.0,0.0,1.0,44,1300,1200,100,0.9230769230769231,14,12,2,346.2943262716074,0.4381826990838619,0.23934788764022952,0.19744926343630992,130290.5716783051,223.77714777626494,130514.34882608136,1564,2,274.27272727272725,37,7,20,35.925585329180535,0.6213400900900901,44.764254385964925,1020.9429824561423,27.593053579895738,0
2044,4,0,0,44,0.0,0.0,1.0,44,850,800,50,0.9411764705882353,9,8,1,347.14362359281836,0.438050563777308,0.2410486807297718,0.19821879623052852,130346.5504410012,249.79476858265693,130596.34520958386,1565,3,275.27272727272725,37,7,20,35.84718046458356,0.6219031531531531,44.70942982456141,1021.1622807017554,27.598980559506902,0
2045,4,1,0,45,0.022222222222222223,0.0,1.0,45,1700,1500,200,0.8823529411764706,19,15,4,316.4110918898921,0.4391203703703704,0.17666622025802425,0.17009658913908007,127964.52591050291,-865.0872961569164,127099.438614346,1566,0,270.1333333333333,40,5,18,39.04931699477702,0.5927083333333334,47.05284552845528,1011.7886178861781,25.294715447154452,8
2046,4,1,0,46,0.021739130434782608,0.0,1.0,46,700,400,300,0.5714285714285714,10,4,6,311.60298397060075,0.4416264090177134,0.18396172175446157,0.16858266366485736,128219.87714356555,-1209.2607355442406,127010.6164080213,1567,0,265.2391304347826,41,5,19,38.91082623175627,0.59375,46.80059523809523,1012.7976190476174,24.702380952380913,0
2047,4,1,0,47,0.02127659574468085,0.0,1.0,47,1450,1000,450,0.6896551724137931,19,10,9,305.78362862827964,0.44349367869256856,0.18582007484515684,0.16696073243882106,128586.40861614373,-1536.0762762153872,127050.33233992834,1568,0,260.5744680851064,42,5,16,38.685471800261126,0.5959821428571428,46.438953488372086,1014.2441860465105,24.14867109634549,0
2048,4,0,0,47,0.0,0.0,1.0,47,1350,1000,350,0.7407407407407407,17,10,7,306.4767245468106,0.4430118717237126,0.18809867724706542,0.16796079205540268,128733.87008180088,-1509.2130318190061,127224.65704998188,1569,1,261.5744680851064,42,5,16,38.518094146853834,0.5974702380952381,46.29360465116279,1014.8255813953481,24.16251384274638,0
2049,4,2,1,48,0.04081632653061224,0.02040816326530612,0.9795918367346939,49,1100,500,600,0.45454545454545453,17,5,12,296.55619975947127,0.44584396258503406,0.20399614954340928,0.16465016105958122,129248.4610768177,-2134.1135116597934,127114.3475651579,1570,0,251.85714285714286,44,5,18,38.248194014447904,0.599905303030303,45.787037037037045,1016.8518518518529,23.110269360269385,0
2050,4,1,1,48,0.02040816326530612,0.02040816326530612,0.9795918367346939,49,1700,1400,300,0.8235294117647058,20,14,6,292.6387852045795,0.44671201814058953,0.20125694825163665,0.16400026038234683,129616.12335249927,-2213.8590238395514,127402.26432865972,1571,0,249.40816326530611,45,4,14,37.975893969044634,0.6023148148148147,45.42572463768115,1018.2971014492738,22.62882447665053,0
2051,4,1,0,49,0.02040816326530612,0.0,1.0,49,1400,1100,300,0.7857142857142857,17,11,6,296.0459817409817,0.44628684807256236,0.2532736543820522,0.15649862202287243,127287.5024412597,-2136.5812717132476,125150.92116954645,1572,0,250.3877551020408,42,7,17,40.25430510210614,0.5828373015873016,47.72286821705427,1009.1085271317842,24.02639350313772,8
2052,4,0,0,49,0.0,0.0,1.0,49,1300,700,600,0.5384615384615384,19,7,12,295.5900177202409,0.44639314058956914,0.24704062047083597,0.15682525380065748,127434.21744486524,-2266.3434814614416,125167.87396340379,1573,1,251.3877551020408,42,7,13,40.11616282789506,0.5843253968253967,47.577519379844965,1009.6899224806214,24.040236249538605,0
2053,4,6,4,51,0.10909090909090909,0.07272727272727272,0.9272727272727272,55,1600,1100,500,0.6875,21,11,10,278.81503619569287,0.4509118967452301,0.29521808609878497,0.15309554682239734,128810.30545217656,-3811.2276028459337,124999.07784933063,1574,0,224.85454545454544,45,10,13,39.14248163350281,0.5942129629629629,46.218297101449274,1015.1268115942031,22.558373590982292,0
2054,4,0,1,50,0.0,0.0196078431372549,0.9803921568627451,51,950,400,550,0.42105263157894735,15,4,11,300.3221243577597,0.44771241830065356,0.29426547863833696,0.16288846819255445,128320.37278163584,-2492.510609567893,125827.86217206795,1575,1,243.41176470588235,41,10,18,39.094271190313016,0.5947662601626016,46.70138888888889,1013.1944444444448,24.712059620596214,0
2055,4,0,0,50,0.0,0.0,1.0,50,1450,800,650,0.5517241379310345,21,8,13,306.9623290456933,0.4479166666666667,0.3082013234409464,0.16693796455298512,128427.65239771307,-2115.509741225449,126312.14265648762,1576,2,248.64,40,10,15,38.816965777688665,0.5973958333333333,46.59552845528456,1013.6178861788624,25.34044715447156,0
2056,4,0,0,50,0.0,0.0,1.0,50,1450,1000,450,0.6896551724137931,19,10,9,306.3777353627105,0.4481292517006803,0.3066940575207937,0.16715929038734223,128556.44710696358,-2122.6333738184812,126433.8137331451,1577,3,249.64,40,10,16,38.700855129104475,0.5986979166666666,46.46849593495936,1014.1260162601636,25.353150406504092,0
2057,4,1,0,51,0.0196078431372549,0.0,1.0,51,1250,700,550,0.56,18,7,11,304.4945271080782,0.4488235294117647,0.31506665593733985,0.167357518282711,128848.62075617307,-2353.2600308641768,126495.3607253089,1578,0,245.72549019607843,41,10,17,38.45189238486091,0.6001016260162602,46.180555555555564,1015.2777777777796,24.76287262872633,0
2058,4,0,1,50,0.0,0.0196078431372549,0.9803921568627451,51,1500,1000,500,0.6666666666666666,20,10,10,329.201579788069,0.4495261437908497,0.32205932855487474,0.1761847251828174,127785.23090457104,-1641.4218435140754,126143.80906105696,1579,1,246.72549019607843,43,8,13,38.90888904498767,0.5864825581395349,47.230113636363626,1011.0795454545436,23.513477801268454,8
2059,4,0,0,50,0.0,0.0,1.0,50,1500,1100,400,0.7333333333333333,19,11,8,331.21743680332077,0.4486309523809524,0.31900143747005383,0.177334733352624,127801.37466385688,-1533.9912527793222,126267.38341107756,1580,2,252.48,42,8,14,38.84143906724166,0.5880456349206349,47.214147286821685,1011.1434108527095,24.074843115540702,0
2060,4,1,0,51,0.0196078431372549,0.0,1.0,51,1100,600,500,0.5454545454545454,16,6,10,326.69987699782456,0.4497549019607843,0.3231330944669817,0.17631473124847968,128121.09482167294,-1828.5708161866078,126292.52400548634,1581,0,248.50980392156862,44,7,16,38.629313761356016,0.5885416666666667,46.898148148148124,1012.4074074074027,23.009259259259153,0
2061,4,2,2,51,0.03773584905660377,0.03773584905660377,0.9622641509433962,53,1450,800,650,0.5517241379310345,21,8,13,321.003717188803,0.4512125060474117,0.34053478195793296,0.17575650637087484,128696.43814745445,-2337.586563100509,126358.85158435394,1582,0,240.0943396226415,43,10,11,38.187606937315294,0.595687984496124,46.330492424242415,1014.6780303030285,23.59716349541927,0
2062,4,1,0,52,0.019230769230769232,0.0,1.0,52,1400,900,500,0.6428571428571429,19,9,10,325.7411384077328,0.45087826797385616,0.33787222324215094,0.17873957175594551,128783.04268260614,-2010.0130137912515,126773.0296688149,1583,0,228.76923076923077,42,10,13,37.979315831344444,0.5979662698412698,46.245155038759684,1015.0193798449607,24.167128091546683,0
2063,4,0,1,51,0.0,0.019230769230769232,0.9807692307692307,52,1700,1400,300,0.8235294117647058,20,14,6,325.38095099353194,0.45087826797385616,0.33971667645331816,0.1790962377317338,128906.01526350567,-2011.2876329547632,126894.72763055091,1584,1,229.76923076923077,42,10,13,37.86339058524173,0.5992063492063492,46.12403100775193,1015.5038759689912,24.17866371354741,0
2064,4,0,0,51,0.0,0.0,1.0,51,1600,1100,500,0.6875,21,11,10,329.69103302120016,0.450343137254902,0.34080459125073426,0.18169408034322923,128955.22072742018,-1696.924012979992,127258.29671444019,1585,2,234.6078431372549,42,9,14,37.70392100744132,0.5997023809523809,46.075581395348834,1015.6976744186042,24.183277962347717,0
2065,4,1,0,52,0.019230769230769232,0.0,1.0,52,1350,1100,250,0.8148148148148148,16,11,5,326.0545766614005,0.45067401960784315,0.34732770302209026,0.1812982281618405,129307.31336805578,-1966.812790134283,127340.5005779215,1586,0,231.07692307692307,39,13,16,37.43854977468252,0.607905982905983,45.72916666666668,1017.0833333333352,26.079059829059876,0
2066,4,0,2,50,0.0,0.038461538461538464,0.9615384615384616,52,1000,700,300,0.7,13,7,6,323.79735402634344,0.4502733785822021,0.34465357337697755,0.18038593829480967,129382.26176754937,-2021.2731963447366,127360.98857120464,1587,1,232.07692307692307,40,12,16,37.41987979888789,0.60703125,45.655487804878064,1017.3780487804902,25.434451219512255,0
2067,4,1,0,51,0.0196078431372549,0.0,1.0,51,1750,1300,450,0.7428571428571429,22,13,9,330.4758631829624,0.4514869281045752,0.3407833902476727,0.1841276529211637,129386.7852105037,-1648.1580946180316,127738.62711588567,1588,0,236.66666666666666,39,12,17,37.24542251117709,0.6087072649572649,45.65104166666668,1017.3958333333352,26.087072649572697,0
2068,4,0,1,50,0.0,0.0196078431372549,0.9803921568627451,51,1500,800,700,0.5333333333333333,22,8,14,330.37666455196273,0.4504738562091503,0.3378609305357365,0.18477850635494206,129537.39636005361,-1640.7734111639802,127896.62294888962,1589,1,237.66666666666666,40,11,13,37.09506339223321,0.60859375,45.50304878048781,1017.9878048780494,25.449695121951233,0
2069,4,0,0,50,0.0,0.0,1.0,50,1050,400,650,0.38095238095238093,17,4,13,336.50695798086775,0.44850340136054423,0.3361142389190295,0.1877405181333581,129439.78000217033,-1288.52267795137,128151.25732421895,1590,4,243.4,39,11,14,37.03818626949192,0.6092414529914529,45.59895833333334,1017.6041666666682,26.09241452991457,0
2070,4,0,1,49,0.0,0.02,0.98,50,1550,1200,350,0.7741935483870968,19,12,7,338.4162963908842,0.4484778911564626,0.33575606347938836,0.18952447588263138,129589.12854658304,-1228.9854129486134,128360.14313363442,1591,5,244.4,40,10,14,36.83792460990784,0.6091145833333333,45.45223577235774,1018.1910569105717,25.45477642276429,0
2071,4,0,0,49,0.0,0.0,1.0,49,900,600,300,0.6666666666666666,12,6,6,336.27326750891774,0.44761550453514737,0.31651433579566723,0.18900876759984012,129731.44531250017,-1074.9565972222078,128656.48871527797,1592,6,232.10204081632654,41,8,14,36.74804021813224,0.6089939024390244,45.31250000000001,1018.7500000000014,24.847560975609788,0
2072,4,2,2,49,0.0392156862745098,0.0392156862745098,0.9607843137254902,51,850,400,450,0.47058823529411764,13,4,9,324.57878117552053,0.44950980392156864,0.3160179539942536,0.18459026515718155,130190.09452658714,-1748.6115594868918,128441.48296710025,1593,0,223.9607843137255,43,8,17,36.58147366304785,0.6107073643410852,44.862689393939405,1020.5492424242444,23.733703312191732,0
2073,4,1,0,50,0.02,0.0,1.0,50,1350,800,550,0.5925925925925926,19,8,11,329.4872130851594,0.44814625850340134,0.32240744256692544,0.18761180014265263,130237.85848957411,-1417.6581936181587,128820.20029595595,1594,0,227.88,42,8,18,36.40790139864567,0.6125992063492063,44.81589147286822,1020.7364341085284,24.30324843115544,0
2074,4,0,0,50,0.0,0.0,1.0,50,1250,600,650,0.48,19,6,13,328.68647802692226,0.4479761904761905,0.3199853510515849,0.18753771167183855,130317.12420784938,-1433.2952940452365,128883.82891380414,1595,1,228.88,38,12,18,36.34813923476683,0.6197916666666667,44.738247863247864,1021.0470085470087,26.869658119658123,0
2075,4,0,1,49,0.0,0.02,0.98,50,1050,700,350,0.6666666666666666,14,7,7,329.6673417009209,0.4482227891156463,0.32140615191462674,0.18822941768084833,130344.39718934907,-1405.9418145956638,128938.45537475341,1596,2,229.88,38,12,18,36.29551161330823,0.6200657894736843,44.71153846153846,1021.1538461538457,26.87246963562752,0
2076,4,0,0,49,0.0,0.0,1.0,49,1450,1100,350,0.7586206896551724,18,11,7,334.38769210609746,0.44641085600907027,0.21198402739903655,0.1816556893867744,128384.34504849635,-1213.971031336083,127170.37401716027,1597,3,235.12244897959184,43,6,12,38.1661527440354,0.5925387596899225,46.63825757575758,1013.4469696969699,23.5685341789993,8
2077,4,0,3,46,0.0,0.061224489795918366,0.9387755102040817,49,1300,1100,200,0.8461538461538461,15,11,4,309.4580684910035,0.44633999433106575,0.15737290301750284,0.16006503795937446,126400.68229345982,-1949.5786164199146,124451.10367703991,1598,4,236.12244897959184,43,6,11,40.82354349122641,0.5724321705426356,48.60321969696968,1005.5871212121184,23.385747004932988,8
2078,4,3,3,46,0.061224489795918366,0.061224489795918366,0.9387755102040817,49,1650,1200,450,0.7272727272727273,21,12,9,306.7015457788348,0.45021967120181405,0.16805066854327966,0.15997023071198221,126742.1392746914,-2025.597993827153,124716.54128086426,1599,0,233.22448979591837,44,5,11,40.543103448275886,0.5745738636363636,48.26388888888889,1006.9444444444448,22.885101010101017,0
2079,4,2,0,48,0.041666666666666664,0.0,1.0,48,1550,1000,550,0.6451612903225806,21,10,11,314.697317581535,0.445561835106383,0.1807781799379522,0.164493138433159,126829.56271701382,-1617.4153645833437,125212.14735243047,1600,0,239.04166666666666,43,5,14,40.25228369527749,0.5767926356589148,48.17708333333333,1007.2916666666661,23.42538759689921,0
2080,4,4,2,50,0.07692307692307693,0.038461538461538464,0.9615384615384616,52,1550,1200,350,0.7741935483870968,19,12,7,318.4195051158948,0.4516559829059829,0.2525438862495366,0.17137004483252916,128009.92565923514,-2247.5572969716527,125762.36836226349,1601,0,221.57692307692307,46,6,17,38.952219302087904,0.5849184782608696,47.007978723404264,1011.9680851063846,21.99930619796488,0
2081,4,2,0,52,0.038461538461538464,0.0,1.0,52,1450,1400,50,0.9655172413793104,15,14,1,312.81650958865055,0.4530385872297637,0.24896338011601293,0.1703799656338395,128488.14791967157,-2361.0742753975524,126127.07364427402,1602,0,220.8653846153846,42,10,15,38.607075727165565,0.5949900793650793,46.53585271317831,1013.856589147289,24.139442598744978,0
2082,4,1,1,52,0.018867924528301886,0.018867924528301886,0.9811320754716981,53,1350,1000,350,0.7407407407407407,17,10,7,316.799304873359,0.45406990807934206,0.27513715171204356,0.17472011019930755,128984.86036680773,-2427.53717932158,126557.32318748615,1603,0,217.67924528301887,43,10,18,38.00116916814272,0.5985949612403101,46.04640151515154,1015.8143939393975,23.623590556730175,0
2083,4,1,1,52,0.018867924528301886,0.018867924528301886,0.9811320754716981,53,1400,1000,400,0.7142857142857143,18,10,8,320.1915515557185,0.455188679245283,0.28031706637975695,0.17734928622495902,129154.32527434884,-2329.1752400548316,126825.15003429401,1604,0,215.11320754716982,44,9,20,37.74291006254933,0.5989583333333333,45.87962962962965,1016.4814814814848,23.10185185185193,0
2084,4,1,1,52,0.018867924528301886,0.018867924528301886,0.9811320754716981,53,1600,800,800,0.5,24,8,16,318.593349150431,0.4563679245283019,0.2757097043258161,0.1771163025785448,129299.92187969483,-2361.163821915373,126938.75805777946,1605,0,211.9433962264151,42,11,21,37.63576600609755,0.6031746031746033,45.736434108527135,1017.0542635658923,24.215577703949815,0
2085,4,0,0,52,0.0,0.0,1.0,52,2200,1600,600,0.7272727272727273,28,16,12,317.58632353556266,0.4562122926093514,0.2701981707317067,0.17655646460960103,129299.92187969483,-2187.222635358445,127112.69924433639,1606,1,216.92307692307693,42,10,21,37.6613709984756,0.6031746031746033,45.736434108527135,1017.0542635658923,24.215577703949815,0
2086,4,1,1,52,0.018867924528301886,0.018867924528301886,0.9811320754716981,53,1300,600,700,0.46153846153846156,20,6,14,313.8540921701062,0.45595972423802617,0.27063558623206463,0.17597429130330158,129634.99070965346,-2462.7055354683066,127172.28517418515,1607,0,213.81132075471697,43,10,14,37.41669766288513,0.6051356589147288,45.407196969696976,1018.3712121212129,23.68305144467937,0
2087,4,0,2,50,0.0,0.038461538461538464,0.9615384615384616,52,1650,1300,350,0.7878787878787878,20,13,7,315.6238686919174,0.4548689668174963,0.2729437039314293,0.17690086592444573,129620.4134836397,-2217.740726969538,127402.67275667016,1608,1,218.82692307692307,42,10,15,37.38640688933297,0.6063988095238095,45.42151162790697,1018.3139534883712,24.245570321151696,0
2088,4,1,3,48,0.0196078431372549,0.058823529411764705,0.9411764705882353,51,1200,800,400,0.6666666666666666,16,8,8,322.4696538279525,0.4540359477124183,0.2711628688887877,0.18066749600928497,129605.142983119,-1841.2548815822747,127763.88810153672,1609,0,223.54901960784315,41,10,17,37.22760782021303,0.6077235772357723,45.43650793650793,1018.2539682539668,24.835462640340655,0
2089,4,2,1,49,0.04,0.02,0.98,50,1150,600,550,0.5217391304347826,17,6,11,323.24453165109713,0.456156462585034,0.2668182250546951,0.18162852812656222,129719.10609526145,-1613.8016608076653,128105.30443445378,1610,0,227.06,42,8,18,37.092369764418656,0.607390873015873,45.324612403100765,1018.7015503875948,24.254798818752256,0
2090,4,0,1,48,0.0,0.02040816326530612,0.9795918367346939,49,900,500,400,0.5555555555555556,13,5,8,331.5902037320348,0.45370960884353745,0.27374923479325575,0.18625646673525872,129706.17992567383,-1198.14027462838,128508.03965104544,1611,1,232.69387755102042,41,8,18,36.892935982339964,0.608739837398374,45.33730158730158,1018.6507936507925,24.845141308555913,0
2091,4,0,0,48,0.0,0.0,1.0,48,1250,800,450,0.64,17,8,9,337.7114227172132,0.453586731678487,0.2758103815321151,0.1893791923362728,129640.87106095909,-843.7593983409389,128797.11166261815,1612,2,234.16666666666666,40,8,19,36.803337990220506,0.6096354166666667,45.40142276422764,1018.3943089430895,25.459857723577237,0
2092,4,1,0,49,0.02040816326530612,0.0,1.0,49,1200,800,400,0.6666666666666666,16,8,8,336.36748361039145,0.45482568027210885,0.2827670577767889,0.18991825613079005,129908.37191358008,-1060.6095679012565,128847.76234567883,1613,0,230.3673469387755,41,8,20,36.56618982742959,0.6107723577235773,45.13888888888888,1019.4444444444431,24.864498644986416,0
2093,4,0,3,46,0.0,0.061224489795918366,0.9387755102040817,49,1300,1000,300,0.7692307692307693,16,10,6,335.177067199054,0.4539930555555556,0.27972005763986174,0.1899829440430359,130060.11924445698,-1081.3661344167383,128978.75311004024,1614,1,231.3673469387755,41,8,20,36.44273163457173,0.6122967479674797,44.99007936507936,1020.0396825396821,24.879016647309317,0
2094,4,1,1,46,0.02127659574468085,0.02127659574468085,0.9787234042553191,47,1350,1000,350,0.7407407407407407,17,10,7,345.239294230336,0.4542668825161887,0.274411356211814,0.19523671006474638,129970.32470703135,-425.82736545137345,129544.49734157998,1615,0,239.0212765957447,39,8,21,36.27722017911263,0.6145833333333333,45.07812500000001,1019.6875000000008,26.145833333333353,0
2095,4,0,1,45,0.0,0.021739130434782608,0.9782608695652174,46,1200,900,300,0.75,15,9,6,352.53554536751665,0.4533212560386473,0.27260992500921977,0.20002150461761273,130099.04308431986,-27.09257889542795,130071.95050542442,1616,1,243.54347826086956,38,8,21,35.96057178762175,0.6175986842105263,44.951923076923094,1020.1923076923104,26.847165991902905,0
2096,4,0,1,44,0.0,0.022222222222222223,0.9777777777777777,45,800,600,200,0.75,10,6,4,360.8747140379109,0.4528409090909091,0.27499940275687407,0.20443706394522848,130038.81602993248,385.54410972609105,130424.36013965857,1617,2,249.2,37,8,21,35.80905540027234,0.6188063063063063,45.01096491228071,1019.9561403508787,27.566382171645373,0
2097,4,2,0,46,0.043478260869565216,0.0,1.0,46,1650,1200,450,0.7272727272727273,21,12,9,351.97976293656194,0.4539855072463768,0.27434447054311817,0.2012898139870506,130406.32482144331,-19.53780701976558,130386.78701442355,1618,0,244.2173913043478,36,10,23,35.66312936420434,0.6244212962962963,44.650900900900915,1021.3963963963984,28.372122122122178,0
2098,4,1,1,46,0.02127659574468085,0.02127659574468085,0.9787234042553191,47,900,700,200,0.7777777777777778,11,7,4,342.639701881508,0.4546137835337651,0.2748846738242663,0.19749430529956402,130710.70545744865,-442.66456986762614,130268.04088758102,1619,0,240.0,37,10,21,35.59359139323755,0.6255630630630631,44.35307017543861,1022.5877192982473,27.637505926979657,0
2099,4,0,0,46,0.0,0.0,1.0,46,1200,900,300,0.75,15,9,6,342.71055354573355,0.45408615136876,0.26159723485537456,0.19774442486037858,130751.61944038661,-238.00802491678178,130513.61141546983,1620,1,243.8695652173913,36,10,21,35.55040189385597,0.6278935185185186,44.313063063063076,1022.74774774775,28.409659659659724,0
2100,4,0,0,46,0.0,0.0,1.0,46,1200,1000,200,0.8333333333333334,14,10,4,341.85217639677103,0.4539754428341385,0.25828288387451814,0.19769108991500117,130838.01442912531,-254.54800239425938,130583.46642673104,1621,2,244.8695652173913,36,10,22,35.48500275178866,0.6287615740740741,44.22860360360362,1023.0855855855875,28.4190440440441,0
2101,4,0,0,46,0.0,0.0,1.0,46,1350,800,550,0.5925925925925926,19,8,11,342.23770774456943,0.45365338164251207,0.2567580496252033,0.19850660661712796,130953.2521330453,-236.5718336579752,130716.68029938733,1622,3,245.8695652173913,36,10,22,35.35867532181757,0.6299189814814814,44.115990990990994,1023.5360360360369,28.43155655655658,0
2102,4,0,2,44,0.0,0.043478260869565216,0.9565217391304348,46,1450,1100,350,0.7586206896551724,18,11,7,346.44910808312386,0.45304951690821255,0.26195735850319624,0.20155225462570991,131068.54056336744,-118.28420481291869,130950.25635855451,1623,4,246.8695652173913,36,10,22,35.134398255068,0.6310763888888888,44.00337837837838,1023.9864864864867,28.444069069069073,0
2103,4,0,1,43,0.0,0.022727272727272728,0.9772727272727273,44,850,600,250,0.7058823529411765,11,6,5,360.1229503012623,0.45051532769556024,0.22937278327422095,0.19705604134462298,128672.41753472203,474.2866916747627,129146.70422639679,1624,5,258.6818181818182,37,7,16,37.21979808350446,0.6050112612612613,46.35416666666666,1014.5833333333318,27.421171171171128,8
2104,4,0,3,40,0.0,0.06976744186046512,0.9302325581395349,43,1400,1100,300,0.7857142857142857,17,11,6,366.55792837785395,0.4483896271686969,0.23728778553430585,0.20036127541430276,128629.57552146741,830.0381462543648,129459.61366772177,1625,6,265.5581395348837,36,7,16,37.10035523978686,0.6064814814814814,46.3963963963964,1014.4144144144144,28.17817817817818,0
2105,4,0,0,40,0.0,0.0,1.0,40,1000,900,100,0.9,11,9,2,378.3357229101235,0.4456063034188034,0.25131879424526193,0.2058052336178173,128437.66744898827,1718.5115526405964,130156.17900162887,1626,16,282.625,35,5,16,36.99807794778107,0.6065476190476191,46.585648148148145,1013.6574074074069,28.961640211640198,0
2106,4,1,0,41,0.024390243902439025,0.0,1.0,41,850,400,450,0.47058823529411764,13,4,9,369.81292783365865,0.44697662601626015,0.24588353739729163,0.20272226919932654,128743.83674214748,1322.227041230416,130066.0637833779,1627,0,276.7073170731707,36,5,18,36.901030108004136,0.6076388888888888,46.28378378378378,1014.8648648648643,28.190690690690676,0
2107,4,0,0,41,0.0,0.0,1.0,41,1450,1200,250,0.8275862068965517,17,12,5,368.8865676926209,0.44608739837398376,0.24590401394781702,0.20298624500305165,128895.01006319237,1309.527570983361,130204.53763417574,1628,1,277.7073170731707,37,4,18,36.77012471655328,0.6072635135135135,46.13486842105262,1015.4605263157882,27.4448790896159,0
2108,4,1,1,41,0.023809523809523808,0.023809523809523808,0.9761904761904762,42,900,600,300,0.6666666666666666,12,6,6,363.22918573400915,0.4477835849787069,0.25432228856886363,0.20158157734595022,129231.64859693882,989.5960727319596,130221.24466967078,1629,0,272.07142857142856,34,8,20,36.57041525192209,0.6167279411764706,45.80357142857143,1016.7857142857147,29.90546218487396,0
2109,4,0,1,40,0.0,0.024390243902439025,0.975609756097561,41,1150,900,250,0.782608695652174,14,9,5,363.81583610123806,0.44702743902439024,0.24216129814896714,0.202528098989256,129352.72285997734,1212.1138038548763,130564.83666383222,1630,1,269.0243902439024,34,7,22,36.43212404915155,0.617953431372549,45.68452380952381,1017.2619047619048,29.919467787114847,0
2110,4,0,0,40,0.0,0.0,1.0,40,1200,600,600,0.5,18,6,12,373.21294817825515,0.4450186965811966,0.25725301204819284,0.20761846312865395,129326.01042868131,1653.228325643984,130979.2387543253,1631,2,276.25,33,7,22,36.220381526104404,0.619949494949495,45.71078431372549,1017.1568627450984,30.82293523469995,0
2111,4,2,0,42,0.047619047619047616,0.0,1.0,42,1300,1000,300,0.7692307692307693,16,10,6,355.44961247372873,0.4468762098335269,0.25246636286481916,0.20084385094811263,129937.87140185611,837.2732070901907,130775.1446089463,1632,0,264.04761904761904,35,7,20,36.049896885760774,0.6217261904761905,45.1099537037037,1019.560185185185,29.130291005291,0
2112,4,0,0,42,0.0,0.0,1.0,42,1000,700,300,0.7,13,7,6,356.06330759971837,0.44651325977545486,0.24877480777855188,0.20179973825571165,130055.90284475731,861.6269879543736,130917.52983271168,1633,1,265.04761904761904,35,7,20,35.914392564015266,0.6229166666666667,44.994212962962955,1020.0231481481476,29.1435185185185,0
2113,4,0,1,41,0.0,0.023809523809523808,0.9761904761904762,42,1600,1200,400,0.75,20,12,8,357.8624947494214,0.4457873596593109,0.24858935523409986,0.20374366308554853,130233.05047850216,921.1048686128175,131154.15534711498,1634,2,266.04761904761904,35,7,22,35.68868824885663,0.624702380952381,44.82060185185185,1020.717592592592,29.163359788359774,0
2114,4,1,0,42,0.023809523809523808,0.0,1.0,42,1350,800,550,0.5925925925925926,19,8,11,352.7033895824298,0.4454365079365079,0.23557057406975868,0.20206278300376576,130475.34722222213,803.8227934242011,131279.17001564632,1635,0,266.85714285714283,34,8,23,35.574700924415446,0.6292892156862745,44.58333333333333,1021.6666666666658,30.049019607843114,0
2115,4,0,1,41,0.0,0.023809523809523808,0.9761904761904762,42,1050,700,350,0.6666666666666666,14,7,7,354.6819618543809,0.4449888695315525,0.23604317105365302,0.20383529615004775,130597.00255102031,864.0802154194885,131461.0827664398,1636,1,267.85714285714283,34,8,16,35.40089486761394,0.6305147058823529,44.46428571428571,1022.1428571428564,30.063025210084014,0
2116,4,0,0,41,0.0,0.0,1.0,41,1150,800,350,0.6956521739130435,15,8,7,365.8932788340748,0.44326727642276426,0.24538879265952018,0.20948395414566243,130450.30757400986,1346.1781526335903,131796.48572664344,1637,5,275.3658536585366,33,8,22,35.2632157709533,0.6313131313131313,44.607843137254896,1021.5686274509793,30.9566250742721,0
2117,4,0,1,40,0.0,0.024390243902439025,0.975609756097561,41,650,500,150,0.7692307692307693,8,5,3,367.10264990871104,0.44308943089430897,0.2485359418237978,0.210515948757829,130512.91120001925,1382.3271097654763,131895.23830978473,1638,6,276.3658536585366,33,8,16,35.1688054689374,0.6319444444444444,44.54656862745098,1021.8137254901964,30.96405228758171,0
2118,4,0,1,39,0.0,0.025,0.975,40,850,800,50,0.9411764705882353,9,8,1,366.27618768294707,0.4434027777777778,0.23822541966426836,0.21038177722284981,130575.52984429066,1565.341455209534,132140.8712995002,1639,7,279.025,33,7,17,35.12639888089528,0.6325757575757576,44.48529411764706,1022.0588235294118,30.971479500891267,0
2119,4,1,0,40,0.025,0.0,1.0,40,1200,800,400,0.6666666666666666,16,8,8,361.5527268815662,0.44305555555555554,0.22985029940119728,0.20935958872823004,130888.84833958093,1464.6440071126506,132353.4923466936,1640,0,270.3,33,7,18,34.92964071856287,0.6357323232323233,44.17892156862745,1023.2843137254903,31.0086155674391,0
2120,4,1,0,41,0.024390243902439025,0.0,1.0,41,1050,700,350,0.6666666666666666,14,7,7,351.94943981614495,0.44402947154471545,0.22161223646134798,0.20518791451731758,131150.23389274685,1031.65027006172,132181.88416280856,1641,0,264.6829268292683,35,6,20,34.91101694915255,0.6339285714285714,43.92361111111111,1024.305555555555,29.265873015872998,0
2121,4,1,2,40,0.023809523809523808,0.047619047619047616,0.9523809523809523,42,1150,700,450,0.6086956521739131,16,7,9,340.0140206006263,0.44520663956639567,0.2152207909458781,0.19992463414347378,131476.4596863211,540.8884977280414,132017.34818404913,1642,0,259.35714285714283,35,7,21,34.8875456118572,0.637202380952381,43.60532407407407,1025.5787037037032,29.302248677248663,0
2122,4,0,0,40,0.0,0.0,1.0,40,900,500,400,0.5555555555555556,13,5,8,354.0220173341549,0.4424145299145299,0.22829383060299713,0.20686133762356235,131236.62308673473,1292.1308106575982,132528.75389739234,1643,1,272.825,34,6,21,34.77063243096703,0.6369485294117647,43.839285714285715,1024.6428571428576,30.136554621848752,0
2123,4,1,0,41,0.024390243902439025,0.0,1.0,41,1450,1100,350,0.7586206896551724,18,11,7,342.96168414543035,0.4425558943089431,0.22676736412034182,0.2022857837624244,131595.1877170138,826.4214409722126,132421.609157986,1644,0,267.1463414634146,35,6,18,34.69225888324873,0.6383928571428572,43.48958333333333,1026.0416666666658,29.315476190476165,0
2124,4,0,0,41,0.0,0.0,1.0,41,800,400,400,0.5,12,4,8,343.3879832323817,0.44225101626016255,0.2263971370964415,0.20285284792282002,131654.57182623885,841.7195805469811,132496.29140678584,1645,1,268.1463414634146,35,6,19,34.62146629825948,0.6389880952380953,43.43171296296296,1026.273148148148,29.322089947089943,0
2125,4,0,2,39,0.0,0.04878048780487805,0.9512195121951219,41,1200,900,300,0.75,15,9,6,341.07298566568664,0.44159044715447154,0.1474951658244097,0.18616383690334393,128572.46393352811,604.1224926205585,129176.58642614867,1646,2,269.1463414634146,36,5,16,37.80488933303723,0.6059027777777778,46.4527027027027,1014.1891891891892,28.17192192192192,8
2126,4,0,0,39,0.0,0.0,1.0,39,950,700,250,0.7368421052631579,12,7,5,353.98348059353054,0.43865272154745844,0.1732944367674909,0.19289042253455524,128506.39349489789,1297.8280895691526,129804.22158446704,1647,3,283.6923076923077,34,5,16,37.545008023169345,0.609375,46.51785714285714,1013.9285714285709,29.821428571428555,0
2127,4,0,0,39,0.0,0.0,1.0,39,1600,1100,500,0.6875,21,11,10,372.59752178795736,0.43766869095816463,0.12067268907190498,0.191190342788534,126072.89422850234,1594.889590835059,127667.78381933739,1648,4,284.6923076923077,35,4,19,39.57456974376704,0.5824404761904762,48.92939814814815,1004.2824074074083,28.693783068783095,8
2128,4,3,1,41,0.07142857142857142,0.023809523809523808,0.9761904761904762,42,650,400,250,0.6153846153846154,9,4,5,355.59934560577267,0.44744483159117304,0.12680484220414234,0.1859648491246163,126849.74163790274,621.5370233399137,127471.27866124266,1649,0,265.2857142857143,38,4,19,39.20153250609822,0.584703947368421,48.157051282051285,1007.3717948717951,26.509784075573556,0
2129,4,3,2,42,0.06818181818181818,0.045454545454545456,0.9545454545454546,44,1250,800,450,0.64,17,8,9,339.90106156826,0.45112094785059903,0.1457041054787802,0.180611845700099,127496.31461620645,-132.31118507560467,127364.00343113084,1650,0,253.97727272727272,38,6,15,38.93406854966678,0.591282894736842,47.51602564102564,1009.9358974358975,26.577260458839408,0
2130,4,0,0,42,0.0,0.0,1.0,42,1000,700,300,0.7,13,7,6,358.47200607374106,0.44700929152148666,0.13818985955623608,0.18911615020074052,127205.59030314101,719.9286279522807,127925.51893109329,1651,1,267.07142857142856,36,6,21,38.76353538736325,0.5920138888888888,47.804054054054056,1008.7837837837841,28.021771771771782,0
2131,4,0,0,42,0.0,0.0,1.0,42,1100,800,300,0.7272727272727273,14,8,6,360.5968835362839,0.4469004065040651,0.14689535711628987,0.19077150355679906,127319.21744379513,782.1826049021986,128101.40004869734,1652,2,268.07142857142856,36,6,16,38.59327345086663,0.5931712962962963,47.69144144144144,1009.2342342342341,28.034284284284283,0
2132,4,0,0,42,0.0,0.0,1.0,42,1350,1100,250,0.8148148148148148,16,11,5,364.814023924607,0.44650116144018587,0.14909568958648745,0.193409682110237,127404.47108848738,895.787552755486,128300.25864124286,1653,3,269.07142857142856,36,6,17,38.39933073061908,0.5940393518518519,47.606981981981995,1009.572072072074,28.043668668668722,0
2133,4,0,0,42,0.0,0.0,1.0,42,1450,1000,450,0.6896551724137931,19,10,9,366.85232581816126,0.446537456445993,0.14583233806285878,0.19531348456467218,127575.06397867473,960.241787395516,128535.30576607025,1654,4,270.07142857142856,36,6,17,38.17276966521755,0.595775462962963,47.43806306306307,1010.2477477477486,28.06243743743746,0
2134,4,0,2,40,0.0,0.047619047619047616,0.9523809523809523,42,600,400,200,0.6666666666666666,8,4,4,370.12181241810475,0.44650116144018587,0.15156483810372845,0.1974716495029769,127660.4032241701,1049.9799630711773,128710.38318724128,1655,5,271.07142857142856,36,6,17,38.00260939008989,0.5966435185185186,47.3536036036036,1010.5855855855855,28.071821821821818,0
2135,4,4,1,43,0.09090909090909091,0.022727272727272728,0.9772727272727273,44,750,700,50,0.9333333333333333,8,7,1,360.1578733992585,0.4498326286116984,0.16744976896318997,0.19548556612588391,128349.69142500428,447.97911992870416,128797.67054493297,1656,0,259.3863636363636,35,9,21,37.54866266895108,0.6056547619047619,46.6724537037037,1013.3101851851851,28.951719576719576,0
2136,4,2,1,44,0.044444444444444446,0.022222222222222223,0.9777777777777777,45,1250,900,350,0.72,16,9,7,357.92270802352954,0.45147306397306397,0.11425755815999716,0.19249778351452831,127982.32299884915,209.86830749392078,128192.19130634307,1657,0,252.48888888888888,38,7,15,37.981073804244524,0.596217105263158,47.035256410256395,1011.8589743589721,26.62786774628874,8
2137,4,2,3,43,0.043478260869565216,0.06521739130434782,0.9347826086956522,46,1350,900,450,0.6666666666666666,18,9,9,347.2273484295109,0.4498892914653784,0.13469800235017648,0.18960171032898293,128588.99493113243,-269.87139363320483,128319.12353749922,1658,0,247.93478260869566,37,9,15,37.63198198198198,0.6041666666666667,46.43640350877192,1014.2543859649104,27.412280701754334,0
2138,4,2,3,42,0.044444444444444446,0.06666666666666667,0.9333333333333333,45,1250,800,450,0.64,17,8,9,352.3647694260212,0.4457070707070707,0.14364590463153126,0.19281083450614855,128672.41753472216,67.92534722221683,128740.34288194438,1659,0,254.11111111111111,37,8,15,37.41658110882957,0.6050112612612613,46.354166666666664,1014.5833333333328,27.421171171171157,0
2139,4,2,2,42,0.045454545454545456,0.045454545454545456,0.9545454545454546,44,700,500,200,0.7142857142857143,9,5,4,360.27893535484674,0.4430056377730796,0.15531732418524857,0.19721222403081234,128686.6997910073,472.6214390065818,129159.32123001388,1660,0,260.77272727272725,36,8,16,37.20125786163522,0.6070601851851851,46.340090090090094,1014.6396396396402,28.18443443443445,0
2140,4,0,0,42,0.0,0.0,1.0,42,950,600,350,0.631578947368421,13,6,7,375.6177572030152,0.440754452187379,0.15660039705841244,0.20436966150694422,128446.04768990938,1249.3232709750644,129695.37096088444,1661,1,271.0952380952381,34,8,16,37.05837737326287,0.6087622549019608,46.577380952380956,1013.6904761904768,29.81442577030814,0
2141,4,0,0,42,0.0,0.0,1.0,42,900,500,400,0.5555555555555556,13,5,8,375.2375878358995,0.44053668215253583,0.15972897729178537,0.20462700212459645,128536.57171201833,1246.350623582787,129782.9223356011,1662,2,272.0952380952381,34,8,16,36.97537567504109,0.6096813725490196,46.48809523809525,1014.0476190476205,29.824929971988837,0
2142,4,0,0,42,0.0,0.0,1.0,42,350,200,150,0.5714285714285714,5,2,3,382.2321353421434,0.44053668215253583,0.14927916120576734,0.202249042486862,127325.5315500684,1403.9546940175067,128729.4862440859,1663,3,273.0952380952381,35,7,15,38.0409021406728,0.5952380952380952,47.685185185185176,1009.2592592592576,28.83597883597879,8
2143,4,1,1,42,0.023255813953488372,0.023255813953488372,0.9767441860465116,43,1300,1000,300,0.7692307692307693,16,10,6,354.163632208916,0.44264488741232927,0.12992113374248815,0.18644453566201658,127118.94729573007,468.74994926988205,127587.69724499996,1664,0,267.72093023255815,38,5,15,38.96113641981847,0.5874451754385965,47.88995726495726,1008.4401709401704,26.537899235267645,8
2144,4,2,1,43,0.045454545454545456,0.022727272727272728,0.9772727272727273,44,1600,1300,300,0.8125,19,13,6,346.9964411743718,0.4464081219168428,0.14472648563557633,0.18517928890394708,127670.36132812517,60.23220486112456,127730.5935329863,1665,0,262.4318181818182,39,5,17,38.576668040953756,0.5913461538461539,47.34375000000001,1010.6250000000014,25.913461538461572,0
2145,4,0,2,41,0.0,0.046511627906976744,0.9534883720930233,43,1050,600,450,0.5714285714285714,15,6,9,355.57709930601135,0.4442368032484312,0.15571220008553177,0.19008307986629855,127739.20323800149,484.2270710059387,128223.43030900742,1666,1,268.69767441860466,38,5,17,38.289341576833664,0.59375,47.275641025641036,1010.8974358974374,26.60256410256414,0
2146,4,0,0,41,0.0,0.0,1.0,41,700,100,600,0.14285714285714285,13,1,12,356.4153888716336,0.4416920731707317,0.17753896380486722,0.19048078087000545,127728.54538175222,904.8838344490746,128633.4292162013,1667,2,281.0731707317073,37,4,17,38.279074917742335,0.5954391891891893,47.28618421052632,1010.8552631578959,27.320412517780973,0
2147,4,1,0,42,0.023809523809523808,0.0,1.0,42,1450,1000,450,0.6896551724137931,19,10,9,352.0046128815661,0.44220625241966705,0.19142425979549094,0.18995740325352306,128118.16541883718,619.6370442708719,128737.80246310805,1668,0,275.35714285714283,39,3,18,37.99184158178139,0.5958867521367521,46.901041666666686,1012.3958333333363,25.958867521367598,0
2148,4,1,0,43,0.023255813953488372,0.0,1.0,43,1500,1000,500,0.6666666666666666,20,10,10,341.7866181071628,0.4435908084163898,0.18366821541969558,0.18556646094713464,128360.96871804015,174.41770436688176,128535.38642240703,1669,0,269.93023255813955,38,5,19,38.00254788262168,0.6000548245614035,46.66132478632479,1013.3547008547018,26.667228969860574,0
2149,4,0,1,42,0.0,0.023255813953488372,0.9767441860465116,43,1050,500,550,0.47619047619047616,16,5,11,341.20640647957305,0.4437753783684016,0.18666794139439236,0.1854714153657123,128408.33875868074,162.7495659722415,128571.08832465298,1670,1,270.93023255813955,39,4,16,37.96891058581706,0.5988247863247863,46.61458333333334,1013.5416666666681,25.9882478632479,0
2150,4,1,0,43,0.023255813953488372,0.0,1.0,43,1150,700,450,0.6086956521739131,16,7,9,339.5527071859477,0.4429448135843485,0.19680862497641516,0.18543043801848408,128593.16541883671,132.8314887152734,128725.99690755198,1671,0,271.8837209302326,39,4,18,37.822331484714674,0.6006944444444444,46.432291666666664,1014.2708333333326,26.006944444444425,0
2151,4,0,1,42,0.0,0.023255813953488372,0.9767441860465116,43,950,600,350,0.631578947368421,13,6,7,345.7028532396732,0.44218346253229973,0.19416455756649653,0.18916549385137146,128672.41753472204,296.4843749999803,128968.90190972203,1672,1,272.8837209302326,39,4,18,37.58555783709787,0.6014957264957265,46.35416666666666,1014.5833333333319,26.01495726495723,0
2152,4,0,1,41,0.0,0.023809523809523808,0.9761904761904762,42,950,700,250,0.7368421052631579,12,7,5,347.9907096327363,0.4406213704994193,0.19062535150652682,0.19003844866483172,128593.16541883662,549.8453776041487,129143.01079644077,1673,2,280.2142857142857,39,3,18,37.60837099038033,0.6006944444444444,46.43229166666666,1014.2708333333319,26.006944444444407,0
2153,4,2,0,43,0.046511627906976744,0.0,1.0,43,1300,900,400,0.6923076923076923,17,9,8,349.0265018100974,0.4443983019564415,0.21189095653751466,0.19291962363732232,129072.27143441388,409.92867588735595,129482.20011030123,1674,0,265.48837209302326,40,3,20,37.0937093709371,0.60390625,45.96036585365853,1016.1585365853646,25.403963414634113,0
2154,4,0,0,43,0.0,0.0,1.0,43,900,600,300,0.6666666666666666,12,6,6,349.99529744055906,0.4441675895164267,0.21516453005862157,0.19370796733276296,129123.91067031844,438.55230434924187,129562.46297466768,1675,1,266.48837209302326,40,3,20,37.01650668266506,0.6044270833333334,45.909552845528445,1016.3617886178849,25.409044715447124,0
2155,4,0,1,42,0.0,0.023255813953488372,0.9767441860465116,43,1250,1000,250,0.8,15,10,5,349.01815457776917,0.443936877076412,0.22065538445752386,0.19394651566992285,129282.8654051608,424.4598957593647,129707.32530092017,1676,2,267.48837209302326,38,5,20,36.8795304128585,0.609375,45.75320512820512,1016.9871794871773,26.762820512820454,0
2156,4,1,1,42,0.023255813953488372,0.023255813953488372,0.9767441860465116,43,1100,600,500,0.5454545454545454,16,6,10,346.1856600063259,0.44479051310446654,0.2161069895966472,0.19340080525567802,129492.7856445311,365.70909288192973,129858.49473741303,1677,0,258.6279069767442,39,4,19,36.738072698120284,0.609775641025641,45.54687499999999,1017.8124999999989,26.09775641025638,0
2157,4,1,0,43,0.023255813953488372,0.0,1.0,43,450,200,250,0.4444444444444444,7,2,5,346.1136795839097,0.44730527870062753,0.21365105104105409,0.19467152961530895,129757.9766167536,382.20214843750557,130140.1787651911,1678,0,255.90697674418604,39,4,20,36.47047421872335,0.6124465811965811,45.286458333333336,1018.8541666666677,26.124465811965838,0
2158,4,0,3,40,0.0,0.06976744186046512,0.9302325581395349,43,1000,700,300,0.7,13,7,6,345.2433764359903,0.44684385382059805,0.2158263122244537,0.19470930480842435,129864.12896050341,366.94607204860574,130231.07503255202,1679,1,256.90697674418607,39,4,20,36.38487906659853,0.6135149572649572,45.182291666666664,1019.2708333333328,26.13514957264956,0
2159,4,1,0,41,0.024390243902439025,0.0,1.0,41,750,400,350,0.5333333333333333,11,4,7,355.13909976327886,0.44601117886178865,0.2130511686007759,0.20004016928484336,129815.23762119118,1020.4933248691964,130835.73094606037,1680,0,263.0,37,4,21,36.18239365899147,0.6165540540540541,45.23026315789474,1019.0789473684214,27.542674253200577,0
2160,4,0,0,41,0.0,0.0,1.0,41,1450,1100,350,0.7586206896551724,18,11,7,349.92175411281386,0.4457571138211382,0.20558330884513665,0.19798477433353942,129990.07100820009,897.27073288773,130887.34174108782,1681,1,264.0,38,3,21,36.13781211803736,0.6165021929824561,45.05876068376069,1019.7649572649578,26.835919928025206,0
2161,4,0,1,40,0.0,0.024390243902439025,0.975609756097561,41,700,600,100,0.8571428571428571,8,6,2,351.8620362595926,0.44596036585365856,0.20622722211289157,0.19925281648453846,130023.43885633674,950.0623914930509,130973.50124782979,1682,2,265.0,39,2,21,36.054476049433156,0.6151175213675213,45.026041666666664,1019.8958333333328,26.1511752136752,0
2162,4,0,0,40,0.0,0.0,1.0,40,1650,1000,650,0.6060606060606061,23,10,13,353.337908037918,0.4450320512820513,0.20623102690254314,0.20103853695570195,130208.06081753617,1201.4887637884622,131409.54958132462,1683,3,270.6,38,2,21,35.829495097526085,0.6186951754385965,44.84508547008548,1020.6196581196597,26.85841205578052,0
2163,4,0,0,40,0.0,0.0,1.0,40,1100,900,200,0.8181818181818182,13,9,4,350.1404424474668,0.44459134615384616,0.20534467948029622,0.199929977959121,130346.55044100134,1127.9311828569062,131474.48162385824,1684,4,271.6,37,3,21,35.77067450517199,0.6219031531531531,44.70942982456142,1021.1622807017566,27.598980559506934,0
2164,4,0,0,40,0.0,0.0,1.0,40,700,200,500,0.2857142857142857,12,2,10,350.71712936704205,0.4446047008547009,0.20729546918617148,0.20040364067022293,130374.5443309481,1144.917186057267,131519.46151700537,1685,5,272.6,37,3,21,35.727578555579434,0.6221846846846847,44.68201754385966,1021.2719298245624,27.6019440493125,0
2165,4,0,0,40,0.0,0.0,1.0,40,800,500,300,0.625,11,5,6,352.84107029905186,0.44415064102564106,0.20936024044654378,0.20190831762321693,130430.54112803958,1204.250346260411,131634.7914743,1686,6,273.6,37,3,21,35.61659152712182,0.6227477477477478,44.62719298245615,1021.4912280701769,27.6078710289237,0
2166,4,0,0,40,0.0,0.0,1.0,40,850,600,250,0.7058823529411765,11,6,5,358.6540084541617,0.4435763888888889,0.20923085174855194,0.2061265515912269,130598.6036568946,1367.942540012333,131966.54619690694,1687,7,274.6,37,3,17,35.297772294929565,0.6244369369369369,44.462719298245624,1022.1491228070189,27.625651967757268,0
2167,4,1,0,41,0.024390243902439025,0.0,1.0,41,950,700,250,0.7368421052631579,12,7,5,349.55238083950974,0.4447154471544716,0.20507975153887403,0.20227571911178188,130863.12601587061,948.703452589687,131811.8294684603,1688,0,268.8780487804878,38,3,18,35.26265183947652,0.6252741228070176,44.20405982905984,1023.1837606837623,26.92588843904638,0
2168,4,0,0,41,0.0,0.0,1.0,41,1250,800,450,0.64,17,8,9,348.8183564717248,0.4444867886178862,0.20529664739177833,0.20213738878660967,130917.78897518103,933.3055966469656,131851.094571828,1689,1,269.8780487804878,38,3,18,35.226145735463,0.6258223684210527,44.150641025641036,1023.3974358974377,26.931511470985203,0
2169,4,0,2,39,0.0,0.04878048780487805,0.9512195121951219,41,900,500,400,0.5555555555555556,13,5,8,351.463235896674,0.4442073170731707,0.2041327489041953,0.20410428644617756,130999.80481591064,1008.3230604865311,132008.12787639716,1690,2,270.8780487804878,38,3,19,35.07553224796495,0.6266447368421053,44.070512820512825,1023.7179487179492,26.939946018893398,0
2170,4,1,1,39,0.025,0.025,0.975,40,700,400,300,0.5714285714285714,10,4,6,357.9968659681433,0.44166666666666665,0.21345082494107626,0.20754923894078553,130935.05333371792,1374.8677477685308,132309.92108148645,1691,0,277.85,37,3,20,34.973841154203285,0.6278153153153153,44.133771929824555,1023.4649122807006,27.66121384542434,0
2171,4,0,0,39,0.0,0.0,1.0,39,1150,800,350,0.6956521739130435,15,8,7,362.14497872494275,0.441183085919928,0.21365599457472273,0.2107209941627564,131075.36844269387,1693.6573032086753,132769.02574590256,1692,1,281.20512820512823,37,2,20,34.72567994431952,0.629222972972973,43.99671052631579,1024.0131578947364,27.676031294452336,0
2172,4,0,0,39,0.0,0.0,1.0,39,1150,700,450,0.6086956521739131,16,7,9,361.12744301576896,0.4413517768780926,0.21322421557891968,0.2107441411677906,131187.6746330601,1675.0938990843242,132862.7685321444,1693,2,282.20512820512823,37,2,20,34.63812033964822,0.6303490990990991,43.88706140350877,1024.4517543859643,27.68788525367471,0
2173,4,0,0,39,0.0,0.0,1.0,39,1550,1300,250,0.8387096774193549,18,13,5,364.65246555502387,0.4413517768780926,0.21795694853687575,0.21326920795226847,131271.93583602633,1773.7270121575687,133045.66284818389,1694,3,283.20512820512823,37,2,20,34.46260432270488,0.6311936936936937,43.8048245614035,1024.7807017543848,27.69677572309148,0
2174,4,0,0,39,0.0,0.0,1.0,39,1350,1000,350,0.7407407407407407,17,10,7,365.24603604201866,0.4404520917678812,0.21839935108827935,0.21425257165763764,131385.84530476414,1797.6438608491226,133183.48916561325,1695,4,284.20512820512823,36,3,21,34.332207454598695,0.6342592592592593,43.69369369369369,1025.2252252252247,28.478478478478465,0
2175,4,0,0,39,0.0,0.0,1.0,39,1300,1000,300,0.7692307692307693,16,10,6,368.48495218219534,0.4397773279352227,0.21693827577471914,0.21713440584604143,131559.0823086601,1895.5084307280295,133454.5907393881,1696,5,285.20512820512823,36,3,20,34.07404866447128,0.6359953703703703,43.52477477477478,1025.9009009009014,28.497247247247262,0
2176,4,0,0,39,0.0,0.0,1.0,39,1050,700,350,0.6666666666666666,14,7,7,376.47246806508593,0.43929937022042287,0.2153285311180051,0.2078412153883853,129024.94454089513,1962.312900597682,130987.25744149281,1697,6,286.20512820512823,35,4,18,36.4448051948052,0.6125,46.00694444444445,1015.9722222222229,29.027777777777796,8
2177,4,0,0,39,0.0,0.0,1.0,39,1400,1100,300,0.7857142857142857,17,11,6,376.9179427018921,0.43904633378317587,0.21742608715963319,0.20870702224514598,129142.56071030519,1935.2296596364863,131077.79036994168,1698,7,287.20512820512823,35,4,18,36.313387231458286,0.6136904761904762,45.8912037037037,1016.435185185185,29.041005291005284,0
2178,4,1,1,39,0.025,0.025,0.975,40,1050,700,350,0.6666666666666666,14,7,7,365.5765706564092,0.4420138888888889,0.20692559663079035,0.2039783633140331,129443.5657596372,1464.33376462725,130907.89952426446,1699,0,281.0,34,6,15,36.29479605365777,0.6188725490196079,45.595238095238095,1017.6190476190478,29.929971988795526,0
2179,4,1,0,40,0.025,0.0,1.0,40,1050,600,450,0.5714285714285714,15,6,9,370.56520589119265,0.4408386752136752,0.22435732647814932,0.20836379973829355,129746.60572562364,1615.915532879826,131362.52125850346,1700,0,281.975,34,6,18,35.85923502375945,0.6219362745098039,45.29761904761905,1018.8095238095242,29.96498599439777,0
2180,4,0,0,40,0.0,0.0,1.0,40,800,400,400,0.5,12,4,8,369.8046866324361,0.44065170940170945,0.22368559411146127,0.20809719348369604,129776.92920918352,1598.4233276643772,131375.3525368479,1701,1,282.975,34,6,18,35.84774311640767,0.6222426470588236,45.26785714285713,1018.9285714285702,29.968487394957947,0
2181,4,0,0,40,0.0,0.0,1.0,40,1200,1000,200,0.8333333333333334,14,10,4,369.6750284340389,0.44054487179487184,0.2236570127291837,0.20867022204882468,129898.25857426283,1604.0284863945317,131502.28706065737,1702,2,283.975,34,6,18,35.72759741523608,0.623468137254902,45.14880952380951,1019.4047619047602,29.98249299719883,0
2182,4,0,1,39,0.0,0.025,0.975,40,1050,900,150,0.8571428571428571,12,9,3,369.05467186605625,0.44019764957264956,0.22791817439010154,0.20896836575522157,130019.64462868469,1596.8714569160857,131616.51608560077,1703,3,284.975,34,6,18,35.619966149177074,0.6246936274509804,45.0297619047619,1019.8809523809515,29.99649859943975,0
2183,4,1,0,40,0.025,0.0,1.0,40,1350,900,450,0.6666666666666666,18,9,9,367.21248612637856,0.43838141025641025,0.23910585217999603,0.20971695778908592,130353.74858276614,1573.5048185940689,131927.2534013602,1704,0,285.375,34,6,19,35.327533613118824,0.6280637254901961,44.702380952380935,1021.1904761904738,30.035014005602168,0
2184,4,0,1,39,0.0,0.025,0.975,40,600,300,300,0.5,9,3,6,365.2990366277079,0.438261217948718,0.23837412587412565,0.20895104895104874,130414.54081632638,1528.0612244897736,131942.60204081616,1705,1,286.375,34,6,19,35.314685314685306,0.6286764705882353,44.64285714285713,1021.4285714285702,30.042016806722653,0
2185,4,0,0,39,0.0,0.0,1.0,39,1200,800,400,0.6666666666666666,16,8,8,370.88400425875267,0.4367408906882591,0.24453713273291044,0.2123412815591317,130450.30757400978,1876.38648596691,132326.6940599767,1706,2,293.56410256410254,33,6,20,35.135756557901466,0.6313131313131313,44.60784313725489,1021.5686274509787,30.956625074272083,0
2186,4,1,1,39,0.025,0.025,0.975,40,800,500,300,0.625,11,5,6,358.4240807917257,0.43723290598290593,0.23567978116633714,0.20679793674155203,130749.15143140565,1372.7288832199242,132121.88031462557,1707,0,287.2,34,6,19,35.151127148566346,0.632046568627451,44.315476190476176,1022.7380952380933,30.080532212885096,0
2187,4,1,0,40,0.025,0.0,1.0,40,1200,1000,200,0.8333333333333334,14,10,4,359.1815516969665,0.43604433760683764,0.2496540295383185,0.20854842424322842,130992.77388038543,1410.0375566893358,132402.81143707476,1708,0,288.1,34,6,20,34.885112609993406,0.6344975490196079,44.07738095238095,1023.6904761904758,30.108543417366935,0
2188,4,0,0,40,0.0,0.0,1.0,40,1150,800,350,0.6956521739130435,15,8,7,354.6624330720079,0.4355101495726496,0.2493491399349137,0.20674224757124376,131145.15306122453,1302.4518140589614,132447.6048752835,1709,1,289.1,34,6,21,34.846679838834646,0.6360294117647058,43.92857142857143,1024.2857142857147,30.126050420168077,0
2189,4,0,0,40,0.0,0.0,1.0,40,1250,900,350,0.72,16,9,7,338.19370353435266,0.4349893162393162,0.18981481481481488,0.18262459990855068,128144.53125000013,667.5347222222376,128812.06597222236,1710,2,290.1,38,2,18,38.314471879286714,0.5978618421052632,46.87500000000001,1012.500000000001,26.64473684210529,8
2190,4,1,1,40,0.024390243902439025,0.024390243902439025,0.975609756097561,41,1800,1500,300,0.8333333333333334,21,15,6,330.4396645434152,0.43630589430894307,0.18727158412592604,0.18045378652042846,128593.16541883706,298.4564887153034,128891.62190755237,1711,0,284.0,39,2,16,38.053408818595734,0.6006944444444444,46.43229166666668,1014.2708333333354,26.006944444444496,0
2191,4,0,0,40,0.0,0.0,1.0,40,1400,1100,300,0.7857142857142857,17,11,6,333.10105309255016,0.43393429487179486,0.1766750948166873,0.1817123675835912,128550.50131492438,564.0614727153123,129114.56278763969,1712,4,292.1,38,2,16,38.02939317319847,0.6019736842105263,46.47435897435897,1014.102564102564,26.68690958164642,0
2192,4,1,0,41,0.024390243902439025,0.0,1.0,41,1150,700,450,0.6086956521739131,16,7,9,326.97363129710135,0.43559451219512196,0.14188050430842636,0.18059460926794646,129042.58355034752,377.208084216833,129419.79163456436,1713,0,285.9512195121951,39,2,15,37.684112500854376,0.6052350427350428,45.98958333333335,1016.0416666666691,26.05235042735049,8
2193,4,3,2,42,0.06818181818181818,0.045454545454545456,0.9545454545454546,44,1250,900,350,0.72,16,9,7,308.1703405388903,0.44191552149400987,0.1400353225506601,0.17321298450979025,129731.44531250026,-804.0256076388594,128927.4197048614,1714,0,267.3863636363636,41,3,12,37.46378663940015,0.6089939024390244,45.312500000000014,1018.750000000002,24.847560975609806,0
2194,4,0,0,42,0.0,0.0,1.0,42,1350,900,450,0.6666666666666666,18,9,9,320.7341002735379,0.43667731320170344,0.13942096797777448,0.17906126626699825,129466.2814670141,-95.14973958330933,129371.13172743078,1715,1,281.1190476190476,39,3,13,37.41257250085297,0.6095085470085471,45.57291666666668,1017.7083333333351,26.095085470085515,0
2195,4,0,0,42,0.0,0.0,1.0,42,1350,800,550,0.5925925925925926,19,8,11,321.47937030062593,0.43503193960511033,0.14009040604785294,0.18020540848961697,129625.34722222232,-65.62499999998948,129559.72222222234,1716,2,282.1190476190476,39,3,14,37.232337697763214,0.6111111111111112,45.41666666666667,1018.3333333333342,26.111111111111132,0
2196,4,0,0,42,0.0,0.0,1.0,42,1050,900,150,0.8571428571428571,12,9,3,354.3526912850675,0.43543118466898956,0.09006027124707039,0.19244537530925288,128372.67324334457,767.632116914202,129140.30536025878,1717,3,283.1190476190476,36,6,16,37.67224136015114,0.6038773148148149,46.64977477477477,1013.4009009008998,28.150025025024995,8
2197,4,0,0,42,0.0,0.0,1.0,42,1350,800,550,0.5925925925925926,19,8,11,355.1510805428906,0.43451171118854043,0.09056079955580221,0.1937089933548593,128543.91289515857,730.5019123853474,129274.41480754392,1718,4,284.1190476190476,36,6,16,37.47709605774569,0.6056134259259259,46.48085585585585,1014.0765765765758,28.16879379379377,0
2198,4,2,2,42,0.045454545454545456,0.045454545454545456,0.9545454545454546,44,1550,1200,350,0.7741935483870968,19,12,7,340.38483245162615,0.4389314658210007,0.11036429077820786,0.18851213146075096,129149.73416121342,-7.877875272671304,129141.85628594075,1719,0,272.15909090909093,40,4,19,37.23442811437711,0.6046875,45.884146341463406,1016.4634146341451,25.41158536585363,0
2199,4,0,0,42,0.0,0.0,1.0,42,1150,800,350,0.6956521739130435,15,8,7,339.29661094674384,0.4363748548199768,0.13324276857953454,0.18828488900175858,129228.54487407763,369.3717905179248,129597.91666459556,1720,1,282.85714285714283,38,4,19,37.1819288291128,0.6088267543859649,45.806623931623925,1016.7735042735036,26.757197480881672,0
2200,4,2,0,44,0.045454545454545456,0.0,1.0,44,1100,700,400,0.6363636363636364,15,7,8,324.9557004249292,0.4387773079633545,0.1449305580737572,0.1830705485315274,129822.05119307282,-362.71688479080717,129459.33430828202,1721,0,270.95454545454544,40,4,18,36.94447214466162,0.6114583333333333,45.22357723577235,1019.1056910569099,25.47764227642275,0
2201,4,0,3,41,0.0,0.06818181818181818,0.9318181818181819,44,1200,1000,200,0.8333333333333334,14,10,4,322.9390866668483,0.438468992248062,0.1491967942537178,0.1824543701855523,129933.65698420547,-407.8686972474409,129525.78828695804,1722,1,271.95454545454544,41,3,18,36.88282491648017,0.6110264227642277,45.11408730158729,1019.5436507936488,24.866918312040216,0
2202,4,0,1,40,0.0,0.024390243902439025,0.975609756097561,41,1200,800,400,0.6666666666666666,16,8,8,342.0681280721259,0.4357469512195122,0.1493499516492962,0.19206581466664593,129690.63321827743,672.6064266929644,130363.2396449704,1723,2,284.6341463414634,38,3,18,36.64188693098385,0.6134868421052632,45.3525641025641,1018.5897435897434,26.80499325236167,0
2203,4,0,0,40,0.0,0.0,1.0,40,900,300,600,0.3333333333333333,15,3,12,349.4473696990002,0.43490918803418804,0.14613569630872525,0.19648172862321134,129745.0507706917,1067.813344656284,130812.86411534798,1724,3,284.525,38,2,18,36.39869092561521,0.6140350877192983,45.299145299145295,1018.803418803418,26.810616284300476,0
2204,4,2,0,42,0.047619047619047616,0.0,1.0,42,1700,1400,300,0.8235294117647058,20,14,6,336.20389122040376,0.43781455671699576,0.15295579895906175,0.19261026665243736,130475.34722222252,374.2940271386128,130849.64124936114,1725,0,271.92857142857144,39,3,20,35.99612561174553,0.6196581196581197,44.58333333333335,1021.666666666669,26.196581196581256,0
2205,4,0,1,41,0.0,0.023809523809523808,0.9761904761904762,42,1250,1000,250,0.8,15,10,5,337.05482549987136,0.43722173828881145,0.15344336183469198,0.1937198534215834,130599.97046235722,403.870050895645,131003.84051325286,1726,1,272.92857142857144,40,2,15,35.848329687810704,0.6192708333333333,44.461382113821145,1022.1544715447167,25.553861788617915,0
2206,4,0,2,39,0.0,0.04878048780487805,0.9512195121951219,41,1300,900,400,0.6923076923076923,17,9,8,337.2166678226341,0.4361280487804878,0.1590197203530248,0.19465787544682223,130768.17626953134,619.441731770848,131387.61800130218,1727,2,277.6829268292683,39,2,15,35.674139423566565,0.6225961538461539,44.29687500000001,1022.8125000000007,26.225961538461554,0
2207,4,0,0,39,0.0,0.0,1.0,39,750,400,350,0.5333333333333333,11,4,7,344.09566782146146,0.43336707152496623,0.16817455801051806,0.19847744550221227,130738.73842191831,1197.326701485072,131936.0651234034,1728,3,291.3076923076923,37,2,15,35.528014545584504,0.6258445945945945,44.32565789473684,1022.6973684210529,27.640469416785216,0
2208,4,0,0,39,0.0,0.0,1.0,39,1150,600,550,0.5217391304347826,17,6,11,343.0977301264005,0.433310841205578,0.16516887899524613,0.19833344622548416,130822.8553497229,1177.0049438288631,131999.86029355176,1729,4,292.3076923076923,37,2,15,35.46847088245803,0.6266891891891893,44.243421052631575,1023.0263157894728,27.649359886201967,0
2209,4,0,1,38,0.0,0.02564102564102564,0.9743589743589743,39,1050,800,250,0.7619047619047619,13,8,5,341.3573031474733,0.43314215024741337,0.16508831359361786,0.1977583929407429,130906.99932912046,1137.2120508233288,132044.2113799438,1730,5,293.3076923076923,37,2,16,35.42793939069252,0.6275337837837838,44.161184210526315,1023.3552631578943,27.658250355618765,0
2210,4,0,0,38,0.0,0.0,1.0,38,1350,1100,250,0.8148148148148148,16,11,5,348.4867585504602,0.43133594120436225,0.17136112157112637,0.2015278294991044,130838.01442912505,1519.0631087168222,132357.07753784186,1731,6,301.7894736842105,36,2,16,35.3153091175931,0.6287615740740741,44.2286036036036,1023.0855855855854,28.41904404404404,0
2211,4,1,0,39,0.02564102564102564,0.0,1.0,39,1150,1000,150,0.8695652173913043,13,10,3,339.6432777894303,0.4320737741790373,0.1662645244702845,0.19791689693269293,131131.51552641194,1107.5875509772234,132239.10307738915,1732,0,295.02564102564105,37,2,17,35.2450442493666,0.6297860360360361,43.94188596491228,1024.2324561403507,27.681958274063533,0
2212,4,1,0,40,0.025,0.0,1.0,40,900,700,200,0.7777777777777778,11,7,4,331.6764090210154,0.4338675213675214,0.16879622877383027,0.1949639834778154,131465.04635336765,720.7708972532612,132185.81725062092,1733,0,288.625,38,2,18,35.11281557106641,0.6313048245614035,43.61645299145299,1025.534188034188,26.987741790373367,0
2213,4,0,0,40,0.0,0.0,1.0,40,1300,1100,200,0.8461538461538461,15,11,4,335.28065409369736,0.4338141025641025,0.17579654310703896,0.19779087235355466,131602.03904594926,824.723546278034,132426.7625922273,1734,1,289.625,38,2,14,34.882384076079425,0.6326754385964912,43.48290598290598,1026.0683760683758,27.001799370220414,0
2214,4,0,1,39,0.0,0.025,0.975,40,1100,1000,100,0.9090909090909091,12,10,2,354.1682762883411,0.4329727564102564,0.12791805094130693,0.19668754827083165,129258.63997443409,1232.2833625945873,130490.92333702868,1735,2,290.625,36,4,18,36.77325581395349,0.6128472222222222,45.77702702702704,1016.8918918918935,28.24699699699704,8
2215,4,1,1,39,0.025,0.025,0.975,40,900,500,400,0.5555555555555556,13,5,8,359.26457957457444,0.43398771367521366,0.1393260292164673,0.20038979882937397,129430.4693206722,1299.9566289262466,130730.42594959844,1736,0,291.525,36,4,15,36.468708499336,0.6145833333333333,45.60810810810812,1017.5675675675691,28.265765765765806,0
2216,4,2,1,40,0.04878048780487805,0.024390243902439025,0.975609756097561,41,1200,800,400,0.6666666666666666,16,8,8,407.89971012218706,0.4370172764227642,0.18682880238544453,0.21247313258603506,126688.35521449723,2216.308486491067,128904.6637009883,1737,0,285.3658536585366,38,3,19,38.051177968799735,0.5830592105263157,48.3173076923077,1006.7307692307709,26.492914979757128,8
2217,4,3,1,42,0.06976744186046512,0.023255813953488372,0.9767441860465116,43,700,300,400,0.42857142857142855,11,3,8,392.2946229272958,0.4437523071244001,0.19020452657807296,0.2072499894710244,127262.39753266798,1387.4390622831604,128649.83659495114,1738,0,272.93023255813955,36,7,23,37.85202752976191,0.5925925925925926,47.74774774774776,1009.0090090090105,28.028028028028068,0
2218,4,1,2,41,0.023255813953488372,0.046511627906976744,0.9534883720930233,43,600,400,200,0.6666666666666666,8,4,4,387.34787241883083,0.4455518641565153,0.1926816521196848,0.20587774107616008,127506.962779413,1277.910150238547,128784.87292965155,1739,0,272.27906976744185,37,6,17,37.72516103933701,0.5931869369369369,47.505482456140356,1009.9780701754395,27.296704599336202,0
2219,4,3,0,44,0.06818181818181818,0.0,1.0,44,1550,1300,250,0.8387096774193549,18,13,5,381.04350589504145,0.44339103241719524,0.19131507217444654,0.20507068680896806,128009.35057345337,955.4263459712386,128964.7769194246,1740,0,266.97727272727275,38,6,22,37.36847198761261,0.5964912280701755,47.00854700854702,1011.9658119658138,26.63067926225826,0
2220,4,2,1,45,0.043478260869565216,0.021739130434782608,0.9782608695652174,46,1500,1100,400,0.7333333333333333,19,11,8,360.03130303088017,0.44739331723027376,0.17884507615018808,0.19715143245919578,128701.77636584785,67.69034554685871,128769.4667113947,1741,0,256.32608695652175,35,11,18,37.1921457359036,0.6092261904761904,46.32523148148148,1014.6990740740736,28.991402116402103,0
2221,4,1,4,42,0.021739130434782608,0.08695652173913043,0.9130434782608696,46,1000,500,500,0.5,15,5,10,363.81380757835973,0.4475342190016103,0.18758831898526562,0.19986480653984834,128829.565946859,173.99498315883127,129003.56093001783,1742,0,257.30434782608694,36,10,19,36.96570530597152,0.6085069444444444,46.19932432432432,1015.2027027027026,28.200075075075073,0
2222,4,0,1,41,0.0,0.023809523809523808,0.9761904761904762,42,1500,1100,400,0.7333333333333333,19,11,8,383.99082702361983,0.4440572977158343,0.17794059228673298,0.20829483293805132,128325.3985969386,1455.1551870748112,129780.5537840134,1743,1,279.3333333333333,34,8,22,36.9698037833392,0.6075367647058824,46.69642857142856,1013.2142857142843,29.800420168067184,0
2223,4,2,2,41,0.046511627906976744,0.046511627906976744,0.9534883720930233,43,1100,700,400,0.6363636363636364,15,7,8,374.4427787796327,0.44721299372462164,0.18591922781151426,0.20549832101986082,128789.87295310342,1044.88758144717,129834.76053455059,1744,0,273.3720930232558,35,8,21,36.736507031546935,0.6101190476190477,46.23842592592592,1015.0462962962952,29.001322751322718,0
2224,4,1,1,41,0.023809523809523808,0.023809523809523808,0.9761904761904762,42,900,700,200,0.7777777777777778,11,7,4,367.9382452826749,0.4475900116144019,0.17746624791846388,0.20328067056869703,129054.34355977768,1096.8057430983943,130151.14930287607,1745,0,250.42857142857142,35,7,22,36.63156870562329,0.612797619047619,45.978009259259245,1016.0879629629608,29.031084656084595,0
2225,4,1,0,42,0.023809523809523808,0.0,1.0,42,800,500,300,0.625,11,5,6,366.1803234792618,0.44784407665505227,0.1843150421552251,0.2032239561142098,129232.5386419887,1064.650009782269,130297.18865177098,1746,0,251.26190476190476,33,9,23,36.494490980675735,0.6190025252525253,45.802696078431374,1016.7892156862749,30.811794414735605,0
2226,4,1,0,43,0.023255813953488372,0.0,1.0,43,1100,600,500,0.5454545454545454,16,6,10,357.77547512735407,0.4492201919527501,0.1947664509582685,0.2009433284362373,129701.96926708233,680.8367358967577,130382.80600297908,1747,0,246.3953488372093,35,8,18,36.230376282998144,0.6193452380952381,45.341435185185176,1018.634259259258,29.103835978835942,0
2227,4,1,0,44,0.022727272727272728,0.0,1.0,44,1100,600,500,0.5454545454545454,16,6,10,353.67177383276993,0.4501189217758985,0.19771999558352604,0.20032553193267041,130032.7708409424,397.7841439412448,130430.55498488364,1748,0,241.77272727272728,36,8,19,35.998859077693105,0.6206597222222222,45.016891891891895,1019.9324324324333,28.33145645645648,0
2228,4,0,4,40,0.0,0.09090909090909091,0.9090909090909091,44,750,600,150,0.8,9,6,3,353.67177383276993,0.4501189217758985,0.19771999558352604,0.20032553193267041,130032.7708409424,397.7841439412448,130430.55498488364,1749,1,242.77272727272728,36,8,19,35.998859077693105,0.6206597222222222,45.016891891891895,1019.9324324324333,28.33145645645648,0
2229,4,0,0,40,0.0,0.0,1.0,40,850,600,250,0.7058823529411765,11,6,5,377.9251712532589,0.4432825854700855,0.20673609438959772,0.21124135076915007,129513.05537533647,1789.2487264513727,131302.30410178783,1750,2,266.175,33,7,19,35.90978409182117,0.6218434343434344,45.52696078431373,1017.8921568627455,30.84521687462865,0
2230,4,0,0,40,0.0,0.0,1.0,40,1350,1100,250,0.8148148148148148,16,11,5,376.9046393742802,0.44285523504273505,0.20310709692505502,0.21111102688724429,129595.04145408176,1768.9944727891261,131364.03592687089,1751,3,267.175,34,6,20,35.85218636735647,0.6204044117647058,45.44642857142858,1018.2142857142868,29.94747899159667,0
2231,4,0,1,39,0.0,0.025,0.975,40,1250,900,350,0.72,16,9,7,378.12517997581125,0.4422275641025641,0.21123353021353974,0.21285256294802068,129790.4074502744,1815.40423525378,131605.8116855282,1752,4,268.175,35,5,20,35.622065727699535,0.6202380952380953,45.25462962962963,1018.9814814814819,29.113756613756625,0
2232,4,0,1,38,0.0,0.02564102564102564,0.9743589743589743,39,850,600,250,0.7058823529411765,11,6,5,385.77948957023983,0.44073324336482234,0.2127162225338941,0.21658328823904022,129685.96938775519,2206.0374149659947,131892.00680272118,1753,5,275.7692307692308,34,5,20,35.53354371201496,0.6213235294117647,45.35714285714286,1018.5714285714292,29.95798319327733,0
2233,4,1,0,39,0.02564102564102564,0.0,1.0,39,1600,1200,400,0.75,20,12,8,380.91071189198885,0.4385964912280702,0.2143537060651235,0.2155139470321516,129989.29280045342,2102.8628117913704,132092.1556122448,1754,0,276.35897435897436,34,5,21,35.34856798194412,0.6243872549019608,45.0595238095238,1019.7619047619039,29.992997198879525,0
2234,4,1,0,40,0.025,0.0,1.0,40,850,500,350,0.5882352941176471,12,5,7,353.02767037456533,0.44135950854700856,0.0690593511239066,0.19619648560939654,129287.27027280637,1255.49781545194,130542.76808825831,1755,0,270.425,36,4,20,36.77310559923227,0.6131365740740741,45.74887387387386,1017.0045045045027,28.250125125125077,8
2235,4,1,2,39,0.024390243902439025,0.04878048780487805,0.9512195121951219,41,950,700,250,0.7368421052631579,12,7,5,319.6061858881523,0.44217479674796745,-0.00021416298776810727,0.17934452379457252,129666.74619109007,88.4588373322872,129755.20502842237,1756,0,264.8048780487805,40,1,15,37.23807623228896,0.6098958333333333,45.37601626016261,1018.4959349593505,25.462398373983763,8
2236,4,0,1,38,0.0,0.02564102564102564,0.9743589743589743,39,950,900,50,0.9473684210526315,10,9,1,375.1706952870426,0.4380623031938822,0.05542650556771789,0.19872390223317116,127368.57133925824,1813.3940488301084,129181.96538808834,1757,1,279.3076923076923,37,2,15,38.174831631544656,0.5917792792792793,47.64254385964912,1009.4298245614036,27.281887150308204,8
2237,4,2,0,40,0.05,0.0,1.0,40,1000,700,300,0.7,13,7,6,360.18504050921194,0.44134615384615383,0.07212241326057911,0.19360693406009805,127960.02739800341,1217.8575303819391,129177.88492838535,1758,0,272.05,39,1,17,37.946673701911536,0.594284188034188,47.057291666666664,1011.7708333333328,25.942841880341867,0
2238,4,0,0,40,0.0,0.0,1.0,40,1350,900,450,0.6666666666666666,18,9,9,364.4571524947539,0.44134615384615383,0.07317863757974874,0.1965479804630424,128091.8023003474,1336.7947048611304,129428.59700520852,1759,1,273.05,39,1,17,37.70365987514578,0.5956196581196581,46.92708333333334,1012.2916666666681,25.956196581196618,0
2239,4,1,0,41,0.024390243902439025,0.0,1.0,41,1450,1000,450,0.6896551724137931,19,10,9,371.61051733047236,0.443140243902439,0.16620921963695312,0.18870092503404537,125641.8474687708,1183.1378282174824,126824.98529698828,1760,0,267.3658536585366,38,3,16,40.044890238704184,0.5723684210526316,49.35897435897437,1002.5641025641046,26.38326585695012,8
2240,4,3,3,41,0.06818181818181818,0.06818181818181818,0.9318181818181819,44,1350,1000,350,0.7407407407407407,17,10,7,352.67262394267544,0.44989869626497536,0.17792675596386243,0.1820495006831958,126317.93986402446,109.77586057572682,126427.71572460019,1761,0,250.0681818181818,41,3,14,39.822342017829534,0.5744410569105691,48.68551587301588,1005.2579365079376,24.518486256291162,0
2241,4,2,2,41,0.046511627906976744,0.046511627906976744,0.9534883720930233,43,1200,600,600,0.5,18,6,12,380.0413102339447,0.450281469176818,0.28271234185156113,0.18728279319075875,124393.09956114973,877.4732447956121,125270.57280594535,1762,0,256.3488372093023,35,8,16,41.12969892098852,0.5651785714285714,50.60763888888889,997.5694444444448,28.501984126984137,8
2242,4,4,1,44,0.08888888888888889,0.022222222222222223,0.9777777777777777,45,950,700,250,0.7368421052631579,12,7,5,352.2083113224362,0.4566919191919192,0.2750502440424927,0.17863283071686623,125591.91528944479,-150.14291987652356,125441.77236956827,1763,0,230.46666666666667,36,9,17,40.58275287420891,0.5755208333333333,49.40878378378378,1002.3648648648643,27.843468468468455,0
2243,4,2,1,45,0.043478260869565216,0.021739130434782608,0.9782608695652174,46,1500,800,700,0.5333333333333333,22,8,14,348.4662657819792,0.4590780998389694,0.2750283956575359,0.17892749709323402,126100.38406227184,-410.8423879960943,125689.54167427575,1764,0,226.08695652173913,36,10,20,40.1521097282954,0.5807291666666667,48.90202702702703,1004.3918918918928,27.899774774774798,0
2244,4,1,1,45,0.021739130434782608,0.021739130434782608,0.9782608695652174,46,1500,1100,400,0.7333333333333333,19,11,8,348.37780155479624,0.45714573268921094,0.2748355014830428,0.17987094473566625,126326.6999051418,-398.11640187483295,125928.58350326696,1765,0,227.0,36,10,16,39.92125947500093,0.5830439814814814,48.67680180180181,1005.2927927927942,27.92479979979984,0
2245,4,2,2,45,0.0425531914893617,0.0425531914893617,0.9574468085106383,47,1350,900,450,0.6666666666666666,18,9,9,344.3512934540679,0.4596053037311132,0.27795550099028254,0.1798104963260722,126788.14785559008,-668.0674582563979,126120.08039733369,1766,0,223.04255319148936,37,10,18,39.54806296497913,0.5858671171171171,48.21820175438596,1007.1271929824554,27.219653864390686,0
2246,4,2,1,46,0.0425531914893617,0.02127659574468085,0.9787234042553191,47,1350,1000,350,0.7407407407407407,17,10,7,345.5987781494445,0.46164816527906255,0.2990191771446542,0.18256027305001093,127257.91229032016,-603.9642005232314,126653.94808979693,1767,0,223.0,37,10,20,39.03453959284213,0.5906531531531531,47.752192982456144,1008.9912280701759,27.270033191085837,0
2247,4,2,2,46,0.041666666666666664,0.041666666666666664,0.9583333333333334,48,1500,1100,400,0.7333333333333333,19,11,8,341.25558507426615,0.46241504137115835,0.3115270146520146,0.18267210730446035,127793.20987654335,-877.9706790123316,126915.23919753102,1768,0,219.22916666666666,38,10,16,38.59603937728938,0.5942982456140351,47.22222222222223,1011.1111111111122,26.608187134502952,0
2248,4,0,1,45,0.0,0.021739130434782608,0.9782608695652174,46,950,700,250,0.7368421052631579,12,7,5,356.68450655358197,0.46087962962962964,0.3197067835395413,0.1894992094059552,127489.7532667803,-105.27605308010874,127384.4772137002,1769,1,229.6304347826087,36,10,16,38.5170420755278,0.5949074074074074,47.52252252252252,1009.9099099099101,28.05305305305306,0
2249,4,1,0,46,0.021739130434782608,0.0,1.0,46,1650,1100,550,0.6666666666666666,22,11,11,353.25618751987696,0.4601449275362319,0.31633256002053556,0.18887318614448695,127745.77100326675,-174.60319271975104,127571.167810547,1770,0,230.54347826086956,36,10,18,38.34127028331663,0.5975115740740741,47.26914414414414,1010.9234234234232,28.0812062062062,0
2250,4,0,1,45,0.0,0.021739130434782608,0.9782608695652174,46,1800,1200,600,0.6666666666666666,24,12,12,396.6793612525227,0.45988325281803544,0.3704584209244204,0.20314536045440043,125991.54188368063,820.2004501334203,126811.74233381405,1771,1,231.54347826086956,39,7,19,39.05417790689631,0.5742521367521367,49.01041666666667,1003.958333333334,25.742521367521388,8
2251,4,1,1,45,0.021739130434782608,0.021739130434782608,0.9782608695652174,46,1500,1100,400,0.7333333333333333,19,11,8,397.79655164344,0.46119162640901773,0.37512394459301035,0.20484398940500284,126218.23157793212,841.8788580246899,127060.11043595681,1772,0,232.3913043478261,35,11,20,38.791465100207326,0.5839285714285714,48.78472222222222,1004.8611111111113,28.710317460317466,0
2252,4,3,1,47,0.0625,0.020833333333333332,0.9791666666666666,48,1300,900,400,0.6923076923076923,17,9,8,384.235819643021,0.4649730348699764,0.3719770895205774,0.2008079438799555,126822.83676674686,145.9753269047954,126968.81209365165,1773,0,223.45833333333334,38,10,21,38.50807877245085,0.5844298245614035,48.183760683760674,1007.2649572649559,26.506972559604105,0
2253,4,2,0,49,0.04081632653061224,0.0,1.0,49,1950,1500,450,0.7692307692307693,24,15,9,382.9566986673659,0.4644451530612245,0.3864497127895943,0.2031667894604268,127432.059259059,-38.0957152181096,127393.96354384089,1774,0,219.85714285714286,33,16,19,37.913050734312414,0.6006944444444444,47.5796568627451,1009.6813725490193,30.59640522875816,0
2254,4,1,2,48,0.02,0.04,0.96,50,800,400,400,0.5,12,4,8,354.53904638017065,0.4643622448979592,0.3300705092333518,0.18406777335309865,126553.21865361999,-991.3246207534278,125561.89403286656,1775,0,216.44,36,14,19,39.53320276067898,0.5853587962962963,48.451576576576585,1006.193693693695,27.94982482482486,8
2255,4,1,1,48,0.02040816326530612,0.02040816326530612,0.9795918367346939,49,1350,700,650,0.5185185185185185,20,7,13,362.55770087945604,0.4627621882086168,0.3489871454787006,0.18944567919673974,126815.7570117729,-604.3941405047678,126211.36287126814,1776,0,221.75510204081633,37,12,21,39.061252630815005,0.5861486486486487,48.19078947368421,1007.2368421052636,27.222617354196313,0
2256,4,0,1,47,0.0,0.020833333333333332,0.9791666666666666,48,1600,1100,500,0.6875,21,11,10,366.23024813772463,0.4609929078014185,0.3567099869573318,0.191462862045117,126836.65242522952,-309.71626186995576,126526.93616335957,1777,1,227.29166666666666,36,12,21,38.94727035587852,0.5882523148148149,48.17004504504506,1007.3198198198218,27.98110610610616,0
2257,4,4,3,48,0.0784313725490196,0.058823529411764705,0.9411764705882353,51,1100,500,600,0.45454545454545453,17,5,12,345.44173009362385,0.4648202614379085,0.3544177167357976,0.18469508106316043,127745.77100326685,-1373.4855632659585,126372.2854400009,1778,0,214.5686274509804,36,15,19,38.53876573465524,0.5975115740740741,47.26914414414415,1010.9234234234241,28.081206206206225,0
2258,4,0,0,48,0.0,0.0,1.0,48,1800,1600,200,0.8888888888888888,20,16,4,372.50254859827925,0.4604850029550827,0.37498771474623616,0.19727976949186796,127362.24666950102,-111.44770408164459,127250.79896541938,1779,1,228.97916666666666,34,14,19,38.24866336439047,0.5977328431372548,47.64880952380952,1009.404761904761,29.68837535014003,0
2259,4,0,0,48,0.0,0.0,1.0,48,1700,1100,600,0.6470588235294118,23,11,12,372.4414810875252,0.46022643321513,0.3697331728932691,0.19792474811021593,127500.81045310361,-102.68186299725295,127398.12859010635,1780,2,229.97916666666666,35,13,19,38.10785774314309,0.5970238095238095,47.511574074074076,1009.953703703704,28.855820105820115,0
2260,4,1,0,49,0.02040816326530612,0.0,1.0,49,1250,700,550,0.56,18,7,11,356.99076629965316,0.461203231292517,0.3032968894643544,0.18272076703015597,125969.13309594642,-806.0365291950393,125163.09656675138,1781,0,226.26530612244898,41,8,16,40.073438580887434,0.5708841463414633,49.03273809523808,1003.8690476190452,24.484610917537687,8
2261,4,2,1,50,0.0392156862745098,0.0196078431372549,0.9803921568627451,51,1250,700,550,0.56,18,7,11,344.82943818780836,0.46251633986928103,0.3013395533790557,0.17854345476751768,126442.63058232538,-1479.7274581128884,124962.90312421249,1782,0,218.35294117647058,41,10,16,39.89116854080359,0.5757113821138211,48.56150793650793,1005.7539682539671,24.53058459156017,0
2262,4,4,0,54,0.07407407407407407,0.0,1.0,54,1400,900,500,0.6428571428571429,19,9,10,334.1380023652009,0.46624592359655254,0.325471749653085,0.17632845594456278,127217.08598080419,-2293.3975615709455,124923.68841923324,1783,0,207.14814814814815,41,13,21,39.36545301078441,0.5835873983739837,47.79265873015872,1008.8293650793637,24.605594270228384,0
2263,4,2,4,52,0.03571428571428571,0.07142857142857142,0.9285714285714286,56,1550,1100,450,0.7096774193548387,20,11,9,326.6241681220067,0.46551677489177484,0.339197417818881,0.17494176263170352,127816.61629801086,-2850.4008058985046,124966.21549211236,1784,0,200.71428571428572,44,12,18,38.9419848609712,0.5854640151515151,47.19907407407407,1011.2037037037028,22.981902356902335,0
2264,4,0,1,51,0.0,0.019230769230769232,0.9807692307692307,52,1450,1100,350,0.7586206896551724,18,11,7,346.4561276203196,0.4640679989944696,0.3425494937282756,0.18407742062499224,127492.4611048122,-1565.8911249685139,125926.56997984368,1785,1,212.05769230769232,41,11,18,38.77251146037982,0.5863821138211383,47.519841269841265,1009.9206349206341,24.632210607820344,0
2265,4,2,2,51,0.03773584905660377,0.03773584905660377,0.9622641509433962,53,1750,1200,550,0.6857142857142857,23,12,11,345.99755696391503,0.46250604741170775,0.37037907049891095,0.18696492844378498,128171.57594601516,-1723.9364458801178,126447.63950013505,1786,0,208.67924528301887,38,15,21,38.089303298867556,0.5981359649122807,46.8482905982906,1012.6068376068384,26.647548358074697,0
2266,4,1,2,50,0.019230769230769232,0.038461538461538464,0.9615384615384616,52,1650,1100,550,0.6666666666666666,22,11,11,350.02343053352877,0.4625989819004525,0.36985056706634456,0.18965269533250972,128279.7832657609,-1419.8140386441587,126859.96922711674,1787,0,213.25,38,14,22,37.87681044786615,0.5992324561403508,46.741452991452995,1013.0341880341886,26.65879442195233,0
2267,4,0,2,48,0.0,0.04,0.96,50,950,600,350,0.631578947368421,13,6,7,367.8020230280938,0.46261904761904765,0.39197278911564615,0.1952682498811676,127461.32270361592,-602.0894129976596,126859.23329061826,1788,1,219.86,36,14,17,38.26553845581948,0.5946180555555556,47.550675675675684,1009.7972972972984,28.049924924924955,8
2268,4,0,1,47,0.0,0.020833333333333332,0.9791666666666666,48,2200,1700,500,0.7727272727272727,27,17,10,382.72257741241987,0.46137152777777773,0.40331398090298265,0.20329590633622757,127482.44224773231,158.08177437640347,127640.52402210872,1789,2,228.66666666666666,34,14,17,37.867155880388225,0.5989583333333333,47.5297619047619,1009.8809523809514,29.702380952380924,0
2269,4,0,0,47,0.0,0.0,1.0,47,1150,800,350,0.6956521739130435,15,8,7,387.20939181964343,0.461840888066605,0.3964918531370132,0.20573775615639445,127493.9344993511,473.369767637427,127967.30426698853,1790,3,231.5744680851064,33,14,17,37.74205699146543,0.6013257575757576,47.51838235294117,1009.9264705882343,30.603832442067706,0
2270,4,3,2,48,0.06,0.04,0.96,50,1050,600,450,0.5714285714285714,15,6,9,366.58292022735793,0.46493197278911563,0.3865288406624785,0.1989729365524192,128349.69142500438,-588.1832980200088,127761.50812698436,1791,0,218.62,35,15,21,37.38589853417097,0.6056547619047619,46.67245370370371,1013.3101851851859,28.951719576719597,0
2271,4,3,2,49,0.058823529411764705,0.0392156862745098,0.9607843137254902,51,1350,800,550,0.5925925925925926,19,8,11,358.7485092406055,0.4641176470588235,0.39638370318187155,0.19750879464785,128915.32368517188,-950.3639619348826,127964.959723237,1792,0,214.72549019607843,36,15,18,37.00677349005692,0.609375,46.11486486486488,1015.5405405405423,28.20945945945951,0
2272,4,2,0,51,0.0392156862745098,0.0,1.0,51,550,300,250,0.5454545454545454,8,3,5,355.7049439461022,0.4641503267973856,0.3989223833577753,0.1968263101847687,129115.53603857252,-1014.5930981657141,128100.9429404068,1793,0,215.45098039215685,36,15,20,36.87996306555864,0.611400462962963,45.9177927927928,1016.3288288288302,28.231356356356393,0
2273,4,1,0,52,0.019230769230769232,0.0,1.0,52,1300,800,500,0.6153846153846154,18,8,10,345.6938199812634,0.4648849924585219,0.3907900898216341,0.1926800532714814,129401.82317029867,-1453.2893535427302,127948.53381675594,1794,0,212.28846153846155,36,16,22,36.84306401033019,0.6142939814814814,45.63626126126126,1017.4549549549549,28.26263763763764,0
2274,4,0,4,48,0.0,0.07692307692307693,0.9230769230769231,52,1950,1300,650,0.6666666666666666,26,13,13,340.12583125792327,0.46524635495223726,0.3217021639952182,0.18145799423963316,127658.21468195271,-1716.0287228796803,125942.18595907303,1795,1,213.28846153846155,38,14,17,38.7626863304789,0.5929276315789473,47.35576923076923,1010.5769230769234,26.59412955465588,8
2275,4,0,0,48,0.0,0.0,1.0,48,1400,1000,400,0.7142857142857143,18,10,8,361.280235507414,0.4602449024822695,0.3785326917201348,0.19227157899443328,127559.26354595322,-383.0718449931593,127176.19170096006,1796,3,231.85416666666666,35,13,17,38.32970516345859,0.5976190476190476,47.453703703703695,1010.185185185184,28.86243386243383,0
2276,4,2,0,50,0.04,0.0,1.0,50,1400,800,600,0.5714285714285714,20,8,12,349.2320018440238,0.46043367346938774,0.3760555864369095,0.18912353140198632,128258.57688347125,-1040.260496357222,127218.31638711403,1797,0,223.54,36,14,19,37.91851954789698,0.6027199074074074,46.762387387387385,1012.9504504504499,28.137512512512497,0
2277,4,0,1,49,0.0,0.02,0.98,50,1700,1200,500,0.7058823529411765,22,12,10,346.5458250444861,0.4606887755102041,0.37779135651594253,0.18847486230969296,128429.74044568214,-1098.6419274003767,127331.09851828177,1798,1,224.54,36,14,19,37.811770914342844,0.6044560185185186,46.593468468468465,1013.6261261261259,28.156281281281274,0
2278,4,0,0,49,0.0,0.0,1.0,49,1850,1300,550,0.7027027027027027,24,13,11,354.5273545982685,0.4603174603174603,0.3851205132206974,0.1932802833625035,128525.67361379034,-686.8265871484815,127838.84702664186,1799,2,229.83673469387756,35,14,19,37.51153312026784,0.6074404761904761,46.498842592592595,1014.00462962963,28.97156084656086,0
2279,4,1,0,50,0.02,0.0,1.0,50,1900,1500,400,0.7894736842105263,23,15,8,350.3664343173456,0.4610034013605442,0.38910916747651436,0.1927952197393306,128895.0100631924,-967.9029845721934,127927.1070786202,1800,0,226.22,37,13,20,37.24028632617068,0.6072635135135135,46.13486842105262,1015.4605263157885,27.444879089615903,0
2280,4,1,1,50,0.0196078431372549,0.0196078431372549,0.9803921568627451,51,1600,1100,500,0.6875,21,11,10,347.82466889538614,0.46215686274509804,0.39063106471257436,0.19375024332005336,129377.9538001542,-1198.7401305102571,128179.21366964394,1801,0,222.76470588235293,35,16,21,36.813139931740594,0.6160714285714286,45.659722222222214,1017.3611111111102,29.06746031746029,0
2281,4,1,1,50,0.0196078431372549,0.0196078431372549,0.9803921568627451,51,1500,900,600,0.6,21,9,12,343.366131480891,0.4633986928104575,0.3736389461298937,0.19334910539953834,129803.15778193726,-1285.9983716825034,128517.15941025475,1802,0,221.2549019607843,36,15,17,36.49459424614137,0.6183449074074074,45.24211711711711,1019.0315315315308,28.306431431431413,0
2282,4,1,2,49,0.0196078431372549,0.0392156862745098,0.9607843137254902,51,1300,800,500,0.6153846153846154,18,8,10,337.7575362750695,0.46395424836601307,0.36097012071447665,0.19152632036721218,130076.56385633671,-1413.1320529513962,128663.43180338532,1803,0,218.0,39,12,18,36.36026158140168,0.6156517094017093,44.97395833333333,1020.1041666666658,26.156517094017072,0
2283,4,0,1,48,0.0,0.02040816326530612,0.9795918367346939,49,1300,900,400,0.6923076923076923,17,9,8,343.2434417916177,0.46373653628117917,0.35133240730847315,0.194885545131388,130126.2932372707,-867.0006483307876,129259.29258893992,1804,1,215.73469387755102,38,11,20,36.16993891797555,0.6178728070175439,44.92521367521367,1020.2991452991446,26.849977507872225,0
2284,4,0,1,47,0.0,0.020833333333333332,0.9791666666666666,48,1550,1200,350,0.7741935483870968,19,12,7,347.8577673675899,0.46333850472813237,0.351568659069734,0.19706290816402686,130038.81602993225,-552.997556940604,129485.81847299164,1805,2,220.97916666666666,37,11,20,36.14097326739768,0.6188063063063063,45.0109649122807,1019.9561403508769,27.566382171645323,0
2285,4,0,0,47,0.0,0.0,1.0,47,1650,1000,650,0.6060606060606061,23,10,13,355.0069073532537,0.4622263336416898,0.35648458110454095,0.2010817736021526,130032.77084094236,-167.49363383653338,129865.27720710583,1806,3,226.51063829787233,36,11,21,35.964815428213896,0.6206597222222222,45.016891891891895,1019.9324324324331,28.331456456456475,0
2286,4,0,1,46,0.0,0.02127659574468085,0.9787234042553191,47,1000,300,700,0.3,17,3,14,388.72801227334065,0.46243832870798646,0.32377548758865227,0.20732160654578194,127645.42936288107,568.969748249244,128214.39911113032,1807,4,227.51063829787233,37,10,17,37.54792390046297,0.5945945945945945,47.36842105263159,1010.5263157894752,27.311522048364196,8
2287,4,2,0,48,0.041666666666666664,0.0,1.0,48,1150,800,350,0.6956521739130435,15,8,7,413.2015377711719,0.4638002364066194,0.3122065409759087,0.2223578421043821,128005.79415060431,1016.3705418975411,129022.16469250186,1808,0,222.875,37,11,18,36.558560876945876,0.5982545045045045,47.01206140350879,1011.9517543859672,27.35004741583695,7
2288,4,2,3,47,0.04,0.06,0.94,50,1250,800,450,0.64,17,8,9,394.99371223525895,0.46437074829931974,0.3048639644641864,0.21544024098597894,128543.91289515895,155.0328978809273,128698.94579303988,1809,0,214.92,36,14,14,36.46700906903571,0.6056134259259259,46.48085585585587,1014.0765765765789,28.168793793793856,0
2289,4,1,1,47,0.020833333333333332,0.020833333333333332,0.9791666666666666,48,1200,800,400,0.6666666666666666,16,8,8,407.6854130731831,0.4623042257683215,0.3324698641931825,0.22215333737327578,128506.39349489799,878.0364229025002,129384.42991780049,1810,0,224.70833333333334,34,14,15,36.18375993111816,0.609375,46.517857142857146,1013.9285714285717,29.82142857142858,0
2290,4,0,2,45,0.0,0.0425531914893617,0.9574468085106383,47,1250,900,350,0.72,16,9,7,415.9351931987248,0.46130126426148627,0.34147425509442275,0.2273369968727602,128627.127621882,1300.1098356008956,129927.2374574829,1811,1,230.2127659574468,34,13,16,35.850643508195425,0.6106004901960784,46.39880952380952,1014.4047619047612,29.835434173669448,0
2291,4,0,1,44,0.0,0.022222222222222223,0.9777777777777777,45,1550,1200,350,0.7741935483870968,19,12,7,431.8056406439851,0.4583333333333333,0.35349187155716777,0.23462763785320337,128392.81316080347,2088.1481881968384,130480.96134900031,1812,2,241.3111111111111,33,12,16,35.689238210399026,0.610479797979798,46.62990196078431,1013.4803921568622,30.71152703505643,0
2292,4,3,1,46,0.06382978723404255,0.02127659574468085,0.9787234042553191,47,1200,900,300,0.75,15,9,6,421.43455687025454,0.45887295713845205,0.3697277419968408,0.2340850980022776,129265.58036169758,1503.01077460051,130768.59113629808,1813,0,231.5531914893617,32,15,19,35.05607979471898,0.6217447916666667,45.77020202020201,1016.9191919191902,31.778724747474694,0
2293,4,1,1,46,0.02127659574468085,0.02127659574468085,0.9787234042553191,47,1950,1500,450,0.7692307692307693,24,15,9,413.57843169502496,0.45829478877582486,0.37880042838075245,0.2319835625905473,129651.06398581772,1324.1767421691593,130975.24072798688,1814,0,232.06382978723406,32,15,17,34.86135217786594,0.6256510416666667,45.39141414141414,1018.434343434343,31.826073232323218,0
2294,4,0,1,45,0.0,0.021739130434782608,0.9782608695652174,46,1200,800,400,0.6666666666666666,16,8,8,422.3703403300608,0.45769927536231886,0.38066273768486614,0.236600004396925,129598.82948133674,1747.7403428819357,131346.56982421866,1815,1,235.91304347826087,31,15,17,34.69096334185848,0.6276881720430108,45.44270833333333,1018.2291666666661,32.84610215053762,0
2295,4,0,1,44,0.0,0.022222222222222223,0.9777777777777777,45,1650,1000,650,0.6060606060606061,23,10,13,417.15842445669693,0.457070707070707,0.3815430047988191,0.2348691963883531,129797.77865939663,1829.2473687065883,131627.02602810322,1816,2,241.24444444444444,31,14,17,34.62017633529261,0.6297043010752688,45.24739583333333,1019.0104166666661,32.87130376344084,0
2296,4,0,1,43,0.0,0.022727272727272728,0.9772727272727273,44,1150,700,450,0.6086956521739131,16,7,9,424.68187004699587,0.4559108527131783,0.3811112710004678,0.23901360481264106,129782.79867976063,2223.280328650704,132006.07900841133,1817,3,229.8409090909091,30,14,17,34.443839862814926,0.6322916666666667,45.262096774193544,1018.9516129032255,33.96505376344085,0
2297,4,1,1,43,0.022727272727272728,0.022727272727272728,0.9772727272727273,44,1200,700,500,0.5833333333333334,17,7,10,424.60422501295915,0.45452343199436224,0.3851953700708146,0.2402291018026342,129988.31376821034,2238.7174456584767,132227.03121386882,1818,0,230.45454545454547,30,14,18,34.23564430385308,0.634375,45.06048387096775,1019.7580645161302,33.991935483871,0
2298,4,0,2,41,0.0,0.046511627906976744,0.9534883720930233,43,1050,700,350,0.6666666666666666,14,7,7,424.4153165961036,0.45452657807308966,0.37045071544565955,0.2407557737641574,130091.13228407911,2442.5338189386093,132533.66610301772,1819,1,223.37209302325581,30,13,18,34.13537549407115,0.6354166666666667,44.95967741935484,1020.1612903225808,34.00537634408603,0
2299,4,0,0,41,0.0,0.0,1.0,41,1350,700,650,0.5185185185185185,20,7,13,435.9207182460226,0.453150406504065,0.3662423873932239,0.24635057680092784,129943.77170138898,3129.036458333343,133072.8081597223,1820,2,221.9268292682927,29,12,18,33.99272919220813,0.6368534482758621,45.10416666666667,1019.583333333334,35.15804597701152,0
2300,4,3,0,44,0.06818181818181818,0.0,1.0,44,1350,1100,250,0.8148148148148148,16,11,5,400.5199118506395,0.4559328752642706,0.34689157518194147,0.23242769687710343,130972.4633487654,1691.4158950617268,132663.87924382713,1821,0,207.72727272727272,32,12,20,33.84780642243329,0.6389973958333333,44.09722222222222,1023.611111111111,31.987847222222218,0
2301,4,0,0,44,0.0,0.0,1.0,44,850,400,450,0.47058823529411764,13,4,9,398.57660010855653,0.455547480620155,0.3437282815827818,0.23188351699285467,131069.41415416797,1648.24029435772,132717.6544485257,1822,1,208.72727272727272,32,12,20,33.79906494040279,0.6399739583333333,44.00252525252525,1023.9898989898992,31.99968434343435,0
2302,4,0,1,43,0.0,0.022727272727272728,0.9772727272727273,44,1300,900,400,0.6923076923076923,17,9,8,401.7999241642191,0.4553933227625088,0.34481367781836103,0.23454709242219238,131198.73769258242,1743.1285710641855,132941.8662636466,1823,2,209.72727272727272,32,12,21,33.585212800920225,0.6412760416666667,43.87626262626263,1024.4949494949499,32.015467171717184,0
2303,4,0,0,43,0.0,0.0,1.0,43,1300,600,700,0.46153846153846156,20,6,14,410.7119142199761,0.45429586563307495,0.35610224870267104,0.23910060735308017,131094.66764662007,2168.428378634987,133263.09602525507,1824,3,215.48837209302326,31,12,21,33.4627304513668,0.6428091397849462,43.977864583333336,1024.0885416666672,33.035114247311846,0
2304,4,0,0,43,0.0,0.0,1.0,43,1300,1100,200,0.8461538461538461,15,11,4,409.9697702959911,0.45362679955703217,0.3549798642647579,0.23991613843864273,131294.76123385952,2165.3766208224733,133460.137854682,1825,4,216.48837209302326,31,12,21,33.27841125651124,0.6448252688172043,43.78255208333333,1024.869791666666,33.060315860215034,0
2305,4,0,0,43,0.0,0.0,1.0,43,1200,900,300,0.75,15,9,6,413.2260216679262,0.4530038759689923,0.35442155777039486,0.2426662878922387,131428.24172973644,2261.913892957913,133690.15562269435,1826,5,217.48837209302326,31,12,21,33.059391534391544,0.6461693548387097,43.65234375000001,1025.390625000001,33.0771169354839,0
2306,4,0,0,43,0.0,0.0,1.0,43,1300,800,500,0.6153846153846154,18,8,10,413.5542515230837,0.4524270948689553,0.3620849388952154,0.24435042057758247,131661.9957817927,2289.8756239149548,133951.87140570767,1827,6,218.48837209302326,31,12,21,32.813689418929215,0.648521505376344,43.42447916666668,1026.3020833333348,33.10651881720435,0
2307,4,0,1,42,0.0,0.023255813953488372,0.9767441860465116,43,1900,1400,500,0.7368421052631579,24,14,10,414.67730716280596,0.45125046142488,0.35860353096893816,0.24652519036981,131895.95752292222,2338.852098253059,134234.80962117529,1828,7,219.48837209302326,31,12,21,32.547560949845774,0.6508736559139785,43.19661458333334,1027.2135416666679,33.13592069892477,0
2308,4,0,0,42,0.0,0.0,1.0,42,1350,900,450,0.6666666666666666,18,9,9,419.8669716064495,0.449973383662408,0.35096770977430447,0.2495041521785761,131879.77837033191,2674.3926320962078,134554.17100242813,1829,8,224.04761904761904,30,12,21,32.43070095088545,0.6534722222222222,43.212365591397855,1027.1505376344094,34.238351254480314,0
2309,4,0,1,41,0.0,0.023809523809523808,0.9761904761904762,42,1250,900,350,0.72,16,9,7,418.2379355417601,0.4494289585753,0.3495513273108004,0.24908041881962512,131962.8418816462,2638.373311360702,134601.2151930069,1830,9,225.04761904761904,31,11,21,32.38829573776032,0.6515456989247312,43.13151041666668,1027.4739583333346,33.14432123655918,0
2310,4,0,1,40,0.0,0.024390243902439025,0.975609756097561,41,1650,1300,350,0.7878787878787878,20,13,7,426.4254070315304,0.448755081300813,0.34669559252819493,0.2540937051251793,131983.34209518446,3056.2100748641574,135039.5521700486,1831,10,230.0731707317073,30,11,21,32.157183344233715,0.6545138888888888,43.11155913978495,1027.5537634408606,34.251792114695355,0
2311,4,0,0,40,0.0,0.0,1.0,40,1450,1100,350,0.7586206896551724,18,11,7,430.9033947672485,0.44794337606837603,0.3336297071129708,0.25746477837343107,132086.9464677998,3383.342727482956,135470.28919528276,1832,11,232.15,30,10,21,31.936998779637378,0.6555555555555556,43.01075268817205,1027.9569892473123,34.26523297491041,0
2312,4,0,2,38,0.0,0.05,0.95,40,800,600,200,0.75,10,6,4,433.96249203143117,0.4478098290598291,0.33257417331067796,0.26000368257889417,132190.5914881778,3473.1517010637012,135663.7431892415,1833,12,233.15,30,10,21,31.753202195791403,0.6565972222222223,42.909946236559136,1028.360215053763,34.27867383512544,0
2313,4,0,0,38,0.0,0.0,1.0,38,1250,900,350,0.72,16,9,7,437.7851737244839,0.4469683499288763,0.3111831442463533,0.26224607008544326,132183.6805555555,3973.6111111111077,136157.2916666666,1834,13,230.31578947368422,29,9,21,31.661939492166397,0.6594827586206897,42.916666666666664,1028.333333333333,35.459770114942515,0
2314,4,0,0,38,0.0,0.0,1.0,38,1450,900,550,0.6206896551724138,20,9,11,441.7381042141323,0.4458422238027501,0.3118474323460474,0.2661202725387578,132398.00347222228,4097.222222222229,136495.2256944445,1835,14,231.31578947368422,28,10,21,31.34278002699055,0.6648065476190477,42.708333333333336,1029.166666666667,36.755952380952394,0
2315,4,0,0,38,0.0,0.0,1.0,38,1250,800,450,0.64,17,8,9,439.16440344291544,0.44516062114746324,0.3075830010354479,0.2656110784367405,132545.9135329964,4041.8894091029224,136587.80294209934,1836,15,232.31578947368422,28,10,21,31.259011208780986,0.6662946428571428,42.564655172413794,1029.7413793103447,36.776477832512306,0
2316,4,0,0,38,0.0,0.0,1.0,38,1000,700,300,0.7,13,7,6,436.5004693784622,0.4449828117591275,0.30002349296312314,0.2645200223984948,132619.89952850438,3977.729678623324,136597.6292071277,1837,16,233.31578947368422,28,10,21,31.25261542753522,0.6670386904761905,42.49281609195402,1030.0287356321835,36.786740558292266,0
2317,4,0,0,38,0.0,0.0,1.0,38,950,700,250,0.7368421052631579,12,7,5,440.4339830579912,0.44467164532954007,0.3024187630258022,0.2676942819060943,132730.91722816753,4091.841309948475,136822.758538116,1838,17,234.31578947368422,28,10,20,31.03881994794572,0.6681547619047619,42.38505747126437,1030.4597701149426,36.80213464696224,0
2318,4,0,0,38,0.0,0.0,1.0,38,900,600,300,0.6666666666666666,12,6,6,437.12147763696424,0.444078947368421,0.29965381681628855,0.26673330982337196,132879.013079667,4016.854108865104,136895.8671885321,1839,18,235.31578947368422,28,10,20,30.974196395392056,0.6696428571428572,42.241379310344826,1031.0344827586202,36.82266009852215,0
2319,4,1,0,39,0.02564102564102564,0.0,1.0,39,1350,900,450,0.6666666666666666,18,9,9,421.2281823881028,0.4437696806117859,0.29312513554543473,0.2604294916856453,133368.075879437,3435.678438258769,136803.75431769577,1840,0,230.25641025641025,30,9,22,30.88999132509218,0.6684027777777778,41.767473118279575,1032.9301075268822,34.43100358422941,0
2320,4,0,0,39,0.0,0.0,1.0,39,1150,700,450,0.6086956521739131,16,7,9,396.7069568831816,0.4433198380566801,0.23399604455084844,0.234533152909337,131684.26890432098,2726.0794038488725,134410.34830816987,1841,1,231.25641025641025,32,7,18,33.22338746053226,0.6461588541666667,43.40277777777778,1026.388888888889,32.07465277777778,8
2321,4,0,0,39,0.0,0.0,1.0,39,1000,700,300,0.7,13,7,6,395.52406286134146,0.44289811066126855,0.23125879689125517,0.23473736875198595,131831.05656478275,2628.471020761242,134459.52758554398,1842,2,232.25641025641025,33,6,18,33.105111376292754,0.6452020202020202,43.259803921568626,1026.9607843137253,31.120023767082586,0
2322,4,0,0,39,0.0,0.0,1.0,39,1250,900,350,0.72,16,9,7,390.66663724347336,0.44157669815564554,0.22337554367593704,0.23359247468535274,132114.37795859767,2522.535953719723,134636.9139123174,1843,3,233.25641025641025,33,6,20,32.943313664719675,0.6480429292929293,42.98406862745098,1028.0637254901962,31.153446226975642,0
2323,4,0,0,39,0.0,0.0,1.0,39,950,600,350,0.631578947368421,13,6,7,391.8946836153604,0.4407051282051282,0.21766463224647659,0.2353050053123987,132271.9101427335,2567.3316753171803,134839.24181805068,1844,4,234.25641025641025,33,6,20,32.75256135334762,0.6496212121212122,42.830882352941174,1028.676470588235,31.172014260249544,0
2324,4,0,0,39,0.0,0.0,1.0,39,900,800,100,0.8888888888888888,10,8,2,370.31741545135924,0.44011470985155193,0.20952073603279753,0.21198757451555103,130444.94224773225,1861.206774376394,132306.14902210864,1845,5,235.25641025641025,34,5,19,35.15567338694013,0.6289828431372548,44.61309523809523,1021.5476190476177,30.04551820728287,8
2325,4,0,0,39,0.0,0.0,1.0,39,600,200,400,0.3333333333333333,10,2,8,373.0011864463768,0.44025528565002253,0.21391121985319783,0.21385899687837367,130505.75573979596,1935.7603458049932,132441.51608560095,1846,6,236.25641025641025,34,5,15,35.025389335508166,0.6295955882352942,44.55357142857143,1021.7857142857147,30.052521008403374,0
2326,4,1,0,40,0.025,0.0,1.0,40,1100,800,300,0.7272727272727273,14,8,6,351.1165085060709,0.44133279914529916,0.16537179936864232,0.19666663374279145,129595.04145408174,1162.326388888899,130757.36784297065,1847,0,231.325,34,6,19,36.508632448653486,0.6204044117647058,45.44642857142858,1018.2142857142867,29.947478991596668,8
2327,4,1,0,41,0.024390243902439025,0.0,1.0,41,550,200,350,0.36363636363636365,9,2,7,342.0885261916404,0.44250508130081306,0.16619920314312764,0.1932942801297088,129937.87140185607,690.0509848679674,130627.92238672404,1848,0,226.65853658536585,35,6,21,36.39045767586184,0.6217261904761905,45.1099537037037,1019.5601851851847,29.13029100529099,0
2328,4,0,0,41,0.0,0.0,1.0,41,1450,1000,450,0.6896551724137931,19,10,9,342.48885634226764,0.4417936991869919,0.16436566544512488,0.19395962738355163,130026.38996056246,706.517918381353,130732.90787894382,1849,1,227.65853658536585,35,6,21,36.29047510969891,0.6226190476190476,45.02314814814815,1019.9074074074078,29.140211640211653,0
2329,4,0,0,41,0.0,0.0,1.0,41,1000,600,400,0.6,14,6,8,340.46784457344484,0.441869918699187,0.16711536599200327,0.19325331937636303,130114.93866008664,659.9905424811441,130774.92920256779,1850,2,228.65853658536585,35,6,21,36.25224522594063,0.6235119047619048,44.936342592592595,1020.2546296296301,29.15013227513229,0
2330,4,0,1,40,0.0,0.024390243902439025,0.975609756097561,41,1050,800,250,0.7619047619047619,13,8,5,338.5328307212672,0.44189532520325203,0.16347741434098806,0.19273860775538126,130233.05047850225,617.6326463906091,130850.68312489286,1851,3,229.65853658536585,35,6,21,36.18194145216768,0.624702380952381,44.820601851851855,1020.7175925925927,29.16335978835979,0
2331,4,0,0,40,0.0,0.0,1.0,40,1300,900,400,0.6923076923076923,17,9,8,342.83086438235586,0.441920405982906,0.15198588592091467,0.19502913074651207,130201.83000283454,927.4411848072667,131129.2711876418,1852,4,229.475,34,6,21,36.10390178467282,0.626531862745098,44.85119047619048,1020.5952380952386,30.017507002801135,0
2332,4,0,0,40,0.0,0.0,1.0,40,950,800,150,0.8421052631578947,11,8,3,343.51028871379725,0.4415998931623932,0.15311589133729742,0.19602712882889162,130323.35778061229,953.4828514739309,131276.8406320862,1853,5,230.475,34,6,22,35.96342932649335,0.6277573529411764,44.73214285714286,1021.071428571429,30.03151260504203,0
2333,4,0,1,39,0.0,0.025,0.975,40,900,700,200,0.7777777777777778,11,7,4,342.668209801077,0.4412393162393162,0.1551864801864804,0.1960062160062161,130414.54081632657,937.7834467120249,131352.32426303858,1854,6,231.475,34,6,22,35.892579642579655,0.6286764705882353,44.642857142857146,1021.4285714285717,30.042016806722696,0
2334,4,0,0,39,0.0,0.0,1.0,39,1050,600,450,0.5714285714285714,15,6,9,346.9285222202982,0.4408738191632928,0.15286185343766912,0.1986261099744785,130450.30757401003,1251.3864859669395,131701.69405997696,1855,7,235.94871794871796,33,6,22,35.747560780550224,0.6313131313131313,44.6078431372549,1021.5686274509808,30.956625074272146,0
2335,4,0,0,39,0.0,0.0,1.0,39,1300,1000,300,0.7692307692307693,16,10,6,344.91222157859096,0.4408175888439046,0.15106717204787,0.198271043431222,130606.8447982749,1209.5793985486612,131816.42419682356,1856,8,236.94871794871796,33,6,19,35.6405856611917,0.6328914141414141,44.45465686274511,1022.1813725490213,30.975193107546097,0
2336,4,1,0,40,0.025,0.0,1.0,40,1000,600,400,0.6,14,6,8,338.63864583652975,0.44155982905982905,0.1542882893359694,0.19662077755221613,130992.77388038553,871.8431122449042,131864.61699263044,1857,0,232.0,34,6,21,35.41085203705858,0.6344975490196079,44.077380952380956,1023.6904761904766,30.10854341736696,0
2337,4,0,0,40,0.0,0.0,1.0,40,800,600,200,0.75,10,6,4,340.1413977197518,0.4406116452991453,0.14758777028597958,0.1979632140179504,131084.19075963725,917.4319727891219,132001.62273242636,1858,1,233.0,34,6,21,35.28007052623421,0.6354166666666667,43.98809523809524,1024.0476190476195,30.11904761904763,0
2338,4,1,1,40,0.024390243902439025,0.024390243902439025,0.975609756097561,41,1300,800,500,0.6153846153846154,18,8,10,334.06552096873787,0.44184451219512194,0.14736067267811404,0.19644876881540443,131480.69905045338,584.8604024943141,132065.5594529477,1859,0,228.29268292682926,34,7,22,35.03579028825692,0.6393995098039216,43.60119047619047,1025.595238095237,30.1645658263305,0
2339,4,0,1,39,0.0,0.025,0.975,40,1300,900,400,0.6923076923076923,17,9,8,343.0406500041235,0.44145299145299144,0.15693879990437476,0.20125372215529416,131390.93888168002,1014.4866157247054,132405.42549740474,1860,1,234.05,33,7,23,34.89620686907323,0.6407828282828283,43.68872549019607,1025.2450980392148,31.0680332739156,0
2340,4,1,1,39,0.025,0.025,0.975,40,1150,800,350,0.6956521739130435,15,8,7,338.4413921067971,0.440892094017094,0.15883476599808954,0.20019668787334255,131705.23356401376,914.9005190311289,132620.1340830449,1861,0,233.775,33,7,20,34.69734957020057,0.6439393939393939,43.382352941176464,1026.4705882352935,31.105169340463437,0
2341,4,0,0,39,0.0,0.0,1.0,39,1350,1100,250,0.8148148148148148,16,11,5,348.7618616196818,0.4397773279352227,0.16649311800677769,0.20566319938472666,131587.09092184465,1378.5117590041702,132965.60268084882,1862,3,240.76923076923077,32,7,20,34.55164492575271,0.6451822916666667,43.49747474747474,1026.0101010101005,32.06281565656564,0
2342,4,0,0,39,0.0,0.0,1.0,39,1400,1000,400,0.7142857142857143,18,10,8,349.5151290678722,0.4386246063877643,0.17032629159058899,0.2069852523270843,131749.07415378527,1409.6589314865823,133158.73308527184,1863,4,241.76923076923077,32,7,21,34.36897880539501,0.6468098958333333,43.339646464646464,1026.6414141414139,32.08254419191918,0
2343,4,0,0,39,0.0,0.0,1.0,39,1300,900,400,0.6923076923076923,17,9,8,350.1349086333976,0.4384840305892937,0.17314781556610037,0.20859428158554824,131976.01807213548,1441.8822058973506,133417.90027803284,1864,5,242.76923076923077,32,7,21,34.12437535840091,0.6490885416666667,43.118686868686865,1027.5252525252522,32.11016414141413,0
2344,4,0,0,39,0.0,0.0,1.0,39,1000,800,200,0.8,12,8,4,376.979508739262,0.43783738191632926,0.14914356295667952,0.22168453705042585,131480.69905045338,2163.100765826668,133643.79981628005,1865,6,243.76923076923077,34,5,16,33.935480750628756,0.6393995098039216,43.60119047619047,1025.595238095237,30.1645658263305,8
2345,4,0,1,38,0.0,0.02564102564102564,0.9743589743589743,39,950,700,250,0.7368421052631579,12,7,5,375.0153292199412,0.43755623031938823,0.14794913448893499,0.2210589676619324,131572.28599773237,2068.3248299319675,133640.61082766432,1866,7,244.76923076923077,34,5,15,33.89320801423378,0.6403186274509804,43.51190476190476,1025.9523809523805,30.17507002801119,0
2346,4,0,1,37,0.0,0.02631578947368421,0.9736842105263158,38,700,400,300,0.5714285714285714,10,4,6,382.43552950245606,0.4358700806069227,0.16243107470024998,0.22528978307284012,131548.03929077747,2461.728812235671,134009.76810301314,1867,10,252.02631578947367,33,5,16,33.72742702982521,0.6423611111111112,43.53553921568627,1025.8578431372541,31.086601307189518,0
2347,4,0,0,37,0.0,0.0,1.0,37,700,400,300,0.5714285714285714,10,4,6,388.1706792899408,0.43502877877877877,0.16608066528066523,0.22870825012550908,131554.70623214476,2813.135936384051,134367.84216852882,1868,11,257.0,32,5,15,33.57358974358974,0.6448567708333333,43.52904040404041,1025.883838383839,32.05886994949497,0
2348,4,0,0,37,0.0,0.0,1.0,37,1050,1000,50,0.9523809523809523,11,10,1,387.3532231614922,0.4348410910910911,0.16742388462792057,0.22842034045067403,131587.09092184482,2794.136759004197,134381.22768084903,1869,12,258.0,32,5,15,33.56176675691198,0.6451822916666667,43.497474747474755,1026.010101010102,32.06281565656569,0
2349,4,0,1,36,0.0,0.02702702702702703,0.972972972972973,37,1150,800,350,0.6956521739130435,15,8,7,384.2481223927189,0.4348098098098098,0.16564702238054663,0.22729253341535408,131705.23356401385,2721.4977412533644,134426.73130526723,1870,13,259.0,33,4,15,33.521868035657434,0.6439393939393939,43.38235294117647,1026.4705882352941,31.10516934046346,0
2350,4,0,0,36,0.0,0.0,1.0,36,1000,600,400,0.6,14,6,8,393.2108767582139,0.43363095238095234,0.17343173431734327,0.23266407773248055,131716.66953627198,3158.4854224058977,134875.1549586779,1871,14,265.8333333333333,32,4,15,33.280289052890524,0.646484375,43.37121212121213,1026.5151515151529,32.07859848484853,0
2351,4,0,0,36,0.0,0.0,1.0,36,1300,900,400,0.6923076923076923,17,9,8,388.9184086908118,0.4322916666666667,0.1659044513375223,0.23119958167704865,131893.9905925606,3059.20018742792,134953.19077998854,1872,15,266.8333333333333,33,3,15,33.21104748270102,0.6458333333333333,43.19852941176471,1027.2058823529417,31.127450980392172,0
2352,4,0,2,34,0.0,0.05555555555555555,0.9444444444444444,36,700,500,200,0.7142857142857143,9,5,4,391.81774809160265,0.43245701058201064,0.16156435538592007,0.23330965909090912,131956.9396386007,3140.6141868512314,135097.55382545193,1873,16,267.8333333333333,33,3,15,33.07291666666667,0.6464646464646464,43.137254901960794,1027.4509803921583,31.134878193701766,0
2353,4,0,0,34,0.0,0.0,1.0,34,1150,800,350,0.6956521739130435,15,8,7,399.2215707770184,0.42791889483065954,0.15139067675262852,0.2370268800511149,131846.3119197024,3727.178349148088,135573.49026885047,1874,17,274.8235294117647,32,2,15,32.9947340381936,0.6477864583333333,43.244949494949516,1027.0202020202046,32.09438131313139,0
2354,4,0,0,34,0.0,0.0,1.0,34,950,800,150,0.8421052631578947,11,8,3,401.064515653035,0.42782605466428997,0.1566591242617239,0.23873167255806516,131943.5855556833,3783.5780468830008,135727.1636025663,1875,18,275.8235294117647,32,2,16,32.84892056859613,0.6487630208333333,43.15025252525254,1027.3989898989917,32.10621843434349,0
2355,4,0,0,34,0.0,0.0,1.0,34,800,500,300,0.625,11,5,6,402.81227173119026,0.42728758169934644,0.1624006359300476,0.24038796861377526,132040.89506172866,3837.5385802469455,135878.4336419756,1876,19,276.8235294117647,32,2,16,32.70551801801802,0.6497395833333333,43.05555555555557,1027.7777777777799,32.11805555555562,0
2356,4,0,0,34,0.0,0.0,1.0,34,850,700,150,0.8235294117647058,10,7,3,403.15805650876007,0.4269162210338681,0.15962980623347356,0.2410068205649285,132105.7879935722,3851.9025482093803,135957.69054178157,1877,20,277.8235294117647,32,2,16,32.63095676737903,0.650390625,42.99242424242425,1028.030303030304,32.125946969697,0
2357,4,0,0,34,0.0,0.0,1.0,34,950,500,450,0.5263157894736842,14,5,9,401.4651567412472,0.426730540701129,0.1601234969125771,0.2406132230800191,132203.15728305798,3814.992252066131,136018.1495351241,1878,21,278.8235294117647,32,2,16,32.575966850828735,0.6513671875,42.89772727272728,1028.409090909092,32.13778409090912,0
2358,4,0,0,34,0.0,0.0,1.0,34,900,600,300,0.6666666666666666,12,6,6,401.4161844973691,0.4266748366013072,0.15801381281257432,0.24182877456304935,132398.00347222236,3829.340277777797,136227.34375000017,1879,22,279.8235294117647,32,2,16,32.380229419703106,0.6533203125,42.70833333333334,1029.1666666666679,32.16145833333337,0
2359,4,1,0,35,0.02857142857142857,0.0,1.0,35,500,300,200,0.6,7,3,4,392.67081450318176,0.428046218487395,0.15746741660860875,0.23835260198759947,132681.93310565664,3420.0645484909883,136101.99765414762,1880,0,272.8,33,2,16,32.31867788747473,0.6537247474747474,42.4325980392157,1030.2696078431386,31.220291146761777,0
2360,4,0,0,35,0.0,0.0,1.0,35,1050,700,350,0.6666666666666666,14,7,7,392.5133044156345,0.42608543417366945,0.1556434769319588,0.2394644256743099,132871.38848339583,3430.757551182239,136302.14603457807,1881,1,273.8,33,2,16,32.131695986370296,0.6556186868686869,42.24877450980392,1031.0049019607845,31.24257278669044,0
2361,4,0,0,35,0.0,0.0,1.0,35,950,600,350,0.631578947368421,13,6,7,395.56534538593866,0.4254551820728291,0.1629277566539924,0.2419388042709347,132966.1668589005,3519.3615436370746,136485.52840253757,1882,2,274.8,33,2,16,31.957481780735115,0.6565656565656566,42.156862745098046,1031.3725490196086,31.253713606654806,0
2362,4,0,0,35,0.0,0.0,1.0,35,1200,900,300,0.75,15,9,6,396.1609252625432,0.42454481792717086,0.13334245357228358,0.23014800901552745,131014.28086553245,3380.547746059204,134394.82861159166,1883,3,275.8,33,2,14,33.9168861224164,0.6369949494949495,44.056372549019606,1023.7745098039213,31.02346999405822,8
2363,4,0,1,34,0.0,0.02857142857142857,0.9714285714285714,35,1000,700,300,0.7,13,7,6,398.56745889770974,0.4243347338935574,0.1331555099598185,0.2317349421774784,131045.64838343424,3446.1062151576275,134491.75459859186,1884,4,276.8,33,2,14,33.823434071414326,0.6373106060606061,44.025735294117645,1023.8970588235293,31.02718360071301,0
2364,4,0,0,34,0.0,0.0,1.0,34,900,600,300,0.6666666666666666,12,6,6,399.1902616634576,0.4222556446821153,0.16058105727191685,0.23282750487962856,131166.40082963483,3672.069973727187,134838.47080336203,1885,5,284.8529411764706,32,2,15,33.684878179054195,0.6409505208333333,43.90782828282829,1024.3686868686877,32.01152146464649,0
2365,4,0,0,34,0.0,0.0,1.0,34,600,400,200,0.6666666666666666,8,4,4,404.91721660569294,0.4220699643493761,0.17271217550913365,0.22899940065179125,129972.73875114799,3725.6399219467594,133698.37867309476,1886,6,285.8529411764706,32,2,17,34.75343610698365,0.62890625,45.075757575757585,1019.6969696969709,31.86553030303034,8
2366,4,0,0,34,0.0,0.0,1.0,34,850,500,350,0.5882352941176471,12,5,7,403.5747108126652,0.4222556446821153,0.17336924868957482,0.228994639281344,130101.52025303557,3701.1366824814045,133802.65693551698,1887,7,286.8529411764706,32,2,18,34.65630156765678,0.6302083333333333,44.94949494949496,1020.2020202020217,31.881313131313178,0
2367,4,0,0,34,0.0,0.0,1.0,34,800,700,100,0.875,9,7,2,404.1269588749126,0.4224970291146762,0.1712199168916606,0.2298774249532669,130198.14822785962,3723.3163388940184,133921.46456675365,1888,8,287.8529411764706,32,2,18,34.54369252340304,0.6311848958333333,44.85479797979799,1020.5808080808098,31.893150252525306,0
2368,4,0,0,34,0.0,0.0,1.0,34,1350,1100,250,0.8148148148148148,16,11,5,405.6137981949205,0.4222185086155674,0.16692603608386136,0.23187349919425554,130391.51178770048,3777.7192697174078,134169.2310574179,1889,9,288.8529411764706,32,2,19,34.30868051263033,0.6331380208333333,44.665404040404056,1021.3383838383858,31.916824494949555,0
2369,4,0,0,34,0.0,0.0,1.0,34,850,700,150,0.8235294117647058,10,7,3,404.69443176195585,0.4222185086155674,0.17301358808261913,0.23173267143566784,130455.99819214882,3758.9632116620887,134214.9614038109,1890,10,289.8529411764706,32,2,19,34.2664689160796,0.6337890625,44.602272727272734,1021.5909090909097,31.924715909090928,0
2370,4,0,1,33,0.0,0.029411764705882353,0.9705882352941176,34,1550,1400,150,0.9032258064516129,17,14,3,405.7250966270286,0.42169860368389783,0.17726628637866448,0.23309756261148343,130585.01882779835,3796.323876390185,134381.34270418854,1891,11,290.8529411764706,32,2,17,34.10876055178093,0.6350911458333333,44.47601010101011,1022.095959595961,31.94049873737378,0
2371,4,0,0,33,0.0,0.0,1.0,33,800,600,200,0.75,10,6,4,408.00450155059957,0.4184816919191919,0.15954281608227494,0.2347983261588633,130649.5530589992,4061.121154729125,134710.6742137283,1892,12,291.0,32,1,17,33.98480918858837,0.6357421875,44.412878787878796,1022.3484848484859,31.948390151515184,0
2372,4,0,0,33,0.0,0.0,1.0,33,950,800,150,0.8421052631578947,11,8,3,407.45387653934114,0.41785037878787884,0.1580575536877229,0.2352661335598863,130778.66934815333,4057.255158912365,134835.9245070657,1893,13,292.0,32,1,17,33.86747520882196,0.6370442708333333,44.286616161616166,1022.853535353536,31.964172979798,0
2373,4,0,0,33,0.0,0.0,1.0,33,1000,800,200,0.8,12,8,4,406.87571405824787,0.41769255050505055,0.15595849883680035,0.23512888982167812,130810.95838434863,4044.7604198551317,134855.71880420376,1894,14,293.0,32,1,17,33.84940961079569,0.6373697916666667,44.25505050505051,1022.9797979797988,31.968118686868713,0
2374,4,0,0,33,0.0,0.0,1.0,33,1150,800,350,0.6956521739130435,15,8,7,405.8221290242998,0.4172190656565657,0.1590395131779121,0.23550465282748753,130972.46334876554,4030.3047839506316,135002.76813271616,1895,15,294.0,32,1,18,33.71212121212121,0.6389973958333333,44.09722222222223,1023.611111111112,31.98784722222225,0
2375,4,0,0,33,0.0,0.0,1.0,33,650,500,150,0.7692307692307693,8,5,3,404.8683256274315,0.41658775252525254,0.15176176063968927,0.23554391110749445,131069.41415416807,4013.170849913289,135082.58500408137,1896,16,295.0,32,1,18,33.637998355939175,0.6399739583333333,44.00252525252526,1023.9898989899,31.999684343434375,0
2376,4,0,0,33,0.0,0.0,1.0,33,1000,700,300,0.7,13,7,6,403.40575575455875,0.4157986111111111,0.14202655015963672,0.2356830603274474,131231.07854109272,3987.874483471073,135218.9530245638,1897,17,296.0,32,1,18,33.51124460874922,0.6416015625,43.84469696969697,1024.621212121212,32.019412878787875,0
2377,4,0,0,33,0.0,0.0,1.0,33,850,600,250,0.7058823529411765,11,6,5,407.16504726022845,0.415167297979798,0.14781966001478164,0.2384823848238483,131328.12500000015,4094.44444444446,135422.5694444446,1898,18,297.0,32,1,18,33.31639566395662,0.642578125,43.75000000000001,1025.0000000000011,32.031250000000036,0
2378,4,1,1,33,0.029411764705882353,0.029411764705882353,0.9705882352941176,34,1100,800,300,0.7272727272727273,14,8,6,398.2163823702648,0.4163510101010101,0.14255731820287165,0.23522549098150541,131651.87225793293,3685.1864605652604,135337.05871849819,1899,0,289.2352941176471,32,2,14,33.21747867454068,0.6458333333333333,43.43434343434344,1026.2626262626268,32.07070707070709,0
2379,4,0,0,33,0.0,0.0,1.0,33,1000,600,400,0.6,14,6,8,409.50661875104686,0.4148121843434343,0.1527654352333805,0.2409024373339801,131495.0074089897,4169.615173339834,135664.62258232955,1900,20,299.0,31,2,18,33.0869673310482,0.6468413978494624,43.58723958333333,1025.6510416666658,33.08551747311825,0
2380,4,0,0,33,0.0,0.0,1.0,33,800,700,100,0.875,9,7,2,408.1424411863229,0.41469381313131315,0.15572988770958318,0.2407307212985197,131595.18771701382,4141.9162326388805,135737.1039496527,1901,21,300.0,31,2,16,33.02030456852793,0.6478494623655914,43.48958333333333,1026.041666666666,33.098118279569874,0
2381,4,0,0,33,0.0,0.0,1.0,33,1200,1000,200,0.8333333333333334,14,10,4,406.06809905476183,0.4143781565656566,0.15598911489322465,0.24034841538646717,131728.82080078125,4098.1743706597235,135826.99517144097,1902,22,301.0,31,2,16,32.938017926602406,0.6491935483870968,43.359375,1026.5625,33.11491935483871,0
2382,4,0,0,33,0.0,0.0,1.0,33,1200,900,300,0.75,15,9,6,407.7668729808114,0.413510101010101,0.16116802452206191,0.2424169450599563,131895.95752292202,4156.560431586363,136052.5179545084,1903,23,302.0,31,2,16,32.725023239109305,0.6508736559139785,43.19661458333333,1027.213541666666,33.135920698924714,0
2383,4,0,0,33,0.0,0.0,1.0,33,550,400,150,0.7272727272727273,7,4,3,405.44238668253763,0.4133522727272727,0.15945001344240906,0.24124739298078596,131929.3975830078,4097.953965928819,136027.35154893663,1904,24,303.0,31,2,16,32.7508449514153,0.6512096774193548,43.1640625,1027.34375,33.140120967741936,0
2384,4,1,0,34,0.029411764705882353,0.0,1.0,34,800,600,200,0.75,10,6,4,399.13036868459244,0.41620246583481874,0.15526205571843255,0.23941943912405664,132235.6216840118,3755.8504871951773,135991.472171207,1905,0,295.05882352941177,32,2,17,32.60316924461904,0.6516927083333333,42.86616161616161,1028.5353535353531,32.141729797979785,0
2385,4,0,0,34,0.0,0.0,1.0,34,700,500,200,0.7142857142857143,9,5,4,403.2227351779994,0.415478312537136,0.16158243884128698,0.2424990456801119,132333.03880024992,3871.937971890618,136204.97677214054,1906,1,296.05882352941177,32,2,17,32.39942528735632,0.6526692708333333,42.77146464646464,1028.914141414141,32.15356691919191,0
2386,4,0,0,34,0.0,0.0,1.0,34,900,700,200,0.7777777777777778,11,7,4,404.81299260558814,0.41466131907308373,0.16135164969949733,0.24429610131112922,132462.98408644504,3924.5473995000234,136387.53148594507,1907,2,297.05882352941177,32,2,17,32.22714542704118,0.6539713541666667,42.64520202020201,1029.41919191919,32.16934974747469,0
2387,4,0,0,34,0.0,0.0,1.0,34,800,400,400,0.5,12,4,8,404.76634519237956,0.41356580510992275,0.16504910373073023,0.24532569421095324,132625.50536934996,3936.4682175288094,136561.97358687877,1908,3,298.05882352941177,32,2,15,32.0641292800523,0.6555989583333333,42.48737373737373,1030.0505050505042,32.189078282828255,0
2388,4,0,0,34,0.0,0.0,1.0,34,1000,700,300,0.7,13,7,6,408.3396410034601,0.41332442067736186,0.16338667820069208,0.2479204963235294,132690.54178145085,4036.5616391184535,136727.1034205693,1909,4,299.05882352941177,32,2,15,31.906403186274503,0.65625,42.42424242424242,1030.3030303030303,32.196969696969695,0
2389,4,0,0,34,0.0,0.0,1.0,34,1050,900,150,0.8571428571428571,12,9,3,404.5994487399146,0.412618835412953,0.15989609917424752,0.24683793779904994,132871.3884833957,3951.9381067377813,136823.32659013348,1910,5,300.05882352941177,33,1,16,31.820174135266846,0.6556186868686869,42.248774509803916,1031.0049019607836,31.242572786690413,0
2390,4,0,1,33,0.0,0.029411764705882353,0.9705882352941176,34,1100,700,400,0.6363636363636364,15,7,8,400.4359707525661,0.4124517231134878,0.1007691551924994,0.23804640474099337,131893.99059256038,3763.019631872337,135657.0102244327,1911,6,301.05882352941177,33,1,15,32.91527479519605,0.6458333333333333,43.198529411764696,1027.2058823529399,31.127450980392116,8
2391,4,0,0,33,0.0,0.0,1.0,33,900,700,200,0.7777777777777778,11,7,4,406.13460702401215,0.4103140782828283,0.11537057320189814,0.2411313060973225,131846.31191970222,4109.470015814729,135955.78193551695,1912,32,311.0,32,1,16,32.81723834111958,0.6477864583333333,43.2449494949495,1027.020202020203,32.09438131313134,0
2392,4,0,1,32,0.0,0.030303030303030304,0.9696969696969697,33,850,500,350,0.5882352941176471,12,5,7,404.7271081584134,0.409603851010101,0.1109646477058619,0.2411178042601148,131976.01807213554,4082.8544281195877,136058.87250025512,1913,33,312.0,32,1,16,32.722003768329664,0.6490885416666667,43.11868686868687,1027.5252525252529,32.11016414141415,0
2393,4,0,0,32,0.0,0.0,1.0,32,800,600,200,0.75,10,6,4,409.58933681740876,0.4086651545698925,0.13395176105409834,0.24436044108086244,132029.74319458022,4415.594991048192,136445.3381856284,1914,34,319.625,31,1,16,32.542680222982376,0.6522177419354839,43.06640625000001,1027.7343750000011,33.15272177419359,0
2394,4,0,0,32,0.0,0.0,1.0,32,850,600,250,0.7058823529411765,11,6,5,407.47845876110637,0.40793010752688175,0.1321841355288158,0.24353084268879166,132096.6614617243,4365.308803982226,136461.9702657065,1915,35,320.625,31,1,16,32.52915875026388,0.6528897849462365,43.00130208333334,1027.9947916666677,33.16112231182799,0
2395,4,0,0,32,0.0,0.0,1.0,32,600,100,500,0.16666666666666666,11,1,10,408.7073187506477,0.4075730846774193,0.1329470618034443,0.24448128703447852,132130.12695312515,4400.509982638904,136530.63693576405,1916,36,321.625,31,1,16,32.463694697737246,0.6532258064516129,42.96875000000001,1028.1250000000011,33.165322580645196,0
2396,4,0,0,32,0.0,0.0,1.0,32,1350,1000,350,0.7407407407407407,17,10,7,410.76551862726154,0.40847614247311825,0.13043701758825743,0.24724142374038444,132364.50407240124,4474.154832628034,136838.65890502927,1917,37,322.625,31,1,16,32.173568054325344,0.6555779569892473,42.740885416666664,1029.0364583333333,33.19472446236559,0
2397,4,1,0,33,0.030303030303030304,0.0,1.0,33,700,400,300,0.5714285714285714,10,4,6,399.83509948096884,0.410708648989899,0.13239750445632792,0.24275702468487398,132690.54178145083,4010.8671946740087,136701.40897612483,1918,0,313.8181818181818,32,1,17,32.12545955882352,0.65625,42.42424242424242,1030.30303030303,32.19696969696969,0
2398,4,0,0,33,0.0,0.0,1.0,33,750,400,350,0.5333333333333333,11,4,7,424.60707572216614,0.4099589646464647,0.172242535402499,0.2502722632422618,131569.33108235046,4697.917478875392,136267.24856122586,1919,1,314.8181818181818,30,3,17,32.62424123324163,0.6503472222222222,43.51478494623655,1025.940860215053,34.1980286738351,8
2399,4,0,0,33,0.0,0.0,1.0,33,1450,1000,450,0.6896551724137931,19,10,9,424.7272451340835,0.40972222222222227,0.1735353270894573,0.25170608421871715,131776.255293242,4593.793176956873,136370.04847019888,1920,2,315.8181818181818,30,3,18,32.41098311297288,0.6524305555555556,43.31317204301075,1026.747311827957,34.22491039426523,0
2400,4,0,0,33,0.0,0.0,1.0,33,1050,600,450,0.5714285714285714,15,6,9,425.7677061870332,0.4092092803030303,0.17531759716193962,0.2537018015432478,131983.3420951844,4638.848963753032,136622.19105893743,1921,3,316.8181818181818,30,3,19,32.17407891868323,0.6545138888888888,43.111559139784944,1027.5537634408602,34.25179211469534,0
2401,4,1,0,34,0.029411764705882353,0.0,1.0,34,500,400,100,0.8,6,4,2,415.818733014804,0.41185754604872254,0.16965104441187306,0.2496444523118357,132268.09007052862,4199.909926283045,136467.99999681168,1922,0,308.47058823529414,32,2,20,32.14117671126386,0.6520182291666667,42.834595959595966,1028.6616161616168,32.14567550505053,0
2402,4,0,0,34,0.0,0.0,1.0,34,1000,700,300,0.7,13,7,6,416.1681063449653,0.41163472964943554,0.1627768516313408,0.2507159079687964,132398.00347222236,4219.9652777777965,136617.96875000017,1923,1,309.47058823529414,32,2,20,32.00067476383266,0.6533203125,42.70833333333334,1029.1666666666679,32.16145833333337,0
2403,4,0,0,34,0.0,0.0,1.0,34,850,500,350,0.5882352941176471,12,5,7,414.31185779693055,0.4119318181818182,0.1574579694784295,0.25005630566325393,132467.1769315818,4176.544434327682,136643.7213659095,1924,2,310.47058823529414,30,4,21,31.978445837141496,0.659375,42.64112903225807,1029.4354838709687,34.31451612903229,0
2404,4,0,0,34,0.0,0.0,1.0,34,950,500,450,0.5263157894736842,14,5,9,416.3601404988537,0.411968954248366,0.16352664793403626,0.2519866821881691,132570.9709937566,4239.453621806001,136810.4246155626,1925,3,311.47058823529414,30,4,21,31.820727834333947,0.6604166666666667,42.54032258064517,1029.8387096774202,34.32795698924734,0
2405,4,0,0,34,0.0,0.0,1.0,34,500,300,200,0.6,7,3,4,416.6930553235046,0.411764705882353,0.16634170306514884,0.25242046505486304,132605.57804731766,4251.164693895251,136856.74274121292,1926,4,312.47058823529414,30,4,21,31.77715429118274,0.6607638888888889,42.50672043010753,1029.9731182795701,34.33243727598567,0
2406,4,0,0,34,0.0,0.0,1.0,34,600,500,100,0.8333333333333334,7,5,2,414.4170302038298,0.41128193701723115,0.16020341402486205,0.25144689746723153,132666.1512586805,4195.822482638885,136861.97374131938,1927,5,313.47058823529414,31,3,19,31.77451971688574,0.6586021505376345,42.447916666666664,1030.208333333333,33.23252688172042,0
2407,4,0,1,33,0.0,0.029411764705882353,0.9705882352941176,34,850,600,250,0.7058823529411765,11,6,5,413.2208708871825,0.411096256684492,0.16491251542315188,0.2511697367281999,132733.2305908203,4169.628228081598,136902.8588189019,1928,6,314.47058823529414,31,3,19,31.737532642574344,0.6592741935483871,42.3828125,1030.46875,33.24092741935484,0
2408,4,0,0,33,0.0,0.0,1.0,33,950,600,350,0.631578947368421,13,6,7,420.529688494895,0.40968276515151514,0.15511578547968274,0.2556860524734624,132744.05142574292,4564.562919123605,137308.6143448665,1929,7,319.90909090909093,30,3,19,31.53830268249206,0.6621527777777778,42.37231182795699,1030.5107526881725,34.35035842293908,0
2409,4,0,0,33,0.0,0.0,1.0,33,750,400,350,0.5333333333333333,11,4,7,419.4384693013231,0.4092881944444444,0.15630025644369105,0.25549433050610393,132813.31521346408,4541.40272719391,137354.71794065798,1930,8,320.90909090909093,30,3,19,31.496392402312342,0.6628472222222221,42.30510752688173,1030.779569892474,34.3593189964158,0
2410,4,0,0,33,0.0,0.0,1.0,33,1100,500,600,0.45454545454545453,17,5,12,416.47591625970347,0.40913036616161613,0.15377020564039978,0.2546310522279447,132951.89698592326,4474.252623135626,137426.1496090589,1931,9,321.90909090909093,30,3,19,31.432729484339013,0.6642361111111111,42.170698924731184,1031.3172043010757,34.377240143369185,0
2411,4,0,1,32,0.0,0.030303030303030304,0.9696969696969697,33,900,700,200,0.7777777777777778,11,7,4,415.4486510881967,0.40778882575757575,0.15028344939757154,0.25471116978857794,133055.88073765743,4455.577234362341,137511.45797201977,1932,10,322.90909090909093,30,3,19,31.35422094841063,0.6652777777777779,42.06989247311827,1031.720430107526,34.3906810035842,0
2412,4,0,0,32,0.0,0.0,1.0,32,350,300,50,0.8571428571428571,4,3,1,427.78024208531525,0.40454889112903225,0.16081290409482785,0.2611710951678765,132898.76543209865,4970.293209876528,137869.05864197516,1933,15,333.6875,29,3,19,31.194998204022987,0.6666666666666667,42.222222222222214,1031.1111111111102,35.55555555555552,0
2413,4,0,0,32,0.0,0.0,1.0,32,850,600,250,0.7058823529411765,11,6,5,427.9271637771067,0.4051369287634408,0.1625100969305331,0.26226427166141497,133042.01388888893,4986.458333333338,138028.47222222228,1934,16,334.6875,29,3,19,31.04637856758213,0.6681034482758621,42.083333333333336,1031.666666666667,35.57471264367817,0
2414,4,0,0,32,0.0,0.0,1.0,32,900,700,200,0.7777777777777778,11,7,4,425.8136505998562,0.4051369287634408,0.15995121130551815,0.2614706961947877,133113.66705246907,4936.323302469129,138049.9903549382,1935,17,335.6875,29,3,19,31.02848811126065,0.6688218390804598,42.013888888888886,1031.9444444444441,35.58429118773945,0
2415,4,0,0,32,0.0,0.0,1.0,32,1200,900,300,0.75,15,9,6,427.66970774282754,0.4049479166666667,0.15746889710827183,0.2638775333666324,133292.8843557098,5001.065779320975,138293.95013503078,1936,18,336.6875,29,3,19,30.799568482403053,0.670617816091954,41.84027777777777,1032.6388888888882,35.6082375478927,0
2416,4,0,0,32,0.0,0.0,1.0,32,500,300,200,0.6,7,3,4,427.0194963314551,0.4049269153225807,0.15552735950524332,0.26424051694786715,133400.47260802466,4992.92052469135,138393.393132716,1937,19,337.6875,29,3,19,30.70773953571749,0.6716954022988506,41.73611111111111,1033.0555555555552,35.62260536398466,0
2417,4,0,0,32,0.0,0.0,1.0,32,1250,1000,250,0.8,15,10,5,426.6298501525176,0.4041498655913978,0.15201057756883807,0.2657957518314221,133651.6806520062,5003.95929783951,138655.63994984573,1938,20,338.6875,29,3,19,30.464377658383707,0.6742097701149425,41.49305555555556,1034.027777777778,35.65613026819924,0
2418,4,0,0,32,0.0,0.0,1.0,32,650,300,350,0.46153846153846156,10,3,7,429.9883177858685,0.40343581989247307,0.154244158721633,0.26840930448879824,133723.49778163584,5099.908371913588,138823.40615354944,1939,21,339.6875,29,3,19,30.305128463363328,0.6749281609195402,41.423611111111114,1034.3055555555559,35.66570881226055,0
2419,4,0,0,32,0.0,0.0,1.0,32,1300,900,400,0.6923076923076923,17,9,8,430.4000109803412,0.4024697580645162,0.15040346933297566,0.2697149269818773,133867.1899112654,5123.288001543208,138990.4779128086,1940,22,340.6875,29,3,19,30.149616382588473,0.6763649425287357,41.28472222222222,1034.8611111111109,35.68486590038313,0
2420,4,0,0,32,0.0,0.0,1.0,32,1000,700,300,0.7,13,7,6,431.15780543707154,0.40146169354838707,0.15425442715320625,0.27098231717773436,133975.00964506165,5152.87422839505,139127.8838734567,1941,23,341.6875,29,3,19,30.02135318844468,0.6774425287356323,41.18055555555555,1035.2777777777771,35.69923371647507,0
2421,4,0,0,32,0.0,0.0,1.0,32,750,400,350,0.5333333333333333,11,4,7,433.009564552672,0.40095766129032256,0.15950241416309008,0.2726789960561418,134046.91358024676,5208.719135802445,139255.6327160492,1942,24,342.6875,29,3,19,29.900974606580824,0.6781609195402298,41.1111111111111,1035.5555555555543,35.708812260536355,0
2422,4,0,0,32,0.0,0.0,1.0,32,1300,1100,200,0.8461538461538461,15,11,4,430.0380534920838,0.40001260080645157,0.1560572797962192,0.271604897628912,134154.80565200603,5138.334297839487,139293.13994984553,1943,25,343.6875,29,3,19,29.86925749653661,0.6792385057471264,41.006944444444436,1035.9722222222213,35.72318007662832,0
2423,4,0,0,32,0.0,0.0,1.0,32,1000,600,400,0.6,14,6,8,433.75958425216123,0.39984459005376344,0.1543738273921198,0.2747634989549767,134262.74112654314,5247.550154320973,139510.29128086413,1944,26,344.6875,29,3,19,29.66418743857767,0.680316091954023,40.90277777777777,1036.3888888888885,35.73754789272029,0
2424,4,0,0,32,0.0,0.0,1.0,32,1150,600,550,0.5217391304347826,17,6,11,435.74451572455166,0.39952956989247307,0.16019234632382506,0.2773831456875726,134442.73003472216,5316.5364583333285,139759.2664930555,1945,27,345.6875,29,3,19,29.431582295433255,0.6821120689655172,40.729166666666664,1037.083333333333,35.761494252873554,0
2425,4,0,0,32,0.0,0.0,1.0,32,650,400,250,0.6153846153846154,9,4,5,435.3155594264606,0.39946656586021506,0.15650100401606415,0.27793224178766335,134550.78125000003,5314.409722222223,139865.19097222225,1946,28,346.6875,29,3,20,29.33400267737617,0.6831896551724138,40.625,1037.5000000000002,35.77586206896552,0
2426,4,0,0,32,0.0,0.0,1.0,32,900,600,300,0.6666666666666666,12,6,6,435.3155594264606,0.39946656586021506,0.15650100401606415,0.27793224178766335,134550.78125000003,5314.409722222223,139865.19097222225,1947,29,347.6875,29,3,20,29.33400267737617,0.6831896551724138,40.625,1037.5000000000002,35.77586206896552,0
2427,4,0,0,32,0.0,0.0,1.0,32,1100,700,400,0.6363636363636364,15,7,8,435.5804654094526,0.399403561827957,0.15761360594297935,0.27837653182840194,134586.8079668209,5324.676890432086,139911.48485725297,1948,30,348.6875,29,3,20,29.290897024048544,0.6835488505747127,40.59027777777777,1037.6388888888882,35.780651340996144,0
2428,4,0,0,32,0.0,0.0,1.0,32,800,500,300,0.625,11,5,6,429.76253062046294,0.3979754704301075,0.15127508361204023,0.27574891986162736,134730.96305941354,5180.46392746913,139911.42698688267,1949,31,349.6875,29,3,21,29.29696209587513,0.6849856321839081,40.451388888888886,1038.1944444444441,35.79980842911876,0
2429,4,0,1,31,0.0,0.03125,0.96875,32,1250,1200,50,0.96,13,12,1,430.8590326480129,0.39724042338709675,0.15196299638989164,0.27755337684534787,134875.1953125,5222.43923611111,140097.63454861112,1950,32,350.6875,29,3,19,29.12362949592192,0.6864224137931034,40.3125,1038.75,35.81896551724138,0
2430,4,0,1,30,0.0,0.03225806451612903,0.967741935483871,31,550,300,250,0.5454545454545454,8,3,5,437.76213260510167,0.39601254480286735,0.14290496659034035,0.28121839398551735,134774.4732832937,5599.832169044787,140374.30545233848,1951,33,355.5483870967742,28,3,21,29.045592915455927,0.6886160714285714,40.40948275862069,1038.3620689655172,37.08435960591133,0
2431,4,0,0,30,0.0,0.0,1.0,30,900,800,100,0.8888888888888888,10,8,2,441.000298937306,0.3947796934865901,0.1494315467660261,0.28336096556026913,134782.46572066328,5887.821534863946,140670.28725552722,1952,34,363.3666666666667,27,3,19,28.95349670392663,0.6921296296296297,40.401785714285715,1038.3928571428573,38.458994708994716,0
2432,4,0,1,29,0.0,0.03333333333333333,0.9666666666666667,30,700,600,100,0.8571428571428571,8,6,2,439.2348788208204,0.39492337164750957,0.14405404159173685,0.2827452305428059,134849.0785812194,5846.083737944236,140695.16231916362,1953,35,364.3666666666667,28,2,19,28.932367316825736,0.6893601190476191,40.337643678160916,1038.649425287356,37.09462233169129,0
2433,4,0,0,29,0.0,0.0,1.0,29,1000,700,300,0.7,13,7,6,434.0000109717261,0.39526888341543515,0.12466806828854327,0.2805292296120192,134998.35110731277,5917.857172347737,140916.20827966052,1954,36,370.48275862068965,28,1,20,28.918383335637582,0.6908482142857143,40.19396551724138,1039.2241379310349,37.115147783251246,0
2434,4,0,0,29,0.0,0.0,1.0,29,300,100,200,0.3333333333333333,5,1,4,434.67325409936734,0.39485837438423643,0.12732022155911205,0.2812545903537409,135035.68214096982,5939.279875148637,140974.96201611846,1955,37,371.48275862068965,28,1,20,28.863411206340423,0.6912202380952381,40.1580459770115,1039.3678160919546,37.120279146141236,0
2435,4,0,0,29,0.0,0.0,1.0,29,750,400,350,0.5333333333333333,11,4,7,428.0952515909192,0.3941399835796387,0.12065583907401844,0.251708723711366,131475.43640177045,5456.802004888373,136932.2384066588,1956,38,372.48275862068965,28,1,20,32.630230223218454,0.6555059523809523,43.606321839080465,1025.5747126436788,36.627668308702816,8
2436,4,0,0,29,0.0,0.0,1.0,29,850,600,250,0.7058823529411765,11,6,5,425.37778854381054,0.39419129720853857,0.11656157359572816,0.25107836080825563,131622.8303771964,5397.8857015457725,137020.71607874217,1957,39,373.48275862068965,28,1,19,32.55011434705497,0.6569940476190477,43.462643678160916,1026.1494252873558,36.64819376026271,0
2437,4,0,0,29,0.0,0.0,1.0,29,750,500,250,0.6666666666666666,10,5,5,424.2802674528402,0.3937807881773399,0.11689577943391116,0.2509154164472758,131696.55833003047,5375.250198176786,137071.80852820727,1958,40,374.48275862068965,28,1,19,32.50338279208661,0.6577380952380952,43.390804597701155,1026.436781609196,36.65845648604272,0
2438,4,0,0,29,0.0,0.0,1.0,29,750,500,250,0.6666666666666666,10,5,5,420.17247088023527,0.3937807881773399,0.11415115280311161,0.24896786707381097,131770.30692627822,5273.251089972258,137043.5580162505,1959,41,375.48275862068965,28,1,19,32.53393506856984,0.6584821428571428,43.31896551724138,1026.7241379310344,36.668719211822655,0
2439,4,0,1,28,0.0,0.034482758620689655,0.9655172413793104,29,1000,900,100,0.9,11,9,2,419.6905698167699,0.39321633825944174,0.109617453128241,0.24940713912053925,131880.96852705107,5269.839765821109,137150.80829287219,1960,42,376.48275862068965,28,1,19,32.434023406537044,0.6595982142857143,43.21120689655172,1027.1551724137928,36.6841133004926,0
2440,4,0,0,28,0.0,0.0,1.0,28,300,100,200,0.3333333333333333,5,1,4,429.3909677642069,0.3933256172839506,0.10290951621918154,0.25479166539473685,131824.31452398663,5720.833997661558,137545.1485216482,1961,43,381.2142857142857,27,1,19,32.24245882239289,0.6624228395061729,43.266369047619044,1026.9345238095234,38.03461199294531,0
2441,4,0,0,28,0.0,0.0,1.0,28,1000,500,500,0.5,15,5,10,430.8588096388828,0.39095568783068785,0.09730811392169403,0.25721190995468995,132053.64062942882,5779.2948820153015,137832.9355114441,1962,44,382.2142857142857,27,1,21,31.971942715119926,0.6647376543209876,43.04315476190476,1027.8273809523807,38.0676807760141,0
2442,4,0,0,28,0.0,0.0,1.0,28,400,100,300,0.25,7,1,6,430.4031913855658,0.3912037037037037,0.09473488295144361,0.25719941575185873,132091.88102324255,5770.553429705199,137862.43445294775,1963,45,383.2142857142857,27,1,21,31.94484655471917,0.6651234567901234,43.00595238095237,1027.9761904761897,38.07319223985888,0
2443,4,0,0,28,0.0,0.0,1.0,28,800,600,200,0.75,10,6,4,430.4031913855658,0.3912037037037037,0.09473488295144361,0.25719941575185873,132091.88102324255,5770.553429705199,137862.43445294775,1964,46,384.2142857142857,27,1,21,31.94484655471917,0.6651234567901234,43.00595238095237,1027.9761904761897,38.07319223985888,0
2444,4,0,0,28,0.0,0.0,1.0,28,700,500,200,0.7142857142857143,9,5,4,420.9934946679199,0.3915068342151675,0.09141666834789319,0.23454405473985368,129384.04439572597,5293.968200885192,134678.01259661117,1965,47,385.2142857142857,28,0,20,34.94592336299018,0.6343005952380952,45.65373563218391,1017.3850574712642,36.33518062397372,8
2445,4,0,0,28,0.0,0.0,1.0,28,650,500,150,0.7692307692307693,8,5,3,420.4905336972704,0.3913690476190476,0.08304428490763915,0.23491758207503657,129493.69963007006,5290.1749735764415,134783.8746036465,1966,48,386.2142857142857,28,0,19,34.84642621870884,0.6354166666666667,45.54597701149426,1017.8160919540232,36.350574712643684,0
2446,4,0,0,28,0.0,0.0,1.0,28,700,600,100,0.8571428571428571,8,6,2,418.0859659827025,0.39186507936507936,0.08331317285593332,0.23400925394576855,129566.82892390013,5234.014565992866,134800.84348989298,1967,49,387.2142857142857,28,0,19,34.83276883996613,0.6361607142857143,45.474137931034484,1018.1034482758621,36.360837438423644,0
2447,4,0,0,28,0.0,0.0,1.0,28,550,400,150,0.7272727272727273,7,4,3,418.7456337984055,0.39178240740740744,0.08371622030106995,0.23503466334100523,129676.56157104635,5260.298792773151,134936.8603638195,1968,50,388.2142857142857,28,0,19,34.70370762213759,0.6372767857142857,45.366379310344826,1018.5344827586205,36.37623152709359,0
2448,4,0,0,28,0.0,0.0,1.0,28,950,600,350,0.631578947368421,13,6,7,419.3809990756848,0.39153439153439157,0.07883926054210777,0.23649354590166208,129859.55253335975,5292.12577619236,135151.6783095521,1969,51,389.2142857142857,28,0,19,34.50039939855275,0.6391369047619048,45.1867816091954,1019.2528735632184,36.40188834154351,0
2449,4,0,0,28,0.0,0.0,1.0,28,1050,800,250,0.7619047619047619,13,8,5,420.63432993216884,0.39123126102292766,0.07132295250165965,0.2387629397960297,130115.95663644471,5346.247646650811,135462.20428309552,1970,52,390.2142857142857,28,0,21,34.206449795803415,0.6417410714285714,44.935344827586206,1020.2586206896552,36.4378078817734,0
2450,4,0,0,28,0.0,0.0,1.0,28,700,400,300,0.5714285714285714,10,4,6,421.8368568412388,0.39101080246913583,0.07363588825647094,0.23989649272564617,130189.2613992932,5383.725764632059,135572.98716392525,1971,53,391.2142857142857,28,0,21,34.10090806701393,0.6424851190476191,44.86350574712644,1020.5459770114945,36.448070607553376,0
2451,4,0,0,28,0.0,0.0,1.0,28,1200,900,300,0.75,15,9,6,420.9912536443149,0.390680114638448,0.07507288629737596,0.2398671096345516,130262.5868055556,5367.881944444455,135630.46875000006,1972,54,392.2142857142857,28,0,22,34.047619047619044,0.6432291666666667,44.79166666666667,1020.8333333333338,36.45833333333335,0
2452,4,0,0,28,0.0,0.0,1.0,28,750,500,250,0.6666666666666666,10,5,5,421.8833634127387,0.39010141093474426,0.07579108198303253,0.24060218141339643,130299.25724996685,5394.21777975953,135693.47502972637,1973,55,393.2142857142857,28,0,22,33.98741673702974,0.6436011904761905,44.75574712643677,1020.9770114942519,36.463464696223284,0
2453,4,0,0,28,0.0,0.0,1.0,28,850,600,250,0.7058823529411765,11,6,5,422.63166028497074,0.3898809523809524,0.07460406785111329,0.24148439238790761,130372.61362135016,5419.918830096435,135792.5324514466,1974,56,394.2142857142857,28,0,22,33.893441661977114,0.6443452380952381,44.683908045977006,1021.2643678160913,36.47372742200326,0
2454,4,0,0,28,0.0,0.0,1.0,28,800,400,400,0.5,12,4,8,423.7922303785989,0.38952270723104054,0.07906549376393279,0.24329573322703596,130556.09486474436,5465.731726449997,136021.82659119435,1975,57,395.2142857142857,28,0,19,33.6766015277192,0.6462053571428572,44.50431034482759,1021.9827586206898,36.4993842364532,0
2455,4,0,0,28,0.0,0.0,1.0,28,350,100,250,0.2857142857142857,6,1,5,425.251273508765,0.3891093474426808,0.07657938069801973,0.2443649078951012,130592.80659598357,5506.9514632051705,136099.75805918872,1976,58,396.2142857142857,28,0,19,33.60187658138881,0.6465773809523809,44.468390804597696,1022.1264367816088,36.50451559934317,0
2456,4,0,0,28,0.0,0.0,1.0,28,700,500,200,0.7142857142857143,9,5,4,423.480990040258,0.38817239858906527,0.06957158917529904,0.2438099292173524,130666.24554102257,5466.934205311133,136133.1797463337,1977,59,397.2142857142857,28,0,19,33.57223159078132,0.6473214285714286,44.39655172413793,1022.4137931034481,36.514778325123146,0
2457,4,0,0,28,0.0,0.0,1.0,28,1000,800,200,0.8,12,8,4,415.1171662567674,0.3885582010582011,0.10917785917785916,0.2187779660001883,127164.46195005954,4957.6302186550565,132122.0921687146,1978,60,398.2142857142857,28,0,20,37.377433523266866,0.6116071428571428,47.844827586206904,1008.6206896551732,36.02216748768476,8
2458,4,1,0,29,0.034482758620689655,0.0,1.0,29,550,400,150,0.7272727272727273,7,4,3,403.48602079353805,0.3923440065681445,0.11435778054874635,0.21467109211641588,127547.57185571002,4492.732445987673,132040.3043016977,1979,0,385.44827586206895,29,0,20,37.27585475961318,0.6124281609195402,47.465277777777786,1010.1388888888899,34.83237547892724,0
2459,4,1,1,29,0.03333333333333333,0.03333333333333333,0.9666666666666667,30,650,400,250,0.6153846153846154,9,4,5,392.9652958238,0.3984674329501916,0.10242714146514298,0.21094556464835362,127906.48666030754,4052.5620736501323,131959.04873395766,1980,0,373.56666666666666,30,0,21,37.17252413854194,0.6131944444444444,47.11021505376344,1011.5591397849462,33.71863799283154,0
2460,4,1,0,30,0.03333333333333333,0.0,1.0,30,700,500,200,0.7142857142857143,9,5,4,388.5337941370492,0.40301724137931033,0.10152239334395441,0.20963012445847098,128110.51133078965,3955.0526072378266,132065.56393802748,1981,0,368.96666666666664,30,0,22,37.075146043547534,0.6152777777777778,46.90860215053763,1012.3655913978492,33.74551971326164,0
2461,4,0,0,30,0.0,0.0,1.0,30,650,500,150,0.7692307692307693,8,5,3,392.26436769968416,0.4026580459770115,0.09750497677504977,0.212183202485077,128212.58463767493,4058.645688807964,132271.23032648288,1982,1,369.96666666666664,30,0,22,36.87596770625968,0.6163194444444444,46.807795698924735,1012.7688172043015,33.75896057347672,0
2462,4,1,0,31,0.03225806451612903,0.0,1.0,31,950,700,250,0.7368421052631579,12,7,5,384.1564454039101,0.40560035842293907,0.09750281512883352,0.2102069538333759,128672.41753472238,3686.067708333358,132358.48524305574,1983,0,359.0,31,0,20,36.610198494182086,0.6182795698924731,46.35416666666668,1014.5833333333346,32.728494623655955,0
2463,4,0,1,30,0.0,0.03225806451612903,0.967741935483871,31,500,300,200,0.6,7,3,4,385.21239336576053,0.405152329749104,0.09191520358919592,0.211135400414398,128738.47961425791,3718.331570095501,132456.81118435343,1984,1,360.0,31,0,20,36.515802754255425,0.6189516129032258,46.28906250000001,1014.8437500000008,32.73689516129035,0
2464,4,1,1,30,0.03225806451612903,0.03225806451612903,0.967741935483871,31,900,500,400,0.5555555555555556,13,5,8,387.1906443020981,0.40707885304659497,0.10007528812185118,0.2129275489610551,128870.65463595917,3779.5023600260374,132650.15699598522,1985,0,360.8709677419355,31,0,21,36.33036248610754,0.6202956989247312,46.158854166666664,1015.364583333333,32.75369623655913,0
2465,4,2,0,32,0.0625,0.0,1.0,32,650,400,250,0.6153846153846154,9,4,5,376.49412698085786,0.4109753024193548,0.1078991870423236,0.2096346358731702,129361.89746263147,3340.7989299561445,132702.69639258762,1986,0,350.375,32,0,23,36.1003371809193,0.6227213541666667,45.67550505050506,1017.2979797979807,31.790561868686897,0
2466,4,0,0,32,0.0,0.0,1.0,32,750,500,250,0.6666666666666666,10,5,5,378.986391769826,0.41139532930107525,0.11526563081503527,0.21171235648347667,129490.37606175398,3415.0180785124053,132905.39414026638,1987,1,351.375,32,0,20,35.90590497456892,0.6240234375,45.54924242424243,1017.8030303030309,31.806344696969717,0
2467,4,0,0,32,0.0,0.0,1.0,32,850,700,150,0.8235294117647058,10,7,3,380.0003350152339,0.4106812836021505,0.11881821282401095,0.21262614165356214,129554.6392746914,3446.1612654321066,133000.8005401235,1988,2,352.375,32,0,20,35.81457480673032,0.6246744791666667,45.486111111111114,1018.055555555556,31.814236111111125,0
2468,4,0,0,32,0.0,0.0,1.0,32,1150,1000,150,0.8695652173913043,13,10,3,382.3477756865357,0.4102822580645162,0.1285867005453647,0.21481767787179465,129715.36705438221,3519.276413121115,133234.6434675033,1989,3,353.375,32,0,21,35.590966369195186,0.6263020833333333,45.32828282828283,1018.6868686868687,31.833964646464647,0
2469,4,0,1,31,0.0,0.03125,0.96875,32,550,400,150,0.7272727272727273,7,4,3,382.3477756865357,0.4102822580645162,0.1285867005453647,0.21481767787179465,129715.36705438221,3519.276413121115,133234.6434675033,1990,4,354.375,32,0,21,35.590966369195186,0.6263020833333333,45.32828282828283,1018.6868686868687,31.833964646464647,0
2470,4,0,0,31,0.0,0.0,1.0,31,800,700,100,0.875,9,7,2,393.0863575087396,0.40470430107526884,0.13467680043571906,0.21982468834072424,129532.54699707033,3983.4954155815967,133516.04241265194,1991,5,366.64516129032256,31,0,21,35.50407180011938,0.627016129032258,45.5078125,1017.9687500000001,32.83770161290323,0
2471,4,1,0,32,0.03125,0.0,1.0,32,800,500,300,0.625,11,5,6,382.5137785275425,0.40988323252688175,0.13447755417956597,0.21615106799229572,129940.55333958274,3540.810408376695,133481.36374795943,1992,0,356.15625,32,0,22,35.35732714138285,0.6285807291666667,45.10732323232323,1019.5707070707074,31.861584595959606,0
2472,4,1,0,33,0.030303030303030304,0.0,1.0,33,950,700,250,0.7368421052631579,12,7,5,372.3312037735671,0.411300505050505,0.12939091964185034,0.2119717427361613,130231.31315179254,3097.836318963856,133329.14947075638,1993,0,346.3333333333333,33,0,23,35.321242045863855,0.6291035353535354,44.822303921568626,1020.7107843137251,30.930629827688637,0
2473,4,0,0,33,0.0,0.0,1.0,33,950,600,350,0.631578947368421,13,6,7,369.4340004754819,0.41094539141414144,0.128473158888589,0.21101569179701238,130359.2745638199,3031.8334148042863,133391.10797862418,1994,1,347.3333333333333,32,1,23,35.26520771513352,0.6328125,44.69696969696969,1021.2121212121202,31.912878787878757,0
2474,4,0,0,33,0.0,0.0,1.0,33,1050,800,250,0.7619047619047619,13,8,5,371.09167975128304,0.41078756313131315,0.12287502387613647,0.21249135037987454,130455.99819214855,3082.2271005509338,133538.22529269947,1995,2,348.3333333333333,32,1,23,35.124675565443084,0.6337890625,44.60227272727271,1021.5909090909074,31.924715909090857,0
2475,4,0,0,33,0.0,0.0,1.0,33,950,600,350,0.631578947368421,13,6,7,372.14346645429157,0.410748106060606,0.12433490970498262,0.21344841063179143,130520.50053884782,3114.4703027751925,133634.970841623,1996,3,349.3333333333333,32,1,20,35.03233246838832,0.6344401041666667,44.5391414141414,1021.8434343434322,31.932607323232258,0
2476,4,1,0,34,0.029411764705882353,0.0,1.0,34,950,900,50,0.9473684210526315,10,9,1,361.4137986817713,0.41317587641117054,0.11710794297352356,0.20876961782676387,130794.81336805524,2654.2100694444052,133449.02343749965,1997,0,340.02941176470586,33,1,21,35.02842837746096,0.6347853535353536,44.270833333333314,1022.9166666666641,30.99747474747467,0
2477,4,0,0,34,0.0,0.0,1.0,34,700,500,200,0.7142857142857143,9,5,4,378.27841897706276,0.41258169934640526,0.0966386554621852,0.21305548636174945,129811.85154894891,3048.131129795407,132859.9826787443,1998,1,341.02941176470586,32,2,21,35.59632222359889,0.6272786458333333,45.23358585858585,1019.0656565656551,31.845801767676722,8
2478,4,0,0,34,0.0,0.0,1.0,34,1000,800,200,0.8,12,8,4,375.8646498678603,0.41260026737967914,0.10405558954636862,0.212568831395857,129972.73875114776,2970.4315886133977,132943.17033976116,1999,2,342.02941176470586,32,2,21,35.49405646359584,0.62890625,45.07575757575757,1019.696969696969,31.86553030303028,0
2479,4,0,0,34,0.0,0.0,1.0,34,550,300,250,0.5454545454545454,8,3,5,376.2189368689344,0.4122289067142008,0.10676324985439734,0.2134725428301258,130101.52025303539,2989.3311269258215,133090.8513799612,2000,3,343.02941176470586,32,2,21,35.354011963696365,0.6302083333333333,44.94949494949495,1020.2020202020201,31.881313131313128,0
2480,4,0,0,34,0.0,0.0,1.0,34,800,500,300,0.625,11,5,6,376.45812790774005,0.4114490493166964,0.1162970941191026,0.21413870850656322,130198.14822785939,3002.830227782879,133200.97845564227,2001,4,344.02941176470586,32,2,21,35.24964947008124,0.6311848958333333,44.85479797979798,1020.580808080808,31.89315025252525,0
2481,4,0,0,34,0.0,0.0,1.0,34,950,600,350,0.631578947368421,13,6,7,377.18581906862454,0.4101121509209744,0.11851628248678048,0.21526476491234747,130327.04132550239,3031.50236583001,133358.5436913324,2002,5,345.02941176470586,32,2,21,35.10005770578295,0.6324869791666667,44.72853535353535,1021.0858585858576,31.90893308080805,0
2482,4,0,0,34,0.0,0.0,1.0,34,850,500,350,0.5882352941176471,12,5,7,374.65734805493497,0.41052064765300056,0.1173452691745509,0.214176910842146,130391.51178770015,2970.427603050697,133361.93939075083,2003,6,346.02941176470586,32,2,22,35.099105781513984,0.6331380208333333,44.665404040404034,1021.3383838383832,31.916824494949473,0
2483,4,0,0,34,0.0,0.0,1.0,34,950,600,350,0.631578947368421,13,6,7,373.6186108882795,0.4106320558526441,0.11558983454973726,0.2141162747385239,130488.247372717,2950.5675441281405,133438.81491684515,2004,7,347.02941176470586,32,2,19,35.02739331026527,0.6341145833333333,44.570707070707066,1021.7171717171711,31.928661616161598,0
2484,4,1,0,35,0.02857142857142857,0.0,1.0,35,1200,900,300,0.75,15,9,6,361.5807716511898,0.41596638655462187,0.1087138065576021,0.20903575358338836,130826.15460399823,2460.8443867742917,133286.99899077252,2005,0,338.0857142857143,33,2,20,34.99241335249961,0.6351010101010102,44.24019607843136,1023.0392156862727,31.001188354129475,0
2485,4,0,0,35,0.0,0.0,1.0,35,1100,800,300,0.7272727272727273,14,8,6,359.92424322804504,0.4161414565826331,0.10358306188925082,0.20848442013398055,130901.38888888873,2422.916666666648,133324.3055555554,2006,1,339.0857142857143,34,1,20,34.95860477741586,0.633578431372549,44.16666666666666,1023.333333333332,30.098039215686235,0
2486,4,1,1,35,0.027777777777777776,0.027777777777777776,0.9722222222222222,36,700,300,400,0.42857142857142855,11,3,8,358.0476933103424,0.41800595238095234,0.12129715642256311,0.21004814269677557,131389.14399092947,2209.4104308389715,133598.55442176844,2007,0,330.6388888888889,34,2,21,34.51337281312897,0.6384803921568627,43.690476190476176,1025.2380952380931,30.1540616246498,0
2487,4,0,0,35,0.0,0.0,1.0,35,1150,1000,150,0.8695652173913043,13,10,3,356.8720588691409,0.4180672268907563,0.09776024138331207,0.21019593515211102,131541.75347222207,2388.7152777777583,133930.46874999983,1776,1,283.74285714285713,34,1,21,34.38938532358516,0.6400122549019608,43.54166666666666,1025.8333333333321,30.171568627450945,0
2488,4,0,0,35,0.0,0.0,1.0,35,700,400,300,0.5714285714285714,10,4,6,357.17265733926934,0.4178921568627451,0.10278422273781906,0.21087865111400692,131633.36167800447,2403.1675170067956,134036.52919501127,1777,2,284.74285714285713,34,1,17,34.2892014694509,0.6409313725490196,43.45238095238095,1026.1904761904757,30.182072829131638,0
2489,4,0,1,34,0.0,0.02857142857142857,0.9714285714285714,35,800,400,400,0.5,12,4,8,355.78634729033615,0.4177871148459384,0.09932730225005804,0.21039711154576654,131694.45153061216,2371.017573696136,134065.4691043083,1778,3,285.74285714285713,34,1,17,34.26312533828192,0.6415441176470589,43.39285714285714,1026.4285714285706,30.189075630252077,0
2490,4,0,0,34,0.0,0.0,1.0,34,600,300,300,0.5,9,3,6,361.5095296608588,0.416592394533571,0.09198550480364087,0.21384207771464334,131705.2335640137,2722.539407920017,134427.7729719337,1779,4,284.79411764705884,33,1,17,34.10538045208533,0.6439393939393939,43.382352941176464,1026.470588235293,31.105169340463423,0
2491,4,1,0,35,0.02857142857142857,0.0,1.0,35,1100,900,200,0.8181818181818182,13,9,4,350.4517569066595,0.419327731092437,0.0868296073207464,0.2090843135711947,132030.69905045332,2254.0780895691446,134284.77714002246,1780,0,277.62857142857143,34,1,18,34.06116066257385,0.6449142156862745,43.06547619047618,1027.7380952380938,30.227591036414523,0
2492,4,0,1,34,0.0,0.02857142857142857,0.9714285714285714,35,1300,1000,300,0.7692307692307693,16,10,6,349.5049410050948,0.41852240896358545,0.08425790480477158,0.20972656385633193,132249.14969403707,2244.346252357667,134493.49594639475,1781,1,278.62857142857143,35,0,18,33.86559487641122,0.6449404761904762,42.85300925925925,1028.587962962962,29.388227513227484,0
2493,4,0,2,32,0.0,0.058823529411764705,0.9411764705882353,34,650,600,50,0.9230769230769231,7,6,1,362.35497037478024,0.41744652406417115,0.07672618921533303,0.20662417920549586,130293.86421388415,2642.609585941698,132936.47379982585,1782,2,287.2352941176471,33,1,20,35.51231844916576,0.6297348484848485,44.76102941176471,1020.9558823529417,30.93805704099823,8
2494,4,1,0,33,0.030303030303030304,0.0,1.0,33,1050,900,150,0.8571428571428571,12,9,3,404.25756509006675,0.4155224116161616,0.1109358032819141,0.21656848420109318,127825.12825540753,3751.709265932929,131576.83752134047,1783,0,295.90909090909093,32,1,19,36.97064760477795,0.6070963541666667,47.19065656565656,1011.237373737373,31.601167929292906,8
2495,4,2,0,35,0.05714285714285714,0.0,1.0,35,650,500,150,0.7692307692307693,8,5,3,385.94237021493143,0.4227941176470588,0.1145632104167782,0.2104211252678964,128528.34093778691,2921.7036208039917,131450.0445585909,1784,0,279.9428571428571,32,3,17,36.712426845971855,0.6142578125,46.49621212121212,1014.0151515151512,31.687973484848474,0
2496,4,2,0,37,0.05405405405405406,0.0,1.0,37,1400,1100,300,0.7857142857142857,17,11,6,371.3770491365508,0.42924174174174173,0.1252604078517776,0.20579208975181812,129171.97312510682,2194.301242069573,131366.27436717637,1785,0,265.7567567567568,35,2,20,36.42417643933355,0.6139880952380952,45.8622685185185,1016.5509259259231,29.04431216931209,0
2497,4,1,0,38,0.02631578947368421,0.0,1.0,38,900,600,300,0.6666666666666666,12,6,6,359.67128026220587,0.4308321479374111,0.1282599961570039,0.20105557837291732,129516.42679419254,1716.6678080106778,131233.0946022032,1786,0,259.7368421052632,36,2,15,36.370865139949096,0.6154513888888888,45.52364864864863,1017.905405405403,28.275150150150083,0
2498,4,0,0,38,0.0,0.0,1.0,38,1000,700,300,0.7,13,7,6,359.4530699349993,0.4310988620199146,0.12611783884490047,0.20108018268641015,129545.08562616646,1713.0757446635569,131258.16137083003,1787,1,260.7368421052632,36,2,15,36.34725294985252,0.6157407407407407,45.49549549549548,1018.0180180180159,28.278278278278222,0
2499,4,0,1,37,0.0,0.02631578947368421,0.9736842105263158,38,500,200,300,0.4,8,2,6,358.22075204820055,0.430906235182551,0.1231145832726932,0.20053707859243197,129573.74762854047,1683.2010642398848,131256.94869278037,1788,2,261.7368421052632,36,2,15,36.349454337647,0.6160300925925926,45.46734234234233,1018.1306306306287,28.281406406406354,0
2500,4,0,0,37,0.0,0.0,1.0,37,900,700,200,0.7777777777777778,11,7,4,372.40665638045857,0.4270207707707708,0.12824010914051875,0.20837715963883638,129554.63927469117,2249.402006172816,131804.04128086398,1789,3,269.72972972972974,35,2,16,36.00784447476126,0.6178571428571429,45.4861111111111,1018.055555555554,29.087301587301543,0
2501,4,0,0,37,0.0,0.0,1.0,37,1100,800,300,0.7272727272727273,14,8,6,371.151007230649,0.42670795795795796,0.11860940695296529,0.20861246268481298,129731.44531249987,2229.991319444429,131961.4366319443,1790,4,270.72972972972974,35,2,17,35.85974778459439,0.6196428571428572,45.31249999999999,1018.749999999999,29.10714285714283,0
2502,4,0,0,37,0.0,0.0,1.0,37,900,600,300,0.6666666666666666,12,6,6,370.01334285271736,0.4258008008008008,0.11293282835413221,0.20860035193092355,129849.38298396763,2209.200853052111,132058.58383701975,1791,5,271.72972972972974,35,2,17,35.768699371640544,0.6208333333333333,45.19675925925925,1019.2129629629618,29.12037037037034,0
2503,4,1,1,37,0.02631578947368421,0.02631578947368421,0.9736842105263158,38,1550,1200,350,0.7741935483870968,19,12,7,368.784492315752,0.42671289710763394,0.1376377596322924,0.2107439546825178,130377.57087746545,2016.245257081424,132393.81613454688,1792,0,265.55263157894734,36,2,18,35.26321351122874,0.6241319444444444,44.67905405405406,1021.283783783785,28.368993993994028,0
2504,4,1,0,38,0.02631578947368421,0.0,1.0,38,1050,900,150,0.8571428571428571,12,9,3,368.6456623439432,0.42548304883831195,0.1461022019689011,0.21207638293778944,130636.47050766986,2031.7136393149933,132668.18414698486,1793,0,266.3157894736842,36,2,17,35.00403906881106,0.6267361111111112,44.42567567567568,1022.2972972972975,28.39714714714715,0
2505,4,0,0,38,0.0,0.0,1.0,38,1400,1000,400,0.7142857142857143,18,10,8,363.74629750394456,0.4256164058795638,0.13974162152767722,0.210352330542542,130838.01442912505,1918.3686642723778,132756.38309339742,1794,1,267.3157894736842,36,2,17,34.92501375894332,0.6287615740740741,44.2286036036036,1023.0855855855854,28.41904404404404,0
2506,4,0,0,38,0.0,0.0,1.0,38,1200,800,400,0.6666666666666666,16,8,8,360.6883712688016,0.42616465149359883,0.1426111468046558,0.2098361714617537,131068.5405633673,1854.979684075955,132923.52024744326,1795,2,268.3157894736842,36,2,17,34.76987792807653,0.6310763888888888,44.00337837837837,1023.9864864864857,28.444069069069045,0
2507,4,0,0,38,0.0,0.0,1.0,38,1050,700,350,0.6666666666666666,14,7,7,360.15820829079735,0.4262091038406828,0.14271504331017093,0.2095649537213552,131075.36844269364,1841.573969875314,132916.94241256895,1796,3,269.3157894736842,37,1,17,34.77654192097653,0.629222972972973,43.99671052631577,1024.0131578947346,27.676031294452287,0
2508,4,1,0,39,0.02564102564102564,0.0,1.0,39,950,700,250,0.7368421052631579,12,7,5,353.22672908361085,0.4286999550157445,0.14615789869797569,0.20721075272997494,131387.448827589,1482.6421514074393,132870.09097899642,1797,0,263.38461538461536,35,4,18,34.63865056069844,0.6363095238095238,43.69212962962962,1025.2314814814802,29.292328042328005,0
2509,4,0,0,39,0.0,0.0,1.0,39,1100,700,400,0.6363636363636364,15,7,8,352.8886320510097,0.4279127305443095,0.14567436099994535,0.20749476898500283,131476.45968632094,1479.309601123089,132955.76928744404,1798,1,264.38461538461536,35,4,19,34.557447428807876,0.637202380952381,43.60532407407406,1025.578703703702,29.30224867724863,0
2510,4,1,0,40,0.025,0.0,1.0,40,1200,900,300,0.75,15,9,6,342.66384210593816,0.4293135683760683,0.1504577348974896,0.2036115246806685,131876.97991488106,1037.8945245921527,132914.8744394732,1799,0,258.75,36,4,18,34.4159997076344,0.6391782407407407,43.21509009009009,1027.1396396396392,28.531656656656644,0
2511,4,0,1,39,0.0,0.025,0.975,40,1050,800,250,0.7619047619047619,13,8,5,341.83457974392417,0.42891292735042735,0.04708552435757518,0.19926840539265556,131145.89659139744,966.0404892921053,132111.93708068953,1800,1,259.75,40,0,20,35.17441379766513,0.6247395833333333,43.92784552845529,1024.28861788618,25.6072154471545,8
2512,4,0,1,38,0.0,0.02564102564102564,0.9743589743589743,39,750,500,250,0.6666666666666666,10,5,5,345.498390186179,0.4268162393162393,0.0694678046452677,0.20138030057502682,131141.3425021704,1261.8245442708578,132403.16704644126,1801,4,267.38461538461536,39,0,20,35.08519356588359,0.6263354700854701,43.93229166666668,1024.2708333333353,26.26335470085475,0
2513,4,1,0,39,0.02564102564102564,0.0,1.0,39,850,700,150,0.8235294117647058,10,7,3,349.75148614438643,0.425944669365722,0.0963615573817691,0.20530609836385144,131412.4312889541,1392.6044702456295,132805.03575919973,1802,0,268.2564102564103,37,2,21,34.70250507967061,0.6326013513513513,43.667763157894726,1025.3289473684197,27.71159317211945,0
2514,4,0,0,39,0.0,0.0,1.0,39,1100,700,400,0.6363636363636364,15,7,8,349.6370718087488,0.42535425101214575,0.10843894701424439,0.20596412046058904,131547.2334082108,1398.7578986777507,132945.99130688855,1803,1,269.2564102564103,38,1,21,34.56940394362285,0.6321271929824561,43.536324786324776,1025.8547008546993,26.99617633828156,0
2515,4,0,0,39,0.0,0.0,1.0,39,1000,800,200,0.8,12,8,4,346.285757535207,0.42510121457489874,0.10471019715242091,0.2045769364626812,131656.8560979618,1318.1788297172832,132975.03492767908,1804,2,270.2564102564103,38,1,18,34.544815740162385,0.6332236842105263,43.429487179487175,1026.2820512820508,27.007422402159232,0
2516,4,1,1,39,0.025,0.025,0.975,40,1350,1000,350,0.7407407407407407,17,10,7,340.6966279987036,0.4254807692307692,0.10655654641264722,0.2035105523662955,132076.58420138867,999.6093749999762,133076.19357638864,1805,0,264.475,39,1,20,34.265639778408314,0.6356837606837606,43.02083333333332,1027.916666666665,26.356837606837562,0
2517,4,0,1,38,0.0,0.02564102564102564,0.9743589743589743,39,1600,1400,200,0.875,18,14,4,347.5648942159173,0.4228520017993702,0.11291534146302484,0.20832252003252905,132205.65440317022,1390.0088574767826,133595.663260647,1806,1,271.43589743589746,38,1,20,33.95924232980122,0.6387061403508771,42.895299145299134,1028.4188034188019,27.063652721547417,0
2518,4,0,0,38,0.0,0.0,1.0,38,1300,900,400,0.6923076923076923,17,9,8,352.8360759677715,0.42038584637268844,0.12078445233646962,0.21176936843593477,132256.98201610093,1733.0069107802199,133989.98892688114,1807,2,279.0,37,1,20,33.77205255303272,0.6410472972972974,42.845394736842096,1028.61842105263,27.800497866287298,0
2519,4,1,0,39,0.02564102564102564,0.0,1.0,39,900,700,200,0.7777777777777778,11,7,4,346.778906480425,0.4209964012595591,0.12875648941222706,0.21017039015981365,132623.79410010768,1398.3020015774,134022.09610168508,1808,0,272.8205128205128,37,2,21,33.5590980058193,0.6447072072072072,42.489035087719294,1030.0438596491224,27.839023233760066,0
2520,4,0,0,39,0.0,0.0,1.0,39,800,600,200,0.75,10,6,4,369.50362458289953,0.42054655870445345,0.089732830411406,0.2124072868811831,130606.84479827479,1933.5762052584032,132540.42100353318,1809,1,273.8205128205128,33,6,17,35.01216380929546,0.6328914141414141,44.454656862745104,1022.1813725490204,30.975193107546072,8
2521,4,0,0,39,0.0,0.0,1.0,39,1350,1000,350,0.7407407407407407,17,10,7,366.8245310254805,0.42091205578047686,0.08992493681867897,0.21173274857427643,130765.21675936646,1793.5778624399875,132558.79462180645,1810,2,274.8205128205128,35,4,18,34.92005676888837,0.6300595238095238,44.29976851851852,1022.8009259259263,29.22288359788361,0
2522,4,0,0,39,0.0,0.0,1.0,39,750,400,350,0.5333333333333333,11,4,7,365.0826150160725,0.42094017094017094,0.08898944193061853,0.21121271706427228,130854.0166323731,1754.5053155006835,132608.52194787379,1811,3,275.8205128205128,35,4,18,34.874622926093515,0.6309523809523809,44.21296296296296,1023.148148148148,29.23280423280423,0
2523,4,0,0,39,0.0,0.0,1.0,39,700,400,300,0.5714285714285714,10,4,6,366.0310779431073,0.4210807467386415,0.09055710718418553,0.21192408383071462,130883.62328800156,1781.4947434413589,132665.11803144292,1812,4,276.8205128205128,35,4,18,34.82036817102138,0.63125,44.18402777777778,1023.263888888889,29.236111111111114,0
2524,4,0,0,39,0.0,0.0,1.0,39,1600,1000,600,0.625,22,10,12,365.3251514637712,0.42079959514170046,0.08419856577215845,0.21233024243419962,131031.70680084011,1773.8356267146678,132805.54242755478,1813,5,277.8205128205128,35,4,18,34.68846559650312,0.6327380952380952,44.03935185185185,1023.8425925925919,29.252645502645482,0
2525,4,1,1,39,0.025,0.025,0.975,40,900,700,200,0.7777777777777778,11,7,4,355.3251992010741,0.42192841880341886,0.09298171351168283,0.20860344199617734,131417.1157648535,1339.4974654921239,132756.6132303456,1814,0,271.85,35,5,19,34.55490179478497,0.6366071428571429,43.66319444444445,1025.347222222223,29.295634920634946,0
2526,4,0,0,39,0.0,0.0,1.0,39,1300,800,500,0.6153846153846154,18,8,10,359.41703096805463,0.4198717948717949,0.10195679161196436,0.21101969241498678,131419.65880102047,1646.8927154195142,133066.55151644,1815,1,279.1025641025641,34,5,19,34.44744378652427,0.6387867647058824,43.66071428571429,1025.3571428571433,30.1575630252101,0
2527,4,0,2,37,0.0,0.05128205128205128,0.9487179487179487,39,700,300,400,0.42857142857142855,11,3,8,359.78546703065814,0.41945006747638325,0.102587915915058,0.21140463935894224,131450.1771541952,1658.7726757369878,133108.9498299322,1816,2,280.1025641025641,34,5,19,34.40716662796997,0.639093137254902,43.630952380952394,1025.4761904761922,30.16106442577036,0
2528,4,0,0,37,0.0,0.0,1.0,37,900,700,200,0.7777777777777778,11,7,4,371.7281823605706,0.4168230730730731,0.11608844295567478,0.21755322378940556,131297.62081916112,2361.4051870748453,133659.02600623597,1817,3,294.18918918918916,34,3,19,34.25533356564836,0.6375612745098039,43.77976190476191,1024.8809523809534,30.14355742296922,0
2529,4,2,2,37,0.05128205128205128,0.05128205128205128,0.9487179487179487,39,800,500,300,0.625,11,5,6,353.80267866247175,0.4201248313090418,0.11306779847408177,0.21006577486725012,131847.23816609985,1529.5882936508112,133376.82645975065,1818,0,280.05128205128204,34,5,19,34.15995324755613,0.6430759803921569,43.24404761904763,1027.0238095238103,30.206582633053245,0
2530,4,0,0,37,0.0,0.0,1.0,37,1300,800,500,0.6153846153846154,18,8,10,372.80807018539076,0.41529029029029024,0.12034412551399254,0.21947049001348662,131522.32552800738,2406.5168732782404,133928.84240128563,1819,1,295.5135135135135,32,5,21,34.00033850320039,0.64453125,43.56060606060606,1025.757575757576,32.05492424242425,0
2531,4,0,0,37,0.0,0.0,1.0,37,1100,800,300,0.7272727272727273,14,8,6,373.0057213278517,0.4150713213213213,0.11624913950495319,0.22014651396016355,131619.47959710748,2418.963785583109,134038.44338269057,1820,2,296.5135135135135,32,5,19,33.89704072843608,0.6455078125,43.46590909090909,1026.136363636364,32.066761363636374,0
2532,4,0,0,37,0.0,0.0,1.0,37,600,500,100,0.8333333333333334,7,5,2,376.5558821937148,0.4156031031031031,0.0952315787758824,0.20865270826966376,129170.24289035473,2340.9120461555694,131511.15493651028,1821,3,297.5135135135135,33,4,23,36.29432891299981,0.6183712121212122,45.8639705882353,1016.5441176470592,30.804367201426036,8
2533,4,1,0,38,0.02631578947368421,0.0,1.0,38,1200,900,300,0.75,15,9,6,372.9253466293288,0.4211711711711712,0.12766420182688165,0.19619116061803796,127092.01388888873,1879.1704212321993,128971.18431012092,1822,0,290.6578947368421,33,5,18,38.51584022038567,0.5972222222222222,47.91666666666666,1008.333333333332,30.555555555555515,8
2534,4,2,0,40,0.05,0.0,1.0,40,1150,800,350,0.6956521739130435,15,8,7,358.06863806117997,0.42761752136752135,0.14895559116401524,0.19181150770941308,127822.46823827579,1153.8434231395622,128976.31166141536,1823,0,277.075,35,5,19,38.14107149669985,0.600297619047619,47.19328703703703,1011.226851851851,28.892195767195744,0
2535,4,1,2,39,0.024390243902439025,0.04878048780487805,0.9512195121951219,41,900,600,300,0.6666666666666666,12,6,6,350.48311001842364,0.4313770325203252,0.154361214357416,0.1891262400399536,128116.02776763242,780.5007710413012,128896.52853867372,1824,0,271.2926829268293,36,5,20,38.03253615127919,0.6012731481481481,46.90315315315315,1012.3873873873868,28.121871871871853,0
2536,4,0,1,38,0.0,0.02564102564102564,0.9743589743589743,39,1300,1000,300,0.7692307692307693,16,10,6,365.17090020944886,0.4288686459739091,0.16063428276629854,0.1963053435091779,127963.79145408153,1545.7305839002163,129509.52203798175,1825,1,284.3076923076923,34,5,20,37.81670392595208,0.6038602941176471,47.05357142857142,1011.7857142857134,29.758403361344513,0
2537,4,1,0,39,0.02564102564102564,0.0,1.0,39,650,200,450,0.3076923076923077,11,2,9,360.26012211202635,0.4344354475933423,0.14338498766810948,0.19499344526888646,128237.60880730955,1439.9068726755227,129677.51567998507,1826,0,273.79487179487177,33,6,21,37.660692679975796,0.6089015151515151,46.78308823529411,1012.8676470588224,30.692959001782498,0
2538,4,2,1,40,0.04878048780487805,0.024390243902439025,0.975609756097561,41,1050,800,250,0.7619047619047619,13,8,5,344.4786324786326,0.43765243902439027,0.14604127579737347,0.1897551789077212,128936.76757812485,683.1922743055406,129619.9598524304,1827,0,261.390243902439,35,6,20,37.34722222222222,0.6116071428571428,46.09374999999999,1015.6249999999989,29.01785714285711,0
2539,4,1,2,39,0.024390243902439025,0.04878048780487805,0.9512195121951219,41,1250,800,450,0.64,17,8,9,352.5929401381213,0.43544207317073175,0.053714742775612834,0.19524563666789463,129144.15048494442,929.0358004753066,130073.18628541972,1828,0,262.3414634146341,36,5,18,36.92988773173793,0.6116898148148149,45.88963963963964,1016.4414414414416,28.23448448448449,8
2540,4,2,2,39,0.04878048780487805,0.04878048780487805,0.9512195121951219,41,950,800,150,0.8421052631578947,11,8,3,353.0873110658623,0.4358739837398374,0.08830131664148455,0.19751913935862622,129545.0856261669,948.1451891080455,130493.23081527495,1829,0,263.1463414634146,36,5,14,36.50926438053095,0.6157407407407407,45.495495495495504,1018.0180180180196,28.27827827827832,0
2541,4,2,3,38,0.04878048780487805,0.07317073170731707,0.926829268292683,41,1100,600,500,0.5454545454545454,16,6,10,351.7120317515753,0.43605182926829267,0.09696760464231935,0.19718114712520107,129631.08114448907,918.5621854963094,130549.64332998538,1830,0,264.0487804878049,36,5,14,36.45683585830662,0.6166087962962963,45.41103603603604,1018.3558558558557,28.287662662662658,0
2542,4,1,0,39,0.02564102564102564,0.0,1.0,39,1050,600,450,0.5714285714285714,15,6,9,370.2541048978395,0.43069613135402607,0.11109011109011124,0.20642934341564487,129413.2812500001,1783.1597222222372,131196.44097222234,1831,0,278.5128205128205,34,5,20,36.20666120666123,0.6185661764705883,45.62500000000001,1017.5000000000008,29.92647058823532,0
2543,4,2,2,39,0.04878048780487805,0.04878048780487805,0.9512195121951219,41,700,400,300,0.5714285714285714,10,4,6,352.9551540497998,0.43409552845528454,0.12506933636348916,0.20006682011158247,130061.48674011863,981.1744176609199,131042.66115777956,1832,0,265.8780487804878,36,5,18,35.98798483844853,0.6209490740740741,44.988738738738746,1020.0450450450461,28.334584584584615,0
2544,4,0,0,39,0.0,0.0,1.0,39,900,600,300,0.6666666666666666,12,6,6,369.59235262537516,0.43249550157444894,0.13040652451936174,0.2083002061109834,129837.58680555562,1797.3958333333387,131634.98263888896,1833,1,279.53846153846155,34,5,18,35.79142818206595,0.6228553921568627,45.208333333333336,1019.1666666666672,29.975490196078447,0
2545,4,0,1,38,0.0,0.02564102564102564,0.9743589743589743,39,1250,900,350,0.72,16,9,7,369.00677039495224,0.4325236167341431,0.1309150579266194,0.20829301086960952,129898.25857426297,1786.6673752834363,131684.92594954642,1834,2,280.53846153846155,34,5,18,35.74462805091673,0.623468137254902,45.14880952380952,1019.4047619047614,29.982492997198865,0
2546,4,0,0,38,0.0,0.0,1.0,38,800,600,200,0.75,10,6,4,375.92627452823075,0.4300912754860123,0.12808452451793428,0.21146488812095485,129762.65889321416,2156.238586120722,131918.89747933488,1835,3,288.6578947368421,33,5,19,35.706338705797435,0.6243686868686869,45.28186274509804,1018.872549019608,30.87492572786691,0
2547,4,0,0,38,0.0,0.0,1.0,38,1000,800,200,0.8,12,8,4,375.7604474852072,0.43059506875296344,0.1376771255060727,0.2123863398829432,129950.01922337567,2166.0154748173854,132116.03469819305,1836,4,289.6578947368421,33,5,21,35.51983173076923,0.6262626262626263,45.09803921568628,1019.6078431372553,30.897207367795612,0
2548,4,0,0,38,0.0,0.0,1.0,38,1250,800,450,0.64,17,8,9,376.62583767131656,0.4305654338549076,0.13262879621548485,0.21321634157147623,130012.50270328743,2193.2135476740063,132205.71625096144,1837,5,290.6578947368421,33,5,21,35.434190499078774,0.6268939393939394,45.03676470588237,1019.8529411764725,30.904634581105228,0
2549,4,0,1,37,0.0,0.02631578947368421,0.9736842105263158,38,1150,900,250,0.782608695652174,14,9,5,376.1785569353136,0.4306395211000474,0.13118697645013433,0.2134755614510217,130106.25608239631,2188.636732266452,132294.89281466277,1838,6,291.6578947368421,33,5,21,35.35022522522524,0.6278409090909092,44.94485294117648,1020.220588235295,30.915775401069546,0
2550,4,0,0,37,0.0,0.0,1.0,37,1150,500,650,0.43478260869565216,18,5,13,383.8357283280667,0.42714589589589586,0.13569694416019562,0.21815473673329394,130165.93491735558,2592.467286501401,132758.402203857,1839,7,300.13513513513516,32,5,22,35.09419079435783,0.630859375,44.88636363636365,1020.4545454545472,31.8892045454546,0
2551,4,0,0,37,0.0,0.0,1.0,37,750,600,150,0.8,9,6,3,383.07139214399217,0.4263638638638639,0.13208606924589095,0.21808092493605882,130230.36552392627,2577.5054841342912,132807.87100806055,1840,8,301.13513513513516,32,5,22,35.048140359557976,0.6315104166666667,44.82323232323233,1020.7070707070719,31.897095959595998,0
2552,4,0,0,37,0.0,0.0,1.0,37,800,600,200,0.75,10,6,4,382.34069137859206,0.4263013013013013,0.13061224489795897,0.21784527764594228,130262.58680555574,2560.9375000000246,132823.52430555577,1841,9,302.13513513513516,32,5,22,35.034013605442176,0.6318359375,44.79166666666668,1020.8333333333348,31.901041666666714,0
2553,4,1,0,38,0.02631578947368421,0.0,1.0,38,1400,1000,400,0.7142857142857143,18,10,8,373.5985566343902,0.42718705547652913,0.13671404328873238,0.2151092310559503,130669.48596993953,2163.586270905431,132833.07224084495,1842,0,295.1578947368421,33,5,17,34.843956011027196,0.6335227272727273,44.39338235294118,1022.426470588236,30.982620320855638,0
2554,4,0,1,37,0.0,0.02631578947368421,0.9736842105263158,38,1050,800,250,0.7619047619047619,13,8,5,373.3464019730581,0.4275574917022285,0.13855110287396522,0.21601310534116872,130857.49959450704,2171.0353289600316,133028.5349234671,1843,1,296.1578947368421,33,5,18,34.65971473629576,0.6354166666666667,44.20955882352942,1023.1617647058833,31.004901960784345,0
2555,4,0,0,37,0.0,0.0,1.0,37,900,700,200,0.7777777777777778,11,7,4,370.433447468475,0.4261761761761762,0.13793103448275845,0.21485139953171567,130951.55709342571,2301.767349096514,133253.32444252222,1844,2,300.9189189189189,33,4,18,34.638908844189025,0.6363636363636364,44.117647058823536,1023.5294117647068,31.01604278074869,0
2556,4,0,1,36,0.0,0.02702702702702703,0.972972972972973,37,1200,700,500,0.5833333333333334,17,7,10,371.0224858196416,0.42517517517517517,0.13426538154376422,0.21642546817630035,131171.15600069688,2333.4896734429117,133504.64567413979,1845,3,301.9189189189189,33,4,21,34.40141863061769,0.6385732323232323,43.90318627450981,1024.3872549019611,31.042038027332154,0
2557,4,0,1,35,0.0,0.027777777777777776,0.9722222222222222,36,500,300,200,0.6,7,3,4,380.68579751824797,0.4218915343915344,0.13876556912073035,0.2212889700412526,131037.09323347113,2776.7920684113956,133813.88530188252,1846,4,310.9166666666667,32,4,21,34.289832285115324,0.6396484375,44.034090909090914,1023.8636363636367,31.995738636363647,0
2558,4,2,1,36,0.05405405405405406,0.02702702702702703,0.972972972972973,37,1350,1000,350,0.7407407407407407,17,10,7,386.55493614812525,0.41920045045045046,0.16811223831281152,0.22865707239948418,131705.23356401382,2782.2616301422527,134487.49519415607,1847,0,302.81081081081084,33,4,16,33.462671123845915,0.6439393939393939,43.38235294117647,1026.470588235294,31.10516934046345,0
2559,4,0,0,36,0.0,0.0,1.0,36,1100,900,200,0.8181818181818182,13,9,4,391.62281449562914,0.4182374338624339,0.1703029308836399,0.23133068577183674,131651.87225793282,3111.575349454133,134763.44760738694,1848,1,312.22222222222223,32,4,16,33.3866469816273,0.6458333333333333,43.43434343434343,1026.2626262626259,32.07070707070706,0
2560,4,0,0,36,0.0,0.0,1.0,36,700,400,300,0.5714285714285714,10,4,6,392.55184433763145,0.41875,0.17175071750717485,0.23227412623471214,131716.66953627186,3141.1243112947714,134857.79384756665,1849,2,313.22222222222223,32,4,16,33.29720172201722,0.646484375,43.371212121212125,1026.515151515152,32.0785984848485,0
2561,4,0,0,36,0.0,0.0,1.0,36,700,500,200,0.7142857142857143,9,5,4,391.35339482557805,0.4187665343915344,0.17055781030076944,0.23176215974703382,131749.07415378527,3112.0894870421357,134861.1636408274,1850,3,314.22222222222223,32,4,16,33.29515639732711,0.6468098958333333,43.339646464646464,1026.6414141414139,32.08254419191918,0
2562,4,0,0,36,0.0,0.0,1.0,36,1200,800,400,0.6666666666666666,16,8,8,389.0166125076471,0.4181547619047619,0.1651777176734146,0.23096796541147457,131846.31191970207,3058.081126925823,134904.3930466279,1851,4,315.22222222222223,32,4,16,33.256751495779035,0.6477864583333333,43.244949494949495,1027.020202020202,32.094381313131315,0
2563,4,0,0,36,0.0,0.0,1.0,36,1000,700,300,0.7,13,7,6,393.2533817258345,0.4174437830687831,0.15629479461031237,0.2344827306861954,132008.45457415062,3182.554235537188,135191.0088096878,1852,5,316.22222222222223,32,4,17,32.983935372895914,0.6494140625,43.08712121212121,1027.6515151515152,32.11410984848485,0
2564,4,0,1,35,0.0,0.027777777777777776,0.9722222222222222,36,1050,600,450,0.5714285714285714,15,6,9,394.61037115447783,0.4172949735449736,0.1568432761468017,0.23569501332124745,132073.33953486884,3223.501906693188,135296.84144156202,1853,6,317.22222222222223,32,4,17,32.883450026614256,0.6500651041666667,43.023989898989896,1027.90404040404,32.12200126262625,0
2565,4,1,0,36,0.027777777777777776,0.0,1.0,36,700,500,200,0.7142857142857143,9,5,4,395.55569121821713,0.4165674603174603,0.15974012686719918,0.23707145731952722,132203.15728305772,3258.7422520661025,135461.8995351238,1854,0,317.8888888888889,32,4,18,32.727900552486204,0.6513671875,42.897727272727266,1028.4090909090899,32.13778409090906,0
2566,4,1,1,36,0.02702702702702703,0.02702702702702703,0.972972972972973,37,850,700,150,0.8235294117647058,10,7,3,402.45041005045124,0.41823073073073075,0.1554583899860773,0.22195019620147652,128983.44574502605,2981.888125961181,131965.33387098723,1855,0,310.27027027027026,33,4,20,35.827477178590094,0.6164772727272727,46.047794117647065,1015.8088235294126,30.782085561497354,8
2567,4,1,0,37,0.02702702702702703,0.0,1.0,37,1300,1000,300,0.7692307692307693,16,10,6,405.45293158656375,0.4181056056056056,0.16456022025642247,0.22466480076890769,129170.24289035474,3074.490730728571,132244.73362108332,1856,0,311.2162162162162,33,4,21,35.55995077355837,0.6183712121212122,45.8639705882353,1016.5441176470595,30.804367201426043,0
2568,4,2,1,38,0.05128205128205128,0.02564102564102564,0.9743589743589743,39,650,400,250,0.6153846153846154,9,4,5,390.1971084826723,0.4235548807917229,0.17337329639953758,0.21948275693117972,129760.92470689719,2326.467522933802,132087.392229831,1857,0,296.20512820512823,35,4,19,35.344603165587486,0.6199404761904762,45.28356481481481,1018.86574074074,29.110449735449713,0
2569,4,0,2,36,0.0,0.05263157894736842,0.9473684210526316,38,1450,1100,350,0.7586206896551724,18,11,7,403.22675885677756,0.4210822664770033,0.1064073226544624,0.22167636938126256,128858.1486892298,2792.778584801179,131650.92727403098,1858,1,305.0,36,2,18,35.93611357586512,0.6087962962962963,46.171171171171174,1015.3153153153156,28.203203203203213,8
2570,4,0,0,36,0.0,0.0,1.0,36,1100,1000,100,0.9090909090909091,12,10,2,420.743726108808,0.41825396825396827,0.1336748527034779,0.23048968646217718,128717.71541950105,3631.434240362798,132349.14965986385,1859,2,322.1666666666667,34,2,18,35.63565618645394,0.6115196078431373,46.3095238095238,1014.761904761904,29.84593837535012,0
2571,4,0,0,36,0.0,0.0,1.0,36,850,300,550,0.35294117647058826,14,3,11,424.69306955821077,0.41820436507936504,0.05043380912398576,0.21560504937929598,125632.1102438525,3499.036014390429,129131.14625824292,1860,3,323.1666666666667,32,4,16,38.72454869857262,0.5846354166666667,49.36868686868686,1002.5252525252512,31.3289141414141,8
2572,4,1,1,36,0.02702702702702703,0.02702702702702703,0.972972972972973,37,500,200,300,0.4,8,2,6,415.55367709213897,0.4197947947947948,0.060086460086460125,0.2124459809853067,125920.80720155693,3065.3708910034406,128986.17809256038,1861,0,315.4054054054054,33,4,17,38.653846153846146,0.5852272727272727,49.08088235294117,1003.676470588234,30.414438502673757,0
2573,4,3,1,38,0.07692307692307693,0.02564102564102564,0.9743589743589743,39,900,600,300,0.6666666666666666,12,6,6,394.2540125820159,0.42647885739991004,0.07784661274594162,0.20539806949202916,126694.89590942286,2189.9942171901557,128884.89012661301,1862,0,298.15384615384613,36,3,16,38.38786353467561,0.5868055555555556,48.31081081081081,1006.7567567567562,27.96546546546545,0
2574,4,2,0,40,0.05,0.0,1.0,40,900,600,300,0.6666666666666666,12,6,6,387.4404214458676,0.4302884615384615,0.09847067600137716,0.20397392097026243,127121.19187510706,1851.6204278093953,128972.81230291646,1863,0,291.65,35,5,18,38.119883124832626,0.5931547619047619,47.887731481481474,1008.4490740740732,28.812830687830665,0
2575,4,1,0,41,0.024390243902439025,0.0,1.0,41,1300,800,500,0.6153846153846154,18,8,10,378.14884123152075,0.4324186991869919,0.10437827258064081,0.20071312270323197,127451.59718615339,1439.1347578100883,128890.73194396347,1864,0,285.5121951219512,37,4,16,38.014329279328194,0.5926238738738738,47.560307017543856,1009.7587719298242,27.290777619724977,0
2576,4,1,2,40,0.023809523809523808,0.047619047619047616,0.9523809523809523,42,1100,1000,100,0.9090909090909091,12,10,2,349.7961808572879,0.4333744676732481,0.03706936769253688,0.18161153574556976,126554.60048788786,457.42034978299137,127012.02083767085,1865,0,279.6904761904762,40,2,13,39.6510874322459,0.5783854166666667,48.45020325203254,1006.1991869918728,25.15497967479682,8
2577,4,3,2,41,0.06976744186046512,0.046511627906976744,0.9534883720930233,43,1100,900,200,0.8181818181818182,13,9,4,338.0966917760558,0.43943798449612403,0.04778433414323713,0.1742498334538137,126253.12500000028,28.009431390076372,126281.13443139035,1866,0,274.0,39,4,17,40.25532061912659,0.5769230769230769,48.750000000000014,1005.0000000000022,25.769230769230823,8
2578,4,6,5,42,0.1276595744680851,0.10638297872340426,0.8936170212765957,47,750,600,150,0.8,9,6,3,313.7770582501305,0.4480033919210607,0.09346256471443937,0.1658717910973026,127287.50244125971,-1409.2426086172563,125878.25983264245,1867,0,251.4468085106383,42,5,15,39.80699058959093,0.5828373015873016,47.72286821705427,1009.1085271317843,24.026393503137722,0
2579,4,1,1,42,0.023255813953488372,0.023255813953488372,0.9767441860465116,43,1200,900,300,0.75,15,9,6,337.0023827829871,0.43934569952011815,0.10923214474556997,0.17683487287463054,126987.00086805575,-41.01562499998039,126945.98524305577,1868,0,275.69767441860466,39,4,18,39.529075375499524,0.5844017094017093,48.02083333333334,1007.9166666666682,25.844017094017133,0
2580,4,0,0,42,0.0,0.0,1.0,42,1400,1000,400,0.7142857142857143,18,10,8,344.7415686824376,0.43861304684475416,0.11149255567860239,0.18077911528469287,126960.75439453125,353.7299262152786,127314.48432074653,1869,1,283.1904761904762,39,3,18,39.36100344530576,0.5841346153846154,48.046875,1007.8125,25.841346153846153,0
2581,4,4,0,46,0.08695652173913043,0.0,1.0,46,1300,1200,100,0.9230769230769231,14,12,2,327.82415555905317,0.44383051529790657,0.16059564051754283,0.17648430312673982,128021.92251066644,-806.1964551385665,127215.72605552788,1870,0,259.4782608695652,42,4,19,38.702045831737514,0.5902777777777778,46.99612403100775,1012.0155038759691,24.095607235142122,0
2582,4,1,1,46,0.02127659574468085,0.02127659574468085,0.9787234042553191,47,950,600,350,0.631578947368421,13,6,7,326.56372379295055,0.4460376194881283,0.1791295666605517,0.177597959711608,128427.65239771307,-1011.8614666325768,127415.7909310805,1871,0,254.93617021276594,40,7,15,38.32025766994185,0.5973958333333333,46.59552845528456,1013.6178861788624,25.34044715447156,0
2583,4,0,0,46,0.0,0.0,1.0,46,1100,700,400,0.6363636363636364,15,7,8,335.06297230434024,0.44352858293075687,0.18479132526759878,0.1824556884120143,128479.16253552795,-590.2779843347028,127888.88455119324,1872,1,261.3695652173913,40,6,15,38.05236734830261,0.5979166666666667,46.54471544715448,1013.8211382113834,25.345528455284587,0
2584,4,0,1,45,0.0,0.021739130434782608,0.9782608695652174,46,1550,1000,550,0.6451612903225806,21,10,11,334.241130794627,0.4434681964573269,0.18330575981695163,0.18243177149564702,128571.78411005597,-605.204298154455,127966.57981190152,1873,2,262.3695652173913,41,5,15,37.97880188463919,0.5973069105691057,46.45337301587301,1014.1865079365073,24.736256291134325,0
2585,4,1,0,46,0.021739130434782608,0.0,1.0,46,1050,600,450,0.5714285714285714,15,6,9,334.2643215593312,0.442512077294686,0.1933531084130493,0.18337041682967942,128773.09032698743,-591.1500653502019,128181.94026163722,1874,0,263.2826086956522,41,5,19,37.77316896360733,0.599339430894309,46.25496031746032,1014.9801587301599,24.755613627564877,0
2586,4,2,0,48,0.041666666666666664,0.0,1.0,48,1100,600,500,0.5454545454545454,16,6,10,324.6247940497519,0.44451832151300236,0.20507454606030362,0.18013705293775742,129227.22012566918,-1207.7948244516153,128019.42530121756,1875,0,253.27083333333334,40,8,21,37.556221889055486,0.60546875,45.80792682926829,1016.7682926829264,25.41920731707316,0
2587,4,1,1,48,0.02040816326530612,0.02040816326530612,0.9795918367346939,49,1550,1300,250,0.8387096774193549,18,13,5,317.2258130706888,0.4460565476190476,0.20446353980188614,0.17727324848067866,129504.14540816295,-1583.588435374181,127920.55697278876,1876,0,249.08163265306123,41,8,17,37.46345029239765,0.6067073170731707,45.53571428571427,1017.8571428571404,24.825783972125375,0
2588,4,0,0,48,0.0,0.0,1.0,48,1500,800,700,0.5333333333333333,22,8,14,325.649020229018,0.4450262263593381,0.20066774837743506,0.18189486545418898,129485.6745013712,-1166.6233929870082,128319.0511083842,1877,2,255.27083333333334,40,8,18,37.26784822765852,0.6080729166666667,45.55386178861787,1017.7845528455258,25.444613821138145,0
2589,4,0,1,47,0.0,0.020833333333333332,0.9791666666666666,48,950,600,350,0.631578947368421,13,6,7,323.3153497105234,0.4448600029550827,0.19939169410903723,0.181306274171749,129640.87106095908,-1217.0232872298288,128423.84777372926,1878,3,256.2708333333333,40,8,18,37.16985996074906,0.6096354166666667,45.40142276422764,1018.3943089430894,25.459857723577237,0
2590,4,0,0,47,0.0,0.0,1.0,47,1150,800,350,0.6956521739130435,15,8,7,331.3648913007231,0.44295405488744993,0.21442839548617543,0.18599804288969413,129678.39084201399,-805.8268229166615,128872.56401909734,1879,4,262.6595744680851,39,8,19,36.926859616826874,0.6116452991452992,45.364583333333336,1018.5416666666675,26.116452991453013,0
2591,4,0,0,47,0.0,0.0,1.0,47,1300,800,500,0.6153846153846154,18,8,10,335.2317366286489,0.4427420598211533,0.22193086856626443,0.18898477159351992,129847.9443969363,-694.1696204309658,129153.77477650534,1880,5,263.6595744680851,40,7,20,36.65640475953069,0.61171875,45.198170731707314,1019.2073170731703,25.480182926829258,0
2592,4,0,1,46,0.0,0.02127659574468085,0.9787234042553191,47,1600,1200,400,0.75,20,12,8,340.5690268116169,0.4420482577860006,0.22377628307178332,0.19301475562440434,130055.18297846861,-541.4465802432312,129513.73639822539,1881,6,264.6595744680851,40,7,20,36.31023546212347,0.6138020833333333,44.994918699187,1020.0203252032529,25.50050813008132,0
2593,4,0,1,45,0.0,0.021739130434782608,0.9782608695652174,46,1150,900,250,0.782608695652174,14,9,5,340.97462514417515,0.4425322061191626,0.21128161409491342,0.19321895424836608,130050.00000000015,-331.2499999999842,129718.75000000016,1882,7,260.2826086956522,39,7,20,36.30514705882354,0.6153846153846154,45.00000000000001,1020.0000000000011,26.15384615384618,0
2594,4,0,0,45,0.0,0.0,1.0,45,1400,800,600,0.5714285714285714,20,8,12,342.13544810258196,0.44111952861952863,0.20539961830284414,0.1939851103612501,130071.79578493678,-99.56557272262683,129972.23021221416,1883,8,266.8,38,7,20,36.253447493366835,0.6173245614035088,44.97863247863248,1020.0854700854699,26.844354475933418,0
2595,4,0,0,45,0.0,0.0,1.0,45,1700,1000,700,0.5882352941176471,24,10,14,343.3409007194942,0.44130892255892257,0.19924895074000415,0.19589904407022127,130317.1242078494,-51.360239060558456,130265.76396878884,1884,9,267.8,38,7,21,35.974067873460996,0.6197916666666667,44.738247863247864,1021.0470085470088,26.869658119658126,0
2596,4,0,1,44,0.0,0.022222222222222223,0.9777777777777777,45,1200,900,300,0.75,15,9,6,346.53152923869334,0.4410143097643098,0.20518076909667782,0.19827576008684283,130426.23325525955,39.36041255751093,130465.59366781705,1885,10,268.8,38,7,21,35.78208346407278,0.6208881578947368,44.63141025641025,1021.4743589743578,26.88090418353573,0
2597,4,0,0,44,0.0,0.0,1.0,44,950,500,450,0.5263157894736842,14,5,9,347.80863532614615,0.4400215821000704,0.21031567959886432,0.19946022600642174,130514.5588666704,278.8181219221133,130793.37698859251,1886,11,274.70454545454544,37,7,19,35.66000912115033,0.6235923423423424,44.54495614035087,1021.8201754385956,27.61676149834042,0
2598,4,0,0,44,0.0,0.0,1.0,44,1600,1100,500,0.6875,21,11,10,351.27305917441623,0.43955910852713176,0.21265572300313917,0.20247049133872694,130710.7054574483,383.02987457677494,131093.73533202507,1887,12,275.70454545454544,37,7,19,35.3728822646365,0.6255630630630631,44.35307017543859,1022.5877192982445,27.63750592697958,0
2599,4,0,0,44,0.0,0.0,1.0,44,1200,700,500,0.5833333333333334,17,7,10,349.92028032095106,0.4390746124031008,0.21060764300973167,0.20220197248479813,130808.47447083422,354.5076110380536,131162.98208187227,1888,13,276.70454545454544,38,6,19,35.308529155787646,0.6247258771929824,44.25747863247863,1022.9700854700852,26.920265407107507,0
2600,4,0,0,44,0.0,0.0,1.0,44,900,600,300,0.6666666666666666,12,6,6,346.8291946572371,0.4390305673009161,0.20911510975713954,0.20098468576053677,130917.78897518071,281.2222633136,131199.0112384943,1889,14,277.70454545454544,38,6,19,35.277038312976316,0.6258223684210527,44.15064102564102,1023.3974358974351,26.931511470985136,0
2601,4,0,0,44,0.0,0.0,1.0,44,1200,900,300,0.75,15,9,6,348.90376906503474,0.43853505990133895,0.2063289157883761,0.20276196597636287,131027.14913662404,343.1732367228896,131370.32237334692,1890,15,278.70454545454544,38,6,19,35.11339524853039,0.6269188596491229,44.04380341880341,1023.8247863247842,26.942757534862743,0
2602,4,0,1,43,0.0,0.022727272727272728,0.9772727272727273,44,1450,1000,450,0.6896551724137931,19,10,9,349.51159969426374,0.43829281183932345,0.2111263358525277,0.20369408548747134,131136.5549551646,366.7494201548549,131503.30437531948,1891,16,279.70454545454544,38,6,19,34.98726574180314,0.628015350877193,43.936965811965806,1024.2521367521358,26.954003598740417,0
2603,4,1,1,43,0.022727272727272728,0.022727272727272728,0.9772727272727273,44,850,500,350,0.5882352941176471,12,5,7,345.2336328528381,0.43952607470049326,0.19544755475217968,0.20236070572178924,131356.983567182,270.0493772165142,131627.03294439852,1892,0,261.54545454545456,36,8,21,34.87426306345892,0.6339699074074074,43.721846846846844,1025.1126126126123,28.475350350350343,0
2604,4,1,0,44,0.022727272727272728,0.0,1.0,44,750,400,350,0.5333333333333333,11,4,7,343.2094907812728,0.438050563777308,0.20044950659043526,0.20239363563159718,131587.9662390431,232.44777716905952,131820.41401621216,1893,0,261.9318181818182,36,8,18,34.69318223392967,0.6362847222222222,43.49662162162162,1026.0135135135135,28.500375375375377,0
2605,4,0,2,42,0.0,0.045454545454545456,0.9545454545454546,44,850,500,350,0.5882352941176471,12,5,7,346.7313952072639,0.4377422480620155,0.20127268842683832,0.20503806636356275,131693.64762474992,332.4644361726653,132026.11206092258,1894,1,262.9318181818182,37,7,18,34.49629224085745,0.6354166666666667,43.39364035087719,1026.4254385964912,27.74122807017544,0
2606,4,0,1,41,0.0,0.023809523809523808,0.9761904761904762,42,1350,1000,350,0.7407407407407407,17,10,7,353.27813224332425,0.4379839334107627,0.2004731293667803,0.20869534967365466,131654.57182623883,902.1362472136457,132556.70807345246,1895,2,269.6190476190476,35,7,18,34.36771643923162,0.6389880952380953,43.43171296296296,1026.2731481481478,29.32208994708994,0
2607,4,0,0,41,0.0,0.0,1.0,41,1200,700,500,0.5833333333333334,17,7,10,359.6556857212761,0.4359247967479675,0.20392258305974664,0.211802547677586,131535.817003708,1261.5208922753745,132797.3378959834,1896,3,277.1219512195122,35,6,21,34.32399206438752,0.6377976190476191,43.5474537037037,1025.8101851851852,29.308862433862434,0
2608,4,0,0,41,0.0,0.0,1.0,41,900,600,300,0.6666666666666666,12,6,6,368.5312750866283,0.4355691056910569,0.20953209652621974,0.20452869494272619,129232.5386419887,1476.6069392232837,130709.145581212,1897,4,278.1219512195122,33,8,19,36.43473042465148,0.6190025252525253,45.802696078431374,1016.7892156862749,30.811794414735605,8
2609,4,1,1,41,0.023809523809523808,0.023809523809523808,0.9761904761904762,42,1000,800,200,0.8,12,8,4,362.79769956686107,0.4376330816879597,0.21003818876159364,0.20336641691316695,129625.34722222212,1005.55555555555,130630.90277777766,1898,0,272.4761904761905,34,8,19,36.180441898527015,0.6207107843137255,45.416666666666664,1018.3333333333325,29.950980392156836,0
2610,4,0,0,41,0.0,0.0,1.0,41,1250,900,350,0.72,16,9,7,370.0327474096119,0.4364837398373984,0.21310050847258566,0.20715849497837313,129575.43372741257,1389.4307477893165,130964.86447520189,1899,1,280.0,33,8,19,36.04708313272348,0.6224747474747474,45.46568627450981,1018.1372549019611,30.852644087938216,0
2611,4,0,0,41,0.0,0.0,1.0,41,650,300,350,0.46153846153846156,10,3,7,374.15242482095215,0.43607723577235774,0.2151550642740918,0.21054376094954144,129776.92920918352,1511.2705498865985,131288.19975907012,1900,2,281.0,34,7,19,35.73699224987342,0.6222426470588236,45.26785714285713,1018.9285714285702,29.968487394957947,0
2612,4,0,0,41,0.0,0.0,1.0,41,1350,1000,350,0.7407407407407407,17,10,7,371.47675492952743,0.4355436991869919,0.20754211746742612,0.20952463608080438,129867.92091836725,1448.5827664398994,131316.50368480716,1901,3,282.0,34,7,19,35.71254769134938,0.6231617647058824,45.17857142857142,1019.2857142857134,29.97899159663863,0
2613,4,1,0,42,0.023809523809523808,0.0,1.0,42,1650,1100,550,0.6666666666666666,22,11,11,364.03146803629244,0.4374758033294619,0.2023404508094917,0.20709867646090463,130203.51750042844,1079.6355238339925,131283.15302426243,1902,0,276.26190476190476,35,7,20,35.56125727678234,0.6244047619047619,44.849537037037024,1020.6018518518499,29.160052910052855,0
2614,4,0,1,41,0.0,0.023809523809523808,0.9761904761904762,42,1700,1100,600,0.6470588235294118,23,11,12,363.641021114045,0.4367620015485869,0.20663429111021236,0.20798003961966588,130410.31867551853,1084.5082893947028,131494.82696491323,1903,1,277.26190476190476,35,7,20,35.36130783758262,0.6264880952380952,44.64699074074073,1021.4120370370358,29.183201058201025,0
2615,4,0,0,41,0.0,0.0,1.0,41,1150,700,450,0.6086956521739131,16,7,9,372.9839906461438,0.43595020325203254,0.2055769421992415,0.2141851210499765,130566.58340419525,1539.849064625882,132106.43246882112,1904,2,278.2439024390244,34,7,17,34.964084643758504,0.6302083333333333,44.494047619047635,1022.0238095238115,30.059523809523867,0
2616,4,0,0,41,0.0,0.0,1.0,41,1200,800,400,0.6666666666666666,16,8,8,375.82138902671386,0.43559451219512196,0.2107460194406343,0.21649429311538906,130688.28125000025,1623.0902777778074,132311.37152777804,1905,3,279.2439024390244,34,7,17,34.76806574300462,0.6314338235294117,44.375000000000014,1022.5000000000019,30.073529411764763,0
2617,4,0,1,40,0.0,0.024390243902439025,0.975609756097561,41,1300,1000,300,0.7692307692307693,16,10,6,377.26267169841367,0.4352388211382114,0.21208611527456012,0.21783876849682637,130779.59183673495,1667.6516439909574,132447.2434807259,1906,4,280.2439024390244,34,7,17,34.63856882371197,0.6323529411764706,44.2857142857143,1022.8571428571449,30.08403361344544,0
2618,4,0,0,40,0.0,0.0,1.0,40,1250,1000,250,0.8,15,10,5,383.76534794810675,0.4328659188034188,0.21585570469798698,0.22114213144192013,130700.81218762019,2031.6885332564484,132732.50072087665,1907,9,288.15,33,7,18,34.55227309044423,0.6338383838383839,44.36274509803922,1022.5490196078435,30.98633392751041,0
2619,4,1,0,41,0.024390243902439025,0.0,1.0,41,1200,1000,200,0.8333333333333334,14,10,4,372.61240379699785,0.4339684959349594,0.21693696475739355,0.21656565860632357,131031.70680084036,1564.8078489369207,132596.51464977727,1908,0,282.0975609756098,35,6,20,34.50194061345995,0.6327380952380952,44.03935185185186,1023.8425925925939,29.25264550264554,0
2620,4,0,0,41,0.0,0.0,1.0,41,1500,1000,500,0.6666666666666666,20,10,10,370.4820453892559,0.4329014227642276,0.21423728813559317,0.21599249681784702,131150.23389274706,1517.7613811728606,132667.99527391992,1909,1,283.0975609756098,35,6,20,34.43644067796611,0.6339285714285714,43.92361111111112,1024.3055555555568,29.26587301587305,0
2621,4,0,0,41,0.0,0.0,1.0,41,1100,600,500,0.5454545454545454,16,6,10,368.8656313505091,0.4320630081300813,0.2065815643473803,0.21571573976072747,131268.8145683302,1484.1108324760303,132752.92540080624,1910,2,284.0975609756098,35,6,22,34.35782320608388,0.6351190476190476,43.80787037037039,1024.768518518521,29.2791005291006,0
2622,4,0,0,41,0.0,0.0,1.0,41,850,400,450,0.47058823529411764,13,4,9,368.6643368039172,0.43089430894308944,0.20954711114509306,0.21644893884745336,131419.6588010205,1489.9616668941364,132909.62046791465,1911,3,285.0975609756098,34,7,23,34.210399009249585,0.6387867647058824,43.66071428571429,1025.3571428571436,30.157563025210106,0
2623,4,0,0,41,0.0,0.0,1.0,41,1400,900,500,0.6428571428571429,19,9,10,367.4540124923419,0.43074186991869917,0.21962497283707472,0.21706960218318433,131654.5718262389,1475.4001361025498,133129.97196234146,1912,4,286.0975609756098,35,6,17,34.004008307958365,0.6389880952380953,43.43171296296297,1026.2731481481487,29.322089947089964,0
2624,4,0,0,41,0.0,0.0,1.0,41,1050,700,350,0.6666666666666666,14,7,7,372.12330633797546,0.4308689024390244,0.21574271880696494,0.22051475287402675,131773.38023244595,1607.1891878858012,133380.56942033177,1913,5,287.0975609756098,35,6,17,33.76416131214069,0.6401785714285715,43.31597222222222,1026.7361111111109,29.33531746031745,0
2625,4,1,0,42,0.023809523809523808,0.0,1.0,42,700,400,300,0.5714285714285714,10,4,6,366.9350691715741,0.43141453735965934,0.21977841415895938,0.21936805805286858,132108.41912436092,1295.0423819089467,133403.46150626987,1914,0,281.23809523809524,36,6,19,33.55926169350422,0.6414930555555556,42.98986486486487,1028.0405405405413,28.556681681681702,0
2626,4,1,1,42,0.023255813953488372,0.023255813953488372,0.9767441860465116,43,1300,900,400,0.6923076923076923,17,9,8,358.2013672811518,0.43247046880767814,0.21455277073952717,0.21596994571219225,132428.63520408154,888.1747594947296,133316.80996357626,1915,0,275.6744186046512,34,9,20,33.46128267406893,0.6488970588235294,42.67857142857142,1029.2857142857135,30.27310924369746,0
2627,4,0,0,42,0.0,0.0,1.0,42,1000,600,400,0.6,14,6,8,358.8493678905736,0.4317290940766551,0.19552652679406624,0.20084291846859842,129564.73922902482,907.0365646258324,130471.77579365065,1916,1,283.07142857142856,34,8,19,36.34261966011848,0.6200980392156863,45.47619047619047,1018.0952380952372,29.943977591036386,8
2628,4,2,1,43,0.045454545454545456,0.022727272727272728,0.9772727272727273,44,950,600,350,0.631578947368421,13,6,7,344.6645612234725,0.43373414376321356,0.20372785457755693,0.19594418154373316,130176.38204082457,173.43711955197898,130349.81916037654,1917,0,271.15909090909093,36,8,21,36.082910321488995,0.6221064814814814,44.876126126126124,1020.4954954954951,28.347097097097087,0
2629,4,1,0,44,0.022727272727272728,0.0,1.0,44,750,400,350,0.5333333333333333,11,4,7,343.7716457938853,0.4359474101479916,0.199838873812755,0.19602298100587473,130292.97052154176,158.26284951524252,130451.23337105701,1918,0,268.6818181818182,34,10,22,35.98754275497513,0.6274509803921569,44.76190476190475,1020.9523809523795,30.02801120448175,0
2630,4,0,1,43,0.0,0.022727272727272728,0.9772727272727273,44,1200,800,400,0.6666666666666666,16,8,8,345.06499840113526,0.4352096546863989,0.2075164437100825,0.1978418758368029,130505.75573979573,206.59367913829738,130712.34941893403,1919,1,269.6818181818182,34,10,20,35.73900928191387,0.6295955882352942,44.553571428571416,1021.7857142857127,30.052521008403318,0
2631,4,0,1,42,0.0,0.023255813953488372,0.9767441860465116,43,1200,900,300,0.75,15,9,6,342.05299240379054,0.4345699520118125,0.20118202157108156,0.19657744262241902,130597.00255102015,334.2191043083634,130931.22165532851,1920,2,273.83720930232556,34,9,20,35.72361014053886,0.6305147058823529,44.4642857142857,1022.1428571428551,30.06302521008397,0
2632,4,1,1,42,0.023255813953488372,0.023255813953488372,0.9767441860465116,43,1150,800,350,0.6956521739130435,15,8,7,334.42048340246924,0.434985234403839,0.19271582568264511,0.1939200219493791,130942.84664619752,157.99401470334183,131100.84066090087,1921,0,266.69767441860466,35,8,21,35.5692119944212,0.6318452380952381,44.1261574074074,1023.4953703703688,29.242724867724824,0
2633,4,1,1,42,0.023255813953488372,0.023255813953488372,0.9767441860465116,43,1050,500,550,0.47619047619047616,16,5,11,338.84376956692614,0.43307032115171645,0.21451686289345484,0.1978691024082088,131212.72243527306,292.12269702133744,131504.8451322944,1922,0,267.6046511627907,36,7,22,35.18355682567597,0.6325231481481481,43.86261261261261,1024.549549549549,28.459709709709696,0
2634,4,1,1,42,0.023255813953488372,0.023255813953488372,0.9767441860465116,43,900,500,400,0.5555555555555556,13,5,8,337.46514485940804,0.4335086747877446,0.22452803451370595,0.19858008723400222,131506.13667052466,275.79821868602374,131781.93488921068,1923,0,268.0232558139535,35,8,24,34.92298578199051,0.6375,43.576388888888886,1025.6944444444443,29.305555555555554,0
2635,4,1,0,43,0.023255813953488372,0.0,1.0,43,1100,700,400,0.6363636363636364,15,7,8,338.83338776013676,0.4336471022517534,0.2337695710431167,0.20047453742792867,131713.96933138274,325.8180887774264,132039.78742016017,1924,0,268.8139534883721,35,8,21,34.678491562370816,0.6395833333333334,43.37384259259259,1026.5046296296287,29.328703703703678,0
2636,4,0,0,43,0.0,0.0,1.0,43,1050,500,550,0.47619047619047616,16,5,11,336.1873531674685,0.4336471022517534,0.2222746355960188,0.19968718688139983,131862.52170138882,266.1024305555524,132128.62413194438,1925,1,269.8139534883721,35,8,23,34.59685598377282,0.6410714285714285,43.229166666666664,1027.0833333333328,29.34523809523808,0
2637,4,0,0,43,0.0,0.0,1.0,43,1150,700,450,0.6086956521739131,16,7,9,334.5117873437812,0.43346253229974163,0.21820373403209992,0.19884742884635337,131892.24222232925,223.90193651404644,132116.1441588433,1926,2,270.8139534883721,35,8,23,34.60997652582161,0.6413690476190477,43.200231481481474,1027.199074074073,29.348544973544943,0
2638,4,1,1,43,0.022727272727272728,0.022727272727272728,0.9772727272727273,44,1000,700,300,0.7,13,7,6,325.47642565195383,0.43545190274841433,0.22358809772602872,0.19547844499214972,132282.13168827607,-189.05692009577615,132093.0747681803,1927,0,265.6363636363636,36,8,24,34.45037401933954,0.6432291666666667,42.820945945945944,1028.7162162162158,28.57545045045044,0
2639,4,0,0,43,0.0,0.0,1.0,43,1400,900,500,0.6428571428571429,19,9,10,330.2093053475677,0.434546880767811,0.2223176235301516,0.19768055719055197,132159.8776148834,128.0842764060401,132287.96189128942,1928,1,272.6744186046512,35,8,24,34.45144829656312,0.644047619047619,42.93981481481482,1028.2407407407406,29.378306878306876,0
2640,4,0,0,43,0.0,0.0,1.0,43,1350,1000,350,0.7407407407407407,17,10,7,333.58031466901394,0.43362403100775193,0.2290860587300938,0.2004993259747443,132311.0948786625,227.2753327652029,132538.3702114277,1929,2,273.6744186046512,36,7,24,34.21286668126095,0.6435185185185186,42.792792792792795,1028.8288288288293,28.57857857857859,0
2641,4,1,0,44,0.022727272727272728,0.0,1.0,44,1350,1000,350,0.7407407407407407,17,10,7,327.5013543602374,0.43431774136715995,0.22523641131595662,0.1992880581851661,132774.93709926168,-103.17712137810693,132671.75997788357,1930,0,268.4318181818182,36,8,19,33.90401915792542,0.6481481481481481,42.342342342342356,1030.6306306306326,28.628628628628682,0
2642,4,0,0,44,0.0,0.0,1.0,44,1400,900,500,0.6428571428571429,19,9,10,328.11373946551066,0.4341195384073291,0.2276971417792646,0.20043612490231397,132920.0542392057,-77.42079072312379,132842.63344848258,1931,1,269.4318181818182,36,8,23,33.74285610279933,0.6495949074074074,42.20157657657659,1031.1936936936959,28.64426926926933,0
2643,4,0,0,44,0.0,0.0,1.0,44,1400,900,500,0.6428571428571429,19,9,10,328.82442361202504,0.43327167019027485,0.226300331408386,0.20165256821508565,133065.250639153,-48.97913115814896,133016.27150799485,1932,2,270.4318181818182,36,8,23,33.57914028960197,0.6510416666666667,42.06081081081083,1031.7567567567594,28.659909909909985,0
2644,4,0,0,44,0.0,0.0,1.0,44,1700,1500,200,0.8823529411764706,19,15,4,337.9330176056312,0.43214852008456656,0.2191302324256037,0.19472347450352204,130699.20562358477,33.515391007390576,130732.72101459216,1933,3,271.4318181818182,38,6,16,35.725542437223545,0.6236293859649122,44.364316239316246,1022.5427350427362,26.9090193432299,8
2645,4,0,0,44,0.0,0.0,1.0,44,1250,800,450,0.64,17,8,9,338.30360203962067,0.4326330162085976,0.22074157431412234,0.1952128018279262,130753.83434007259,46.89862754769892,130800.73296762028,1934,4,272.4318181818182,38,6,16,35.660842995926046,0.6241776315789473,44.31089743589745,1022.7564102564124,26.91464237516875,0
2646,4,2,0,46,0.043478260869565216,0.0,1.0,46,800,500,300,0.625,11,5,6,326.7511231380069,0.4364130434782609,0.2222866504278842,0.1912527612795594,131302.08462431468,-619.3792757286785,130682.70534858601,1935,0,261.54347826086956,40,6,22,35.403239134027444,0.6263020833333333,43.77540650406507,1024.8983739837436,25.62245934959359,0
2647,4,0,1,45,0.0,0.021739130434782608,0.9782608695652174,46,1350,1000,350,0.7407407407407407,17,10,7,326.9652140660585,0.43637278582930755,0.22364381661653088,0.19190927859583914,131408.21533203172,-606.8143668228829,130801.40096520883,1936,1,262.54347826086956,39,7,23,35.29083697382233,0.6290064102564102,43.67187500000002,1025.3125000000036,26.290064102564195,0
2648,4,0,1,44,0.0,0.022222222222222223,0.9777777777777777,45,750,400,350,0.5333333333333333,11,4,7,305.4202631101061,0.43442760942760944,0.1396628560356521,0.17770845297759383,131074.03175390526,-993.4669469639696,130080.5648069413,1937,2,269.1777777777778,41,4,16,36.17919653813861,0.6224593495934959,43.99801587301587,1024.0079365079366,24.97580332946187,8
2649,4,0,2,42,0.0,0.045454545454545456,0.9545454545454546,44,1400,900,500,0.6428571428571429,19,9,10,308.93960884463417,0.4318181818181818,0.15457450742168932,0.18023222604122544,131175.6395266439,-694.9298469387863,130480.70967970512,1938,3,276.25,41,3,16,35.98682936277356,0.6234756097560976,43.89880952380952,1024.4047619047612,24.985481997677102,0
2650,4,0,0,42,0.0,0.0,1.0,42,1500,900,600,0.6,21,9,12,322.27982210280624,0.42852303523035234,0.17876864067718157,0.1881240814486621,131197.94894118933,56.49032900392615,131254.43927019325,1939,9,288.7142857142857,40,2,16,35.62270608074598,0.6252604166666667,43.877032520325216,1024.491869918701,25.612296747967527,0
2651,4,0,1,41,0.0,0.023809523809523808,0.9761904761904762,42,1400,1100,300,0.7857142857142857,17,11,6,322.123329979753,0.4281842818428185,0.18081781051538126,0.18854403847044765,131302.08462431445,59.09294649351693,131361.17757080795,1940,10,289.7142857142857,40,2,16,35.521814576103125,0.6263020833333333,43.77540650406505,1024.8983739837417,25.622459349593544,0
2652,4,0,0,41,0.0,0.0,1.0,41,1150,800,350,0.6956521739130435,15,8,7,325.8380984434781,0.4269563008130081,0.19448144043758187,0.19112117314569751,131382.88498064125,361.9124639838491,131744.7974446251,1941,11,297.3658536585366,38,3,16,35.34523933583441,0.6304824561403508,43.69658119658119,1025.213675213674,26.979307242465104,0
2653,4,0,0,41,0.0,0.0,1.0,41,1150,700,450,0.6086956521739131,16,7,9,325.1167880229268,0.42662601626016255,0.19701258900482332,0.1909712932340301,131437.65637555698,346.5177332164495,131784.17410877344,1942,12,298.3658536585366,38,3,17,35.30857123011739,0.6310307017543859,43.64316239316239,1025.4273504273501,26.98493027440395,0
2654,4,0,0,41,0.0,0.0,1.0,41,1150,800,350,0.6956521739130435,15,8,7,328.48379818828084,0.42629573170731705,0.1996008592190852,0.1940599855717482,131656.85609796183,449.42882971728363,132106.2849276791,1943,13,299.3658536585366,38,3,15,35.001561524047446,0.6332236842105263,43.429487179487175,1026.282051282051,27.00742240215924,0
2655,4,0,0,41,0.0,0.0,1.0,41,1450,900,550,0.6206896551724138,20,9,11,326.84289531812595,0.426244918699187,0.1978018073802632,0.19378698747085166,131793.9486654429,415.183153444357,132209.13181888725,1944,14,300.3658536585366,38,3,15,34.905750355495435,0.6345942982456141,43.29594017094016,1026.8162393162381,27.021479982006266,0
2656,4,0,0,41,0.0,0.0,1.0,41,600,100,500,0.16666666666666666,11,1,10,324.52121173770496,0.42596544715447154,0.19612647920550952,0.1929666945490435,131903.67408366204,361.1080292570647,132264.7821129191,1945,15,301.3658536585366,38,3,16,34.85504420176807,0.6356907894736843,43.18910256410256,1027.2435897435896,27.032726045883937,0
2657,4,0,0,41,0.0,0.0,1.0,41,1000,800,200,0.8,12,8,4,324.03758800268395,0.4255589430894309,0.19504588226046526,0.19323729442019946,132013.44515897808,355.46367064797437,132368.90882962605,1946,16,302.3658536585366,38,3,16,34.75716463942892,0.6367872807017544,43.08226495726496,1027.6709401709406,27.043972109761597,0
2658,4,0,1,40,0.0,0.024390243902439025,0.975609756097561,41,800,600,200,0.75,10,6,4,324.401936806442,0.4251270325203252,0.19396618366058993,0.1940161490297323,132123.26189139095,372.2084109504025,132495.47030234136,1947,17,303.3658536585366,38,3,17,34.63750043299041,0.6378837719298245,42.97542735042735,1028.098290598291,27.055218173639236,0
2659,4,1,0,41,0.024390243902439025,0.0,1.0,41,1200,700,500,0.5833333333333334,17,7,10,327.6656542146335,0.42494918699186995,0.1940584231423712,0.19725472383720916,132370.5164730804,474.6543757761511,132845.17084885656,1948,0,303.609756097561,38,3,18,34.30535368217053,0.6403508771929824,42.735042735042725,1029.0598290598277,27.080521817363888,0
2660,4,0,0,41,0.0,0.0,1.0,41,950,600,350,0.631578947368421,13,6,7,328.8442799016782,0.42494918699186995,0.19976867611365745,0.19868792008855618,132507.9800044743,514.8982531594585,133022.87825763374,1949,1,304.609756097561,38,3,18,34.13709314793678,0.6417214912280702,42.60149572649572,1029.5940170940162,27.094579397210953,0
2661,4,1,0,42,0.023809523809523808,0.0,1.0,42,1200,800,400,0.6666666666666666,16,8,8,322.1213622840627,0.42564363143631434,0.19586929538434883,0.19656949715706873,132880.8648003473,160.7530381944488,133041.61783854174,1950,0,298.3333333333333,39,3,16,33.936569677375886,0.6436965811965811,42.239583333333336,1031.0416666666672,26.436965811965827,0
2662,4,0,1,41,0.0,0.023809523809523808,0.9761904761904762,42,1400,1100,300,0.7857142857142857,17,11,6,321.63063668665137,0.4248209446380178,0.19257688942728302,0.19740229783258792,133095.751953125,161.53428819444503,133257.28624131944,1951,1,299.3333333333333,39,3,17,33.73418466922404,0.6458333333333333,42.03125,1031.875,26.458333333333332,0
2663,4,0,0,41,0.0,0.0,1.0,41,950,600,350,0.631578947368421,13,6,7,328.74628072900975,0.42339939024390244,0.20006366626748884,0.2011227245980902,132975.88962853403,543.0658284023829,133518.9554569364,1952,2,307.5609756097561,38,3,17,33.67062875492023,0.6463815789473684,42.147435897435905,1031.4102564102577,27.142375168690993,0
2664,4,0,0,41,0.0,0.0,1.0,41,1200,900,300,0.75,15,9,6,329.8533748877977,0.42317073170731706,0.20250344191686342,0.20194891151183827,133003.4394061839,574.3266719629012,133577.7660781468,1953,3,308.5609756097561,38,3,17,33.614491627826695,0.6466557017543859,42.1207264957265,1031.517094017095,27.14518668466039,0
2665,4,1,0,42,0.023809523809523808,0.0,1.0,42,1300,900,400,0.6923076923076923,17,9,8,322.3836987451345,0.4223165892373209,0.19864960909736995,0.1992990496731145,133364.60503472234,198.9149305555605,133563.5199652779,1954,0,302.1904761904762,39,3,18,33.44594594594593,0.6485042735042735,41.770833333333336,1032.9166666666674,26.485042735042754,0
2666,4,0,0,42,0.0,0.0,1.0,42,1100,800,300,0.7272727272727273,14,8,6,321.2429591882984,0.42198993418505615,0.20413684175152125,0.19902616565825917,133445.31385633667,173.67350260415753,133618.98735894082,1955,1,303.1904761904762,39,3,18,33.39476845784186,0.6493055555555556,41.69270833333333,1033.2291666666656,26.49305555555553,0
2667,4,0,0,42,0.0,0.0,1.0,42,1000,700,300,0.7,13,7,6,321.0157088956122,0.42153019744483156,0.2088246162114955,0.1994639248197344,133552.96359592007,174.51985677083024,133727.4834526909,1956,2,304.1904761904762,39,3,18,33.29312791830428,0.6503739316239316,41.588541666666664,1033.6458333333328,26.5037393162393,0
2668,4,1,0,43,0.023255813953488372,0.0,1.0,43,1250,800,450,0.64,17,8,9,318.9314809070972,0.42169619785898854,0.2197120708748619,0.200142768517485,133918.90290377734,-57.80919508891617,133861.09370868842,1957,0,298.09302325581393,40,3,13,32.98191785305187,0.65234375,41.23475609756097,1035.060975609755,25.876524390243873,0
2669,4,0,0,43,0.0,0.0,1.0,43,1300,1000,300,0.7692307692307693,16,10,6,321.0516058213066,0.4209579180509413,0.21839151280313462,0.20233994526437424,134076.733064396,9.110090719788218,134085.84315511578,1958,1,299.09302325581393,40,3,14,32.76972328525171,0.65390625,41.08231707317072,1035.6707317073153,25.891768292682883,0
2670,4,0,1,42,0.0,0.023255813953488372,0.9767441860465116,43,1050,800,250,0.7619047619047619,13,8,5,320.50598375323676,0.4208656330749354,0.21757749846565866,0.2022859128419035,134129.36377363003,-2.147262707396351,134127.21651092262,1959,2,300.09302325581393,40,3,14,32.73140880996761,0.6544270833333333,41.03150406504064,1035.8739837398366,25.896849593495915,0
2671,4,0,0,42,0.0,0.0,1.0,42,1000,700,300,0.7,13,7,6,325.63910595296704,0.4200300038714673,0.2209632067292273,0.20501446182890698,134037.92453341995,329.59798177081393,134367.52251519077,1960,3,308.1190476190476,39,3,15,32.689639707608215,0.6551816239316239,41.11979166666666,1035.5208333333317,26.551816239316196,0
2672,4,0,0,42,0.0,0.0,1.0,42,1500,1100,400,0.7333333333333333,19,11,8,327.11583904458695,0.419437185443283,0.22757920545531185,0.206398471031686,134118.8368055555,374.47916666666237,134493.31597222216,1961,4,309.1190476190476,39,3,16,32.57072941807454,0.655982905982906,41.041666666666664,1035.833333333333,26.559829059829053,0
2673,4,0,1,41,0.0,0.023809523809523808,0.9761904761904762,42,1400,1200,200,0.8571428571428571,16,12,4,327.21166151261565,0.41865079365079366,0.22616057374421694,0.2078326526506105,134361.72010633687,392.9443359375094,134754.66444227437,1962,5,310.1190476190476,39,3,19,32.3262039920962,0.6583867521367521,40.80729166666667,1036.770833333334,26.583867521367537,0
2674,4,0,0,41,0.0,0.0,1.0,41,1300,1000,300,0.7692307692307693,16,10,6,335.5340663575152,0.4170477642276423,0.23476584008186263,0.21260718339217846,134273.81388569277,810.6877556797272,135084.5016413725,1963,6,318.390243902439,38,3,20,32.198141085111494,0.659265350877193,40.89209401709401,1036.4316239316229,27.274516419253235,0
2675,4,0,0,41,0.0,0.0,1.0,41,950,600,350,0.631578947368421,13,6,7,339.5680949017115,0.4165650406504065,0.2364943987375172,0.21597954974547906,134412.26189823938,928.4231408430046,135340.68503908237,1964,7,319.390243902439,38,3,21,31.955534377361076,0.6606359649122807,40.758547008547005,1036.9658119658113,27.288573999100297,0
2676,4,0,0,41,0.0,0.0,1.0,41,850,500,350,0.5882352941176471,12,5,7,353.6254874743871,0.4159044715447155,0.20860598849890977,0.2071234998064266,131328.12499999985,1118.9016957045667,132447.0266957044,1965,8,320.390243902439,35,6,20,34.688346883468846,0.6357142857142857,43.74999999999999,1024.9999999999989,29.285714285714253,8
2677,4,0,0,41,0.0,0.0,1.0,41,1200,900,300,0.75,15,9,6,352.8963871965804,0.4160823170731707,0.20714911145498882,0.2070169667408815,131387.44882758913,1073.2312028463584,132460.6800304355,1966,9,321.390243902439,35,6,20,34.647117483254306,0.6363095238095238,43.692129629629626,1025.2314814814813,29.292328042328037,0
2678,4,0,0,41,0.0,0.0,1.0,41,1050,800,250,0.7619047619047619,13,8,5,352.22839556637456,0.416234756097561,0.21170324331614832,0.20710655694184765,131476.45968632106,1061.9484900119933,132538.40817633306,1967,10,322.390243902439,35,6,20,34.574375540759135,0.637202380952381,43.60532407407407,1025.578703703703,29.302248677248656,0
2679,4,1,0,42,0.023809523809523808,0.0,1.0,42,1200,800,400,0.6666666666666666,16,8,8,343.0571629389349,0.4174167634533488,0.21129521978608867,0.2031653520934374,131749.9269606993,639.5512321098677,132389.47819280915,1968,0,315.6904761904762,37,5,17,34.53387002029266,0.6359797297297297,43.33881578947368,1026.644736842104,27.747155049786596,0
2680,4,0,0,42,0.0,0.0,1.0,42,1300,1200,100,0.9230769230769231,14,12,2,341.1587420034296,0.4177555168408827,0.20988241354374115,0.2027132352052514,131876.23844875421,598.146321864243,132474.38477061846,1969,1,316.6904761904762,38,4,18,34.45539491020038,0.6354166666666667,43.21581196581195,1027.1367521367501,27.02991452991448,0
2681,4,0,0,42,0.0,0.0,1.0,42,1250,800,450,0.64,17,8,9,341.38903853148963,0.41748935346496324,0.21200710616769003,0.2033491229513656,131969.53125000003,610.5902777777785,132580.1215277778,1970,2,317.6904761904762,39,3,18,34.355569072722346,0.6346153846153846,43.125,1027.5000000000002,26.34615384615385,0
2682,4,0,0,42,0.0,0.0,1.0,42,950,700,250,0.7368421052631579,12,7,5,343.7881521002447,0.41738046844754156,0.21104323784433232,0.20550243931419207,132103.35422091998,683.1136067708144,132786.4678276908,1971,3,318.6904761904762,39,3,18,34.159257101361156,0.6359508547008548,42.99479166666666,1028.020833333332,26.35950854700851,0
2683,4,0,0,42,0.0,0.0,1.0,42,1300,1000,300,0.7692307692307693,16,10,6,313.4287553080797,0.41723528842431284,0.13646504528041548,0.1707108044439586,128487.53390842021,-345.33420138888494,128142.19970703132,1972,4,319.6904761904762,39,3,15,38.59218209527723,0.5996260683760684,46.536458333333336,1013.8541666666673,25.9962606837607,8
2684,4,1,0,43,0.023255813953488372,0.0,1.0,43,950,700,250,0.7368421052631579,12,7,5,319.86211939290837,0.42063492063492064,0.16803570514401645,0.1762239261969531,128943.21852898417,-351.1897679952291,128592.02876098895,1973,0,313.2325581395349,40,3,16,37.96569608431726,0.6026041666666666,46.087398373983746,1015.6504065040659,25.391260162601647,0
2685,4,1,0,44,0.022727272727272728,0.0,1.0,44,1000,600,400,0.6,14,6,8,316.0008851774686,0.4225466878083157,0.1743453927643417,0.1754664182622504,129253.05394441147,-630.925912155451,128622.12803225602,1974,0,307.09090909090907,40,4,18,37.74922546472118,0.6057291666666667,45.78252032520326,1016.8699186991876,25.42174796747969,0
2686,4,0,0,44,0.0,0.0,1.0,44,1100,800,300,0.7272727272727273,14,8,6,319.7718150829213,0.42295410500352365,0.1808079294594127,0.17814333003868257,129382.26176754909,-525.4398630114339,128856.82190453766,1975,1,308.09090909090907,40,4,19,37.522267172776615,0.60703125,45.65548780487805,1017.3780487804879,25.434451219512198,0
2687,4,1,1,44,0.022222222222222223,0.022222222222222223,0.9777777777777777,45,1350,1100,250,0.8148148148148148,16,11,5,318.1952361857565,0.4251473063973064,0.19681179182494146,0.17861730398683207,129680.91699932274,-747.229997323012,128933.68700199973,1976,0,302.22222222222223,41,4,15,37.25964660238304,0.6084857723577235,45.36210317460317,1018.5515873015862,24.842721641502102,0
2688,4,2,1,45,0.043478260869565216,0.021739130434782608,0.9782608695652174,46,1300,700,600,0.5384615384615384,19,7,12,313.0525141813178,0.42624798711755235,0.20967688648077187,0.17757633994078179,130089.53788834793,-1055.0286190733855,129034.50926927454,1977,0,296.5652173913044,42,4,17,36.977187816616016,0.6111111111111112,44.961240310077514,1020.155038759689,24.2894056847545,0
2689,4,0,0,45,0.0,0.0,1.0,45,1350,1000,350,0.7407407407407407,17,10,7,317.6898968947298,0.424726430976431,0.20718547341115467,0.17983767291177413,130009.52695893154,-739.4573570168993,129270.06960191464,1978,1,303.9555555555556,41,4,17,36.93985084306096,0.6117886178861789,45.03968253968253,1019.8412698412684,24.874177313201667,0
2690,4,0,0,45,0.0,0.0,1.0,45,1400,1000,400,0.7142857142857143,18,10,8,314.56454628344494,0.4248737373737374,0.20420808272660174,0.1786604461901117,130138.96869929673,-812.5788714620697,129326.38982783466,1979,2,304.9555555555556,42,3,17,36.8886514719848,0.6116071428571428,44.91279069767441,1020.3488372093009,24.294019933554782,0
2691,4,0,1,44,0.0,0.022222222222222223,0.9777777777777777,45,1650,1000,650,0.6060606060606061,23,10,13,313.63105011053165,0.42464225589225585,0.20306854738925972,0.17825359683497305,130165.93491735535,-835.1842286501455,129330.7506887052,1980,3,305.9555555555556,43,2,17,36.885207869339254,0.6104651162790697,44.88636363636363,1020.4545454545453,23.731501057082447,0
2692,4,0,0,44,0.0,0.0,1.0,44,1050,700,350,0.6666666666666666,14,7,7,314.70220741357787,0.42391208597603947,0.20083487940630795,0.17930707166587556,130262.58680555537,-601.1076675849606,129661.47913797041,1981,4,310.8863636363636,39,5,17,36.760204081632644,0.6175213675213675,44.79166666666666,1020.8333333333319,26.175213675213637,0
2693,4,0,0,44,0.0,0.0,1.0,44,1200,600,600,0.5,18,6,12,315.9121694445259,0.42320736434108525,0.19727865935043742,0.1809851961397141,130475.34722222202,-556.2500000000248,129919.09722222199,1982,5,311.8863636363636,39,5,17,36.51441000543773,0.6196581196581197,44.58333333333332,1021.6666666666649,26.196581196581153,0
2694,4,0,0,44,0.0,0.0,1.0,44,1300,900,400,0.6923076923076923,17,9,8,313.4401549057045,0.4228329809725158,0.19130698609451335,0.18018677446336687,130608.41064453099,-612.4159071180856,129995.9947374129,1983,6,312.8863636363636,39,5,15,36.443259791433135,0.6209935897435898,44.453124999999986,1022.187499999998,26.209935897435845,0
2695,4,1,0,45,0.022222222222222223,0.0,1.0,45,1200,900,300,0.75,15,9,6,303.75478445581035,0.42394781144781146,0.19015091342335233,0.17623376664970736,130963.79469892247,-1043.8241539427672,129919.9705449797,1984,0,306.9111111111111,40,5,16,36.33277899126292,0.6229166666666667,44.105691056910565,1023.5772357723567,25.58943089430892,0
2696,4,0,0,45,0.0,0.0,1.0,45,1250,800,450,0.64,17,8,9,307.55342367439783,0.42352693602693603,0.1997882757708087,0.17892080236392774,131067.83743142289,-937.9275728733116,130129.90985854958,1985,1,307.9111111111111,40,5,16,36.13082241630276,0.6239583333333334,44.004065040650396,1023.9837398373967,25.59959349593492,0
2697,4,1,0,46,0.021739130434782608,0.0,1.0,46,1100,600,500,0.5454545454545454,16,6,10,300.967807441478,0.4237520128824477,0.20042094727856075,0.1771033671677539,131506.13667052455,-1284.1772762345884,130221.95939428995,1986,0,302.19565217391306,41,5,18,35.858863687655145,0.6267784552845528,43.57638888888888,1025.6944444444432,25.016937669376663,0
2698,4,0,0,46,0.0,0.0,1.0,46,1300,1100,200,0.8461538461538461,15,11,4,303.05648925506455,0.42266505636070856,0.201426860276966,0.17904736615326342,131658.81406092527,-1219.9884062421374,130438.82565468314,1987,1,303.19565217391306,41,5,14,35.651985661350075,0.6283028455284553,43.42757936507936,1026.2896825396822,25.031455671699565,0
2699,4,1,0,47,0.02127659574468085,0.0,1.0,47,1350,900,450,0.6666666666666666,18,9,9,295.7000788770713,0.42368177613320995,0.20173929797871382,0.1758113592919704,131899.84568422867,-1599.4410454600104,130300.40463876865,1988,0,297.72340425531917,42,5,15,35.59903939879887,0.6292162698412698,43.19282945736434,1027.2286821705422,24.457825765965293,0
2700,4,0,1,46,0.0,0.02127659574468085,0.9787234042553191,47,950,700,250,0.7368421052631579,12,7,5,296.3832089752607,0.42360468701819304,0.19509532629263893,0.1764486897678097,131949.61921045918,-1578.4696870680793,130371.1495233911,1989,1,298.72340425531917,42,5,15,35.53161055047313,0.6297123015873016,43.14437984496124,1027.4224806201555,24.46244001476561,0
2701,4,0,0,46,0.0,0.0,1.0,46,900,400,500,0.4444444444444444,14,4,10,299.8526710283254,0.42405394524959744,0.1934604160980833,0.1783443083571689,131913.47321625412,-1289.0785422965437,130624.39467395758,1990,2,304.5869565217391,41,5,15,35.478734105906966,0.6308434959349594,43.179563492063494,1027.2817460317463,25.055652342237714,0
2702,4,0,0,46,0.0,0.0,1.0,46,1200,800,400,0.6666666666666666,16,8,8,298.31137393068116,0.42397342995169085,0.19351248765171447,0.17806351959947875,132049.1944312993,-1321.6446765518815,130727.54975474741,1991,3,305.5869565217391,42,4,16,35.382294711039876,0.6307043650793651,43.04748062015504,1027.8100775193807,24.471668512366207,0
2703,4,0,0,46,0.0,0.0,1.0,46,900,500,400,0.5555555555555556,13,5,8,298.71041771995846,0.4238828502415459,0.1883790971131971,0.1785682981700369,132105.7879935721,-1307.7249770431583,130798.06301652895,1992,4,306.5869565217391,43,3,17,35.31534021125031,0.6298449612403101,42.99242424242424,1028.0303030303032,23.907681465821007,0
2704,4,0,0,46,0.0,0.0,1.0,46,1800,1300,500,0.7222222222222222,23,13,10,303.4830747993089,0.42364130434782604,0.07045849032640472,0.17068845444627057,129756.7131598009,-1316.530549126602,128440.1826106743,1993,5,307.5869565217391,41,5,13,37.55761116520611,0.6092479674796748,45.28769841269841,1018.8492063492058,24.849980642663557,8
2705,4,1,1,46,0.02127659574468085,0.02127659574468085,0.9787234042553191,47,1050,500,550,0.47619047619047616,16,5,11,298.5772795518628,0.42481884057971014,0.0700486021818425,0.1689369510754733,129990.70443482959,-1637.5458205636662,128353.15861426592,1994,0,302.02127659574467,42,5,14,37.44615482072724,0.6101190476190477,45.05813953488372,1019.7674418604647,24.28017718715392,0
2706,4,1,0,47,0.02127659574468085,0.0,1.0,47,1000,900,100,0.9,11,9,2,296.93830736669526,0.42647625655257476,0.10129057410246611,0.16897089095048087,130213.1325209573,-1666.9465664623503,128546.18595449494,1995,0,302.78723404255317,42,5,16,37.2634418810722,0.6123511904761905,44.84011627906977,1020.6395348837211,24.300941306755266,0
2707,4,0,0,47,0.0,0.0,1.0,47,900,800,100,0.8888888888888888,10,8,2,299.3537028144674,0.42643771199506625,0.10390222523587833,0.17078427435512733,130313.22830057939,-1598.0411270431405,128715.18717353625,1996,1,303.78723404255317,41,6,16,37.10082264542039,0.6148373983739837,44.74206349206349,1021.0317460317452,24.903213317847445,0
2708,4,1,0,48,0.020833333333333332,0.0,1.0,48,1200,1000,200,0.8333333333333334,14,10,4,303.5007867929173,0.42736037234042556,0.19977152592026437,0.16581660940231013,128610.97965867449,-1789.3565367877318,126821.62312188676,1997,0,298.4375,42,6,15,38.71839574576485,0.5962301587301587,46.41472868217055,1014.341085271319,24.150978220745692,7
2709,4,0,1,47,0.0,0.020833333333333332,0.9791666666666666,48,1700,1500,200,0.8823529411764706,19,15,4,325.53741275648105,0.4270279255319149,0.1564499065052658,0.1709449948846822,127017.00015943863,-1301.839762603041,125715.16039683559,1998,1,299.4375,41,7,17,39.78723796870388,0.5815548780487805,47.99107142857142,1008.0357142857131,24.58623693379788,7
2710,4,1,0,48,0.020833333333333332,0.0,1.0,48,1450,1000,450,0.6896551724137931,19,10,9,326.0194243792991,0.4297152039007092,0.16158677989956205,0.17307429554032983,127458.6781612432,-1289.1990227450383,126169.47913849815,1999,0,297.4791666666667,42,6,14,39.3230416146883,0.5845734126984127,47.553294573643406,1009.7868217054254,24.0425433739387,0
2711,4,1,0,49,0.02040816326530612,0.0,1.0,49,1200,900,300,0.75,15,9,6,318.214655924181,0.43326601473922904,0.16628208191941884,0.17010222593843924,127737.36230379068,-1670.4198411673633,126066.94246262332,2000,0,292.38775510204084,43,6,16,39.23546057767369,0.5859980620155039,47.27746212121212,1010.8901515151509,23.509073291050022,0
2712,4,0,3,46,0.0,0.061224489795918366,0.9387755102040817,49,1400,800,600,0.5714285714285714,20,8,12,321.2038050105449,0.4328762755102041,0.17572953165538885,0.17241703744334855,127904.9416394052,-1583.2892131542887,126321.6524262509,2001,1,293.38775510204084,43,6,17,38.98887536666042,0.5876937984496124,47.111742424242415,1011.5530303030284,23.524489076814614,0
2713,4,1,0,47,0.02127659574468085,0.0,1.0,47,1150,800,350,0.6956521739130435,15,8,7,328.28053243542047,0.43391535615171134,0.18761956220155085,0.17649621245697691,127968.81028163574,-998.0661651234631,126970.74411651227,2002,0,300.97872340425533,41,6,18,38.744709448638744,0.5912093495934959,47.04861111111111,1011.8055555555551,24.678184281842807,0
2714,4,1,0,48,0.020833333333333332,0.0,1.0,48,1050,700,350,0.6666666666666666,14,7,7,319.1705050852165,0.4353945035460993,0.18814267352185143,0.17292106751831357,128276.40109592005,-1411.2295645254671,126865.17153139459,2003,0,295.6875,39,9,19,38.66163239074552,0.5974893162393162,46.744791666666664,1013.0208333333326,25.974893162393144,0
2715,4,3,1,50,0.058823529411764705,0.0196078431372549,0.9803921568627451,51,1500,1000,500,0.6666666666666666,20,10,10,299.92907186936674,0.4406209150326797,0.2020402629339766,0.16560064868616695,129029.04652852891,-2460.087566101797,126568.95896242712,2004,0,279.2352941176471,42,9,18,38.38479573994596,0.6004464285714286,46.002906976744185,1015.988372093023,24.19019933554817,0
2716,4,1,0,51,0.0196078431372549,0.0,1.0,51,1100,500,600,0.45454545454545453,17,5,12,302.00214995968844,0.44026143790849676,0.2078109932497587,0.16747391952309973,129201.38888888879,-2395.9505137912497,126805.43837509754,2005,0,280.19607843137254,40,11,19,38.15744535519126,0.6052083333333333,45.83333333333333,1016.6666666666658,25.416666666666647,0
2717,4,0,1,50,0.0,0.0196078431372549,0.9803921568627451,51,1200,800,400,0.6666666666666666,16,8,8,300.7504213428543,0.44052287581699345,0.20898331048014662,0.16731383993642343,129327.49438027517,-2420.9403147833327,126906.55406549183,2006,1,281.19607843137254,41,10,19,38.06152264377905,0.6049288617886179,45.70932539682539,1017.1626984126976,24.808846302748723,0
2718,4,0,0,50,0.0,0.0,1.0,50,1150,600,550,0.5217391304347826,17,6,11,307.4654584885248,0.437610544217687,0.20721422861710614,0.17095079491961984,129304.72932778116,-2048.652422499831,127256.07690528133,2007,2,287.7,40,10,19,37.91383559818811,0.60625,45.73170731707317,1017.0731707317079,25.4268292682927,0
2719,4,0,1,49,0.0,0.02,0.98,50,1550,1100,450,0.7096774193548387,20,11,9,307.8417290790329,0.43804421768707485,0.20243274853801196,0.17202920154416554,129504.14540816336,-2026.6439909296928,127477.50141723367,2008,3,288.7,41,9,13,37.70224171539964,0.6067073170731707,45.53571428571429,1017.8571428571436,24.825783972125453,0
2720,4,0,0,49,0.0,0.0,1.0,49,1700,1300,400,0.7647058823529411,21,13,8,313.2468546306848,0.43714569160997735,0.2032135470263985,0.17496749855696112,129485.67450137172,-1687.8039485425184,127797.87055282919,2009,4,294.55102040816325,40,9,13,37.58341654185389,0.6080729166666667,45.553861788617894,1017.7845528455299,25.444613821138248,0
2721,4,0,0,49,0.0,0.0,1.0,49,1250,800,450,0.64,17,8,9,313.6236731389122,0.43691539115646255,0.2059111754914602,0.17540861718774345,129537.39636005364,-1674.8011889417564,127862.59517111188,2010,5,295.55102040816325,40,9,13,37.521421916076,0.60859375,45.50304878048781,1017.9878048780496,25.44969512195124,0
2722,4,0,0,49,0.0,0.0,1.0,49,1200,700,500,0.5833333333333334,17,7,10,311.2628234723644,0.4369508219954648,0.20094943475843574,0.17454755198749672,129640.8710609592,-1729.5232872298145,127911.34777372939,2011,6,296.55102040816325,40,9,14,37.476715563982296,0.6096354166666667,45.40142276422765,1018.3943089430903,25.459857723577258,0
2723,4,0,0,49,0.0,0.0,1.0,49,1450,900,550,0.6206896551724138,20,9,11,311.53956993397884,0.4371279761904762,0.20364590014395456,0.17493339548729805,129692.62390318263,-1719.1231451186418,127973.50075806398,2012,7,297.55102040816325,40,9,15,37.41727360404404,0.61015625,45.35060975609756,1018.5975609756097,25.46493902439024,0
2724,4,0,2,47,0.0,0.04081632653061224,0.9591836734693877,49,1250,700,550,0.56,18,7,11,312.1679008430642,0.4371279761904762,0.20739040456146585,0.1759826800199602,129847.94439693642,-1693.127953764284,128154.81644317214,2013,8,298.55102040816325,40,9,15,37.244075514341745,0.61171875,45.19817073170732,1019.2073170731712,25.48018292682928,0
2725,4,0,0,47,0.0,0.0,1.0,47,1800,1400,400,0.7777777777777778,22,14,8,327.149374806946,0.4312943262411348,0.2152656728809892,0.18356180047290283,129663.42872242327,-916.1380716268347,128747.29065079644,2014,9,311.8723404255319,38,9,15,37.04937235567679,0.6132127192982456,45.37927350427351,1018.4829059829071,26.802181736392292,0
2726,4,0,1,46,0.0,0.02127659574468085,0.9787234042553191,47,1550,1400,150,0.9032258064516129,17,14,3,327.35948745658106,0.4314292321924144,0.2106155445407616,0.18431846466120858,129799.4797373805,-901.781768208039,128897.69796917247,2015,10,312.8723404255319,38,9,16,36.90610365555322,0.6145833333333333,45.2457264957265,1019.017094017095,26.816239316239344,0
2727,4,1,3,44,0.02127659574468085,0.06382978723404255,0.9361702127659575,47,1250,1200,50,0.96,13,12,1,324.698042482299,0.4334528214616096,0.23308727746417723,0.18500237304224026,130262.58680555565,-939.9739297976363,129322.61287575802,2016,0,311.7659574468085,38,9,17,36.50510204081634,0.6192434210526316,44.79166666666667,1020.8333333333342,26.86403508771932,0
2728,4,0,0,44,0.0,0.0,1.0,44,1200,800,400,0.6666666666666666,16,8,8,343.4306563391981,0.43143278717406625,0.22302740275102884,0.1941374877384926,129954.95158366038,126.10286338104379,130081.05444704143,1329,1,285.75,37,7,17,36.3389208517045,0.6179617117117118,45.093201754385966,1019.6271929824563,27.55749170222855,0
2729,4,1,0,45,0.022222222222222223,0.0,1.0,45,1300,600,700,0.46153846153846156,20,6,14,334.49038842874654,0.43312289562289563,0.22284262142524836,0.19099380670980476,130346.55044100097,-279.70264889197995,130066.847792109,1330,0,280.3777777777778,37,8,19,36.17020562654353,0.6219031531531531,44.7094298245614,1021.1622807017535,27.598980559506852,0
2730,4,0,0,45,0.0,0.0,1.0,45,1050,700,350,0.6666666666666666,14,7,7,335.30839995401607,0.43259680134680134,0.22101986044015054,0.19173712373061114,130402.54122662723,-254.98651027241547,130147.55471635482,1331,1,281.3777777777778,37,8,19,36.09265968867419,0.6224662162162162,44.65460526315788,1021.3815789473668,27.604907539118024,0
2731,4,0,0,45,0.0,0.0,1.0,45,1300,900,400,0.6923076923076923,17,9,8,339.8274056785725,0.4321759259259259,0.22589452850210434,0.1948831749857609,130514.55886667041,-129.51521141121893,130385.0436552592,1332,2,282.3777777777778,37,8,17,35.8638936581178,0.6235923423423424,44.54495614035087,1021.8201754385957,27.616761498340423,0
2732,4,2,1,46,0.0425531914893617,0.02127659574468085,0.9787234042553191,47,1300,800,500,0.6153846153846154,18,8,10,327.75341702386993,0.4362087573234659,0.24109111180559695,0.19067225346030706,131067.83743142326,-808.4136839843791,130259.42374743888,1333,0,271.3191489361702,40,7,19,35.6137107979357,0.6239583333333334,44.00406504065042,1023.9837398373996,25.59959349593499,0
2733,4,0,0,46,0.0,0.0,1.0,46,1500,1000,500,0.6666666666666666,20,10,10,334.7740889402536,0.4335849436392915,0.24437331044460398,0.1943192541060765,130981.34901258693,-430.1676432291556,130551.18136935777,1334,1,278.1521739130435,39,7,19,35.521289135375326,0.624732905982906,44.08854166666667,1023.6458333333344,26.247329059829088,0
2734,4,1,0,47,0.02127659574468085,0.0,1.0,47,1350,700,650,0.5185185185185185,20,7,13,328.73446306297296,0.4343200740055504,0.24471144210381945,0.19241364248346404,131302.08462431436,-767.2959423953886,130534.78868191897,1335,0,273.21276595744683,40,7,20,35.35242108742358,0.6263020833333333,43.775406504065046,1024.8983739837408,25.62245934959352,0
2735,4,0,0,47,0.0,0.0,1.0,47,1250,600,650,0.48,19,6,13,327.6227873402608,0.4343008017267962,0.24120756228142626,0.1923164271449325,131412.4312889541,-789.2508481050951,130623.18044084901,1336,1,274.21276595744683,37,10,20,35.269734965957284,0.6326013513513513,43.667763157894726,1025.3289473684197,27.71159317211945,0
2736,4,1,0,48,0.020833333333333332,0.0,1.0,48,1550,1100,450,0.7096774193548387,20,11,9,318.29221432205946,0.4353945035460993,0.2297951558653215,0.1889896884668287,131848.80566741535,-1206.7103376799005,130642.09532973544,1337,0,269.4791666666667,38,10,18,35.07013072575333,0.6351425438596492,43.24252136752136,1027.0299145299139,27.0271030139451,0
2737,4,0,0,48,0.0,0.0,1.0,48,1350,900,450,0.6666666666666666,18,9,9,321.5008594371891,0.4354960845153664,0.22983822051228797,0.1914472919633092,131958.55391418276,-1115.042301300327,130843.51161288243,1338,1,270.4791666666667,38,10,18,34.87747391771517,0.6362390350877193,43.135683760683754,1027.4572649572638,27.03834907782273,0
2738,4,0,1,47,0.0,0.020833333333333332,0.9791666666666666,48,1100,700,400,0.6363636363636364,15,7,8,320.46098345720765,0.43518210697399523,0.2244253892660517,0.19155841585337274,132103.35422092024,-1133.2058376736013,130970.14838324665,1339,2,271.4791666666667,39,9,18,34.75877748505421,0.6359508547008548,42.99479166666667,1028.0208333333342,26.35950854700857,0
2739,4,0,1,46,0.0,0.02127659574468085,0.9787234042553191,47,1200,800,400,0.6666666666666666,16,8,8,325.0530363723766,0.435013876040703,0.22448693778615758,0.19513062213843252,132264.03130425335,-801.4350043402825,131462.59629991307,1340,3,268.1914893617021,39,8,19,34.47943037974685,0.6375534188034189,42.838541666666664,1028.6458333333326,26.37553418803417,0
2740,4,1,0,47,0.02127659574468085,0.0,1.0,47,1100,700,400,0.6363636363636364,15,7,8,327.6388736193941,0.43273974714770275,0.2322890118772607,0.1975264648591515,132425.49332493232,-722.3842888650473,131703.10903606727,1341,0,269.02127659574467,38,9,20,34.2508736419625,0.6408991228070176,42.681623931623925,1029.2735042735032,27.086144849302716,0
2741,4,0,0,47,0.0,0.0,1.0,47,1550,1300,250,0.8387096774193549,18,13,5,330.3274997119845,0.43191103916127044,0.2345934035667565,0.20013960276667292,132612.49999999988,-638.8888888889051,131973.61111111098,1342,1,270.02127659574467,39,8,21,33.99406688241639,0.641025641025641,42.49999999999999,1029.999999999999,26.410256410256387,0
2742,4,0,0,47,0.0,0.0,1.0,47,1150,900,250,0.782608695652174,14,9,5,331.18845992545124,0.431313598519889,0.23007806365985028,0.20109177760114408,132692.98095703122,-610.7231987847224,132082.2577582465,1343,2,271.02127659574467,39,8,18,33.89118474707649,0.6418269230769231,42.421875,1030.3124999999998,26.418269230769226,0
2743,4,0,2,45,0.0,0.0425531914893617,0.9574468085106383,47,1450,1300,150,0.896551724137931,16,13,3,329.18586116958346,0.4308510638297873,0.2333373467035902,0.20059256663387906,132827.1701388888,-655.034722222227,132172.13541666657,1344,3,272.02127659574467,39,8,18,33.80827270277555,0.6431623931623931,42.291666666666664,1030.8333333333326,26.43162393162391,0
2744,4,0,0,45,0.0,0.0,1.0,45,1600,1400,200,0.875,18,14,4,339.7589276281559,0.4302819865319865,0.22880728519898308,0.20607069884225473,132652.0314543899,13.942390927985826,132665.97384531787,1345,8,283.8,37,8,18,33.71152652119923,0.6449887387387387,42.46162280701755,1030.1535087719303,27.841986723565686,0
2745,4,0,0,45,0.0,0.0,1.0,45,950,700,250,0.7368421052631579,12,7,5,338.8525221409318,0.43013468013468015,0.22551662174303666,0.2060889929742389,132755.59413580256,-3.086419753079042,132752.50771604947,1346,9,284.8,38,7,18,33.63095238095239,0.6441885964912281,42.361111111111114,1030.555555555556,27.119883040935687,0
2746,4,0,1,44,0.0,0.022222222222222223,0.9777777777777777,45,1050,700,350,0.6666666666666666,14,7,7,340.23399285886865,0.42956649831649835,0.21920552677029392,0.2075384343292089,132865.71905361983,41.08682153555844,132906.80587515538,1347,10,285.8,38,7,18,33.484887737478424,0.6452850877192983,42.25427350427351,1030.9829059829071,27.131129104813347,0
2747,4,0,1,43,0.0,0.022727272727272728,0.9772727272727273,44,750,400,350,0.5333333333333333,11,4,7,339.7410148854645,0.42761187455954897,0.2133763811569216,0.20739029314735113,132893.2574169956,229.85802925708228,133123.11544625266,1348,11,289.45454545454544,38,6,18,33.46997720443477,0.6455592105263157,42.22756410256411,1031.089743589745,27.133940620782763,0
2748,4,0,0,43,0.0,0.0,1.0,43,1200,900,300,0.75,15,9,6,343.64703133236367,0.42665651531930604,0.21171241666405827,0.21101631758673242,133113.66705246916,548.8233024691444,133662.49035493832,1349,12,288.16279069767444,38,5,19,33.14827276805743,0.6477521929824561,42.01388888888889,1031.9444444444448,27.15643274853802,0
2749,4,0,1,42,0.0,0.023255813953488372,0.9767441860465116,43,1500,1000,500,0.6666666666666666,20,10,10,345.9638179049907,0.4257105943152455,0.21051263850623814,0.21338483089034674,133279.09412895385,621.9488503542948,133901.04297930814,1350,13,289.16279069767444,38,5,19,32.922702190032766,0.6493969298245614,41.85363247863248,1032.5854700854695,27.173301844354462,0
2750,4,0,1,41,0.0,0.023809523809523808,0.9761904761904762,42,800,500,300,0.625,11,5,6,351.86300988952206,0.4235143244289586,0.20932055132522298,0.21715896639184273,133302.32018505692,980.8311211141875,134283.15130617112,1351,16,296.73809523809524,37,5,20,32.74713314928858,0.6514639639639639,41.83114035087719,1032.6754385964912,27.910146989094358,0
2751,4,0,0,41,0.0,0.0,1.0,41,1100,800,300,0.7272727272727273,14,8,6,349.06809063780395,0.42357723577235773,0.19188096359842843,0.21609195466421724,133415.57618690355,1114.2240881809698,134529.8002750845,1352,17,293.0731707317073,37,4,20,32.70581263709049,0.6525900900900901,41.72149122807017,1033.1140350877185,27.922000948316718,0
2752,4,0,0,41,0.0,0.0,1.0,41,1400,1000,400,0.7142857142857143,18,10,8,351.0497227951744,0.42284044715447155,0.19772655392457827,0.2178217245497847,133501.3153990138,1173.1319756531157,134674.44737466692,1353,18,294.0731707317073,36,5,21,32.56874069231048,0.6553819444444444,41.63851351351351,1033.4459459459454,28.706831831831817,0
2753,4,0,0,41,0.0,0.0,1.0,41,1350,1000,350,0.7407407407407407,17,10,7,353.66574500115354,0.4224847560975609,0.1953078524687688,0.22065667133767602,133705.05640775897,1257.3796769742567,134962.43608473323,1354,19,295.0731707317073,36,5,20,32.29711091753774,0.6574074074074074,41.441441441441434,1034.234234234233,28.728728728728697,0
2754,4,0,0,41,0.0,0.0,1.0,41,1200,700,500,0.5833333333333334,17,7,10,353.1218357070191,0.42266260162601627,0.19181858013463082,0.2204910986382712,133734.17494775177,1244.891470862749,134979.06641861453,1355,20,296.0731707317073,36,5,20,32.28202685538014,0.6576967592592593,41.413288288288285,1034.3468468468466,28.73185685685685,0
2755,4,0,0,41,0.0,0.0,1.0,41,950,500,450,0.5263157894736842,14,5,9,354.927323168529,0.4220782520325203,0.19820159451186337,0.2219685036044436,133792.42153893757,1297.3172074101121,135089.7387463477,1356,21,297.0731707317073,36,5,20,32.177034577845504,0.658275462962963,41.35698198198198,1034.572072072072,28.73811311311311,0
2756,4,0,2,39,0.0,0.04878048780487805,0.9512195121951219,41,1250,1000,250,0.8,15,10,5,355.5500260945111,0.4220782520325203,0.194708017576259,0.22323878687573429,133938.09349890446,1324.3385277169239,135262.4320266214,1357,22,298.0731707317073,36,5,21,32.01515810850016,0.6597222222222222,41.216216216216225,1035.1351351351364,28.753753753753788,0
2757,4,0,0,39,0.0,0.0,1.0,39,1600,1000,600,0.625,22,10,12,368.5954136637464,0.4197312190733244,0.1848112392228347,0.2310165775759877,133872.3232001135,2068.9448696145287,135941.26806972802,1018,23,277.8205128205128,34,5,21,31.743452586372175,0.663296568627451,41.27976190476191,1034.8809523809534,30.437675070028043,0
2758,4,0,0,39,0.0,0.0,1.0,39,800,500,300,0.625,11,5,6,369.40036537341155,0.4189158794421952,0.1831720819993985,0.23249235730954682,134026.3676303856,2101.8778344671323,136128.24546485272,1019,24,278.8205128205128,34,5,21,31.568320303518046,0.664828431372549,41.13095238095239,1035.4761904761913,30.455182072829157,0
2759,4,0,0,39,0.0,0.0,1.0,39,1150,900,250,0.782608695652174,14,9,5,371.58044825762806,0.41846603688708955,0.18103430492811023,0.23445405948438153,134118.8368055555,2167.187499999996,136286.0243055555,1020,25,279.8205128205128,34,5,21,31.41928130866183,0.6657475490196079,41.041666666666664,1035.833333333333,30.465686274509796,0
2760,4,0,1,38,0.0,0.02564102564102564,0.9743589743589743,39,1050,800,250,0.7619047619047619,13,8,5,371.54485120858703,0.4180443094916779,0.18967600785782635,0.235276704223599,134250.74615269207,2176.034700788758,136426.78085348083,1021,26,280.8205128205128,35,4,21,31.288157992703457,0.6648809523809525,40.914351851851855,1036.3425925925928,29.609788359788368,0
2761,4,0,0,38,0.0,0.0,1.0,38,1450,1000,450,0.6896551724137931,19,10,9,362.8027069133556,0.41662221431958274,0.10374721682694577,0.21787773371931796,132278.91375171472,1998.5644933127617,134277.47824502748,1022,27,284.42105263157896,35,3,18,33.49366186618663,0.6452380952380952,42.824074074074076,1028.703703703704,29.391534391534396,8
2762,4,0,0,38,0.0,0.0,1.0,38,750,500,250,0.6666666666666666,10,5,5,361.0942647806062,0.416474039829303,0.10451736629021968,0.2175372765873407,132398.00347222216,1961.685528120704,134359.68900034286,1023,28,285.42105263157896,34,4,19,33.41767881241566,0.6485906862745099,42.70833333333333,1029.166666666666,30.269607843137237,0
2763,4,0,0,38,0.0,0.0,1.0,38,1000,800,200,0.8,12,8,4,360.6084822898877,0.41576280227596013,0.10911209692632529,0.2179526738871586,132520.55165816328,1957.6070011337893,134478.15865929707,1024,29,286.42105263157896,34,4,19,33.30683701391297,0.6498161764705883,42.589285714285715,1029.6428571428573,30.28361344537816,0
2764,4,0,0,38,0.0,0.0,1.0,38,1100,800,300,0.7272727272727273,14,8,6,359.98078081474324,0.41567389758179235,0.10533920629802496,0.2179281829830891,132581.84700963716,1945.383361678005,134527.23037131518,1025,30,287.42105263157896,34,4,19,33.26132817015373,0.6504289215686274,42.529761904761905,1029.8809523809523,30.290616246498598,0
2765,4,0,0,38,0.0,0.0,1.0,38,1250,800,450,0.64,17,8,9,360.27669602336255,0.4148737553342816,0.1012796029824965,0.21864197246747405,132673.8166099773,1959.8568594104293,134633.67346938775,1026,31,288.42105263157896,34,4,16,33.161206763731606,0.6513480392156863,42.44047619047619,1030.2380952380952,30.30112044817927,0
2766,4,0,0,38,0.0,0.0,1.0,38,800,500,300,0.625,11,5,6,359.2266943361543,0.41398470839260315,0.10261820215974282,0.21836139509647134,132735.1473922902,1936.4016439909274,134671.54903628113,1027,32,289.42105263157896,34,4,16,33.12658849353049,0.6519607843137255,42.38095238095238,1030.4761904761904,30.308123249299715,0
2767,4,0,0,38,0.0,0.0,1.0,38,1100,800,300,0.7272727272727273,14,8,6,358.37385142291873,0.41355500237079185,0.09720826881936495,0.2183089959488722,132815.2394654491,1919.5017789780368,134734.74124442713,1028,33,290.42105263157896,35,3,16,33.06806272924619,0.6505952380952381,42.30324074074073,1030.787037037036,29.451058201058174,0
2768,4,0,0,38,0.0,0.0,1.0,38,1450,1000,450,0.6896551724137931,19,10,9,359.5959595959595,0.41242887624466573,0.10053163211057958,0.2197530864197532,132934.57031250012,1960.5468750000143,134895.11718750012,1029,34,291.42105263157896,35,3,16,32.916666666666664,0.6517857142857143,42.18750000000001,1031.250000000001,29.46428571428574,0
2769,4,0,0,38,0.0,0.0,1.0,38,1550,1400,150,0.9032258064516129,17,14,3,356.9972404044051,0.4115546467520152,0.10425657525754928,0.21903856835549032,133083.80922335834,1902.1105270490577,134985.9197504074,1030,35,292.42105263157896,35,3,16,32.83382407926716,0.6532738095238095,42.04282407407408,1031.8287037037048,29.48082010582014,0
2770,4,0,0,38,0.0,0.0,1.0,38,900,400,500,0.4444444444444444,14,4,10,356.5795489374095,0.4110212185870081,0.1035370970311753,0.2194846788801074,133203.26063368056,1899.5117187500048,135102.77235243056,1031,36,293.42105263157896,35,3,17,32.724730911537186,0.6544642857142857,41.927083333333336,1032.2916666666667,29.49404761904762,0
2771,4,0,0,38,0.0,0.0,1.0,38,1100,900,200,0.8181818181818182,13,9,4,356.4946867471459,0.4107989568515884,0.1026262697766609,0.21996165941618515,133292.8843557099,1903.64101080247,135196.52536651236,1032,37,294.42105263157896,35,3,18,32.63702084734365,0.6553571428571429,41.84027777777778,1032.638888888889,29.503968253968253,0
2772,4,0,0,38,0.0,0.0,1.0,38,1350,1000,350,0.7407407407407407,17,10,7,354.87279303229155,0.4110064011379801,0.10067470334284834,0.21931335214821124,133352.65024862834,1864.6454903978133,135217.29573902616,1033,38,295.42105263157896,35,3,18,32.61896757806664,0.655952380952381,41.78240740740741,1032.870370370371,29.510582010582027,0
2773,4,0,0,38,0.0,0.0,1.0,38,1250,600,650,0.48,19,6,13,352.81464241188934,0.4097321005215742,0.11135371179039266,0.2192754051065125,133561.93636670534,1824.5213638117339,135386.45773051708,1034,39,296.42105263157896,35,3,18,32.462420221699695,0.6580357142857143,41.579861111111114,1033.680555555556,29.533730158730176,0
2774,4,0,0,38,0.0,0.0,1.0,38,1050,600,450,0.5714285714285714,15,6,9,356.2276724312412,0.40962837837837834,0.11343215870191536,0.22175482911695313,133621.7625412594,1919.9538912465694,135541.716432506,1035,40,297.42105263157896,35,3,18,32.31428877943206,0.6586309523809524,41.52199074074074,1033.912037037037,29.540343915343914,0
2775,4,0,0,38,0.0,0.0,1.0,38,950,600,350,0.631578947368421,13,6,7,355.753717472864,0.4091986723565671,0.11357960703010894,0.22199826950680934,133711.52692043892,1913.6745541838095,135625.20147462274,1036,41,298.42105263157896,35,3,16,32.23664577737988,0.6595238095238095,41.43518518518518,1034.259259259259,29.55026455026454,0
2776,4,0,1,37,0.0,0.02631578947368421,0.9736842105263158,38,800,400,400,0.5,12,4,8,356.1849198165344,0.40887268847795166,0.11347194179386522,0.22317094380375832,133861.2011986667,1935.8682430984081,135797.0694417651,1037,42,299.42105263157896,35,3,17,32.07566733773255,0.6610119047619047,41.29050925925925,1034.837962962962,29.56679894179891,0
2777,4,0,0,37,0.0,0.0,1.0,37,650,300,350,0.46153846153846156,10,3,7,357.45903188042905,0.4066566566566567,0.10323036891302562,0.22433376295485427,133921.0943528162,2174.2609471450405,136095.35529996123,1038,43,294.8918918918919,35,2,17,31.98276585038577,0.6616071428571428,41.23263888888888,1035.0694444444432,29.573412698412664,0
2778,4,0,1,36,0.0,0.02702702702702703,0.972972972972973,37,1100,700,400,0.6363636363636364,15,7,8,355.621482807635,0.40618743743743746,0.09892592637340036,0.22409162170159985,134070.88584533607,2135.697445130313,136206.5832904664,1039,44,295.8918918918919,35,2,17,31.880494710177317,0.6630952380952381,41.08796296296296,1035.648148148148,29.58994708994709,0
2779,4,0,0,36,0.0,0.0,1.0,36,1050,600,450,0.5714285714285714,15,6,9,351.3148092650605,0.40395171957671955,0.08433563984591075,0.22216134433318357,134200.5027620526,2229.324806225146,136429.82756827775,1040,45,297.47222222222223,36,0,17,31.862478716081597,0.6623263888888888,40.96283783783784,1036.1486486486488,28.78190690690691,0
2780,4,0,0,36,0.0,0.0,1.0,36,1200,1000,200,0.8333333333333334,14,10,4,352.438502920239,0.4037037037037037,0.08598314742382529,0.22340523284282912,134288.02958363772,2265.654421313207,136553.68400495092,1041,46,298.47222222222223,36,0,17,31.745934738519477,0.6631944444444444,40.87837837837838,1036.4864864864867,28.791291291291298,0
2781,4,0,0,36,0.0,0.0,1.0,36,1000,600,400,0.6,14,6,8,352.944869341949,0.40223214285714287,0.09185157032371705,0.22462123716447868,134433.97102761536,2289.556067892207,136723.52709550757,1042,47,299.47222222222223,36,0,18,31.5870796684403,0.6646412037037037,40.73761261261261,1037.0495495495488,28.806931931931913,0
2782,4,0,0,36,0.0,0.0,1.0,36,1000,600,400,0.6,14,6,8,352.88247559442664,0.40244708994708994,0.09751169971534712,0.22512142418115355,134521.5739388036,2294.0612064767374,136815.63514528034,1043,48,300.47222222222223,36,0,18,31.50125741786076,0.6655092592592593,40.65315315315315,1037.3873873873868,28.8163163163163,0
2783,4,0,0,36,0.0,0.0,1.0,36,1200,900,300,0.75,15,9,6,354.2263834689348,0.4021329365079365,0.0961719582620768,0.22653307804439854,134610.8284572187,2336.5445584316726,136947.37301565037,1044,49,301.47222222222223,35,1,19,31.37733288720351,0.668452380952381,40.567129629629626,1037.7314814814808,29.64947089947088,0
2784,4,0,0,36,0.0,0.0,1.0,36,800,400,400,0.5,12,4,8,342.7602376032102,0.4017361111111111,0.08642549055342941,0.20744820469102285,132571.90626014516,1888.0756178475672,134459.98187799272,1045,50,302.47222222222223,36,0,20,33.71468926553672,0.6461226851851851,42.53941441441441,1029.8423423423415,28.606731731731706,8
2785,4,0,1,35,0.0,0.027777777777777776,0.9722222222222222,36,600,400,200,0.6666666666666666,8,4,4,346.0848077831602,0.4015542328042328,0.09145289802264012,0.20994587676394882,132658.9004545085,1982.246012904786,134641.1464674133,1046,51,303.47222222222223,36,0,18,33.54171221396296,0.6469907407407407,42.45495495495495,1030.1801801801796,28.6161161161161,0
2786,4,0,0,35,0.0,0.0,1.0,35,800,600,200,0.75,10,6,4,350.3658628960992,0.3999299719887955,0.10054574638844316,0.2124152711018582,132636.3436642659,2294.2493998628033,134930.5930641287,1047,52,311.1714285714286,35,0,18,33.45411985018727,0.6488095238095238,42.47685185185184,1030.092592592591,29.431216931216888,0
2787,4,0,0,35,0.0,0.0,1.0,35,850,600,250,0.7058823529411765,11,6,5,350.1312198970684,0.3996848739495798,0.09798119202747402,0.21261037650229886,132695.96220207462,2292.1998242455265,134988.16202632015,1048,53,312.1714285714286,35,0,18,33.400265857859665,0.6494047619047619,42.418981481481474,1030.324074074073,29.437830687830658,0
2788,4,0,0,35,0.0,0.0,1.0,35,900,500,400,0.5555555555555556,13,5,8,355.4425143551083,0.3993347338935574,0.0679500796601169,0.2078566007859221,131267.12018140592,2363.746651567006,133630.8668329729,1049,54,313.1714285714286,34,1,21,34.703425108426266,0.6372549019607843,43.80952380952381,1024.7619047619048,30.140056022408967,8
2789,4,1,0,36,0.027777777777777776,0.0,1.0,36,1650,1500,150,0.9090909090909091,18,15,3,343.2173022347626,0.4013723544973545,0.07041568415220278,0.20312716521416327,131725.001771542,1842.0741213151987,133567.07589285722,1050,0,305.44444444444446,34,2,19,34.55487262746916,0.6418504901960784,43.36309523809524,1026.5476190476195,30.192577030812338,0
2790,4,0,0,36,0.0,0.0,1.0,36,900,500,400,0.5555555555555556,13,5,8,343.7971081156594,0.40150462962962963,0.07439033555029506,0.20372906787535178,131773.3802324461,1860.661410108038,133634.04164255413,1051,1,306.44444444444446,35,1,19,34.49124957727426,0.6401785714285715,43.31597222222223,1026.736111111112,29.335317460317487,0
2791,4,0,0,36,0.0,0.0,1.0,36,1050,600,450,0.5714285714285714,15,6,9,341.7514937512399,0.40071097883597884,0.07324256651017258,0.20315100516023135,131892.24222232937,1814.874158736282,133707.11638106566,1052,2,307.44444444444446,35,1,20,34.42406103286387,0.6413690476190477,43.20023148148148,1027.199074074074,29.348544973544968,0
2792,4,0,0,36,0.0,0.0,1.0,36,1300,1000,300,0.7692307692307693,16,10,6,342.51827142153377,0.4003472222222222,0.07322208456908363,0.20424578455015432,132011.157795889,1843.2467153206449,133854.40451120966,1053,3,308.44444444444446,35,1,21,34.28466512745431,0.6425595238095239,43.08449074074074,1027.6620370370367,29.361772486772477,0
2793,4,1,1,36,0.02702702702702703,0.02702702702702703,0.972972972972973,37,750,600,150,0.8,9,6,3,334.00722423994046,0.4028403403403404,0.07421411559342594,0.20060197195475715,132282.1316882761,1436.6375243486696,133718.7692126248,1054,0,301.0810810810811,36,1,23,34.23097974822113,0.6432291666666667,42.820945945945944,1028.716216216216,28.575450450450447,0
2794,4,0,0,36,0.0,0.0,1.0,36,850,600,250,0.7058823529411765,11,6,5,332.5738825419201,0.40100859788359783,0.07411156095366644,0.2003554853362298,132398.00347222216,1606.4236111111022,134004.42708333326,1055,1,304.5833333333333,35,1,23,34.15148448043185,0.6464285714285714,42.70833333333333,1029.166666666666,29.404761904761887,0
2795,4,0,0,36,0.0,0.0,1.0,36,650,300,350,0.46153846153846156,10,3,7,331.8412915496908,0.4010416666666667,0.0739887064937661,0.20023042381566825,132457.56842635458,1590.97811642661,134048.5465427812,1056,2,305.5833333333333,35,1,23,34.11054268795442,0.6470238095238094,42.65046296296296,1029.398148148148,29.411375661375658,0
2796,4,0,0,36,0.0,0.0,1.0,36,1200,1000,200,0.8333333333333334,14,10,4,331.3218936799093,0.4011574074074074,0.07604162764855027,0.2007102472333228,132606.5394188314,1587.0899509173555,134193.62936974876,1057,3,306.5833333333333,35,1,23,33.97444001198638,0.6485119047619048,42.50578703703704,1029.9768518518517,29.42791005291005,0
2797,4,0,0,36,0.0,0.0,1.0,36,1000,800,200,0.8,12,8,4,329.23476707896816,0.40071097883597884,0.07130243238858291,0.20008035025966242,132725.77649444877,1539.5880219050105,134265.3645163538,1058,4,307.5833333333333,35,1,19,33.90863098581002,0.649702380952381,42.3900462962963,1030.4398148148152,29.441137566137577,0
2798,4,0,0,36,0.0,0.0,1.0,36,800,600,200,0.75,10,6,4,330.25918388621176,0.4003306878306878,0.07604899466147752,0.20150334315468313,132874.89819101506,1576.631087105618,134451.52927812067,1059,5,308.5833333333333,35,1,21,33.73278700793294,0.6511904761904762,42.24537037037037,1031.0185185185182,29.45767195767195,0
2799,4,0,1,35,0.0,0.027777777777777776,0.9722222222222222,36,950,700,250,0.7368421052631579,12,7,5,330.53770023466984,0.40028108465608464,0.07951739618406295,0.20199526125452055,132934.5703125,1587.9774305555568,134522.54774305556,1060,6,309.5833333333333,35,1,22,33.66582491582491,0.6517857142857143,42.1875,1031.25,29.464285714285715,0
2800,4,0,1,34,0.0,0.02857142857142857,0.9714285714285714,35,700,400,300,0.5714285714285714,10,4,6,333.1109657435611,0.40014005602240893,0.08256166732621018,0.2038187434464839,132980.61224489784,1859.460034013583,134840.07227891142,1061,7,313.2,34,1,22,33.55335295475529,0.6544117647058824,42.14285714285713,1031.4285714285704,30.336134453781483,0
2801,4,0,0,34,0.0,0.0,1.0,34,850,600,250,0.7058823529411765,11,6,5,342.3567401052184,0.39562908496732024,0.09139604486587793,0.2086887607076158,132839.80320069205,2295.7203960015413,135135.5235966936,1062,12,323.20588235294116,33,1,22,33.45617372008242,0.6553030303030303,42.279411764705884,1030.8823529411766,31.238859180035654,0
2802,4,0,0,34,0.0,0.0,1.0,34,850,400,450,0.47058823529411764,13,4,9,344.0508047164687,0.39557338086749855,0.08822132012325112,0.21096603968739588,133060.9790254948,2355.9473820165144,135416.92640751132,1063,13,324.20588235294116,33,1,22,33.190674862414404,0.6575126262626263,42.06495098039215,1031.7401960784298,31.264854426619085,0
2803,4,0,0,34,0.0,0.0,1.0,34,1300,1000,300,0.7692307692307693,16,10,6,343.12309698422615,0.3954248366013072,0.07847211067734738,0.21111218742864393,133187.44781153876,2339.937914504029,135527.3857260428,1064,14,325.20588235294116,33,1,22,33.08784973683171,0.6587752525252526,41.94240196078431,1032.230392156862,31.279708853238244,0
2804,4,0,0,34,0.0,0.0,1.0,34,900,600,300,0.6666666666666666,12,6,6,342.866760641373,0.395257724301842,0.08042846768336998,0.21113374207916114,133219.0743944636,2335.2784986543534,135554.35289311793,1065,15,326.20588235294116,33,1,23,33.06277698638809,0.6590909090909092,41.91176470588235,1032.3529411764698,31.283422459893025,0
2805,4,0,0,34,0.0,0.0,1.0,34,1100,1100,0,1.0,11,11,0,341.46493989724627,0.39499777183600715,0.07703081232493059,0.21048510474263063,133257.03124999983,2300.5208333333194,135557.55208333314,1066,16,327.20588235294116,34,0,23,33.06093623890236,0.6571691176470589,41.87499999999999,1032.4999999999986,30.36764705882349,0
2806,4,0,0,34,0.0,0.0,1.0,34,1100,800,300,0.7272727272727273,14,8,6,345.2139093800842,0.3955362448009507,0.07781679161639321,0.21367805318119593,133410.72137188193,2411.0473356008893,135821.7687074828,1067,17,328.20588235294116,34,0,23,32.810219328570334,0.6587009803921569,41.72619047619047,1033.095238095237,30.385154061624615,0
2807,4,0,0,34,0.0,0.0,1.0,34,900,700,200,0.7777777777777778,11,7,4,344.6930280957336,0.39475638740344626,0.07779886148007598,0.21370967741935476,133472.2222222222,2401.3888888888846,135873.61111111107,1068,18,329.20588235294116,34,0,23,32.762096774193544,0.6593137254901961,41.666666666666664,1033.3333333333333,30.392156862745097,0
2808,4,0,0,34,0.0,0.0,1.0,34,450,300,150,0.6666666666666666,6,3,3,345.068636828612,0.39470068330362446,0.07933146764062138,0.21412014555462333,133502.9779620181,2413.5381235827617,135916.51608560086,1069,19,330.20588235294116,34,0,23,32.72160465384172,0.6596200980392157,41.63690476190476,1033.4523809523807,30.395658263305315,0
2809,4,0,0,34,0.0,0.0,1.0,34,1050,800,250,0.7619047619047619,13,8,5,340.9556078580407,0.39419934640522875,0.07727106499979741,0.21244909683320942,133656.80980725613,2314.207766439901,135971.01757369604,1070,20,331.20588235294116,34,0,23,32.67398687543174,0.6611519607843137,41.488095238095234,1034.0476190476181,30.413165266106414,0
2810,4,0,0,34,0.0,0.0,1.0,34,750,500,250,0.6666666666666666,10,5,5,339.57659360056965,0.393048128342246,0.07960468422121392,0.2122964459272627,133779.9390589569,2285.7071995464753,136065.64625850337,1071,21,332.20588235294116,34,0,20,32.5865458381281,0.6623774509803921,41.36904761904761,1034.5238095238092,30.42717086834733,0
2811,4,0,0,34,0.0,0.0,1.0,34,850,600,250,0.7058823529411765,11,6,5,340.31651198913,0.3928624480095068,0.08430425310220735,0.213471266611363,133903.12499999974,2313.888888888861,136217.01388888858,1072,22,333.20588235294116,34,0,20,32.44431025228126,0.6636029411764706,41.249999999999986,1034.999999999998,30.441176470588175,0
2812,4,0,0,34,0.0,0.0,1.0,34,1250,900,350,0.72,16,9,7,337.5509068873676,0.3925653594771242,0.08026002489312178,0.21209123455870987,133964.73922902477,2243.983843537386,136208.72307256216,1073,23,334.20588235294116,34,0,20,32.454337243176916,0.6642156862745099,41.190476190476176,1035.2380952380936,30.448179271708636,0
2813,4,0,0,34,0.0,0.0,1.0,34,950,800,150,0.8421052631578947,11,8,3,337.4504145142546,0.39217543077837197,0.07918552036199156,0.21220580296677283,133995.551658163,2243.3708900226457,136238.92254818563,1074,24,335.20588235294116,34,0,21,32.426171860028354,0.6645220588235294,41.16071428571427,1035.3571428571406,30.451680672268843,0
2814,4,0,0,34,0.0,0.0,1.0,34,1100,700,400,0.6363636363636364,15,7,8,336.8355488534477,0.3923611111111111,0.05036913550845412,0.2029228794312235,132398.0034722223,2119.2708333333376,134517.27430555565,1075,25,336.20588235294116,34,0,21,34.04183535762482,0.6485906862745099,42.708333333333336,1029.1666666666672,30.26960784313727,8
2815,4,0,0,34,0.0,0.0,1.0,34,800,400,400,0.5,12,4,8,338.37463036546575,0.3902814913844326,0.047478360203172754,0.20484807048926815,132581.84700963704,2172.466695011324,134754.31370464838,1076,26,337.20588235294116,34,0,21,33.81762224020344,0.6504289215686274,42.5297619047619,1029.8809523809514,30.29061624649857,0
2816,4,0,0,34,0.0,0.0,1.0,34,950,700,250,0.7368421052631579,12,7,5,340.64835688903145,0.3898172905525847,0.054717981484250666,0.2067300757726283,132673.81660997734,2239.023526077096,134912.84013605444,1077,27,338.20588235294116,34,0,17,33.66675333179261,0.6513480392156863,42.44047619047619,1030.2380952380954,30.301120448179276,0
2817,4,0,0,34,0.0,0.0,1.0,34,550,200,350,0.36363636363636365,9,2,7,339.60742455096164,0.38907456922162803,0.05113759921713612,0.20643552436187676,132735.1473922903,2215.568310657608,134950.7157029479,1078,28,339.20588235294116,34,0,18,33.632018253234754,0.6519607843137255,42.38095238095239,1030.476190476191,30.308123249299737,0
2818,4,0,0,34,0.0,0.0,1.0,34,1400,1000,400,0.7142857142857143,18,10,8,339.7499791099162,0.38898172905525846,0.04883853576060471,0.20771023775788316,132949.9167375284,2233.946286848079,135183.86302437648,1079,29,340.20588235294116,34,0,18,33.412934318365465,0.6541053921568627,42.17261904761905,1031.3095238095243,30.332633053221304,0
2819,4,0,0,34,0.0,0.0,1.0,34,1000,800,200,0.8,12,8,4,340.8782011725749,0.387979055258467,0.04952863803880825,0.20908643804406993,133072.72002551027,2272.317885487532,135345.0379109978,1080,30,341.20588235294116,34,0,18,33.26073997153955,0.6553308823529411,42.05357142857143,1031.785714285715,30.346638655462204,0
2820,4,0,0,34,0.0,0.0,1.0,34,750,500,250,0.6666666666666666,10,5,5,340.24296581144864,0.387979055258467,0.04975470405026705,0.20904084129124376,133134.14292800456,2259.5911281179156,135393.73405612248,1081,31,342.20588235294116,34,0,18,33.21557657553737,0.6559436274509804,41.99404761904762,1032.0238095238096,30.353641456582636,0
2821,4,0,0,34,0.0,0.0,1.0,34,1000,600,400,0.6,14,6,8,340.2216902957019,0.3879047831253714,0.05282991988168817,0.20937276625649626,133195.5800028346,2263.205073696161,135458.78507653077,1082,32,343.20588235294116,34,0,18,33.154576557874904,0.6565563725490196,41.93452380952382,1032.2619047619057,30.36064425770311,0
2822,4,0,0,34,0.0,0.0,1.0,34,950,600,350,0.631578947368421,13,6,7,340.2807900595701,0.3872549019607843,0.050082057263763025,0.20992856137814445,133287.76218820864,2271.0530045351466,135558.8151927438,1083,33,344.20588235294116,34,0,19,33.06072746137882,0.6574754901960784,41.845238095238095,1032.6190476190477,30.371148459383758,0
2823,4,0,0,34,0.0,0.0,1.0,34,1000,800,200,0.8,12,8,4,340.40459400480097,0.38682783719548425,0.053018442081291584,0.21087590802053313,133441.47002551032,2284.8178854875378,135726.28791099787,1084,34,345.20588235294116,34,0,21,32.90365633521526,0.6590073529411764,41.69642857142858,1033.2142857142865,30.388655462184897,0
2824,4,0,0,34,0.0,0.0,1.0,34,1300,1000,300,0.7692307692307693,16,10,6,337.8181372201421,0.385769459298871,0.05336244054178452,0.2098054616579294,133535.54672481754,2222.1494725341327,135757.69619735167,1085,35,346.20588235294116,33,1,21,32.87635364793298,0.6622474747474747,41.605392156862756,1033.5784313725503,31.32055852644092,0
2825,4,0,0,34,0.0,0.0,1.0,34,1000,700,300,0.7,13,7,6,372.46372926888694,0.38485962566844917,0.017629700349339306,0.22095167834747312,131813.89534550047,3086.5959850152944,134900.49133051577,1086,36,347.20588235294116,32,2,15,33.71449649575802,0.6474609375,43.27651515151515,1026.8939393939393,32.0904356060606,8
2826,4,0,0,34,0.0,0.0,1.0,34,900,500,400,0.5555555555555556,13,5,8,372.63994312328555,0.3840054961378491,0.021088976463357056,0.22143359658933,131878.73247946645,3028.6566740638773,134907.38915353033,1087,37,348.20588235294116,32,2,15,33.64448883425526,0.6481119791666667,43.21338383838384,1027.1464646464651,32.098327020202035,0
2827,4,0,0,34,0.0,0.0,1.0,34,1400,1100,300,0.7857142857142857,17,11,6,376.1869978086193,0.3830213903743316,0.022337042925278272,0.22449869224062782,132040.89506172854,3134.4135802469323,135175.30864197548,1088,38,349.20588235294116,32,2,16,33.38963963963963,0.6497395833333333,43.055555555555564,1027.777777777779,32.11805555555559,0
2828,4,0,0,34,0.0,0.0,1.0,34,850,600,250,0.7058823529411765,11,6,5,378.15559828929383,0.38296568627450983,0.024536886577835704,0.22664292480252377,132203.15728305787,3198.6728076216727,135401.83009067955,1089,39,350.20588235294116,32,2,16,33.17526089625537,0.6513671875,42.89772727272727,1028.409090909091,32.13778409090909,0
2829,4,0,0,34,0.0,0.0,1.0,34,550,500,50,0.9090909090909091,6,5,1,377.4676480284405,0.3828357100415924,0.026501639202206828,0.22642499711632375,132235.6216840119,3182.933820528525,135418.55550454042,1090,40,351.20588235294116,32,2,16,33.160191095834364,0.6516927083333333,42.86616161616162,1028.5353535353538,32.14172979797981,0
2830,4,1,0,35,0.02857142857142857,0.0,1.0,35,550,300,250,0.5454545454545454,8,3,5,369.49466413416184,0.38718487394957984,0.025191280987520326,0.2233449041766349,132524.15687475956,2793.3937668204408,135317.55064158,1091,0,342.14285714285717,33,2,18,33.07446639688963,0.6521464646464646,42.58578431372548,1029.6568627450968,31.20172311348778,0
2831,4,0,1,34,0.0,0.02857142857142857,0.9714285714285714,35,600,500,100,0.8333333333333334,7,5,2,372.00042986765834,0.38728991596638657,0.011566495399689236,0.21878226265371997,131485.187863442,2785.888390282594,134271.0762537246,1092,1,343.14285714285717,33,2,19,34.0586041741347,0.641729797979798,43.5968137254902,1025.6127450980398,31.079174093879995,8
2832,4,1,0,35,0.02857142857142857,0.0,1.0,35,750,400,350,0.5333333333333333,11,4,7,404.9019354755124,0.3867997198879552,-0.05253899378444915,0.22231801698645823,128808.3351048754,3430.9488378684946,132239.2839427439,1093,0,344.0857142857143,34,1,19,35.94464641726282,0.6124387254901961,46.2202380952381,1015.1190476190485,29.856442577030837,8
2833,4,0,0,35,0.0,0.0,1.0,35,1000,700,300,0.7,13,7,6,401.2824024318266,0.38665966386554623,-0.04922067268252639,0.22134083645447838,128989.67013888908,3352.256944444469,132341.92708333355,1094,1,345.0857142857143,34,1,19,35.85076565490839,0.6142769607843137,46.04166666666668,1015.833333333335,29.877450980392204,0
2834,4,0,0,35,0.0,0.0,1.0,35,850,600,250,0.7058823529411765,11,6,5,404.50412648157675,0.3867997198879552,-0.041232283003396875,0.22380114891595737,129110.6310232427,3445.1566043083976,132555.7876275511,1095,2,346.0857142857143,34,1,20,35.64508414353207,0.6155024509803921,45.92261904761905,1016.3095238095243,29.89145658263307,0
2835,4,1,0,36,0.027777777777777776,0.0,1.0,36,1250,1000,250,0.8,15,10,5,392.3354516611741,0.39037698412698413,-0.02860716483398884,0.21929597991236285,129513.05537533638,2962.576390850451,132475.63176618682,1096,0,337.44444444444446,33,3,17,35.543081306685906,0.6218434343434344,45.52696078431372,1017.8921568627449,30.845216874628633,0
2836,4,0,0,36,0.0,0.0,1.0,36,1050,800,250,0.7619047619047619,13,8,5,393.87932657015944,0.39006283068783065,-0.023004740567569293,0.22095984516771894,129655.6565334468,3013.736536281188,132669.393069728,1097,1,338.44444444444446,34,2,19,35.35822131307228,0.6210171568627452,45.386904761904766,1018.4523809523816,29.954481792717107,0
2837,4,0,0,36,0.0,0.0,1.0,36,950,700,250,0.7368421052631579,12,7,5,392.2282024581696,0.38998015873015873,-0.021642808452623896,0.2204593000023507,129731.44531250012,2976.86631944446,132708.31163194458,1098,2,339.44444444444446,35,1,19,35.322937968643494,0.6196428571428572,45.31250000000001,1018.7500000000009,29.107142857142883,0
2838,4,0,0,36,0.0,0.0,1.0,36,600,500,100,0.8333333333333334,7,5,2,392.74266833016867,0.3903439153439154,-0.01778459131400334,0.22141433657589413,129849.3829839678,2999.478630829905,132848.8616147977,1099,3,340.44444444444446,35,1,19,35.18954879248996,0.6208333333333333,45.19675925925926,1019.2129629629633,29.12037037037038,0
2839,4,1,0,37,0.02702702702702703,0.0,1.0,37,850,600,250,0.7058823529411765,11,6,5,388.3419457055956,0.3955205205205205,-0.013003513334566286,0.2207750760341349,130176.3820408247,2710.589897329772,132886.97193815446,1100,0,332.2162162162162,36,1,20,34.968595968513206,0.6221064814814814,44.87612612612613,1020.4954954954962,28.34709709709712,0
2840,4,0,1,36,0.0,0.02702702702702703,0.972972972972973,37,950,600,350,0.631578947368421,13,6,7,386.6723301897956,0.39461336336336333,-0.009395063050086305,0.22049056692752814,130293.86421388405,2676.292017806575,132970.15623169063,1101,1,333.2162162162162,33,4,21,34.89164466050494,0.6297348484848485,44.7610294117647,1020.9558823529409,30.93805704099821,0
2841,4,0,0,36,0.0,0.0,1.0,36,800,500,300,0.625,11,5,6,384.99717323950904,0.3923941798941799,0.007881261001760231,0.21971208544051984,130325.14537677821,2834.9625144175398,133160.10789119574,1102,2,342.05555555555554,33,3,21,34.902584413506155,0.630050505050505,44.73039215686275,1021.0784313725494,30.941770647653012,0
2842,4,1,0,37,0.02702702702702703,0.0,1.0,37,750,500,250,0.6666666666666666,10,5,5,380.738899632868,0.39611486486486486,0.018720699745147007,0.2194998085802908,130718.71456916085,2553.939909297037,133272.65447845787,1103,0,333.7837837837838,34,3,19,34.61146682188592,0.6317401960784313,44.34523809523809,1022.6190476190463,30.077030812324892,0
2843,4,0,0,37,0.0,0.0,1.0,37,1050,700,350,0.6666666666666666,14,7,7,378.2290216312448,0.39658408408408413,0.017075653058916673,0.2182386260771897,130751.61944038633,2490.811419527635,133242.43085991396,1104,1,334.7837837837838,36,1,19,34.64224106290831,0.6278935185185186,44.31306306306306,1022.7477477477478,28.40965965965966,0
2844,4,0,1,36,0.0,0.02702702702702703,0.972972972972973,37,1100,600,500,0.5454545454545454,16,6,10,380.3327528881667,0.39602102102102105,0.014410447872198029,0.21994417950280015,130838.01442912493,2552.396442050142,133390.41087117506,1105,2,335.7837837837838,36,1,19,34.50077967345441,0.6287615740740741,44.228603603603595,1023.0855855855845,28.419044044044014,0
2845,4,0,0,36,0.0,0.0,1.0,36,1400,1100,300,0.7857142857142857,17,11,6,363.8256756830417,0.3905257936507936,0.008643918490018221,0.20762028079397526,130323.35778061223,2292.2416271414772,132615.5994077537,1106,3,345.97222222222223,34,2,20,35.44484279662663,0.6277573529411764,44.732142857142854,1021.0714285714286,30.031512605042018,8
2846,4,0,0,36,0.0,0.0,1.0,36,900,600,300,0.6666666666666666,12,6,6,366.6573996061389,0.39026124338624335,0.01436312784057825,0.20989240467113265,130444.94224773247,2365.7206632653124,132810.66291099778,1107,4,346.97222222222223,34,2,21,35.24914539874919,0.6289828431372548,44.61309523809524,1021.5476190476194,30.045518207282925,0
2847,4,0,1,35,0.0,0.027777777777777776,0.9722222222222222,36,1300,1100,200,0.8461538461538461,15,11,4,367.3109313049717,0.3903439153439154,0.016635608354685694,0.2110931496776765,130597.00255102041,2393.9413265306152,132990.94387755104,1108,5,347.97222222222223,34,2,17,35.07817959468903,0.6305147058823529,44.464285714285715,1022.1428571428572,30.063025210084035,0
2848,4,0,0,35,0.0,0.0,1.0,35,700,400,300,0.5714285714285714,10,4,6,373.9989074479929,0.3862044817927171,0.027496213445182605,0.21443103691557255,130505.75573979583,2761.8020124716454,133267.5577522675,1109,13,358.77142857142854,34,1,17,34.99990290885083,0.6295955882352942,44.55357142857142,1021.7857142857135,30.05252100840334,0
2849,4,0,0,35,0.0,0.0,1.0,35,1100,700,400,0.6363636363636364,15,7,8,373.98124683481393,0.3861344537815126,0.027489807804309985,0.21475779291484148,130566.58340419504,2765.8907312925207,133332.47413548757,1110,14,359.77142857142854,34,1,17,34.9386041545331,0.6302083333333333,44.49404761904762,1022.0238095238097,30.059523809523817,0
2850,4,0,0,35,0.0,0.0,1.0,35,1150,1000,150,0.8695652173913043,13,10,3,378.08264476250207,0.3861344537815126,0.029103608847496965,0.21796845090670428,130718.71456916105,2884.495464852608,133603.21003401367,1111,15,360.77142857142854,34,1,18,34.67937524253005,0.6317401960784313,44.345238095238095,1022.619047619048,30.077030812324942,0
2851,4,0,0,35,0.0,0.0,1.0,35,1350,1100,250,0.8148148148148148,16,11,5,377.88747725348355,0.3848739495798319,0.026983019306815903,0.2192359331596118,130962.3086734692,2897.80328798184,133860.11196145104,1112,16,361.77142857142854,34,1,19,34.437272233852845,0.6341911764705883,44.10714285714285,1023.5714285714271,30.105042016806678,0
2852,4,0,0,35,0.0,0.0,1.0,35,700,500,200,0.7142857142857143,9,5,4,378.9007571660358,0.38431372549019605,0.023953488372093545,0.22017206159648023,131023.24263038553,2928.9611678004626,133952.203798186,1113,17,362.77142857142854,34,1,19,34.34956395348838,0.6348039215686274,44.04761904761905,1023.8095238095241,30.112044817927178,0
2853,4,0,0,35,0.0,0.0,1.0,35,1150,800,350,0.6956521739130435,15,8,7,372.7698314451179,0.3829831932773109,0.022542412270508683,0.217642955862733,131206.12953514737,2781.937358276633,133988.066893424,1114,18,363.77142857142854,34,1,20,34.321258424355086,0.6366421568627452,43.86904761904761,1024.5238095238092,30.133053221288506,0
2854,4,0,0,35,0.0,0.0,1.0,35,800,500,300,0.625,11,5,6,372.05875025286764,0.38217787114845936,0.019282146590776872,0.21774668803038297,131297.62081916083,2770.085742630358,134067.7065617912,1115,19,364.77142857142854,34,1,20,34.24686374724125,0.6375612745098039,43.77976190476189,1024.880952380951,30.143557422969145,0
2855,4,0,0,35,0.0,0.0,1.0,35,1400,1200,200,0.8571428571428571,16,12,4,374.091962566743,0.3817927170868347,0.02478057443393311,0.21947078252688432,131390.93888168005,2830.4623810308276,134221.4012627109,1116,20,365.77142857142854,33,2,20,34.100326719260494,0.6407828282828283,43.68872549019607,1025.245098039215,31.068033273915606,0
2856,4,0,0,35,0.0,0.0,1.0,35,1250,900,350,0.72,16,9,7,374.6883328641569,0.38207282913165264,0.024009833378858092,0.22018202032354378,131453.76778162233,2850.838619761612,134304.60640138394,1117,21,366.77142857142854,33,2,20,34.02147068196303,0.6414141414141414,43.62745098039215,1025.4901960784305,31.075460487225165,0
2857,4,0,1,34,0.0,0.02857142857142857,0.9714285714285714,35,800,400,400,0.5,12,4,8,373.36359901430274,0.3821428571428571,0.025797205302758863,0.22030820398497228,131610.90573637537,2827.7442870530463,134438.6500234284,1118,22,367.77142857142854,33,2,18,33.896527528962146,0.6429924242424243,43.47426470588235,1026.10294117647,31.09402852049909,0
2858,4,0,0,34,0.0,0.0,1.0,34,1100,900,200,0.8181818181818182,13,9,4,378.57910609553574,0.38003193701723115,0.04143118681843494,0.2238159675236805,131684.26890432078,3170.582561728368,134854.85146604915,1119,23,375.2647058823529,32,2,18,33.68854307622913,0.6461588541666667,43.402777777777764,1026.3888888888873,32.07465277777773,0
2859,4,0,1,33,0.0,0.029411764705882353,0.9705882352941176,34,600,400,200,0.6666666666666666,8,4,4,377.2001217143718,0.3802176173499703,0.04552731920033182,0.2233078035053914,131736.6836823576,3138.218623846582,134874.9023062042,1120,24,376.2647058823529,33,1,18,33.67093927818234,0.6442550505050505,43.3517156862745,1026.5931372549007,31.108882947118204,0
2860,4,0,0,33,0.0,0.0,1.0,33,1750,1400,350,0.8,21,14,7,384.5462195466879,0.37669665404040403,0.05421156970591312,0.22792491671673937,131781.48275686143,3535.2142000816125,135316.69695694305,1121,25,384.030303030303,32,1,21,33.43709009673718,0.6471354166666667,43.3080808080808,1026.767676767676,32.086489898989875,0
2861,4,0,0,33,0.0,0.0,1.0,33,900,700,200,0.7777777777777778,11,7,4,380.9985955607914,0.3757102272727273,0.060851851438062265,0.22678753270505939,131943.58555568312,3454.064157994085,135397.6497136772,1122,26,385.030303030303,32,1,21,33.36431321945023,0.6487630208333333,43.150252525252526,1027.3989898989903,32.10621843434345,0
2862,4,0,0,33,0.0,0.0,1.0,33,1150,1100,50,0.9565217391304348,12,11,1,382.10372534696876,0.3757102272727273,0.06036036036036041,0.22802964254577157,132040.8950617283,3490.6635802469036,135531.55864197522,1123,27,386.030303030303,32,1,21,33.237612612612615,0.6497395833333333,43.05555555555555,1027.7777777777771,32.118055555555536,0
2863,4,0,0,33,0.0,0.0,1.0,33,1050,800,250,0.7619047619047619,13,8,5,384.7571521390884,0.37602588383838387,0.06453581622438298,0.23020407713950028,132138.24043783805,3568.2266159065457,135706.4670537446,1124,28,387.030303030303,32,1,22,33.07109378198042,0.6507161458333333,42.96085858585859,1028.1565656565663,32.129892676767696,0
2864,4,0,0,33,0.0,0.0,1.0,33,1000,600,400,0.6,14,6,8,381.4063245113774,0.37507891414141414,0.058641906419957035,0.22878762293591154,132235.62168401177,3487.1004871951764,135722.72217120696,1125,29,388.030303030303,32,1,22,33.05891439561339,0.6516927083333333,42.86616161616161,1028.535353535353,32.14172979797978,0
2865,4,0,0,33,0.0,0.0,1.0,33,850,500,350,0.5882352941176471,12,5,7,383.4700590914221,0.3753945707070707,0.06011526306004833,0.230818388596388,132365.51914345485,3551.6426895214927,135917.16183297633,1126,30,389.030303030303,32,1,22,32.87474437627812,0.6529947916666667,42.739898989899,1029.0404040404048,32.15751262626265,0
2866,4,0,0,33,0.0,0.0,1.0,33,400,300,100,0.75,5,3,2,381.7469553672405,0.37507891414141414,0.058152373941847246,0.2299792633553866,132398.00347222234,3508.50694444445,135906.51041666677,1127,31,390.030303030303,32,1,22,32.886302294197016,0.6533203125,42.708333333333336,1029.1666666666674,32.16145833333336,0
2867,4,0,0,33,0.0,0.0,1.0,33,750,500,250,0.6666666666666666,10,5,5,384.7107637146085,0.375039457070707,0.05987022543313958,0.2323653012836238,132495.48037190095,3594.487488521601,136089.96786042256,1128,32,391.030303030303,32,1,22,32.711705911209236,0.654296875,42.613636363636374,1029.5454545454556,32.17329545454549,0
2868,4,0,0,33,0.0,0.0,1.0,33,750,500,250,0.6666666666666666,10,5,5,387.74892129522567,0.37507891414141414,0.06845112066980175,0.23501156760226255,132625.5053693502,3685.079328639949,136310.58469799015,1129,33,392.030303030303,32,1,20,32.50234943205034,0.6555989583333333,42.487373737373744,1030.050505050506,32.18907828282831,0
2869,4,0,0,33,0.0,0.0,1.0,33,900,600,300,0.6666666666666666,12,6,6,390.1996477925004,0.37511837121212116,0.07237220841829206,0.2367017789099638,132658.02158261926,3752.6226596776028,136410.64424229687,1130,34,393.030303030303,32,1,20,32.406442783020786,0.6559244791666667,42.45580808080809,1030.1767676767688,32.193023989899025,0
2870,4,0,0,33,0.0,0.0,1.0,33,850,700,150,0.8235294117647058,10,7,3,390.61637858782916,0.3753156565656566,0.06795449906288864,0.2381913914241694,132853.20255905026,3778.9273734823196,136632.12993253258,1131,35,394.030303030303,32,1,21,32.19891814656052,0.6578776041666667,42.26641414141415,1030.9343434343448,32.216698232323274,0
2871,4,0,0,33,0.0,0.0,1.0,33,1250,1100,150,0.88,14,11,3,390.3385895064767,0.37472380050505055,0.06378804567520735,0.2392690633801519,133048.5270157384,3786.794874247551,136835.32188998593,1132,36,395.030303030303,32,1,21,32.009290988455106,0.6598307291666667,42.077020202020215,1031.6919191919208,32.240372474747524,0
2872,4,0,0,33,0.0,0.0,1.0,33,950,700,250,0.7368421052631579,12,7,5,389.3693357684896,0.3737373737373737,0.061339826045708534,0.2399301475944944,133243.9949526835,3776.2251619732824,137020.22011465678,1133,37,396.030303030303,32,1,21,31.83752191105134,0.6617838541666667,41.88762626262627,1032.4494949494958,32.264046717171745,0
2873,4,1,0,34,0.029411764705882353,0.0,1.0,34,750,500,250,0.6666666666666666,10,5,5,379.81269510926097,0.3781008615567439,0.05834914611005715,0.23548387096774206,133472.22222222242,3338.888888888911,136811.11111111133,1134,0,385.3529411764706,33,1,22,31.854838709677416,0.6616161616161615,41.66666666666668,1033.3333333333348,31.313131313131358,0
2874,4,0,0,34,0.0,0.0,1.0,34,750,600,150,0.8,9,6,3,379.81269510926097,0.3781008615567439,0.05834914611005715,0.23548387096774206,133472.22222222242,3338.888888888911,136811.11111111133,1135,1,386.3529411764706,33,1,22,31.854838709677416,0.6616161616161615,41.66666666666668,1033.3333333333348,31.313131313131358,0
2875,4,0,0,34,0.0,0.0,1.0,34,950,800,150,0.8421052631578947,11,8,3,376.9757060849766,0.378305109922757,0.05963577798074349,0.23472649684420283,133630.56163795176,3275.095065599772,136905.65670355153,1136,2,387.3529411764706,33,1,23,31.769166567895386,0.6631944444444444,41.513480392156865,1033.9460784313726,31.33169934640523,0
2876,4,0,0,34,0.0,0.0,1.0,34,450,300,150,0.6666666666666666,6,3,3,378.3394353226565,0.37862076648841353,0.05832171731251745,0.2361823102162148,133725.61034217622,3318.7343810073203,137044.34472318355,1137,3,388.3529411764706,33,1,17,31.63852685624013,0.6641414141414141,41.42156862745099,1034.3137254901972,31.342840166369612,0
2877,4,0,0,34,0.0,0.0,1.0,34,550,300,250,0.5454545454545454,8,3,5,378.3394353226565,0.37862076648841353,0.05832171731251745,0.2361823102162148,133725.61034217622,3318.7343810073203,137044.34472318355,1138,4,389.3529411764706,33,1,17,31.63852685624013,0.6641414141414141,41.42156862745099,1034.3137254901972,31.342840166369612,0
2878,4,0,0,34,0.0,0.0,1.0,34,950,800,150,0.8421052631578947,11,8,3,379.6550731739977,0.37722816399286985,0.05723888134294586,0.23802428307011222,133884.09994052775,3365.9555519511814,137250.05549247895,1139,5,390.3529411764706,33,1,18,31.44550522991909,0.665719696969697,41.26838235294118,1034.9264705882358,31.36140819964351,0
2879,4,0,1,33,0.0,0.029411764705882353,0.9705882352941176,34,600,400,200,0.6666666666666666,8,4,4,385.7040196767998,0.3767825311942959,0.027869873029201964,0.22744781305469342,131587.09092184468,3352.3897446347105,134939.4806664794,1140,6,391.3529411764706,32,2,18,33.60406924275987,0.6451822916666667,43.49747474747475,1026.010101010101,32.062815656565654,8
2880,4,0,0,33,0.0,0.0,1.0,33,1100,700,400,0.6363636363636364,15,7,8,397.33514778684935,0.37188289141414144,0.039219757529616706,0.23456167039012427,131628.58963012695,3860.133022732205,135488.72265285917,1141,45,404.030303030303,31,2,18,33.26367740980417,0.6481854838709677,43.45703125,1026.171875,33.102318548387096,0
2881,4,0,0,33,0.0,0.0,1.0,33,650,300,350,0.46153846153846156,10,3,7,395.85403881394353,0.3714094065656566,0.037021662592438664,0.2343027959466315,131728.82080078128,3829.077148437501,135557.89794921878,1142,46,405.030303030303,31,2,18,33.20015220700151,0.6491935483870968,43.359375,1026.5625000000002,33.11491935483872,0
2882,4,0,0,33,0.0,0.0,1.0,33,1250,900,350,0.72,16,9,7,394.9409378355806,0.37133049242424243,0.042780748663101775,0.23458540042523032,131862.52170138885,3815.581597222217,135678.10329861107,1143,47,406.030303030303,31,2,18,33.088235294117645,0.6505376344086021,43.229166666666664,1027.083333333333,33.131720430107514,0
2883,4,0,0,33,0.0,0.0,1.0,33,600,300,300,0.5,9,3,6,395.8328463142441,0.3714883207070707,0.04288193644503857,0.23594507727432118,131996.2904188367,3849.693467881935,135845.98388671863,1144,48,407.030303030303,31,2,18,32.92997127893226,0.6518817204301075,43.09895833333333,1027.6041666666658,33.148521505376316,0
2884,4,0,0,33,0.0,0.0,1.0,33,700,500,200,0.7142857142857143,9,5,4,395.4537382826614,0.37172506313131315,0.045917172485017366,0.23592716222713864,132029.74319457996,3842.331102159274,135872.07429673924,1145,49,408.030303030303,31,2,19,32.905871236116404,0.6522177419354839,43.06640624999999,1027.734374999999,33.152721774193516,0
2885,4,0,0,33,0.0,0.0,1.0,33,1200,1000,200,0.8333333333333334,14,10,4,395.258367039591,0.37117266414141414,0.050363106952548975,0.23706498414925783,132230.54885864243,3853.0461629231613,136083.5950215656,1146,50,409.030303030303,31,2,19,32.70785858969491,0.654233870967742,42.87109374999999,1028.5156249999989,33.17792338709674,0
2886,4,0,0,33,0.0,0.0,1.0,33,1150,900,250,0.782608695652174,14,9,5,396.63968428695057,0.3716066919191919,0.0534799967783135,0.23831560042214414,132297.5179884168,3894.8891533745564,136192.40714179137,1147,51,410.030303030303,31,2,19,32.6046544741172,0.6549059139784946,42.80598958333333,1028.776041666666,33.18632392473116,0
2887,4,0,0,33,0.0,0.0,1.0,33,700,400,300,0.5714285714285714,10,4,6,395.35405639385397,0.37121212121212116,0.047024720186810365,0.23796520241284286,132364.5040724012,3866.168721516922,136230.67279391811,1148,52,411.030303030303,31,2,19,32.57004196718546,0.6555779569892473,42.740885416666664,1029.036458333333,33.194724462365585,0
2888,4,1,0,34,0.029411764705882353,0.0,1.0,34,1100,800,300,0.7272727272727273,14,8,6,383.7915412263842,0.37563131313131315,0.0493763843672419,0.23328158657953954,132733.2305908203,3388.3824666341134,136121.61305745444,1149,0,399.9117647058824,31,3,19,32.495682756296866,0.6592741935483871,42.3828125,1030.46875,33.24092741935484,0
2889,4,0,0,34,0.0,0.0,1.0,34,1150,900,250,0.782608695652174,14,9,5,383.26606238828003,0.3749628639334522,0.05325914149443567,0.23379820354317413,132867.44011773,3384.7161187065913,136252.1562364366,1150,1,400.9117647058824,31,3,19,32.374021217479154,0.6606182795698925,42.252604166666664,1030.9895833333333,33.257728494623656,0
2890,4,0,0,34,0.0,0.0,1.0,34,600,200,400,0.3333333333333333,10,2,8,381.2678538752077,0.37466577540106955,0.049296820470172475,0.23341606942808293,133001.71746147997,3341.855875651031,136343.573337131,1151,2,401.9117647058824,31,3,19,32.2903517630228,0.6619623655913979,42.12239583333333,1031.510416666666,33.27452956989245,0
2891,4,0,0,34,0.0,0.0,1.0,34,700,600,100,0.8571428571428571,8,6,2,381.7134127825967,0.3740344622697564,0.05460064419408961,0.23453182245851653,133136.0626220703,3363.9641655815967,136500.0267876519,1152,3,402.9117647058824,31,3,19,32.14368323660526,0.6633064516129032,41.9921875,1032.03125,33.29133064516129,0
2892,4,0,0,34,0.0,0.0,1.0,34,950,600,350,0.631578947368421,13,6,7,379.4934616546799,0.37407159833630427,0.05382697914580148,0.23379981798445662,133236.86599731445,3312.503899468316,136549.36989678277,1153,4,403.9117647058824,31,3,19,32.09959746920586,0.6643145161290323,41.89453125,1032.421875,33.303931451612904,0
2893,4,1,0,35,0.02857142857142857,0.0,1.0,35,700,500,200,0.7142857142857143,9,5,4,368.3291067906453,0.3779411764705882,0.04152799581371003,0.22957499121882682,133668.00103305784,2846.763085399447,136514.76411845727,1154,0,393.34285714285716,32,3,20,31.955128205128215,0.666015625,41.47727272727273,1034.090909090909,32.31534090909091,0
2894,4,0,0,35,0.0,0.0,1.0,35,500,400,100,0.8,6,4,2,367.67303943634056,0.37710084033613445,0.03947405133928594,0.22957145877000765,133733.29252117124,2834.025227017647,136567.31774818889,1155,1,394.34285714285716,32,3,19,31.906636555989593,0.6666666666666667,41.41414141414141,1034.3434343434337,32.323232323232304,0
2895,4,0,0,35,0.0,0.0,1.0,35,800,600,200,0.75,10,6,4,366.776271339129,0.3763655462184874,0.0365100671140941,0.22962043877953872,133831.25964506168,2817.226080246911,136648.4857253086,1156,2,395.34285714285716,32,3,19,31.83165548098434,0.6676432291666667,41.31944444444444,1034.722222222222,32.335069444444436,0
2896,4,0,0,35,0.0,0.0,1.0,35,700,600,100,0.8571428571428571,8,6,2,366.88968014251134,0.3759453781512605,0.04043087220246799,0.22989509315351864,133863.92332415064,2822.65840220386,136686.58172635452,1157,3,396.34285714285716,32,3,19,31.795998047828206,0.66796875,41.28787878787879,1034.8484848484852,32.33901515151516,0
2897,4,0,0,35,0.0,0.0,1.0,35,650,400,250,0.6153846153846154,9,4,5,364.5768693646744,0.37531512605042017,0.03493805864826749,0.22905484689049538,133961.93827479333,2767.8848140495766,136729.8230888429,1158,4,397.34285714285716,32,3,19,31.757683863885827,0.6689453125,41.19318181818181,1035.2272727272723,32.35085227272726,0
2898,4,0,0,35,0.0,0.0,1.0,35,1050,600,450,0.5714285714285714,15,6,9,364.5768693646744,0.3752450980392157,0.03493805864826749,0.22905484689049538,133961.93827479333,2767.8848140495766,136729.8230888429,1159,5,398.34285714285716,32,3,19,31.757683863885827,0.6689453125,41.19318181818181,1035.2272727272723,32.35085227272726,0
2899,4,0,0,35,0.0,0.0,1.0,35,1050,600,450,0.5714285714285714,15,6,9,365.73896656243573,0.3744747899159664,0.04571699006152374,0.23068848846162,134106.1430699731,2809.568435217226,136915.71150519032,1160,6,399.34285714285716,33,2,19,31.583254456538878,0.6679292929292929,41.05392156862745,1035.7843137254904,31.387403446226983,0
2900,4,0,0,35,0.0,0.0,1.0,35,800,400,400,0.5,12,4,8,364.0773972619508,0.37356442577030813,0.041767339697558414,0.2302374266155417,134201.36072964725,2771.936424692424,136973.29715433967,1161,7,400.34285714285716,33,2,20,31.53102207766608,0.6688762626262627,40.96200980392157,1036.1519607843136,31.398544266191323,0
2901,4,1,0,36,0.027777777777777776,0.0,1.0,36,650,500,150,0.7692307692307693,8,5,3,394.33830564427,0.37556216931216935,0.13656225173079095,0.2231544515755726,129996.88042534729,3052.54991319445,133049.43033854174,1162,0,390.19444444444446,35,1,18,34.99851038474633,0.6223214285714286,45.052083333333336,1019.7916666666672,29.136904761904777,8
2902,4,0,0,36,0.0,0.0,1.0,36,1250,800,450,0.64,17,8,9,388.8653037068457,0.3756283068783069,0.130703943140146,0.22105901887706392,130173.98787133499,2924.029465663594,133098.01733699857,1163,1,391.19444444444446,35,1,18,34.95768118407622,0.6241071428571429,44.87847222222223,1020.486111111112,29.156746031746057,0
2903,4,1,0,37,0.02702702702702703,0.0,1.0,37,1150,800,350,0.6956521739130435,15,8,7,371.324641879569,0.38163163163163166,0.1395415765978949,0.1927786162878448,126552.40929705196,2153.299275439322,128705.70857249128,1164,0,381.5945945945946,34,3,17,39.11179799652942,0.5894607843137255,48.45238095238094,1006.1904761904746,29.593837535013957,8
2904,4,2,0,39,0.05128205128205128,0.0,1.0,39,950,500,450,0.5263157894736842,14,5,9,357.53061104569235,0.38762370670265406,0.15426977795036567,0.18863418921756986,127208.74592764056,1297.352091556784,128506.09801919734,1165,0,362.97435897435895,35,4,19,38.78403702003976,0.594047619047619,47.800925925925924,1008.796296296296,28.822751322751312,0
2905,4,0,1,38,0.0,0.02564102564102564,0.9743589743589743,39,1250,900,350,0.72,16,9,7,365.37557652960015,0.3881016644174539,0.16167780854779212,0.1936090995438134,127383.94445516099,1508.5964291837877,128892.54088434478,1166,1,363.97435897435895,35,4,14,38.40623327982877,0.5958333333333333,47.6273148148148,1009.4907407407393,28.842592592592553,0
2906,4,1,0,39,0.02564102564102564,0.0,1.0,39,1100,700,400,0.6363636363636364,15,7,8,364.32191831139437,0.3905476833108412,0.17984534357330384,0.19473608534465825,127734.70320001701,1507.310420953352,129242.01362097036,1167,0,360.5128205128205,35,4,16,38.072952446378146,0.5994047619047619,47.28009259259259,1010.8796296296285,28.8822751322751,0
2907,4,2,1,40,0.04878048780487805,0.024390243902439025,0.975609756097561,41,1200,900,300,0.75,15,9,6,358.4682086036902,0.398755081300813,0.20533583575360814,0.19514127030203368,128466.99948827585,1011.5798343192697,129478.57932259512,1168,0,343.8780487804878,35,6,13,37.471576854283214,0.606845238095238,46.55671296296296,1013.7731481481478,28.96494708994708,0
2908,4,0,0,40,0.0,0.0,1.0,40,900,600,300,0.6666666666666666,12,6,6,366.5829202273582,0.3959401709401709,0.20984294688749294,0.19897293655241907,128349.69142500423,1410.1609385716708,129759.8523635759,1169,1,353.475,35,5,18,37.385898534170956,0.6056547619047619,46.6724537037037,1013.3101851851848,28.951719576719565,0
2909,4,0,0,40,0.0,0.0,1.0,40,800,600,200,0.75,10,6,4,367.1840748374461,0.3961004273504274,0.2116636218314687,0.19973901412586045,128437.66744898839,1432.0532193072781,129869.72066829566,1170,2,354.475,35,5,13,37.280676714622835,0.6065476190476191,46.58564814814815,1013.6574074074078,28.961640211640223,0
2910,4,2,1,41,0.047619047619047616,0.023809523809523808,0.9761904761904762,42,1250,1100,150,0.88,14,11,3,355.5432450359867,0.4016163375919473,0.2279322605174996,0.19660947464161843,129089.93632656202,779.4109726069521,129869.34729916898,1171,0,338.54761904761904,37,5,16,36.91015681196949,0.6092342342342343,45.94298245614035,1016.2280701754386,27.465623518255097,0
2911,4,0,0,41,0.0,0.0,1.0,41,1400,1000,400,0.7142857142857143,18,10,8,366.27700689639795,0.39959349593495935,0.23104640444608981,0.20238318635800373,129058.31665702877,1254.2187880448166,130312.53544507359,1172,1,347.7073170731707,36,5,16,36.669714433484806,0.6108217592592593,45.97409909909911,1016.1036036036046,28.22510010010013,0
2912,4,0,0,41,0.0,0.0,1.0,41,1400,1100,300,0.7857142857142857,17,11,6,366.58771116094596,0.39931402439024394,0.23236554810226662,0.2034454607554023,129231.64859693882,1275.1053737479936,130506.75397068681,1173,2,348.7073170731707,34,7,16,36.48504273504273,0.6167279411764706,45.80357142857143,1016.7857142857147,29.90546218487396,0
2913,4,0,1,40,0.0,0.024390243902439025,0.975609756097561,41,750,300,450,0.4,12,3,9,365.8338218235097,0.3985010162601626,0.22821209438627554,0.2036297314760498,129348.51794249396,1264.0125332218734,130612.53047571583,1174,3,349.7073170731707,35,6,16,36.3850883680358,0.6157738095238094,45.688657407407405,1017.24537037037,29.06415343915343,0
2914,4,1,0,41,0.024390243902439025,0.0,1.0,41,1100,700,400,0.6363636363636364,15,7,8,319.02148309719644,0.39921239837398376,0.10144886705613887,0.17776720793063772,129391.54071015025,55.73624351666578,129447.27695366692,1175,0,350.4634146341463,38,3,18,37.53194021491827,0.6104714912280702,45.64636752136751,1017.414529914528,26.774066576698104,7
2915,4,0,2,39,0.0,0.04878048780487805,0.9512195121951219,41,1200,900,300,0.75,15,9,6,318.0309383730955,0.3981707317073171,0.09561394969184556,0.17767182955080144,129492.78564453125,36.542426215277885,129529.32807074653,1176,1,351.4634146341463,39,2,14,37.45447838842834,0.609775641025641,45.546875,1017.8125,26.09775641025641,0
2916,4,1,0,40,0.025,0.0,1.0,40,1750,1500,250,0.8571428571428571,20,15,5,327.527567274158,0.39606036324786326,0.11208966963817502,0.18402918997991152,129717.84056770045,497.2337506392096,130215.07431833966,1177,0,360.55,38,2,16,36.984574375109226,0.6137609649122807,45.325854700854705,1018.6965811965821,26.807804768331106,0
2917,4,1,0,41,0.024390243902439025,0.0,1.0,41,1400,1100,300,0.7857142857142857,17,11,6,324.0770250735719,0.39865345528455287,0.13477023159897628,0.183768749655211,130076.56385633702,230.96516927085355,130307.52902560787,1178,0,352.7317073170732,39,2,17,36.70915024337112,0.6156517094017093,44.97395833333334,1020.1041666666683,26.156517094017136,0
2918,4,0,0,41,0.0,0.0,1.0,41,950,800,150,0.8421052631578947,11,8,3,327.72937045995525,0.398094512195122,0.14058500732006074,0.18622023857457823,130156.27170138921,331.20659722225736,130487.47829861147,1179,1,353.7317073170732,39,2,17,36.53532053899553,0.6164529914529915,44.89583333333335,1020.4166666666692,26.164529914529982,0
2919,4,0,0,41,0.0,0.0,1.0,41,1250,800,450,0.64,17,8,9,328.3086226229834,0.3981961382113821,0.14450434911295384,0.18758530326677225,130371.67302441756,360.472282717884,130732.14530713543,1180,2,354.7317073170732,38,3,18,36.30261184921713,0.6203399122807017,44.68482905982906,1021.2606837606849,26.87528115159697,0
2920,4,0,0,41,0.0,0.0,1.0,41,1200,1000,200,0.8333333333333334,14,10,4,330.5582600478546,0.3982723577235772,0.1481628873395726,0.18913629708662724,130426.23325525982,422.6937458908741,130848.9270011507,1181,3,355.7317073170732,38,3,18,36.189990586758704,0.6208881578947368,44.63141025641026,1021.47435897436,26.88090418353579,0
2921,4,0,0,41,0.0,0.0,1.0,41,1700,1200,500,0.7058823529411765,22,12,10,329.39114399631825,0.3978912601626016,0.15338537977247735,0.1893564906875146,130608.41064453135,404.2507595486263,131012.66140407998,1182,4,356.7317073170732,39,2,15,36.0356372499066,0.6209935897435898,44.45312500000001,1022.1875000000008,26.20993589743592,0
2922,4,0,0,41,0.0,0.0,1.0,41,800,600,200,0.75,10,6,4,347.6327615603305,0.39857723577235776,0.1651625974468851,0.18859028843822287,128329.16802300354,724.2621527777824,129053.43017578132,1183,5,357.7317073170732,39,2,16,37.88691700078819,0.5980235042735043,46.692708333333336,1013.2291666666673,25.98023504273506,8
2923,4,1,0,42,0.023809523809523808,0.0,1.0,42,1200,800,400,0.6666666666666666,16,8,8,341.7596273572937,0.4014590592334495,0.17299233859041574,0.18682610078206488,128633.75491605523,392.3648291360935,129026.11974519132,1184,0,350.1904761904762,40,2,15,37.72498831229547,0.5994791666666667,46.392276422764226,1014.4308943089428,25.36077235772357,0
2924,4,3,0,45,0.06666666666666667,0.0,1.0,45,900,700,200,0.7777777777777778,11,7,4,325.4860107873513,0.41117424242424244,0.19269844294136917,0.1810612959848876,129324.56099580863,-580.0832394208581,128744.47775638777,1185,0,327.77777777777777,42,3,19,37.435497443714056,0.6034226190476191,45.71220930232558,1017.1511627906983,24.21788482834996,0
2925,4,0,0,45,0.0,0.0,1.0,45,1150,800,350,0.6956521739130435,15,8,7,324.8795637489757,0.41003787878787884,0.18294621721917248,0.18159804632021542,129514.47289837309,-584.678909119594,128929.79398925349,1186,1,328.77777777777777,43,2,13,37.258213942382234,0.6039244186046512,45.52556818181819,1017.8977272727285,23.672040169133222,0
2926,4,0,3,42,0.0,0.06666666666666667,0.9333333333333333,45,1000,700,300,0.7,13,7,6,323.3091739299881,0.4101010101010101,0.18164682539682486,0.1810531374007938,129586.77685950446,-620.6812442607618,128966.0956152437,1187,2,329.77777777777777,43,2,13,37.224857390873,0.6046511627906976,45.45454545454547,1018.1818181818209,23.67864693446095,0
2927,4,4,3,43,0.08695652173913043,0.06521739130434782,0.9347826086956522,46,850,400,450,0.47058823529411764,13,4,9,323.1272472467948,0.41215780998389695,0.2151933200217826,0.1833272919755502,130097.22650891641,-792.4082647462151,129304.8182441702,1188,0,322.95652173913044,44,2,14,36.71246293943246,0.6084280303030303,44.95370370370371,1020.1851851851859,23.186026936026952,0
2928,4,0,1,42,0.0,0.023255813953488372,0.9767441860465116,43,1100,700,400,0.6363636363636364,15,7,8,341.95815592388817,0.40210871170173496,0.22067540845472444,0.19195650010227192,129680.91699932265,269.08944712141863,129950.00644644407,1189,1,346.48837209302326,41,2,15,36.65455261192817,0.6084857723577235,45.36210317460316,1018.5515873015855,24.842721641502084,0
2929,4,0,0,42,0.0,0.0,1.0,42,1400,1000,400,0.7142857142857143,18,10,8,340.98997912863524,0.39815621370499416,0.193431482996137,0.18710991326578422,128783.68975309726,475.15330462750137,129258.84305772476,1190,2,355.6190476190476,37,5,16,37.59170987721004,0.6061373873873874,46.24451754385966,1015.0219298245627,27.433025130393585,8
2930,4,0,0,42,0.0,0.0,1.0,42,1400,900,500,0.6428571428571429,19,9,10,343.77045984669996,0.39793844367015097,0.19413325926611757,0.18876790731083923,128811.5153220222,456.3187711603642,129267.83409318257,1191,3,356.6190476190476,37,5,16,37.492799020666816,0.6064189189189189,46.2171052631579,1015.1315789473687,27.435988620199154,0
2931,4,0,0,42,0.0,0.0,1.0,42,1500,1100,400,0.7333333333333333,19,11,8,344.69911320518173,0.3980473286875726,0.19485734325292436,0.18971424846643065,128902.86138733677,486.5404019651066,129389.40178930188,1192,4,357.6190476190476,38,4,17,37.376161669296856,0.6055372807017544,46.127136752136764,1015.4914529914548,26.72345928924881,0
2932,4,1,0,43,0.023255813953488372,0.0,1.0,43,950,700,250,0.7368421052631579,12,7,5,339.4795997973666,0.400124584717608,0.2013279503520058,0.1880046501034456,129148.44292534764,168.65234375004064,129317.09526909768,1193,0,350.27906976744185,39,4,18,37.25874496139919,0.6063034188034189,45.885416666666686,1016.4583333333367,26.063034188034273,0
2933,4,1,1,43,0.022727272727272728,0.022727272727272728,0.9772727272727273,44,850,500,350,0.5882352941176471,12,5,7,331.24411618374154,0.4027043692741367,0.20731299982822082,0.18496081188548205,129473.0771513625,-222.53929649261676,129250.53785486988,1194,0,343.29545454545456,38,6,12,37.138270697739515,0.6112938596491229,45.56623931623932,1017.7350427350434,26.782501124606405,0
2934,4,0,0,43,0.0,0.0,1.0,43,1250,900,350,0.72,16,9,7,336.0253487634752,0.3990402362495386,0.194525037206295,0.18766469838884375,129480.23069598366,101.72793551864763,129581.9586315023,1195,2,352.27906976744185,37,6,14,37.00935502406087,0.6131756756756757,45.5592105263158,1017.7631578947392,27.50711237553349,0
2935,4,0,1,42,0.0,0.023255813953488372,0.9767441860465116,43,1200,1000,200,0.8333333333333334,14,10,4,336.71854656170495,0.3988556662975267,0.19267672215211396,0.18885518481069552,129647.68005540175,130.9556786703694,129778.63573407213,1196,3,353.27906976744185,37,6,15,36.82170542635658,0.6148648648648649,45.39473684210527,1018.4210526315796,27.524893314367016,0
2936,4,2,0,44,0.045454545454545456,0.0,1.0,44,1300,1100,200,0.8461538461538461,15,11,4,327.7171705207234,0.40436707188160675,0.19230934039250758,0.18568046450809203,130044.55133912283,-276.4335187011301,129768.1178204217,1197,0,346.1363636363636,38,6,17,36.64872909465452,0.6170504385964912,45.00534188034189,1019.9786324786339,26.841542959964052,0
2937,4,0,0,44,0.0,0.0,1.0,44,1150,600,550,0.5217391304347826,17,6,11,328.0216430265231,0.40337605708245244,0.20445505928026297,0.18676512380663887,130235.3223847614,-255.9991142523338,129979.32327050906,1198,1,347.1363636363636,38,6,18,36.44786651315329,0.6189692982456141,44.81837606837606,1020.726495726495,26.86122357174987,0
2938,4,0,0,44,0.0,0.0,1.0,44,750,500,250,0.6666666666666666,10,5,5,327.9725647885758,0.4031778541226216,0.2067910877652046,0.1870026056795119,130290.57167830483,-253.65055421075957,130036.92112409406,1199,2,348.1363636363636,37,7,18,36.393222174488955,0.6213400900900901,44.76425438596491,1020.94298245614,27.593053579895678,0
2939,4,0,2,42,0.0,0.045454545454545456,0.9545454545454546,44,1350,1000,350,0.7407407407407407,17,10,7,345.41164781381485,0.4024290873854827,0.12148352096959991,0.19369726484287855,129640.87106095909,366.97094657288017,130007.84200753197,1200,3,349.1363636363636,40,4,18,36.60729135482151,0.6096354166666667,45.40142276422764,1018.3943089430895,25.459857723577237,8
2940,4,0,0,42,0.0,0.0,1.0,42,1050,900,150,0.8571428571428571,12,9,3,349.6052994607859,0.39435733643050713,0.15883407372769143,0.19597141098214682,129625.34722222218,663.5416666666617,130288.88888888883,1201,13,366.6190476190476,39,3,18,36.516298417894156,0.6111111111111112,45.416666666666664,1018.3333333333329,26.1111111111111,0
2941,4,1,0,43,0.023255813953488372,0.0,1.0,43,1300,800,500,0.6153846153846154,18,8,10,341.72614299958985,0.39671004060538945,0.1703309944664324,0.1935419622541694,130029.2691189106,286.88012261219166,130316.14924152278,1202,0,359.06976744186045,40,3,19,36.3070031220938,0.6135416666666667,45.02032520325203,1019.918699186991,25.497967479674777,0
2942,4,0,0,43,0.0,0.0,1.0,43,1150,700,450,0.6086956521739131,16,7,9,344.333722682598,0.3966177556293835,0.16802452953409608,0.19579837164092,130184.79100568432,365.4027447286499,130550.19375041297,1203,1,360.06976744186045,40,3,19,36.08282712607049,0.6151041666666667,44.86788617886178,1020.5284552845519,25.5132113821138,0
2943,4,1,0,44,0.022727272727272728,0.0,1.0,44,1400,1000,400,0.7142857142857143,18,10,8,337.85053934782707,0.39997357293868924,0.1685580959971824,0.19368649564364948,130501.95448133704,18.07761680539363,130520.03209814244,1204,0,352.8636363636364,39,5,16,35.927145988378015,0.6199252136752137,44.55729166666668,1021.7708333333353,26.199252136752186,0
2944,4,0,1,43,0.0,0.022727272727272728,0.9772727272727273,44,800,400,400,0.5,12,4,8,334.72848925822575,0.3995991895701198,0.15976427628843637,0.19238280828338503,130599.97046235719,-56.89383799324315,130543.07662436395,1205,1,353.8636363636364,40,4,16,35.90777656260357,0.6192708333333333,44.461382113821145,1022.1544715447164,25.553861788617912,0
2945,4,0,1,42,0.0,0.023255813953488372,0.9767441860465116,43,850,800,50,0.9411764705882353,9,8,1,340.5617266345369,0.3969176818014027,0.17649776682581209,0.19604770363155327,130661.65500217027,299.6717664930644,130961.32676866333,1206,2,362.4418604651163,39,4,16,35.69631940906774,0.6215277777777778,44.40104166666667,1022.3958333333344,26.215277777777803,0
2946,4,0,0,42,0.0,0.0,1.0,42,1450,1000,450,0.6896551724137931,19,10,9,352.4191772934342,0.39504694154084397,0.20997452478933942,0.1903063557384545,128144.53125000001,632.1180555555565,128776.64930555558,1207,3,371.23809523809524,38,4,15,37.954389574759944,0.5978618421052632,46.875,1012.5000000000001,26.644736842105267,8
2947,4,2,1,43,0.045454545454545456,0.022727272727272728,0.9772727272727273,44,1300,900,400,0.6923076923076923,17,9,8,339.19127074319044,0.39880637773079636,0.21510114159823823,0.18590362401984076,128736.86814230941,-66.71562066230754,128670.1525216471,1208,0,355.3181818181818,40,4,13,37.685050737699456,0.6005208333333334,46.290650406504064,1014.8373983739832,25.37093495934958,0
2948,4,1,0,44,0.022727272727272728,0.0,1.0,44,1400,1100,300,0.7857142857142857,17,11,6,334.5887278277387,0.39997357293868924,0.21885235461096175,0.18409749826292762,128891.61544054466,-174.86367241720617,128716.75176812745,1209,0,356.29545454545456,40,4,14,37.64428209234055,0.6020833333333333,46.13821138211382,1015.4471544715448,25.38617886178862,0
2949,4,1,1,44,0.022222222222222223,0.022222222222222223,0.9777777777777777,45,900,500,400,0.5555555555555556,13,5,8,328.1963141661531,0.4039983164983165,0.21795108102668448,0.18165969072764013,129127.51379311638,-524.1651831320238,128603.34860998436,1210,0,349.35555555555555,42,3,15,37.566736581180294,0.6014384920634921,45.906007751937985,1016.3759689922479,24.199427833148757,0
2950,4,1,0,45,0.022222222222222223,0.0,1.0,45,800,800,0,1.0,8,8,0,323.4717694665491,0.403766835016835,0.21638039601655223,0.1801660534551351,129373.84627013095,-630.2214785770135,128743.62479155393,1211,0,342.0888888888889,42,3,16,37.436700320665466,0.6039186507936508,45.66375968992248,1017.3449612403097,24.22249907715023,0
2951,4,0,0,45,0.0,0.0,1.0,45,1100,700,400,0.6363636363636364,15,7,8,323.5786703086832,0.4036195286195286,0.21777862417740534,0.18056446310211452,129447.79178685191,-622.6911318430233,128825.1006550089,1212,1,343.0888888888889,42,3,12,37.35895543705962,0.6046626984126984,45.59108527131784,1017.63565891473,24.229420450350716,0
2952,4,0,0,45,0.0,0.0,1.0,45,950,500,450,0.5263157894736842,14,5,9,320.80558602612643,0.4029671717171717,0.21901589416579426,0.1795793442928349,129571.08126201852,-686.574668739859,128884.50659327865,1213,2,344.0888888888889,42,3,12,37.30449541575457,0.6059027777777778,45.46996124031008,1018.1201550387598,24.240956072351423,0
2953,4,0,0,45,0.0,0.0,1.0,45,1050,900,150,0.8571428571428571,12,9,3,319.5578578519542,0.4027356902356902,0.21620775705282735,0.1789932819993782,129595.74619914667,-717.3321915750296,128878.41400757164,1214,3,345.0888888888889,42,3,12,37.31125491688869,0.6061507936507937,45.445736434108525,1018.2170542635658,24.243263196751567,0
2954,4,0,1,44,0.0,0.022222222222222223,0.9777777777777777,45,1250,1000,250,0.8,15,10,5,320.5157720740693,0.40277777777777773,0.22134280399120554,0.1799819335492852,129694.42942130895,-686.1779640646487,129008.2514572443,1215,4,346.0888888888889,42,3,13,37.18686580416032,0.6071428571428572,45.34883720930233,1018.6046511627917,24.252491694352184,0
2955,4,0,1,43,0.0,0.022727272727272728,0.9772727272727273,44,1100,600,500,0.5454545454545454,16,6,10,303.72377851042114,0.39907064834390416,0.17257239977634398,0.1678922106466403,129075.34490937594,-930.2189073873392,128145.1260019886,1216,5,354.84090909090907,41,3,19,38.241461648605565,0.6023882113821138,45.95734126984128,1016.1706349206361,24.784649632210638,8
2956,4,1,0,44,0.022727272727272728,0.0,1.0,44,1000,800,200,0.8,12,8,4,304.01473041020796,0.40155919661733613,0.17222262597999616,0.16892145514797074,129278.89034511543,-939.4010889265048,128339.48925618893,1217,0,339.8863636363636,40,4,20,38.02775557110023,0.6059895833333333,45.75711382113822,1016.9715447154479,25.424288617886198,0
2957,4,0,0,44,0.0,0.0,1.0,44,1200,900,300,0.75,15,9,6,304.3405824664689,0.4013830162085976,0.17011060560656022,0.16954666505686256,129382.2617675491,-924.7454185669899,128457.51634898211,1218,1,340.8863636363636,40,4,20,37.91475210601671,0.60703125,45.65548780487805,1017.378048780488,25.4344512195122,0
2958,4,0,1,43,0.0,0.022727272727272728,0.9772727272727273,44,850,400,450,0.47058823529411764,13,4,9,308.21894965838806,0.4018454897815363,0.172094131529978,0.1721591065715983,129485.67450137156,-818.0122818758655,128667.66221949569,1219,2,341.8863636363636,40,4,15,37.71134964220336,0.6080729166666667,45.55386178861789,1017.7845528455287,25.444613821138216,0
2959,4,0,1,42,0.0,0.023255813953488372,0.9767441860465116,43,850,400,450,0.47058823529411764,13,4,9,314.36446666366373,0.4003783684016242,0.1730975220775517,0.17550519081737098,129466.2814670138,-460.0802951388947,129006.20117187491,1220,3,350.04651162790697,39,4,16,37.574633230979195,0.6095085470085471,45.572916666666664,1017.7083333333326,26.09508547008545,0
2960,4,1,1,42,0.023255813953488372,0.023255813953488372,0.9767441860465116,43,950,700,250,0.7368421052631579,12,7,5,308.0452821467295,0.4052464008859358,0.16247987789885787,0.1733143658138671,129770.27253123141,-604.9759567717656,129165.29657445964,1221,0,343.48837209302326,40,3,17,37.42768801117094,0.6109375,45.27439024390244,1018.9024390243903,25.47256097560976,0
2961,4,0,0,42,0.0,0.0,1.0,42,1000,700,300,0.7,13,7,6,314.71069449312904,0.40301974448315914,0.1654344257903635,0.17653049111068975,129651.86767578124,-239.4341362847233,129412.43353949652,1222,1,352.57142857142856,39,3,18,37.37779567692885,0.6113782051282051,45.390625,1018.4374999999999,26.113782051282048,0
2962,4,1,0,43,0.023255813953488372,0.0,1.0,43,800,400,400,0.5,12,4,8,310.4149807081862,0.406999815430048,0.1762045714259226,0.17545878881381577,129951.54303200799,-532.2188553440473,129419.32417666394,1223,0,345.3488372093023,40,3,19,37.18395959998671,0.6127604166666667,45.09654471544715,1019.6138211382108,25.490345528455272,0
2963,4,0,0,43,0.0,0.0,1.0,43,1250,900,350,0.72,16,9,7,310.20934879520235,0.4069767441860465,0.18255315895912894,0.17604249025183896,130107.01844346926,-527.917306993219,129579.10113647605,1224,1,346.3488372093023,40,3,19,37.032033403061384,0.6143229166666666,44.9441056910569,1020.2235772357706,25.505589430894265,0
2964,4,0,0,43,0.0,0.0,1.0,43,900,500,400,0.5555555555555556,13,5,8,311.9198664070048,0.40626153562200074,0.18419882748464889,0.17760335250521286,130236.6522903033,-475.320163262617,129761.33212704069,1225,2,347.3488372093023,40,3,21,36.85741072613831,0.615625,44.8170731707317,1020.7317073170725,25.518292682926813,0
2965,4,1,0,44,0.022727272727272728,0.0,1.0,44,1450,1200,250,0.8275862068965517,17,12,5,307.56003042572706,0.4074392177589852,0.19303294958316775,0.1769629320791244,130642.63791454092,-763.9092616213067,129878.72865291961,1226,0,340.4318181818182,41,3,15,36.55901261523531,0.618140243902439,44.41964285714286,1022.3214285714294,24.934668989547056,0
2966,4,0,0,44,0.0,0.0,1.0,44,1250,900,350,0.72,16,9,7,310.64408920435756,0.40759337561663145,0.1989193026393532,0.17920704620076783,130744.07837498422,-677.0249708679808,130067.05340411625,1227,1,341.4318181818182,41,3,15,36.37790199502054,0.6191565040650406,44.320436507936506,1022.7182539682537,24.944347657762286,0
2967,4,0,0,44,0.0,0.0,1.0,44,1250,700,550,0.56,18,7,11,317.45880204912163,0.4065693269908386,0.20620219253410443,0.18398342707520976,130921.69390904499,-487.5511778785685,130434.14273116642,1228,2,342.4318181818182,41,3,16,36.02454116582653,0.6209349593495934,44.14682539682539,1023.4126984126975,24.961285327138963,0
2968,4,0,1,43,0.0,0.022727272727272728,0.9772727272727273,44,1350,900,450,0.6666666666666666,18,9,9,319.9900615413299,0.4067014622973925,0.20419316200172632,0.18618587459016947,131074.03175390526,-411.5225025195255,130662.50925138574,1229,3,343.4318181818182,41,3,18,35.80620680746625,0.6224593495934959,43.99801587301587,1024.0079365079366,24.97580332946187,0
2969,4,0,0,43,0.0,0.0,1.0,43,1400,900,500,0.6428571428571429,19,9,10,322.5272151830303,0.40390826873385016,0.19939095763715486,0.18725167945467822,130989.80150910518,-150.44482037806983,130839.35668872712,1230,4,352.2325581395349,40,3,18,35.826177239485084,0.6231770833333333,44.080284552845534,1023.6788617886191,25.591971544715477,0
2970,4,1,1,43,0.022727272727272728,0.022727272727272728,0.9772727272727273,44,1600,1300,300,0.8125,19,13,6,316.4684479986114,0.4073621388301621,0.20436972820993438,0.18561242461686003,131380.213497257,-484.0251958159745,130896.18830144103,1231,0,345.20454545454544,40,4,19,35.588074940523384,0.6270833333333333,43.69918699186992,1025.2032520325208,25.63008130081302,0
2971,4,0,1,42,0.0,0.023255813953488372,0.9767441860465116,43,1100,1000,100,0.9090909090909091,12,10,2,324.7677832130409,0.40669988925802875,0.20406083176718814,0.1900918800756543,131302.08462431445,-71.46260906203918,131230.62201525242,1232,1,353.7674418604651,40,3,19,35.4540571806313,0.6263020833333333,43.77540650406505,1024.8983739837417,25.622459349593544,0
2972,4,0,0,42,0.0,0.0,1.0,42,750,400,350,0.5333333333333333,11,4,7,326.3243040022478,0.4068912117692605,0.20540430719219804,0.19166685254165466,131434.91753472242,178.08417918403785,131613.00171390647,1233,2,356.85714285714283,39,3,20,35.28037383177571,0.6292735042735043,43.64583333333334,1025.4166666666683,26.292735042735085,0
2973,4,0,0,42,0.0,0.0,1.0,42,1350,1200,150,0.8888888888888888,15,12,3,326.29562933961046,0.40716947348044913,0.20369242224252915,0.1923211043306897,131568.4692382814,186.04329427084872,131754.51253255224,1234,3,357.85714285714283,39,3,17,35.14665194435983,0.6306089743589743,43.51562500000001,1025.9375000000011,26.306089743589773,0
2974,4,0,0,42,0.0,0.0,1.0,42,1150,700,450,0.6086956521739131,16,7,9,327.3003965928076,0.40729045683313975,0.20546737213403854,0.19372645095628352,131728.82080078128,222.97905815972263,131951.799858941,1235,4,358.85714285714283,39,3,17,34.95951716556739,0.6322115384615384,43.359375,1026.5625000000002,26.32211538461539,0
2975,4,1,1,42,0.023255813953488372,0.023255813953488372,0.9767441860465116,43,1000,700,300,0.7,13,7,6,321.7428018221237,0.4103682170542636,0.20949091109802742,0.19183155731281354,132006.0810364202,-105.59872595676381,131900.4823104634,1236,0,351.48837209302326,40,3,18,34.82351826213079,0.6333333333333333,43.08943089430895,1027.642276422765,25.691056910569124,0
2976,4,0,1,41,0.0,0.023809523809523808,0.9761904761904762,42,1050,700,350,0.6666666666666666,14,7,7,322.15812703344824,0.41019405729771585,0.2104861719257607,0.19234399627014723,132058.3037956904,108.73116200674312,132167.03495769712,1237,1,354.6666666666667,40,2,18,34.76039812800739,0.6338541666666666,43.03861788617886,1027.8455284552845,25.696138211382113,0
2977,4,0,1,40,0.0,0.024390243902439025,0.975609756097561,41,1500,1100,400,0.7333333333333333,19,11,8,330.12297810882495,0.41034044715447154,0.21067063906737538,0.19789339179529017,132210.46142578125,529.142252604167,132739.6036783854,1238,2,348.4878048780488,39,2,19,34.402853742530134,0.6370192307692308,42.890625,1028.4375,26.370192307692307,0
2978,4,0,0,40,0.0,0.0,1.0,40,1400,1000,400,0.7142857142857143,18,10,8,333.2186805744984,0.41101762820512816,0.20136826254024331,0.20015986745176814,132288.0725970669,816.1714013076128,133104.24399837453,1239,3,334.925,38,2,19,34.24529199986152,0.6395285087719298,42.81517094017094,1028.7393162393157,27.072087269455675,0
2979,4,0,0,40,0.0,0.0,1.0,40,1150,900,250,0.782608695652174,14,9,5,337.8190103099545,0.410670405982906,0.20597165991902866,0.20351535499160658,132398.00347222213,945.3581570969293,133343.36162931906,1240,4,335.925,37,3,19,34.01653171390014,0.642454954954955,42.70833333333333,1029.1666666666658,27.815315315315292,0
2980,4,0,0,40,0.0,0.0,1.0,40,1250,900,350,0.72,16,9,7,333.3146378861397,0.4105635683760684,0.20406940553999364,0.20168360292432502,132562.98539201167,837.0366946087878,133400.02208662045,1241,5,336.925,38,2,20,33.96682747172942,0.6422697368421053,42.54807692307691,1029.807692307691,27.100202429149764,0
2981,4,0,0,40,0.0,0.0,1.0,40,1250,900,350,0.72,16,9,7,332.09561931329523,0.41018963675213677,0.19937772246421925,0.20138779631564735,132645.51487508212,810.1988823142613,133455.71375739638,1242,6,337.925,38,2,16,33.9154221115951,0.643092105263158,42.467948717948715,1030.1282051282046,27.108636977058016,0
2982,4,0,0,40,0.0,0.0,1.0,40,1150,900,250,0.782608695652174,14,9,5,333.7437023671599,0.4098023504273504,0.20459564541213027,0.20283289283750855,132728.0700402697,859.4315006574745,133587.50154092716,1243,7,338.925,38,2,16,33.790176257128046,0.6439144736842105,42.38782051282052,1030.448717948719,27.11707152496629,0
2983,4,0,1,39,0.0,0.025,0.975,40,1450,1200,250,0.8275862068965517,17,12,5,331.41399769121307,0.40920138888888885,0.20553886010362654,0.20215834878130257,132865.71905361974,806.7118215355424,133672.4308751553,1244,8,339.925,38,2,17,33.71221934369602,0.6452850877192983,42.254273504273506,1030.9829059829065,27.13112910481333,0
2984,4,0,0,39,0.0,0.0,1.0,39,1150,900,250,0.782608695652174,14,9,5,342.0748824821089,0.4081477732793522,0.21141164727635697,0.20857250616710699,132849.7770948754,1288.9143775007783,134138.69147237617,1245,9,331.94871794871796,37,2,18,33.45343189392329,0.6469594594594594,42.26973684210527,1030.9210526315794,27.862731152204848,0
2985,4,0,0,39,0.0,0.0,1.0,39,900,300,600,0.3333333333333333,15,3,12,332.9423722563995,0.4079228520017994,0.12408787981475267,0.19182212817817934,130694.03863322784,993.7182106350267,131687.75684386288,1246,10,332.94871794871796,36,3,16,35.858342511013234,0.6273148148148149,44.36936936936937,1022.5225225225226,28.403403403403406,8
2986,4,0,0,39,0.0,0.0,1.0,39,1150,800,350,0.6956521739130435,15,8,7,332.0882079500672,0.40806342780026994,0.12470990801754955,0.1916153179544162,130751.6194403863,884.2141973054104,131635.8336376917,1247,11,333.94871794871796,36,3,16,35.82200139470014,0.6278935185185186,44.31306306306306,1022.7477477477476,28.409659659659653,0
2987,4,0,0,39,0.0,0.0,1.0,39,1050,500,550,0.47619047619047616,16,5,11,332.8091410021048,0.40797908232118757,0.12721426615514475,0.1921745345023596,130780.41459956573,904.9834885561157,131685.39808812184,1248,12,334.94871794871796,36,3,16,35.774477962494025,0.6281828703703703,44.284909909909906,1022.86036036036,28.412787787787778,0
2988,4,0,0,39,0.0,0.0,1.0,39,850,400,450,0.47058823529411764,13,4,9,333.25647181196985,0.40733243364822314,0.13033858796570663,0.1928642231136023,130866.81909950484,922.442882071252,131789.2619815761,1249,13,335.94871794871796,36,3,17,35.67576491305305,0.6290509259259259,44.20045045045045,1023.1981981981976,28.422172172172154,0
2989,4,1,0,40,0.025,0.0,1.0,40,1200,700,500,0.5833333333333334,17,7,10,330.7234944069587,0.4083733974358974,0.13387138296776868,0.1775376370473175,127907.33642578112,486.0724936560149,128393.40891943713,1250,0,328.525,39,1,14,38.74568787972401,0.59375,47.10937499999999,1011.562499999999,25.937499999999975,8
2990,4,3,0,43,0.06976744186046512,0.0,1.0,43,1500,1000,500,0.6666666666666666,20,10,10,323.43409719775184,0.4165051679586564,0.16858923559329386,0.17216567756219062,127567.61508133342,-335.0304582191718,127232.58462311425,1251,0,306.5348837209302,41,2,19,39.276960784313715,0.5871443089430894,47.445436507936506,1010.2182539682536,24.639469608981795,8
2991,4,3,1,45,0.06521739130434782,0.021739130434782608,0.9782608695652174,46,1550,1100,450,0.7096774193548387,20,11,9,312.02234257699564,0.421719001610306,0.20063085452112372,0.16984275484081834,128463.58861396552,-1180.6948464879101,127282.89376747761,1252,0,287.4782608695652,42,4,16,38.652185687886316,0.5947420634920635,46.560077519379846,1013.7596899224807,24.137135474344777,0
2992,4,0,0,45,0.0,0.0,1.0,45,1050,500,550,0.47619047619047616,16,5,11,316.30418168831636,0.42024410774410775,0.21431787291879045,0.17238577902013272,128512.70957274223,-870.1785124090852,127642.53106033315,1253,1,294.2888888888889,42,3,17,38.49368469673805,0.5952380952380952,46.511627906976756,1013.9534883720946,24.14174972314511,0
2993,4,0,0,45,0.0,0.0,1.0,45,1300,1000,300,0.7692307692307693,16,10,6,314.06170806522476,0.41988636363636367,0.21429415974361388,0.17174798767242244,128648.39916386887,-919.2928037476952,127729.10636012118,1254,2,295.2888888888889,43,2,17,38.412540060362794,0.595203488372093,46.377840909090914,1014.4886363636369,23.59275898520086,0
2994,4,1,3,43,0.021739130434782608,0.06521739130434782,0.9347826086956522,46,650,300,350,0.46153846153846156,10,3,7,308.12955790038933,0.423299114331723,0.21840026006874336,0.16955629008999362,128895.62864369014,-1256.6893861453918,127638.93925754476,1255,0,289.8478260869565,44,2,18,38.31190541320934,0.5963541666666667,46.13425925925927,1015.4629629629642,23.07870370370373,0
2995,4,1,1,43,0.022727272727272728,0.022727272727272728,0.9772727272727273,44,1300,1100,200,0.8461538461538461,15,11,4,318.5773580214775,0.41783386187455956,0.21774081533439782,0.1744844191004665,128709.28730244606,-599.2270596718693,128110.06024277418,1256,0,303.72727272727275,42,2,19,38.23608989050164,0.5972222222222222,46.317829457364354,1014.728682170545,24.16020671834631,0
2996,4,0,0,43,0.0,0.0,1.0,43,1250,1000,250,0.8,15,10,5,320.3618332137639,0.41687430786268,0.22325403836166124,0.1761149679125824,128856.81918905121,-343.83863650020487,128512.980552551,1257,1,310.2093023255814,42,1,20,38.04081567729212,0.5987103174603174,46.17248062015504,1015.3100775193805,24.174049464747153,0
2997,4,2,0,45,0.044444444444444446,0.0,1.0,45,1100,900,200,0.8181818181818182,13,9,4,312.4043378490139,0.42140151515151514,0.23645051194539257,0.1740199068246407,129377.95380015418,-914.9729515746083,128462.98084857957,1258,0,297.3777777777778,41,4,22,37.71402161547211,0.6054369918699187,45.659722222222214,1017.3611111111101,24.81368563685634,0
2998,4,2,0,47,0.0425531914893617,0.0,1.0,47,1050,900,150,0.8571428571428571,12,9,3,309.6108180315273,0.4237974098057354,0.26802367028521523,0.1751280913703751,129979.17631172814,-1351.4081790123646,128627.76813271578,1259,0,285.6808510638298,44,3,20,37.17651865976574,0.6072443181818181,45.069444444444436,1019.7222222222201,23.175505050505002,0
2999,4,0,1,46,0.0,0.02127659574468085,0.9787234042553191,47,1550,1200,350,0.7741935483870968,19,12,7,312.43102994078595,0.42410576626580326,0.2732429871004729,0.17779696659975666,130215.33028978051,-1263.338048696846,128951.99224108366,1260,1,286.6808510638298,44,3,22,36.86590915963592,0.6096117424242424,44.83796296296296,1020.648148148148,23.19654882154882,0
3000,4,0,1,45,0.0,0.021739130434782608,0.9782608695652174,46,1350,1100,250,0.8148148148148148,16,11,5,322.3005397349771,0.42184983896940415,0.2824957231851779,0.18318093967215784,130165.93491735529,-809.4897842057005,129356.4451331496,1261,2,293.39130434782606,43,3,22,36.66403736698835,0.6104651162790697,44.88636363636363,1020.4545454545448,23.731501057082436,0
3001,4,0,0,45,0.0,0.0,1.0,45,950,800,150,0.8421052631578947,11,8,3,329.7344005506234,0.42037037037037034,0.28962765957446845,0.18703899617440514,130089.53788834793,-421.00084129560594,129668.53704705232,1262,3,300.8,42,3,22,36.55173505572443,0.6111111111111112,44.961240310077514,1020.155038759689,24.2894056847545,0
3002,4,1,1,45,0.021739130434782608,0.021739130434782608,0.9782608695652174,46,1850,1200,650,0.6486486486486487,25,12,13,320.27270370753337,0.42325885668276975,0.28625062717348015,0.18333606023166996,130444.2007072509,-844.1115686576521,129600.08913859325,1263,0,295.2391304347826,40,6,24,36.4344989388513,0.6177083333333333,44.61382113821138,1021.544715447154,25.538617886178848,0
3003,4,0,0,45,0.0,0.0,1.0,45,1150,900,250,0.782608695652174,14,9,5,320.1436953528194,0.4231060606060606,0.27188400168301197,0.18348135327983747,130490.55103812326,-644.8545564059269,129845.69648171733,1264,1,287.2,41,4,15,36.390972424507225,0.6166158536585367,44.568452380952365,1021.7261904761879,24.920150987224094,0
3004,4,0,1,44,0.0,0.022222222222222223,0.9777777777777777,45,1200,800,400,0.6666666666666666,16,8,8,322.960474043494,0.42342171717171717,0.27465294631589265,0.1853379299789429,130541.236821696,-568.0680547682284,129973.16876692777,1265,2,288.2,41,4,15,36.267817849399734,0.6171239837398375,44.518849206349195,1021.924603174601,24.92499032133173,0
3005,4,0,0,44,0.0,0.0,1.0,44,1100,900,200,0.8181818181818182,13,9,4,328.01091729486717,0.4185275722339676,0.27753313922997647,0.1880172042464421,130496.1136311058,-239.17001288915571,130256.94361821665,1266,7,295.70454545454544,40,4,15,36.18439592865194,0.6182291666666666,44.5630081300813,1021.7479674796747,25.543699186991866,0
3006,4,0,0,44,0.0,0.0,1.0,44,1100,800,300,0.7272727272727273,14,8,6,325.7554780404495,0.4185275722339676,0.268569569225763,0.18722563417890525,130599.97046235719,-291.2688379932431,130308.70162436395,1267,8,296.70454545454544,40,4,17,36.137071651090345,0.6192708333333333,44.461382113821145,1022.1544715447164,25.553861788617912,0
3007,4,0,0,44,0.0,0.0,1.0,44,1100,400,700,0.36363636363636365,18,4,14,322.25385936214633,0.41781183932346727,0.2588633717853739,0.18578259408864678,130718.71456916102,-375.07794784580574,130343.63662131522,1268,9,297.70454545454544,41,3,17,36.10666472642607,0.6189024390243902,44.345238095238095,1022.6190476190478,24.941927990708482,0
3008,4,0,0,44,0.0,0.0,1.0,44,1250,800,450,0.64,17,8,9,322.57341315577725,0.41739341085271314,0.2577843994639961,0.18645611190932587,130820.1845553036,-360.1773116654047,130460.00724363819,1269,10,298.70454545454544,41,3,18,35.99608869925008,0.6199186991869918,44.24603174603175,1023.015873015873,24.951606658923733,0
3009,4,0,3,41,0.0,0.06818181818181818,0.9318181818181819,44,1300,1000,300,0.7692307692307693,16,10,6,322.37754914005643,0.41684284707540525,0.26194790438233273,0.18675969810576734,130906.34694617223,-359.746540923011,130546.60040524922,1270,11,299.70454545454544,42,2,18,35.91417321592021,0.6192956349206349,44.16182170542636,1023.3527131782955,24.365540789959418,0
3010,4,1,0,42,0.023809523809523808,0.0,1.0,42,1350,1100,250,0.8148148148148148,16,11,5,329.05296040254945,0.4147793263646922,0.2516868330094417,0.1907825195287324,130937.79047070228,217.09351659068403,131154.88398729297,1271,0,295.8095238095238,40,2,20,35.71165557872439,0.62265625,44.131097560975626,1023.4756097561002,25.586890243902506,0
3011,4,1,0,43,0.023255813953488372,0.0,1.0,43,1400,1200,200,0.8571428571428571,16,12,4,322.88647317633047,0.41752030269472135,0.2508781726802727,0.1886182972265354,131226.45817586317,-125.7503464348419,131100.7078294283,1272,0,289.90697674418607,41,2,21,35.578443712884074,0.6239837398373984,43.84920634920636,1024.6031746031765,24.99032133178479,0
3012,4,0,1,42,0.0,0.023255813953488372,0.9767441860465116,43,1150,800,350,0.6956521739130435,15,8,7,331.2906548207379,0.41668973791066816,0.21812778035273106,0.1805589716699367,128513.93771701415,-46.75948070197657,128467.17823631217,1273,1,290.90697674418607,39,4,16,38.11254366139304,0.5998931623931624,46.51041666666668,1013.9583333333355,25.99893162393168,8
3013,4,2,0,44,0.045454545454545456,0.0,1.0,44,1350,800,550,0.5925925925925926,19,8,11,325.6087319744809,0.41959566596194503,0.23454518157250592,0.1790400022651097,128865.81776926779,-408.0328962588246,128457.78487300896,1274,0,285.22727272727275,40,4,18,37.89848363527174,0.6018229166666667,46.16361788617887,1015.3455284552858,25.383638211382145,0
3014,4,0,0,44,0.0,0.0,1.0,44,950,600,350,0.631578947368421,13,6,7,323.35644057214495,0.4196176885130374,0.22996779563876513,0.17803310802410177,128917.41569378357,-462.7446666997066,128454.67102708385,1275,1,286.22727272727275,40,4,18,37.90319890590079,0.60234375,46.112804878048784,1015.5487804878057,25.388719512195145,0
3015,4,1,0,45,0.022222222222222223,0.0,1.0,45,1500,1200,300,0.8,18,12,6,318.7858655562168,0.42169612794612793,0.23140596205962094,0.17700731971566727,129251.8237040185,-759.2691011589982,128492.55460285951,1276,0,280.84444444444443,41,4,19,37.67967479674796,0.6041666666666667,45.78373015873015,1016.8650793650783,24.801587301587276,0
3016,4,1,1,45,0.021739130434782608,0.021739130434782608,0.9782608695652174,46,1300,1000,300,0.7692307692307693,16,10,6,312.27541634469065,0.42285628019323673,0.23915939546641218,0.17502412535287215,129620.41348363973,-1104.5462825250943,128515.86720111463,1277,0,275.7173913043478,42,4,15,37.471651283027235,0.6063988095238095,45.42151162790697,1018.3139534883715,24.2455703211517,0
3017,4,0,0,45,0.0,0.0,1.0,45,1750,1500,250,0.8571428571428571,20,15,5,318.07342940301766,0.4203914141414142,0.23799408879794748,0.17808988575903797,129579.88989866756,-756.8160076530883,128823.07389101447,1278,1,282.8222222222222,41,4,16,37.36511010425801,0.6074695121951219,45.46130952380951,1018.15476190476,24.83304297328683,0
3018,4,0,0,45,0.0,0.0,1.0,45,1500,800,700,0.5333333333333333,22,8,14,334.1084893811538,0.4200757575757576,0.12368634643561127,0.19109265255381105,130411.00599610878,-228.11789993965584,130182.88809616913,1279,2,283.8222222222222,42,3,15,36.11473452866583,0.6143353174603174,44.64631782945735,1021.4147286821687,24.319398301956397,8
3019,4,2,0,47,0.0425531914893617,0.0,1.0,47,1050,900,150,0.8571428571428571,12,9,3,327.3069756966485,0.4255511871723712,0.13988639645710976,0.18935822415957912,130854.01663237296,-834.1135116598243,130019.90312071313,1280,0,272.70212765957444,44,3,15,35.84087481146304,0.6160037878787878,44.212962962962955,1023.148148148147,23.25336700336698,0
3020,4,0,0,47,0.0,0.0,1.0,47,1450,800,650,0.5517241379310345,21,8,13,326.8912978644541,0.42531991982732037,0.14167465164336623,0.19005068200763053,131043.55709876545,-832.6003086419735,130210.95679012347,1281,1,273.70212765957444,44,3,16,35.660268583830714,0.6178977272727273,44.02777777777778,1023.888888888889,23.270202020202024,0
3021,4,0,0,47,0.0,0.0,1.0,47,1250,800,450,0.64,17,8,9,325.3546120148128,0.4246646623496762,0.13847094660082182,0.18985883055547928,131185.80246913573,-863.618827160499,130322.18364197522,1282,2,274.70212765957444,44,3,17,35.55619577006509,0.6193181818181819,43.888888888888886,1024.444444444444,23.28282828282827,0
3022,4,1,0,48,0.020833333333333332,0.0,1.0,48,1200,900,300,0.75,15,9,6,321.5537020127224,0.42614140070921985,0.14798014773776558,0.1890568182843532,131473.7619447314,-1144.670704838787,130329.09123989262,1283,0,269.9583333333333,43,5,18,35.36357340720222,0.623546511627907,43.60795454545455,1025.568181818182,23.850422832980975,0
3023,4,0,1,47,0.0,0.020833333333333332,0.9791666666666666,48,1400,1100,300,0.7857142857142857,17,11,6,321.4144547480256,0.42629838947990545,0.14656041301203326,0.18909505482758648,131498.0426154299,-1146.9256664657887,130351.11694896412,1284,1,270.9583333333333,43,5,18,35.342708429507894,0.6237887596899225,43.584280303030305,1025.6628787878792,23.852625088090214,0
3024,4,1,0,48,0.020833333333333332,0.0,1.0,48,1000,700,300,0.7,13,7,6,319.3671923837134,0.42697251773049644,0.16295130239567035,0.18885002718205518,131692.36868866227,-1188.3555907082105,130504.01309795407,1285,0,271.4166666666667,43,5,17,35.19976089430145,0.6257267441860466,43.39488636363637,1026.4204545454552,23.870243128964074,0
3025,4,0,1,47,0.0,0.020833333333333332,0.9791666666666666,48,1200,800,400,0.6666666666666666,16,8,8,317.2655741782354,0.42674165189125296,0.15382546415836718,0.18820721479150926,131813.89534550058,-1235.9977617079778,130577.89758379261,1286,1,272.4166666666667,43,5,17,35.13156276896595,0.626937984496124,43.276515151515156,1026.8939393939402,23.881254404510237,0
3026,4,0,0,47,0.0,0.0,1.0,47,1650,1000,650,0.6060606060606061,23,10,13,324.7937713733778,0.4246839346284305,0.15759743927697234,0.19316682192206192,131911.15702479368,-831.215564738266,131079.94146005542,1287,2,278.5531914893617,43,4,18,34.84052359882005,0.627906976744186,43.181818181818194,1027.2727272727295,23.890063424947197,0
3027,4,0,0,47,0.0,0.0,1.0,47,1300,800,500,0.6153846153846154,18,8,10,323.9688118897297,0.4246068455134135,0.16102140207511506,0.19317085421029417,132008.45457415085,-846.6755624425804,131161.77901170828,1288,3,279.5531914893617,43,4,18,34.763945202113284,0.6288759689922481,43.087121212121225,1027.6515151515173,23.89887244538412,0
3028,4,1,2,46,0.020833333333333332,0.041666666666666664,0.9583333333333334,48,1150,900,250,0.782608695652174,14,9,5,320.63469861055916,0.42514406028368795,0.16801129714645802,0.19243278589220453,132255.10223765447,-1118.885030864184,131136.2172067903,1289,0,274.7083333333333,44,4,19,34.60201188225763,0.6299715909090908,42.84722222222223,1028.6111111111122,23.377525252525277,0
3029,4,0,0,46,0.0,0.0,1.0,46,800,400,400,0.5,12,4,8,330.44086078722023,0.4220410628019324,0.17067748056408227,0.19750124462488,132098.99612590892,-469.8188022053953,131629.1773237035,1290,1,286.6521739130435,42,4,19,34.50666886605713,0.6312003968253967,42.99903100775194,1028.0038759689924,24.476282761166484,0
3030,4,1,0,47,0.02127659574468085,0.0,1.0,47,1100,800,300,0.7272727272727273,14,8,6,328.90309705868924,0.42266034535923525,0.17132006758641105,0.19841270552796242,132449.05832703423,-686.7428616430133,131762.3154653912,1291,0,281.531914893617,41,6,20,34.19469609354921,0.6361788617886179,42.658730158730144,1029.365079365077,25.10646535036773,0
3031,4,0,0,47,0.0,0.0,1.0,47,1100,700,400,0.6363636363636364,15,7,8,329.420098950161,0.4223519888991674,0.1797678655973376,0.19940000275228087,132576.73852237637,-665.3115354938429,131911.42698688252,1292,1,282.531914893617,41,6,20,34.05329849404362,0.6374491869918699,42.534722222222214,1029.8611111111097,25.118563685636822,0
3032,4,0,1,46,0.0,0.02127659574468085,0.9787234042553191,47,1200,700,500,0.5833333333333334,17,7,10,332.84326170150734,0.4222556275053962,0.17949553382062744,0.20174615214516914,132627.82782383767,-571.1442389455992,132056.68358489207,1293,2,283.531914893617,41,6,15,33.91390975633244,0.6379573170731707,42.48511904761904,1030.0595238095223,25.123403019744444,0
3033,4,0,0,46,0.0,0.0,1.0,46,1150,700,450,0.6086956521739131,16,7,9,339.26566530116827,0.421688808373591,0.18021610496526863,0.20624423538092604,132738.1395002974,-193.30135831846624,132544.83814197892,1294,3,288.7173913043478,40,6,16,33.63782051282052,0.640625,42.3780487804878,1030.4878048780486,25.762195121951216,0
3034,4,0,2,44,0.0,0.043478260869565216,0.9565217391304348,46,1150,800,350,0.6956521739130435,15,8,7,340.11010378001544,0.4214070048309179,0.17738050336030686,0.20733635172743256,132842.88452640627,-163.7585514574691,132679.1259749488,1295,4,289.7173913043478,40,6,16,33.510983504206074,0.6416666666666666,42.27642276422764,1030.8943089430895,25.772357723577237,0
3035,4,0,0,44,0.0,0.0,1.0,44,1400,1000,400,0.7142857142857143,18,10,8,345.01094336195973,0.4182963354474982,0.18309524663034105,0.21032397893411797,132842.8845264064,366.4497818758776,133209.33430828227,1296,7,301.84090909090907,40,4,17,33.38467731335435,0.6416666666666666,42.27642276422765,1030.8943089430904,25.77235772357726,0
3036,4,0,1,43,0.0,0.022727272727272728,0.9772727272727273,44,1450,1100,350,0.7586206896551724,18,11,7,343.3465465461263,0.4173603770260747,0.1811530916615156,0.21004364682921278,132973.87390318283,331.22407710359073,133305.09798028643,1297,8,302.84090909090907,40,4,17,33.296178605445526,0.64296875,42.149390243902445,1031.4024390243917,25.78506097560979,0
3037,4,0,0,43,0.0,0.0,1.0,43,1400,1300,100,0.9285714285714286,15,13,2,341.01243716558923,0.4151208933185677,0.18677420945021228,0.20944886639798488,133122.62505425367,479.29416232641057,133601.91921658008,1298,9,309.83720930232556,39,4,17,33.20726506510548,0.6461004273504274,42.00520833333334,1031.9791666666683,26.461004273504315,0
3038,4,0,3,40,0.0,0.06976744186046512,0.9302325581395349,43,950,700,250,0.7368421052631579,12,7,5,339.2453852240613,0.41502860834256183,0.18347728917262818,0.2085578772600223,133157.36747306504,434.60448476437074,133591.9719578294,1299,10,310.83720930232556,40,3,17,33.2180484442694,0.6447916666666667,41.97154471544716,1032.113821138212,25.8028455284553,0
3039,4,0,0,40,0.0,0.0,1.0,40,1200,800,400,0.6666666666666666,16,8,8,356.3250187572336,0.4094417735042735,0.2027860484900046,0.21758964132422245,132906.30290089268,1471.5681748230359,134377.87107571572,1300,11,333.025,37,3,17,33.02938465901037,0.6475225225225225,42.21491228070176,1031.1403508771937,27.868658131816044,0
3040,4,1,0,41,0.024390243902439025,0.0,1.0,41,1450,1300,150,0.896551724137931,16,13,3,350.8856822292856,0.41074695121951216,0.2072457278940345,0.21660527108475347,133310.81271701402,1155.371093750011,134466.18381076402,1301,0,325.8780487804878,39,2,19,32.76385246452828,0.6479700854700854,41.82291666666667,1032.7083333333344,26.479700854700884,0
3041,4,0,0,41,0.0,0.0,1.0,41,850,600,250,0.7058823529411765,11,6,5,349.12654939191776,0.40995934959349595,0.20875707395775112,0.21598802185400215,133391.50526258707,1114.1031901041927,134505.60845269126,1302,1,326.8780487804878,39,2,20,32.72841669187591,0.6487713675213675,41.74479166666668,1033.0208333333355,26.487713675213733,0
3042,4,1,1,41,0.023809523809523808,0.023809523809523808,0.9761904761904762,42,850,500,350,0.5882352941176471,12,5,7,345.0082069739866,0.4118152342237708,0.21260077248101172,0.21542490693787014,133734.17494775192,827.9752382238751,134562.1501859758,1303,0,320.07142857142856,36,6,17,32.49183451279259,0.6576967592592593,41.41328828828829,1034.3468468468477,28.73185685685688,0
3043,4,0,0,41,0.0,0.0,1.0,41,800,400,400,0.5,12,4,8,370.90120830217444,0.4086636178861789,0.26882908591566634,0.2159395383034557,131097.37059694843,1571.2144154289522,132668.58501237739,1304,3,328.8780487804878,36,5,19,34.479235393299604,0.6313657407407407,43.97522522522523,1024.0990990991002,28.447197197197227,8
3044,4,0,0,41,0.0,0.0,1.0,41,1000,600,400,0.6,14,6,8,374.568201718026,0.40881605691056916,0.2697510575897142,0.21873051984792047,131212.72243527314,1629.6226970213502,132842.3451322945,1305,4,329.8780487804878,36,5,20,34.268520553967896,0.6325231481481481,43.862612612612615,1024.5495495495497,28.459709709709713,0
3045,4,0,0,41,0.0,0.0,1.0,41,1000,700,300,0.7,13,7,6,375.30171656273666,0.4086128048780488,0.2725877022584351,0.2199852882080226,131356.983567182,1659.700283053318,133016.68385023533,1306,5,330.8780487804878,36,5,20,34.10368376725621,0.6339699074074074,43.721846846846844,1025.1126126126123,28.475350350350343,0
3046,4,0,0,41,0.0,0.0,1.0,41,1450,900,550,0.6206896551724138,20,9,11,371.84368749070575,0.40777439024390244,0.2700708034748329,0.21878244868639196,131501.32395909424,1579.5874421718995,133080.91140126614,1307,6,331.8780487804878,36,5,20,34.046305445761945,0.6354166666666667,43.58108108108108,1025.6756756756758,28.490990990990994,0
3047,4,1,0,42,0.023809523809523808,0.0,1.0,42,1200,800,400,0.6666666666666666,16,8,8,365.46882287941696,0.40896002710027096,0.27453402885818035,0.21691894772424697,131834.36850761765,1236.2702947060557,133070.6388023237,1308,0,324.95238095238096,37,5,15,33.87340735995445,0.6368243243243243,43.25657894736842,1026.9736842105258,27.7560455192034,0
3048,4,0,0,42,0.0,0.0,1.0,42,1250,900,350,0.72,16,9,7,359.60757833561775,0.4087543554006969,0.2690544791174392,0.21423284275798318,131975.1645337989,1091.8538636888302,133067.01839748773,1309,1,325.95238095238096,37,5,16,33.88190072208586,0.6382319819819819,43.11951754385965,1027.5219298245618,27.7708629682314,0
3049,4,0,0,42,0.0,0.0,1.0,42,850,500,350,0.5882352941176471,12,5,7,359.77868845298167,0.40828252032520324,0.27072159921989325,0.21513297085045613,132116.0357032932,1106.506809787611,133222.5425130808,1310,2,326.95238095238096,37,5,17,33.73551265642775,0.6396396396396397,42.98245614035087,1028.0701754385955,27.785680417259336,0
3050,4,0,0,42,0.0,0.0,1.0,42,950,400,550,0.42105263157894735,15,4,11,359.4565101362771,0.40784698025551686,0.26961277153215724,0.21526073767931078,132172.40521121887,1102.0463027085289,133274.4515139274,1311,3,327.95238095238096,37,5,17,33.686997938437486,0.6402027027027026,42.92763157894737,1028.2894736842109,27.791607396870564,0
3051,4,1,0,43,0.023255813953488372,0.0,1.0,43,1550,1200,350,0.7741935483870968,19,12,7,377.765692933006,0.4098375784422296,0.20462347424580707,0.21619637858645466,130435.0819358213,1385.3368203589907,131820.4187561803,1312,0,321.30232558139534,36,7,18,34.975471282107826,0.6247106481481481,44.622747747747766,1021.5090090090118,28.37525025025033,8
3052,4,0,0,43,0.0,0.0,1.0,43,1200,900,300,0.75,15,9,6,380.71508090159426,0.40999907715024,0.20670068872888847,0.21820770240177972,130492.6056757775,1336.100585382723,131828.70626116023,1313,1,322.30232558139534,36,7,16,34.841700650281055,0.6252893518518519,44.56644144144146,1021.7342342342372,28.38150650650659,0
3053,4,0,0,43,0.0,0.0,1.0,43,850,500,350,0.5882352941176471,12,5,7,383.59650258334864,0.41025286083425616,0.2065817181327716,0.22067737962304454,130636.47050766999,1422.3386393150085,132058.809146985,1314,2,323.30232558139534,36,7,16,34.621933979584334,0.6267361111111112,44.425675675675684,1022.2972972972985,28.39714714714718,0
3054,4,0,1,42,0.0,0.023255813953488372,0.9767441860465116,43,1450,1000,450,0.6896551724137931,19,10,9,379.309234948107,0.41011443337024733,0.20371109950539168,0.21918861897382974,130809.21292914537,1323.428496063634,132132.641425209,1315,3,324.30232558139534,36,7,18,34.55617936298255,0.6284722222222222,44.25675675675676,1022.9729729729731,28.41591591591592,0
3055,4,0,0,42,0.0,0.0,1.0,42,1150,800,350,0.6956521739130435,15,8,7,377.8727273179148,0.4096254355400697,0.20546092732352905,0.21881892274794398,130890.45606874157,1491.9867229162364,132382.4427916578,1316,4,329.76190476190476,38,4,18,34.5105101969792,0.6255482456140351,44.17735042735044,1023.2905982906002,26.928699955015794,0
3056,4,0,0,42,0.0,0.0,1.0,42,1550,1200,350,0.7741935483870968,19,12,7,374.07878914939556,0.40934717382888114,0.1948862817588688,0.21739217928554636,131027.14913662434,1402.8954589451428,132430.0445955695,1317,5,330.76190476190476,38,4,18,34.46902500956555,0.6269188596491229,44.04380341880342,1023.8247863247866,26.942757534862807,0
3057,4,0,0,42,0.0,0.0,1.0,42,1600,1100,500,0.6875,21,11,10,369.9177619520149,0.4084639953542393,0.19680823425491556,0.2159317289078328,131197.9489411895,1306.4903290039406,132504.43927019346,1318,6,331.76190476190476,40,2,18,34.402589028866196,0.6252604166666667,43.87703252032522,1024.4918699187024,25.61229674796756,0
3058,4,0,0,42,0.0,0.0,1.0,42,800,500,300,0.625,11,5,6,371.159876840531,0.40851238869531553,0.19605606796918873,0.21695101670626568,131250.01161882837,1342.9476295525476,132592.9592483809,1319,7,332.76190476190476,40,2,18,34.318076630632426,0.62578125,43.82621951219514,1024.695121951222,25.61737804878055,0
3059,4,0,0,42,0.0,0.0,1.0,42,850,500,350,0.5882352941176471,12,5,7,374.11593628131357,0.4081857336430507,0.19918699186991873,0.2191250483933412,131328.12500000026,1426.388888888918,132754.51388888917,1320,8,333.76190476190476,40,2,18,34.163279132791345,0.6265625,43.750000000000014,1025.000000000002,25.62500000000005,0
3060,4,0,1,41,0.0,0.023809523809523808,0.9761904761904762,42,1250,800,450,0.64,17,8,9,368.4436880273983,0.40781068524970965,0.20471429563285426,0.21704271732755054,131547.2334082108,1293.5495653444164,132840.7829735552,1321,9,334.76190476190476,38,4,19,34.087082552246045,0.6321271929824561,43.536324786324776,1025.8547008546993,26.99617633828156,0
3061,4,0,0,41,0.0,0.0,1.0,41,1500,1100,400,0.7333333333333333,19,11,8,367.30457218842463,0.4066819105691057,0.20155168011838231,0.21736443772617103,131721.78578985814,1476.402835487812,133198.18862534597,1322,10,340.0487804878049,37,4,17,33.93995228939685,0.6356981981981982,43.366228070175424,1026.5350877192961,27.744191559980976,0
3062,4,0,0,41,0.0,0.0,1.0,41,1300,1100,200,0.8461538461538461,15,11,4,368.8743332686774,0.40625,0.20693678957293637,0.21861640865366402,131778.07113727278,1521.9096260387555,133299.98076331153,1323,11,341.0487804878049,37,4,17,33.842820019934486,0.6362612612612613,43.31140350877192,1026.7543859649106,27.75011853959218,0
3063,4,0,0,41,0.0,0.0,1.0,41,1250,900,350,0.72,16,9,7,371.0595704404141,0.4054878048780488,0.20408673243616082,0.22089124364845494,131946.99931709756,1592.0393775007713,133539.03869459833,1324,12,342.0487804878049,37,4,17,33.616150836001424,0.6379504504504505,43.146929824561404,1027.4122807017545,27.767899478425797,0
3064,4,0,0,41,0.0,0.0,1.0,41,1300,800,500,0.6153846153846154,18,8,10,368.53722341810897,0.40558943089430893,0.2011596556426507,0.21971570342713245,132003.33275623288,1529.6283471837683,133532.96110341666,1325,13,343.0487804878049,37,4,17,33.62409304310714,0.6385135135135135,43.092105263157904,1027.63157894737,27.773826458037025,0
3065,4,0,0,41,0.0,0.0,1.0,41,1100,700,400,0.6363636363636364,15,7,8,370.78049887749455,0.40495426829268294,0.21184842771120982,0.22191489559682887,132150.7232084155,1599.782215647601,133750.5054240631,1326,14,344.0487804878049,38,3,19,33.41775768911056,0.638157894736842,42.94871794871795,1028.2051282051282,27.058029689608635,0
3066,4,0,0,41,0.0,0.0,1.0,41,1450,1200,250,0.8275862068965517,17,12,5,351.41873560927576,0.40477642276422765,0.17092022601863754,0.2029241842414482,130781.15297866927,992.2517623639709,131773.40474103324,1327,15,345.0487804878049,38,3,18,35.29785530255553,0.6244517543859649,44.28418803418805,1022.86324786325,26.917453891138155,8
3067,4,0,0,41,0.0,0.0,1.0,41,1150,500,650,0.43478260869565216,18,5,13,351.2474964039563,0.4049034552845528,0.16686747755205955,0.20296890634085013,130808.47447083448,989.2298332603054,131797.70430409478,1328,16,346.0487804878049,38,3,18,35.2745865970409,0.6247258771929824,44.257478632478644,1022.9700854700873,26.92026540710756,0
3068,4,0,0,41,0.0,0.0,1.0,41,850,600,250,0.7058823529411765,11,6,5,350.47599131713184,0.40497967479674796,0.16714917540656726,0.20309797464167034,130917.78897518101,976.7083744247414,131894.49734960575,1329,17,347.0487804878049,38,3,18,35.1837352542019,0.6258223684210527,44.150641025641036,1023.3974358974376,26.9315114709852,0
3069,4,0,0,41,0.0,0.0,1.0,41,950,600,350,0.631578947368421,13,6,7,350.03838584308005,0.4049288617886179,0.16242512492967554,0.2031325120994883,130972.46334876554,969.0779320987781,131941.5412808643,1330,18,348.0487804878049,38,3,19,35.13964269561285,0.6263706140350878,44.09722222222223,1023.611111111112,26.937134502924,0
3070,4,0,1,40,0.0,0.024390243902439025,0.975609756097561,41,900,600,300,0.6666666666666666,12,6,6,348.6004762475828,0.40503048780487805,0.12658521138726253,0.18786353310407297,128063.41428336644,729.0756949010427,128792.48997826748,1331,19,349.0487804878049,38,3,17,38.133971923158114,0.5970394736842105,46.95512820512822,1012.1794871794891,26.636302294197083,8
3071,4,0,0,40,0.0,0.0,1.0,40,1500,1200,300,0.8,18,12,6,356.54843074649574,0.4048344017094017,0.13275563258232292,0.19226957433712888,128089.02739304396,1133.9883425669404,129223.0157356109,1332,20,357.35,37,3,19,37.90664716926632,0.5990990990990991,46.92982456140351,1012.2807017543855,27.358937885253663,0
3072,4,1,1,40,0.024390243902439025,0.024390243902439025,0.975609756097561,41,1700,1400,300,0.8235294117647058,20,14,6,349.7902598789459,0.4102642276422764,0.13644766587697,0.18983189133840508,128344.14439777618,778.7303704280833,129122.87476820426,1333,0,349.609756097561,36,5,20,37.81696858561163,0.603587962962963,46.67792792792793,1013.2882882882885,28.146896896896905,0
3073,4,0,1,39,0.0,0.025,0.975,40,1050,800,250,0.7619047619047619,13,8,5,351.41564976476366,0.40810630341880344,0.16312486114196822,0.19126019825770274,128458.27880245114,1028.4499026053106,129486.72870505645,1334,1,358.825,36,4,13,37.65922387617565,0.6047453703703703,46.56531531531532,1013.7387387387391,28.15940940940942,0
3074,4,0,0,39,0.0,0.0,1.0,39,900,700,200,0.7777777777777778,11,7,4,360.2692260990271,0.4026090868196131,0.16163835402953386,0.19525922823806693,128291.05748724692,1443.8639992712353,129734.92148651816,1335,27,369.0,35,4,19,37.60579706005558,0.6050595238095238,46.73032407407406,1013.0787037037023,28.94510582010578,0
3075,4,2,0,41,0.04878048780487805,0.0,1.0,41,1050,800,250,0.7619047619047619,13,8,5,343.63184036269996,0.4102896341463415,0.16886444860561323,0.18908939237070474,128895.01006319237,658.4859043166934,129553.49596750906,1336,0,351.9512195121951,37,4,16,37.41125418421336,0.6072635135135135,46.13486842105262,1015.4605263157882,27.4448790896159,0
3076,4,2,0,43,0.046511627906976744,0.0,1.0,43,900,600,300,0.6666666666666666,12,6,6,329.118232018937,0.4129983388704319,0.1717190453034687,0.18328685214115795,129368.65790435483,-83.75581909822614,129284.9020852566,1337,0,336.5348837209302,37,6,19,37.298358123158735,0.6120495495495495,45.66885964912279,1017.3245614035059,27.495258416310968,0
3077,4,0,1,42,0.0,0.023255813953488372,0.9767441860465116,43,1000,600,400,0.6,14,6,8,329.4517204989391,0.4127445551864157,0.1758932352417919,0.1838629836410493,129452.33298947735,-70.34123480303663,129381.99175467431,1338,1,337.5348837209302,37,6,13,37.20493032360019,0.6128941441441442,45.586622807017534,1017.6535087719284,27.504148885727794,0
3078,4,1,1,42,0.023255813953488372,0.023255813953488372,0.9767441860465116,43,700,300,400,0.42857142857142855,11,3,8,340.362200448411,0.4153516057585825,0.19968427370342967,0.18227759654676196,127811.68845221579,116.4740593259204,127928.16251154171,1339,0,335.48837209302326,37,6,18,38.59972529458544,0.5962837837837838,47.20394736842104,1011.1842105263136,27.329302987197664,8
3079,4,2,0,44,0.045454545454545456,0.0,1.0,44,1100,700,400,0.6363636363636364,15,7,8,344.09642333193705,0.42096106412966877,0.24345926053705957,0.18694723205766062,128388.03624260346,35.57281393818721,128423.60905654164,1340,0,328.77272727272725,38,6,12,37.91640312038793,0.600328947368421,46.63461538461538,1013.4615384615378,26.67004048582994,0
3080,4,0,0,44,0.0,0.0,1.0,44,1600,1000,600,0.625,22,10,12,344.792644023269,0.4208509513742072,0.24825653798256564,0.18783479860969132,128496.3348765432,60.91820987654455,128557.25308641975,1341,1,329.77272727272725,38,6,14,37.78824200913242,0.6014254385964912,46.52777777777778,1013.8888888888888,26.6812865497076,0
3081,4,0,0,44,0.0,0.0,1.0,44,1050,700,350,0.6666666666666666,14,7,7,346.3580315424565,0.42115926708949963,0.24819503226918416,0.18920156222463083,128604.6791675799,108.65270472643482,128713.33187230634,1342,2,330.77272727272725,38,6,14,37.63802577066216,0.6025219298245614,46.42094017094018,1014.3162393162402,26.692532613585268,0
3082,4,1,1,44,0.022222222222222223,0.022222222222222223,0.9777777777777777,45,1350,1000,350,0.7407407407407407,17,10,7,345.8973687734741,0.42365319865319867,0.25518184304074465,0.19079135408817408,128989.6701388888,-76.56250000000603,128913.1076388888,1343,0,324.4,39,6,17,37.257314738857005,0.6047008547008548,46.041666666666664,1015.8333333333326,26.047008547008527,0
3083,4,0,1,43,0.0,0.022727272727272728,0.9772727272727273,44,1400,900,500,0.6428571428571429,19,9,10,350.62779775436195,0.4234055673009161,0.2502795769069479,0.19378890465120652,129069.04432508661,251.03895399303633,129320.08327907964,1344,1,322.75,39,5,18,37.05631727319323,0.6055021367521367,45.96354166666666,1016.1458333333318,26.055021367521327,0
3084,4,2,3,42,0.044444444444444446,0.06666666666666667,0.9333333333333333,45,1050,600,450,0.5714285714285714,15,6,9,337.68640337280675,0.4276094276094276,0.20107086614173242,0.18842782613508982,129445.8954840565,-252.01524362056557,129193.88024043593,1345,0,316.35555555555555,38,7,18,37.00196850393701,0.6110197368421053,45.592948717948715,1017.6282051282049,26.77968960863697,8
3085,4,0,0,42,0.0,0.0,1.0,42,950,600,350,0.631578947368421,13,6,7,354.37614701575194,0.4193041037553233,0.24404084420018823,0.19681092463213667,129260.2304633919,761.348486797009,130021.57895018891,1346,1,339.6904761904762,35,7,21,36.76635177175809,0.6148809523809524,45.775462962962976,1016.8981481481503,29.054232804232868,0
3086,4,1,0,43,0.023255813953488372,0.0,1.0,43,850,600,250,0.7058823529411765,11,6,5,347.3916320776881,0.4217884828349945,0.2440625643136447,0.19433294269692478,129545.08562616695,400.5757446636145,129945.66137083057,1347,0,332.7674418604651,36,7,20,36.65422197640119,0.6157407407407407,45.49549549549551,1018.01801801802,28.278278278278336,0
3087,4,0,1,42,0.0,0.023255813953488372,0.9767441860465116,43,1500,1100,400,0.7333333333333333,19,11,8,348.02903727725254,0.4221576227390181,0.24598237362060815,0.19511634123361438,129631.08114448936,423.0760743852268,130054.15721887459,1348,1,333.7674418604651,36,7,20,36.550600833056876,0.6166087962962963,45.41103603603605,1018.3558558558581,28.287662662662726,0
3088,4,0,1,41,0.0,0.023809523809523808,0.9761904761904762,42,1550,1100,450,0.7096774193548387,20,11,9,345.1920942879686,0.42249806426635694,0.22498270959809408,0.19457613804770588,129843.17440222,564.1674601800637,130407.34186240006,1349,2,329.1190476190476,37,5,21,36.40745472476242,0.6168355855855856,45.202850877192986,1019.1885964912287,27.545637743006182,0
3089,4,1,0,42,0.023809523809523808,0.0,1.0,42,900,500,400,0.5555555555555556,13,5,8,315.1277067436754,0.4282326751838947,0.13336526477344113,0.17159427423745718,128477.80687326877,-277.7261994075011,128200.08067386127,1350,0,318.1190476190476,37,5,16,38.55901651164467,0.6030405405405406,46.54605263157895,1013.8157894736848,27.400426742532023,8
3090,4,0,0,42,0.0,0.0,1.0,42,1100,800,300,0.7272727272727273,14,8,6,310.1095592651528,0.4281237901664731,0.08294435160106772,0.16252887894678947,126938.35101460775,-527.040782602945,126411.3102320048,1351,1,319.1190476190476,40,2,15,40.256487831114704,0.5822916666666667,48.06910569105691,1007.7235772357726,25.193089430894315,8
3091,4,4,3,43,0.08695652173913043,0.06521739130434782,0.9347826086956522,46,1350,500,850,0.37037037037037035,22,5,17,291.68155498433197,0.4382145732689211,0.11288799524596471,0.1565699683589263,127904.94163940536,-1738.404595862979,126166.53704354238,1352,0,292.2826086956522,43,3,13,39.735458403544904,0.5876937984496124,47.11174242424242,1011.5530303030298,23.524489076814646,0
3092,4,2,0,45,0.044444444444444446,0.0,1.0,45,900,400,500,0.4444444444444444,14,4,10,296.8401814418463,0.4353535353535354,0.12365687526607116,0.15941417151506548,127923.87777176837,-1405.4105822967515,126518.46718947162,1353,0,299.6222222222222,42,3,15,39.58572796934868,0.5892857142857143,47.09302325581395,1011.6279069767429,24.086378737541498,0
3093,4,0,0,45,0.0,0.0,1.0,45,950,500,450,0.5263157894736842,14,5,9,294.5995941807639,0.43545875420875424,0.11974552108600389,0.1585978433826752,128021.92251066644,-1456.9587164232908,126564.96379424314,1354,1,300.6222222222222,42,3,16,39.542640112345204,0.5902777777777778,46.99612403100775,1012.0155038759691,24.095607235142122,0
3094,4,2,1,46,0.0425531914893617,0.02127659574468085,0.9787234042553191,47,1000,600,400,0.6,14,6,8,290.67679960354474,0.4401788467468393,0.1430174229058776,0.15881026817588217,128610.97965867417,-1923.037039540911,126687.94261913326,1355,0,288.78723404255317,42,5,11,39.043593172844226,0.5962301587301587,46.414728682170534,1014.3410852713163,24.150978220745625,0
3095,4,0,0,46,0.0,0.0,1.0,46,900,600,300,0.6666666666666666,12,6,6,300.7745751229378,0.43800322061191627,0.14309715617636232,0.1640617773162577,128546.63190507685,-1467.288281053165,127079.34362402369,1356,1,296.0652173913044,41,5,11,38.85288267136241,0.5970528455284553,46.4781746031746,1014.0873015873017,24.733836624080528,0
3096,4,0,0,46,0.0,0.0,1.0,46,1300,800,500,0.6153846153846154,18,8,10,305.6470280685926,0.4378522544283414,0.15181680207124382,0.16724730637011742,128672.41753472216,-1334.3315972222263,127338.08593749994,1357,2,297.0652173913044,41,5,12,38.60155715263518,0.5983231707317074,46.354166666666664,1014.5833333333328,24.74593495934958,0
3097,4,0,2,44,0.0,0.043478260869565216,0.9565217391304348,46,1200,800,400,0.6666666666666666,16,8,8,308.3115865554371,0.43733896940418676,0.15450272615622596,0.16913328911789147,128773.09032698725,-1259.552843127993,127513.53748385925,1358,3,298.0652173913044,41,5,13,38.43170674095071,0.599339430894309,46.254960317460316,1014.9801587301585,24.75561362756484,0
3098,4,1,1,44,0.022222222222222223,0.022222222222222223,0.9777777777777777,45,1250,600,650,0.48,19,6,13,315.8413586140044,0.43529040404040403,0.1576263081217537,0.17366929080421145,128865.81776926781,-859.7690073699371,128006.04876189788,1359,0,305.26666666666665,40,5,14,38.14641510692956,0.6018229166666667,46.16361788617887,1015.3455284552861,25.383638211382152,0
3099,4,2,0,46,0.043478260869565216,0.0,1.0,46,1500,1000,500,0.6666666666666666,20,10,10,324.30099455807874,0.4360205314009662,0.06819535437760593,0.17667143733387863,128496.33487654316,-695.2410427728921,127801.09383377027,1360,0,299.4347826086956,41,5,12,38.307648401826505,0.5965447154471545,46.52777777777778,1013.8888888888885,24.728997289972888,8
3100,4,1,1,46,0.02127659574468085,0.02127659574468085,0.9787234042553191,47,1300,1000,300,0.7692307692307693,16,10,6,318.64293551170067,0.43670983657107615,0.06929824205022417,0.17473644536908653,128758.45520852113,-1194.4055720809988,127564.04963644013,1361,0,294.0425531914894,42,5,13,38.18443288142068,0.597718253968254,46.26937984496124,1014.922480620155,24.16482096714655,0
3101,4,1,2,45,0.02127659574468085,0.0425531914893617,0.9574468085106383,47,1100,1000,100,0.9090909090909091,12,10,2,316.336571564576,0.4365942028985507,0.0456179752949013,0.1721597864056321,128456.33290468597,-1272.9128106347655,127183.42009405121,1362,0,294.8510638297872,43,4,13,38.55022964346878,0.593265503875969,46.567234848484844,1013.7310606060598,23.57514094432697,8
3102,4,1,0,46,0.021739130434782608,0.0,1.0,46,900,500,400,0.5555555555555556,13,5,8,338.84898898665574,0.43658413848631245,0.10906903418519742,0.18650931746744495,128906.0152635058,-464.06541073252765,128441.94985277328,1363,0,289.9782608695652,42,4,14,37.521469465648856,0.5992063492063492,46.12403100775194,1015.5038759689922,24.178663713547433,0
3103,4,1,1,46,0.02127659574468085,0.02127659574468085,0.9787234042553191,47,1450,800,650,0.5517241379310345,21,8,13,328.8766460628867,0.4380974406413814,0.11440530170910423,0.18237704918032782,129201.38888888876,-901.0600700078211,128300.32881888094,1364,0,284.78723404255317,41,6,15,37.47438524590166,0.6036585365853658,45.83333333333333,1016.6666666666656,24.79674796747965,0
3104,4,0,0,46,0.0,0.0,1.0,46,850,600,250,0.7058823529411765,11,6,5,334.705871188018,0.4370169082125604,0.11184534984437988,0.18549388772496012,129176.76150959972,-552.7559003365241,128624.0056092632,1365,1,291.4347826086956,42,4,15,37.35126139865916,0.6019345238095238,45.85755813953488,1016.56976744186,24.204042081949048,0
3105,4,0,0,46,0.0,0.0,1.0,46,1250,800,450,0.64,17,8,9,332.02867892971597,0.4368256843800322,0.11381074168797989,0.1844783733175348,129277.04480229584,-615.2603723062629,128661.78442998958,1366,2,292.4347826086956,41,5,15,37.31739586381816,0.6044207317073171,45.75892857142857,1016.9642857142851,24.8040069686411,0
3106,4,1,0,47,0.02127659574468085,0.0,1.0,47,1500,1100,400,0.7333333333333333,19,11,8,332.84030490602987,0.43817452975639837,0.1273559411923071,0.18678507447235898,129669.75509472103,-768.135835436557,128901.61925928447,1367,0,287.1914893617021,42,5,12,36.89805124789903,0.6068948412698413,45.37306201550388,1018.5077519379857,24.25018456995204,0
3107,4,0,3,44,0.0,0.06382978723404255,0.9361702127659575,47,1150,600,550,0.5217391304347826,17,6,11,332.4995508630336,0.43825161887141534,0.1306019141026653,0.1871179480798246,129779.6860651976,-769.6625344352467,129010.02353076235,1368,1,288.1914893617021,43,4,12,36.79522924411399,0.6065891472868217,45.26515151515152,1018.9393939393954,23.696264975334774,0
3108,4,0,1,43,0.0,0.022727272727272728,0.9772727272727273,44,1250,1000,250,0.8,15,10,5,345.34010865103073,0.43363504228329813,0.14027962957924078,0.19391282403413335,129692.62390318261,157.6129659924668,129850.23686917507,1369,2,307.3863636363636,40,4,13,36.556544946622786,0.61015625,45.35060975609756,1018.5975609756096,25.46493902439024,0
3109,4,2,1,44,0.044444444444444446,0.022222222222222223,0.9777777777777777,45,1650,1500,150,0.9090909090909091,18,15,3,349.0487240953688,0.43303872053872056,0.16962906697050228,0.19849790292507702,130188.40889970562,88.41960368968807,130276.82850339531,1370,0,301.4,42,3,16,35.95886346372958,0.6121031746031746,44.86434108527132,1020.5426356589154,24.29863418235513,0
3110,4,1,0,45,0.022222222222222223,0.0,1.0,45,1400,900,500,0.6428571428571429,19,9,10,347.66521270716066,0.4323232323232323,0.16571934140394018,0.1991243804481836,130465.21183704966,71.66425112700762,130536.87608817666,1371,0,302.1777777777778,41,4,18,35.713649899656886,0.6163617886178862,44.59325396825397,1021.6269841269843,24.91773132017035,0
3111,4,0,2,43,0.0,0.044444444444444446,0.9555555555555556,45,1050,900,150,0.8571428571428571,12,9,3,349.6721379472678,0.43169191919191924,0.16609617479267103,0.20092984033857766,130591.93244716852,132.87204349330875,130724.80449066183,1372,1,303.1777777777778,41,4,13,35.53404752661039,0.6176321138211383,44.469246031746025,1022.1230158730147,24.92982965543938,0
3112,4,0,1,42,0.0,0.023255813953488372,0.9767441860465116,43,1200,700,500,0.5833333333333334,17,7,10,371.57524589304074,0.42709486895533405,0.18619921873075773,0.19600075261017283,127199.76463766536,884.2745689457649,128084.03920661112,1373,3,317.74418604651163,38,5,15,38.43906658193885,0.5882675438596492,47.80982905982906,1008.7606837606844,26.546333783175907,8
3113,4,2,0,44,0.045454545454545456,0.0,1.0,44,1200,800,400,0.6666666666666666,16,8,8,360.37071242562155,0.43124559548978153,0.197570476342261,0.19169033452502776,127538.80343967033,392.249891493074,127931.0533311634,1374,0,311.40909090909093,39,5,16,38.37365937918944,0.5900106837606838,47.47395833333334,1010.1041666666682,25.900106837606877,0
3114,4,0,1,43,0.0,0.022727272727272728,0.9772727272727273,44,700,400,300,0.5714285714285714,10,4,6,364.2964925885823,0.43124559548978153,0.19715950097948198,0.19403139382848233,127591.4184570314,496.22124565973843,128087.63970269113,1375,1,312.40909090909093,39,5,16,38.22054249578995,0.5905448717948718,47.42187500000001,1010.3125000000011,25.905448717948747,0
3115,4,2,2,43,0.044444444444444446,0.044444444444444446,0.9555555555555556,45,1400,900,500,0.6428571428571429,19,9,10,360.64363423364847,0.43514309764309766,0.21510187390248015,0.19528873933472707,128255.57503270231,254.50020529152704,128510.07523799383,1376,0,303.0444444444444,37,8,19,37.63260445983978,0.6007882882882882,46.76535087719298,1012.9385964912276,27.37671882408723,0
3116,4,3,4,42,0.06521739130434782,0.08695652173913043,0.9130434782608696,46,1000,600,400,0.6,14,6,8,353.3394700247772,0.4390096618357488,0.21285669158681642,0.19341008339050814,128685.96734832741,-106.03369950322005,128579.93364882418,1377,0,295.2391304347826,38,8,15,37.378031659120424,0.6033442982456141,46.34081196581198,1014.6367521367545,26.700967161493537,0
3117,4,2,1,43,0.045454545454545456,0.022727272727272728,0.9772727272727273,44,1050,700,350,0.6666666666666666,14,7,7,359.78563808929505,0.43841393587033123,0.2273193951838719,0.1968714671342548,128672.41753472228,458.8975694444558,129131.31510416673,1378,0,306.9318181818182,37,7,16,37.22835386721426,0.6050112612612613,46.35416666666667,1014.5833333333338,27.421171171171185,0
3118,4,0,0,43,0.0,0.0,1.0,43,1200,1000,200,0.8333333333333334,14,10,4,365.20823014237976,0.4352390180878553,0.2340090462224791,0.19962352773801934,128629.57552146746,795.3159240321438,129424.8914454996,1379,1,315.06976744186045,36,7,16,37.1345840734162,0.6064814814814814,46.3963963963964,1014.4144144144148,28.178178178178186,0
3119,4,1,0,44,0.022727272727272728,0.0,1.0,44,1050,900,150,0.8571428571428571,12,9,3,358.1559422220135,0.43549594785059903,0.23916393474804187,0.1972199962461527,128922.8476550477,434.8967951677439,129357.74445021545,1380,0,308.8863636363636,37,7,17,37.014143813431225,0.607545045045045,46.10745614035088,1015.5701754385965,27.447842579421525,0
3120,4,0,2,42,0.0,0.045454545454545456,0.9545454545454546,44,1850,1600,250,0.8648648648648649,21,16,5,354.7111060654828,0.43552898167723747,0.2309371834808036,0.1964331468630384,129147.08547921674,361.981107093272,129509.06658631001,1381,1,309.8863636363636,38,6,18,36.87307301520566,0.6080043859649122,45.88675213675213,1016.4529914529902,26.748762932973428,0
3121,4,0,0,42,0.0,0.0,1.0,42,1050,700,350,0.6666666666666666,14,7,7,369.4627853353719,0.43088221060782034,0.22988068841727372,0.20370136453087148,128972.5113627142,1130.108655953267,130102.62001866747,1382,2,325.3095238095238,36,6,18,36.676367331855154,0.6099537037037037,46.058558558558566,1015.7657657657668,28.215715715715746,0
3122,4,0,0,42,0.0,0.0,1.0,42,1450,1100,350,0.7586206896551724,18,11,7,372.0855853849887,0.4294667053813395,0.2383854051259322,0.20603953948987186,129144.15048494455,1210.5353664475442,130354.68585139209,1383,3,326.3095238095238,36,6,18,36.434559420932125,0.6116898148148149,45.88963963963965,1016.4414414414426,28.23448448448452,0
3123,4,0,0,42,0.0,0.0,1.0,42,1550,1100,450,0.7096774193548387,20,11,9,373.1015666872254,0.4289827719705768,0.24497691657454967,0.20752003595236312,129319.0854338135,1249.8433571835171,130568.92879099702,1384,4,327.3095238095238,35,7,19,36.23027613412229,0.6154761904761905,45.717592592592595,1017.1296296296301,29.060846560846574,0
3124,4,0,0,42,0.0,0.0,1.0,42,1600,1000,600,0.625,22,10,12,372.97278537080143,0.42865611691831207,0.24807498619188384,0.20838136432978593,129495.73072059342,1259.6766760974072,130755.40739669083,1385,5,328.3095238095238,35,7,18,36.05346448335986,0.6172619047619048,45.54398148148149,1017.8240740740753,29.080687830687864,0
3125,4,1,1,42,0.023255813953488372,0.023255813953488372,0.9767441860465116,43,1400,1100,300,0.7857142857142857,17,11,6,368.81569422918847,0.42997877445551863,0.25869652344592975,0.20813713616973922,129889.23890106338,981.037963639332,130870.27686470271,1386,0,321.6511627906977,36,7,19,35.758672116659305,0.619212962962963,45.157657657657666,1019.3693693693706,28.31581581581585,0
3126,4,0,1,41,0.0,0.023809523809523808,0.9761904761904762,42,1650,1100,550,0.6666666666666666,22,11,11,366.09776237201,0.42996273712737126,0.14086534267686313,0.21235399132629107,130954.69292534729,1188.444010416671,132143.13693576396,1387,1,327.26190476190476,39,3,14,34.74667548680372,0.624465811965812,44.114583333333336,1023.5416666666672,26.244658119658133,8
3127,4,0,0,41,0.0,0.0,1.0,41,1300,1000,300,0.7692307692307693,16,10,6,371.1752388510622,0.42660060975609754,0.16206380552954114,0.2158582214289187,131054.49631090659,1528.8367941412812,132583.33310504787,1388,2,335.9756097560976,38,3,15,34.5156423900946,0.6271929824561404,44.01709401709402,1023.9316239316241,26.945569050832216,0
3128,4,0,0,41,0.0,0.0,1.0,41,1000,800,200,0.8,12,8,4,372.8048933605363,0.4250762195121951,0.16531052299680615,0.21804539860452812,131273.37643363266,1587.8714204835806,132861.24785411623,1389,3,336.9756097560976,38,3,15,34.25228489018627,0.6293859649122807,43.80341880341879,1024.7863247863233,26.968061178587458,0
3129,4,1,1,41,0.023809523809523808,0.023809523809523808,0.9761904761904762,42,850,700,150,0.8235294117647058,10,7,3,362.74883249250195,0.4272164150212931,0.16052275330625898,0.21384143882292764,131574.63480029564,1145.7204461611282,132720.35524645678,1390,0,329.92857142857144,38,4,14,34.20545662813704,0.6324013157894737,43.50961538461537,1025.9615384615365,26.99898785425096,0
3130,4,0,0,41,0.0,0.0,1.0,41,900,500,400,0.5555555555555556,13,5,8,368.9068588115325,0.4234756097560976,0.16306054016281046,0.21702860108950117,131496.7646295011,1502.0116766697142,132998.7763061708,1391,5,338.9756097560976,37,4,15,34.12622051172405,0.6334459459459459,43.58552631578946,1025.6578947368398,27.720483641536212,0
3131,4,0,0,41,0.0,0.0,1.0,41,1350,800,550,0.5925925925925926,19,8,11,373.5906623400345,0.4234502032520325,0.16420400629829324,0.22010794942401463,131553.00188519506,1629.3946214219345,133182.396506617,1392,6,339.9756097560976,37,4,15,33.94924825423969,0.634009009009009,43.530701754385944,1025.8771929824532,27.726410621147384,0
3132,4,0,0,41,0.0,0.0,1.0,41,1450,1100,350,0.7586206896551724,18,11,7,371.47485706874056,0.42278963414634146,0.16631441236946887,0.21934594241680347,131637.3803117302,1579.9954072406545,133217.37571897084,1393,7,340.9756097560976,37,4,14,33.918220429533065,0.6348536036036037,43.448464912280684,1026.2061403508744,27.735301090564175,0
3133,4,0,1,40,0.0,0.024390243902439025,0.975609756097561,41,1250,800,450,0.64,17,8,9,373.04092945670334,0.42225609756097565,0.1703098389087676,0.22141326649502396,131834.3685076175,1635.9230724838194,133470.29158010133,1394,8,341.9756097560976,37,4,14,33.67899850523169,0.6368243243243243,43.25657894736841,1026.9736842105247,27.75604551920337,0
3134,4,2,0,42,0.047619047619047616,0.0,1.0,42,1000,700,300,0.7,13,7,6,363.4021424772998,0.42253435927216415,0.1875130490644823,0.2194475259562513,132487.35592689045,1232.8446780366185,133720.20060492706,1395,0,333.85714285714283,35,7,17,33.2683389544688,0.6473214285714286,42.62152777777778,1029.513888888889,29.41468253968254,0
3135,4,0,0,42,0.0,0.0,1.0,42,1500,1000,500,0.6666666666666666,20,10,10,360.1119321447989,0.4224375725900116,0.1877450597516206,0.21794994172496285,132571.90626014545,1148.14506229204,133720.0513224375,1396,1,334.85714285714283,36,6,17,33.26795152177874,0.6461226851851851,42.53941441441442,1029.8423423423437,28.60673173173177,0
3136,4,0,0,42,0.0,0.0,1.0,42,1600,1100,500,0.6875,21,11,10,362.0747549333803,0.4216632791327913,0.18684661057079377,0.22015588587344642,132745.92318247329,1212.7895209398912,133958.71270341318,1397,2,335.85714285714283,36,6,15,33.04238152478783,0.6478587962962963,42.37049549549551,1030.5180180180203,28.625500500500564,0
3137,4,0,0,42,0.0,0.0,1.0,42,750,400,350,0.5333333333333333,11,4,7,391.65517282876806,0.42142131242741,0.20801697620994464,0.22073468957123638,129837.58680555546,1920.6465333576741,131758.23333891312,1398,3,336.85714285714283,34,8,14,35.229285908967015,0.6228553921568627,45.20833333333333,1019.1666666666658,29.975490196078407,8
3138,4,0,0,42,0.0,0.0,1.0,42,1200,1000,200,0.8333333333333334,14,10,4,391.58193679111645,0.4212035423925668,0.20993194101554669,0.22120763236669655,129928.59977324257,1775.5385487528233,131704.1383219954,1399,4,337.85714285714283,34,8,14,35.13836992059784,0.6237745098039216,45.11904761904761,1019.5238095238091,29.98599439775909,0
3139,4,1,0,43,0.023255813953488372,0.0,1.0,43,1400,700,700,0.5,21,7,14,385.93976358048,0.4236803248431156,0.20785558995981313,0.22073353296161577,130410.31867551846,1466.1055116169116,131876.42418713536,1400,0,330.9767441860465,35,8,15,34.791902738432476,0.6264880952380952,44.646990740740726,1021.4120370370351,29.183201058201004,0
3140,4,0,1,42,0.0,0.023255813953488372,0.9767441860465116,43,1300,1100,200,0.8461538461538461,15,11,4,384.44962903541875,0.4235418973791067,0.20686003040354528,0.22021653961684853,130469.4348663621,1431.7851669667132,131901.2200333288,1401,1,331.9767441860465,35,8,16,34.76985857784827,0.6270833333333333,44.58912037037036,1021.6435185185169,29.189814814814767,0
3141,4,1,1,42,0.023255813953488372,0.023255813953488372,0.9767441860465116,43,1800,1400,400,0.7777777777777778,22,14,8,390.73660757742215,0.42421096345514947,0.21735605925021373,0.2253621843703719,130735.62349965687,1616.63880315499,132352.26230281187,1402,0,332.8139534883721,35,8,14,34.33869020673005,0.6297619047619047,44.328703703703695,1022.6851851851836,29.219576719576676,0
3142,4,1,1,42,0.023255813953488372,0.023255813953488372,0.9767441860465116,43,1300,900,400,0.6923076923076923,17,9,8,388.4168901610931,0.4219961240310077,0.21964577636148563,0.21373314437206645,128895.0100631924,1424.8417856610024,130319.8518488534,1403,0,333.74418604651163,37,6,16,36.274317928229486,0.6072635135135135,46.13486842105262,1015.4605263157885,27.444879089615903,8
3143,4,0,0,42,0.0,0.0,1.0,42,1200,900,300,0.75,15,9,6,398.16169693835076,0.4199332171893147,0.22097149828102425,0.21904966572868295,128886.7346020008,1863.552192395114,130750.28679439591,1404,1,342.6666666666667,36,6,16,36.03540534545858,0.6090856481481481,46.143018018018026,1015.4279279279292,28.206331331331366,0
3144,4,1,1,42,0.023255813953488372,0.023255813953488372,0.9767441860465116,43,1650,1200,450,0.7272727272727273,21,12,9,392.00104359223076,0.4210271317829457,0.22003891844816104,0.21821817052088666,129352.72285997722,1542.4313257686676,130895.1541857459,1405,0,335.6744186046512,34,9,19,35.71533060269162,0.617953431372549,45.6845238095238,1017.2619047619039,29.919467787114822,0
3145,4,1,0,43,0.023255813953488372,0.0,1.0,43,1450,900,550,0.6206896551724138,20,9,11,387.787545398454,0.42308047249907715,0.22268610630918584,0.21771064556621855,129685.96938775507,1458.1207482993134,131144.09013605438,1406,0,334.3953488372093,34,9,16,35.482410004675074,0.6213235294117647,45.357142857142854,1018.5714285714283,29.957983193277304,0
3146,4,0,0,43,0.0,0.0,1.0,43,1050,800,250,0.7619047619047619,13,8,5,388.71532066708306,0.42287283130306386,0.2259703058287652,0.21840032823034988,129716.28578514734,1484.5415249433038,131200.82731009065,1407,1,335.3953488372093,34,9,16,35.427866074558835,0.6216299019607843,45.32738095238095,1018.6904761904758,29.961484593837525,0
3147,4,0,0,43,0.0,0.0,1.0,43,1100,600,500,0.5454545454545454,16,6,10,386.86119798738366,0.42273440383905503,0.22740104935101635,0.21769526584970514,129776.92920918361,1441.1316609977243,131218.06087018133,1408,2,336.3953488372093,34,9,16,35.41325894769639,0.6222426470588236,45.26785714285714,1018.9285714285709,29.968487394957968,0
3148,4,0,1,42,0.0,0.023255813953488372,0.9767441860465116,43,850,600,250,0.7058823529411765,11,6,5,387.4246659096865,0.4224114064230344,0.22668985003260134,0.21818125922282325,129807.2562358275,1458.1065759636954,131265.3628117912,1409,3,337.3953488372093,34,9,16,35.36799065420559,0.6225490196078431,45.23809523809523,1019.0476190476178,29.971988795518172,0
3149,4,0,1,41,0.0,0.023809523809523808,0.9761904761904762,42,1100,800,300,0.7272727272727273,14,8,6,391.77138833085866,0.42114305071622143,0.23503560302625748,0.2206291502705361,129807.25623582759,1770.953798185932,131578.21003401352,1410,4,345.6904761904762,34,8,16,35.2572527258567,0.6225490196078431,45.238095238095234,1019.0476190476185,29.97198879551819,0
3150,4,0,0,41,0.0,0.0,1.0,41,1200,700,500,0.5833333333333334,17,7,10,401.5862377445335,0.4202743902439024,0.23096546425911502,0.226621053294371,129887.5507617262,2232.210568050744,132119.76132977696,1411,5,350.7560975609756,33,8,17,34.92526248296866,0.6256313131313131,45.15931372549019,1019.3627450980388,30.889780154486022,0
3151,4,1,0,42,0.023809523809523808,0.0,1.0,42,800,400,400,0.5,12,4,8,393.33462055007385,0.42142131242741,0.2428079862361463,0.22428957726233162,130293.86421388404,1850.3581855536258,132144.22239943765,1412,0,343.3809523809524,33,9,18,34.7215970471732,0.6297348484848485,44.7610294117647,1020.9558823529408,30.938057040998206,0
3152,4,0,1,41,0.0,0.023809523809523808,0.9761904761904762,42,1450,1100,350,0.7586206896551724,18,11,7,395.2668667716083,0.42127613240418116,0.24810015198784097,0.2259364929817961,130387.71896626313,1907.5890282583812,132295.3079945215,1413,1,344.3809523809524,33,9,19,34.5767338612911,0.6306818181818181,44.66911764705883,1021.323529411766,30.949197860962606,0
3153,4,0,0,41,0.0,0.0,1.0,41,1450,1100,350,0.7586206896551724,18,11,7,402.5742375127828,0.41824186991869916,0.25205662731201084,0.2310947431509551,130552.75769054191,2311.4353764922093,132864.19306703412,1414,2,352.5365853658537,32,9,17,34.222108969607106,0.634765625,44.507575757575765,1021.9696969696979,31.93655303030306,0
3154,4,0,0,41,0.0,0.0,1.0,41,1200,1000,200,0.8333333333333334,14,10,4,402.8283681400627,0.41796239837398375,0.2538830566299186,0.2319390666247443,130669.48596993953,2327.475159794319,132996.96112973386,1415,3,353.5365853658537,33,8,17,34.0968226856846,0.6335227272727273,44.39338235294118,1022.426470588236,30.982620320855638,0
3155,4,0,0,41,0.0,0.0,1.0,41,1100,900,200,0.8181818181818182,13,9,4,400.55715886315164,0.4175558943089431,0.25381051893203166,0.23100549348396707,130732.14215986655,2273.1390871299714,133005.2812469965,1416,4,354.5365853658537,33,8,18,34.09114739364889,0.6341540404040404,44.332107843137265,1022.6715686274522,30.990047534165218,0
3156,4,0,1,40,0.0,0.024390243902439025,0.975609756097561,41,950,800,150,0.8421052631578947,11,8,3,398.69195740256015,0.4173272357723577,0.25412589455235834,0.23086531513948522,130888.84833958093,2236.8662293348716,133125.7145689158,1417,5,355.5365853658537,33,8,18,33.979540918163664,0.6357323232323233,44.17892156862745,1023.2843137254903,31.0086155674391,0
3157,4,0,1,39,0.0,0.025,0.975,40,950,700,250,0.7368421052631579,12,7,5,399.8143024322866,0.41669337606837603,0.24524907196742918,0.23170362523331173,130920.20083922037,2468.753754565537,133388.95459378592,1418,6,353.625,33,7,18,33.91896679040435,0.6360479797979798,44.14828431372548,1023.406862745097,31.01232917409385,0
3158,4,0,0,39,0.0,0.0,1.0,39,1150,700,450,0.6086956521739131,16,7,9,399.1424704606649,0.41613247863247865,0.24910529578951923,0.23188012505065328,131014.28086553243,2658.6727460592037,133672.95361159163,1419,7,360.38461538461536,33,6,18,33.84057537307477,0.6369949494949495,44.056372549019606,1023.7745098039212,31.023469994058217,0
3159,4,0,0,39,0.0,0.0,1.0,39,700,500,200,0.7142857142857143,9,5,4,399.5610694062583,0.4160481331533963,0.24858444966164872,0.23231264682597685,131045.64838343422,2672.147881824293,133717.7962652585,1420,8,361.38461538461536,33,6,18,33.79800019948134,0.6373106060606061,44.025735294117645,1023.8970588235292,31.027183600713006,0
3160,4,0,0,39,0.0,0.0,1.0,39,1100,700,400,0.6363636363636364,15,7,8,399.01002874340156,0.41551394511920825,0.24477583473399367,0.23259365090164152,131145.15306122453,2665.6462585034055,133810.79931972793,1421,9,362.38461538461536,34,5,18,33.71106462110645,0.6360294117647058,43.92857142857143,1024.2857142857147,30.126050420168077,0
3161,4,0,0,39,0.0,0.0,1.0,39,750,200,550,0.26666666666666666,13,2,11,356.58885305333206,0.4150922177237966,0.13250532065111398,0.20118373022682223,129878.87577428414,1462.7994206620426,131341.67519494618,1422,10,363.38461538461536,35,4,17,36.08079274062298,0.6211309523809524,45.167824074074076,1019.3287037037038,29.12367724867725,8
3162,4,0,0,39,0.0,0.0,1.0,39,950,700,250,0.7368421052631579,12,7,5,353.9393661164329,0.4146986054880792,0.13619339462036084,0.20029285516068646,129996.88042534715,1402.2026909722108,131399.08311631935,1423,11,364.38461538461536,35,4,19,36.028472931562824,0.6223214285714286,45.05208333333333,1019.791666666666,29.13690476190474,0
3163,4,0,1,38,0.0,0.02564102564102564,0.9743589743589743,39,850,700,150,0.8235294117647058,10,7,3,350.2854765693629,0.4146986054880792,0.12866937287339142,0.19855355736954267,130061.48674011863,1311.7299732164734,131373.2167133351,1424,12,365.38461538461536,36,3,19,36.05606462059322,0.6209490740740741,44.988738738738746,1020.0450450450461,28.334584584584615,0
3164,4,0,0,38,0.0,0.0,1.0,38,1600,1200,400,0.75,20,12,8,330.62948926575734,0.41268077287814126,0.12272174278859826,0.1815520647462859,128811.51532202207,917.7771044936806,129729.29242651575,1425,13,372.2105263157895,37,1,16,37.82629437603514,0.6064189189189189,46.21710526315789,1015.1315789473676,27.435988620199126,8
3165,4,0,0,38,0.0,0.0,1.0,38,1100,800,300,0.7272727272727273,14,8,6,330.1626524534088,0.41220661450924606,0.12747571877539632,0.1816777376334531,128895.0100631924,911.263682094473,129806.27374528688,1426,14,373.2105263157895,37,1,18,37.75318990029873,0.6072635135135135,46.13486842105262,1015.4605263157885,27.444879089615903,0
3166,4,0,0,38,0.0,0.0,1.0,38,1300,900,400,0.6923076923076923,17,9,8,332.30811481981897,0.41097676623992413,0.12704820303185183,0.1840200850883942,129145.65659626023,983.2299361341811,130128.88653239442,1427,15,374.2105263157895,37,1,19,37.44381517439771,0.6097972972972974,45.888157894736835,1016.4473684210514,27.471550497866254,0
3167,4,1,0,39,0.02564102564102564,0.0,1.0,39,1000,700,300,0.7,13,7,6,324.3359114338084,0.4143612235717499,0.12799513240504434,0.1808533501461115,129418.71667031899,595.0274855723276,130013.74415589131,1428,0,365.5897435897436,38,1,21,37.36919011619764,0.6107456140350878,45.619658119658105,1017.5213675213655,26.776878092667513,0
3168,4,0,1,38,0.0,0.02564102564102564,0.9743589743589743,39,1050,600,450,0.5714285714285714,15,6,9,324.1254003567881,0.41377080521817367,0.12684058532699272,0.18111100816417097,129500.26167223658,594.8648321644833,130095.12650440107,1429,1,366.5897435897436,38,1,15,37.29181974038696,0.6115679824561404,45.5395299145299,1017.8418803418783,26.785312640575746,0
3169,4,1,0,39,0.02564102564102564,0.0,1.0,39,1000,700,300,0.7,13,7,6,325.81043820144606,0.41427687809266756,0.14257626006288593,0.18281053015740925,129663.428722423,649.1397061509133,130312.56842857393,1430,0,367.53846153846155,38,1,17,37.08346445679919,0.6132127192982456,45.3792735042735,1018.4829059829051,26.80218173639224,0
3170,4,0,0,39,0.0,0.0,1.0,39,1200,900,300,0.75,15,9,6,329.32043827380267,0.4140800719748088,0.14413804225125015,0.1856806726437397,129853.92011834319,752.7099769888252,130606.63009533202,1431,1,368.53846153846155,38,1,18,36.80096960167715,0.6151315789473684,45.19230769230769,1019.2307692307692,26.821862348178136,0
3171,4,0,0,39,0.0,0.0,1.0,39,800,600,200,0.75,10,6,4,327.63845657593924,0.41371457489878544,0.13805218456381274,0.1855063289723555,130017.30974687697,719.7341387245151,130737.04388560148,1432,2,369.53846153846155,38,1,18,36.67832076262309,0.6167763157894737,45.03205128205128,1019.8717948717941,26.838731443994583,0
3172,4,0,0,39,0.0,0.0,1.0,39,1700,1300,400,0.7647058823529411,21,13,8,330.9023327211422,0.4136302294197031,0.14391193448785033,0.18787855395284858,130126.29323727098,811.8187961136854,130938.11203338466,1433,3,370.53846153846155,38,1,18,36.484729493891784,0.6178728070175439,44.92521367521368,1020.2991452991467,26.849977507872282,0
3173,4,1,0,40,0.025,0.0,1.0,40,750,200,550,0.26666666666666666,13,2,11,324.87978852604266,0.41461004273504276,0.14171933938220027,0.1862504877645795,130501.95448133699,479.4894748264128,130981.4439561634,1434,0,362.25,39,1,16,36.25847436028138,0.6199252136752137,44.55729166666668,1021.7708333333348,26.199252136752175,0
3174,4,0,1,39,0.0,0.025,0.975,40,1350,1200,150,0.8888888888888888,15,12,3,339.62546753779606,0.4152644230769231,0.12306132125171221,0.18514562391735906,128523.41666894949,732.5719744896642,129255.98864343915,1435,1,363.25,38,2,12,37.89159905875742,0.6016995614035088,46.501068376068375,1013.9957264957262,26.684098065677006,8
3175,4,0,1,38,0.0,0.02564102564102564,0.9743589743589743,39,800,600,200,0.75,10,6,4,341.33135764832855,0.4139394961763383,0.14287338062881294,0.18625213727961018,128561.1934080679,976.3933373730383,129537.58674544095,1436,2,372.79487179487177,37,2,13,37.809830792518106,0.6038851351351351,46.463815789473685,1014.1447368421057,27.409317211948803,0
3176,4,1,0,39,0.02564102564102564,0.0,1.0,39,1300,900,400,0.6923076923076923,17,9,8,349.30050520364426,0.4153452541610436,0.1732624466965722,0.19207379324143392,128867.17547706992,1202.6738996614436,130069.84937673136,1437,0,373.71794871794873,37,2,14,37.29571634269259,0.6069819819819819,46.16228070175439,1015.3508771929828,27.441915599810347,0
3177,4,2,1,40,0.04878048780487805,0.024390243902439025,0.975609756097561,41,900,500,400,0.5555555555555556,13,5,8,335.52070122636707,0.4196900406504065,0.17914681508523866,0.18747834138320274,129500.26167223715,490.43654653819436,129990.69821877535,1438,0,356.4390243902439,38,3,16,37.0018543787831,0.6115679824561404,45.53952991452993,1017.8418803418829,26.785312640575864,0
3178,4,1,1,40,0.024390243902439025,0.024390243902439025,0.975609756097561,41,1400,1000,400,0.7142857142857143,18,10,8,336.5299747663931,0.41880081300813005,0.130527416910877,0.18623674519794636,129119.93805473374,490.54589907955665,129610.4839538133,1439,0,357.219512195122,38,3,16,37.362687900767384,0.6077302631578947,45.91346153846154,1016.3461538461539,26.74595141700405,8
3179,4,2,2,40,0.047619047619047616,0.047619047619047616,0.9523809523809523,42,750,400,350,0.5333333333333333,11,4,7,331.4619042480636,0.4224375725900116,0.1405419895696256,0.18505044597163336,129466.28146701398,182.62803819445423,129648.90950520843,1440,0,349.64285714285717,39,3,13,37.13962811327193,0.6095085470085471,45.57291666666667,1017.708333333334,26.09508547008549,0
3180,4,0,0,40,0.0,0.0,1.0,40,950,700,250,0.7368421052631579,12,7,5,344.0957909237082,0.4165064102564102,0.14392868702125394,0.19041336633264794,129117.79495854504,885.7779557171566,130003.5729142622,1441,2,368.125,37,3,16,37.17263189125041,0.6095157657657657,45.9155701754386,1016.3377192982465,27.468587008060716,0
3181,4,1,1,40,0.024390243902439025,0.024390243902439025,0.975609756097561,41,800,500,300,0.625,11,5,6,341.43963277811326,0.419385162601626,0.13859210620665663,0.19039057743435284,129418.7166703191,637.7358189056756,130056.45248922477,1442,0,360.1219512195122,38,3,18,36.934105067898635,0.6107456140350878,45.61965811965811,1017.5213675213664,26.776878092667538,0
3182,4,0,0,40,0.0,0.0,1.0,40,650,300,350,0.46153846153846156,10,3,7,348.1740469772816,0.41923076923076924,0.13474663072776272,0.193487973979286,129285.0098708255,1002.7370200446112,130287.74689087011,1443,1,354.9,37,3,18,36.89880952380952,0.611204954954955,45.75109649122806,1016.9956140350865,27.48636794689423,0
3183,4,0,0,40,0.0,0.0,1.0,40,1150,800,350,0.6956521739130435,15,8,7,345.78612055741206,0.4195779914529914,0.12841631641340667,0.192705670429563,129396.54659366336,948.7059720298457,130345.2525656932,1444,2,355.9,37,3,18,36.84608165391385,0.6123310810810811,45.64144736842105,1017.4342105263152,27.498221906116626,0
3184,4,0,0,40,0.0,0.0,1.0,40,1450,1100,350,0.7586206896551724,18,11,7,344.62020461952613,0.41973824786324787,0.1276278944534195,0.19287514164510539,129563.94184989601,930.0704303247039,130494.01228022072,1445,3,356.9,37,3,14,36.705595943277686,0.6140202702702703,45.47697368421052,1018.092105263157,27.51600284495019,0
3185,4,1,1,40,0.024390243902439025,0.024390243902439025,0.975609756097561,41,1050,400,650,0.38095238095238093,17,4,13,335.4916055959584,0.4232215447154472,0.06754464520887149,0.18448053846903656,128867.17547706993,509.9726598568877,129377.14813692681,1446,0,349.1707317073171,37,4,15,37.64623830093593,0.6069819819819819,46.16228070175439,1015.3508771929829,27.44191559981035,8
3186,4,1,0,41,0.024390243902439025,0.0,1.0,41,1450,1200,250,0.8275862068965517,17,12,5,335.2593388873957,0.4207825203252033,0.08616553378648484,0.18591654247391953,129201.38888888895,463.1944444444496,129664.5833333334,1447,0,350.0487804878049,37,4,17,37.31215846994535,0.6103603603603603,45.833333333333336,1016.6666666666672,27.477477477477493,0
3187,4,0,0,41,0.0,0.0,1.0,41,1250,700,550,0.56,18,7,11,376.17582420545733,0.4205284552845528,0.12833927817827573,0.19331130357159867,126133.51048752839,1480.6476757369646,127614.15816326535,1448,1,351.0487804878049,34,7,16,39.42210831950698,0.585171568627451,48.86904761904762,1004.5238095238099,29.54481792717088,8
3188,4,2,1,42,0.046511627906976744,0.023255813953488372,0.9767441860465116,43,600,400,200,0.6666666666666666,8,4,4,360.37273314964,0.424718530823182,0.13790663861021746,0.18787711994699294,126723.24087178383,533.5201333089722,127256.7610050928,1449,0,335.6744186046512,36,7,14,39.21145099355031,0.5870949074074074,48.28265765765765,1006.8693693693683,27.968593593593564,0
3189,4,2,1,43,0.045454545454545456,0.022727272727272728,0.9772727272727273,44,2000,1700,300,0.85,23,17,6,345.77115720901264,0.42873502466525726,0.1513644061273185,0.18311916442324855,127361.47636788675,7.58501351451045,127369.06138140126,1450,0,328.15909090909093,38,6,13,38.92402272085802,0.5899122807017544,47.649572649572654,1009.4017094017104,26.563202878992378,0
3190,4,0,0,43,0.0,0.0,1.0,43,650,400,250,0.6153846153846154,9,4,5,351.055762567515,0.42589516426725726,0.14876442431625114,0.1854428890439881,127257.91229032003,334.9246883656441,127592.83697868568,1451,1,336.7906976744186,37,6,17,38.896888357603416,0.5906531531531531,47.75219298245614,1008.9912280701749,27.27003319108581,0
3191,4,0,0,43,0.0,0.0,1.0,43,700,500,200,0.7142857142857143,9,5,4,351.4360715443778,0.4260566629752676,0.15039854477470516,0.1860246715679123,127340.90206842477,350.4372739688981,127691.33934239366,1452,2,337.7906976744186,37,6,13,38.8021682056853,0.5914977477477478,47.66995614035087,1009.3201754385955,27.27892366050258,0
3192,4,2,0,45,0.044444444444444446,0.0,1.0,45,1200,900,300,0.75,15,9,6,341.0512716821051,0.4301557239057239,0.16829580816401224,0.18320187779737862,127933.68055555562,-273.61111111110694,127660.06944444451,1453,0,323.73333333333335,39,6,16,38.45757825370675,0.594017094017094,47.083333333333336,1011.6666666666672,25.940170940170955,0
3193,4,1,1,45,0.021739130434782608,0.021739130434782608,0.9782608695652174,46,1350,1000,350,0.7407407407407407,17,10,7,335.26646370768776,0.4317028985507247,0.1807321369399537,0.18209570675888118,128376.15258774516,-591.9562595016444,127784.19632824352,1454,0,317.67391304347825,40,6,14,38.15224294691803,0.596875,46.64634146341462,1013.4146341463396,25.33536585365849,0
3194,4,0,0,45,0.0,0.0,1.0,45,1450,1200,250,0.8275862068965517,17,12,5,336.09258066684373,0.43223905723905726,0.17316318122090846,0.18325310217998714,128530.68300118962,-360.35821105163996,128170.32479013798,1455,1,304.84444444444443,40,5,14,37.97375058461948,0.5984375,46.49390243902438,1014.0243902439013,25.350609756097533,0
3195,4,0,0,45,0.0,0.0,1.0,45,1000,700,300,0.7,13,7,6,336.3909713196085,0.4316498316498316,0.17739037504592114,0.18377221044012082,128607.98306439596,-347.48713150243435,128260.49593289352,1456,2,305.84444444444443,40,5,14,37.8874027318572,0.59921875,46.41768292682926,1014.329268292681,25.358231707317024,0
3196,4,0,1,44,0.0,0.022222222222222223,0.9777777777777777,45,900,400,500,0.4444444444444444,14,4,10,341.3349981765697,0.4314183501683502,0.17978988603988588,0.18683599900191186,128685.30636525882,-215.04023729261326,128470.2661279662,1457,3,306.84444444444443,40,5,14,37.68320980235043,0.6,46.34146341463415,1014.6341463414637,25.365853658536594,0
3197,4,1,1,44,0.022222222222222223,0.022222222222222223,0.9777777777777777,45,1250,800,450,0.64,17,8,9,340.29590895447694,0.430976430976431,0.18610893927547578,0.18679762555913113,128798.26467624068,-234.09549004789045,128564.16918619278,1458,0,307.4,41,4,15,37.594474850143335,0.5995934959349594,46.23015873015872,1015.0793650793636,24.758033294618624,0
3198,4,2,0,46,0.043478260869565216,0.0,1.0,46,1400,800,600,0.5714285714285714,20,8,12,331.7479724762822,0.4332729468599034,0.20720227949220282,0.1846766400527576,129352.72285997719,-616.8694098009702,128735.85345017622,1459,0,300.30434782608694,41,5,18,37.24765944997074,0.6051829268292683,45.6845238095238,1017.2619047619037,24.81126596980253,0
3199,4,0,1,45,0.0,0.021739130434782608,0.9782608695652174,46,900,500,400,0.5555555555555556,13,5,8,333.07067733339204,0.4328401771336554,0.20460470262090413,0.18576976277371382,129428.42306193289,-578.2374929138537,128850.18556901903,1460,1,301.30434782608694,41,5,16,37.13713805206201,0.6059451219512195,45.61011904761904,1017.559523809522,24.818524970963953,0
3200,4,0,0,45,0.0,0.0,1.0,45,1300,1000,300,0.7692307692307693,16,10,6,341.11002565470096,0.43013468013468015,0.19837257579289824,0.1897815590204502,129330.57089240855,-176.8091289906866,129153.76176341786,1461,2,308.75555555555553,40,5,18,37.03208778765777,0.6065104166666666,45.70630081300813,1017.1747967479669,25.429369918699173,0
3201,4,1,1,45,0.021739130434782608,0.021739130434782608,0.9782608695652174,46,1350,1000,350,0.7407407407407407,17,10,7,337.9418877991335,0.4322966988727858,0.20010713937859181,0.18970198808276098,129680.91699932265,-435.07721954524806,129245.83977977741,1462,0,303.0217391304348,41,5,17,36.756822018765604,0.6084857723577235,45.36210317460316,1018.5515873015855,24.842721641502084,0
3202,4,0,0,45,0.0,0.0,1.0,45,1300,700,600,0.5384615384615384,19,7,12,341.36334906550235,0.43099747474747474,0.19767622341958835,0.1915533865808772,129666.74619109005,-147.3050515566009,129519.44113953345,1463,1,310.68888888888887,40,5,18,36.684086675979515,0.6098958333333333,45.37601626016261,1018.4959349593503,25.462398373983756,0
3203,4,0,1,44,0.0,0.022222222222222223,0.9777777777777777,45,1650,1300,350,0.7878787878787878,20,13,7,335.23173662864883,0.4309343434343434,0.19242419206523342,0.18898477159351998,129847.94439693642,-294.16962043095054,129553.77477650547,1464,2,311.68888888888887,40,5,18,36.656404759530695,0.61171875,45.19817073170732,1019.2073170731712,25.48018292682928,0
3204,4,1,0,45,0.022222222222222223,0.0,1.0,45,1800,1600,200,0.8888888888888888,20,16,4,330.6015802322558,0.43255471380471383,0.1964734863217945,0.18763281739009485,130110.72137188207,-397.03798185941037,129713.68339002266,1465,0,311.3777777777778,41,4,19,36.508168028004654,0.6128048780487805,44.94047619047619,1020.2380952380952,24.883855981416957,0
3205,4,0,1,44,0.0,0.022222222222222223,0.9777777777777777,45,1050,700,350,0.6666666666666666,14,7,7,330.563500943396,0.43152356902356903,0.18903155170697672,0.18859576910722908,130314.46358194546,-384.4703618607691,129929.99322008468,1466,1,312.3777777777778,40,5,19,36.3029179522909,0.61640625,44.740853658536594,1021.0365853658551,25.52591463414638,0
3206,4,1,0,45,0.022222222222222223,0.0,1.0,45,1000,600,400,0.6,14,6,8,329.0604041393648,0.43171296296296297,0.18652435251480548,0.18887165662245758,130548.03688280811,-408.36204474847443,130139.67483805964,1467,0,312.97777777777776,40,5,14,36.105103089366196,0.61875,44.51219512195123,1021.9512195121972,25.54878048780493,0
3207,4,1,0,46,0.021739130434782608,0.0,1.0,46,1600,1100,500,0.6875,21,11,10,323.54519669325407,0.4346417069243156,0.18714454951327797,0.18714086446985578,130845.55820302655,-733.1096269526332,130112.44857607392,1468,0,307.1521739130435,41,5,16,35.94563091890495,0.6201727642276422,44.22123015873016,1023.115079365079,24.954026325977537,0
3208,4,1,1,46,0.02127659574468085,0.02127659574468085,0.9787234042553191,47,1700,1200,500,0.7058823529411765,22,12,10,322.3712451706686,0.43545713845205053,0.19897057817448638,0.18832892521738392,131228.8220734932,-939.1202451775738,130289.70182831564,1469,0,301.59574468085106,42,5,17,35.589259819683505,0.6225198412698413,43.8468992248062,1024.6124031007753,24.395533407161317,0
3209,4,1,0,47,0.02127659574468085,0.0,1.0,47,1150,900,250,0.782608695652174,14,9,5,323.3031612252249,0.43472479185938945,0.20173547849180085,0.18974095237153316,131404.4009530895,-903.2707967527738,130501.13015633673,1470,0,302.48936170212767,41,6,18,35.38854620222545,0.6257621951219512,43.675595238095234,1025.2976190476186,25.00725900116143,0
3210,4,0,2,45,0.0,0.0425531914893617,0.9574468085106383,47,1250,1000,250,0.8,15,10,5,326.17955886901666,0.43433934628430465,0.20389470585934855,0.1916838032989779,131455.2638908571,-824.3960026140235,130630.86788824308,1471,1,303.48936170212767,41,6,18,35.26359598207088,0.626270325203252,43.625992063492056,1025.4960317460304,25.012098335269034,0
3211,4,0,0,45,0.0,0.0,1.0,45,1300,1000,300,0.7692307692307693,16,10,6,337.4314230947188,0.4307449494949495,0.20704607046070467,0.1976384049554781,131328.12499999997,-137.15277777777783,131190.9722222222,1472,2,317.4888888888889,39,6,19,35.10331978319784,0.6282051282051282,43.75,1024.9999999999998,26.282051282051277,0
3212,4,0,0,45,0.0,0.0,1.0,45,1550,1400,150,0.9032258064516129,17,14,3,339.84641283496177,0.4303872053872054,0.21438758010650827,0.20016791110040072,131541.7534722221,-59.2013888888946,131482.5520833332,1473,3,318.4888888888889,39,6,19,34.82602220417007,0.6303418803418803,43.541666666666664,1025.8333333333326,26.303418803418783,0
3213,4,0,1,44,0.0,0.022222222222222223,0.9777777777777777,45,1100,600,500,0.5454545454545454,16,6,10,339.56738547189235,0.4304503367003367,0.21221838847168706,0.20084615945018136,131702.0887586804,-55.65321180557555,131646.43554687483,1474,4,319.4888888888889,39,6,16,34.671622353020766,0.6319444444444444,43.38541666666666,1026.458333333332,26.319444444444407,0
3214,4,0,0,44,0.0,0.0,1.0,44,950,700,250,0.7368421052631579,12,7,5,345.8391089154237,0.42803030303030304,0.21450977980071362,0.20446008119079837,131684.26890432084,308.3140432098639,131992.5829475307,1475,5,327.27272727272725,38,6,16,34.528642309427156,0.6334978070175439,43.40277777777777,1026.3888888888878,27.010233918128627,0
3215,4,0,1,43,0.0,0.022727272727272728,0.9772727272727273,44,1000,800,200,0.8,12,8,4,350.06374678343724,0.4277109760394644,0.21449040971512923,0.20770448975817263,131821.37573964492,429.1769395134719,132250.5526791584,1476,6,328.27272727272725,38,6,16,34.28201727007907,0.6348684210526316,43.26923076923077,1026.9230769230765,27.024291497975696,0
3216,4,1,0,44,0.022727272727272728,0.0,1.0,44,1200,800,400,0.6666666666666666,16,8,8,346.08801379744557,0.4264446793516561,0.22203824648347936,0.20687720219061093,132103.35422091998,343.87749565970284,132447.23171657967,1477,0,329.1136363636364,39,5,18,34.10014945789847,0.6359508547008548,42.99479166666666,1028.020833333332,26.35950854700851,0
3217,4,0,1,43,0.0,0.022727272727272728,0.9772727272727273,44,550,300,250,0.5454545454545454,8,3,5,343.37380329028406,0.42637861169837915,0.21615890441237462,0.20554534944077568,132156.90239800338,275.8436414930467,132432.74603949641,1478,1,330.1136363636364,39,5,18,34.11603434302502,0.6364850427350428,42.94270833333333,1028.2291666666658,26.364850427350405,0
3218,4,1,0,44,0.022727272727272728,0.0,1.0,44,1450,700,750,0.4827586206896552,22,7,15,347.2346074574022,0.4234496124031008,0.22904166194950748,0.20964615773555936,132480.48159105846,400.5813307702508,132881.0629218287,1479,0,330.8636363636364,38,6,19,33.69136571191365,0.6414473684210527,42.628205128205124,1029.487179487179,27.09176788124155,0
3219,4,0,1,43,0.0,0.022727272727272728,0.9772727272727273,44,1000,500,500,0.5,15,5,10,344.85676193411757,0.42322938689217754,0.22356734740057704,0.20912634582193462,132645.51487508215,348.7405489809305,132994.25542406307,1480,1,331.8636363636364,38,6,19,33.58678178801078,0.643092105263158,42.467948717948715,1030.1282051282049,27.108636977058023,0
3220,4,0,0,43,0.0,0.0,1.0,43,700,400,300,0.5714285714285714,10,4,6,343.9965896663658,0.42266519010705056,0.23060488265990187,0.2089107752356695,132700.54879830522,529.7072466944289,133230.25604499964,1481,2,338.7906976744186,38,5,19,33.55367758882898,0.643640350877193,42.414529914529915,1030.3418803418804,27.11426000899685,0
3221,4,0,0,43,0.0,0.0,1.0,43,1550,1100,450,0.7096774193548387,20,11,9,346.1139896373056,0.4220191952750092,0.23364260754307753,0.21112515802781295,132865.71905361972,597.3368215355449,133463.05587515526,1482,3,339.7906976744186,38,5,19,33.33333333333334,0.6452850877192983,42.254273504273506,1030.9829059829062,27.131129104813322,0
3222,4,0,0,43,0.0,0.0,1.0,43,1300,800,500,0.6153846153846154,18,8,10,345.9120897398077,0.42190383905500184,0.23196548126982997,0.21146861318925678,132948.34270445255,597.687810468266,133546.0305149208,1483,4,340.7906976744186,38,5,19,33.255637280292824,0.6461074561403508,42.1741452991453,1031.3034188034194,27.139563652721563,0
3223,4,0,0,43,0.0,0.0,1.0,43,1150,900,250,0.782608695652174,14,9,5,344.7069943289226,0.4214885566629753,0.22667918532428133,0.21182376369067382,133141.2310979619,578.9427186061844,133720.17381656807,1484,5,341.7906976744186,38,5,20,33.093297101449295,0.6480263157894737,41.98717948717949,1032.0512820512822,27.159244264507425,0
3224,4,0,0,43,0.0,0.0,1.0,43,1150,1000,150,0.8695652173913043,13,10,3,347.6428137564319,0.420796419342931,0.22740514962194558,0.2147388549893565,133334.25931633066,670.5394157717897,134004.79873210244,1485,6,342.7906976744186,38,5,20,32.82408365228785,0.6499451754385965,41.800213675213676,1032.7991452991455,27.1789248762933,0
3225,4,0,0,43,0.0,0.0,1.0,43,1500,1200,300,0.8,18,12,6,358.6640903997445,0.4202427094868955,0.21239184208696393,0.21256522420906337,131778.07113727272,852.8837430305014,132630.95488030324,1486,7,343.7906976744186,37,6,15,34.1049053111206,0.6362612612612613,43.31140350877192,1026.7543859649102,27.750118539592165,8
3226,4,0,0,43,0.0,0.0,1.0,43,1400,1200,200,0.8571428571428571,16,12,4,387.5166111548336,0.420265780730897,0.15304632786818284,0.2286950363240185,131616.8533398264,1667.1580614735494,133284.01140129994,1487,8,344.7906976744186,36,7,15,33.52744549312263,0.6365740740740741,43.46846846846847,1026.1261261261268,28.503503503503524,8
3227,4,0,0,43,0.0,0.0,1.0,43,1500,1000,500,0.6666666666666666,20,10,10,387.5266985610766,0.41971207087486156,0.15374759769378588,0.23001109370868428,131834.36850761753,1617.8675169282642,133452.2360245458,1488,9,345.7906976744186,37,6,16,33.30708591358815,0.6368243243243243,43.25657894736841,1026.9736842105249,27.756045519203376,0
3228,4,0,0,43,0.0,0.0,1.0,43,1150,900,250,0.782608695652174,14,9,5,388.6862338567765,0.41964285714285715,0.15739876472106928,0.2310414110894848,131890.67790089245,1652.818174823006,133543.49607571546,1489,10,346.7906976744186,37,6,17,33.22036009109022,0.6373873873873874,43.201754385964904,1027.1929824561394,27.76197249881458,0
3229,4,0,1,42,0.0,0.023255813953488372,0.9767441860465116,43,1350,800,550,0.5925925925925926,19,8,11,363.6737974923883,0.4189045773348099,0.13173331120121223,0.2032093999243391,129500.26167223672,820.1442450607738,130320.4059172975,1490,11,347.7906976744186,38,5,13,36.28546936776179,0.6115679824561404,45.53952991452991,1017.8418803418795,26.785312640575775,8
3230,4,0,0,42,0.0,0.0,1.0,42,1500,1000,500,0.6666666666666666,20,10,10,371.40874213361303,0.41764663182346107,0.15336534268991442,0.20757298935739468,129508.13140822163,1220.0904364804392,130728.22184470207,1491,14,356.8095238095238,37,5,14,36.08062677295414,0.6134572072072072,45.53179824561403,1017.8728070175428,27.510075865338994,0
3231,4,0,0,42,0.0,0.0,1.0,42,1550,1300,250,0.8387096774193549,18,13,5,373.797768588051,0.4167634533488192,0.15306268901532594,0.20995050001106344,129703.52055440111,1296.5773122498917,131000.097866651,1492,15,357.8095238095238,37,5,16,35.82077502691063,0.615427927927928,45.33991228070174,1018.640350877191,27.530820293978138,0
3232,4,1,1,42,0.023255813953488372,0.023255813953488372,0.9767441860465116,43,1000,800,200,0.8,12,8,4,379.8001310562426,0.41955057216685127,0.10568905463884914,0.2079686634789626,128700.2310807171,1203.7737573099384,129904.00483802705,1493,0,350.4651162790698,37,6,15,36.692241192997635,0.6052927927927928,46.32675438596491,1014.6929824561399,27.424134660976755,8
3233,4,2,0,44,0.045454545454545456,0.0,1.0,44,900,600,300,0.6666666666666666,12,6,6,373.09348826136136,0.4238570295983087,0.14386750838120266,0.2071897610859799,129257.13320444747,845.972799322863,130103.10600377033,1494,0,343.09090909090907,37,7,19,36.29367047660125,0.6109234234234234,45.77850877192982,1016.8859649122802,27.483404457088653,0
3234,4,0,0,44,0.0,0.0,1.0,44,1250,900,350,0.72,16,9,7,369.8164161166677,0.4236918604651163,0.14115309612237525,0.20580605232839394,129340.77222077947,766.4681680901828,130107.24038886966,1495,1,344.09090909090907,37,7,19,36.29170259782258,0.6117680180180181,45.69627192982456,1017.2149122807017,27.49229492650545,0
3235,4,0,0,44,0.0,0.0,1.0,44,1300,900,400,0.6923076923076923,17,9,8,378.431836724807,0.42295410500352365,0.15184584565487014,0.21189514712029422,129581.83235627135,1007.5781649499484,130589.4105212213,1496,2,345.09090909090907,38,6,16,35.82677509618748,0.612390350877193,45.4594017094017,1018.1623931623923,26.79374718848401,0
3236,4,0,0,44,0.0,0.0,1.0,44,1650,1200,450,0.7272727272727273,21,12,9,381.8961561416154,0.4224365750528541,0.1498627211714456,0.21472651798151182,129745.05077069163,1109.8272335451584,130854.87800423679,1497,3,346.09090909090907,38,6,17,35.57221756152124,0.6140350877192983,45.29914529914529,1018.8034188034175,26.81061628430046,0
3237,4,0,1,43,0.0,0.022727272727272728,0.9772727272727273,44,1100,700,400,0.6363636363636364,15,7,8,381.8961561416154,0.42251365398167723,0.1498627211714456,0.21472651798151182,129745.05077069163,1109.8272335451584,130854.87800423679,1498,4,347.09090909090907,38,6,17,35.57221756152124,0.6140350877192983,45.29914529914529,1018.8034188034175,26.81061628430046,0
3238,4,0,1,42,0.0,0.023255813953488372,0.9767441860465116,43,1750,1300,450,0.7428571428571429,22,13,9,364.16548092360534,0.41973514211886304,0.10852713178294571,0.1949816251170573,127802.69870799844,727.4650569294831,128530.16376492793,1499,5,353.3255813953488,36,7,17,38.007201989828104,0.5980902777777778,47.21283783783783,1011.1486486486478,28.08746246246244,8
3239,4,0,0,42,0.0,0.0,1.0,42,1300,900,400,0.6923076923076923,17,9,8,366.467516407917,0.4171506000774294,0.13193296018318246,0.196910536328273,127945.07345183015,977.5426609041385,128922.61611273428,1500,6,362.0238095238095,36,6,17,37.80308511427721,0.599537037037037,47.07207207207207,1011.7117117117112,28.10310310310309,0
3240,4,2,1,43,0.045454545454545456,0.022727272727272728,0.9772727272727273,44,1050,600,450,0.5714285714285714,15,6,9,334.7046425608846,0.42081791754756875,0.15198358136525414,0.1808692395377087,128173.0379027676,-148.89429125071382,128024.14361151688,1501,0,346.52272727272725,36,8,21,38.373693282918154,0.6018518518518519,46.846846846846844,1012.6126126126123,28.12812812812812,7
3241,4,2,1,44,0.044444444444444446,0.022222222222222223,0.9777777777777777,45,1150,800,350,0.6956521739130435,15,8,7,325.49620502651226,0.4220749158249158,0.16436394271272103,0.17804792413201379,128658.8684345094,-624.4053163123757,128034.46311819702,1502,0,338.64444444444445,38,7,20,38.11188044088739,0.6030701754385965,46.36752136752136,1014.529914529914,26.698155645524054,0
3242,4,1,0,45,0.022222222222222223,0.0,1.0,45,1600,1100,500,0.6875,21,11,10,323.70740230588694,0.4233164983164983,0.1710858585858579,0.17803907126823784,128875.73964497047,-656.3938198553587,128219.3458251151,1503,0,339.6222222222222,38,7,21,37.936658249158235,0.6052631578947368,46.15384615384615,1015.3846153846158,26.720647773279364,0
3243,4,1,0,46,0.021739130434782608,0.0,1.0,46,1000,600,400,0.6,14,6,8,314.70135658167015,0.4260567632850241,0.17197628063280623,0.1741742261855718,129123.91067031855,-1072.9060289840747,128051.00464133448,1504,0,333.2173913043478,40,6,22,37.9132920041329,0.6044270833333334,45.90955284552845,1016.3617886178858,25.409044715447145,0
3244,4,0,0,46,0.0,0.0,1.0,46,1250,800,450,0.64,17,8,9,313.09948344704577,0.4259963768115942,0.16712656070829768,0.17374739265105152,129228.54487407763,-1107.6753953502748,128120.86947872736,1505,1,334.2173913043478,38,8,22,37.84784245735699,0.6088267543859649,45.806623931623925,1016.7735042735036,26.757197480881672,0
3245,4,2,3,45,0.041666666666666664,0.0625,0.9375,48,1350,1100,250,0.8148148148148148,16,11,5,295.7771448422714,0.43039856678487,0.10979096362954599,0.15745262381124514,127569.89282024802,-2036.629458773977,125533.26336147403,1506,0,321.25,43,5,14,39.97312835895513,0.5843023255813953,47.44318181818182,1010.2272727272733,23.493657505285427,8
3246,4,0,0,45,0.0,0.0,1.0,45,1550,1200,350,0.7741935483870968,19,12,7,308.8524273667283,0.42636784511784515,0.11708275997641038,0.16348931300879777,127342.21958459304,-1134.0092750063059,126208.21030958674,1507,1,343.4222222222222,41,4,14,39.87533582334053,0.5848577235772358,47.66865079365079,1009.3253968253963,24.61769260549747,0
3247,4,0,0,45,0.0,0.0,1.0,45,2250,1800,450,0.8,27,18,9,312.88685830602157,0.42664141414141415,0.1147664408000264,0.16655132661422983,127567.61508133342,-1017.1539391219492,126550.46114221147,1508,2,344.4222222222222,41,4,15,39.54333611574845,0.5871443089430894,47.445436507936506,1010.2182539682536,24.639469608981795,0
3248,4,0,2,43,0.0,0.044444444444444446,0.9555555555555556,45,1300,900,400,0.6923076923076923,17,9,8,314.30311556171483,0.4261363636363636,0.11655542468263258,0.16782600321502913,127692.92091836753,-973.1434240362707,126719.77749433125,1509,3,345.4222222222222,41,4,17,39.3796623478602,0.5884146341463414,47.32142857142858,1010.7142857142871,24.651567944250907,0
3249,4,3,2,44,0.06521739130434782,0.043478260869565216,0.9565217391304348,46,1200,700,500,0.5833333333333334,17,7,10,309.4338506584247,0.43439009661835754,0.145381831181018,0.16820063502270835,128408.33875868085,-1250.8310746173142,127157.50768406354,1510,0,331.1304347826087,39,7,14,38.77398081534774,0.5988247863247863,46.61458333333335,1013.541666666669,25.988247863247924,0
3250,4,1,0,45,0.022222222222222223,0.0,1.0,45,1500,1200,300,0.8,18,12,6,318.80660006964916,0.42931397306397306,0.1626180694546857,0.17403283809437525,128577.58881446799,-801.7232129812082,127775.86560148679,1511,0,339.31111111111113,38,7,16,38.36423329470838,0.6022478070175439,46.44764957264958,1014.2094017094031,26.68972109761587,0
3251,4,0,0,45,0.0,0.0,1.0,45,1200,900,300,0.75,15,9,6,318.955854485607,0.42853535353535355,0.16528077199466185,0.17464581104802138,128698.84033203137,-790.1502821180411,127908.69004991332,1512,1,340.31111111111113,39,6,17,38.23711203504091,0.6017628205128205,46.32812500000001,1014.6875000000009,26.01762820512823,0
3252,4,2,1,46,0.0425531914893617,0.02127659574468085,0.9787234042553191,47,1500,1300,200,0.8666666666666667,17,13,4,334.19219077959457,0.4336648165279062,0.20396747827768102,0.17394501574734003,126656.87715851999,-845.5768234976159,125811.30033502237,1513,0,326.78723404255317,40,7,19,39.938583207134435,0.5794270833333333,48.34857723577235,1006.6056910569099,25.16514227642275,7
3253,4,0,0,46,0.0,0.0,1.0,46,1150,800,350,0.6956521739130435,15,8,7,341.4197993481991,0.4321457326892109,0.20900032852841788,0.17743177415292893,126593.58859592004,-555.6884765625089,126037.90011935752,1514,1,334.82608695652175,39,7,19,39.8217273919194,0.5803952991452992,48.41145833333333,1006.3541666666658,25.80395299145297,0
3254,4,3,1,48,0.061224489795918366,0.02040816326530612,0.9795918367346939,49,1100,600,500,0.5454545454545454,16,6,10,324.51827072689923,0.4393069727891157,0.22434236852635814,0.17183508433571876,127354.73632812499,-1531.2744140625007,125823.46191406249,1515,0,315.265306122449,39,10,16,39.4672342621259,0.5881410256410257,47.65625,1009.3749999999999,25.881410256410252,0
3255,4,0,0,48,0.0,0.0,1.0,48,700,400,300,0.5714285714285714,10,4,6,333.32916242175526,0.4364841903073286,0.22475910631088536,0.1760604367959203,127253.65713346479,-1116.529010519398,126137.12812294539,1516,1,322.8333333333333,38,10,21,39.34839580686151,0.5888157894736843,47.756410256410255,1008.9743589743587,26.551956815114703,0
3256,4,0,0,48,0.0,0.0,1.0,48,1700,1400,300,0.8235294117647058,20,14,6,330.3445927134522,0.4364934249408983,0.23251272264631018,0.1636730016848043,124619.19290972641,-1360.3296224706155,123258.8632872558,1517,2,323.8333333333333,40,8,17,42.13507209499577,0.55859375,50.38109756097561,998.4756097560979,24.96189024390245,8
3257,4,5,4,49,0.09433962264150944,0.07547169811320754,0.9245283018867925,53,1600,1000,600,0.625,22,10,12,308.8566116893315,0.4461780358006773,0.2563597447922348,0.15715351124192445,125725.68788069731,-2833.7580077714797,122891.92987292583,1518,0,294.188679245283,45,8,14,41.53156611271676,0.5629629629629629,49.27536231884058,1002.8985507246374,22.286634460547496,0
3258,4,3,0,52,0.057692307692307696,0.0,1.0,52,1100,500,600,0.45454545454545453,17,5,12,318.34851328317313,0.4441145047762695,0.2940472390679856,0.16323828021541456,126043.83680555577,-2374.0223298676547,123669.81447568811,1519,0,299.5,43,9,18,40.966459197786996,0.5687984496124031,48.95833333333334,1004.1666666666683,23.35271317829461,0
3259,4,2,2,52,0.037037037037037035,0.037037037037037035,0.962962962962963,54,1800,1300,500,0.7222222222222222,23,13,10,311.3709016166463,0.44745807127882603,0.30639622236531405,0.162035091980592,126648.92082476012,-2913.042266803829,123735.8785579563,1520,0,289.3703703703704,44,10,16,40.521034556771845,0.5736268939393939,48.35648148148149,1006.5740740740755,22.876683501683534,0
3260,4,0,0,52,0.0,0.0,1.0,52,1450,1100,350,0.7586206896551724,18,11,7,321.60951994384607,0.4452928607340372,0.29883188737453503,0.166640796138709,126472.11192177466,-2265.072959710731,124207.03896206393,1521,1,301.3076923076923,43,9,16,40.444753028306046,0.5731589147286822,48.532196969696976,1005.8712121212129,23.392353770260765,0
3261,4,1,2,51,0.018867924528301886,0.03773584905660377,0.9622641509433962,53,1600,1300,300,0.8125,19,13,6,319.556151917913,0.4471758587324625,0.30797198866918385,0.16686568720168724,126788.76135973958,-2496.7742626885947,124291.987097051,1522,0,296.60377358490564,44,9,17,40.17173086941867,0.5750473484848485,48.2175925925926,1007.1296296296314,22.889309764309804,0
3262,4,1,0,52,0.019230769230769232,0.0,1.0,52,1550,1100,450,0.7096774193548387,20,11,9,326.32975320880547,0.4481287707390649,0.3077400267226571,0.1707933643417514,126882.03125,-2118.9236111111104,124763.10763888889,1523,0,279.8269230769231,44,8,19,39.90556934105321,0.5759943181818181,48.125,1007.5,22.897727272727273,0
3263,4,1,2,51,0.018867924528301886,0.03773584905660377,0.9622641509433962,53,1550,1000,550,0.6451612903225806,21,10,11,316.4863114149595,0.4500332607643929,0.30866416833986987,0.16710220458684336,127238.61621897697,-2545.6231033291497,124692.99311564781,1524,0,275.52830188679246,42,11,21,39.78862530413627,0.5823412698412698,47.77131782945735,1008.9147286821685,24.021779254337346,0
3264,4,1,0,52,0.019230769230769232,0.0,1.0,52,1400,900,500,0.6428571428571429,19,9,10,318.2857531963331,0.4521194695827049,0.30459020484086907,0.16837862544286475,127317.18794288517,-2295.350588151956,125021.83735473322,1525,0,271.28846153846155,41,11,17,39.662894426422895,0.5846036585365854,47.693452380952365,1009.2261904761879,24.615272938443606,0
3265,4,1,1,52,0.018867924528301886,0.018867924528301886,0.9811320754716981,53,1750,1500,250,0.8571428571428571,20,15,5,312.9079608408724,0.4532988630865989,0.30894656888145366,0.16667074559217496,127593.81030654546,-2614.97620021236,124978.8341063331,1526,0,267.1509433962264,43,10,19,39.51606289249228,0.5845445736434108,47.41950757575757,1010.3219696969688,23.495859760394623,0
3266,4,1,1,52,0.018867924528301886,0.018867924528301886,0.9811320754716981,53,1650,1100,550,0.6666666666666666,22,11,11,306.40615994063796,0.454931664247702,0.30848875231250017,0.1643040984306126,127863.43557098723,-2764.371141975354,125099.06442901188,1527,0,265.188679245283,44,9,20,39.40538313650094,0.5859375,47.15277777777776,1011.3888888888855,22.986111111111033,0
3267,4,3,2,53,0.05454545454545454,0.03636363636363636,0.9636363636363636,55,1250,900,350,0.72,16,9,7,303.00157035858075,0.45520482603815937,0.3403183048037248,0.1653172591912673,128556.44710696355,-3207.5870775221865,125348.86002944136,1528,0,256.27272727272725,40,15,13,38.78645154825136,0.5986979166666666,46.46849593495936,1014.1260162601634,25.353150406504085,0
3268,4,1,1,53,0.018518518518518517,0.018518518518518517,0.9814814814814815,54,2100,1500,600,0.7142857142857143,27,15,12,309.63082598824786,0.45439523643139995,0.34277807454890796,0.16948213633040954,128685.3063652589,-2831.0124595148213,125854.29390574408,1529,0,261.8888888888889,40,14,15,38.48741319444445,0.6,46.341463414634156,1014.6341463414644,25.36585365853661,0
3269,4,1,3,51,0.018518518518518517,0.05555555555555555,0.9444444444444444,54,1550,1200,350,0.7741935483870968,19,12,7,310.54025812206356,0.4523279175401817,0.3482933845017613,0.17103375960995013,128930.61682178064,-2792.370594465467,126138.24622731518,1530,0,262.6666666666667,42,12,17,38.21518302960916,0.5994543650793651,46.09980620155039,1015.6007751937992,24.1809708379476,0
3270,4,0,1,50,0.0,0.0196078431372549,0.9803921568627451,51,1300,900,400,0.6923076923076923,17,9,8,311.4512271121184,0.4477287581699347,0.31691922692349617,0.1601641332250345,126162.72925454825,-2333.879653084532,123828.84960146372,1531,1,278.8235294117647,43,8,17,41.01755192132466,0.5700096899224807,48.83996212121212,1004.6401515151509,23.36372445384072,8
3271,4,5,4,51,0.09090909090909091,0.07272727272727272,0.9272727272727272,55,1400,1200,200,0.8571428571428571,16,12,4,297.79386653917066,0.4552469135802469,0.3344853493613824,0.15666546891843336,127092.01388888898,-3427.1456575700095,123664.86823131896,1532,0,259.25454545454545,46,9,15,40.40977961432508,0.5756340579710144,47.91666666666667,1008.3333333333342,21.920289855072483,0
3272,4,4,3,52,0.07272727272727272,0.05454545454545454,0.9454545454545454,55,1250,900,350,0.72,16,9,7,296.97919407894005,0.4547699214365881,0.35811511640895577,0.15797296626215873,127539.3631167948,-3424.6925456466033,124114.6705711482,1533,0,259.0,46,9,13,39.97388976654381,0.5801630434782609,47.473404255319146,1010.1063829787224,21.958834412580924,0
3273,4,1,2,51,0.018867924528301886,0.03773584905660377,0.9622641509433962,53,1600,1200,400,0.75,20,12,8,306.9630097207651,0.45373730043541366,0.3511178492435172,0.16260985092204988,127372.26080246936,-2780.2854938271375,124591.97530864223,1534,0,269.0188679245283,44,9,13,39.89233626857458,0.5809659090909092,47.6388888888889,1009.4444444444464,22.941919191919236,0
3274,4,0,0,51,0.0,0.0,1.0,51,1550,800,750,0.5161290322580645,23,8,15,316.329152528933,0.45008169934640524,0.34946512937259766,0.16712001345934963,127263.05815643606,-2148.5969330268467,125114.46122340922,1535,2,280.52941176470586,42,9,17,39.76759819456449,0.5825892857142857,47.74709302325582,1009.011627906978,24.02408637873757,0
3275,4,0,1,50,0.0,0.0196078431372549,0.9803921568627451,51,1400,1000,400,0.7142857142857143,18,10,8,343.57562424090463,0.45022875816993463,0.3458481105539928,0.1739577634314477,125521.37586805565,-1463.8840767907473,124057.4917912649,1536,3,281.52941176470586,37,14,13,40.871881496881485,0.5729166666666667,49.47916666666667,1002.0833333333342,27.083333333333357,8
3276,4,2,0,52,0.038461538461538464,0.0,1.0,52,1250,900,350,0.72,16,9,7,342.1084347721283,0.45322712418300654,0.36937440153207746,0.1754215591065596,126043.83680555574,-1775.868055555532,124267.9687500002,1537,0,276.7307692307692,39,13,16,40.369986168741356,0.5747863247863247,48.95833333333334,1004.1666666666681,25.747863247863286,0
3277,4,1,0,53,0.018867924528301886,0.0,1.0,53,1400,900,500,0.6428571428571429,19,9,10,332.5808417699469,0.45475024189646834,0.37212847543886385,0.17206513646554505,126410.20507812515,-2191.677517361101,124218.52756076405,1538,0,272.49056603773585,39,14,15,40.23245977487743,0.578525641025641,48.59375000000001,1005.6250000000011,25.78525641025644,0
3278,4,3,0,56,0.05357142857142857,0.0,1.0,56,1650,1400,250,0.8484848484848485,19,14,5,318.77521708192495,0.45727813852813853,0.3841930284102357,0.16812767294129588,127194.50744431236,-3087.0411208399337,124107.46632347243,1539,0,258.8392857142857,40,16,18,39.776009134260185,0.5848958333333334,47.81504065040651,1008.7398373983749,25.21849593495937,0
3279,4,0,1,55,0.0,0.017857142857142856,0.9821428571428571,56,2200,1600,600,0.7272727272727273,28,16,12,317.9414429440769,0.4571022727272727,0.38091462800765186,0.16843265881405423,127373.97057183228,-3100.507200575047,124273.46337125724,1540,1,259.8392857142857,40,16,16,39.61353568911709,0.58671875,47.63719512195122,1009.4512195121954,25.236280487804883,0
3280,4,2,1,56,0.03508771929824561,0.017543859649122806,0.9824561403508771,57,1700,1100,600,0.6470588235294118,23,11,12,309.82193141699753,0.4604349415204678,0.3765902537849175,0.16587952048929538,127801.37466385722,-3480.8662527792903,124320.50841107793,1541,0,251.73684210526315,42,15,19,39.38228717457276,0.5880456349206349,47.2141472868217,1011.1434108527121,24.074843115540766,0
3281,4,0,1,55,0.0,0.017857142857142856,0.9821428571428571,56,1600,1100,500,0.6875,21,11,10,314.47125306843685,0.46084280303030306,0.3892114700361413,0.16896616642739293,127943.71712805488,-3153.0757905013897,124790.64133755349,1542,1,257.0,41,15,19,39.11959861410734,0.5909552845528455,47.073412698412696,1011.7063492063489,24.675764614789,0
3282,4,2,3,54,0.03508771929824561,0.05263157894736842,0.9473684210526316,57,1350,800,550,0.5925925925925926,19,8,11,334.91222561519174,0.461844715956558,0.34635028819050073,0.1782266437998145,127556.54450040538,-2828.8166403813148,124727.72786002407,1543,0,253.3859649122807,42,15,15,38.998401278976814,0.5855654761904762,47.4563953488372,1010.1744186046491,24.051771871539263,8
3283,4,2,2,54,0.03571428571428571,0.03571428571428571,0.9642857142857143,56,1500,800,700,0.5333333333333333,22,8,14,339.37458366223734,0.4604301948051948,0.3642447117204266,0.1815520410552154,127768.13394628654,-2527.74854733563,125240.38539895091,1544,0,258.4642857142857,41,15,17,38.6692302031204,0.5891768292682926,47.247023809523796,1011.0119047619023,24.65882694541225,0
3284,4,0,0,54,0.0,0.0,1.0,54,1250,800,450,0.64,17,8,9,346.97246163690386,0.4577364313999534,0.37676537500605045,0.18545594174649555,127733.27637525611,-1936.0141326260818,125797.26224263004,1545,1,268.81481481481484,40,14,17,38.51286820146778,0.5903645833333333,47.28150406504065,1010.8739837398373,25.271849593495933,0
3285,4,1,1,54,0.01818181818181818,0.01818181818181818,0.9818181818181818,55,1400,1100,300,0.7857142857142857,17,11,6,343.2470736912112,0.45871212121212124,0.37833291757243126,0.1851212018998477,128094.31295666419,-2206.4003842277575,125887.91257243643,1546,0,264.90909090909093,41,14,21,38.23786423624724,0.592479674796748,46.92460317460318,1012.3015873015877,24.690282617111894,0
3286,4,1,0,55,0.01818181818181818,0.0,1.0,55,2050,1400,650,0.6829268292682927,27,14,13,345.1817276549459,0.46007295173961843,0.38822001998823086,0.18800524651738074,128487.53390842033,-2129.6705288741464,126357.86337954618,1547,0,246.61818181818182,39,16,17,37.78736001232919,0.5996260683760684,46.53645833333334,1013.8541666666682,25.996260683760724,0
3287,4,0,2,53,0.0,0.03636363636363636,0.9636363636363636,55,2050,1500,550,0.7317073170731707,26,15,11,340.4630905096761,0.4601290684624018,0.3810675897249036,0.18587645751020648,128582.21379469926,-2244.5004213761326,126337.71337332313,1548,1,247.61818181818182,40,15,17,37.81041249164997,0.5989583333333333,46.443089430894325,1014.2276422764255,25.355691056910636,0
3288,4,0,0,53,0.0,0.0,1.0,53,1800,1300,500,0.7222222222222222,23,13,10,352.7958949758825,0.45759252539912915,0.3753307502837846,0.192325435911321,128523.41666894949,-1531.4932381839435,126991.92343076554,1549,2,257.37735849056605,38,15,18,37.557730130298886,0.6016995614035088,46.501068376068375,1013.9957264957262,26.684098065677006,0
3289,4,0,1,52,0.0,0.018867924528301886,0.9811320754716981,53,1450,1000,450,0.6896551724137931,19,10,9,352.2941732865141,0.4570331398161587,0.37357894423082705,0.1925753123405556,128631.7723742603,-1536.7552186061864,127095.01715565412,1550,3,258.37735849056605,38,15,18,37.45984728804633,0.602796052631579,46.39423076923077,1014.4230769230765,26.695344129554645,0
3290,4,0,2,50,0.0,0.038461538461538464,0.9615384615384616,52,1500,900,600,0.6,21,9,12,357.3138878892392,0.45590592006033187,0.37651789053733964,0.1957927787101784,128728.04763244472,-1200.736164011989,127527.31146843273,1551,4,263.2692307692308,37,15,19,37.23426526202053,0.6055743243243243,46.299342105263165,1014.8026315789484,27.42709815078239,0
3291,4,0,0,50,0.0,0.0,1.0,50,1400,1000,400,0.7142857142857143,18,10,8,371.16072326918913,0.45419217687074825,0.3767503423094476,0.20279629543211794,128613.70991941006,-452.7284807956226,128160.98143861444,1552,5,273.5,35,15,19,36.99984786246767,0.6083333333333334,46.41203703703703,1014.3518518518512,28.981481481481463,0
3292,4,0,3,47,0.0,0.06,0.94,50,2000,1600,400,0.8,24,16,8,372.17280347611637,0.4536734693877551,0.372649800266311,0.20401589446026538,128743.83674214767,-417.00906988068164,128326.82767226698,1553,6,274.5,36,14,19,36.8411562361296,0.6076388888888888,46.28378378378379,1014.8648648648659,28.19069069069072,0
3293,4,3,1,49,0.06,0.02,0.98,50,1250,800,450,0.64,17,8,9,372.66467395860406,0.45475340136054426,0.38160639101802896,0.20535353211651078,128950.68825263533,-388.9267611188216,128561.7614915165,1554,0,274.74,37,13,21,36.61734409298642,0.6078265765765766,46.080043859649116,1015.6798245614027,27.4508060692271,0
3294,4,0,0,49,0.0,0.0,1.0,49,800,500,300,0.625,11,5,6,334.9110463501168,0.4538513321995465,0.27866686242842453,0.18204941234562236,128408.33875868075,-1170.5697005328364,127237.76905814791,1555,1,281.3469387755102,43,6,13,38.128425830763966,0.592781007751938,46.61458333333334,1013.5416666666682,23.570736434108564,8
3295,4,1,0,50,0.02,0.0,1.0,50,1650,1300,350,0.7878787878787878,20,13,7,352.41126568367685,0.45620748299319724,0.30258492129245984,0.18255811059236018,126462.58680555595,-961.3064236110703,125501.28038194489,1556,0,276.7,39,11,12,39.67999171499585,0.579059829059829,48.541666666666686,1005.8333333333366,25.790598290598375,8
3296,4,3,0,53,0.05660377358490566,0.0,1.0,53,1300,900,400,0.6923076923076923,17,9,8,334.7064698081962,0.46017779390420904,0.3133539280452451,0.1764185721107991,127168.88018251378,-2084.0256089298637,125084.85457358391,1557,0,261.9811320754717,40,13,15,39.400503778337544,0.5846354166666667,47.84044715447155,1008.6382113821144,25.21595528455286,0
3297,4,1,1,53,0.018518518518518517,0.018518518518518517,0.9814814814814815,54,1700,1400,300,0.8235294117647058,20,14,6,330.886527544014,0.46170364546936876,0.32369759270171716,0.17602333455868083,127542.56129535151,-2359.5769557823132,125182.9843395692,1558,0,258.1111111111111,41,13,13,39.11436849341974,0.586890243902439,47.470238095238095,1010.1190476190479,24.637049941927998,0
3298,4,1,0,54,0.018518518518518517,0.0,1.0,54,1600,800,800,0.5,24,8,16,332.3177964514473,0.4628246564174237,0.3367796536229979,0.1774451630108674,127692.92091836753,-2313.0739795918253,125379.8469387757,1559,0,259.0740740740741,41,13,14,38.92446996466428,0.5884146341463414,47.32142857142858,1010.7142857142871,24.651567944250907,0
3299,4,0,0,54,0.0,0.0,1.0,54,1800,1300,500,0.7222222222222222,23,13,10,327.87494568982265,0.4627955392499417,0.335890617962018,0.17594804980281226,127893.53820231798,-2413.382621567147,125480.15558075084,1560,1,260.0740740740741,41,13,17,38.83181312933177,0.5904471544715447,47.12301587301587,1011.5079365079366,24.67092528068138,0
3300,4,0,0,54,0.0,0.0,1.0,54,1800,1200,600,0.6666666666666666,24,12,12,326.7011242826172,0.4623296645702306,0.33137092587146477,0.17586692183677996,128019.0039702225,-2435.209494677485,125583.79447554502,1561,2,261.0740740740741,41,13,17,38.733437081331886,0.5917174796747968,46.999007936507944,1012.0039682539696,24.68302361595048,0
3301,4,0,0,54,0.0,0.0,1.0,54,1950,1500,450,0.7692307692307693,24,15,9,331.57464472973277,0.46242429536454693,0.32561138864400685,0.17938768140147557,128219.8771435658,-2297.1079577664327,125922.76918579936,1562,3,262.0740740740741,41,13,17,38.40514497012439,0.59375,46.80059523809524,1012.7976190476194,24.70238095238096,0
3302,4,1,3,52,0.01818181818181818,0.05454545454545454,0.9454545454545454,55,1250,900,350,0.72,16,9,7,326.41813683339365,0.4628928170594837,0.32963546765335394,0.178665831339677,128684.16066529516,-2599.0312071330377,126085.12945816212,1563,0,258.2909090909091,44,11,15,38.06275476060109,0.5942234848484849,46.3425925925926,1014.6296296296315,23.05976430976435,0
3303,4,0,1,51,0.0,0.019230769230769232,0.9807692307692307,52,1450,900,550,0.6206896551724138,20,9,11,341.9202286354456,0.4622611865258924,0.3294743853153008,0.18638755503375404,128521.48216057254,-1611.1810870181423,126910.30107355441,1564,1,265.8076923076923,41,11,15,37.83540015654045,0.5967987804878049,46.50297619047619,1013.9880952380952,24.731416957026713,0
3304,4,2,0,53,0.03773584905660377,0.0,1.0,53,1000,600,400,0.6,14,6,8,337.33505043559444,0.4644412191582003,0.3360254759108545,0.1862897588540405,129036.70374657089,-1894.2794067215145,127142.42433984937,1565,0,255.8679245283019,44,9,17,37.426903915671815,0.5977746212121212,45.99537037037038,1016.0185185185204,23.091329966330008,0
3305,4,1,2,52,0.018518518518518517,0.037037037037037035,0.962962962962963,54,1450,800,650,0.5517241379310345,21,8,13,329.47175453317925,0.4648337409736781,0.3411745078411743,0.18369178643151252,129413.28125000016,-2271.765689300398,127141.51556069976,1566,0,252.11111111111111,39,15,18,37.244062244062235,0.608974358974359,45.62500000000001,1017.5000000000013,26.089743589743623,0
3306,4,2,1,53,0.037037037037037035,0.018518518518518517,0.9814814814814815,54,1300,800,500,0.6153846153846154,18,8,10,335.6224928000541,0.4643678662939669,0.3488673764264314,0.18851535652451026,129704.91672091998,-2093.6225043402933,127611.29421657968,1567,0,252.44444444444446,39,15,16,36.79153032007362,0.6119123931623931,45.33854166666666,1018.645833333332,26.119123931623896,0
3307,4,1,1,53,0.018518518518518517,0.018518518518518517,0.9814814814814815,54,1350,700,650,0.5185185185185185,20,7,13,331.38804589479946,0.4632468553459119,0.34189053144704107,0.1870221117143315,129890.673828125,-2191.1566840277783,127699.51714409722,1568,0,253.42592592592592,39,15,18,36.711032767899724,0.6137820512820513,45.15625,1019.375,26.137820512820515,0
3308,4,0,0,53,0.0,0.0,1.0,53,1700,1300,400,0.7647058823529411,21,13,8,340.5794613340673,0.46191642477019834,0.3481692949604418,0.19162869160725665,129772.26382725184,-1760.44645792242,128011.81736932942,1569,1,259.1509433962264,38,15,18,36.59693824053685,0.6143092105263157,45.2724358974359,1018.9102564102567,26.813427800269913,0
3309,4,0,1,52,0.0,0.018867924528301886,0.9811320754716981,53,1300,1000,300,0.7692307692307693,16,10,6,343.358648787627,0.4617954765360426,0.35445591550967115,0.1935958338908961,129853.92011834323,-1682.7066896778404,128171.21342866539,1570,2,260.1509433962264,38,15,18,36.44326519916143,0.6151315789473684,45.19230769230769,1019.2307692307695,26.821862348178144,0
3310,4,0,0,52,0.0,0.0,1.0,52,1650,1200,450,0.7272727272727273,21,12,9,350.5763951742802,0.46219048516842637,0.35201440241276716,0.1975279523666545,129826.69850107758,-1297.1648084228145,128529.53369265478,1571,3,265.1923076923077,38,14,19,36.28699723940315,0.6148574561403508,45.2190170940171,1019.1239316239322,26.81905083220874,0
3311,4,0,0,52,0.0,0.0,1.0,52,1750,1200,550,0.6857142857142857,23,12,11,348.39344461243803,0.46204122674710907,0.3454586124344059,0.19684539028635265,129935.60209155167,-1346.2576019066391,128589.34448964504,1572,4,266.1923076923077,38,14,19,36.23205490935764,0.615953947368421,45.11217948717949,1019.5512820512826,26.830296896086384,0
3312,4,0,0,52,0.0,0.0,1.0,52,1350,1100,250,0.8148148148148148,16,11,5,353.48067813910984,0.4615620286576169,0.3460692533273175,0.20041766715393278,130071.79578493704,-1204.4266838337082,128867.36910110334,1573,5,267.1923076923077,38,14,19,35.96411988549086,0.6173245614035088,44.97863247863249,1020.085470085472,26.844354475933475,0
3313,4,0,0,52,0.0,0.0,1.0,52,1350,900,450,0.6666666666666666,18,9,9,352.35318617242757,0.4611142533936652,0.3465463108320246,0.20075937351684878,130262.58680555594,-1220.3124999999602,129042.27430555598,1574,6,268.1923076923077,38,14,19,35.79931972789116,0.6192434210526316,44.791666666666686,1020.8333333333364,26.86403508771938,0
3314,4,0,2,50,0.0,0.038461538461538464,0.9615384615384616,52,1300,800,500,0.6153846153846154,18,8,10,351.1325878979316,0.46072932378079434,0.34435586375557037,0.20104968895089975,130453.5176510339,-1238.7037493607766,129214.81390167311,1575,7,269.1923076923077,38,14,19,35.63693962211531,0.6211622807017544,44.604700854700866,1021.5811965811984,26.88371569950522,0
3315,4,0,0,50,0.0,0.0,1.0,50,1300,900,400,0.6923076923076923,17,9,8,354.4954071164961,0.4608333333333334,0.3375968243750669,0.20358913676727428,130570.58572108728,-742.665411472758,129827.92030961452,1576,8,276.86,37,13,17,35.43242409612702,0.6241554054054055,44.49013157894737,1022.0394736842107,27.62268847795164,0
3316,4,0,1,49,0.0,0.02,0.98,50,1700,1300,400,0.7647058823529411,21,13,8,352.9333201922829,0.4602551020408163,0.3333948102080202,0.20342745019241226,130710.70545744846,-773.5673476454303,129937.13810980304,1577,9,277.86,37,13,17,35.33043820144397,0.6255630630630631,44.353070175438596,1022.5877192982458,27.637505926979617,0
3317,4,1,0,50,0.02,0.0,1.0,50,950,600,350,0.631578947368421,13,6,7,351.54886974283363,0.45974489795918366,0.3431609380019276,0.2045554451419516,131075.36844269387,-784.120474569101,130291.24796812476,1578,0,278.16,37,13,18,34.996943819823684,0.629222972972973,43.99671052631579,1024.0131578947364,27.676031294452336,0
3318,4,0,1,49,0.0,0.02,0.98,50,1800,1400,400,0.7777777777777778,22,14,8,350.5142850440985,0.45933673469387754,0.3457962328767126,0.20470034246575333,131215.758694983,-801.4004309018233,130414.35826408118,1579,1,279.16,37,13,18,34.88156392694064,0.6306306306306306,43.859649122807014,1024.5614035087713,27.690848743480306,0
3319,4,0,2,47,0.0,0.04081632653061224,0.9591836734693877,49,1300,1000,300,0.7692307692307693,16,10,6,353.15286762705773,0.45847505668934235,0.3338306191994225,0.2060700216038065,131183.87972009165,-534.4073380813295,130649.47238201031,1580,2,284.8979591836735,36,13,19,34.84619471620682,0.6322337962962963,43.890765765765764,1024.4369369369365,28.45658158158157,0
3320,4,0,0,47,0.0,0.0,1.0,47,1800,1000,800,0.5555555555555556,26,10,16,370.0839688541291,0.45733117483811286,0.3482852344926681,0.21556075721408777,131114.67013888902,304.68750000001995,131419.35763888905,1581,3,296.6808510638298,34,13,20,34.48264171413073,0.6357230392156863,43.95833333333334,1024.1666666666679,30.122549019607877,0
3321,4,0,0,47,0.0,0.0,1.0,47,1500,1100,400,0.7333333333333333,19,11,8,365.26654961284027,0.4569842738205365,0.3408507177482949,0.21343171707520164,131236.62308673482,187.2696995465015,131423.89278628133,1582,4,297.6808510638298,34,13,20,34.48259168893536,0.6369485294117647,43.83928571428572,1024.6428571428582,30.136554621848774,0
3322,4,1,0,48,0.020833333333333332,0.0,1.0,48,1350,900,450,0.6666666666666666,18,9,9,356.4843206472727,0.4563848256501182,0.33800761421319847,0.21026171008237327,131595.1877170138,-217.67578125001035,131377.5119357638,1583,0,292.4583333333333,35,13,18,34.34538917089679,0.6383928571428572,43.48958333333333,1026.0416666666658,29.315476190476165,0
3323,4,2,1,49,0.04,0.02,0.98,50,1250,900,350,0.72,16,9,7,343.2858386508343,0.45803571428571427,0.3519292261777869,0.20619127645468163,132285.18029586025,-917.67418821176,131367.50610764849,1584,0,281.72,37,13,20,33.98928799829461,0.6413288288288288,42.81798245614035,1028.7280701754385,27.80346135609293,0
3324,4,0,0,49,0.0,0.0,1.0,49,1500,900,600,0.6,21,9,12,346.0145224475077,0.4574475623582766,0.34173345451540915,0.20845265132813293,132398.00347222236,-637.6736111110929,131760.32986111127,1585,1,285.7959183673469,36,13,21,33.805668016194346,0.6443865740740741,42.70833333333334,1029.1666666666679,28.587962962962997,0
3325,4,0,0,49,0.0,0.0,1.0,49,1350,1000,350,0.7407407407407407,17,10,7,344.50269100703963,0.45730583900226757,0.33811046064664474,0.2077059275339394,132427.78427479859,-675.654390646424,131752.12988415215,1586,2,286.7959183673469,35,14,21,33.81463416919676,0.6467261904761905,42.67939814814815,1029.2824074074078,29.408068783068796,0
3326,4,0,0,49,0.0,0.0,1.0,49,1450,900,550,0.6206896551724138,20,9,11,346.7663173841685,0.4562606292517007,0.35157074065581284,0.2102329853350886,132636.34366426617,-601.2367112482787,132035.10695301788,1587,3,287.7959183673469,35,14,18,33.546816479400746,0.6488095238095238,42.476851851851855,1030.092592592593,29.431216931216944,0
3327,4,0,0,49,0.0,0.0,1.0,49,1150,800,350,0.6956521739130435,15,8,7,347.24391714678035,0.45583545918367346,0.3573903955113038,0.2111926119040253,132755.59413580244,-580.2854938271673,132175.30864197528,1588,4,288.7959183673469,35,14,18,33.41475741239891,0.65,42.36111111111111,1030.5555555555552,29.444444444444436,0
3328,4,0,0,49,0.0,0.0,1.0,49,1350,900,450,0.6666666666666666,18,9,9,346.974029704456,0.45525085034013607,0.35976771921220707,0.21162873030941323,132861.9978720274,-580.0674407515655,132281.93043127583,1589,5,289.7959183673469,36,13,18,33.3149007828145,0.6490162037037037,42.25788288288288,1030.9684684684682,28.63801301301301,0
3329,4,0,1,48,0.0,0.02040816326530612,0.9795918367346939,49,1600,1100,500,0.6875,21,11,10,346.7261177668404,0.45477253401360546,0.3607187988223577,0.2118059413202774,132920.05423920543,-582.6291240564863,132337.42511514894,1590,6,290.7959183673469,36,13,19,33.26303192457501,0.6495949074074074,42.20157657657658,1031.1936936936938,28.644269269269273,0
3330,4,0,1,47,0.0,0.020833333333333332,0.9791666666666666,48,1350,1100,250,0.8148148148148148,16,11,5,356.40656833308753,0.45360520094562645,0.3637939261255194,0.21728359371271788,132845.0671537422,-130.62909915124686,132714.43805459095,1591,7,296.375,35,13,19,33.08879252273493,0.6508928571428572,42.27430555555555,1030.902777777777,29.454365079365054,0
3331,4,1,0,48,0.020833333333333332,0.0,1.0,48,1550,1000,550,0.6451612903225806,21,10,11,354.38819108241375,0.45345744680851063,0.35428818470742196,0.2174377648657756,133083.80922335823,-167.33391739540136,132916.4753059628,1592,0,295.3125,35,13,21,32.90112637876239,0.6532738095238095,42.042824074074076,1031.828703703704,29.48082010582011,0
3332,4,1,0,49,0.02040816326530612,0.0,1.0,49,1350,1100,250,0.8148148148148148,16,11,5,349.8370219930841,0.4526821145124717,0.36211921001232406,0.21655903102324908,133414.04537983923,-465.3655344533799,132948.67984538584,1593,0,290.265306122449,36,13,22,32.68748637453674,0.6545138888888888,41.72297297297297,1033.1081081081074,28.69744744744743,0
3333,4,0,1,48,0.0,0.02040816326530612,0.9795918367346939,49,2050,1500,550,0.7317073170731707,26,15,11,350.9205662157025,0.4523100907029478,0.36493491533233513,0.21775135348952904,133502.97796201808,-430.18651321619996,133072.79144880187,1594,1,291.265306122449,34,15,22,32.57041239488538,0.6596200980392157,41.63690476190476,1033.4523809523805,30.395658263305307,0
3334,4,0,0,48,0.0,0.0,1.0,48,2000,1600,400,0.8,24,16,8,357.0976027909644,0.45004986702127664,0.3609295204085554,0.22158429519859615,133502.97796201808,-65.28132086168404,133437.6966411564,1595,2,297.6041666666667,34,14,22,32.410820565987024,0.6596200980392157,41.63690476190476,1033.4523809523805,30.395658263305307,0
3335,4,0,0,48,0.0,0.0,1.0,48,800,500,300,0.625,11,5,6,358.4639986087044,0.44983747044917255,0.36403748704364824,0.2228019255489893,133564.50007086166,-24.387046485268712,133540.1130243764,1596,3,298.6041666666667,34,14,22,32.31386041690657,0.6602328431372548,41.57738095238095,1033.6904761904761,30.402661064425768,0
3336,4,0,1,47,0.0,0.020833333333333332,0.9791666666666666,48,1250,800,450,0.64,17,8,9,355.09628305154115,0.44949578900709225,0.2828040781043426,0.20697461477449938,131141.34250217024,-282.81122670421377,130858.53127546603,1597,4,299.6041666666667,39,9,16,34.839422522797385,0.6263354700854701,43.93229166666667,1024.2708333333342,26.263354700854723,8
3337,4,0,1,46,0.0,0.02127659574468085,0.9787234042553191,47,1500,1200,300,0.8,18,12,6,362.54566541650473,0.448427382053654,0.2977924783207664,0.21189369146920767,131246.0064308021,116.53414694279857,131362.54057774492,1598,5,306.6808510638298,38,9,16,34.542800542174966,0.6291118421052632,43.830128205128204,1024.679487179487,26.96524966261808,0
3338,4,0,2,44,0.0,0.043478260869565216,0.9565217391304348,46,1150,700,450,0.6086956521739131,16,7,9,382.90339301845466,0.44837962962962963,0.25013321118413034,0.21691640449803068,130038.81602993223,758.5121406267878,130797.32817055902,1599,6,303.3695652173913,37,9,17,35.24734824052175,0.6188063063063063,45.0109649122807,1019.9561403508768,27.56638217164532,7
3339,4,0,1,43,0.0,0.022727272727272728,0.9772727272727273,44,1400,1000,400,0.7142857142857143,18,10,8,384.698899100229,0.4485332980972516,0.22902018598321594,0.21885644466231094,130203.5175004287,1217.829968278466,131421.34746870716,1600,7,298.75,35,9,19,35.03392681636048,0.6244047619047619,44.84953703703704,1020.6018518518521,29.160052910052915,0
3340,4,0,0,43,0.0,0.0,1.0,43,1100,900,200,0.8181818181818182,13,9,4,394.734378106322,0.4474437061646364,0.22917774473949826,0.22438084145407117,130171.45691609984,1676.6298185941152,131848.08673469396,1601,8,305.3720930232558,34,9,20,34.81052652045421,0.6262254901960784,44.88095238095239,1020.4761904761909,30.01400560224091,0
3341,4,1,1,43,0.022727272727272728,0.022727272727272728,0.9772727272727273,44,1100,700,400,0.6363636363636364,15,7,8,388.29957513781875,0.44897374911909793,0.22483927001578152,0.2226302774487574,130505.75573979596,1335.097789115651,131840.85352891163,1602,0,299.40909090909093,34,10,14,34.63459746009554,0.6295955882352942,44.55357142857143,1021.7857142857147,30.052521008403374,0
3342,4,1,0,44,0.022727272727272728,0.0,1.0,44,1450,1100,350,0.7586206896551724,18,11,7,391.20222694386587,0.44765239605355883,0.2314518775739225,0.22500023595224194,130627.42524092959,1420.3479308389897,132047.77317176858,1603,0,300.3863636363636,34,10,15,34.43674546795543,0.6308210784313726,44.4345238095238,1022.2619047619038,30.066526610644228,0
3343,4,0,1,43,0.0,0.022727272727272728,0.9772727272727273,44,1200,1000,200,0.8333333333333334,14,10,4,391.40553613070443,0.44747621564482026,0.23155579564747653,0.22557520624362484,130706.0335889273,1431.8130304783742,132137.84661940567,1604,1,301.3863636363636,35,9,15,34.35165534804754,0.6294642857142857,44.35763888888888,1022.5694444444431,29.216269841269803,0
3344,4,0,1,42,0.0,0.023255813953488372,0.9767441860465116,43,1200,1100,100,0.9166666666666666,13,11,2,392.43293261050064,0.4470514950166113,0.2148801485254357,0.22677714794364695,130810.03578514735,1666.833191609975,132476.86897675734,1605,2,284.13953488372096,34,9,16,34.21971372047015,0.6326593137254901,44.25595238095238,1022.9761904761901,30.087535014005592,0
3345,4,0,0,42,0.0,0.0,1.0,42,1250,800,450,0.64,17,8,9,401.365446858893,0.4458599496709253,0.22479797288042747,0.23128406689161637,130700.8121876202,2091.7579777008923,132792.57016532109,1606,3,291.5952380952381,33,9,16,34.102348993288594,0.6338383838383839,44.36274509803922,1022.5490196078437,30.986333927510415,0
3346,4,0,0,42,0.0,0.0,1.0,42,1550,1100,450,0.7096774193548387,20,11,9,398.6919574025601,0.4454002129307007,0.2268548617051609,0.23086531513948516,130888.84833958093,2036.8662293348727,132925.7145689158,1607,4,292.5952380952381,33,9,16,33.979540918163664,0.6357323232323233,44.17892156862745,1023.2843137254903,31.0086155674391,0
3347,4,0,1,41,0.0,0.023809523809523808,0.9761904761904762,42,1400,900,500,0.6428571428571429,19,9,10,400.7988844596215,0.44520663956639567,0.2219581153026211,0.23284241173683431,131014.28086553243,2102.0755238369834,133116.3563893694,1608,5,293.5952380952381,33,9,17,33.798180512329424,0.6369949494949495,44.056372549019606,1023.7745098039212,31.023469994058217,0
3348,4,1,0,42,0.023809523809523808,0.0,1.0,42,1600,1200,400,0.75,20,12,8,400.5082301229372,0.4459930313588851,0.21648439280018295,0.23381625725054125,131202.54229142613,2109.539600153763,133312.0818915799,1609,0,290.5,33,9,20,33.61443381180224,0.6388888888888888,43.87254901960783,1024.5098039215668,31.04575163398687,0
3349,4,0,0,42,0.0,0.0,1.0,42,900,500,400,0.5555555555555556,13,5,8,383.5422121000593,0.4459567363530778,0.14093544394501967,0.21080402785349148,128848.62075617303,1483.7770061728593,130332.39776234589,1610,1,291.5,38,4,17,36.44550843593251,0.6049890350877193,46.180555555555564,1015.2777777777793,26.717836257309983,8
3350,4,0,0,42,0.0,0.0,1.0,42,1100,700,400,0.6363636363636364,15,7,8,351.12640673868043,0.44558168795973674,0.20799660740290316,0.1812900770940543,126326.6999051415,479.5263450387169,126806.22625018022,1611,2,292.5,36,6,18,39.852180650461165,0.5830439814814814,48.676801801801794,1005.2927927927917,27.92479979979977,8
3351,4,7,1,48,0.14285714285714285,0.02040816326530612,0.9795918367346939,49,1250,1000,250,0.8,15,10,5,323.29082626293393,0.4545068027210884,0.26219870664315104,0.17457704618198444,128144.53125000015,-1462.4658864945904,126682.06536350555,1612,0,251.57142857142858,39,10,23,38.691700960219485,0.5961538461538461,46.87500000000001,1012.5000000000011,25.961538461538492,0
3352,4,2,2,48,0.04,0.04,0.96,50,1300,900,400,0.6923076923076923,17,9,8,325.6819088163603,0.45659863945578233,0.2292594510616257,0.1686036905963514,126436.39458550328,-1707.9671223958553,124728.42746310742,1613,0,247.5,39,11,16,40.37901346452613,0.5787927350427351,48.56770833333332,1005.729166666665,25.78792735042731,8
3353,4,0,0,48,0.0,0.0,1.0,48,1100,700,400,0.6363636363636364,15,7,8,339.9299053618122,0.4560339095744681,0.24549512691832165,0.1752417048676245,126264.14497730037,-1015.8082294552521,125248.33674784511,1614,1,258.7708333333333,37,11,21,40.197923485344404,0.5805180180180181,48.73903508771928,1005.0438596491201,27.16334755808433,0
3354,4,5,2,51,0.09433962264150944,0.03773584905660377,0.9622641509433962,53,1650,1300,350,0.7878787878787878,20,13,7,318.76736737358476,0.4631107885824867,0.28302858864813896,0.17044833610802418,127749.32861328124,-2447.4210890009417,125301.9075242803,1615,0,235.26415094339623,39,14,19,39.20927786364417,0.5921474358974359,47.265625,1010.9374999999999,25.921474358974358,0
3355,4,2,0,53,0.03773584905660377,0.0,1.0,53,1500,1000,500,0.6666666666666666,20,10,10,319.1476101615127,0.4621129656507015,0.2936938917036447,0.17178767037774884,128015.94309769361,-2428.8035395597453,125587.13955813387,1616,0,236.16981132075472,40,13,21,38.92766285063932,0.5932291666666667,47.00203252032522,1011.9918699187028,25.29979674796757,0
3356,4,0,0,53,0.0,0.0,1.0,53,1500,1000,500,0.6666666666666666,20,10,10,323.2558357526835,0.46209784712143204,0.29494168028815904,0.17433945814061244,128094.31295666433,-2318.5531620055217,125775.7597946588,1617,1,237.16981132075472,41,12,21,38.74379328367963,0.592479674796748,46.924603174603185,1012.3015873015888,24.690282617111922,0
3357,4,1,1,53,0.018518518518518517,0.018518518518518517,0.9814814814814815,54,1750,1100,650,0.6285714285714286,24,11,13,316.6616453380559,0.4630721523410202,0.30205028545561663,0.17262697736378443,128523.4166689495,-2660.2733150294994,125863.14335392001,1618,0,233.75925925925927,38,16,18,38.473729498121024,0.6016995614035088,46.501068376068375,1013.9957264957263,26.68409806567701,0
3358,4,0,3,50,0.0,0.05660377358490566,0.9433962264150944,53,1450,800,650,0.5517241379310345,21,8,13,318.0745548695536,0.4625514029995162,0.2966651301044332,0.17398824729500456,128658.8684345094,-2415.3775385346003,126243.4908959748,1619,1,238.03773584905662,38,15,19,38.30011759337265,0.6030701754385965,46.36752136752136,1014.529914529914,26.698155645524054,0
3359,4,0,1,49,0.0,0.02,0.98,50,1200,800,400,0.6666666666666666,16,8,8,326.81438409690486,0.46291666666666664,0.2867964104227485,0.17833075153464722,128561.19340806775,-1596.8705515158651,126964.32285655188,1620,2,239.14,37,13,19,38.17788860056943,0.6038851351351351,46.46381578947368,1014.1447368421043,27.409317211948764,0
3360,4,0,3,46,0.0,0.061224489795918366,0.9387755102040817,49,1550,1000,550,0.6451612903225806,21,10,11,327.2701206306057,0.46327593537414963,0.2814526588845654,0.17895408723843748,128644.60699445977,-1379.6927900892638,127264.9142043705,1621,3,242.83673469387756,37,12,19,38.08140582216458,0.6047297297297297,46.38157894736842,1014.4736842105258,27.418207681365562,0
3361,4,0,0,46,0.0,0.0,1.0,46,1350,800,550,0.5925925925925926,19,8,11,340.12478288621315,0.46244967793880837,0.28544412939625063,0.18498266892802437,128429.74044568212,-463.5724829559334,127966.16796272619,1622,4,257.7826086956522,36,10,19,37.97448431655742,0.6044560185185186,46.593468468468465,1013.6261261261258,28.15628128128127,0
3362,4,0,0,46,0.0,0.0,1.0,46,1300,1000,300,0.7692307692307693,16,10,6,340.63215543465424,0.4622685185185185,0.28364676628925944,0.18578997938758707,128543.9128951587,-442.76197650352697,128101.15091865518,1623,5,258.7826086956522,36,10,19,37.84517860447899,0.6056134259259259,46.48085585585586,1014.0765765765768,28.1687937937938,0
3363,4,0,1,45,0.0,0.021739130434782608,0.9782608695652174,46,1400,1100,300,0.7857142857142857,17,11,6,339.5639636683711,0.46204710144927535,0.2835498880222407,0.18560632188863407,128629.57552146747,-464.40629819007785,128165.1692232774,1624,6,259.7826086956522,36,10,19,37.78493191237418,0.6064814814814814,46.3963963963964,1014.4144144144149,28.17817817817819,0
3364,4,0,0,45,0.0,0.0,1.0,45,1250,1000,250,0.8,15,10,5,348.05779696003015,0.4600378787878788,0.2846270928462711,0.1896135759558373,128496.33487654322,-55.16975308641702,128441.1651234568,1625,7,266.35555555555555,35,10,19,37.7054794520548,0.6071428571428572,46.52777777777778,1013.8888888888889,28.96825396825397,0
3365,4,0,0,45,0.0,0.0,1.0,45,1150,600,550,0.5217391304347826,17,6,11,347.87665165965166,0.45942760942760946,0.28684103811841033,0.19063640510948893,128731.13854595326,-43.48851165981972,128687.65003429345,1626,8,267.35555555555555,35,10,20,37.470536800486606,0.6095238095238096,46.29629629629629,1014.8148148148141,28.994708994708976,0
3366,4,2,0,47,0.0425531914893617,0.0,1.0,47,1300,1000,300,0.7692307692307693,16,10,6,335.0432758160265,0.46043401171754544,0.28481145986939116,0.18621285671065288,129289.65627411245,-734.7593289180652,128554.89694519438,1627,0,256.93617021276594,35,12,23,37.22793615568452,0.6151785714285714,45.746527777777764,1017.0138888888872,29.057539682539634,0
3367,4,0,0,47,0.0,0.0,1.0,47,1850,1600,250,0.8648648648648649,21,16,5,334.93536445382523,0.4598558433549183,0.28708924774979505,0.18695558298759798,129459.11864144515,-727.9125831913378,128731.20605825381,1628,1,257.93617021276594,36,11,15,37.05852790380286,0.6148726851851851,45.579954954954935,1017.6801801801773,28.268893893893814,0
3368,4,0,2,45,0.0,0.0425531914893617,0.9574468085106383,47,1300,700,600,0.5384615384615384,19,7,12,335.6407831363515,0.45983657107616405,0.2866446599109225,0.1881710850528223,129631.08114448896,-698.1044811703699,128932.97666331858,1629,2,258.93617021276594,36,11,17,36.865992111762324,0.6166087962962963,45.41103603603603,1018.3558558558548,28.287662662662633,0
3369,4,1,0,46,0.021739130434782608,0.0,1.0,46,1200,800,400,0.6666666666666666,16,8,8,346.68804277315934,0.4587459742351047,0.2985411704241081,0.1942777961986148,129613.56122470838,-212.90562842936976,129400.655596279,1630,0,265.45652173913044,35,11,19,36.6025422444495,0.618452380952381,45.42824074074073,1018.287037037036,29.093915343915317,0
3370,4,1,2,45,0.02127659574468085,0.0425531914893617,0.9574468085106383,47,950,700,250,0.7368421052631579,12,7,5,335.69992709548194,0.45958603145235893,0.28611964137792123,0.18963170851359595,129927.00277970135,-676.7029278239603,129250.29985187738,1631,0,260.78723404255317,37,10,20,36.56431490643149,0.6176801801801801,45.12061403508771,1019.5175438596484,27.55452821242293,0
3371,4,1,0,46,0.021739130434782608,0.0,1.0,46,1250,800,450,0.64,17,8,9,330.68775707196164,0.45954106280193235,0.2728609005105982,0.1882831246165387,130235.3223847614,-586.5546698078911,129648.7677149535,1632,0,254.8913043478261,38,8,21,36.3798321819831,0.6189692982456141,44.81837606837606,1020.726495726495,26.86122357174987,0
3372,4,0,0,46,0.0,0.0,1.0,46,1450,1000,450,0.6896551724137931,19,10,9,334.6526410833451,0.45945048309178743,0.273846017367648,0.19096413969193196,130321.6695066014,-477.493261139328,129844.17624546208,1633,1,255.8913043478261,35,11,21,36.19124537141993,0.6255952380952381,44.73379629629629,1021.0648148148141,29.173280423280403,0
3373,4,0,1,45,0.0,0.021739130434782608,0.9782608695652174,46,1200,900,300,0.75,15,9,6,334.7889239551337,0.4592995169082126,0.27158395649218225,0.19162432184358025,130439.8750964505,-466.0349151234682,129973.84018132703,1634,2,256.89130434782606,35,11,21,36.06815091774304,0.6267857142857143,44.61805555555555,1021.5277777777768,29.18650793650791,0
3374,4,0,0,45,0.0,0.0,1.0,45,1150,700,450,0.6086956521739131,16,7,9,333.6249947715182,0.457807239057239,0.2580951681238217,0.19135987373936503,130521.37230135535,-290.96156967779183,130230.41073167756,1635,3,259.4222222222222,36,9,13,36.01544706487401,0.6255787037037037,44.538288288288285,1021.8468468468465,28.384634634634622,0
3375,4,0,2,43,0.0,0.044444444444444446,0.9555555555555556,45,950,800,150,0.8421052631578947,11,8,3,333.65731733262385,0.45787037037037037,0.2601936518428756,0.191805412883358,130607.69120049084,-284.35762620730765,130323.33357428353,1636,4,260.4222222222222,36,9,13,35.92734383606919,0.6264467592592593,44.45382882882882,1022.1846846846831,28.394019019018977,0
3376,4,0,1,42,0.0,0.023255813953488372,0.9767441860465116,43,1250,800,450,0.64,17,8,9,339.14907467198105,0.4551956441491325,0.25034432087809066,0.19486177478388186,130587.70743580669,257.7400280778379,130845.44746388453,1637,5,266.74418604651163,35,8,16,35.80721794436266,0.6282738095238095,44.473379629629626,1022.106481481481,29.20304232804231,0
3377,4,0,0,42,0.0,0.0,1.0,42,1300,900,400,0.6923076923076923,17,9,8,344.5845019471292,0.45394163763066203,0.24995553399628112,0.19859126384232764,130706.03358892733,607.854697145041,131313.88828607235,1638,6,271.7142857142857,35,7,16,35.54859932088282,0.6294642857142857,44.35763888888888,1022.5694444444433,29.21626984126981,0
3378,4,0,0,42,0.0,0.0,1.0,42,1000,800,200,0.8,12,8,4,345.54548046913993,0.45353029423151375,0.2537321071657537,0.19975647494223184,130824.41332572428,641.1569519461386,131465.57027767043,1639,7,272.7142857142857,35,7,17,35.40429252932082,0.6306547619047619,44.24189814814814,1023.032407407406,29.229497354497315,0
3379,4,0,2,40,0.0,0.047619047619047616,0.9523809523809523,42,650,500,150,0.7692307692307693,8,5,3,344.0329256839208,0.4534335075493612,0.2476185091247851,0.199493977824453,130942.84664619756,609.7301258144525,131552.57677201202,1640,8,273.7142857142857,35,7,17,35.323254740095734,0.6318452380952381,44.1261574074074,1023.4953703703692,29.242724867724835,0
3380,4,0,0,40,0.0,0.0,1.0,40,1150,700,450,0.6086956521739131,16,7,9,361.955040284319,0.45137553418803417,0.2629376498800955,0.2078997958657867,130575.52984429068,1452.4942329873106,132028.02407727798,1641,9,287.925,33,7,17,35.23681055155875,0.6325757575757576,44.48529411764706,1022.0588235294119,30.97147950089127,0
3381,4,0,1,39,0.0,0.025,0.975,40,1250,1000,250,0.8,15,10,5,363.04141248387657,0.45098824786324787,0.2657789095266623,0.2093697710558363,130732.14215986646,1492.2363093521794,132224.37846921865,1642,10,288.925,33,7,17,35.050304573596954,0.6341540404040404,44.33210784313726,1022.6715686274515,30.990047534165196,0
3382,4,1,0,40,0.025,0.0,1.0,40,1200,800,400,0.6666666666666666,16,8,8,359.0144465519309,0.4485576923076923,0.26281678679376896,0.208947379515542,131084.19075963713,1412.2236394557724,132496.4143990929,1643,0,288.45,34,6,18,34.79689800821513,0.6354166666666667,43.988095238095234,1024.0476190476186,30.119047619047606,0
3383,4,0,0,40,0.0,0.0,1.0,40,850,600,250,0.7058823529411765,11,6,5,358.42909865857075,0.4481971153846154,0.26494770482277774,0.20910389111572894,131175.63952664402,1403.433248299324,132579.07277494334,1644,1,289.45,34,6,18,34.71939763703273,0.6363357843137255,43.898809523809526,1024.4047619047622,30.1295518207283,0
3384,4,0,0,40,0.0,0.0,1.0,40,1350,800,550,0.5925925925925926,19,8,11,359.2404094566169,0.44795673076923076,0.2604453078302449,0.21058486510894214,131359.53006355753,1438.0188503097609,132797.5489138673,1645,2,290.45,33,7,19,34.51272663877266,0.6404671717171717,43.71936274509805,1025.1225490196098,31.064319667260904,0
3385,4,0,0,40,0.0,0.0,1.0,40,950,600,350,0.631578947368421,13,6,7,357.09316284334585,0.4477163461538462,0.2510931899641582,0.2101877477495644,131516.61169982704,1392.7365676662903,132909.34826749333,1646,3,291.45,33,7,19,34.409099960175226,0.6420454545454546,43.56617647058824,1025.7352941176475,31.082887700534773,0
3386,4,0,0,40,0.0,0.0,1.0,40,1700,1200,500,0.7058823529411765,22,12,10,378.5826680214834,0.4478365384615384,0.24814457831325276,0.21060563971704505,129326.01042868131,1855.569372356787,131181.5798010381,1647,4,292.45,33,7,19,36.08383534136544,0.619949494949495,45.71078431372549,1017.1568627450984,30.82293523469995,8
3387,4,0,1,39,0.0,0.025,0.975,40,1450,1200,250,0.8275862068965517,17,12,5,379.5608783547458,0.44768963675213674,0.24732261173352588,0.21131689143009685,129357.17520004325,1819.7846080834295,131176.95980812667,1648,5,293.45,33,7,19,36.02716038228326,0.6202651515151515,45.68014705882353,1017.2794117647059,30.82664884135472,0
3388,4,0,0,39,0.0,0.0,1.0,39,1000,800,200,0.8,12,8,4,384.0141141880249,0.4468623481781377,0.27333886805416396,0.21452098229173028,129490.37606175388,2145.2264118457256,131635.6024735996,1649,6,301.15384615384613,32,7,18,35.77797419674978,0.6240234375,45.54924242424242,1017.8030303030301,31.806344696969692,0
3389,4,1,0,40,0.025,0.0,1.0,40,900,500,400,0.5555555555555556,13,5,8,375.9804042903308,0.44877136752136754,0.27772268301478586,0.21234086784054726,129918.7831152681,1769.3833201172556,131688.16643538536,1650,0,294.6,33,7,20,35.54601414432824,0.6259469696969697,45.12867647058823,1019.4852941176465,30.893493761140803,0
3390,4,0,0,40,0.0,0.0,1.0,40,1100,800,300,0.7272727272727273,14,8,6,375.0405158169292,0.44863782051282053,0.271365493211583,0.21248891852582014,130043.75007509108,1754.335021385979,131798.08509647707,1651,1,295.6,33,7,20,35.442824101886345,0.627209595959596,45.00612745098038,1019.9754901960766,30.9083481877599,0
3391,4,1,1,40,0.024390243902439025,0.024390243902439025,0.975609756097561,41,1000,900,100,0.9,11,9,2,364.4917539443288,0.4503556910569106,0.2610043309247363,0.20800038413709263,130323.35778061199,1300.357851473889,131623.71563208586,1652,0,289.3658536585366,34,7,21,35.427839959581824,0.6277573529411764,44.73214285714284,1021.0714285714264,30.031512605041954,0
3392,4,0,1,39,0.0,0.025,0.975,40,750,500,250,0.6666666666666666,10,5,5,376.67638483965015,0.4502403846153846,0.27091836734693886,0.2146179401993355,130262.58680555552,1813.368055555552,132075.95486111107,1653,1,297.375,33,7,21,35.178571428571416,0.6294191919191919,44.791666666666664,1020.833333333333,30.934343434343425,0
3393,4,1,0,40,0.025,0.0,1.0,40,1100,700,400,0.6363636363636364,15,7,8,369.8858591738168,0.45094818376068374,0.27210892514395413,0.21176981607643788,130450.3075740099,1650.3448193002578,132100.65239331016,1654,0,297.325,33,7,22,35.161248400511845,0.6313131313131313,44.607843137254896,1021.5686274509796,30.95662507427211,0
3394,4,0,0,40,0.0,0.0,1.0,40,850,400,450,0.47058823529411764,13,4,9,368.4328716432111,0.4510950854700855,0.2696509954425519,0.21127876779649893,130512.91120001923,1617.0493319876991,132129.96053200692,1655,1,298.325,33,7,18,35.13482449828097,0.6319444444444444,44.54656862745098,1021.8137254901961,30.9640522875817,0
3395,4,0,1,39,0.0,0.025,0.975,40,1100,700,400,0.6363636363636364,15,7,8,367.1774107851949,0.4506276709401709,0.26392818606881674,0.21107007466294342,130606.84479827469,1591.1766207708567,132198.02141904554,1656,2,299.325,33,7,18,35.07160911960997,0.6328914141414141,44.4546568627451,1022.1813725490194,30.975193107546044,0
3396,4,0,0,39,0.0,0.0,1.0,39,1200,800,400,0.6666666666666666,16,8,8,376.279557212667,0.4490834457939721,0.26636627501679366,0.21564123066323684,130488.24737271725,2020.011988572614,132508.25936128985,1657,5,307.94871794871796,32,7,18,34.959424946449175,0.6341145833333333,44.57070707070708,1021.7171717171731,31.92866161616166,0
3397,4,0,0,39,0.0,0.0,1.0,39,950,500,450,0.5263157894736842,14,5,9,374.9704631379963,0.4485773729194782,0.26344760312151627,0.21560801630434795,130617.28395061735,1995.5246913580384,132612.8086419754,1658,6,308.94871794871796,32,7,18,34.861865942029006,0.6354166666666667,44.44444444444445,1022.2222222222227,31.94444444444446,0
3398,4,0,1,38,0.0,0.02564102564102564,0.9743589743589743,39,950,500,450,0.5263157894736842,14,5,9,371.942754998114,0.4479588394062078,0.26251903057235726,0.21476181455735738,130778.66934815336,1928.4357144679227,132707.10506262127,1659,7,309.94871794871796,32,7,18,34.775542114142276,0.6370442708333333,44.286616161616166,1022.8535353535362,31.964172979798008,0
3399,4,1,1,38,0.02564102564102564,0.02564102564102564,0.9743589743589743,39,1500,1200,300,0.8,18,12,6,361.614483864154,0.4473403058929375,0.2864640103346654,0.19451796698803372,127989.47707912816,1493.9901869709283,129483.46726609909,1660,0,310.7435897435897,33,6,19,37.8803590892576,0.6063762626262627,47.0281862745098,1011.8872549019603,30.66325014854425,8
3400,4,1,0,39,0.02564102564102564,0.0,1.0,39,1100,700,400,0.6363636363636364,15,7,8,363.9638999521958,0.44852114260008996,0.2943057506986382,0.1973042335019543,128299.67928501061,1539.2903270376848,129838.9696120483,1661,0,309.0,33,6,21,37.503402080561266,0.6095328282828283,46.7218137254902,1013.1127450980396,30.70038621509211,0
3401,4,1,0,40,0.025,0.0,1.0,40,1250,600,650,0.48,19,6,13,361.2310001876527,0.44995993589743594,0.2557534246575346,0.19679002249028826,128496.33487654309,1283.3719135802335,129779.70679012332,1662,0,302.25,35,5,16,37.37157534246576,0.6071428571428572,46.52777777777777,1013.8888888888879,28.96825396825394,8
3402,4,0,0,40,0.0,0.0,1.0,40,1650,1300,350,0.7878787878787878,20,13,7,359.68687304459723,0.4496260683760684,0.2518827019625747,0.19652716679319487,128613.70991940991,1252.1326303154738,129865.84254972539,1663,1,303.25,35,5,16,37.290810893047315,0.6083333333333334,46.412037037037024,1014.3518518518499,28.981481481481428,0
3403,4,0,0,40,0.0,0.0,1.0,40,1550,1200,350,0.7741935483870968,19,12,7,360.91655837511723,0.44937232905982905,0.24983753277847476,0.19822161136556998,128819.2451801483,1298.599724579903,130117.8449047282,1664,2,304.25,35,5,18,37.04977102572874,0.6104166666666666,46.20949074074074,1015.1620370370368,29.004629629629623,0
3404,4,0,0,40,0.0,0.0,1.0,40,1350,1000,350,0.7407407407407407,17,10,7,359.37405255149883,0.4490518162393162,0.24119557784362922,0.19781354686868555,128907.381955161,1265.1936514060176,130172.57560656703,1665,3,305.25,35,5,19,36.99899323759593,0.6113095238095239,46.122685185185176,1015.5092592592578,29.014550264550223,0
3405,4,0,0,40,0.0,0.0,1.0,40,1100,800,300,0.7272727272727273,14,8,6,349.540135220588,0.4489449786324786,0.22791461881357966,0.1888898482424284,128173.82979948951,960.7144579474921,129134.54425743701,1666,4,306.25,35,5,16,37.99731874118947,0.6038690476190476,46.846064814814795,1012.6157407407377,28.931878306878218,8
3406,4,0,0,40,0.0,0.0,1.0,40,1250,900,350,0.72,16,9,7,347.872696754469,0.44885149572649574,0.22787868403015743,0.18867890876013754,128320.37278163565,927.830825617264,129248.20360725292,1667,5,307.25,35,5,17,37.88982179575051,0.6053571428571429,46.70138888888888,1013.1944444444433,28.948412698412668,0
3407,4,0,0,40,0.0,0.0,1.0,40,1100,700,400,0.6363636363636364,15,7,8,347.72279327821144,0.4485042735042735,0.22586618545252635,0.18965740481346421,128543.9128951587,939.5296901631389,129483.44258532184,1668,6,308.25,36,4,15,37.66541736072553,0.6056134259259259,46.48085585585586,1014.0765765765768,28.1687937937938,0
3408,4,0,0,40,0.0,0.0,1.0,40,1050,700,350,0.6666666666666666,14,7,7,350.4979668662641,0.44809027777777777,0.23462264150943457,0.1918582431023717,128686.69979100714,1020.8853278954539,129707.58511890259,1669,7,309.25,36,4,15,37.44936182019976,0.6070601851851851,46.34009009009009,1014.639639639639,28.184434434434415,0
3409,4,1,0,41,0.024390243902439025,0.0,1.0,41,700,500,200,0.7142857142857143,9,5,4,345.80004033429634,0.4483485772357723,0.2442919670375081,0.1910869990326726,129062.08070031146,725.9345423591669,129788.01524267063,1670,0,302.6829268292683,37,4,16,37.18604996223158,0.6089527027027026,45.970394736842096,1016.1184210526301,27.462660028449463,0
3410,4,1,0,42,0.023809523809523808,0.0,1.0,42,1450,1100,350,0.7586206896551724,18,11,7,345.60330542049627,0.4495378435927216,0.2493215965692539,0.19315084191562085,129508.13140822158,551.7628020159879,130059.89421023757,1671,0,296.45238095238096,37,5,16,36.7372930805415,0.6134572072072072,45.53179824561403,1017.8728070175424,27.510075865338983,0
3411,4,0,0,42,0.0,0.0,1.0,42,850,500,350,0.5882352941176471,12,5,7,344.93734371714015,0.4492595818815331,0.2460600609603758,0.19314059257487312,129581.83235627125,539.522609394377,130121.35496566563,1672,1,297.45238095238096,38,4,16,36.67934592514864,0.612390350877193,45.459401709401696,1018.1623931623915,26.793747188483987,0
3412,4,0,1,41,0.0,0.023809523809523808,0.9761904761904762,42,1250,1000,250,0.8,15,10,5,348.0920789204892,0.44870305845915603,0.24913842188857904,0.19544816728079742,129690.63321827732,628.8564266929487,130319.48964497026,1673,2,298.45238095238096,38,4,16,36.48848856723305,0.6134868421052632,45.352564102564095,1018.5897435897425,26.804993252361644,0
3413,4,1,0,42,0.023809523809523808,0.0,1.0,42,1350,1000,350,0.7407407407407407,17,10,7,348.9520302326101,0.44745692992644215,0.2515894641235248,0.19702368476210438,129908.37191358018,666.3580246913517,130574.72993827153,1674,0,296.85714285714283,38,4,18,36.24545867393279,0.6156798245614035,45.138888888888886,1019.4444444444439,26.827485380116944,0
3414,4,0,0,42,0.0,0.0,1.0,42,1100,700,400,0.6363636363636364,15,7,8,348.25228899747316,0.4471060782036392,0.24927286786899172,0.19704019552346652,129990.07100819996,653.8679551099381,130643.93896330989,1675,1,297.85714285714283,38,4,18,36.1803736685874,0.6165021929824561,45.05876068376068,1019.7649572649568,26.83591992802518,0
3415,4,1,0,43,0.023255813953488372,0.0,1.0,43,1250,1100,150,0.88,14,11,3,346.84872887332347,0.44834348468069396,0.26453962593421565,0.1987086642984556,130475.34722222229,451.04166666667106,130926.38888888896,1676,0,291.90697674418607,39,4,20,35.724238716693854,0.6196581196581197,44.583333333333336,1021.6666666666672,26.19658119658121,0
3416,4,0,0,43,0.0,0.0,1.0,43,950,500,450,0.5263157894736842,14,5,9,349.75988596044044,0.4481589147286822,0.26597103867751626,0.20078959866342222,130555.17713758699,532.5927734375189,131087.76991102452,1677,1,292.90697674418607,39,4,16,35.569025413651346,0.6204594017094017,44.50520833333334,1021.9791666666681,26.204594017094053,0
3417,4,0,0,43,0.0,0.0,1.0,43,900,400,500,0.4444444444444444,14,4,10,346.1308284330623,0.4474206349206349,0.25932033130532006,0.19939085750580646,130688.28125000013,447.0486111111268,131135.32986111127,1678,2,293.90697674418607,39,4,17,35.52703069817986,0.6217948717948718,44.37500000000001,1022.500000000001,26.217948717948744,0
3418,4,0,0,43,0.0,0.0,1.0,43,1000,600,400,0.6,14,6,8,348.2683171007233,0.44649778516057587,0.2630954551589728,0.20131507605922355,130821.45317925357,512.193467881954,131333.64664713552,1679,3,294.90697674418607,39,4,17,35.33764806706717,0.6231303418803419,44.24479166666667,1023.0208333333342,26.23130341880344,0
3419,4,0,0,43,0.0,0.0,1.0,43,1150,900,250,0.782608695652174,14,9,5,346.2117498245161,0.445921004060539,0.2634585982135671,0.20081916492182394,130954.69292534728,467.6106770833371,131422.30360243062,1680,4,295.90697674418607,39,4,18,35.25552954745912,0.624465811965812,44.114583333333336,1023.5416666666671,26.24465811965813,0
3420,4,0,1,42,0.0,0.023255813953488372,0.9767441860465116,43,1250,800,450,0.64,17,8,9,350.90010289961765,0.44502122554448137,0.2681740010834257,0.20424505101279716,131088.0004882814,599.7585720486262,131687.75906033002,1681,5,296.90697674418607,39,4,19,35.000784084359,0.625801282051282,43.98437500000001,1024.0625000000011,26.25801282051285,0
3421,4,0,1,41,0.0,0.023809523809523808,0.9761904761904762,42,2000,1600,400,0.8,24,16,8,355.08329854951836,0.44420247773906313,0.27264959812424916,0.2067939550361896,131109.19922017667,910.9373858572494,132020.13660603392,1682,6,304.8095238095238,38,4,19,34.87225293831282,0.6277412280701755,43.96367521367521,1024.1452991452984,26.951192082771012,0
3422,4,0,0,41,0.0,0.0,1.0,41,1450,1100,350,0.7586206896551724,18,11,7,360.68487469094214,0.4437245934959349,0.26981152756102755,0.21094873835178626,131271.93583602645,1269.560345490916,132541.49618151737,1683,7,303.219512195122,37,4,20,34.56425208645409,0.6311936936936937,43.80482456140351,1024.7807017543857,27.696775723091505,0
3423,4,0,0,41,0.0,0.0,1.0,41,1400,1200,200,0.8571428571428571,16,12,4,388.4730451489806,0.4436229674796748,0.2636838648116058,0.21464741496504927,129058.31665702877,1943.673716484337,131001.99037351311,1684,8,304.219512195122,36,5,18,36.1058775721305,0.6108217592592593,45.97409909909911,1016.1036036036046,28.22510010010013,7
3424,4,0,0,41,0.0,0.0,1.0,41,1050,600,450,0.5714285714285714,15,6,9,391.51183286451993,0.4430640243902439,0.25953252508408964,0.21744434826584705,129261.91184807249,1921.6721254486595,131183.58397352113,1685,9,305.219512195122,34,7,18,35.82055334425973,0.6170343137254901,45.77380952380952,1016.9047619047612,29.908963585434154,0
3425,4,0,1,40,0.0,0.024390243902439025,0.975609756097561,41,1400,1100,300,0.7857142857142857,17,11,6,393.4066951930347,0.44189532520325203,0.26443498407843213,0.2195065555163225,129443.56575963719,1984.7930839002265,131428.35884353743,1686,10,306.219512195122,34,7,16,35.58678443300577,0.6188725490196079,45.595238095238095,1017.6190476190477,29.929971988795522,0
3426,4,2,0,42,0.047619047619047616,0.0,1.0,42,900,600,300,0.6666666666666666,12,6,6,384.38629866934133,0.44548490127758417,0.2673880362955998,0.21670331280936075,129849.38298396752,1582.4647419409862,131431.8477259085,1687,0,294.1904761904762,35,7,18,35.402471799530616,0.6208333333333333,45.196759259259245,1019.2129629629609,29.12037037037031,0
3427,4,0,0,42,0.0,0.0,1.0,42,1250,800,450,0.64,17,8,9,382.9033930184546,0.4441298877274487,0.26867237972376623,0.2169164044980307,130038.81602993226,1558.4607763927302,131597.27680632498,1688,1,295.1904761904762,37,5,18,35.247348240521745,0.6188063063063063,45.0109649122807,1019.956140350877,27.566382171645326,0
3428,4,0,0,42,0.0,0.0,1.0,42,1450,1100,350,0.7586206896551724,18,11,7,379.78521971386914,0.4439242160278745,0.2615057196062791,0.2160782900425851,130206.62607725442,1490.1104185903268,131696.73649584476,1689,2,296.1904761904762,37,5,19,35.156138089098995,0.6204954954954955,44.84649122807017,1020.6140350877183,27.584163110478872,0
3429,4,0,0,42,0.0,0.0,1.0,42,1300,800,500,0.6153846153846154,18,8,10,381.80978873778275,0.44344028261711194,0.2580572627791933,0.2178830710581479,130323.35778061222,1551.7828091532037,131875.14058976542,1690,3,297.1904761904762,34,8,19,34.98576619641677,0.6277573529411764,44.732142857142854,1021.0714285714284,30.031512605042014,0
3430,4,1,0,43,0.023255813953488372,0.0,1.0,43,1400,1000,400,0.7142857142857143,18,10,8,374.1382043750596,0.44282945736434104,0.25792237533067497,0.215623681386409,130706.03358892741,1180.4241415894996,131886.4577305169,1691,0,291.25581395348837,35,8,17,34.79308149405771,0.6294642857142857,44.357638888888886,1022.569444444444,29.216269841269828,0
3431,4,0,0,43,0.0,0.0,1.0,43,1400,1100,300,0.7857142857142857,17,11,6,370.4659418922564,0.44299095607235145,0.2568905192436133,0.21446576735350703,130878.9483302553,1097.2385734071838,131976.18690366248,1692,1,292.25581395348837,37,6,17,34.71165523646235,0.6272522522522522,44.18859649122806,1023.2456140350864,27.655286865813146,0
3432,4,0,0,43,0.0,0.0,1.0,43,1300,900,400,0.6923076923076923,17,9,8,368.7291686427129,0.4427602436323366,0.2568376377054531,0.2142392188934042,131019.23338190575,1062.1226002231224,132081.35598212888,1693,2,293.25581395348837,37,6,17,34.613968619470924,0.6286599099099099,44.05153508771929,1023.793859649121,27.670104314841108,0
3433,4,0,1,42,0.0,0.023255813953488372,0.9767441860465116,43,750,300,450,0.4,12,3,9,366.2775120554663,0.44222960502030273,0.251715980638352,0.21316150291752528,131081.84633875726,1002.4665105193761,132084.31284927664,1694,3,294.25581395348837,38,5,17,34.61332811684923,0.627467105263158,43.990384615384606,1024.0384615384603,26.948380566801585,0
3434,4,0,1,41,0.0,0.023809523809523808,0.9761904761904762,42,1400,900,500,0.6428571428571429,19,9,10,374.3293322730416,0.44069396051103366,0.2596197004937366,0.2173344929167358,130991.17036011058,1406.7674669128721,132397.93782702344,1695,4,302.0952380952381,37,5,17,34.49907169380177,0.6283783783783784,44.07894736842104,1023.684210526314,27.667140825035514,0
3435,4,0,0,41,0.0,0.0,1.0,41,1100,800,300,0.7272727272727273,14,8,6,376.6900122355473,0.4405233739837398,0.255440178164158,0.2186533979068404,130982.06948502545,1667.927471390296,132649.99695641574,1696,5,306.5121951219512,36,5,17,34.44788228822881,0.6302083333333333,44.08783783783783,1023.6486486486477,28.434684684684658,0
3436,4,0,0,41,0.0,0.0,1.0,41,1300,900,400,0.6923076923076923,17,9,8,374.3095703130673,0.440015243902439,0.24941250952324756,0.21759735379069092,131039.71370018659,1609.8837858128315,132649.59748599943,1697,6,307.5121951219512,36,5,17,34.4503867869189,0.630787037037037,44.03153153153153,1023.8738738738732,28.440940940940923,0
3437,4,0,0,41,0.0,0.0,1.0,41,950,500,450,0.5263157894736842,14,5,9,376.3463100576784,0.4391768292682927,0.248152392687365,0.21962545751835624,131187.67463305994,1674.3994546398637,132862.07408769982,1698,7,308.5121951219512,37,4,18,34.24834546362695,0.6303490990990991,43.88706140350876,1024.451754385963,27.68788525367468,0
3438,4,0,0,41,0.0,0.0,1.0,41,1100,700,400,0.6363636363636364,15,7,8,373.85226626402846,0.4388719512195122,0.24126170650815348,0.2188100897163351,131300.02891514683,1617.3626740920106,132917.39158923883,1699,8,309.5121951219512,37,4,19,34.1984727720124,0.6314752252252251,43.777412280701746,1024.8903508771918,27.69973921289708,0
3439,4,0,0,41,0.0,0.0,1.0,41,1400,1100,300,0.7857142857142857,17,11,6,369.85696099715034,0.43846544715447155,0.2420357965855311,0.2171347128875916,131417.11576485346,1521.1130234249536,132938.22878827841,1700,9,310.5121951219512,35,6,19,34.18239925499493,0.6366071428571429,43.66319444444445,1025.3472222222229,29.29563492063494,0
3440,4,0,1,40,0.0,0.024390243902439025,0.975609756097561,41,1300,1000,300,0.7692307692307693,16,10,6,368.2588511772159,0.43795731707317076,0.23900512211178815,0.21765960892536598,131674.63705259305,1498.0701140329493,133172.707166626,1701,10,311.5121951219512,36,5,15,33.9630879233414,0.6371527777777778,43.41216216216216,1026.3513513513508,28.509759759759746,0
3441,4,0,0,40,0.0,0.0,1.0,40,1500,1100,400,0.7333333333333333,19,11,8,373.7712085758335,0.43855502136752134,0.2353720405862456,0.22131846595912177,131743.67310742463,1848.3983839163316,133592.07149134096,1702,11,316.925,35,5,15,33.75187899285982,0.6398809523809523,43.34490740740741,1026.620370370371,29.332010582010597,0
3442,4,0,1,39,0.0,0.025,0.975,40,1650,1200,450,0.7272727272727273,21,12,9,371.6465745034026,0.4382879273504274,0.23813308484981377,0.2210013072112151,131905.89871966562,1804.4750831913013,133710.37380285692,1703,12,317.925,36,4,16,33.64256741942557,0.6394675925925926,43.18693693693694,1027.2522522522524,28.53478478478479,0
3443,4,0,0,39,0.0,0.0,1.0,39,950,700,250,0.7368421052631579,12,7,5,379.7012846210262,0.4378092667566352,0.24218772584048853,0.22482979937172906,131743.6731074245,2204.648383916317,133948.32149134082,1704,17,326.7692307692308,35,4,17,33.59968057121383,0.6398809523809523,43.344907407407405,1026.6203703703698,29.332010582010565,0
3444,4,1,0,40,0.025,0.0,1.0,40,900,700,200,0.7777777777777778,11,7,4,373.8782576902186,0.439196047008547,0.24907427695004358,0.22334821571965444,132079.4781267756,1876.3290317344527,133955.80715851006,1705,0,319.575,36,4,18,33.410020449897736,0.6412037037037037,43.018018018018026,1027.9279279279292,28.553553553553588,0
3445,4,0,0,40,0.0,0.0,1.0,40,950,600,350,0.631578947368421,13,6,7,376.40915149195814,0.43898237179487176,0.2492059145673604,0.22520416468686624,132137.36329234645,1947.542559451349,134084.90585179778,1706,1,320.575,36,4,18,33.286555312157724,0.6417824074074074,42.961711711711715,1028.1531531531534,28.559809809809817,0
3446,4,0,0,40,0.0,0.0,1.0,40,950,600,350,0.631578947368421,13,6,7,374.66993418826763,0.4371260683760683,0.2493269862114249,0.2255424149283522,132369.03077063535,1918.9392094797306,134287.96998011507,1707,2,321.575,36,4,19,33.09759611877143,0.6440972222222222,42.73648648648648,1029.0540540540528,28.5848348348348,0
3447,4,0,0,40,0.0,0.0,1.0,40,1200,1000,200,0.8333333333333334,14,10,4,358.85738842456277,0.437099358974359,0.15390438924804406,0.20400036065373084,130173.98787133463,1391.705080467543,131565.69295180216,1708,3,322.575,35,5,18,35.723247703300444,0.6241071428571429,44.87847222222221,1020.486111111109,29.15674603174597,8
3448,4,1,0,41,0.024390243902439025,0.0,1.0,41,1400,1000,400,0.7142857142857143,18,10,8,350.11711825579795,0.43930386178861786,0.15559379237773818,0.20116358303948936,130587.70743580672,944.2285022290758,131531.9359380358,1709,0,315.6829268292683,35,6,16,35.52695523345788,0.6282738095238095,44.473379629629626,1022.1064814814812,29.20304232804232,0
3449,4,0,1,40,0.0,0.024390243902439025,0.975609756097561,41,1450,1200,250,0.8275862068965517,17,12,5,353.2160659229944,0.43904979674796746,0.15396462214028017,0.20387788207455929,130765.21675936645,1037.6750846622112,131802.89184402867,1710,1,316.6829268292683,35,6,17,35.26802553656971,0.6300595238095238,44.29976851851852,1022.8009259259262,29.222883597883605,0
3450,4,1,0,41,0.024390243902439025,0.0,1.0,41,600,300,300,0.5,9,3,6,354.394272963931,0.4409298780487805,0.1542601589253514,0.20597711817601394,131031.70680084013,1087.377293381337,132119.08409422147,1711,0,313.3414634146341,35,6,18,34.9682530710679,0.6327380952380952,44.03935185185185,1023.842592592592,29.252645502645485,0
3451,4,2,0,43,0.046511627906976744,0.0,1.0,43,1450,1100,350,0.7586206896551724,18,11,7,338.4190495397843,0.4428525286083425,0.15452997402209956,0.1992391572337749,131524.88175448214,302.1050948368726,131826.98684931902,1712,0,299.72093023255815,37,6,20,34.879632104044184,0.6337274774774775,43.55811403508772,1025.767543859649,27.723447131341867,0
3452,4,0,0,43,0.0,0.0,1.0,43,1300,800,500,0.6153846153846154,18,8,10,336.8297918223643,0.44329088224437063,0.15284664385076696,0.19859586402532217,131581.1250216412,264.0885897583771,131845.21361139958,1713,1,300.72093023255815,37,6,16,34.86371611271417,0.6342905405405406,43.503289473684205,1025.9868421052627,27.729374110953046,0
3453,4,0,3,40,0.0,0.06976744186046512,0.9302325581395349,43,1050,800,250,0.7619047619047619,13,8,5,339.82224702135363,0.44329088224437063,0.15078633425852983,0.2006559249131135,131637.3803117305,346.6620739073501,131984.04238563785,1714,2,301.72093023255815,37,6,16,34.73027299925204,0.6348536036036037,43.4484649122807,1026.206140350877,27.735301090564242,0
3454,4,0,1,39,0.0,0.025,0.975,40,1250,900,350,0.72,16,9,7,361.9023555947376,0.43874198717948715,0.16132215503023617,0.21085854735004092,131126.20380092927,1490.9764071503857,132617.18020807966,1715,4,325.025,36,4,18,34.680456294667394,0.6316550925925926,43.94707207207207,1024.2117117117114,28.450325325325316,0
3455,4,0,0,39,0.0,0.0,1.0,39,1100,700,400,0.6363636363636364,15,7,8,367.5422456425076,0.43924313990103464,0.15312778801256033,0.21460975979073038,131209.5175325786,1845.008144718764,133054.52567729738,1716,5,311.9230769230769,35,4,19,34.451724657327915,0.6345238095238095,43.865740740740726,1024.537037037035,29.27248677248671,0
3456,4,0,1,38,0.0,0.02564102564102564,0.9743589743589743,39,1250,900,350,0.72,16,9,7,366.8451318659529,0.43868083670715247,0.15843235355430485,0.2148664343786295,131328.125,1835.4702503429357,133163.59525034294,1717,6,312.9230769230769,34,5,19,34.34959349593497,0.6378676470588236,43.75,1025.0,30.147058823529413,0
3457,4,1,1,38,0.02564102564102564,0.02564102564102564,0.9743589743589743,39,1350,1100,250,0.8148148148148148,16,11,5,357.9602072268174,0.43747188484030586,0.12670499380002243,0.21212191037468925,131773.38023244595,1633.9252989969118,133407.30553144286,1718,0,282.35897435897436,35,4,16,34.12770544470748,0.6401785714285715,43.31597222222222,1026.7361111111109,29.33531746031745,0
3458,4,0,0,38,0.0,0.0,1.0,38,1150,800,350,0.6956521739130435,15,8,7,364.8657020381898,0.4367443100995732,0.13421379019767232,0.21587684532199508,131713.96933138292,2011.58197766633,133725.55130904925,1719,8,290.7894736842105,35,3,16,34.010434284210916,0.6395833333333334,43.373842592592595,1026.50462962963,29.328703703703713,0
3459,4,0,0,38,0.0,0.0,1.0,38,1050,700,350,0.6666666666666666,14,7,7,367.4846004634386,0.43616642958748225,0.13577855943815353,0.2181064120342538,131832.80452942834,2089.3051000943274,133922.10962952266,1720,9,291.7894736842105,35,3,16,33.82323246553216,0.6407738095238096,43.25810185185186,1026.967592592594,29.341931216931258,0
3460,4,1,0,39,0.02564102564102564,0.0,1.0,39,1150,800,350,0.6956521739130435,15,8,7,363.3921140237308,0.43612235717498876,0.15595178936906717,0.21791596699794735,132224.21481870403,1809.8473896193696,134034.0622083234,1721,0,285.28205128205127,36,3,17,33.5336143654878,0.642650462962963,42.87725225225226,1028.4909909909925,28.569194194194235,0
3461,4,0,1,38,0.0,0.02564102564102564,0.9743589743589743,39,1000,800,200,0.8,12,8,4,364.565638508349,0.4359817813765183,0.14957765954248958,0.21913641166712627,132313.3815813521,1847.3824878809,134160.764069233,1722,1,286.28205128205127,37,2,17,33.41359817400263,0.6416103603603603,42.7905701754386,1028.8377192982466,27.806424845898558,0
3462,4,0,0,38,0.0,0.0,1.0,38,1150,1000,150,0.8695652173913043,13,10,3,369.6362909230529,0.433869724988146,0.1510309683357467,0.22135690525392024,132172.40521121887,2171.1435249307515,134343.54873614962,1723,2,294.5263157894737,37,1,17,33.425303902751125,0.6402027027027026,42.92763157894737,1028.2894736842109,27.791607396870564,0
3463,4,0,0,38,0.0,0.0,1.0,38,600,200,400,0.3333333333333333,10,2,8,369.6362909230529,0.433869724988146,0.1510309683357467,0.22135690525392024,132172.40521121887,2171.1435249307515,134343.54873614962,1724,3,295.5263157894737,37,1,17,33.425303902751125,0.6402027027027026,42.92763157894737,1028.2894736842109,27.791607396870564,0
3464,4,0,0,38,0.0,0.0,1.0,38,750,500,250,0.6666666666666666,10,5,5,368.9164074458642,0.4329806780464675,0.1531398852103074,0.22142065375877504,132256.98201610122,2158.354133002472,134415.33614910368,1725,4,296.5263157894737,37,1,17,33.35853942365775,0.6410472972972974,42.84539473684211,1028.6184210526324,27.800497866287362,0
3465,4,0,1,37,0.0,0.02631578947368421,0.9736842105263158,38,1250,900,350,0.72,16,9,7,372.3811330381144,0.4326102418207682,0.1552474536725441,0.2240015738736966,132341.58587257622,2256.3019390581735,134597.8878116344,1726,5,297.5263157894737,37,1,18,33.184143222506385,0.6418918918918919,42.76315789473684,1028.947368421053,27.809388335704135,0
3466,4,0,0,37,0.0,0.0,1.0,37,1150,800,350,0.6956521739130435,15,8,7,369.09792257314757,0.4316816816816817,0.16743130734805112,0.22290215324110196,132489.9092970521,2380.374102549596,134870.2833996017,1727,6,303.64864864864865,34,3,19,33.11917013567684,0.6495098039215687,42.61904761904761,1029.523809523809,30.280112044817912,0
3467,4,0,0,37,0.0,0.0,1.0,37,700,500,200,0.7142857142857143,9,5,4,370.78385603938204,0.43096221221221226,0.17510239403662142,0.22446823922999948,132581.84700963707,2431.841695011325,135013.6887046484,1728,7,304.64864864864865,34,3,20,32.98318113512887,0.6504289215686274,42.5297619047619,1029.8809523809516,30.290616246498576,0
3468,4,0,0,37,0.0,0.0,1.0,37,1250,800,450,0.64,17,8,9,367.4013900799847,0.43002377377377377,0.17468901433781303,0.22333050790255238,132735.14739229012,2353.4155328798015,135088.5629251699,1729,8,305.64864864864865,34,3,16,32.915992760320385,0.6519607843137255,42.38095238095237,1030.4761904761895,30.30812324929969,0
3469,4,0,1,36,0.0,0.02702702702702703,0.972972972972973,37,1200,800,400,0.6666666666666666,16,8,8,372.7415749978148,0.4295858358358358,0.20033903161111644,0.21097173144876333,130004.05811216633,2291.5834753672707,132295.6415875336,1730,9,306.64864864864865,36,1,16,35.54181389870436,0.6203703703703703,45.04504504504505,1019.8198198198206,28.32832832832835,8
3470,4,0,1,35,0.0,0.027777777777777776,0.9722222222222222,36,1000,700,300,0.7,13,7,6,375.753024351334,0.4300429894179894,0.18727069858920564,0.21295893270792957,130055.90284475725,2573.7797657321507,132629.6826104894,1731,10,300.44444444444446,35,1,17,35.41229339233707,0.6229166666666667,44.994212962962955,1020.0231481481471,29.14351851851849,0
3471,4,1,0,36,0.027777777777777776,0.0,1.0,36,1100,800,300,0.7272727272727273,14,8,6,370.42099002422606,0.43192791005291004,0.16287054311774485,0.21121877729040958,130292.9705215419,2452.814326765938,132745.78484830784,1732,0,283.77777777777777,34,2,19,35.307349968905484,0.6274509803921569,44.76190476190476,1020.9523809523805,30.02801120448178,0
3472,4,0,1,35,0.0,0.027777777777777776,0.9722222222222222,36,1550,1300,250,0.8387096774193549,18,13,5,371.00574444314503,0.43154761904761907,0.1590903206597014,0.21271491680397567,130505.75573979599,2483.6770124716604,132989.43275226766,1733,1,284.77777777777777,34,2,16,35.076362188822856,0.6295955882352942,44.55357142857143,1021.7857142857149,30.052521008403378,0
3473,4,0,0,35,0.0,0.0,1.0,35,1000,500,500,0.5,15,5,10,380.29720269639097,0.4295868347338936,0.1766869123887178,0.2183847147256532,130566.58340419501,2930.8212868480746,133497.40469104308,1734,2,292.2857142857143,34,1,17,34.777227722772295,0.6302083333333333,44.49404761904762,1022.0238095238095,30.05952380952381,0
3474,4,1,1,35,0.027777777777777776,0.027777777777777776,0.9722222222222222,36,1250,1100,150,0.88,14,11,3,378.55903624606634,0.4305059523809524,0.20379892266546173,0.22053119892965378,131120.59709630057,2727.3773737568617,133847.97447005744,1735,0,285.1388888888889,35,1,18,34.25963856556298,0.6336309523809525,43.9525462962963,1024.1898148148148,29.262566137566136,0
3475,4,0,0,35,0.0,0.0,1.0,35,700,200,500,0.2857142857142857,12,2,10,385.1946998377502,0.4266456582633053,0.21338870431893708,0.22382935260842235,131023.24263038543,3093.8917233560023,134117.13435374142,1736,1,294.2,34,1,18,34.18846899224806,0.6348039215686274,44.047619047619044,1023.8095238095233,30.112044817927156,0
3476,4,0,0,35,0.0,0.0,1.0,35,1250,900,350,0.72,16,9,7,377.14747720430825,0.4255252100840336,0.18537671995750404,0.21610161631974714,130481.607509732,2849.3365636696008,133330.9440734016,1737,2,295.2,33,2,20,34.943999640158324,0.6316287878787878,44.57720588235295,1021.6911764705895,30.960338680926956,8
3477,4,0,0,35,0.0,0.0,1.0,35,1050,700,350,0.6666666666666666,14,7,7,379.2452247661678,0.42556022408963584,0.18876389102926283,0.21836044929083093,130669.48596993955,2911.155715349875,133580.64168528942,1738,3,296.2,33,2,18,34.69962343681329,0.6335227272727273,44.39338235294118,1022.4264705882362,30.98262032085564,0
3478,4,0,0,35,0.0,0.0,1.0,35,900,700,200,0.7777777777777778,11,7,4,378.8283505692483,0.42573529411764705,0.1847523193317584,0.21865155005884832,130763.47588667825,2907.382376970402,133670.85826364864,1739,4,297.2,33,2,18,34.61488537423117,0.634469696969697,44.3014705882353,1022.7941176470592,30.993761140819977,0
3479,4,0,0,35,0.0,0.0,1.0,35,800,400,400,0.5,12,4,8,380.8228040928751,0.42573529411764705,0.1834759394893557,0.2201598870198978,130826.15460399858,2964.3166089965575,133790.47121299515,1740,5,298.2,33,2,18,34.5002795080658,0.6351010101010102,44.24019607843138,1023.0392156862755,31.00118835412956,0
3480,4,1,0,36,0.027777777777777776,0.0,1.0,36,550,300,250,0.5454545454545454,8,3,5,372.2117019026165,0.42686838624338624,0.18377483443708575,0.21748989261886092,131236.62308673473,2569.5613662131545,133806.1844529479,1741,0,290.8888888888889,34,2,19,34.304684171798144,0.6369485294117647,43.839285714285715,1024.6428571428576,30.136554621848752,0
3481,4,0,1,35,0.0,0.027777777777777776,0.9722222222222222,36,1250,900,350,0.72,16,9,7,373.1244629519465,0.4261078042328042,0.18970189701897033,0.21854432830042583,131328.12500000003,2600.3472222222235,133928.47222222225,1742,1,291.8888888888889,34,2,20,34.188685636856356,0.6378676470588236,43.75,1025.0000000000002,30.14705882352942,0
3482,4,0,0,35,0.0,0.0,1.0,35,600,300,300,0.5,9,3,6,377.08266268990735,0.4260504201680672,0.18030911109213554,0.22104390142964778,131359.53006355723,2906.6802732122114,134266.21033676944,1743,2,290.8857142857143,33,2,20,34.05546423590355,0.6404671717171717,43.71936274509803,1025.1225490196073,31.064319667260825,0
3483,4,2,0,37,0.05405405405405406,0.0,1.0,37,1150,900,250,0.782608695652174,14,9,5,367.31976562796166,0.429710960960961,0.1972571400756904,0.21989681926137533,132159.87761488336,2308.9870541838036,134468.86466906717,1744,0,276.1081081081081,35,2,21,33.497486117364545,0.644047619047619,42.93981481481481,1028.2407407407402,29.378306878306862,0
3484,4,0,0,37,0.0,0.0,1.0,37,950,500,450,0.5263157894736842,14,5,9,368.0525568308405,0.42927302302302306,0.20050113119420043,0.2210304814265209,132278.91375171463,2337.1184842249554,134616.03223593958,1745,1,277.1081081081081,35,2,21,33.35864836483648,0.6452380952380952,42.82407407407407,1028.7037037037032,29.39153439153438,0
3485,4,0,0,37,0.0,0.0,1.0,37,1250,1200,50,0.96,13,12,1,371.48973273356347,0.42936686686686687,0.20361130187979737,0.22415398120300617,132457.5684263545,2441.3253386488177,134898.8937650033,1746,2,278.1081081081081,35,2,21,33.09019188966343,0.6470238095238094,42.650462962962955,1029.3981481481474,29.41137566137564,0
3486,4,0,0,37,0.0,0.0,1.0,37,700,400,300,0.5714285714285714,10,4,6,374.0608696362929,0.4286786786786787,0.20855496386574313,0.22624198213148164,132546.94097490126,2516.1248017403777,135063.06577664163,1747,3,279.1081081081081,35,2,21,32.93397118879023,0.6479166666666667,42.5636574074074,1029.745370370369,29.42129629629626,0
3487,4,0,0,37,0.0,0.0,1.0,37,1100,700,400,0.6363636363636364,15,7,8,379.8609783452152,0.428272022022022,0.21157051895171253,0.2304800660020967,132666.15125868047,2678.9388020833276,135345.0900607638,1748,4,280.1081081081081,35,2,18,32.664518031681844,0.6491071428571429,42.447916666666664,1030.2083333333328,29.434523809523796,0
3488,4,0,2,35,0.0,0.05405405405405406,0.9459459459459459,37,1350,800,550,0.5925925925925926,19,8,11,396.94964493337466,0.4273335835835836,0.20984433288066828,0.2278157666276266,130544.21864487226,2982.071161031827,133526.2898059041,1749,5,281.1081081081081,33,4,19,34.37450033976897,0.632260101010101,44.515931372549026,1021.9362745098048,30.967765894236507,8
3489,4,0,0,35,0.0,0.0,1.0,35,900,500,400,0.5555555555555556,13,5,8,403.57159931223214,0.42538515406162464,0.21558826644074958,0.23166727126476683,130552.75769054198,3537.4770431588886,134090.23473370087,1750,6,286.8285714285714,32,3,19,34.1966271312083,0.634765625,44.50757575757577,1021.9696969696987,31.936553030303084,0
3490,4,0,0,35,0.0,0.0,1.0,35,750,600,150,0.8,9,6,3,396.11170383918477,0.4251050420168067,0.16413874191652011,0.21390032007315946,128144.53124999977,3212.207300275454,131356.73855027521,1751,7,287.8285714285714,31,4,18,36.84842249657065,0.6129032258064516,46.874999999999986,1012.4999999999982,32.661290322580584,8
3491,4,1,0,36,0.027777777777777776,0.0,1.0,36,1100,900,200,0.8181818181818182,13,9,4,384.25391856834926,0.4259259259259259,0.16669779604034374,0.20950055804632806,128528.34093778691,2677.5037304866783,131205.84466827358,1752,0,280.80555555555554,32,4,19,36.75522973477772,0.6142578125,46.49621212121212,1014.0151515151512,31.687973484848474,0
3492,4,0,0,36,0.0,0.0,1.0,36,650,500,150,0.7692307692307693,8,5,3,384.69068073830346,0.4258267195767196,0.16930130279644828,0.21024523326881156,128624.38303489437,2696.1202938475612,131320.50332874194,1753,1,281.80555555555554,32,4,19,36.64581777445854,0.615234375,46.40151515151515,1014.3939393939393,31.699810606060602,0
3493,4,2,0,38,0.05263157894736842,0.0,1.0,38,900,700,200,0.7777777777777778,11,7,4,369.4950792885581,0.427868658131816,0.1868354478534613,0.20571285400230147,129357.17520004297,1960.6592637307836,131317.83446377376,1754,0,267.92105263157896,33,5,21,36.28315363610811,0.6202651515151515,45.680147058823515,1017.2794117647036,30.826648841354654,0
3494,4,0,0,38,0.0,0.0,1.0,38,1000,800,200,0.8,12,8,4,369.28886329112026,0.4277649359886202,0.19113089768370384,0.2062504377695189,129481.8718311463,1963.2426530660803,131445.1144842124,1755,1,268.92105263157896,33,5,16,36.16132349989966,0.6215277777777778,45.55759803921566,1017.7696078431343,30.841503267973767,0
3495,4,0,1,37,0.0,0.02631578947368421,0.9736842105263158,38,1300,900,400,0.6923076923076923,17,9,8,372.15133782533366,0.42816500711237554,0.19805560833491676,0.20867595258626973,129637.82709775066,2048.978157439421,131686.8052551901,1756,2,269.92105263157896,33,5,16,35.929602888086634,0.6231060606060606,45.40441176470587,1018.3823529411748,30.86007130124772,0
3496,4,1,0,38,0.02631578947368421,0.0,1.0,38,1200,900,300,0.75,15,9,6,369.37126839544555,0.4281353722143196,0.2029166640299198,0.2082753111352487,129856.32216274976,1993.0388852844878,131849.36104803425,1757,0,270.8421052631579,33,5,17,35.77799987976433,0.6253156565656566,45.18995098039215,1019.2401960784302,30.88606654783122,0
3497,4,0,0,38,0.0,0.0,1.0,38,1400,1100,300,0.7857142857142857,17,11,6,367.5402622922807,0.4273500474158369,0.19315445476436177,0.20827281529895883,130049.9999999998,1959.7222222221928,132009.722222222,1758,1,271.8421052631579,34,4,17,35.62772331154683,0.625,44.999999999999986,1019.9999999999984,29.999999999999954,0
3498,4,0,0,38,0.0,0.0,1.0,38,750,400,350,0.5333333333333333,11,4,7,368.15354095383105,0.42726114272166904,0.19514217281827695,0.2089454202632004,130110.72137188182,1980.144557823098,132090.86592970492,1759,2,272.8421052631579,34,4,18,35.55036950602879,0.6256127450980392,44.940476190476176,1020.2380952380931,30.007002801120386,0
3499,4,0,0,38,0.0,0.0,1.0,38,850,600,250,0.7058823529411765,11,6,5,368.92746032033665,0.42666844476055,0.1941733269492838,0.21003878119432692,130232.2066326529,2009.2474489795732,132241.4540816325,1760,3,273.8421052631579,34,4,19,35.40719034289714,0.6268382352941176,44.82142857142856,1020.7142857142844,30.021008403361307,0
3500,4,1,1,38,0.02564102564102564,0.02564102564102564,0.9743589743589743,39,800,500,300,0.625,11,5,6,361.6817538412171,0.4268724696356276,0.19150874363454418,0.20769483991483934,130566.58340419493,1644.7137188208494,132211.29712301577,1761,0,267.79487179487177,34,5,16,35.25286352164628,0.6302083333333333,44.49404761904761,1022.0238095238088,30.05952380952379,0
3501,4,0,0,38,0.0,0.0,1.0,38,700,600,100,0.8571428571428571,8,6,2,370.8274080886956,0.4261942863916548,0.1967986717423278,0.21248028187185286,130481.60750973206,2077.231263216101,132558.83877294816,1762,5,275.8421052631579,33,5,20,35.10542861141099,0.6316287878787878,44.577205882352956,1021.69117647059,30.96033868092697,0
3502,4,0,0,38,0.0,0.0,1.0,38,850,700,150,0.8235294117647058,10,7,3,374.0088230589598,0.42569049312470364,0.19818418212457578,0.21464966107974315,130544.21864487231,2164.9379145040502,132709.15655937637,1763,6,276.8421052631579,33,5,17,34.96060179078225,0.632260101010101,44.515931372549026,1021.9362745098051,30.967765894236518,0
3503,4,0,1,37,0.0,0.02631578947368421,0.9736842105263158,38,950,800,150,0.8421052631578947,11,8,3,369.3970785367633,0.42502370791844474,0.1921096796174082,0.21251796063128833,130638.16350682439,2051.471188965793,132689.63469579018,1764,7,277.8421052631579,33,5,17,34.983117557739945,0.6332070707070707,44.42401960784314,1022.3039215686282,30.978906714200853,0
3504,4,1,0,38,0.02631578947368421,0.0,1.0,38,1400,1000,400,0.7142857142857143,18,10,8,359.01444655193103,0.42391239924134666,0.16738457396688622,0.20894737951554224,131084.19075963736,1812.2236394558026,132896.41439909316,1765,0,267.57894736842104,34,4,18,34.79689800821515,0.6354166666666667,43.98809523809525,1024.0476190476204,30.11904761904766,0
3505,4,0,1,37,0.0,0.02631578947368421,0.9736842105263158,38,1050,800,250,0.7619047619047619,13,8,5,357.17383201329915,0.4239568515884305,0.16665239176052404,0.20804106139542428,131114.67013888905,1766.145833333353,132880.8159722224,1766,1,268.57894736842104,34,4,18,34.81319500949281,0.6357230392156863,43.95833333333334,1024.166666666668,30.122549019607884,0
3506,4,0,1,36,0.0,0.02702702702702703,0.972972972972973,37,1000,800,200,0.8,12,8,4,365.201386551223,0.4230480480480481,0.17053290724903936,0.21250855055863657,131077.01965590165,2173.901864667446,133250.9215205691,1767,2,276.4594594594595,33,4,18,34.645763523216836,0.6376262626262627,43.99509803921569,1024.019607843138,31.030897207367815,0
3507,4,0,1,35,0.0,0.027777777777777776,0.9722222222222222,36,900,600,300,0.6666666666666666,12,6,6,376.2357186541085,0.4199900793650793,0.18148947837411789,0.21796929947759452,130907.84940631049,2650.4417597693996,133558.2911660799,1768,3,284.8611111111111,32,4,18,34.53475221056961,0.6383463541666667,44.16035353535353,1023.3585858585851,31.979955808080785,0
3508,4,1,0,36,0.027777777777777776,0.0,1.0,36,800,700,100,0.875,9,7,2,371.4720074030011,0.4204861111111111,0.17795844625112922,0.21757646147890033,131328.12499999977,2556.9444444444157,133885.06944444418,1769,0,280.1388888888889,32,4,20,34.23102981029811,0.642578125,43.749999999999986,1024.9999999999982,32.03124999999994,0
3509,4,0,0,36,0.0,0.0,1.0,36,1100,600,500,0.5454545454545454,16,6,10,372.6114595141433,0.42003968253968255,0.17794123681726792,0.21916892727251175,131489.9488094327,2598.932347464543,134088.88115689726,1770,1,281.1388888888889,32,4,20,34.038122204440064,0.6442057291666667,43.592171717171716,1025.6313131313132,32.050978535353536,0
3510,4,0,0,36,0.0,0.0,1.0,36,950,700,250,0.7368421052631579,12,7,5,377.7236148745251,0.4194609788359788,0.1874333743337433,0.22350021753492647,131716.66953627186,2750.499311294773,134467.16884756665,1771,2,282.1388888888889,32,4,17,33.67773677736778,0.646484375,43.371212121212125,1026.515151515152,32.0785984848485,0
3511,4,0,0,36,0.0,0.0,1.0,36,800,600,200,0.75,10,6,4,377.7320998198386,0.4195436507936508,0.1790339768023277,0.2240769633723376,131813.89534550055,2758.0678948576765,134571.96324035822,1772,3,283.1388888888889,32,4,17,33.57924505102669,0.6474609375,43.276515151515156,1026.89393939394,32.09043560606062,0
3512,4,0,1,35,0.0,0.027777777777777776,0.9722222222222222,36,900,700,200,0.7777777777777778,11,7,4,376.0028628362093,0.41929563492063493,0.1769501802687643,0.2236227552657454,131911.15702479336,2719.794536271805,134630.95156106516,1773,4,284.1388888888889,32,4,17,33.52538102261555,0.6484375,43.18181818181818,1027.272727272727,32.10227272727272,0
3513,4,0,0,35,0.0,0.0,1.0,35,800,700,100,0.875,9,7,2,384.6889074838885,0.41768207282913167,0.18548781592535546,0.2278942175439867,131762.23966810448,3137.494405110687,134899.73407321516,1774,5,293.0285714285714,31,4,18,33.45289050940604,0.6495295698924731,43.32682291666667,1026.6927083333342,33.11911962365594,0
3514,4,0,0,35,0.0,0.0,1.0,35,900,700,200,0.7777777777777778,11,7,4,381.75547491570563,0.4167016806722689,0.18585551330798467,0.2271531445765398,131929.3975830078,3072.9539659288193,135002.35154893663,1775,6,294.0285714285714,31,4,18,33.359209970426704,0.6512096774193548,43.1640625,1027.34375,33.140120967741936,0
3515,4,0,0,35,0.0,0.0,1.0,35,600,500,100,0.8333333333333334,7,5,2,386.58327112381716,0.41673669467787117,0.12902008260931552,0.20959082212820998,128304.3822058973,2920.065554535249,131224.44776043255,1776,7,295.0285714285714,32,3,20,36.92568128946495,0.6119791666666667,46.717171717171716,1013.1313131313127,31.660353535353522,8
3516,4,1,0,36,0.027777777777777776,0.0,1.0,36,850,600,250,0.7058823529411765,11,6,5,377.831841429529,0.41957671957671955,0.13683550079854,0.2067461873889671,128672.41753472229,2523.307291666675,131195.72482638896,1777,0,287.80555555555554,33,3,15,36.77061943874058,0.6133207070707071,46.35416666666667,1014.5833333333339,30.744949494949513,0
3517,4,0,1,35,0.0,0.027777777777777776,0.9722222222222222,36,850,700,150,0.8235294117647058,10,7,3,367.70664821802444,0.41884920634920636,0.07209010757906675,0.1955250448137393,127524.87775134572,2266.239697472135,129791.11744881785,1778,1,288.80555555555554,33,3,17,38.202701609641665,0.6016414141414141,47.48774509803922,1010.0490196078438,30.60754604872254,8
3518,4,3,0,38,0.07894736842105263,0.0,1.0,38,1200,900,300,0.75,15,9,6,368.0396916512053,0.42472735893788527,0.10440496909320052,0.20198423628166912,128789.87295310368,1881.4588521123273,130671.331805216,1275,0,227.73684210526315,35,3,17,36.89899277841125,0.6101190476190477,46.23842592592593,1015.0462962962972,29.00132275132278,0
3519,4,0,0,38,0.0,0.0,1.0,38,850,500,350,0.5882352941176471,12,5,7,366.84382434426453,0.42407539118065435,0.09723446355714072,0.20182005882319914,128886.73460200064,1856.260525728433,130742.99512772907,1276,1,228.73684210526315,36,2,17,36.83043140734169,0.6090856481481481,46.14301801801802,1015.4279279279278,28.206331331331327,0
3520,4,0,1,37,0.0,0.02631578947368421,0.9736842105263158,38,1100,800,300,0.7272727272727273,14,8,6,367.16542519308234,0.42410502607871026,0.09782773634018493,0.20214272310080705,128915.32368517175,1866.6499269539918,130781.97361212574,1277,2,229.73684210526315,36,2,17,36.79308050565535,0.609375,46.11486486486487,1015.5405405405413,28.20945945945948,0
3521,4,0,1,36,0.0,0.02702702702702703,0.972972972972973,37,1150,700,450,0.6086956521739131,16,7,9,370.225351143887,0.4216403903903904,0.1021746698254169,0.2036355489395184,128877.99968117704,2142.7805373370984,131020.78021851413,1278,3,236.83783783783784,35,2,18,36.75350982180174,0.6110119047619047,46.15162037037037,1015.3935185185179,29.01124338624337,0
3522,4,1,1,36,0.02702702702702703,0.02702702702702703,0.972972972972973,37,550,200,350,0.36363636363636365,9,2,7,368.1776023694149,0.42373623623623624,0.09951685763466589,0.20311092495263064,128995.5488709919,2098.6543799296915,131094.2032509216,1279,0,233.21621621621622,35,2,19,36.68548953704759,0.6122023809523809,46.035879629629626,1015.8564814814811,29.024470899470888,0
3523,4,0,0,36,0.0,0.0,1.0,36,900,700,200,0.7777777777777778,11,7,4,370.1962581481622,0.4249834656084656,0.08585110959285402,0.20498509073500404,129142.56071030533,2361.618548525391,131504.17925883073,1280,1,235.16666666666666,35,1,20,36.48419114856146,0.6136904761904762,45.89120370370371,1016.4351851851861,29.04100529100532,0
3524,4,0,2,34,0.0,0.05555555555555555,0.9444444444444444,36,750,700,50,0.9333333333333333,8,7,1,360.37511214765874,0.42547949735449736,0.0554442150154526,0.19031227057804145,127246.52364775525,2016.6546279534628,129263.17827570872,1281,2,236.16666666666666,33,3,19,38.673503988015696,0.598800505050505,47.763480392156836,1008.9460784313692,30.57412358882937,7
3525,4,2,1,35,0.05555555555555555,0.027777777777777776,0.9722222222222222,36,1200,800,400,0.6666666666666666,16,8,8,360.78463838278185,0.4268022486772487,0.09175288285375593,0.1927300322138071,127710.61610918865,2015.2056901191709,129725.82179930781,1282,0,236.88888888888889,33,3,19,38.187035240866464,0.6035353535353536,47.303921568627445,1010.7843137254893,30.62982768865119,0
3526,4,0,0,35,0.0,0.0,1.0,35,800,700,100,0.875,9,7,2,370.43196768224266,0.42170868347338936,0.09220827903821771,0.19750613173624176,127633.67776566168,2455.918879451076,130089.59664511275,1283,1,244.65714285714284,32,3,19,38.0222000083302,0.6051432291666667,47.380050505050505,1010.4797979797981,31.577493686868692,0
3527,4,0,0,35,0.0,0.0,1.0,35,1300,1000,300,0.7692307692307693,16,10,6,367.4091860219588,0.42170868347338936,0.0868008948545862,0.19662295002422742,127783.17920918339,2389.7427721088075,130172.9219812922,1284,2,245.65714285714284,34,1,20,37.94521959260565,0.6020220588235294,47.23214285714284,1011.0714285714263,29.737394957983128,0
3528,4,1,0,36,0.027777777777777776,0.0,1.0,36,1100,900,200,0.8181818181818182,13,9,4,360.18530231114437,0.42569444444444443,0.07961099677312888,0.19421582330537995,128085.94419795928,2026.934906550045,130112.87910450932,1285,0,239.80555555555554,35,1,21,37.817764311304224,0.6029761904761906,46.93287037037036,1012.2685185185164,28.921957671957614,0
3529,4,2,2,36,0.05263157894736842,0.05263157894736842,0.9473684210526316,38,900,600,300,0.6666666666666666,12,6,6,347.8953826174586,0.4324027975343765,0.08964660110234535,0.1903652262187666,128672.41753472213,1352.9347779492393,130025.35231267137,1286,0,228.1315789473684,35,3,18,37.52994524298427,0.6089285714285715,46.354166666666664,1014.5833333333326,28.988095238095216,0
3530,4,1,0,37,0.02702702702702703,0.0,1.0,37,1200,800,400,0.6666666666666666,16,8,8,357.99954212921597,0.4269894894894895,0.0925160669569618,0.19560523611100034,128613.70991940991,1808.7298525376948,130422.43977194761,1287,0,235.24324324324326,35,2,19,37.333599574014904,0.6083333333333334,46.412037037037024,1014.3518518518499,28.981481481481428,0
3531,4,1,0,38,0.02631578947368421,0.0,1.0,38,700,400,300,0.5714285714285714,10,4,6,350.6474320311406,0.42801683262209583,0.0949311687023302,0.19318809954116423,128943.91593874284,1442.770599991889,130386.68653873472,1288,0,230.02631578947367,36,2,20,37.183307462024615,0.6096643518518519,46.086711711711715,1015.6531531531534,28.212587587587596,0
3532,4,0,1,37,0.0,0.02631578947368421,0.9736842105263158,38,1200,900,300,0.75,15,9,6,351.7481750792215,0.42800201517306785,0.08899659387831282,0.1944960497496871,129086.9247626004,1481.2180423666864,130568.1428049671,1289,1,231.02631578947367,36,2,21,37.009640957446805,0.6111111111111112,45.945945945945944,1016.2162162162159,28.228228228228218,0
3533,4,2,1,38,0.05128205128205128,0.02564102564102564,0.9743589743589743,39,950,600,350,0.631578947368421,13,6,7,335.99926718883347,0.43106162843004947,0.0851845052322382,0.1884294169531258,129643.02722318663,912.093881430687,130555.12110461731,1290,0,221.4102564102564,35,4,19,36.844740879645414,0.61875,45.39930555555555,1018.4027777777769,29.097222222222197,0
3534,4,0,0,38,0.0,0.0,1.0,38,800,400,400,0.5,12,4,8,358.1189363121901,0.42806128496917967,0.09118466714193962,0.18566897609267524,126496.5699440995,1518.0940671104645,128014.66401120996,1291,1,228.23684210526315,36,2,16,39.50147393559461,0.5847800925925926,48.50788288288288,1005.9684684684684,27.943568568568566,8
3535,4,1,1,38,0.02564102564102564,0.02564102564102564,0.9743589743589743,39,1300,1100,200,0.8461538461538461,15,11,4,356.93144453003754,0.43106162843004947,0.11323112628595644,0.18726677158219782,126981.47506925209,1264.7362650046189,128246.2113342567,1292,0,223.35897435897436,37,2,17,39.032582680591815,0.5878378378378378,48.026315789473685,1007.8947368421054,27.240398293029877,0
3536,4,2,0,40,0.05,0.0,1.0,40,1200,800,400,0.6666666666666666,16,8,8,335.57362118401056,0.43456196581196577,0.11622077922077922,0.1704430661686599,125651.88937717033,433.0919053819643,126084.9812825523,1293,0,218.675,39,1,16,40.93777056277057,0.5707799145299146,49.34895833333334,1002.6041666666682,25.707799145299184,8
3537,4,0,1,39,0.0,0.025,0.975,40,1200,600,600,0.5,18,6,12,332.62151457827474,0.43357371794871796,0.11564673518114787,0.16980090354703356,125860.85205078142,372.8054470486257,126233.65749783005,1294,1,219.675,39,1,16,40.79650247413404,0.5729166666666667,49.14062500000001,1003.4375000000014,25.729166666666703,0
3538,4,2,1,40,0.04878048780487805,0.024390243902439025,0.975609756097561,41,950,600,350,0.631578947368421,13,6,7,330.2014911739654,0.43597560975609756,0.15195073943902182,0.17072495952342212,126384.01828342021,146.57118055556566,126530.58946397578,1295,0,215.1219512195122,39,2,14,40.319179702337784,0.5782585470085471,48.61979166666667,1005.520833333334,25.78258547008549,0
3539,4,2,0,42,0.047619047619047616,0.0,1.0,42,700,300,400,0.42857142857142855,11,3,8,324.2757589790578,0.4389638985675571,0.18132939509641477,0.1698464949961627,126912.74957242723,-169.05436165640688,126743.69521077082,1296,0,210.73809523809524,40,2,17,39.9258278702303,0.58203125,48.09451219512196,1007.621951219513,25.190548780487823,0
3540,4,1,0,43,0.023255813953488372,0.0,1.0,43,1050,800,250,0.7619047619047619,13,8,5,318.5656416448325,0.4412144702842377,0.1756145356041614,0.16802776000482353,127197.07031250012,-495.6237038551636,126701.44660864495,1297,0,206.8139534883721,39,4,19,39.77867272476941,0.5865384615384616,47.81250000000001,1008.7500000000009,25.865384615384638,0
3541,4,1,0,44,0.022727272727272728,0.0,1.0,44,1250,1000,250,0.8,15,10,5,320.44601761863174,0.4438975510923185,0.17972587328156275,0.17040732847038953,127527.89680621652,-626.8386666336175,126901.0581395829,1298,0,203.0909090909091,40,4,13,39.39300566790757,0.58828125,47.484756097560975,1010.060975609756,25.2515243902439,0
3542,4,2,1,45,0.043478260869565216,0.021739130434782608,0.9782608695652174,46,1050,700,350,0.6666666666666666,14,7,7,310.96416890375934,0.4450986312399356,0.19105339165393898,0.16771516120483076,128095.48071217161,-1233.3790600024142,126862.1016521692,1299,0,195.2173913043478,42,4,15,39.05367569637219,0.5910218253968254,46.9234496124031,1012.3062015503865,24.102528608342535,0
3543,4,1,3,43,0.021739130434782608,0.06521739130434782,0.9347826086956522,46,1150,800,350,0.6956521739130435,15,8,7,319.1379188926838,0.4459742351046699,0.15286363868594544,0.17298494839342238,128295.2451814055,-988.2930816774499,127306.95209972805,1300,0,196.1304347826087,41,5,17,38.64326282804545,0.5945121951219512,46.72619047619046,1013.0952380952349,24.709639953542315,8
3544,4,0,1,42,0.0,0.023255813953488372,0.9767441860465116,43,1150,900,250,0.782608695652174,14,9,5,331.0978242569804,0.43943798449612403,0.181747694784004,0.17891363616349265,128171.57594601512,-112.53401453721008,128059.04193147791,1301,1,210.46511627906978,38,5,18,38.46649257930646,0.5981359649122807,46.8482905982906,1012.6068376068381,26.647548358074687,0
3545,4,0,0,42,0.0,0.0,1.0,42,1400,1200,200,0.8571428571428571,16,12,4,335.8436148053199,0.4372338366240805,0.18089210367691422,0.18172359979191954,128225.67389875079,212.75476660092136,128438.4286653517,1302,2,216.4047619047619,38,4,19,38.29113924050634,0.5986842105263157,46.794871794871796,1012.8205128205126,26.65317139001349,0
3546,4,0,0,42,0.0,0.0,1.0,42,1100,700,400,0.6363636363636364,15,7,8,334.5667750876642,0.43667731320170344,0.17692130082769975,0.18189312293734478,128415.10662073545,192.68561892759075,128607.79223966303,1303,3,217.4047619047619,38,4,14,38.130248410105075,0.6006030701754386,46.607905982905976,1013.5683760683746,26.67285200179933,0
3547,4,1,1,42,0.023255813953488372,0.023255813953488372,0.9767441860465116,43,1050,600,450,0.5714285714285714,15,6,9,329.39136812077203,0.4377076411960133,0.18547370832856003,0.1807201289959909,128778.12499999985,-116.31944444446054,128661.80555555539,1304,0,213.32558139534885,39,4,16,37.891694033935394,0.6025641025641026,46.24999999999999,1014.9999999999989,26.025641025640997,0
3548,4,1,1,42,0.023255813953488372,0.023255813953488372,0.9767441860465116,43,1300,1100,200,0.8461538461538461,15,11,4,326.43881454845115,0.4371308600959764,0.18795507247759824,0.1795781921116421,128883.87586805534,-185.46006944446913,128698.41579861088,1305,0,214.2093023255814,39,4,17,37.859048009848166,0.6036324786324787,46.14583333333332,1015.4166666666649,26.03632478632474,0
3549,4,0,0,42,0.0,0.0,1.0,42,950,500,450,0.5263157894736842,14,5,9,331.198372709624,0.4360361014324429,0.18825610648384816,0.18191022760039535,128821.50472094351,133.09454671630462,128954.59926765983,1306,1,220.16666666666666,38,4,17,37.801690872097076,0.6047149122807017,46.20726495726494,1015.1709401709377,26.715024741340464,0
3550,4,0,0,42,0.0,0.0,1.0,42,1250,1100,150,0.88,14,11,3,333.8753416072448,0.4348262679055362,0.1908267724422541,0.18413496218107187,128984.24373584603,212.93168785152645,129197.17542369755,1307,2,221.16666666666666,38,4,17,37.568144369653595,0.606359649122807,46.04700854700853,1015.8119658119637,26.73189383715694,0
3551,4,1,0,43,0.023255813953488372,0.0,1.0,43,950,600,350,0.631578947368421,13,6,7,325.73023353630043,0.4356312292358804,0.19306013104137132,0.1815055011097826,129391.54071015025,-170.47001698446758,129221.07069316578,1308,0,217.0,38,5,18,37.3613007105604,0.6104714912280702,45.64636752136751,1017.414529914528,26.774066576698104,0
3552,4,1,0,44,0.022727272727272728,0.0,1.0,44,1250,900,350,0.72,16,9,7,319.2257657917241,0.43557302677942217,0.19470525895006974,0.17930550049840693,129704.91672091994,-518.9697265625188,129185.94699435742,1309,0,213.04545454545453,39,5,16,37.20909176125713,0.6119123931623931,45.33854166666666,1018.6458333333317,26.11912393162389,0
3553,4,0,0,44,0.0,0.0,1.0,44,1000,700,300,0.7,13,7,6,316.7548202849083,0.4347141472868217,0.1915480830236569,0.1786867743227011,129873.8401827614,-572.3670186397147,129301.47316412168,1310,1,214.04545454545453,40,4,16,37.100988700564976,0.6119791666666667,45.17276422764227,1019.3089430894294,25.482723577235735,0
3554,4,1,0,45,0.022222222222222223,0.0,1.0,45,1350,700,650,0.5185185185185185,20,7,13,314.1404044105115,0.43514309764309766,0.2050012469110618,0.17923191175971073,130315.76063368043,-811.3489678866019,129504.41166579383,1311,0,210.26666666666668,39,6,17,36.72082228116713,0.6180555555555556,44.73958333333333,1021.0416666666656,26.18055555555553,0
3555,4,0,2,43,0.0,0.044444444444444446,0.9555555555555556,45,1050,600,450,0.5714285714285714,15,6,9,316.91393044523454,0.4346590909090909,0.21201182828591847,0.1814346127189967,130448.74267578112,-731.7952473958466,129716.94742838528,1312,1,211.26666666666668,39,6,17,36.51569032323849,0.6193910256410257,44.60937499999999,1021.562499999999,26.19391025641023,0
3556,4,0,0,43,0.0,0.0,1.0,43,1450,1100,350,0.7586206896551724,18,11,7,332.30316295729267,0.43154761904761907,0.207236751729013,0.18947181569475502,130290.57167830481,59.19381444290414,130349.76549274771,1313,2,221.2325581395349,37,6,17,36.28268982923425,0.6213400900900901,44.76425438596491,1020.9429824561399,27.593053579895674,0
3557,4,0,1,42,0.0,0.023255813953488372,0.9767441860465116,43,1500,1100,400,0.7333333333333333,19,11,8,331.09932599623994,0.43046327057954964,0.20794197153989602,0.18960371360214912,130458.54403518385,38.94720010002524,130497.49123528387,1314,3,222.2325581395349,37,6,19,36.14349665486029,0.6230292792792793,44.59978070175438,1021.600877192982,27.610834518729245,0
3558,4,0,0,42,0.0,0.0,1.0,42,1050,400,650,0.38095238095238093,17,4,13,328.74365803217387,0.42872870692992643,0.20436550505205275,0.18893639828458234,130598.6036568944,186.6925400123023,130785.2961969067,1315,4,225.0,37,5,15,36.062093256096674,0.6244369369369369,44.46271929824561,1022.1491228070173,27.625651967757225,0
3559,4,0,1,41,0.0,0.023809523809523808,0.9761904761904762,42,1050,700,350,0.6666666666666666,14,7,7,366.39106882085014,0.4283415602013163,0.152665418821315,0.19998290701821675,128572.46393352814,1111.7444952298629,129684.20842875801,1316,5,226.0,36,6,17,37.16295617736322,0.6059027777777778,46.4527027027027,1014.1891891891894,28.17192192192193,8
3560,4,1,0,42,0.023809523809523808,0.0,1.0,42,1100,700,400,0.6363636363636364,15,7,8,363.1444620979443,0.42968447541618277,0.18270165208940736,0.19964088233384555,128858.14868922984,958.8246185374637,129816.9733077673,1317,0,226.8095238095238,36,6,18,36.95351782017154,0.6087962962962963,46.171171171171174,1015.315315315316,28.20320320320322,0
3561,4,0,0,42,0.0,0.0,1.0,42,1450,1000,450,0.6896551724137931,19,10,9,363.1444620979443,0.42968447541618277,0.18270165208940736,0.19964088233384555,128858.14868922984,958.8246185374637,129816.9733077673,1318,1,227.8095238095238,36,6,18,36.95351782017154,0.6087962962962963,46.171171171171174,1015.315315315316,28.20320320320322,0
3562,4,1,1,42,0.023255813953488372,0.023255813953488372,0.9767441860465116,43,1350,1000,350,0.7407407407407407,17,10,7,357.5261003986953,0.43064784053156147,0.185500527955909,0.1985523177490912,129258.63997443412,643.124036198386,129901.7640106325,1319,0,223.48837209302326,36,7,19,36.687892211148025,0.6128472222222222,45.77702702702704,1016.8918918918937,28.246996996997048,0
3563,4,0,0,42,0.0,0.0,1.0,42,1450,900,550,0.6206896551724138,20,9,11,367.71392175074453,0.42944250871080136,0.1916218426854306,0.20498244046358885,129407.39300679443,1116.9799972136516,130524.37300400808,1320,1,229.16666666666666,35,7,19,36.2772769499109,0.6163690476190475,45.63078703703704,1017.4768518518521,29.070767195767203,0
3564,4,0,0,42,0.0,0.0,1.0,42,1000,500,500,0.5,15,5,10,364.7737200888642,0.42944250871080136,0.19151688560784508,0.20361087760611915,129459.11864144566,1044.6568612531637,130503.77550269883,1321,2,230.16666666666666,36,6,17,36.299380325329196,0.6148726851851851,45.579954954954964,1017.6801801801814,28.268893893893928,0
3565,4,0,0,42,0.0,0.0,1.0,42,1100,900,200,0.8181818181818182,13,9,4,365.1047389309276,0.4283657568718544,0.19324865852566808,0.2046895321855167,129631.08114448928,1065.7844077185478,130696.86555220782,1322,3,231.16666666666666,36,6,17,36.11587231376018,0.6166087962962963,45.411036036036045,1018.3558558558574,28.287662662662704,0
3566,4,0,0,42,0.0,0.0,1.0,42,1200,800,400,0.6666666666666666,16,8,8,368.5987481669104,0.4284020518776616,0.19759140803916897,0.20695069380320957,129688.42734203809,1160.5983940021179,130849.0257360402,1323,4,232.16666666666666,36,6,17,35.96853694490509,0.6171875,45.35472972972973,1018.581081081082,28.293918918918944,0
3567,4,0,0,42,0.0,0.0,1.0,42,650,300,350,0.46153846153846156,10,3,7,366.885384386984,0.4285956252419667,0.19432271886259622,0.20621488846578753,129731.44531250001,1119.314236111111,130850.75954861112,1324,5,233.16666666666666,37,5,17,35.968387866393996,0.6157094594594594,45.3125,1018.7500000000001,27.533783783783786,0
3568,4,0,0,42,0.0,0.0,1.0,42,1200,1000,200,0.8333333333333334,14,10,4,367.25396505261585,0.4280995934959349,0.19270216962524644,0.20701186204754804,129843.17440222,1137.0841268467302,130980.25852906673,1325,6,234.16666666666666,37,5,18,35.84532454724763,0.6168355855855856,45.202850877192986,1019.1885964912287,27.545637743006182,0
3569,4,0,0,42,0.0,0.0,1.0,42,850,600,250,0.7058823529411765,11,6,5,366.43299620449574,0.4276519550909795,0.19465015517930118,0.20699234500057095,129927.00277970133,1121.9081832871511,131048.91096298848,1326,7,235.16666666666666,37,5,18,35.78099232809923,0.6176801801801801,45.12061403508771,1019.5175438596483,27.554528212422927,0
3570,4,1,0,43,0.023255813953488372,0.0,1.0,43,1200,800,400,0.6666666666666666,16,8,8,339.2543542921803,0.4303940568475452,0.12619060174826657,0.1866806045810981,128895.01006319247,154.01866439673364,129049.0287275892,1327,0,230.67441860465115,37,6,16,37.52238329194111,0.6072635135135135,46.13486842105263,1015.4605263157891,27.444879089615924,8
3571,4,1,0,44,0.022727272727272728,0.0,1.0,44,600,300,300,0.5,9,3,6,330.53952204791005,0.4334038054968288,0.12147566044045299,0.18317318301024252,129174.23575726856,-260.5619703776812,128913.67378689088,1328,0,226.4090909090909,38,6,17,37.4597127342792,0.6082785087719298,45.86004273504273,1016.5598290598286,26.751574448942858,0
3572,4,0,0,44,0.0,0.0,1.0,44,1150,800,350,0.6956521739130435,15,8,7,329.54850846546645,0.43335976039464413,0.12481371087928483,0.18274962742175851,129201.38888888879,-284.3750000000093,128917.01388888877,1329,1,227.4090909090909,38,6,17,37.4573087431694,0.6085526315789473,45.83333333333333,1016.6666666666658,26.75438596491226,0
3573,4,0,1,43,0.0,0.022727272727272728,0.9772727272727273,44,1000,800,200,0.8,12,8,4,326.7808029083183,0.4334698731501057,0.12118347940654184,0.18196531025105278,129364.36760355011,-345.241617357024,129019.12598619309,1330,2,228.4090909090909,38,6,17,37.36216131064903,0.6101973684210527,45.67307692307691,1017.3076923076908,26.771255060728706,0
3574,4,0,0,43,0.0,0.0,1.0,43,1700,1400,300,0.8235294117647058,20,14,6,326.83571508368385,0.4319629014396456,0.1107701249345514,0.18266200741251246,129508.1314082215,-134.4234524084651,129373.70795581304,1331,3,232.62790697674419,37,6,13,37.21486857696864,0.6134572072072072,45.53179824561402,1017.8728070175417,27.510075865338965,0
3575,4,2,2,43,0.044444444444444446,0.044444444444444446,0.9555555555555556,45,1150,700,450,0.6086956521739131,16,7,9,332.6897014342517,0.43526936026936025,0.14892091817280528,0.1788667509187102,127968.81028163576,-485.2189429012427,127483.59133873452,1332,0,223.24444444444444,41,4,14,38.633178906428725,0.5912093495934959,47.04861111111111,1011.8055555555552,24.67818428184281,8
3576,4,1,0,44,0.022727272727272728,0.0,1.0,44,1400,900,500,0.6428571428571429,19,9,10,334.7762101579372,0.43489032769556024,0.15806635543993464,0.18055266640864612,128094.31295666391,-223.41427311667644,127870.89868354723,1333,0,228.9090909090909,41,3,16,38.45224095126093,0.592479674796748,46.92460317460316,1012.3015873015854,24.69028261711184,0
3577,4,3,0,47,0.06382978723404255,0.0,1.0,47,1350,1000,350,0.7407407407407407,17,10,7,339.04762948993425,0.4419904409497379,0.2295688319008029,0.17653859328613847,126672.22222222241,-733.6892164272947,125938.5330057951,1334,0,215.2340425531915,39,8,14,39.80063465783664,0.5811965811965811,48.33333333333334,1006.6666666666682,25.81196581196585,8
3578,4,0,0,47,0.0,0.0,1.0,47,900,600,300,0.6666666666666666,12,6,6,338.65392120560745,0.44181699044094974,0.22266143427189178,0.17667390481892128,126750.88026258702,-815.0634765624795,125935.81678602453,1335,1,216.2340425531915,39,8,14,39.72977224923278,0.5819978632478633,48.25520833333334,1006.9791666666683,25.819978632478676,0
3579,4,4,5,46,0.0784313725490196,0.09803921568627451,0.9019607843137255,51,1700,1200,500,0.7058823529411765,22,12,10,311.5889150494472,0.44998366013071894,0.22985080947074055,0.16627324660077078,127667.85483001056,-2243.10544168479,125424.74938832577,1336,0,200.19607843137254,41,10,14,39.47381875593075,0.588160569105691,47.34623015873015,1010.6150793650781,24.64914827719703,0
3580,4,2,1,47,0.041666666666666664,0.020833333333333332,0.9791666666666666,48,1400,900,500,0.6428571428571429,19,9,10,330.2998236331571,0.447621158392435,0.2321957671957673,0.17515899738121962,127415.40310650886,-1182.9429651545029,126232.46014135436,1337,0,212.72916666666666,38,10,15,39.25925925925926,0.5904605263157895,47.59615384615385,1009.6153846153845,26.56882591093117,0
3581,4,0,0,47,0.0,0.0,1.0,47,1350,900,450,0.6666666666666666,18,9,9,336.62589130655977,0.4455750847980265,0.22934670243170774,0.178157131382245,127334.51727892846,-827.1809253780259,126507.33635355043,1338,1,218.25531914893617,38,9,16,39.18241240605485,0.5896381578947368,47.67628205128206,1009.2948717948727,26.560391363022966,0
3582,4,1,0,48,0.020833333333333332,0.0,1.0,48,1300,1000,300,0.7692307692307693,16,10,6,328.7482609732838,0.44697473404255317,0.2240141522396264,0.17567032623814705,127723.00347222244,-1202.2569444444207,126520.74652777801,1339,0,214.6875,39,9,18,38.98392415498765,0.5918803418803419,47.29166666666668,1010.8333333333351,25.918803418803464,0
3583,4,1,0,49,0.02040816326530612,0.0,1.0,49,1650,1100,550,0.6666666666666666,22,11,11,322.06126720988846,0.4484658446712018,0.22502642164854736,0.17402486260733876,128170.25662634676,-1544.264946460437,126625.99167988633,1340,0,211.28571428571428,40,9,19,38.69659942459522,0.5947916666666666,46.84959349593496,1012.6016260162602,25.315040650406505,0
3584,4,0,0,49,0.0,0.0,1.0,49,1100,700,400,0.6363636363636364,15,7,8,320.6163816936404,0.44809382086167804,0.21781762739365806,0.17389565088885542,128320.37278163573,-1571.6772762345736,126748.69550540115,1341,1,212.28571428571428,41,8,19,38.580220470642,0.5947662601626016,46.701388888888886,1013.1944444444439,24.712059620596193,0
3585,4,1,0,50,0.02,0.0,1.0,50,1550,1200,350,0.7741935483870968,19,12,7,316.3941819285868,0.44920918367346935,0.23074028082911457,0.1729676600840926,128635.55304856971,-1860.091885253296,126775.46116331642,1342,0,209.02,42,8,14,38.36644697042061,0.5964781746031746,46.39050387596899,1014.4379844961234,24.153285345145793,0
3586,4,0,1,49,0.0,0.02,0.98,50,1400,1000,400,0.7142857142857143,18,10,8,317.26556269800074,0.44908163265306117,0.23051847608135212,0.17387348184909257,128733.87008180091,-1831.435254041227,126902.43482775969,1343,1,210.02,42,8,14,38.24437442311978,0.5974702380952381,46.29360465116279,1014.8255813953483,24.16251384274639,0
3587,4,2,2,49,0.0392156862745098,0.0392156862745098,0.9607843137254902,51,1350,1100,250,0.8148148148148148,16,11,5,315.42016787396994,0.4509150326797386,0.22978845791102476,0.1756815035813694,129373.84627013108,-2036.8811407066762,127336.9651294244,1344,0,203.2156862745098,42,9,18,37.6414817284186,0.6039186507936508,45.663759689922486,1017.3449612403107,24.222499077150253,0
3588,4,0,1,48,0.0,0.02040816326530612,0.9795918367346939,49,1850,1400,450,0.7567567567567568,23,14,9,328.54071486159603,0.4467474489795918,0.22181331549013006,0.18219076005961263,129201.38888888911,-1310.4166666666476,127890.97222222247,1345,1,212.24489795918367,42,7,18,37.48292349726776,0.6021825396825398,45.83333333333334,1016.6666666666684,24.20634920634925,0
3589,4,1,1,48,0.02040816326530612,0.02040816326530612,0.9795918367346939,49,1100,600,500,0.5454545454545454,16,6,10,331.1775087559513,0.44602111678004536,0.22942926046654777,0.1844973867643754,129382.26176754899,-1230.3009741225571,128151.96079342643,1346,0,213.0612244897959,40,9,19,37.232169613425214,0.60703125,45.65548780487804,1017.3780487804871,25.434451219512177,0
3590,4,1,2,47,0.02040816326530612,0.04081632653061224,0.9591836734693877,49,1200,800,400,0.6666666666666666,16,8,8,360.4189746421215,0.445046768707483,0.24484758938540407,0.19513998382071224,128250.02170138896,-468.2576973444991,127781.76400404447,1347,0,213.0204081632653,39,10,16,37.64397367338543,0.5972222222222222,46.770833333333336,1012.9166666666673,25.97222222222224,8
3591,4,2,1,48,0.04081632653061224,0.02040816326530612,0.9795918367346939,49,1650,900,750,0.5454545454545454,24,9,15,360.1054302366498,0.4456313775510204,0.27556255418235365,0.19783469690453195,128830.99500868081,-521.4518229166449,128309.54318576417,1348,0,213.69387755102042,39,10,15,37.05836582529585,0.6030982905982907,46.19791666666668,1015.2083333333354,26.03098290598296,0
3592,4,2,0,50,0.04,0.0,1.0,50,1350,900,450,0.6666666666666666,18,9,9,346.0569126506581,0.4482397959183673,0.28012289086121145,0.19251880224672802,129327.4943802753,-1049.0653147833168,128278.42906549198,1349,0,209.16,41,9,18,36.90942081992262,0.6049288617886179,45.7093253968254,1017.1626984126987,24.808846302748748,0
3593,4,0,0,50,0.0,0.0,1.0,50,1000,500,500,0.5,15,5,10,343.70657197582744,0.44806972789115646,0.27754290171606866,0.19157905446652657,129403.18720080634,-1104.6548248929096,128298.53237591343,1350,1,210.16,41,9,18,36.89222568902757,0.6056910569105691,45.63492063492064,1017.4603174603182,24.8161053039102,0
3594,4,0,0,50,0.0,0.0,1.0,50,1250,700,550,0.56,18,7,11,348.1206583599304,0.44718537414965986,0.2853620504824095,0.19466300138589884,129529.39111118978,-981.6286178823448,128547.76249330743,1351,2,211.16,41,9,15,36.65162183672806,0.6069613821138211,45.510912698412696,1017.9563492063487,24.828203639179236,0
3595,4,0,1,49,0.0,0.02,0.98,50,1400,1100,300,0.7857142857142857,17,11,6,348.9906425217496,0.44653911564625853,0.28032723022984074,0.19603041123705262,129706.17992567386,-946.7513857394925,128759.42853993436,1352,3,212.16,41,9,16,36.449811712764564,0.608739837398374,45.33730158730158,1018.6507936507927,24.84514130855592,0
3596,4,1,0,50,0.02,0.0,1.0,50,1700,1200,500,0.7058823529411765,22,12,10,350.73391294018086,0.4468027210884354,0.2847411444141692,0.1980297631523789,129908.37191358018,-887.3456790123535,129021.02623456782,1353,0,213.08,41,9,17,36.20004541326066,0.6107723577235773,45.138888888888886,1019.4444444444439,24.864498644986437,0
3597,4,0,2,48,0.0,0.04,0.96,50,1450,700,750,0.4827586206896552,22,7,15,350.50053691708536,0.44681122448979593,0.2836365405195058,0.19828260973972023,129984.2345068813,-888.091202916369,129096.14330396493,1354,1,214.08,41,9,17,36.12898060771151,0.6115345528455285,45.06448412698412,1019.7420634920622,24.87175764614786,0
3598,4,1,2,47,0.02040816326530612,0.04081632653061224,0.9591836734693877,49,1800,1200,600,0.6666666666666666,24,12,12,352.8542816267334,0.44701318027210885,0.2783245711212001,0.201893464191095,130426.23325525968,-594.8158794870702,129831.41737577261,1355,0,195.91836734693877,38,11,18,35.620620228009614,0.6208881578947368,44.631410256410255,1021.4743589743588,26.88090418353576,0
3599,4,0,0,47,0.0,0.0,1.0,47,1950,1400,550,0.717948717948718,25,14,11,369.08368225373243,0.4444958371877891,0.28174652527637023,0.21060300484547506,130320.0725007104,219.802446027136,130539.87494673755,1356,1,203.93617021276594,36,11,19,35.31395904562332,0.6235532407407407,44.735360360360374,1021.0585585585604,28.36273773773779,0
3600,4,0,0,47,0.0,0.0,1.0,47,1900,1500,400,0.7894736842105263,23,15,8,367.117569220612,0.4440525747764416,0.2802384029535314,0.2101024271545855,130435.08193582129,177.00204427404276,130612.08398009534,1357,2,204.93617021276594,36,11,19,35.247400139639154,0.6247106481481481,44.622747747747766,1021.5090090090117,28.375250250250325,0
3601,4,0,0,47,0.0,0.0,1.0,47,1250,800,450,0.64,17,8,9,368.3317320462321,0.44424529756398395,0.2846304437020102,0.21142381203792282,130550.14209733398,217.15199151856308,130767.29408885255,1358,3,205.93617021276594,36,11,18,35.09963269054178,0.6258680555555556,44.510135135135144,1021.9594594594608,28.3877627627628,0
3602,4,0,0,47,0.0,0.0,1.0,47,1000,500,500,0.5,15,5,10,367.2711137318599,0.44418748072772124,0.28511185957994445,0.21138492990344854,130654.64854570659,197.13565712529305,130851.78420283188,1359,4,206.93617021276594,37,10,18,35.02073502073503,0.625,44.40789473684212,1022.3684210526333,27.631578947368467,0
3603,4,0,2,45,0.0,0.0425531914893617,0.9574468085106383,47,950,600,350,0.631578947368421,13,6,7,368.51038563194965,0.44349367869256856,0.2926582075918309,0.21264315380679047,130753.83434007234,236.82918310322526,130990.66352317556,1360,5,207.93617021276594,38,9,18,34.888488457118996,0.6241776315789473,44.31089743589744,1022.7564102564104,26.914642375168693,0
3604,4,0,0,45,0.0,0.0,1.0,45,1300,900,400,0.6923076923076923,17,9,8,372.4267334335617,0.4410143097643098,0.2987707261292163,0.21497503523937314,130766.77439212095,740.2085257002489,131506.9829178212,1361,6,216.13333333333333,37,8,18,34.775228702115506,0.6261261261261262,44.2982456140351,1022.807017543862,27.643432906590863,0
3605,4,0,0,45,0.0,0.0,1.0,45,1250,700,550,0.56,18,7,11,371.77396609155744,0.44059343434343434,0.29538825658696166,0.21513469929056492,130863.12601587057,730.3006748119078,131593.42669068248,1362,7,217.13333333333333,38,7,18,34.6942327103129,0.6252741228070176,44.20405982905984,1023.183760683762,26.925888439046368,0
3606,4,0,0,45,0.0,0.0,1.0,45,1300,900,400,0.6923076923076923,17,9,8,372.99899741570835,0.4400042087542087,0.29291031795728073,0.21661069049923162,130999.80481591079,772.5591715976565,131772.36398750843,1363,8,218.13333333333333,38,7,18,34.52436860780631,0.6266447368421053,44.07051282051283,1023.7179487179503,26.93994601889343,0
3607,4,0,0,45,0.0,0.0,1.0,45,1800,1200,600,0.6666666666666666,24,12,12,372.89975289049505,0.43937289562289567,0.2889653973222044,0.21701542996086215,131081.84633875763,776.0776216305318,131857.92396038817,1364,9,219.13333333333333,38,7,18,34.44379238393323,0.627467105263158,43.99038461538463,1024.0384615384635,26.94838056680167,0
3608,4,0,1,44,0.0,0.022222222222222223,0.9777777777777777,45,1650,1200,450,0.7272727272727273,21,12,9,370.4898620166206,0.4392676767676768,0.2814691267938425,0.21684620172821514,131300.74929003234,729.1192974286118,132029.86858746095,1365,10,220.13333333333333,38,7,19,34.28389624378886,0.6296600877192983,43.77670940170941,1024.893162393164,26.970872694556945,0
3609,4,1,1,44,0.022222222222222223,0.022222222222222223,0.9777777777777777,45,1450,900,550,0.6206896551724138,20,9,11,368.177710188804,0.43977272727272726,0.28530113616127095,0.21739906559350247,131637.38031173046,693.1927052536862,132330.57301698416,1366,0,219.11111111111111,37,8,17,34.0028092388788,0.6348536036036037,43.4484649122807,1026.2061403508767,27.735301090564235,0
3610,4,0,0,44,0.0,0.0,1.0,44,1200,800,400,0.6666666666666666,16,8,8,370.4775241933848,0.4387883192389006,0.27692656906140023,0.21981666435474181,131821.3757396451,967.3713839579333,132788.74712360304,1367,1,217.3181818181818,38,6,17,33.7579327923429,0.6348684210526316,43.269230769230774,1026.9230769230778,27.02429149797573,0
3611,4,0,0,44,0.0,0.0,1.0,44,1350,1000,350,0.7407407407407407,17,10,7,340.8463941625611,0.4381716878083157,0.16227100955422924,0.19301486670015236,130023.43885633674,63.60405815971734,130087.04291449646,1368,2,218.3181818181818,39,5,18,36.3353462363395,0.6151175213675213,45.026041666666664,1019.8958333333328,26.1511752136752,8
3612,4,0,1,43,0.0,0.022727272727272728,0.9772727272727273,44,850,500,350,0.5882352941176471,12,5,7,344.06923701660014,0.4381606765327695,0.16345261516760035,0.19550477063889898,130156.27170138898,156.5538194444492,130312.82552083343,1369,3,219.3181818181818,39,5,18,36.118483734857755,0.6164529914529915,44.895833333333336,1020.4166666666674,26.164529914529933,0
3613,4,0,0,43,0.0,0.0,1.0,43,1500,1100,400,0.7333333333333333,19,11,8,343.1059751998314,0.4374077150239941,0.1511281647477054,0.19577985381603952,130320.07250071004,342.849321027093,130662.92182173714,1370,4,219.37209302325581,36,7,20,35.97707804860116,0.6235532407407407,44.73536036036035,1021.0585585585575,28.362737737737707,0
3614,4,1,2,42,0.022727272727272728,0.045454545454545456,0.9545454545454546,44,1050,900,150,0.8571428571428571,12,9,3,337.37359348684976,0.438468992248062,0.16031941031941055,0.19417724602909778,130654.6485457062,15.885657125250361,130670.53420283145,1371,0,215.36363636363637,37,7,17,35.784892034892025,0.625,44.407894736842096,1022.3684210526301,27.631578947368382,0
3615,4,1,0,43,0.023255813953488372,0.0,1.0,43,1850,1400,450,0.7567567567567568,23,14,9,338.210459577268,0.4368078626799557,0.19213350613796254,0.19640803779814411,130999.80481591038,261.1008382642798,131260.90565417465,1372,0,220.2325581395349,38,5,18,35.41470987267793,0.6266447368421053,44.07051282051281,1023.7179487179471,26.939946018893345,0
3616,4,0,0,43,0.0,0.0,1.0,43,1200,800,400,0.6666666666666666,16,8,8,339.184239911662,0.43655407899593945,0.19125127161749722,0.1972888212030555,131061.3335503473,290.7877604166772,131352.121310764,1373,1,221.2325581395349,39,4,18,35.3276534418447,0.625534188034188,44.01041666666667,1023.958333333334,26.2553418803419,0
3617,4,1,2,42,0.022727272727272728,0.045454545454545456,0.9545454545454546,44,1300,1000,300,0.7692307692307693,16,10,6,336.2955760816724,0.4371916842847075,0.19350996596985914,0.19726246150336474,131384.32618690346,37.607334708732594,131421.9335216122,1374,0,217.1818181818182,37,7,19,35.075757575757564,0.6323198198198199,43.69517543859648,1025.2192982456124,27.70862968231385,0
3618,4,1,0,43,0.023255813953488372,0.0,1.0,43,1300,900,400,0.6923076923076923,17,9,8,340.24094425559423,0.43620801033591733,0.20747728914447872,0.20064305780664854,131587.96623904313,354.3227771690608,131942.2890162122,1375,0,220.72093023255815,36,7,18,34.76932645520066,0.6362847222222222,43.49662162162162,1026.0135135135138,28.500375375375384,0
3619,4,0,2,41,0.0,0.046511627906976744,0.9534883720930233,43,1200,800,400,0.6666666666666666,16,8,8,338.57296733506934,0.4351467331118494,0.1965866306388644,0.20065805481807514,131778.07113727287,323.2985149276597,132101.36965220052,1376,1,221.72093023255815,37,6,18,34.620621529261,0.6362612612612613,43.311403508771924,1026.7543859649113,27.750118539592197,0
3620,4,0,0,41,0.0,0.0,1.0,41,850,800,50,0.9411764705882353,9,8,1,355.85969623186685,0.4342987804878049,0.20476134114687206,0.209241723179202,131476.45968632124,1157.4346011231187,132633.89428744436,1377,2,225.58536585365854,35,6,20,34.48127092502727,0.637202380952381,43.605324074074076,1025.5787037037044,29.302248677248695,0
3621,4,0,0,41,0.0,0.0,1.0,41,1300,1100,200,0.8461538461538461,15,11,4,358.55287838249353,0.4334857723577236,0.2069663619834572,0.21181135060743303,131654.57182623888,1241.0251361025362,132895.59696234143,1378,3,226.58536585365854,35,6,19,34.23238318108343,0.6389880952380953,43.43171296296296,1026.2731481481483,29.32208994708995,0
3622,4,0,1,40,0.0,0.024390243902439025,0.975609756097561,41,1150,800,350,0.6956521739130435,15,8,7,356.29810493402033,0.43328252032520326,0.20420263510336079,0.21080773133154282,131713.96933138292,1185.8875332218859,132899.8568646048,1379,4,227.58536585365854,35,6,19,34.2303012365167,0.6395833333333334,43.373842592592595,1026.50462962963,29.328703703703713,0
3623,4,0,0,40,0.0,0.0,1.0,40,1050,700,350,0.6666666666666666,14,7,7,359.06971689629177,0.43434829059829055,0.1907238901124375,0.2131930108509504,131847.23816609982,1468.4700963718853,133315.70826247171,1380,5,226.65,34,6,19,34.02471890576099,0.6430759803921569,43.24404761904762,1027.0238095238099,30.20658263305323,0
3624,4,0,0,40,0.0,0.0,1.0,40,1000,500,500,0.5,15,5,10,358.865415426862,0.4344818376068376,0.18584134893962267,0.2134148635229766,131908.37762188198,1467.4709467120056,133375.848568594,1381,6,227.65,34,6,19,33.96830455440955,0.6436887254901961,43.1845238095238,1027.261904761904,30.213585434173645,0
3625,4,0,2,38,0.0,0.05,0.95,40,1350,900,450,0.6666666666666666,18,9,9,356.0540887325482,0.43295940170940167,0.16817721233956284,0.2128177938171262,132100.37964034645,1406.9760588134543,133507.3556991599,1382,7,228.65,35,5,19,33.84701268483074,0.6434523809523809,42.99768518518519,1028.00925925926,29.371693121693145,0
3626,4,0,0,38,0.0,0.0,1.0,38,1300,1000,300,0.7692307692307693,16,10,6,370.1335732877105,0.4279575628259839,0.1876253895078328,0.22047086756702752,131969.53125,2169.270833333333,134138.80208333334,1383,8,240.1578947368421,34,4,19,33.61719383617195,0.6443014705882353,43.125,1027.5,30.220588235294116,0
3627,4,0,1,37,0.0,0.02631578947368421,0.9736842105263158,38,950,600,350,0.631578947368421,13,6,7,366.78440804418955,0.4275723091512565,0.1775982509465155,0.21940376408461515,132130.126953125,2092.6540798611118,134222.78103298612,1384,9,241.1578947368421,35,3,19,33.5412445119892,0.64375,42.96875,1028.125,29.375,0
3628,4,0,0,37,0.0,0.0,1.0,37,1150,900,250,0.782608695652174,14,9,5,361.2085851551184,0.4272084584584585,0.08872442124275892,0.20807649482879353,130688.28124999999,2041.1458333333342,132729.4270833333,1385,10,246.27027027027026,34,3,17,35.1416055419723,0.6314338235294117,44.375,1022.4999999999999,30.073529411764703,8
3629,4,0,1,36,0.0,0.02702702702702703,0.972972972972973,37,750,500,250,0.6666666666666666,10,5,5,375.3371524776794,0.42661411411411415,0.08035145294514257,0.20736846202652937,129054.3435597782,2287.7779653206744,131342.12152509886,1386,11,247.27027027027026,35,2,17,36.44362019212517,0.612797619047619,45.978009259259274,1016.0879629629649,29.031084656084712,8
3630,4,0,0,36,0.0,0.0,1.0,36,1050,600,450,0.5714285714285714,15,6,9,376.8205512863479,0.4276951058201058,0.07081560422115496,0.20880406797106596,129171.13272392297,2534.8674886621375,131706.00021258512,1387,12,249.05555555555554,34,2,19,36.286694382636526,0.6161151960784313,45.86309523809524,1016.5476190476196,29.89845938375352,0
3631,4,0,1,35,0.0,0.027777777777777776,0.9722222222222222,36,1150,700,450,0.6086956521739131,16,7,9,381.2675279430979,0.42726521164021164,0.06963855421686804,0.2120992280112406,129326.01042868115,2661.565202061203,131987.57563074236,1388,13,250.05555555555554,33,3,19,36.015562248995984,0.619949494949495,45.71078431372548,1017.156862745097,30.82293523469991,0
3632,4,1,0,36,0.027777777777777776,0.0,1.0,36,900,600,300,0.6666666666666666,12,6,6,377.58306397075074,0.4279596560846561,0.11992945326278726,0.21273582384693476,129825.09731833884,2603.9516051518317,132429.04892349069,1389,0,250.55555555555554,33,3,18,35.6005491422158,0.625,45.2205882352941,1019.1176470588214,30.882352941176407,0
3633,4,0,1,35,0.0,0.027777777777777776,0.9722222222222222,36,600,200,400,0.3333333333333333,10,2,8,382.2051569839214,0.42786044973544973,0.11978707488445428,0.21568402278102133,129887.55076172612,2728.7383458285076,132616.28910755462,1390,1,251.55555555555554,33,3,18,35.419171275146255,0.6256313131313131,45.159313725490186,1019.3627450980381,30.889780154486004,0
3634,4,1,0,36,0.027777777777777776,0.0,1.0,36,800,500,300,0.625,11,5,6,377.23227667827894,0.429265873015873,0.11289267889075738,0.21424528892382996,130137.51471789683,2618.41419165704,132755.92890955388,1391,0,247.72222222222223,33,3,19,35.291556569781406,0.6281565656565656,44.9142156862745,1020.343137254901,30.919489007724273,0
3635,4,0,0,36,0.0,0.0,1.0,36,1100,800,300,0.7272727272727273,14,8,6,381.5152053983719,0.4281415343915344,0.11437767060989534,0.21773560099199957,130327.04132550256,2744.409661101074,133071.45098660362,1392,1,248.72222222222223,32,4,19,34.98954082684143,0.6324869791666667,44.72853535353536,1021.0858585858591,31.908933080808097,0
3636,4,0,0,36,0.0,0.0,1.0,36,750,700,50,0.9333333333333333,8,7,1,380.2000250514847,0.4275793650793651,0.11348368522072994,0.2176749593976081,130450.30757400989,2719.4420415224804,133169.74961553238,1393,2,249.72222222222223,33,3,19,34.89783269353808,0.6313131313131313,44.607843137254896,1021.5686274509795,30.956625074272107,0
3637,4,0,1,35,0.0,0.027777777777777776,0.9722222222222222,36,1100,800,300,0.7272727272727273,14,8,6,361.90282646615503,0.4274966931216931,0.12174211248285305,0.19542752629172383,128144.53125000004,2075.1736111111127,130219.70486111115,1394,3,250.72222222222223,34,2,17,37.71433470507544,0.6056985294117647,46.875,1012.5000000000003,29.77941176470589,8
3638,4,0,0,35,0.0,0.0,1.0,35,1350,1000,350,0.7407407407407407,17,10,7,369.01556334569614,0.42741596638655466,0.11593180482069365,0.19926840420667574,128144.53124999988,2457.4652777777646,130601.99652777765,1395,4,250.8,33,2,17,37.53429355281207,0.6079545454545454,46.87499999999999,1012.4999999999991,30.681818181818155,0
3639,4,3,1,37,0.07894736842105263,0.02631578947368421,0.9736842105263158,38,1350,1000,350,0.7407407407407407,17,10,7,356.51875316558915,0.43406235182550973,0.14037419129218387,0.19799288690561329,129258.63997443399,1616.6258319130043,130875.26580634699,1396,0,231.92105263157896,36,2,18,36.713501291989665,0.6128472222222222,45.77702702702703,1016.8918918918927,28.24699699699702,0
3640,4,1,0,38,0.02631578947368421,0.0,1.0,38,850,400,450,0.47058823529411764,13,4,9,357.06911462331624,0.4331288525367473,0.15857860397981605,0.2001845011493273,129631.0811444891,1657.4510743851995,131288.5322188743,1397,0,232.89473684210526,36,2,17,36.32045044048804,0.6166087962962963,45.41103603603604,1018.3558558558559,28.287662662662665,0
3641,4,0,0,38,0.0,0.0,1.0,38,1450,1300,150,0.896551724137931,16,13,3,353.6116867596471,0.43318812233285914,0.15463216802229396,0.19889587126940916,129759.37307633109,1576.8861572791502,131336.25923361024,1398,1,233.89473684210526,37,1,17,36.27807074185678,0.615990990990991,45.28508771929824,1018.8596491228063,27.53674727358936,0
3642,4,0,0,38,0.0,0.0,1.0,38,850,600,250,0.7058823529411765,11,6,5,353.1330435295214,0.43309921763869136,0.157900399805194,0.19891021251899224,129815.2376211911,1568.4099915358486,131383.64761272696,1399,2,234.89473684210526,37,1,18,36.23350190086792,0.6165540540540541,45.23026315789473,1019.0789473684208,27.542674253200563,0
3643,4,0,0,38,0.0,0.0,1.0,38,1150,700,450,0.6086956521739131,16,7,9,354.452103765498,0.4326102418207682,0.157569291548044,0.20036778801917138,129954.95158366051,1612.5611967143896,131567.5127803749,1400,3,235.89473684210526,37,1,19,36.057976664157444,0.6179617117117118,45.09320175438597,1019.6271929824574,27.557491702228578,0
3644,4,0,2,36,0.0,0.05263157894736842,0.9473684210526316,38,1000,500,500,0.5,15,5,10,355.5335471358277,0.4320471787577051,0.16542605842925462,0.20184500647339057,130122.70752779683,1652.597554055078,131775.3050818519,1401,4,236.89473684210526,37,1,19,35.86008866200967,0.6196509009009009,44.92872807017543,1020.2850877192967,27.575272641062075,0
3645,4,0,1,35,0.0,0.027777777777777776,0.9722222222222222,36,950,500,450,0.5263157894736842,14,5,9,407.77007673275955,0.432010582010582,0.22152543783019274,0.21914564888394394,127952.84162649229,3246.2583518625675,131199.09997835485,1402,5,244.13888888888889,32,4,16,36.7504367902159,0.6083984375,47.064393939393945,1011.7424242424249,31.61695075757578,8
3646,4,1,0,36,0.027777777777777776,0.0,1.0,36,950,500,450,0.5263157894736842,14,5,9,400.90403843485007,0.43077050264550265,0.22800628391888011,0.2172028843330875,128276.40109592023,3085.448927305737,131361.85002322597,1403,0,243.22222222222223,31,5,18,36.59168808911738,0.614247311827957,46.74479166666667,1013.0208333333342,32.67809139784949,0
3647,4,3,0,39,0.07692307692307693,0.0,1.0,39,1250,1000,250,0.8,15,10,5,378.2651883272033,0.4357287449392713,0.23507929593000054,0.2102627460098767,129294.84941188479,1984.8711376784045,131279.72054956318,1404,0,225.43589743589743,33,6,19,36.12370466321243,0.6196338383838385,45.741421568627445,1017.0343137254897,30.819221628045142,0
3648,4,1,2,38,0.025,0.05,0.95,40,900,600,300,0.6666666666666666,12,6,6,369.7770229487679,0.4379139957264957,0.23762419637638832,0.20743884795584977,129655.65653344669,1588.7365362811745,131244.39306972787,1405,0,220.775,34,6,14,35.971897525813354,0.6210171568627452,45.38690476190476,1018.4523809523807,29.95448179271708,0
3649,4,0,0,38,0.0,0.0,1.0,38,950,700,250,0.7368421052631579,12,7,5,385.2175010527956,0.4339882645803699,0.24132986680428226,0.21449187325379226,129361.8974626313,2366.4933744005607,131728.39083703185,1406,1,233.3421052631579,32,6,18,35.87848041040916,0.6227213541666667,45.675505050505045,1017.2979797979793,31.790561868686854,0
3650,4,0,0,38,0.0,0.0,1.0,38,1050,700,350,0.6666666666666666,14,7,7,383.77284573490635,0.43358819345661453,0.24116468917959688,0.214170007458512,129450.69204152231,2335.9320934255875,131786.6241349479,1407,2,234.3421052631579,33,5,14,35.82460260115609,0.6212121212121212,45.58823529411764,1017.6470588235279,30.83778966131903,0
3651,4,0,1,37,0.0,0.02631578947368421,0.9736842105263158,38,1300,900,400,0.6923076923076923,17,9,8,382.73416215932787,0.43336593172119486,0.2414143589029123,0.21478079822458945,129669.02941476817,2325.753466214891,131994.78288098305,1408,3,235.3421052631579,33,5,15,35.628359002125684,0.6234217171717171,45.37377450980391,1018.5049019607828,30.86378490790251,0
3652,4,0,0,37,0.0,0.0,1.0,37,1750,1400,350,0.8,21,14,7,390.60143518191376,0.43205705705705705,0.24924366538349463,0.2192750019215376,129683.21352731851,2730.889864554623,132414.10339187313,1409,4,241.1081081081081,32,5,17,35.41356762117268,0.6259765625,45.35984848484848,1018.560606060605,31.830018939393906,0
3653,4,2,0,39,0.05128205128205128,0.0,1.0,39,1650,1200,450,0.7272727272727273,21,12,9,376.65949678563516,0.43435110211426003,0.2534288112757188,0.21595647701476972,130505.75573979579,2031.2464569160888,132537.00219671187,1410,0,229.69230769230768,34,5,14,34.931939104431265,0.6295955882352942,44.55357142857142,1021.7857142857132,30.05252100840333,0
3654,4,0,0,39,0.0,0.0,1.0,39,1000,700,300,0.7,13,7,6,382.1545162335861,0.4337606837606838,0.18980114195707842,0.2003057572704215,126942.00857426302,1929.53160430839,128871.5401785714,1411,1,230.69230769230768,34,5,18,38.43768458357944,0.5934436274509804,48.06547619047619,1007.7380952380952,29.639355742296917,8
3655,4,3,3,39,0.07142857142857142,0.07142857142857142,0.9285714285714286,42,1150,500,650,0.43478260869565216,18,5,13,361.78853175556105,0.4401737320944638,0.20687854253158777,0.19398345096696676,127859.63909433076,851.7187968442718,128711.35789117504,1412,0,215.14285714285714,36,6,19,38.00894480941245,0.5986689814814814,47.15653153153153,1011.3738738738734,28.093718718718705,0
3656,4,1,0,40,0.025,0.0,1.0,40,950,700,250,0.7368421052631579,12,7,5,378.27829177973047,0.43876869658119655,0.2342900035323212,0.2024396680583016,127783.17920918348,1667.520549886601,129450.69975907008,1413,0,226.3,34,6,20,37.670483535460576,0.6020220588235294,47.23214285714285,1011.071428571427,29.737394957983145,0
3657,4,1,1,40,0.024390243902439025,0.024390243902439025,0.975609756097561,41,1250,800,450,0.64,17,8,9,369.33443266528184,0.4407774390243902,0.2281628395977533,0.19914913366772843,128085.9441979595,1261.3099065500614,129347.25410450956,1414,0,221.7560975609756,35,6,21,37.5862298955713,0.6029761904761906,46.93287037037037,1012.2685185185182,28.921957671957664,0
3658,4,0,0,40,0.0,0.0,1.0,40,900,400,500,0.4444444444444444,14,4,10,367.3475389701644,0.4399439102564102,0.2304701682197754,0.19852143325771554,128175.55334787109,1417.008211614967,129592.56155948606,1415,1,227.325,33,7,21,37.544752712896866,0.608270202020202,46.844362745098046,1012.6225490196084,30.685531788472982,0
3659,4,0,0,40,0.0,0.0,1.0,40,1250,800,450,0.64,17,8,9,360.7498631995141,0.4404780982905983,0.2302260716382849,0.19628019713379324,128446.04768990938,1267.3788265306193,129713.42651644,1416,2,228.325,34,6,17,37.43516343707183,0.6087622549019608,46.577380952380956,1013.6904761904768,29.81442577030814,0
3660,4,1,1,40,0.024390243902439025,0.024390243902439025,0.975609756097561,41,1150,700,450,0.6086956521739131,16,7,9,355.570521980058,0.441869918699187,0.23835136412937685,0.19514101863361127,128789.87295310352,958.7764703360724,129748.6494234396,1417,0,223.73170731707316,35,6,19,37.21541239072596,0.6101190476190477,46.238425925925924,1015.046296296296,29.001322751322743,0
3661,4,0,0,40,0.0,0.0,1.0,40,900,500,400,0.5555555555555556,13,5,8,362.8926798622737,0.443122329059829,0.23206075533661719,0.1991005784109233,128778.12500000013,1346.527777777793,130124.65277777793,1418,1,224.475,34,6,20,37.0415982484948,0.6121323529411764,46.25000000000001,1015.000000000001,29.85294117647062,0
3662,4,1,1,40,0.024390243902439025,0.024390243902439025,0.975609756097561,41,1650,1400,250,0.8484848484848485,19,14,5,354.98216848180334,0.4436991869918699,0.238672083548648,0.19730726514899463,129292.17864229034,979.9780328798365,130272.15667517018,1419,0,219.97560975609755,34,7,21,36.718414686487975,0.6173406862745099,45.74404761904763,1017.0238095238102,29.91246498599442,0
3663,4,3,2,41,0.06976744186046512,0.046511627906976744,0.9534883720930233,43,1300,1100,200,0.8461538461538461,15,11,4,338.4078420376283,0.44559800664451826,0.2327020111192175,0.19097679464617293,129889.23890106328,191.10740808376067,130080.34630914703,1420,0,210.53488372093022,36,7,18,36.533592944468985,0.619212962962963,45.15765765765766,1019.3693693693698,28.315815815815828,0
3664,4,0,0,41,0.0,0.0,1.0,41,1250,900,350,0.72,16,9,7,356.38685427021716,0.44247967479674793,0.2363473079499938,0.19992718283814467,129655.65653344664,1041.5143140589512,130697.1708475056,1421,1,221.8048780487805,34,7,19,36.31282875511397,0.6210171568627452,45.38690476190476,1018.4523809523804,29.954481792717072,0
3665,4,1,1,41,0.023809523809523808,0.023809523809523808,0.9761904761904762,42,1300,1100,200,0.8461538461538461,15,11,4,349.77115080384124,0.44435975609756095,0.2365519030861296,0.1976352833502909,129937.87140185609,689.7037626457443,130627.57516450183,1422,0,217.5,35,7,20,36.194635221553725,0.6217261904761905,45.1099537037037,1019.5601851851848,29.130291005290992,0
3666,4,0,0,41,0.0,0.0,1.0,41,1100,800,300,0.7272727272727273,14,8,6,356.6879202714113,0.44357215447154474,0.2330161632110357,0.20093647715865515,129819.89354263128,1061.037567515443,130880.93111014673,1423,1,221.85365853658536,35,6,21,36.13820272572403,0.6205357142857143,45.22569444444445,1019.0972222222231,29.117063492063515,0
3667,4,0,0,41,0.0,0.0,1.0,41,1150,800,350,0.6956521739130435,15,8,7,359.9491257156149,0.4431910569105691,0.23677719923266594,0.2036937538009175,129996.88042534732,1158.452690972228,131155.33311631955,1424,2,222.85365853658536,35,6,21,35.8752553626149,0.6223214285714286,45.052083333333336,1019.7916666666674,29.136904761904784,0
3668,4,1,0,42,0.023809523809523808,0.0,1.0,42,1500,1000,500,0.6666666666666666,20,10,10,351.71647174524026,0.44342818428184283,0.24845625072818334,0.2016554760847961,130505.75573979596,780.7473249716613,131286.50306476763,1425,0,218.52380952380952,34,8,19,35.56909977086489,0.6295955882352942,44.55357142857143,1021.7857142857147,30.052521008403374,0
3669,4,0,0,42,0.0,0.0,1.0,42,1100,700,400,0.6363636363636364,15,7,8,350.8240784499054,0.44308943089430897,0.2476708074534162,0.20172384510869565,130617.28395061727,764.7376543209842,131382.02160493826,1426,1,219.52380952380952,35,7,19,35.478940217391305,0.6285714285714286,44.44444444444444,1022.2222222222222,29.206349206349206,0
3670,4,2,0,44,0.045454545454545456,0.0,1.0,44,1150,700,450,0.6086956521739131,16,7,9,337.54059465046544,0.4450207011980268,0.25993132696535204,0.19741266568230612,131271.93583602647,61.92145660202738,131333.8572926285,1427,0,210.5,37,7,21,35.15719737499107,0.6311936936936937,43.80482456140351,1024.780701754386,27.696775723091513,0
3671,4,0,1,43,0.0,0.022727272727272728,0.9772727272727273,44,1700,1200,500,0.7058823529411765,22,12,10,335.05045471075425,0.44481148696264977,0.2484277828244006,0.19698544164304976,131472.44953991158,9.9928229869505,131482.44236289852,1428,1,211.5,36,8,22,35.01884996888839,0.6351273148148149,43.609234234234236,1025.5630630630635,28.487862862862876,0
3672,4,0,0,43,0.0,0.0,1.0,43,1250,900,350,0.72,16,9,7,344.20557556981197,0.44273717238833515,0.26004514672686274,0.2022321882989743,131446.78605109724,448.9433299039627,131895.7293810012,1429,2,217.27906976744185,35,8,23,34.810007524454484,0.6369047619047619,43.63425925925925,1025.4629629629617,29.29894179894176,0
3673,4,0,0,43,0.0,0.0,1.0,43,1650,1300,350,0.7878787878787878,20,13,7,344.94060656033366,0.44202196382428943,0.25989847715736025,0.20345299249217302,131595.18771701396,478.50477430556003,132073.69249131953,1430,3,218.27906976744185,35,8,17,34.64149746192893,0.6383928571428572,43.489583333333336,1026.0416666666672,29.315476190476204,0
3674,4,0,0,43,0.0,0.0,1.0,43,1800,1200,600,0.6666666666666666,24,12,12,344.22885395106186,0.4407299741602067,0.2569437183289678,0.2042305087299764,131819.1518165126,475.191111719845,132294.34292823245,1431,4,219.27906976744185,36,7,19,34.4340570969039,0.638599537037037,43.271396396396405,1026.9144144144157,28.525400400400436,0
3675,4,0,0,43,0.0,0.0,1.0,43,1250,1000,250,0.8,15,10,5,343.67787752381025,0.4407299741602067,0.25308097469445157,0.20436959574786184,131905.89871966577,466.62786096909537,132372.52658063488,1432,5,220.27906976744185,36,7,19,34.36084009354674,0.6394675925925926,43.186936936936945,1027.2522522522536,28.534784784784822,0
3676,4,0,1,42,0.0,0.023255813953488372,0.9767441860465116,43,1050,600,450,0.5714285714285714,15,6,9,344.3315356321802,0.43994555186415657,0.25739627631790163,0.2055404791180453,132050.54029959033,493.8330644834238,132544.37336407375,1433,6,221.27906976744185,36,7,20,34.19844052445127,0.6409143518518519,43.04617117117118,1027.8153153153169,28.55042542542547,0
3677,4,0,0,42,0.0,0.0,1.0,42,1150,800,350,0.6956521739130435,15,8,7,344.6318730360148,0.4396293070073558,0.24829410291724074,0.20587694614350424,132079.47812677556,703.7595872900085,132783.23771406556,1434,7,223.1904761904762,36,6,20,34.161599839322236,0.6412037037037037,43.018018018018026,1027.927927927929,28.553553553553584,0
3678,4,0,0,42,0.0,0.0,1.0,42,1400,1200,200,0.8571428571428571,16,12,4,342.45745803649913,0.4386856368563686,0.25089689840018314,0.2052048232801389,132195.26113951823,654.250618862146,132849.51175838037,1435,8,224.1904761904762,36,6,20,34.1010092714265,0.6423611111111112,42.905405405405425,1028.378378378381,28.566066066066142,0
3679,4,0,0,42,0.0,0.0,1.0,42,1100,600,500,0.5454545454545454,16,6,10,344.50384826689634,0.43810491676345337,0.26154519588531366,0.20738314660493448,132369.0307706358,720.3280983686793,133089.3588690045,1436,9,225.1904761904762,36,6,20,33.87365944407969,0.6440972222222222,42.736486486486505,1029.0540540540567,28.584834834834908,0
3680,4,0,0,42,0.0,0.0,1.0,42,1400,1200,200,0.8571428571428571,16,12,4,342.6545027816561,0.43741531165311653,0.26308265604420367,0.20675503037585155,132457.56842635464,677.4396201600882,133135.00804651473,1437,10,226.1904761904762,35,7,20,33.83226519751145,0.6470238095238094,42.65046296296297,1029.3981481481487,29.41137566137568,0
3681,4,0,0,42,0.0,0.0,1.0,42,900,500,400,0.5555555555555556,13,5,8,343.19037575694824,0.4370886566008518,0.26676515930113043,0.20740635752267764,132517.14677640618,695.7218792867143,133212.8686556929,1438,11,227.1904761904762,35,7,20,33.758618105515595,0.6476190476190475,42.5925925925926,1029.629629629631,29.417989417989457,0
3682,4,0,0,42,0.0,0.0,1.0,42,1400,1100,300,0.7857142857142857,17,11,6,343.91661649774306,0.43667731320170344,0.2716404018358638,0.20883667940401832,132695.9622020747,727.2692686899848,133423.2314707647,1439,12,228.1904761904762,35,7,19,33.560342245188366,0.6494047619047619,42.41898148148148,1030.3240740740737,29.437830687830676,0
3683,4,0,0,42,0.0,0.0,1.0,42,950,600,350,0.631578947368421,13,6,7,345.25830197386557,0.4363506581494387,0.2725164872193966,0.20981806569783779,132725.7764944487,764.9352441272316,133490.71173857595,1440,13,229.1904761904762,35,7,19,33.495848777565634,0.649702380952381,42.3900462962963,1030.4398148148148,29.441137566137566,0
3684,4,0,0,42,0.0,0.0,1.0,42,1850,1500,350,0.8108108108108109,22,15,7,343.6682723955353,0.43514082462253195,0.26917647813672985,0.20935086415558404,132815.23946544924,728.8767789780513,133544.11624442728,1441,14,230.1904761904762,35,7,19,33.44702073508497,0.6505952380952381,42.30324074074074,1030.787037037037,29.4510582010582,0
3685,4,0,0,42,0.0,0.0,1.0,42,1300,1000,300,0.7692307692307693,16,10,6,307.80302593270693,0.4353464963221061,0.1454710226336524,0.17318687069735852,129772.26382725182,-411.1409023668628,129361.12292488496,1442,15,231.1904761904762,38,4,16,37.431844395512215,0.6143092105263157,45.2724358974359,1018.9102564102566,26.81342780026991,8
3686,4,0,0,42,0.0,0.0,1.0,42,1400,1100,300,0.7857142857142857,17,11,6,308.0645963749296,0.43545538133952766,0.1439376924650999,0.17381693163886489,129881.1445891775,-397.64352308422986,129483.50106609326,1443,16,232.1904761904762,38,4,16,37.31505258009294,0.6154057017543859,45.16559829059829,1019.3376068376073,26.82467386414756,0
3687,4,0,0,42,0.0,0.0,1.0,42,1000,800,200,0.8,12,8,4,306.4148912101819,0.4348625629113434,0.14400471001476878,0.17324785081220231,129962.83512309153,-435.4904028782212,129527.34472021331,1444,17,233.1904761904762,38,4,16,37.27450929030454,0.6162280701754386,45.085470085470085,1019.6581196581196,26.83310841205578,0
3688,4,0,0,42,0.0,0.0,1.0,42,1350,700,650,0.5185185185185185,20,7,13,305.26453500790285,0.43442702284165696,0.13955026455026465,0.17298323650447847,130050.00000000015,-460.06944444442814,129589.93055555572,1445,18,234.1904761904762,39,3,17,37.21575435729848,0.6153846153846154,45.00000000000001,1020.0000000000011,26.15384615384618,0
3689,4,0,0,42,0.0,0.0,1.0,42,800,400,400,0.5,12,4,8,305.5097558197958,0.4344512195121952,0.1431731769693787,0.17335820095591437,130103.13042534732,-450.4448784722102,129652.68554687512,1446,19,235.1904761904762,39,3,17,37.155826696616984,0.6159188034188035,44.94791666666667,1020.2083333333342,26.159188034188055,0
3690,4,0,0,42,0.0,0.0,1.0,42,1450,1000,450,0.6896551724137931,19,10,9,306.7209706014119,0.4339914827719706,0.14776682416535403,0.1742829830633083,130156.27170138911,-415.6684027777568,129740.60329861136,1447,20,236.1904761904762,39,3,18,37.071253572886874,0.6164529914529915,44.89583333333334,1020.4166666666684,26.16452991452996,0
3691,4,0,0,42,0.0,0.0,1.0,42,1000,700,300,0.7,13,7,6,308.3052110977955,0.4339309910956253,0.14493461431924493,0.17554228724853588,130236.00396050369,-369.512261284702,129866.49169921898,1448,21,237.1904761904762,39,3,20,36.95030530326224,0.6172542735042735,44.81770833333334,1020.7291666666683,26.17254273504278,0
3692,4,2,2,42,0.045454545454545456,0.045454545454545456,0.9545454545454546,44,1100,700,400,0.6363636363636364,15,7,8,295.1794204949234,0.43667415433403806,0.14586571480209698,0.1698801470354078,130651.91436975347,-1086.8460132831533,129565.06835647032,1449,0,227.36363636363637,40,4,14,36.86609509609015,0.6197916666666667,44.41056910569106,1022.3577235772359,25.558943089430898,0
3693,4,0,1,41,0.0,0.023809523809523808,0.9761904761904762,42,950,700,250,0.7368421052631579,12,7,5,311.32992153465653,0.43418505613627567,0.14958478422229793,0.17788420322473308,130371.67302441756,-282.279453393227,130089.39357102432,1450,23,239.1904761904762,38,4,20,36.73610384628795,0.6203399122807017,44.68482905982906,1021.2606837606849,26.87528115159697,0
3694,4,0,0,41,0.0,0.0,1.0,41,1200,800,400,0.6666666666666666,16,8,8,333.6659823572294,0.4331808943089431,0.18028513301308102,0.17801164845555725,127658.21468195258,384.9695695448805,128043.18425149746,1451,24,245.41463414634146,38,3,16,38.925890686119025,0.5929276315789473,47.355769230769226,1010.5769230769224,26.594129554655854,8
3695,4,2,0,43,0.046511627906976744,0.0,1.0,43,1050,800,250,0.7619047619047619,13,8,5,320.2731933984938,0.4364156515319306,0.18191050927288788,0.17329850875671926,128225.67389875081,-384.7016765285978,127840.97222222222,1452,0,234.95348837209303,38,5,19,38.68539029535866,0.5986842105263157,46.794871794871796,1012.8205128205128,26.653171390013494,0
3696,4,1,1,43,0.022727272727272728,0.022727272727272728,0.9772727272727273,44,1150,700,450,0.6086956521739131,16,7,9,317.3408215171402,0.43825977801268495,0.18680436244117393,0.17318555147370393,128566.75347222229,-640.1041666666615,127926.64930555563,1453,0,230.5909090909091,39,5,16,38.412421254450834,0.6004273504273504,46.458333333333336,1014.1666666666672,26.004273504273517,0
3697,4,1,0,44,0.022727272727272728,0.0,1.0,44,1250,800,450,0.64,17,8,9,317.9321669214654,0.43985641296687805,0.20566502463054182,0.17443305374339854,128778.125,-611.4583333333333,128166.66666666667,1454,0,231.54545454545453,39,5,17,38.182471264367805,0.6025641025641026,46.25,1015.0,26.025641025641026,0
3698,4,0,0,44,0.0,0.0,1.0,44,900,500,400,0.5555555555555556,13,5,8,317.18858252579486,0.43944899577167024,0.1989540586527878,0.17441007859192156,128865.8177692676,-625.0467851477288,128240.77098411987,1455,1,232.54545454545453,40,4,17,38.112217662563,0.6018229166666667,46.16361788617886,1015.3455284552842,25.383638211382106,0
3699,4,1,0,45,0.022222222222222223,0.0,1.0,45,1250,800,450,0.64,17,8,9,316.1176444529951,0.44023569023569026,0.20567986833350815,0.17566397300338935,129282.86540516102,-824.971969367197,128457.89343579383,1456,0,228.35555555555555,38,7,19,37.71601533774556,0.609375,45.753205128205124,1016.9871794871791,26.762820512820504,0
3700,4,0,0,45,0.0,0.0,1.0,45,1450,900,550,0.6206896551724138,20,9,11,313.8803397606795,0.4402146464646464,0.20028696412948377,0.1751441263163721,129445.8954840565,-873.8956689677901,128571.99981508871,1457,1,229.35555555555555,38,7,16,37.60761154855642,0.6110197368421053,45.592948717948715,1017.6282051282049,26.77968960863697,0
3701,4,0,0,45,0.0,0.0,1.0,45,850,300,550,0.35294117647058826,14,3,11,313.9798624353639,0.4400462962962963,0.20230135989448272,0.17552695742095986,129519.29253472232,-866.7100694444405,128652.58246527788,1458,2,230.35555555555555,39,6,16,37.53069995906672,0.6100427350427351,45.520833333333336,1017.9166666666674,26.10042735042737,0
3702,4,0,0,45,0.0,0.0,1.0,45,1700,1500,200,0.8823529411764706,19,15,4,312.7616805898254,0.4396675084175084,0.20302792826558558,0.17615126777261159,129811.04736328126,-880.015733506945,128931.03162977433,1459,3,231.35555555555555,39,6,16,37.266282496848255,0.6129807692307692,45.234375,1019.0625000000001,26.129807692307697,0
3703,4,2,1,46,0.0425531914893617,0.02127659574468085,0.9787234042553191,47,1000,600,400,0.6,14,6,8,303.1505998150101,0.4419133518347209,0.20903418741872537,0.17284057467318867,130288.52390276923,-1499.807203299054,128788.71669947017,1460,0,222.46808510638297,40,7,19,37.02883403012808,0.6161458333333334,44.76626016260161,1020.9349593495912,25.52337398373978,0
3704,4,0,2,44,0.0,0.043478260869565216,0.9565217391304348,46,950,700,250,0.7368421052631579,12,7,5,303.84059800500023,0.44164653784219005,0.20285528877352443,0.1736972701905717,130392.29811124323,-1276.305233326723,129115.9928779165,1461,1,225.56521739130434,40,6,19,36.906509121061376,0.6171875,44.66463414634146,1021.3414634146335,25.533536585365837,0
3705,4,0,0,44,0.0,0.0,1.0,44,800,600,200,0.75,10,6,4,318.0393962000607,0.4397573114869626,0.21135458167330734,0.1806060824575003,130132.94004891255,-522.5196642210418,129610.42038469152,1462,2,229.0681818181818,40,4,19,36.8061088977424,0.6145833333333333,44.918699186991866,1020.3252032520314,25.508130081300784,0
3706,4,0,0,44,0.0,0.0,1.0,44,1100,800,300,0.7272727272727273,14,8,6,317.994223840964,0.4396141649048626,0.2121197390981564,0.18071207659824046,130161.33334120666,-521.8895660116128,129639.44377519505,1463,3,230.0681818181818,41,3,20,36.778550132866656,0.6133130081300813,44.890873015873005,1020.4365079365064,24.888695315524544,0
3707,4,0,0,44,0.0,0.0,1.0,44,1150,900,250,0.782608695652174,14,9,5,319.86929662012665,0.43911865750528545,0.21223681071576883,0.1821325507982557,130237.26974875582,-468.21922634796215,129769.05052240785,1464,4,231.0681818181818,41,3,20,36.65393057310394,0.6140752032520325,44.816468253968246,1020.7341269841257,24.895954316685994,0
3708,4,1,1,44,0.022222222222222223,0.022222222222222223,0.9777777777777777,45,1500,1200,300,0.8,18,12,6,315.1853176602353,0.43994107744107747,0.20773508193750745,0.18094108552162494,130555.17713758688,-770.1776229154805,129784.9995146714,1465,0,226.9111111111111,39,6,16,36.45238762613393,0.6204594017094017,44.505208333333336,1021.9791666666673,26.204594017094035,0
3709,4,0,0,44,0.0,0.0,1.0,44,950,300,650,0.3157894736842105,16,3,13,321.4613286383002,0.43862315010570824,0.2115563773254876,0.18419021484530035,130480.80490037613,-411.0934189860575,130069.71148139007,1466,6,233.0681818181818,38,6,20,36.36716162989297,0.6214364035087719,44.57799145299145,1021.6880341880335,26.886527215474565,0
3710,4,0,1,43,0.0,0.022727272727272728,0.9772727272727273,44,1050,800,250,0.7619047619047619,13,8,5,334.52519388406273,0.43862315010570824,0.1663606385370604,0.17875729523408307,127723.00347222235,-220.7842519541149,127502.21922026823,1467,7,234.0681818181818,39,5,17,38.83793624622149,0.5918803418803419,47.29166666666667,1010.8333333333344,25.918803418803446,8
3711,4,4,1,46,0.0851063829787234,0.02127659574468085,0.9787234042553191,47,1100,700,400,0.6363636363636364,15,7,8,323.06938123760494,0.4418940795559667,0.20659926059301736,0.17695270277879815,128711.08596280341,-1082.0889310264843,127628.99703177692,1468,0,219.89361702127658,40,7,17,38.12030545818728,0.6002604166666667,46.31605691056912,1014.735772357725,25.368394308943124,0
3712,4,1,0,47,0.02127659574468085,0.0,1.0,47,1400,1200,200,0.8571428571428571,16,12,4,325.6087319744815,0.4417206290471785,0.20709702562093169,0.17904000226510966,128865.8177692676,-1008.0328962588402,127857.78487300876,1469,0,220.87234042553192,40,7,18,37.89848363527177,0.6018229166666667,46.16361788617886,1015.3455284552842,25.383638211382106,0
3713,4,1,0,48,0.020833333333333332,0.0,1.0,48,1150,900,250,0.782608695652174,14,9,5,322.2381643093903,0.44317929964539005,0.20896898042206935,0.17825073139646028,129102.89345592218,-1279.6241211465624,127823.26933477561,1470,0,217.25,42,6,19,37.743135011441645,0.6011904761904762,45.93023255813954,1016.2790697674424,24.197120708748628,0
3714,4,1,0,49,0.02040816326530612,0.0,1.0,49,1050,700,350,0.6666666666666666,14,7,7,321.08722526412936,0.4465171485260771,0.22701365558508435,0.17901712422260366,129413.28125,-1489.2594908659344,127924.02175913406,1471,0,213.79591836734693,39,10,20,37.45734370734371,0.608974358974359,45.625,1017.5,26.08974358974359,0
3715,4,0,0,49,0.0,0.0,1.0,49,1250,900,350,0.72,16,9,7,317.9627665682122,0.44648171768707484,0.2201525652725027,0.17787350415976738,129545.80213758671,-1561.85167100695,127983.95046657976,1472,1,214.79591836734693,39,10,16,37.4024736518981,0.610309829059829,45.494791666666664,1018.0208333333326,26.103098290598272,0
3716,4,0,1,48,0.0,0.02040816326530612,0.9795918367346939,49,1400,900,500,0.6428571428571429,19,9,10,321.20062648277514,0.44641085600907027,0.23264256859556176,0.1740209522309185,128276.40109592008,-1464.3581814236172,126812.04291449646,1473,2,215.79591836734693,39,10,16,38.61021850899742,0.5974893162393162,46.744791666666664,1013.0208333333328,25.974893162393148,8
3717,4,2,2,48,0.04,0.04,0.96,50,1300,800,500,0.6153846153846154,18,8,10,325.21823192798587,0.44916666666666666,0.2887027851964903,0.17945199702805276,129004.43558079429,-1609.0811099092755,127395.35447088501,1474,0,211.52,42,8,15,37.76747106702276,0.6001984126984127,46.02713178294573,1015.8914728682159,24.187892211148,0
3718,4,0,0,48,0.0,0.0,1.0,48,1100,700,400,0.6363636363636364,15,7,8,330.80563253866546,0.4472517730496454,0.2863619442671772,0.18225047630922234,128942.64510459518,-1069.0093449931574,127873.63575960202,1475,1,218.6875,44,4,15,37.68840976084114,0.5968276515151515,46.087962962962955,1015.6481481481469,23.08291245791243,0
3719,4,1,0,49,0.02040816326530612,0.0,1.0,49,900,500,400,0.5555555555555556,13,5,8,330.87466983938157,0.4479875283446712,0.30185764061722287,0.1837196839574029,129251.82370401848,-1245.731721186433,128006.09198283205,1476,0,215.20408163265307,41,8,16,37.37235772357723,0.6041666666666667,45.78373015873015,1016.865079365078,24.80158730158727,0
3720,4,0,1,48,0.0,0.02040816326530612,0.9795918367346939,49,1800,1300,500,0.7222222222222222,23,13,10,330.83434815371874,0.44749149659863946,0.30324064839563336,0.18424849156119208,129369.92550684378,-1239.9970048496552,128129.92850199412,1477,1,216.20408163265307,43,6,16,37.2534247106643,0.6024709302325582,45.667613636363626,1017.3295454545436,23.65882663847776,0
3721,4,0,0,48,0.0,0.0,1.0,48,1350,800,550,0.5925925925925926,19,8,11,336.22013865479954,0.447408761820331,0.2988637806775254,0.1872665907552645,129373.84627013079,-900.3814937503951,128473.4647763804,1478,2,216.77083333333334,42,6,16,37.11246309172302,0.6039186507936508,45.66375968992247,1017.3449612403084,24.2224990771502,0
3722,4,0,1,47,0.0,0.020833333333333332,0.9791666666666666,48,1150,900,250,0.782608695652174,14,9,5,335.64917362459033,0.447159426713948,0.29755840157430336,0.187300086153318,129447.79178685162,-910.191131843052,128537.60065500857,1479,3,217.77083333333334,42,6,15,37.051871072176716,0.6046626984126984,45.59108527131782,1017.6356589147276,24.22942045035066,0
3723,4,0,0,47,0.0,0.0,1.0,47,1000,800,200,0.8,12,8,4,372.2798994184833,0.4470783225408572,0.3035196789933863,0.19728955522183103,127388.43831041343,152.85763627514172,127541.29594668858,1480,4,219.5744680851064,38,9,15,38.227369739302205,0.5901864035087719,47.62286324786324,1009.5085470085467,26.566014394961755,7
3724,4,2,0,49,0.04081632653061224,0.0,1.0,49,1400,1100,300,0.7857142857142857,17,11,6,365.7579999863406,0.449812216553288,0.32078200289230696,0.19713834515904005,128069.2075007084,-431.532560941063,127637.67493976734,1481,0,211.57142857142858,41,8,17,37.69387680094089,0.5922256097560976,46.94940476190475,1012.2023809523793,24.68786295005803,0
3725,4,1,2,48,0.02,0.04,0.96,50,1550,1000,550,0.6451612903225806,21,10,11,360.45135678895974,0.45063775510204085,0.3230685438289995,0.1960621661773823,128434.73442925357,-741.0387104060275,127693.69571884755,1482,0,208.32,39,11,15,37.454291268454774,0.5990918803418803,46.58854166666667,1013.6458333333342,25.990918803418825,0
3726,4,0,0,48,0.0,0.0,1.0,48,1200,900,300,0.75,15,9,6,364.9857040033781,0.4503823138297873,0.3154338392888518,0.19843090967793972,128415.1066207356,-226.06438107239285,128189.0422396632,1483,1,215.10416666666666,38,10,16,37.35945680053407,0.6006030701754386,46.60790598290598,1013.5683760683759,26.672852001799367,0
3727,4,1,2,47,0.02040816326530612,0.04081632653061224,0.9591836734693877,49,1300,900,400,0.6923076923076923,17,9,8,360.06158309538625,0.45108772675736963,0.31744914714654326,0.19754730099557694,128778.12500000013,-526.388888888875,128251.73611111126,1484,0,211.69387755102042,39,10,17,37.113437328954575,0.6025641025641026,46.25000000000001,1015.000000000001,26.02564102564105,0
3728,4,1,1,47,0.020833333333333332,0.020833333333333332,0.9791666666666666,48,1550,1100,450,0.7096774193548387,20,11,9,353.97295083787503,0.4523677600472813,0.3020747880776593,0.1952457136069548,128989.67013888899,-468.2291666666571,128521.44097222234,1485,0,207.8125,39,9,18,37.05222860267978,0.6047008547008548,46.04166666666667,1015.8333333333342,26.04700854700857,0
3729,4,0,0,47,0.0,0.0,1.0,47,1150,800,350,0.6956521739130435,15,8,7,359.2492710644944,0.4524167437557817,0.31156453453251864,0.19840072983875398,129038.51290269564,-128.60166009204167,128909.9112426036,1486,1,212.70212765957447,38,9,18,36.8684279705573,0.606907894736842,45.993589743589745,1016.0256410256414,26.737516869095828,0
3730,4,2,1,48,0.04081632653061224,0.02040816326530612,0.9795918367346939,49,1600,1100,500,0.6875,21,11,10,349.17221067499145,0.4540639172335601,0.3235114631310505,0.19564728629884434,129609.02829142008,-748.6203566732443,128860.40793474684,1487,0,204.9795918367347,38,11,17,36.54390934844192,0.6126644736842105,45.43269230769231,1018.2692307692305,26.796558704453435,0
3731,4,0,0,48,0.0,0.0,1.0,48,1500,1300,200,0.8666666666666667,17,13,4,355.6562327572827,0.4522569444444444,0.3311506227342882,0.19933490848623317,129619.76431450054,-379.98458660357875,129239.77972789697,1488,1,210.25,37,11,17,36.36792918416425,0.6145833333333333,45.422149122807014,1018.3114035087714,27.52192982456139,0
3732,4,0,0,48,0.0,0.0,1.0,48,1250,900,350,0.72,16,9,7,352.83392090197015,0.45180444739952713,0.3241734832992502,0.19831699692076252,129731.4453125,-445.269097222221,129286.17621527778,1489,2,211.25,37,11,17,36.32626107702794,0.6157094594594594,45.3125,1018.75,27.533783783783782,0
3733,4,0,1,47,0.0,0.020833333333333332,0.9791666666666666,48,1450,1200,250,0.8275862068965517,17,12,5,350.27928285554293,0.45164745862884165,0.3260631812966146,0.1975847216884182,129871.11418898145,-501.76785164663545,129369.3463373348,1490,3,212.25,37,11,17,36.24946213425129,0.6171171171171171,45.17543859649124,1019.2982456140369,27.54860123281181,0
3734,4,0,0,47,0.0,0.0,1.0,47,650,200,450,0.3076923076923077,11,2,9,385.8533686228327,0.4503353376503238,0.2669829631227085,0.21427569704240435,129257.1332044476,632.2334756848339,129889.36668013243,1491,4,217.6595744680851,37,10,16,35.96928689526275,0.6109234234234234,45.77850877192983,1016.8859649122813,27.483404457088685,8
3735,4,0,1,46,0.0,0.02127659574468085,0.9787234042553191,47,1500,1200,300,0.8,18,12,6,381.8969068480273,0.45054733271662045,0.26311697426029657,0.21252895049964896,129340.77222077946,478.9681680901822,129819.74038886964,1492,5,218.6595744680851,37,10,16,35.98449121483239,0.6117680180180181,45.69627192982456,1017.2149122807016,27.492294926505448,0
3736,4,2,2,46,0.041666666666666664,0.041666666666666664,0.9583333333333334,48,1450,800,650,0.5517241379310345,21,8,13,380.6645823122099,0.451065676713948,0.2834132683370023,0.21448077086096698,129826.69850107758,284.0851915771856,130110.78369265478,1493,0,214.83333333333334,38,10,12,35.52040745011707,0.6148574561403508,45.2190170940171,1019.1239316239322,26.81905083220874,0
3737,4,0,0,46,0.0,0.0,1.0,46,1400,1000,400,0.7142857142857143,18,10,8,386.0566444754886,0.4500503220611916,0.2880783243134124,0.21691108111337093,129717.10519641275,815.6300726402242,130532.73526905298,1494,1,223.08695652173913,36,10,12,35.49473984818338,0.6174768518518519,45.326576576576585,1018.6936936936947,28.297047047047077,0
3738,4,1,0,47,0.02127659574468085,0.0,1.0,47,1300,700,600,0.5384615384615384,19,7,12,375.8942678882819,0.45079787234042556,0.28442293352607817,0.21294570523122996,130038.8160299322,376.1691097260631,130414.98513965827,1495,0,219.31914893617022,37,10,13,35.42607324589695,0.6188063063063063,45.0109649122807,1019.9561403508766,27.566382171645312,0
3739,4,0,0,47,0.0,0.0,1.0,47,1500,1400,100,0.9333333333333333,16,14,2,374.8796025548889,0.4507593277829171,0.28508123063555435,0.21282823073662233,130122.70752779699,356.06977627731374,130478.7773040743,1496,1,220.31914893617022,37,10,13,35.36662636575319,0.6196509009009009,44.92872807017544,1020.2850877192981,27.57527264106211,0
3740,4,0,0,47,0.0,0.0,1.0,47,1800,1400,400,0.7777777777777778,22,14,8,376.54815491601164,0.4511062288004934,0.28963487615641315,0.2147034951238091,130291.32806793298,412.26698042072405,130703.5950483537,1497,2,221.31914893617022,36,11,16,35.1526307081403,0.6232638888888888,44.76351351351352,1020.9459459459473,28.35960960960965,0
3741,4,0,0,47,0.0,0.0,1.0,47,900,600,300,0.6666666666666666,12,6,6,376.74377535937003,0.45097132284921365,0.2869559707989453,0.21497393399518025,130320.07250071045,419.45522380491553,130739.52772451537,1498,3,222.31914893617022,36,11,16,35.11842395500166,0.6235532407407407,44.735360360360374,1021.0585585585608,28.3627377377378,0
3742,4,0,0,47,0.0,0.0,1.0,47,1450,1200,250,0.8275862068965517,17,12,5,377.18693247288707,0.4504509713228492,0.2800191334605766,0.21634603193798876,130521.37230135564,446.19120810001453,130967.56350945566,1499,4,223.31914893617022,36,11,13,34.902606347806916,0.6255787037037037,44.5382882882883,1021.8468468468487,28.384634634634686,0
3743,4,0,0,47,0.0,0.0,1.0,47,1300,600,700,0.46153846153846156,20,6,14,376.84466664413543,0.45056660499537465,0.27135918576780593,0.21727786779653335,130722.82745160729,452.44006675597745,131175.26751836325,1500,5,224.31914893617022,36,11,13,34.70685130125172,0.6276041666666667,44.34121621621623,1022.6351351351373,28.40653153153159,0
3744,4,0,2,45,0.0,0.0425531914893617,0.9574468085106383,47,1100,700,400,0.6363636363636364,15,7,8,375.9053835321922,0.4504509713228492,0.2683399944711766,0.21689788394151055,130751.6194403866,430.0475306387735,131181.66697102538,1501,6,225.31914893617022,36,11,13,34.70165345371798,0.6278935185185186,44.313063063063076,1022.7477477477499,28.40965965965972,0
3745,4,0,0,45,0.0,0.0,1.0,45,750,400,350,0.5333333333333333,11,4,7,377.6502242100296,0.4497895622895623,0.259807231273546,0.21822993872289514,130809.21292914548,880.0257182858695,131689.23864743134,1502,7,231.66666666666666,36,9,14,34.59860744165567,0.6284722222222222,44.256756756756765,1022.9729729729739,28.415915915915942,0
3746,4,0,3,42,0.0,0.06666666666666667,0.9333333333333333,45,1250,900,350,0.72,16,9,7,379.3665500882007,0.4496422558922559,0.2642700805790934,0.21971343790003067,130895.62694028491,931.4844827936072,131827.11142307852,1503,8,232.66666666666666,36,9,14,34.467049998165876,0.6293402777777778,44.1722972972973,1023.3108108108111,28.425300300300307,0
3747,4,0,0,42,0.0,0.0,1.0,42,1400,1100,300,0.7857142857142857,17,11,6,404.1555070899388,0.44703348819202476,0.27730554793894546,0.23139013098226147,130450.30757400989,2144.4420415224804,132594.74961553238,1504,11,248.52380952380952,33,9,16,34.28602847088932,0.6313131313131313,44.607843137254896,1021.5686274509795,30.956625074272107,0
3748,4,1,0,43,0.023255813953488372,0.0,1.0,43,1600,1200,400,0.75,20,12,8,393.9829654497011,0.44728220745662606,0.26893497896478835,0.2277577129895298,130824.41332572456,1708.5180630572793,132532.93138878184,1505,0,243.72093023255815,35,8,16,34.16546460761021,0.6306547619047619,44.24189814814815,1023.0324074074082,29.229497354497376,0
3749,4,0,2,41,0.0,0.046511627906976744,0.9534883720930233,43,1000,800,200,0.8,12,8,4,390.84040969359256,0.44665928386858617,0.26278385927628745,0.2264620512785548,130913.23329260974,1633.2363468792923,132546.46963948905,1506,1,244.72093023255815,35,8,16,34.15563974967956,0.631547619047619,44.155092592592595,1023.3796296296298,29.239417989417994,0
3750,4,0,0,41,0.0,0.0,1.0,41,1300,800,500,0.6153846153846154,18,8,10,399.2933030599904,0.44570630081300816,0.25171844224842066,0.2309237312582474,130840.48327664395,2248.745748299317,133089.22902494326,1507,2,253.390243902439,34,7,16,34.013313552090594,0.6329656862745099,44.226190476190474,1023.0952380952378,30.09103641456582,0
3751,4,1,0,42,0.023809523809523808,0.0,1.0,42,1200,700,500,0.5833333333333334,17,7,10,389.86101146204606,0.4453881145954317,0.25428657509778274,0.22746603905409174,131179.8740381731,1828.3836751971987,133008.2577133703,1508,0,248.33333333333334,35,7,17,33.91012785749256,0.6342261904761906,43.89467592592593,1024.421296296297,29.269179894179914,0
3752,4,1,0,43,0.023255813953488372,0.0,1.0,43,1450,1000,450,0.6896551724137931,19,10,9,378.64904798262575,0.44532115171650055,0.25039200498743663,0.22302247754383372,131541.7534722223,1361.7993934327951,132903.5528656551,1509,0,243.53488372093022,34,9,18,33.83089629027891,0.6400122549019608,43.54166666666667,1025.8333333333342,30.171568627451006,0
3753,4,1,3,41,0.022727272727272728,0.06818181818181818,0.9318181818181819,44,900,700,200,0.7777777777777778,11,7,4,366.71492727095097,0.44629800916138124,0.24678397312466682,0.21816097147834884,131921.96609224982,875.550840192062,132797.51693244188,1510,0,238.97727272727272,35,9,16,33.75300435631665,0.6416666666666666,43.171296296296305,1027.3148148148161,29.35185185185189,0
3754,4,0,0,41,0.0,0.0,1.0,41,1200,800,400,0.6666666666666666,16,8,8,385.75299704698756,0.4463922764227642,0.2492778316050288,0.22844556584042638,131749.07415378527,1964.5200425976918,133713.59419638297,1511,1,242.58536585365854,32,9,16,33.43889640470627,0.6468098958333333,43.339646464646464,1026.6414141414139,32.08254419191918,0
3755,4,0,1,40,0.0,0.024390243902439025,0.975609756097561,41,800,600,200,0.75,10,6,4,385.96392880570045,0.44593495934959354,0.24798697267680891,0.22896022122368803,131813.89534550055,1975.081783746566,133788.97712924713,1512,2,243.58536585365854,32,9,16,33.367914668633965,0.6474609375,43.276515151515156,1026.89393939394,32.09043560606062,0
3756,4,0,0,40,0.0,0.0,1.0,40,1050,700,350,0.6666666666666666,14,7,7,398.1604395134833,0.44436431623931627,0.2557965499746322,0.2356679358201428,131728.82080078125,2489.8410373263887,134218.66183810763,1513,3,250.5,31,9,16,33.140960595298495,0.6491935483870968,43.359375,1026.5625,33.11491935483871,0
3757,4,0,1,39,0.0,0.025,0.975,40,1050,300,750,0.2857142857142857,18,3,15,394.568533180877,0.4433894230769231,0.24717102838186467,0.2352669078065318,132008.45457415062,2417.2764577594103,134425.73103191002,1514,4,251.5,32,8,18,32.95014743826022,0.6494140625,43.08712121212121,1027.6515151515152,32.11410984848485,0
3758,4,0,0,39,0.0,0.0,1.0,39,1050,900,150,0.8571428571428571,12,9,3,399.17156327352615,0.4426450742240216,0.23406768928331756,0.23801152772770906,132008.4545741506,2738.8042355371877,134747.25880968777,1515,5,256.53846153846155,32,7,18,32.83188966703526,0.6494140625,43.08712121212121,1027.651515151515,32.114109848484844,0
3759,4,0,0,39,0.0,0.0,1.0,39,1400,1000,400,0.7142857142857143,18,10,8,401.84387403615307,0.44185784975258663,0.2360221453810254,0.24022120575641398,132105.78799357207,2817.1803259871435,134922.9683195592,1516,6,257.53846153846155,32,7,18,32.66473225251781,0.650390625,42.99242424242424,1028.030303030303,32.12594696969697,0
3760,4,0,0,39,0.0,0.0,1.0,39,850,600,250,0.7058823529411765,11,6,5,403.7908270000502,0.441689158794422,0.241203213943882,0.2417994481682653,132170.69686766653,2873.862998673601,135044.55986634013,1517,7,258.53846153846155,32,7,18,32.54901358873608,0.6510416666666667,42.92929292929293,1028.2828282828282,32.13383838383838,0
3761,4,0,0,39,0.0,0.0,1.0,39,1150,1000,150,0.8695652173913043,13,10,3,403.353523384742,0.4407613585245164,0.2425036736963344,0.24198328247091788,132240.39619677534,2867.925947952722,135108.32214472807,1518,8,259.53846153846155,33,6,18,32.489748401445645,0.6493055555555556,42.86151960784314,1028.553921568628,31.16830065359479,0
3762,4,0,1,38,0.0,0.02564102564102564,0.9743589743589743,39,1350,900,450,0.6666666666666666,18,9,9,405.62169038833855,0.44028340080971656,0.2460458714507765,0.24416392003598864,132367.37528344666,2938.2157029478376,135305.5909863945,1519,9,260.53846153846155,34,5,19,32.30299436989048,0.6482843137254901,42.738095238095234,1029.0476190476186,30.266106442577016,0
3763,4,0,0,38,0.0,0.0,1.0,38,1000,500,500,0.5,15,5,10,407.9876545620893,0.4395448079658606,0.2452661664880309,0.2455822462622126,132366.47450800182,3200.777495434455,135567.25200343627,1520,10,267.07894736842104,33,5,19,32.243038188241826,0.6505681818181819,42.7389705882353,1029.0441176470595,31.183155080213922,0
3764,4,1,0,39,0.02564102564102564,0.0,1.0,39,900,600,300,0.6666666666666666,12,6,6,402.5400123593218,0.4380623031938822,0.2645438915169942,0.24577597207968152,132901.0030958388,2899.605549449699,135800.6086452885,1521,0,261.20512820512823,31,8,16,31.8433777412973,0.6609543010752688,42.220052083333336,1031.119791666667,33.26192876344087,0
3765,4,0,0,39,0.0,0.0,1.0,39,1100,800,300,0.7272727272727273,14,8,6,397.91080938672377,0.43766869095816463,0.2587924572271958,0.24360505656581347,133001.7174614801,2784.5642089843814,135786.28167046446,1522,1,262.20512820512823,31,8,16,31.86116721366658,0.6619623655913979,42.122395833333336,1031.510416666667,33.274529569892486,0
3766,4,0,0,39,0.0,0.0,1.0,39,1000,800,200,0.8,12,8,4,397.22923146314935,0.4370220422852002,0.2538565068847711,0.24391844543563618,133113.66705246904,2775.32793209876,135888.9949845678,1523,2,263.20512820512823,32,7,16,31.765926424405567,0.6604817708333333,42.013888888888886,1031.944444444444,32.24826388888887,0
3767,4,0,0,39,0.0,0.0,1.0,39,1000,900,100,0.9,11,9,2,395.8484612457202,0.4369376968061178,0.24311003254510255,0.24413640392665897,133276.58689164364,2751.4663682277246,136028.05325987138,1524,3,264.20512820512823,32,7,16,31.63747248716068,0.662109375,41.8560606060606,1032.575757575757,32.26799242424241,0
3768,4,0,0,39,0.0,0.0,1.0,39,1150,800,350,0.6956521739130435,15,8,7,396.331406762483,0.43592555105713,0.24510827151091208,0.24507840050822918,133374.38662190078,2772.09165518824,136146.47827708902,1525,4,265.20512820512823,32,7,16,31.526555433321107,0.6630859375,41.76136363636363,1032.954545454545,32.27982954545453,0
3769,4,0,0,39,0.0,0.0,1.0,39,1700,1300,400,0.7647058823529411,21,13,8,398.2841216216163,0.43451979307242466,0.24664593686127523,0.2480607223370396,133640.46096801758,2845.410592015234,136485.8715600328,1526,5,266.20512820512823,31,8,19,31.208417285816232,0.6683467741935484,41.50390625,1033.984375,33.35433467741935,0
3770,4,0,1,38,0.0,0.02564102564102564,0.9743589743589743,39,1200,900,300,0.75,15,9,6,400.2292342174517,0.43378879892037786,0.2404047835711569,0.25041114134581677,133808.80567762596,2910.8391655816185,136719.64484320758,1527,6,267.20512820512823,31,8,15,30.988862320664495,0.6700268817204301,41.34114583333334,1034.6354166666677,33.37533602150541,0
3771,4,0,0,38,0.0,0.0,1.0,38,1300,1000,300,0.7692307692307693,16,10,6,406.3084786777704,0.43215090090090086,0.2503308366640913,0.23051607027084228,130096.48852878153,2984.2208862304756,133080.709415012,1528,7,270.10526315789474,31,7,19,34.5917092108062,0.632728494623656,44.954427083333336,1020.1822916666672,32.90910618279572,8
3772,4,1,0,39,0.02564102564102564,0.0,1.0,39,850,600,250,0.7058823529411765,11,6,5,394.3386426592799,0.43426675663517766,0.24335357624831344,0.2256757292327203,130434.15423748402,2487.2573953099823,132921.411632794,1529,0,264.15384615384613,30,9,20,34.55317982456141,0.6388888888888888,44.62365591397849,1021.5053763440853,34.05017921146951,0
3773,4,1,1,39,0.025,0.025,0.975,40,1000,600,400,0.6,14,6,8,380.58412359438364,0.43545673076923075,0.23853570064910268,0.22003307278006426,130828.11355590823,1958.2205878363727,132786.3341437446,1530,0,258.525,31,9,20,34.504396292053805,0.6401209677419355,44.23828125,1023.0468750000002,33.0015120967742,0
3774,4,0,0,39,0.0,0.0,1.0,39,1150,700,450,0.6086956521739131,16,7,9,384.76425022039786,0.4349696356275304,0.22833623596788244,0.22341333347361636,130994.6780734591,2280.413818359367,133275.09189181848,1531,1,256.61538461538464,31,8,20,34.22846179937251,0.6418010752688172,44.07552083333333,1023.6979166666658,33.02251344086019,0
3775,4,0,0,39,0.0,0.0,1.0,39,1250,800,450,0.64,17,8,9,386.2852164489296,0.43437921727395407,0.232049227735164,0.22530064421640306,131166.40082963475,2333.528307060506,133499.92913669525,1532,2,257.61538461538464,32,7,21,34.01536628456386,0.6409505208333333,43.907828282828284,1024.368686868687,32.01152146464647,0
3776,4,0,0,39,0.0,0.0,1.0,39,1450,1000,450,0.6896551724137931,19,10,9,390.38599110650574,0.43395748987854255,0.23978165483647818,0.2284616503108513,131295.77219480163,2451.2060312723283,133746.97822607396,1533,3,258.61538461538464,32,7,21,33.779156913473784,0.6422526041666667,43.78156565656566,1024.8737373737379,32.02730429292931,0
3777,4,0,0,39,0.0,0.0,1.0,39,850,500,350,0.5882352941176471,12,5,7,392.60917231511905,0.4337606837606838,0.24567710673882925,0.2303580195834013,131394.86524793826,2517.3698438526194,133912.23509179088,1534,4,259.61538461538464,31,8,21,33.6217297434595,0.6458333333333333,43.68489583333333,1025.2604166666658,33.07291666666664,0
3778,4,0,1,38,0.0,0.02564102564102564,0.9743589743589743,39,600,200,400,0.3333333333333333,10,2,8,390.24122244201055,0.4339293747188484,0.24057506739070988,0.22936864686218467,131461.6224500867,2460.34884982637,133921.97129991307,1535,5,260.61538461538464,31,8,22,33.61477907567292,0.646505376344086,43.61979166666666,1025.5208333333323,33.081317204301044,0
3779,4,0,0,38,0.0,0.0,1.0,38,1400,1100,300,0.7857142857142857,17,11,6,391.91315603073724,0.4336030109056425,0.24360123871466155,0.23058514214884765,131500.39247673136,2707.3467669672727,134207.73924369863,1536,6,266.92105263157896,30,8,22,33.53263006159088,0.6496527777777779,43.581989247311824,1025.672043010752,34.189068100358405,0
3780,4,0,0,38,0.0,0.0,1.0,38,950,600,350,0.631578947368421,13,6,7,392.93809456683357,0.43326220957799905,0.2456611527508672,0.2316059054693929,131569.33108235046,2739.720451786321,134309.0515341368,1537,7,267.92105263157896,30,8,19,33.43650377745753,0.6503472222222222,43.51478494623655,1025.940860215053,34.1980286738351,0
3781,4,0,0,38,0.0,0.0,1.0,38,700,500,200,0.7142857142857143,9,5,4,391.9495735231346,0.43292140825035563,0.24551521586255376,0.23123207451898062,131603.8071597872,2716.4112180598827,134320.21837784708,1538,8,268.92105263157896,30,8,19,33.42693869531045,0.6506944444444445,43.48118279569892,1026.0752688172038,34.20250896057346,0
3782,4,0,1,37,0.0,0.02631578947368421,0.9736842105263158,38,1050,700,350,0.6666666666666666,14,7,7,391.90020904330436,0.43256578947368424,0.24546716868274165,0.23196255616346936,131728.82080078128,2724.910481770833,134453.73128255212,1539,9,269.92105263157896,31,7,19,33.30162354134956,0.6491935483870968,43.359375,1026.5625000000002,33.11491935483872,0
3783,4,0,0,37,0.0,0.0,1.0,37,800,500,300,0.625,11,5,6,388.6874203054098,0.43161911911911915,0.23197921304633917,0.2307725165521313,131846.31191970193,2849.4005713702545,134695.7124910722,1540,10,272.94594594594594,32,5,19,33.265203671830186,0.6477864583333333,43.24494949494949,1027.020202020201,32.09438131313128,0
3784,4,0,0,37,0.0,0.0,1.0,37,850,500,350,0.5882352941176471,12,5,7,393.87444198777763,0.4309309309309309,0.23678704509375414,0.2346522846922791,131976.0180721354,2996.3960947862247,134972.41416692163,1541,11,273.94594594594594,32,5,19,33.0007884820185,0.6490885416666667,43.11868686868686,1027.5252525252515,32.11016414141411,0
3785,4,0,0,37,0.0,0.0,1.0,37,1250,800,450,0.64,17,8,9,389.9926953981011,0.4308058058058058,0.23272461650840093,0.23273757628596348,132040.89506172837,2898.9969135802507,134939.89197530862,1542,12,274.94594594594594,32,5,19,33.03490990990991,0.6497395833333333,43.05555555555556,1027.7777777777776,32.11805555555555,0
3786,4,0,0,37,0.0,0.0,1.0,37,1050,700,350,0.6666666666666666,14,7,7,391.2877438960285,0.4289602102102102,0.2347319695386001,0.23451351538139434,132203.15728305772,2945.8950298438813,135149.0523129016,1543,13,275.94594594594594,32,5,20,32.8376304481277,0.6513671875,42.897727272727266,1028.4090909090899,32.13778409090906,0
3787,4,1,1,37,0.02631578947368421,0.02631578947368421,0.9736842105263158,38,700,300,400,0.42857142857142855,11,3,8,381.8815155142356,0.4284169037458511,0.23269571644212306,0.23102594491476722,132555.7046118077,2524.1146734428767,135079.8192852506,1544,0,269.6578947368421,33,5,21,32.723803998571945,0.6524621212121212,42.555147058823515,1029.779411764704,31.205436720142547,0
3788,4,0,1,36,0.0,0.02702702702702703,0.972972972972973,37,1000,900,100,0.9,11,9,2,369.5271290473141,0.4288038038038038,0.10469879849330543,0.2149379691440886,131061.33355034728,2286.143663194456,133347.47721354174,1545,1,267.4594594594595,35,2,17,34.55090708714819,0.6330357142857144,44.01041666666667,1023.9583333333338,29.255952380952394,8
3789,4,0,0,36,0.0,0.0,1.0,36,1100,900,200,0.8181818181818182,13,9,4,383.20713899405064,0.42868716931216927,0.11560077519379863,0.22267441860465131,131023.24263038566,2841.8083900226975,133865.05102040837,1546,16,275.8611111111111,34,2,17,34.23934108527132,0.6348039215686274,44.04761904761906,1023.8095238095252,30.112044817927213,0
3790,4,0,0,36,0.0,0.0,1.0,36,1400,1000,400,0.7142857142857143,18,10,8,382.99410569495876,0.4283399470899471,0.12216345719193544,0.22308045303275126,131114.67013888908,2843.2291666666874,133957.89930555577,1547,17,276.8611111111111,34,2,17,34.15208841876864,0.6357230392156863,43.95833333333334,1024.1666666666683,30.12254901960789,0
3791,4,0,0,36,0.0,0.0,1.0,36,900,500,400,0.5555555555555556,13,5,8,385.7712849445605,0.42713293650793654,0.12262305875062895,0.22541299725171998,131236.62308673485,2925.4641439909465,134162.0872307258,1548,18,277.8611111111111,34,2,17,33.95734092405405,0.6369485294117647,43.83928571428572,1024.6428571428585,30.136554621848777,0
3792,4,0,0,36,0.0,0.0,1.0,36,800,600,200,0.75,10,6,4,384.8698927944611,0.4269510582010582,0.1214955080545228,0.225065219916761,131267.12018140592,2904.1524943310683,134171.27267573698,1549,19,278.8611111111111,34,2,17,33.949523698884754,0.6372549019607843,43.80952380952381,1024.7619047619048,30.140056022408967,0
3793,4,0,0,36,0.0,0.0,1.0,36,1350,1100,250,0.8148148148148148,16,11,5,383.19581740313043,0.42627314814814815,0.112926841854045,0.22498061181275805,131419.65880102038,2871.8927154195,134291.55151643988,1550,20,279.8611111111111,34,2,18,33.83790007353225,0.6387867647058824,43.660714285714285,1025.3571428571427,30.157563025210077,0
3794,4,0,0,36,0.0,0.0,1.0,36,850,500,350,0.5882352941176471,12,5,7,384.2418759004275,0.4259093915343915,0.11834977751982989,0.2259552055209681,131480.6990504535,2904.0780895691582,134384.77714002266,1551,21,280.8611111111111,34,2,18,33.74927452118399,0.6393995098039216,43.601190476190474,1025.5952380952378,30.164565826330524,0
3795,4,0,0,36,0.0,0.0,1.0,36,950,800,150,0.8421052631578947,11,8,3,383.88036240114985,0.4258267195767196,0.11182005671564865,0.22664717286972003,131633.36167800458,2906.2925170068106,134539.6541950114,1552,22,281.8611111111111,34,2,16,33.60402165506575,0.6409313725490196,43.452380952380956,1026.1904761904766,30.182072829131666,0
3796,4,1,0,37,0.02702702702702703,0.0,1.0,37,800,300,500,0.375,13,3,10,375.35640961287635,0.42824074074074076,0.1113974014582535,0.22295266257728688,131862.52170138896,2499.088541666677,134361.61024305565,1553,0,275.2162162162162,35,2,17,33.591108857336046,0.6410714285714285,43.22916666666667,1027.083333333334,29.345238095238113,0
3797,4,0,0,37,0.0,0.0,1.0,37,1100,900,200,0.8181818181818182,13,9,4,375.5401778570964,0.42755255255255253,0.10756007782030075,0.2235861944223637,131951.69331114966,2510.632474922832,134462.3257860725,1554,1,276.2162162162162,35,2,17,33.496324771882385,0.6419642857142858,43.14236111111111,1027.4305555555552,29.35515873015872,0
3798,4,1,0,38,0.02631578947368421,0.0,1.0,38,1350,1100,250,0.8148148148148148,16,11,5,368.63413594715536,0.4275723091512565,0.09940336671638628,0.2220795892169449,132398.00347222228,2161.284722222227,134559.2881944445,1555,0,269.92105263157896,36,2,18,33.22368421052632,0.6443865740740741,42.708333333333336,1029.166666666667,28.587962962962973,0
3799,4,0,1,37,0.0,0.02631578947368421,0.9736842105263158,38,1300,1100,200,0.8461538461538461,15,11,4,373.3367048691708,0.4261350165955429,0.1066269982851289,0.22612831143930032,132600.9011545329,2300.9566999431863,134901.8578544761,1556,1,270.92105263157896,36,2,18,32.8982615350973,0.646412037037037,42.51126126126126,1029.954954954955,28.60985985985986,0
3800,4,0,1,36,0.0,0.02702702702702703,0.972972972972973,37,850,600,250,0.7058823529411765,11,6,5,377.1613776821225,0.42454954954954954,0.1181592535889282,0.21311190352801915,129937.8714018562,2401.509318201316,132339.38072005752,1557,2,278.5405405405405,35,2,17,35.4964856018466,0.6217261904761905,45.10995370370371,1019.5601851851857,29.13029100529102,8
3801,4,0,0,36,0.0,0.0,1.0,36,1100,800,300,0.7272727272727273,14,8,6,362.17856996247997,0.42347883597883595,0.13478191658707472,0.1923315899526862,127471.5889301481,2056.5666795267216,129528.15560967481,1558,5,287.22222222222223,35,1,17,38.39696752626551,0.5967261904761905,47.540509259259245,1009.8379629629611,28.852513227513175,8
3802,4,0,0,36,0.0,0.0,1.0,36,1100,700,400,0.6363636363636364,15,7,8,367.08482335577037,0.42347883597883595,0.13417280839093215,0.19550234429972646,127588.49511584778,2167.1600383658993,129755.65515421367,1559,6,288.22222222222223,35,1,17,38.15311509527629,0.5979166666666667,47.42476851851851,1010.3009259259248,28.86574074074071,0
3803,4,0,0,36,0.0,0.0,1.0,36,900,500,400,0.5555555555555556,13,5,8,368.3993798021667,0.42402447089947093,0.1255692949647611,0.19691555588691065,127734.70320001697,2211.477087620005,129946.18028763698,1560,7,289.22222222222223,35,1,17,37.9699068773376,0.5994047619047619,47.28009259259258,1010.8796296296282,28.88227513227509,0
3804,4,2,0,38,0.05263157894736842,0.0,1.0,38,700,500,200,0.7142857142857143,9,5,4,354.0761381625757,0.4319582740635372,0.1431339794857618,0.19275033524959592,128466.99948827579,1498.7326120970354,129965.73210037283,1561,0,274.94736842105266,35,3,17,37.58289093123261,0.606845238095238,46.556712962962955,1013.7731481481474,28.964947089947067,0
3805,4,0,0,38,0.0,0.0,1.0,38,950,600,350,0.631578947368421,13,6,7,350.2139707493027,0.4316619250829777,0.14255211805618107,0.19121028197359122,128584.36113522375,1406.4079378858012,129990.76907310955,1562,1,275.94736842105266,35,3,17,37.56098082848341,0.6080357142857142,46.44097222222222,1014.236111111111,28.978174603174597,0
3806,4,1,0,39,0.02564102564102564,0.0,1.0,39,1350,1000,350,0.7407407407407407,17,10,7,346.09879030314096,0.43117408906882587,0.16157000485937623,0.19123388762432583,129058.31665702868,1133.3854547114688,130191.70211174016,1563,0,269.84615384615387,36,3,19,37.18229339835234,0.6108217592592593,45.9740990990991,1016.1036036036039,28.225100100100107,0
3807,4,0,0,39,0.0,0.0,1.0,39,850,500,350,0.5882352941176471,12,5,7,346.96492506963557,0.43131466486729647,0.16474465516016745,0.19199009495729388,129115.53603857242,1159.7124573898288,130275.24849596225,1564,1,270.84615384615387,36,3,19,37.102031394275166,0.611400462962963,45.917792792792795,1016.3288288288294,28.231356356356372,0
3808,4,0,0,39,0.0,0.0,1.0,39,850,700,150,0.8235294117647058,10,7,3,344.8884957284548,0.43128654970760233,0.15469810951038143,0.19139509698415616,129230.01284646142,1113.9889467170024,130344.00179317842,1565,2,271.84615384615387,36,3,19,37.03829327721787,0.6125578703703703,45.80518018018019,1016.77927927928,28.243868868868887,0
3809,4,1,0,40,0.025,0.0,1.0,40,750,600,150,0.8,9,6,3,342.59720320044556,0.43238514957264956,0.17068213631958695,0.19201570465434742,129619.76431450054,881.4737467297559,130501.2380612303,1566,0,266.025,37,3,17,36.700383152076384,0.6145833333333333,45.422149122807014,1018.3114035087714,27.52192982456139,0
3810,4,1,1,40,0.024390243902439025,0.024390243902439025,0.975609756097561,41,1300,1100,200,0.8461538461538461,15,11,4,337.7290597384773,0.4351117886178862,0.15638016302342073,0.18467312415486936,128644.60699445971,530.0479474453596,129174.65494190507,1567,0,260.5121951219512,37,4,14,37.81614785992218,0.6047297297297297,46.38157894736842,1014.4736842105253,27.41820768136555,8
3811,4,0,0,40,0.0,0.0,1.0,40,1350,1100,250,0.8148148148148148,16,11,5,342.6754176004924,0.43536324786324787,0.15324397824397806,0.18744158088420387,128658.13607103736,817.5961011687465,129475.7321722061,1568,1,264.275,36,4,14,37.676906426906434,0.6067708333333333,46.36824324324325,1014.5270270270279,28.18130630630633,0
3812,4,0,0,40,0.0,0.0,1.0,40,1050,600,450,0.5714285714285714,15,6,9,342.57067956661723,0.4351896367521368,0.15745506989128,0.1880592025343173,128800.98637488855,824.6882862592481,129625.6746611478,1569,2,265.275,36,4,15,37.53397492788995,0.6082175925925926,46.227477477477485,1015.0900900900914,28.196946946946984,0
3813,4,0,1,39,0.0,0.025,0.975,40,1450,900,550,0.6206896551724138,20,9,11,343.5748639028964,0.4348824786324786,0.15480561555075578,0.18892537053092767,128867.17547706995,855.1044552169992,129722.27993228695,1570,3,266.275,37,3,15,37.441054715622755,0.6069819819819819,46.16228070175439,1015.350877192983,27.44191559981035,0
3814,4,0,1,38,0.0,0.02564102564102564,0.9743589743589743,39,750,600,150,0.8,9,6,3,347.98729105468817,0.4305555555555556,0.16358951607398842,0.1913081351310408,128858.14868922981,1168.1996185374624,130026.34830776727,1571,4,273.87179487179486,36,3,16,37.338250517598354,0.6087962962962963,46.171171171171174,1015.3153153153157,28.203203203203216,0
3815,4,0,1,37,0.0,0.02631578947368421,0.9736842105263158,38,900,600,300,0.6666666666666666,12,6,6,352.46537129105747,0.42918741109530584,0.16497145324569384,0.19429874990265816,128966.15655006851,1491.220850480099,130457.3774005486,1572,5,279.44736842105266,35,3,18,37.11447888179884,0.611904761904762,46.06481481481481,1015.7407407407401,29.021164021164,0
3816,4,1,0,38,0.02631578947368421,0.0,1.0,38,1250,800,450,0.64,17,8,9,349.3919163039073,0.43142484589853014,0.15380170188812636,0.1944778690560506,129348.51794249391,1438.6653109996514,130787.18325349357,1573,0,276.0263157894737,35,3,19,36.803224674782875,0.6157738095238094,45.688657407407405,1017.2453703703696,29.06415343915342,0
3817,4,0,0,38,0.0,0.0,1.0,38,1100,1000,100,0.9090909090909091,12,10,2,348.26092874454935,0.4315730203888099,0.15720922714019636,0.1941383528594377,129407.39300679434,1413.5077749914142,130820.90078178576,1574,1,277.0263157894737,35,3,19,36.77210120198688,0.6163690476190475,45.63078703703703,1017.4768518518513,29.07076719576718,0
3818,4,1,1,38,0.02564102564102564,0.02564102564102564,0.9743589743589743,39,1150,700,450,0.6086956521739131,16,7,9,342.6973838399331,0.4328891138101664,0.14896673665598414,0.19297253431036415,129803.15778193726,1096.6405172063824,130899.79829914364,1575,0,270.8974358974359,36,3,18,36.511631119460695,0.6183449074074074,45.24211711711711,1019.0315315315308,28.306431431431413,0
3819,4,0,0,38,0.0,0.0,1.0,38,1100,700,400,0.6363636363636364,15,7,8,351.731603896305,0.4300912754860123,0.1496409716783158,0.19784621783381273,129760.92470689706,1528.2036340448988,131289.12834094197,1576,1,278.9736842105263,35,3,18,36.32438278617138,0.6199404761904762,45.2835648148148,1018.8657407407389,29.110449735449684,0
3820,4,0,0,38,0.0,0.0,1.0,38,650,400,250,0.6153846153846154,9,4,5,350.57363313906563,0.42972083926031296,0.1443976980033823,0.1977900055769218,129878.87577428405,1506.4218696416215,131385.29764392567,1577,2,279.9736842105263,35,3,19,36.234079898565525,0.6211309523809524,45.16782407407407,1019.3287037037031,29.123677248677232,0
3821,4,1,0,39,0.02564102564102564,0.0,1.0,39,1000,800,200,0.8,12,8,4,340.82106535288455,0.4327204228520018,0.13908982849380291,0.19347361228678758,130118.92804967116,1069.4543360928403,131188.382385764,1578,0,273.7692307692308,36,3,20,36.23919242089772,0.6215277777777778,44.93243243243243,1020.2702702702692,28.340840840840812,0
3822,4,1,0,40,0.025,0.0,1.0,40,1100,900,200,0.8181818181818182,13,9,4,331.43202001868787,0.43409455128205127,0.13902275410539877,0.189794230517155,130458.54403518373,647.6277556555654,131106.1717908393,1579,0,267.9,37,3,22,36.134999642231044,0.6230292792792793,44.599780701754376,1021.6008771929811,27.61083451872922,0
3823,4,0,1,39,0.0,0.025,0.975,40,800,300,500,0.375,13,3,10,331.90111144451475,0.43314636752136754,0.14581411562801683,0.19088920801956877,130626.62459843408,671.0243776931277,131297.6489761272,1580,1,268.9,37,3,16,35.95308645285851,0.6247184684684685,44.435307017543856,1022.2587719298241,27.628615457562812,0
3824,4,0,0,39,0.0,0.0,1.0,39,1600,1200,400,0.75,20,12,8,336.670075767456,0.4295715249662618,0.15202211436106383,0.19411434654249335,130722.82745160714,1002.0928445337388,131724.9202961409,1581,3,276.7692307692308,36,3,18,35.73395000550601,0.6276041666666667,44.341216216216225,1022.6351351351361,28.40653153153156,0
3825,4,0,1,38,0.0,0.02564102564102564,0.9743589743589743,39,1300,1100,200,0.8461538461538461,15,11,4,342.47373462487946,0.42934660368870897,0.08830903492258058,0.1900588603082481,129230.80800165047,1249.5056722881325,130480.3136739386,1582,4,277.7692307692308,35,4,18,37.09886643900589,0.6145833333333333,45.80439814814815,1016.7824074074082,29.05092592592595,8
3826,4,0,0,38,0.0,0.0,1.0,38,1700,1400,300,0.8235294117647058,20,14,6,351.4657028976149,0.4250385253674727,0.10009805710115849,0.1895287014690876,128089.02739304397,1403.7800092336067,129492.80740227758,1583,8,285.9736842105263,37,1,19,38.035275852108605,0.5990990990990991,46.92982456140351,1012.2807017543856,27.358937885253667,8
3827,4,3,5,36,0.07317073170731707,0.12195121951219512,0.8780487804878049,41,1250,900,350,0.72,16,9,7,328.28414640902156,0.4316819105691057,0.1065493572756595,0.18047295967561944,128857.43408203124,260.3825741454094,129117.81665617664,1584,0,265.9756097560976,39,2,16,37.83910006497725,0.6033653846153846,46.171875,1015.3124999999999,26.033653846153843,0
3828,4,2,0,38,0.05263157894736842,0.0,1.0,38,1100,700,400,0.6363636363636364,15,7,8,341.86754244079424,0.4310395922238028,0.12477535301668818,0.18848687242151377,128972.51136271408,1218.3031003976964,130190.81446311178,1585,0,279.2631578947368,36,2,20,37.37712490761272,0.6099537037037037,46.05855855855856,1015.7657657657659,28.215715715715717,0
3829,4,0,0,38,0.0,0.0,1.0,38,550,400,150,0.7272727272727273,7,4,3,342.6699899558622,0.4302394499762921,0.12429427958193329,0.18947634738735922,129086.92476260054,1246.8430423667003,130333.76780496724,1586,1,280.2631578947368,36,2,20,37.24027593085106,0.6111111111111112,45.94594594594595,1016.2162162162169,28.228228228228247,0
3830,4,1,0,39,0.02564102564102564,0.0,1.0,39,1100,700,400,0.6363636363636364,15,7,8,335.2742271105826,0.43241115609536657,0.13479221927497798,0.18697985742705575,129424.43828870429,878.5357032933271,130302.97399199761,1587,0,274.05128205128204,37,2,21,37.08512931034482,0.6126126126126126,45.6140350877193,1017.5438596491233,27.501185395922253,0
3831,4,0,0,39,0.0,0.0,1.0,39,1200,1000,200,0.8333333333333334,14,10,4,337.0309720361048,0.4325798470535313,0.1361222990182258,0.1882263226497672,129480.23069598366,927.769602185313,130408.00029816898,1588,1,275.05128205128204,37,2,18,36.983767866120786,0.6131756756756757,45.5592105263158,1017.7631578947392,27.50711237553349,0
3832,4,0,1,38,0.0,0.02564102564102564,0.9743589743589743,39,800,600,200,0.75,10,6,4,337.5853898375762,0.4323549257759784,0.13465335597807315,0.18893793518034338,129563.94184989616,947.7787636580514,130511.72061355421,1589,2,276.05128205128204,37,2,18,36.884648178064985,0.6140202702702703,45.47697368421053,1018.0921052631581,27.51600284495022,0
3833,4,0,1,37,0.0,0.02631578947368421,0.9736842105263158,38,1200,800,400,0.6666666666666666,16,8,8,340.66304832860817,0.4330695827406354,0.12060215228993587,0.19098672945044073,129631.08114448928,1232.1038521629916,130863.18499665227,1590,3,269.5,36,2,18,36.7381307825574,0.6166087962962963,45.411036036036045,1018.3558558558574,28.287662662662704,0
3834,4,0,0,37,0.0,0.0,1.0,37,1400,1000,400,0.7142857142857143,18,10,8,346.8452223252019,0.4318380880880881,0.11364200020916404,0.19473712203174773,129688.4273420382,1596.3622828910213,131284.78962492922,1591,4,273.1621621621622,36,1,18,36.52248019163441,0.6171875,45.35472972972974,1018.5810810810827,28.293918918918965,0
3835,4,0,0,37,0.0,0.0,1.0,37,900,600,300,0.6666666666666666,12,6,6,346.67401132460986,0.4320257757757758,0.11694386694386627,0.19506880935728077,129774.47041636257,1597.8872453534834,131372.35766171606,1592,5,274.1621621621622,36,1,20,36.43945254936634,0.6180555555555556,45.27027027027028,1018.918918918921,28.303303303303363,0
3836,4,2,0,39,0.05128205128205128,0.0,1.0,39,1000,700,300,0.7,13,7,6,333.00453214842923,0.43384502923976603,0.11841628485614697,0.18946946370541648,130208.06081753588,871.9748748995437,131080.03569243543,1593,0,261.05128205128204,38,1,22,36.34831117624483,0.6186951754385965,44.845085470085465,1020.6196581196573,26.858412055780455,0
3837,4,1,1,39,0.025,0.025,0.975,40,1200,800,400,0.6666666666666666,16,8,8,325.9767156331097,0.4346688034188034,0.11094886488869315,0.18697299100220222,130521.37230135547,509.41989536714993,131030.79219672261,1594,0,255.5,36,4,15,36.21083131290866,0.6255787037037037,44.53828828828829,1021.8468468468474,28.38463463463465,0
3838,4,1,2,38,0.025,0.05,0.95,40,750,400,350,0.5333333333333333,11,4,7,329.3203778717184,0.4356837606837607,0.08913067552602438,0.18288825413171073,129258.63997443386,529.3813661634558,129788.0213405973,1595,0,256.475,36,4,19,37.4049464747139,0.6128472222222222,45.777027027027025,1016.8918918918916,28.24699699699699,8
3839,4,0,0,38,0.0,0.0,1.0,38,1350,1100,250,0.8148148148148148,16,11,5,343.5187776956139,0.43447724039829305,0.10581711313515307,0.1902208888024915,129144.15048494442,1272.688144225307,130416.83862916972,1596,1,270.86842105263156,36,2,21,37.16047160056133,0.6116898148148149,45.88963963963964,1016.4414414414416,28.23448448448449,0
3840,4,0,0,38,0.0,0.0,1.0,38,1050,800,250,0.7619047619047619,13,8,5,344.83925913528446,0.4344179706021811,0.10527548090549477,0.19152255861726902,129261.91184807249,1314.9417464209832,130576.85359449347,1597,2,271.86842105263156,34,4,22,37.007092406149994,0.6170343137254901,45.77380952380952,1016.9047619047612,29.908963585434154,0
3841,4,2,0,40,0.05,0.0,1.0,40,750,500,250,0.6666666666666666,10,5,5,328.03702209167136,0.438928952991453,0.10733344381836285,0.18498835432720978,129860.54202428774,519.8130985715372,130380.35512285928,1598,0,259.225,36,4,18,36.82696202997826,0.6189236111111112,45.18581081081081,1019.2567567567563,28.312687687687674,0
3842,4,0,0,40,0.0,0.0,1.0,40,1300,800,500,0.6153846153846154,18,8,10,329.06937635947446,0.43876869658119655,0.10098128831057163,0.18601921767579005,129954.95158366008,552.838974492124,130507.7905581522,1599,1,260.225,37,3,19,36.70499964153852,0.6179617117117118,45.09320175438595,1019.6271929824538,27.557491702228482,0
3843,4,0,0,40,0.0,0.0,1.0,40,700,500,200,0.7142857142857143,9,5,4,329.7787027402012,0.43852831196581193,0.0970752688172043,0.18655364571069763,129982.90339335172,573.1186518928789,130556.0220452446,1600,2,261.225,37,3,19,36.65860215053763,0.6182432432432432,45.065789473684205,1019.7368421052626,27.560455192034123,0
3844,4,0,1,39,0.0,0.025,0.975,40,1700,1300,400,0.7647058823529411,21,13,8,327.1847868759373,0.4383146367521367,0.09126182287188289,0.18561751567644647,130094.7406894429,513.0040012311457,130607.74469067405,1601,3,262.225,37,3,19,36.61149326454571,0.6193693693693694,44.95614035087719,1020.1754385964913,27.572309151256523,0
3845,4,0,1,38,0.0,0.02564102564102564,0.9743589743589743,39,1200,1000,200,0.8333333333333334,14,10,4,335.64747130624073,0.43634727845254156,0.0966471605756134,0.19011626939466061,130032.77084094238,929.0341439412443,130961.80498488362,1602,4,269.5128205128205,36,3,20,36.45844834566265,0.6206597222222222,45.016891891891895,1019.9324324324332,28.33145645645648,0
3846,4,1,1,38,0.02564102564102564,0.02564102564102564,0.9743589743589743,39,850,500,350,0.5882352941176471,12,5,7,330.6561197426868,0.4380623031938822,0.11149282969731855,0.18868358915717867,130321.6695066014,818.5344170966383,131140.20392369805,1603,0,268.12820512820514,35,4,22,36.293263054485,0.6255952380952381,44.73379629629629,1021.0648148148141,29.173280423280403,0
3847,4,0,0,38,0.0,0.0,1.0,38,1200,1000,200,0.8333333333333334,14,10,4,334.0430462165446,0.43754445234708395,0.12095605987445657,0.1916352212505439,130528.564453125,1120.4318576388887,131648.99631076388,1604,1,274.2368421052632,35,3,15,35.997494053686715,0.6276785714285714,44.53125,1021.875,29.196428571428573,0
3848,4,0,1,37,0.0,0.02631578947368421,0.9736842105263158,38,450,400,50,0.8888888888888888,5,4,1,334.2095935727788,0.43705547652916077,0.11892162471395884,0.19217051630434787,130617.28395061726,1130.7098765432067,131747.99382716048,1605,2,275.2368421052632,35,3,15,35.90353260869567,0.6285714285714286,44.44444444444444,1022.2222222222221,29.206349206349202,0
3849,4,0,0,37,0.0,0.0,1.0,37,850,500,350,0.5882352941176471,12,5,7,345.4002939211989,0.4341529029029029,0.12379411097957216,0.19818958041574664,130536.16780045332,1617.4461451246905,132153.61394557802,1606,8,283.6216216216216,34,3,15,35.69965439577509,0.6299019607843137,44.52380952380951,1021.9047619047603,30.05602240896354,0
3850,4,0,1,36,0.0,0.02702702702702703,0.972972972972973,37,900,700,200,0.7777777777777778,11,7,4,346.7057706224287,0.43365240240240244,0.1227705693114498,0.1992513886589138,130597.00255102034,1655.7468820861545,132252.7494331065,1607,9,284.6216216216216,34,3,15,35.60471503998755,0.6305147058823529,44.46428571428571,1022.1428571428567,30.06302521008402,0
3851,4,0,0,36,0.0,0.0,1.0,36,1200,800,400,0.6666666666666666,16,8,8,355.3071212095071,0.4290509259259259,0.12751132427391432,0.20408136300876656,130575.52984429077,2078.8831218762134,132654.41296616697,1608,10,292.9166666666667,33,3,16,35.40667466027179,0.6325757575757576,44.485294117647065,1022.0588235294126,30.97147950089129,0
3852,4,0,1,35,0.0,0.027777777777777776,0.9722222222222222,36,750,600,150,0.8,9,6,3,356.1076149948144,0.4284556878306878,0.1334811795732438,0.20487239477839603,130638.16350682438,2104.24896674357,132742.41247356794,1609,11,293.9166666666667,33,3,17,35.322764325101915,0.6332070707070707,44.42401960784314,1022.3039215686281,30.97890671420085,0
3853,4,1,0,36,0.027777777777777776,0.0,1.0,36,650,600,50,0.9230769230769231,7,6,1,351.85693576150493,0.42943121693121694,0.12069143847128494,0.20348980524457416,130840.48327664395,2007.4263038548706,132847.90958049882,1610,0,290.97222222222223,34,2,18,35.22661158948103,0.6329656862745099,44.226190476190474,1023.0952380952378,30.09103641456582,0
3854,4,0,2,34,0.0,0.05555555555555555,0.9444444444444444,36,1100,700,400,0.6363636363636364,15,7,8,349.5205802630657,0.42915013227513227,0.12276569345895849,0.20261823523409153,130931.84700963728,1952.6750283446788,132884.52203798195,1611,1,291.97222222222223,34,2,19,35.19396301035245,0.6338848039215687,44.136904761904766,1023.4523809523816,30.10154061624652,0
3855,4,1,0,35,0.02857142857142857,0.0,1.0,35,1000,600,400,0.6,14,6,8,361.4845275318914,0.42503501400560223,0.1354953475643128,0.20966102596849737,130951.55709342587,2467.392349096529,133418.9494425224,1612,0,300.54285714285714,33,2,20,34.86789591315451,0.6363636363636364,44.11764705882354,1023.529411764708,31.016042780748727,0
3856,4,0,0,35,0.0,0.0,1.0,35,1300,1000,300,0.7692307692307693,16,10,6,361.83972410635016,0.4246848739495798,0.1343099639576799,0.21042484564156305,131053.71492346941,2484.0880102040874,133537.8029336735,1613,1,301.54285714285714,34,1,20,34.755406348099065,0.6351102941176471,44.017857142857146,1023.9285714285716,30.1155462184874,0
3857,4,0,0,35,0.0,0.0,1.0,35,700,300,400,0.42857142857142855,11,3,8,361.83972410635016,0.4246848739495798,0.1343099639576799,0.21042484564156305,131053.71492346941,2484.0880102040874,133537.8029336735,1614,2,302.54285714285714,34,1,20,34.755406348099065,0.6351102941176471,44.017857142857146,1023.9285714285716,30.1155462184874,0
3858,4,0,0,35,0.0,0.0,1.0,35,800,600,200,0.75,10,6,4,346.161399528351,0.4244747899159664,0.06644361875619942,0.18580754338549557,127903.57320011318,1855.3429705215176,129758.91617063471,1615,3,303.54285714285714,34,1,22,38.35912675061787,0.6032475490196079,47.11309523809523,1011.5476190476176,29.751400560224045,8
3859,4,0,0,35,0.0,0.0,1.0,35,800,500,300,0.625,11,5,6,343.626297577855,0.42461484593837534,0.06504201680672317,0.18486224869694692,127993.90589569138,1796.4143990929447,129790.32029478432,1616,4,304.54285714285714,34,1,22,38.33088235294118,0.6041666666666667,47.02380952380951,1011.9047619047601,29.76190476190471,0
3860,4,3,4,34,0.07894736842105263,0.10526315789473684,0.8947368421052632,38,1050,900,150,0.8571428571428571,12,9,3,317.4885186848145,0.4297356567093409,0.05665086241202433,0.17433622218173256,128811.51532202198,579.2354378269995,129390.75075984898,1617,0,281.42105263157896,37,1,19,38.159789731403464,0.6064189189189189,46.21710526315788,1015.131578947367,27.435988620199108,0
3861,4,3,1,36,0.08108108108108109,0.02702702702702703,0.972972972972973,37,550,300,250,0.5454545454545454,8,3,5,327.1040776173131,0.4319944944944945,0.07621285882155426,0.1798274612071761,128858.14868922945,1030.0051740929741,129888.15386332243,1618,0,289.6216216216216,36,1,21,37.868326678497475,0.6087962962962963,46.17117117117115,1015.3153153153127,28.20320320320313,0
3862,4,0,0,36,0.0,0.0,1.0,36,850,600,250,0.7058823529411765,11,6,5,335.98390525279865,0.42910052910052915,0.08078706342872333,0.18452816737459543,128819.24518014786,1456.2386134687335,130275.4837936166,1619,1,298.6666666666667,35,1,22,37.68253809903847,0.6104166666666666,46.20949074074071,1015.1620370370333,29.004629629629523,0
3863,4,0,1,35,0.0,0.027777777777777776,0.9722222222222222,36,1350,1000,350,0.7407407407407407,17,10,7,359.89360976615404,0.4291666666666667,0.09811495066242082,0.19060199357946367,127362.24666950082,2049.92074263472,129412.16741213555,1620,2,299.6666666666667,34,2,16,38.566851436883255,0.5977328431372548,47.648809523809504,1009.4047619047594,29.68837535013998,8
3864,4,0,0,35,0.0,0.0,1.0,35,1600,1300,300,0.8125,19,13,6,370.52831503381486,0.42615546218487393,0.10726160140066265,0.1968745225140983,127493.93449935105,2448.022545415205,129941.95704476626,1621,3,309.1714285714286,33,2,17,38.16322351656353,0.6013257575757576,47.51838235294117,1009.9264705882339,30.603832442067695,0
3865,4,0,0,35,0.0,0.0,1.0,35,1500,1200,300,0.8,18,12,6,372.0216017034089,0.4263655462184874,0.10576593126635614,0.19797121128735934,127555.82475790543,2490.7044466070515,130046.52920451248,1622,4,310.1714285714286,33,2,18,38.06196671923653,0.6019570707070707,47.457107843137244,1010.1715686274495,30.611259655377257,0
3866,4,0,0,35,0.0,0.0,1.0,35,1300,900,400,0.6923076923076923,17,9,8,373.18051903864455,0.4264005602240896,0.10725285385161709,0.19919868870625893,127679.65032980095,2529.511636149545,130209.1619659505,1623,5,311.1714285714286,33,2,18,37.90557677539308,0.603219696969697,47.334558823529406,1010.6617647058815,30.62611408199641,0
3867,4,2,0,37,0.05405405405405406,0.0,1.0,37,900,600,300,0.6666666666666666,12,6,6,356.9572948947857,0.43337087087087084,0.10697773536306254,0.19318078463971985,128232.43694540893,1754.7007619598721,129987.1377073688,1624,0,295.2972972972973,35,2,21,37.74961432979087,0.6044642857142857,46.78819444444444,1012.8472222222222,28.938492063492063,0
3868,4,0,0,37,0.0,0.0,1.0,37,1250,1100,150,0.88,14,11,3,358.57765154083586,0.43324574574574576,0.1104486183887532,0.19434242624996495,128291.057487247,1800.4612214934727,130091.51870874048,1625,1,296.2972972972973,35,2,22,37.64863951407138,0.6050595238095238,46.73032407407407,1013.078703703703,28.945105820105802,0
3869,4,0,0,37,0.0,0.0,1.0,37,1000,600,400,0.6,14,6,8,357.56663063562917,0.4328703703703704,0.10765770907307282,0.1949372278157275,128525.67361379007,1791.2984128514843,130316.97202664155,1626,2,297.2972972972973,35,2,16,37.4344871209527,0.6074404761904761,46.49884259259258,1014.0046296296279,28.971560846560795,0
3870,4,2,2,37,0.05128205128205128,0.05128205128205128,0.9487179487179487,39,950,600,350,0.631578947368421,13,6,7,343.0286875585949,0.4365159694107063,0.12163100265786064,0.19009079272897367,129173.52123970816,1062.0446916358603,130235.56593134403,1627,0,283.0,37,2,18,37.14304012512133,0.6100788288288288,45.860745614035075,1016.5570175438579,27.474513987671834,0
3871,4,1,0,38,0.02631578947368421,0.0,1.0,38,750,400,350,0.5333333333333333,11,4,7,349.31800707483836,0.43404753437648175,0.12675608689313322,0.19329215290315227,129115.53603857226,1420.4763462787002,130536.01238485095,1628,0,291.2631578947368,36,2,19,37.042243767313025,0.611400462962963,45.91779279279279,1016.328828828828,28.231356356356333,0
3872,4,1,1,38,0.02564102564102564,0.02564102564102564,0.9743589743589743,39,1300,900,400,0.6923076923076923,17,9,8,359.8891544658761,0.4367408906882591,0.11499973015426668,0.19943028835871493,129172.76810171668,1497.6041920298783,130670.37229374655,1629,0,284.7692307692308,36,3,19,36.71531701192718,0.6119791666666667,45.86148648648649,1016.5540540540547,28.237612612612633,8
3873,4,2,1,39,0.05,0.025,0.975,40,1200,800,400,0.6666666666666666,16,8,8,351.81852917754776,0.4388888888888889,0.1259045875511524,0.1970438396829139,129591.85157933227,1118.5629232071615,130710.41450253944,1630,0,278.575,37,3,15,36.49400531265706,0.6143018018018018,45.44956140350878,1018.2017543859662,27.51896633475584,0
3874,4,0,1,38,0.0,0.02564102564102564,0.9743589743589743,39,800,600,200,0.75,10,6,4,360.2154626226915,0.43525078722447147,0.13581402738295822,0.20121306249591428,129487.77113261937,1528.69947650356,131016.47060912293,1631,1,286.71794871794873,36,3,16,36.38618425905437,0.615162037037037,45.551801801801815,1017.7927927927949,28.27202202202208,0
3875,4,0,1,37,0.0,0.02631578947368421,0.9736842105263158,38,1400,1000,400,0.7142857142857143,18,10,8,366.7298669120978,0.4331436699857753,0.1479391697187158,0.19625940514709792,127783.17920918352,1787.678841624284,129570.8580508078,1632,2,294.10526315789474,34,4,18,37.96239059617722,0.6020220588235294,47.23214285714285,1011.0714285714273,29.737394957983156,8
3876,4,1,1,37,0.02631578947368421,0.02631578947368421,0.9736842105263158,38,850,600,250,0.7058823529411765,11,6,5,364.8745559212222,0.43255097202465626,0.14389838570800628,0.1960275656611802,127939.53517500416,1736.3762163494396,129675.9113913536,1633,0,295.0,35,3,19,37.84904949853182,0.6014880952380952,47.07754629629629,1011.6898148148139,28.905423280423253,0
3877,4,0,0,37,0.0,0.0,1.0,37,1050,900,150,0.8571428571428571,12,9,3,369.0495427559131,0.4311811811811812,0.1567796610169494,0.19794475475089873,127873.46938775503,2038.3290816326441,129911.79846938768,1634,1,303.81081081081084,34,3,19,37.81117584745762,0.6029411764705883,47.14285714285714,1011.4285714285709,29.74789915966385,0
3878,4,2,1,38,0.05128205128205128,0.02564102564102564,0.9743589743589743,39,850,600,250,0.7058823529411765,11,6,5,352.38688030060916,0.43499775078722447,0.15064944189273488,0.19183074484481222,128466.9994882756,1254.3040240465737,129721.30351232218,1635,0,289.1794871794872,35,4,17,37.62570403775163,0.606845238095238,46.55671296296295,1013.7731481481458,28.96494708994702,0
3879,4,0,0,38,0.0,0.0,1.0,38,950,800,150,0.8421052631578947,11,8,3,348.09423718032536,0.4358700806069227,0.11658974467544558,0.18168973951445744,126771.2770731522,1225.6701978309006,127996.9472709831,1636,1,295.89473684210526,35,3,19,39.47115752978582,0.5895833333333333,48.23495370370369,1007.0601851851833,28.773148148148096,6
3880,4,0,1,37,0.0,0.02631578947368421,0.9736842105263158,38,1000,600,400,0.6,14,6,8,347.72948241213925,0.4355292792792793,0.1159091733468749,0.18214999241155713,126917.0163001541,1226.5576774691071,128143.5739776232,1637,2,296.89473684210526,35,3,19,39.33063404548585,0.5910714285714286,48.090277777777764,1007.6388888888871,28.789682539682488,0
3881,4,3,1,39,0.075,0.025,0.975,40,1250,1000,250,0.8,15,10,5,329.9920868191146,0.4399973290598291,0.11008467216673945,0.17551311222734856,127534.65008464117,417.0850646352426,127951.73514927641,1638,0,282.875,37,3,13,39.1450463163989,0.5934684684684685,47.47807017543858,1010.0877192982434,27.299668089141715,0
3882,4,1,0,40,0.025,0.0,1.0,40,1150,1000,150,0.8695652173913043,13,10,3,328.7844996166012,0.4395299145299145,0.11496528531134764,0.17559301955190182,127700.83703639566,397.21116112648156,128098.04819752215,1639,0,283.85,37,3,16,39.005659217473045,0.5951576576576576,47.31359649122806,1010.7456140350864,27.317449027975307,0
3883,4,1,0,41,0.024390243902439025,0.0,1.0,41,1200,800,400,0.6666666666666666,16,8,8,319.60090096480786,0.44217479674796745,0.11251805897849909,0.17188757143882413,127982.32299884927,-19.346852399754823,127962.97614644951,1640,0,277.9024390243902,38,3,17,38.95048041389504,0.596217105263158,47.0352564102564,1011.858974358973,26.627867746288764,0
3884,4,3,2,42,0.06818181818181818,0.045454545454545456,0.9545454545454546,44,1000,700,300,0.7,13,7,6,305.635486450925,0.4462869978858351,0.1395761130365234,0.16755900462984766,128747.91843820836,-930.0134637188496,127817.90497448952,1641,0,259.8863636363636,41,3,13,38.52517106549363,0.5990853658536586,46.27976190476189,1014.8809523809504,24.753193960510984,0
3885,4,1,1,42,0.023255813953488372,0.023255813953488372,0.9767441860465116,43,1350,1000,350,0.7407407407407407,17,10,7,315.7840269356467,0.444905869324474,0.1400704100734831,0.1732994978589692,128788.4402472074,-466.1335431951843,128322.30670401221,1642,0,266.83720930232556,40,3,14,38.22649679615539,0.6010416666666667,46.239837398373986,1015.0406504065045,25.37601626016261,0
3886,4,0,2,40,0.0,0.047619047619047616,0.9523809523809523,42,650,300,350,0.46153846153846156,10,3,7,322.21965174084266,0.44219415408439794,0.1366640271382622,0.17655027262425693,128725.26584201393,-104.43793402777408,128620.82790798615,1643,1,274.14285714285717,39,3,14,38.12743789776228,0.6020299145299146,46.302083333333336,1014.7916666666671,26.020299145299155,0
3887,4,0,0,40,0.0,0.0,1.0,40,1600,1100,500,0.6875,21,11,10,334.9168809628158,0.43696581196581197,0.13415774678343584,0.18275199008997547,128561.19340806788,611.4627818174833,129172.65618988535,1644,2,288.625,37,3,14,37.97246098677334,0.6038851351351351,46.463815789473685,1014.1447368421054,27.409317211948796,0
3888,4,2,0,42,0.047619047619047616,0.0,1.0,42,1650,1300,350,0.7878787878787878,20,13,7,322.82988443966656,0.4388792102206736,0.147150663544106,0.1790238450074517,129201.38888888907,-57.986111111092015,129143.40277777797,1645,0,275.8333333333333,39,3,16,37.62807377049181,0.6068376068376069,45.83333333333334,1016.6666666666681,26.068376068376104,0
3889,4,0,1,41,0.0,0.023809523809523808,0.9761904761904762,42,1000,800,200,0.8,12,8,4,348.84233795271,0.43902439024390244,0.11201292690796194,0.18999561818440713,128486.82032962026,607.731337756689,129094.55166737695,1646,1,276.8333333333333,36,6,15,37.695305268614185,0.6050347222222222,46.53716216216217,1013.8513513513522,28.16253753753756,8
3890,4,2,0,43,0.046511627906976744,0.0,1.0,43,900,500,400,0.5555555555555556,13,5,8,339.8700371788831,0.44243724621631597,0.12099050680596712,0.18688815583589413,128867.17547706985,159.61834410587392,129026.79382117571,1647,0,271.3255813953488,37,6,17,37.53509719222462,0.6069819819819819,46.16228070175438,1015.3508771929822,27.44191559981033,0
3891,4,0,0,43,0.0,0.0,1.0,43,1000,700,300,0.7,13,7,6,342.10844677189965,0.4420450350682909,0.12371623307678403,0.18841731720820823,128929.98598327114,221.60744941192752,129151.59343268306,1648,1,272.3255813953488,38,5,18,37.41430850690792,0.6058114035087719,46.100427350427346,1015.5982905982897,26.72627080521815,0
3892,4,2,1,44,0.044444444444444446,0.022222222222222223,0.9777777777777777,45,1050,700,350,0.6666666666666666,14,7,7,330.47133276590756,0.44608585858585864,0.14286006756065084,0.18437318388293278,129439.7800021702,-444.4873210955136,128995.29268107469,1649,0,261.1777777777778,39,6,16,37.19173320367148,0.6092414529914529,45.598958333333336,1017.6041666666672,26.092414529914542,0
3893,4,0,0,44,0.0,0.0,1.0,44,1450,1000,450,0.6896551724137931,19,10,9,331.4238543101097,0.444756430584919,0.1390748848255936,0.1857025723356643,129609.02829141992,-208.89525805392898,129400.13303336599,1650,1,267.3863636363636,38,6,16,36.9957244780191,0.6126644736842105,45.4326923076923,1018.2692307692291,26.7965587044534,0
3894,4,0,0,44,0.0,0.0,1.0,44,1350,800,550,0.5925925925925926,19,8,11,334.0592854066262,0.44416182170542634,0.1467930140329472,0.18782956047391391,129745.05077069145,-131.4922108993014,129613.55855979215,1651,2,268.3863636363636,38,6,16,36.79062674776285,0.6140350877192983,45.29914529914528,1018.803418803416,26.81061628430042,0
3895,4,0,0,44,0.0,0.0,1.0,44,850,500,350,0.5882352941176471,12,5,7,335.0025711008269,0.44405170894996476,0.15530303030303028,0.18888442838663624,129853.9201183431,-99.72057856674462,129754.19953977635,1652,3,269.3863636363636,38,6,17,36.656184486373164,0.6151315789473684,45.192307692307686,1019.2307692307684,26.821862348178115,0
3896,4,0,3,41,0.0,0.06818181818181818,0.9318181818181819,44,1300,1000,300,0.7692307692307693,16,10,6,334.8017458645675,0.44377642706131076,0.14355997104320628,0.18929785915470557,129962.83512309143,-97.64318065601668,129865.19194243541,1653,4,270.3863636363636,38,6,18,36.55088711930704,0.6162280701754386,45.08547008547008,1019.6581196581188,26.833108412055758,0
3897,4,0,1,40,0.0,0.024390243902439025,0.975609756097561,41,1050,700,350,0.6666666666666666,14,7,7,355.187639060883,0.43927845528455284,0.14228811684000853,0.1984045662442685,129487.77113261924,998.4911431702089,130486.26227578944,1654,5,290.4390243902439,36,5,18,36.51411632367043,0.615162037037037,45.55180180180181,1017.7927927927939,28.272022022022053,0
3898,4,0,0,40,0.0,0.0,1.0,40,1150,800,350,0.6956521739130435,15,8,7,364.2628335798902,0.4368055555555555,0.15325938566552888,0.20290686357206822,129377.9538001544,1425.5160108024809,130803.46981095689,1655,6,298.4,35,5,19,36.395051194539256,0.6160714285714286,45.65972222222223,1017.3611111111118,29.067460317460338,0
3899,4,1,0,41,0.024390243902439025,0.0,1.0,41,1400,1000,400,0.7142857142857143,18,10,8,356.51406610042613,0.4382367886178862,0.15561873410145166,0.2003854923254119,129731.4453125,1050.2170138888887,130781.66232638889,1656,0,292.0975609756098,37,4,19,36.23253237900475,0.6157094594594594,45.3125,1018.75,27.533783783783782,0
3900,4,0,0,41,0.0,0.0,1.0,41,1650,1200,450,0.7272727272727273,21,12,9,360.90282043855075,0.43704268292682924,0.1569267505477634,0.20343188089607836,129843.17440222012,1172.1535712911893,131015.3279735113,1657,1,293.0975609756098,37,4,19,36.00714990138067,0.6168355855855856,45.20285087719299,1019.1885964912296,27.545637743006207,0
3901,4,0,0,41,0.0,0.0,1.0,41,1250,700,550,0.56,18,7,11,362.75839011537425,0.43686483739837395,0.15217539570534422,0.20491661672495456,129927.00277970158,1226.422072176069,131153.42485187764,1658,2,294.0975609756098,37,4,19,35.874650462465056,0.6176801801801801,45.120614035087726,1019.5175438596502,27.55452821242298,0
3902,4,1,0,42,0.023809523809523808,0.0,1.0,42,1200,700,500,0.5833333333333334,17,7,10,355.4681204112867,0.4385041618273326,0.16222842621425215,0.20297207880995188,130346.5504410012,867.241482956311,131213.79192395753,1659,0,288.07142857142856,37,5,20,35.63466391066251,0.6219031531531531,44.70942982456141,1021.1622807017555,27.598980559506906,0
3903,4,0,0,42,0.0,0.0,1.0,42,1050,700,350,0.6666666666666666,14,7,7,356.9229570003263,0.43785085172280297,0.1657774507098393,0.20453924436217966,130486.54994806105,914.7290512465484,131401.2789993076,1660,1,289.07142857142856,37,5,21,35.455569864777864,0.6233108108108107,44.57236842105264,1021.7105263157903,27.61379800853487,0
3904,4,0,0,42,0.0,0.0,1.0,42,1100,800,300,0.7272727272727273,14,8,6,357.15332263232995,0.43766937669376693,0.16796402139102962,0.20541273454048192,130626.6245984341,930.7465999153524,131557.37119834946,1661,2,290.07142857142856,37,5,19,35.30772909292432,0.6247184684684685,44.435307017543856,1022.2587719298242,27.628615457562816,0
3905,4,0,0,42,0.0,0.0,1.0,42,1000,700,300,0.7,13,7,6,356.0469840025739,0.43689508323654663,0.16878034584692747,0.20537107110649366,130738.73842191813,909.8267014850596,131648.56512340318,1662,3,291.07142857142856,37,5,19,35.222450055394745,0.6258445945945945,44.325657894736835,1022.6973684210514,27.640469416785173,0
3906,4,1,0,43,0.023255813953488372,0.0,1.0,43,1000,600,400,0.6,14,6,8,351.3043703194809,0.4376845699520118,0.17906782622199802,0.20430225031200866,131054.49631090641,608.0034608079338,131662.49977171436,1663,0,285.27906976744185,38,5,20,35.02430265720647,0.6271929824561404,44.01709401709401,1023.9316239316227,26.945569050832177,0
3907,4,0,0,43,0.0,0.0,1.0,43,1200,800,400,0.6666666666666666,16,8,8,351.2134222847397,0.4375,0.17830427569345386,0.20483176963905594,131163.91354372108,613.3053911899884,131777.21893491107,1664,1,286.27906976744185,38,5,20,34.91604088443887,0.6282894736842105,43.9102564102564,1024.3589743589732,26.956815114709823,0
3908,4,0,1,42,0.0,0.023255813953488372,0.9767441860465116,43,1100,800,300,0.7272727272727273,14,8,6,347.5696401649806,0.43736157253599117,0.17326266919443856,0.20329311057925553,131274.74500868045,525.4231770833242,131800.16818576376,1665,2,287.27906976744185,39,4,20,34.89742156264825,0.6276709401709402,43.80208333333333,1024.7916666666658,26.27670940170938,0
3909,4,0,0,42,0.0,0.0,1.0,42,950,800,150,0.8421052631578947,11,8,3,344.2239698018246,0.43666521486643434,0.17937866055513108,0.201913056314119,131384.32618690346,645.148567347622,132029.47475425107,1666,3,293.2142857142857,37,5,20,34.87254901960783,0.6323198198198199,43.69517543859648,1025.2192982456124,27.70862968231385,0
3910,4,0,0,42,0.0,0.0,1.0,42,1050,800,250,0.7619047619047619,13,8,5,378.38254186263157,0.4365200348432056,0.275170534803175,0.2037758851088522,128036.38100162543,1305.8056502086636,129342.1866518341,1667,4,294.2142857142857,38,4,18,37.4080720644639,0.596765350877193,46.98183760683761,1012.0726495726499,26.63349077822763,8
3911,4,1,1,42,0.023255813953488372,0.023255813953488372,0.9767441860465116,43,1100,700,400,0.6363636363636364,15,7,8,350.64580103316393,0.4377999261720192,0.14569770035638507,0.1860290089978315,127432.8953108516,383.8629334796405,127816.75824433124,1668,0,288.3488372093023,36,7,15,38.72778645252435,0.5943287037037037,47.57882882882884,1009.6846846846864,28.046796796796844,8
3912,4,1,0,43,0.023255813953488372,0.0,1.0,43,950,800,150,0.8421052631578947,11,8,3,346.30591725971476,0.438999630860096,0.16951912774941746,0.18584479852942812,127894.85857427292,258.1492622730186,128153.00783654593,1669,0,287.6279069767442,37,6,16,38.36438572719062,0.5971283783783784,47.121710526315795,1011.5131578947373,27.338193456614523,0
3913,4,3,2,44,0.06521739130434782,0.043478260869565216,0.9565217391304348,46,1150,900,250,0.782608695652174,14,9,5,324.9646805030766,0.4443035426731079,0.1741853965192388,0.17758170924461064,128619.58007812513,-840.39238635925,127779.18769176588,1670,0,269.80434782608694,39,7,15,38.16534880536729,0.6009615384615384,46.40625000000001,1014.375000000001,26.00961538461541,0
3914,4,0,1,43,0.0,0.022727272727272728,0.9772727272727273,44,950,700,250,0.7368421052631579,12,7,5,335.5838350046836,0.44035192036645526,0.17314460709615842,0.18286056112482674,128505.5993791359,-175.119628154819,128330.47975098109,1671,1,283.0681818181818,37,7,15,38.012215673551765,0.603322072072072,46.51864035087719,1013.9254385964914,27.403390232337607,0
3915,4,1,0,44,0.022727272727272728,0.0,1.0,44,1150,600,550,0.5217391304347826,17,6,11,335.4991588276715,0.44112270965468636,0.18233152884076964,0.18358212398772566,128672.41753472204,-166.10243055557567,128506.31510416647,1672,0,283.8636363636364,37,7,16,37.844370294318956,0.6050112612612613,46.35416666666666,1014.5833333333319,27.42117117117113,0
3916,4,0,0,44,0.0,0.0,1.0,44,1850,1600,250,0.8648648648648649,21,16,5,334.67286482912436,0.441232822410148,0.1844743612404014,0.18377232399691779,128811.5153220222,-178.05622883963724,128633.45909318257,1673,1,284.8636363636364,37,7,16,37.72368042053721,0.6064189189189189,46.2171052631579,1015.1315789473687,27.435988620199154,0
3917,4,1,0,45,0.022222222222222223,0.0,1.0,45,1200,800,400,0.6666666666666666,16,8,8,324.82749117815746,0.4435185185185185,0.18193962748876102,0.18000777976471574,129174.23575726867,-608.1314148221097,128566.10434244656,1674,0,279.5111111111111,38,7,17,37.60487826239271,0.6082785087719298,45.86004273504274,1016.5598290598296,26.751574448942883,0
3918,4,0,1,44,0.0,0.022222222222222223,0.9777777777777777,45,1150,800,350,0.6956521739130435,15,8,7,326.08340271909697,0.4433291245791246,0.1865478158771232,0.18108368124652136,129257.13320444766,-570.2759822270614,128686.8572222206,1675,1,280.5111111111111,37,8,17,37.48876788153258,0.6109234234234234,45.77850877192983,1016.8859649122818,27.483404457088696,0
3919,4,0,1,43,0.0,0.022727272727272728,0.9772727272727273,44,1300,900,400,0.6923076923076923,17,9,8,333.4796911254253,0.4417613636363636,0.18836837876501633,0.18571576076000576,129368.65790435518,-171.63598414896683,129197.02192020621,1676,2,286.79545454545456,37,7,18,37.18743263634406,0.6120495495495495,45.66885964912281,1017.3245614035086,27.495258416311042,0
3920,4,0,0,43,0.0,0.0,1.0,43,1500,1100,400,0.7333333333333333,19,11,8,330.3837109854695,0.440453119232189,0.1736247113684517,0.185038790121295,129591.85157933214,-36.99263234841186,129554.85894698373,1677,3,282.13953488372096,37,6,15,37.03962954986,0.6143018018018018,45.449561403508774,1018.2017543859652,27.518966334755817,0
3921,4,0,1,42,0.0,0.023255813953488372,0.9767441860465116,43,800,400,400,0.5,12,4,8,330.02305031229605,0.4401531930601698,0.17402800312481248,0.18509988474037456,129647.68005540158,-42.655432440757664,129605.02462296082,1678,4,283.13953488372096,37,6,15,36.99217628481193,0.6148648648648649,45.39473684210526,1018.4210526315783,27.52489331436698,0
3922,4,0,1,41,0.0,0.023809523809523808,0.9761904761904762,42,1250,1000,250,0.8,15,10,5,334.72139059306306,0.4405850754936121,0.17140013900296935,0.18779281988360194,129659.75265806356,279.9785427319334,129939.73120079549,1679,5,287.14285714285717,36,6,15,36.86030333185907,0.6168981481481481,45.38288288288289,1018.4684684684692,28.29079079079081,0
3923,4,0,2,39,0.0,0.04878048780487805,0.9512195121951219,41,1250,800,450,0.64,17,8,9,362.6581937191233,0.4400914634146342,-0.006060305002235422,0.20948843896010558,130794.81336805572,1286.7621527777967,132081.57552083352,1680,6,289.6585365853659,39,2,21,34.996605566870336,0.6228632478632479,44.27083333333334,1022.916666666668,26.228632478632512,8
3924,4,0,0,39,0.0,0.0,1.0,39,700,600,100,0.8571428571428571,8,6,2,373.91500711964034,0.43758434547908237,0.015455015455015264,0.2152088596533041,130654.64854570634,1970.7467682363738,132625.39531394272,1681,7,304.5128205128205,37,2,21,34.850922350922346,0.625,44.4078947368421,1022.3684210526313,27.631578947368414,0
3925,4,0,2,37,0.0,0.05128205128205128,0.9487179487179487,39,950,600,350,0.631578947368421,13,6,7,373.91500711964034,0.43758434547908237,0.015455015455015264,0.2152088596533041,130654.64854570634,1970.7467682363738,132625.39531394272,1682,8,305.5128205128205,37,2,21,34.850922350922346,0.625,44.4078947368421,1022.3684210526313,27.631578947368414,0
3926,4,0,0,37,0.0,0.0,1.0,37,900,700,200,0.7777777777777778,11,7,4,379.06870274102084,0.4320883383383383,0.054641598119858914,0.21796450407608695,130617.28395061725,2502.584876543206,133119.86882716045,1683,13,321.9189189189189,35,2,21,34.757133152173914,0.6285714285714286,44.44444444444444,1022.222222222222,29.2063492063492,0
3927,4,0,0,37,0.0,0.0,1.0,37,750,300,450,0.4,12,3,9,378.45301772800303,0.4316816816816817,0.04933135942642508,0.21827747158254796,130735.62349965703,2495.4582475994475,133231.08174725648,1684,14,322.9189189189189,35,2,21,34.65274634072733,0.6297619047619047,44.3287037037037,1022.6851851851849,29.21957671957671,0
3928,4,0,0,37,0.0,0.0,1.0,37,1500,1300,200,0.8666666666666667,17,13,4,379.0901174404283,0.431275025025025,0.04092559316439903,0.21999166657763428,130972.4633487653,2530.07330246912,133502.53665123443,1685,15,323.9189189189189,35,2,21,34.396200814111246,0.6321428571428571,44.097222222222214,1023.6111111111102,29.24603174603172,0
3929,4,0,0,37,0.0,0.0,1.0,37,1100,1000,100,0.9090909090909091,12,10,2,375.44613616776843,0.4312124624624625,0.04144754924415972,0.21888658136263137,131150.2338927466,2447.969714506137,133598.20360725274,1686,16,324.9189189189189,35,2,21,34.309322033898304,0.6339285714285714,43.92361111111109,1024.305555555553,29.26587301587294,0
3930,4,0,0,37,0.0,0.0,1.0,37,1100,800,300,0.7272727272727273,14,8,6,378.9338297771268,0.43030530530530525,0.04950020602194538,0.22177521894755137,131298.4681096748,2550.6862729337827,133849.1543826086,1687,17,325.9189189189189,35,2,21,34.06985224920008,0.6354166666666667,43.77893518518517,1024.884259259257,29.282407407407344,0
3931,4,0,1,36,0.0,0.02702702702702703,0.972972972972973,37,950,700,250,0.7368421052631579,12,7,5,377.8679508108133,0.4302427427427427,0.04435671156525789,0.22167566705604355,131389.1439909295,2529.5526687076285,133918.69665963712,1688,18,326.9189189189189,34,3,21,34.005360736956185,0.6384803921568627,43.690476190476176,1025.2380952380934,30.154061624649806,0
3932,4,0,0,36,0.0,0.0,1.0,36,1350,1100,250,0.8148148148148148,16,11,5,385.2539401672219,0.4293154761904762,0.0620352666241768,0.22639079854770436,131453.7677816223,2928.61639753939,134382.3841791617,1689,19,333.47222222222223,33,3,21,33.750597514340335,0.6414141414141414,43.62745098039215,1025.4901960784302,31.075460487225158,0
3933,4,0,1,35,0.0,0.027777777777777776,0.9722222222222222,36,1200,900,300,0.75,15,9,6,379.63449488190685,0.42895171957671957,0.049944285259471366,0.22456345544709386,131705.23356401373,2799.969963475573,134505.2035274893,1690,20,334.47222222222223,33,3,20,33.640261859280486,0.6439393939393939,43.382352941176464,1026.4705882352932,31.10516934046343,0
3934,4,0,0,35,0.0,0.0,1.0,35,600,400,200,0.6666666666666666,8,4,4,383.05117625860265,0.42713585434173673,0.0609814398200228,0.2262674389992675,131651.87225793282,3085.8809050096893,134737.7531629425,1691,21,344.0571428571429,32,3,20,33.6065657808399,0.6458333333333333,43.43434343434343,1026.2626262626259,32.07070707070706,0
3935,4,0,0,35,0.0,0.0,1.0,35,850,400,450,0.47058823529411764,13,4,9,383.11751573941564,0.4264705882352941,0.06709418978512582,0.22688481576672873,131749.07415378516,3095.0755981532334,134844.14975193838,1692,22,345.0571428571429,32,3,20,33.506538761120005,0.6468098958333333,43.33964646464646,1026.641414141413,32.082544191919155,0
3936,4,0,1,34,0.0,0.02857142857142857,0.9714285714285714,35,800,400,400,0.5,12,4,8,384.12251102242544,0.4258053221288515,0.05875837153422747,0.22853789992200066,131925.46323829758,3135.108041378295,135060.57127967587,1693,23,346.0571428571429,33,2,21,33.30239273927393,0.6461489898989898,43.167892156862735,1027.3284313725476,31.131164587046896,0
3937,4,0,1,33,0.0,0.029411764705882353,0.9705882352941176,34,750,500,250,0.6666666666666666,10,5,5,382.2822539478645,0.42346256684491984,0.045122353221722866,0.22819937821072844,132051.39136690192,3296.180705738152,135347.57207264006,1694,24,330.0882352941176,33,1,21,33.22242259846587,0.6474116161616161,43.04534313725489,1027.8186274509787,31.146019013666024,0
3938,4,1,0,34,0.029411764705882353,0.0,1.0,34,1150,1000,150,0.8695652173913043,13,10,3,381.09997177831434,0.42309120617944146,0.06498469341291369,0.22939759591559197,132366.47450800182,3288.9719398788993,135655.4464478807,1695,0,329.5,33,1,22,32.93475348338691,0.6505681818181819,42.7389705882353,1029.0441176470595,31.183155080213922,0
3939,4,0,0,34,0.0,0.0,1.0,34,950,700,250,0.7368421052631579,12,7,5,382.74528786640815,0.4230169340463458,0.0708565987101244,0.2311781538713108,132495.48037190098,3342.4079097538192,135837.8882816548,1696,1,330.5,32,2,22,32.76229457934757,0.654296875,42.613636363636374,1029.5454545454559,32.173295454545496,0
3940,4,0,1,33,0.0,0.029411764705882353,0.9705882352941176,34,1200,900,300,0.75,15,9,6,380.384309693836,0.4228869578134284,0.067219166131951,0.23074762697338363,132658.02158261926,3292.205993010937,135950.22757563018,1697,2,331.5,32,2,19,32.65923111492421,0.6559244791666667,42.45580808080809,1030.1767676767688,32.193023989899025,0
3941,4,1,0,34,0.029411764705882353,0.0,1.0,34,950,600,350,0.631578947368421,13,6,7,373.14919669506475,0.42552361853832443,0.05516101383616978,0.22793638664237817,132918.2947690288,3119.6709838282004,136037.965752857,1698,0,322.1764705882353,32,2,20,32.58361903595771,0.6585286458333333,42.20328282828284,1031.18686868687,32.224589646464686,0
3942,4,0,0,34,0.0,0.0,1.0,34,900,700,200,0.7777777777777778,11,7,4,376.0153397978699,0.42446524064171126,0.054353459445452,0.23069049225436902,133081.09504132243,3208.106634527106,136289.20167584953,1699,1,323.1764705882353,32,2,22,32.34596793930495,0.66015625,42.045454545454554,1031.818181818183,32.244318181818215,0
3943,4,0,0,34,0.0,0.0,1.0,34,900,600,300,0.6666666666666666,12,6,6,379.94448694283494,0.42390819964349374,0.0525210084033616,0.23391762991299841,133211.40699928586,3322.587937455371,136533.99493674122,1700,2,324.1764705882353,32,2,22,32.11355389758644,0.6614583333333333,41.919191919191924,1032.3232323232328,32.260101010101025,0
3944,4,0,0,34,0.0,0.0,1.0,34,1050,600,450,0.5714285714285714,15,6,9,378.91417070690676,0.42346256684491984,0.05480989167493866,0.23369231433190688,133276.5868916438,3300.077479338849,136576.66437098265,1701,3,325.1764705882353,32,2,23,32.07462093421375,0.662109375,41.85606060606061,1032.5757575757582,32.26799242424244,0
3945,4,0,0,34,0.0,0.0,1.0,34,950,600,350,0.631578947368421,13,6,7,378.51196670135243,0.4223856209150327,0.05811195445920303,0.23467741935483885,133472.22222222245,3304.1666666666897,136776.38888888914,1702,4,326.1764705882353,32,2,23,31.888440860215045,0.6640625,41.66666666666668,1033.333333333335,32.29166666666672,0
3946,4,1,0,35,0.02857142857142857,0.0,1.0,35,1000,800,200,0.8,12,8,4,369.1004306018348,0.42412464985994397,0.06393719970223999,0.23120801454019993,133852.39451172636,2880.9952902729824,136733.38980199935,1703,0,317.8285714285714,33,2,18,31.75035528185694,0.6654040404040404,41.29901960784314,1034.8039215686283,31.357694592988736,0
3947,4,0,0,35,0.0,0.0,1.0,35,1050,800,250,0.7619047619047619,13,8,5,369.2812581391595,0.423984593837535,0.0671098705912212,0.2315204324413659,133884.0999405276,2888.1777741733904,136772.277714701,1704,1,318.8285714285714,33,2,18,31.7139086244326,0.665719696969697,41.268382352941174,1034.9264705882347,31.361408199643474,0
3948,4,0,0,35,0.0,0.0,1.0,35,850,600,250,0.7058823529411765,11,6,5,367.9623009687904,0.42324929971988795,0.053808565679793086,0.23149020706517587,134010.95920138896,2862.196180555561,136873.15538194453,1705,2,319.8285714285714,33,2,19,31.62097585513078,0.6669823232323233,41.145833333333336,1035.4166666666672,31.376262626262644,0
3949,4,0,0,35,0.0,0.0,1.0,35,1000,800,200,0.8,12,8,4,373.13302658769226,0.422093837535014,0.053756864070288346,0.23596407926693605,134201.3607296471,3014.9919802479653,137216.35270989506,1706,3,320.8285714285714,33,2,19,31.296446875616006,0.6688762626262627,40.96200980392156,1036.1519607843125,31.398544266191287,0
3950,4,0,1,34,0.0,0.02857142857142857,0.9714285714285714,35,650,400,250,0.6153846153846154,9,4,5,371.26459723839537,0.4219887955182073,0.05485876469793194,0.2349860354975951,134233.10745866975,2967.200115340251,137200.30757401,1707,4,321.8285714285714,33,2,19,31.31307158625039,0.6691919191919191,40.931372549019606,1036.2745098039215,31.402257872846107,0
3951,4,0,0,34,0.0,0.0,1.0,34,1000,900,100,0.9,11,9,2,386.475003330018,0.42160576351752826,0.07449797597236629,0.22732342158216776,131489.94880943268,3410.6129510785386,134900.56176051122,1708,5,325.8235294117647,32,2,18,33.68265008822684,0.6442057291666667,43.592171717171716,1025.631313131313,32.05097853535353,8
3952,4,0,0,34,0.0,0.0,1.0,34,800,400,400,0.5,12,4,8,385.6781918665413,0.4212901069518717,0.07266052654444355,0.227047074690129,131522.3255280073,3345.0585399448933,134867.3840679522,1709,6,326.8235294117647,32,2,18,33.67029788281634,0.64453125,43.560606060606055,1025.7575757575753,32.05492424242423,0
3953,4,0,0,34,0.0,0.0,1.0,34,1150,900,250,0.782608695652174,14,9,5,385.17105183649784,0.42108585858585856,0.07112154740109866,0.22771312584573744,131684.2689043209,3344.1936728394935,135028.4625771604,1710,7,327.8235294117647,32,2,16,33.51939557961209,0.6461588541666667,43.40277777777777,1026.3888888888882,32.07465277777776,0
3954,4,0,0,34,0.0,0.0,1.0,34,950,700,250,0.7368421052631579,12,7,5,396.2244664515691,0.421215834818776,0.0725101921956901,0.21731993583787393,128765.68657487509,3498.544697018247,132264.23127189334,1711,8,328.8235294117647,33,1,18,36.20854463495131,0.6142676767676767,46.26225490196079,1014.9509803921571,30.756090314913852,8
3955,4,1,0,35,0.02857142857142857,0.0,1.0,35,950,600,350,0.631578947368421,13,6,7,387.0234246481383,0.42608543417366945,0.07146705935507636,0.21412955127810465,129110.63102324256,2993.767715419494,132104.39873866204,1712,0,320.4,34,1,20,36.08922923743703,0.6155024509803921,45.922619047619044,1016.3095238095232,29.891456582633033,0
3956,4,2,0,37,0.05405405405405406,0.0,1.0,37,900,400,500,0.4444444444444444,14,4,10,366.47597696706333,0.43083708708708707,0.07923546771404943,0.20582993447907627,129701.96926708249,2106.5630680963186,131808.5323351788,1713,0,304.02702702702703,35,2,19,36.00881055183123,0.6193452380952381,45.34143518518518,1018.6342592592594,29.10383597883598,0
3957,4,0,2,35,0.0,0.05405405405405406,0.9459459459459459,37,850,500,350,0.5882352941176471,12,5,7,368.13997934100297,0.4308058058058058,0.07571989167081195,0.2069200573537363,129731.4453125001,2151.866319444459,131883.31163194455,1714,1,305.02702702702703,35,2,19,35.93643490115884,0.6196428571428572,45.31250000000001,1018.7500000000008,29.10714285714288,0
3958,4,1,0,36,0.027777777777777776,0.0,1.0,36,1350,1000,350,0.7407407407407407,17,10,7,373.8613460657041,0.4269675925925926,0.10828513099693815,0.21252968976539735,130173.98787133489,2533.4044656635797,132707.39233699845,1715,0,313.1388888888889,35,1,21,35.340464443688326,0.6241071428571429,44.87847222222222,1020.4861111111112,29.156746031746035,0
3959,4,0,0,36,0.0,0.0,1.0,36,950,500,450,0.5263157894736842,14,5,9,376.5256186386739,0.4270006613756614,0.11364667195827183,0.21436923374915834,130233.05047850216,2607.215979723929,132840.26645822608,1716,1,314.1388888888889,35,1,21,35.21244377669426,0.624702380952381,44.82060185185185,1020.717592592592,29.163359788359774,0
3960,4,0,0,36,0.0,0.0,1.0,36,750,300,450,0.4,12,3,9,374.6772178259059,0.4270502645502645,0.10986394557823154,0.21347887992406261,130262.58680555552,2561.291420181752,132823.87822573728,1717,2,315.1388888888889,33,3,21,35.22959183673468,0.6294191919191919,44.791666666666664,1020.833333333333,30.934343434343425,0
3961,4,0,0,36,0.0,0.0,1.0,36,750,400,350,0.5333333333333333,11,4,7,372.6581800581518,0.4266865079365079,0.10464085230075915,0.21284171449106082,130356.43029423771,2515.6780144655822,132872.1083087033,1718,3,316.1388888888889,33,3,22,35.185782431297255,0.6303661616161615,44.69975490196078,1021.2009803921562,30.945484254307765,0
3962,4,0,0,36,0.0,0.0,1.0,36,900,400,500,0.4444444444444444,14,4,10,374.31016000978155,0.42673611111111115,0.0999656864649292,0.214273214345826,130444.94224773224,2565.3734410430616,133010.3156887753,1719,4,317.1388888888889,34,2,22,35.053703919512095,0.6289828431372548,44.61309523809523,1021.5476190476176,30.045518207282868,0
3963,4,1,1,36,0.02702702702702703,0.02702702702702703,0.972972972972973,37,1000,500,500,0.5,15,5,10,367.70250732622105,0.42833458458458457,0.11308738043956601,0.21348697813417922,130991.17036011085,2233.1563558017892,133224.32671591264,1720,0,309.5405405405405,37,0,20,34.668666095401306,0.6283783783783784,44.078947368421055,1023.6842105263161,27.66714082503557,0
3964,4,0,0,36,0.0,0.0,1.0,36,1100,800,300,0.7272727272727273,14,8,6,373.3980542853851,0.426901455026455,0.11457454483205565,0.2162567316310577,130895.6269402849,2575.234482793606,133470.86142307852,1721,1,316.6388888888889,36,0,20,34.619740655148384,0.6293402777777778,44.1722972972973,1023.310810810811,28.425300300300304,0
3965,4,0,0,36,0.0,0.0,1.0,36,1000,700,300,0.7,13,7,6,355.6703813705755,0.4270998677248677,0.051357546285743405,0.1957749012638288,128907.38195516124,1970.4208803241527,130877.80283548539,1722,2,317.6388888888889,35,1,16,37.0930210470329,0.6113095238095239,46.12268518518519,1015.5092592592598,29.01455026455028,7
3966,4,1,0,37,0.02702702702702703,0.0,1.0,37,1300,900,400,0.6923076923076923,17,9,8,353.39962375705437,0.43140015015015015,0.05338945502879944,0.19597615499254853,129201.38888888904,1731.944444444462,130933.3333333335,1723,0,310.02702702702703,36,1,17,36.85109289617487,0.6122685185185186,45.83333333333334,1016.6666666666679,28.240740740740776,0
3967,4,0,1,36,0.0,0.02702702702702703,0.972972972972973,37,1050,600,450,0.5714285714285714,15,6,9,358.44369251694445,0.43068068068068066,0.09039123251125525,0.1835454060188719,125987.30223043988,1649.2318754565383,127636.53410589641,1724,1,311.02702702702703,36,1,20,40.01822770611331,0.5795717592592593,49.01463963963964,1003.9414414414413,27.887262262262258,8
3968,4,4,1,39,0.1,0.025,0.975,40,650,400,250,0.6153846153846154,9,4,5,339.0512013455115,0.4397970085470086,0.1181867653461035,0.17740332790219585,126870.98434133574,603.1772945645291,127474.16163590028,1725,0,288.575,37,3,18,39.596484545058765,0.5867117117117118,48.1359649122807,1007.4561403508768,27.22854433380748,0
3969,4,3,0,42,0.07142857142857142,0.0,1.0,42,1650,1200,450,0.7272727272727273,21,12,9,329.58607778836995,0.4435733643050716,0.1386057118692703,0.17583500901298307,127658.21468195257,15.066421780201722,127673.28110373276,1726,0,275.76190476190476,38,4,16,39.02896712126017,0.5929276315789473,47.355769230769226,1010.5769230769223,26.59412955465585,0
3970,4,1,1,42,0.023255813953488372,0.023255813953488372,0.9767441860465116,43,1300,1000,300,0.7692307692307693,16,10,6,334.3884970320599,0.44419066076042824,0.16769837072911598,0.18045096072485256,128118.16541883691,-31.751844618046675,128086.41357421887,1727,0,270.3255813953488,39,4,19,38.437703638920325,0.5958867521367521,46.90104166666667,1012.3958333333343,25.958867521367544,0
3971,4,0,1,41,0.0,0.023809523809523808,0.9761904761904762,42,950,500,450,0.5263157894736842,14,5,9,340.84697266100926,0.4401616337591947,0.17906018344013086,0.18380905327052133,128090.45041867551,331.8484503981231,128422.29886907362,1728,1,277.7142857142857,38,4,19,38.30255057167989,0.5973135964912281,46.9284188034188,1012.2863247863241,26.639113810166425,0
3972,4,2,3,40,0.046511627906976744,0.06976744186046512,0.9302325581395349,43,950,700,250,0.7368421052631579,12,7,5,342.9537495471561,0.4432216685123662,0.08637873754152792,0.1835811247575952,127793.20987654309,170.22894751258502,127963.43882405567,1729,0,271.86046511627904,38,5,16,38.553113553113555,0.5942982456140351,47.222222222222214,1011.1111111111102,26.6081871345029,8
3973,4,1,0,41,0.024390243902439025,0.0,1.0,41,800,500,300,0.625,11,5,6,352.96526306913125,0.43948170731707314,0.11570970720843032,0.1891186194726015,127831.16731596475,823.9923200227363,128655.15963598748,1730,0,285.8536585365854,36,5,17,38.26118225686711,0.5983796296296297,47.18468468468469,1011.2612612612623,28.090590590590622,0
3974,4,4,4,41,0.08888888888888889,0.08888888888888889,0.9111111111111111,45,900,700,200,0.7777777777777778,11,7,4,354.4472152204068,0.448442760942761,0.15122805745835,0.18659708290681642,127119.65610812951,57.637521752645796,127177.29362988216,1731,0,261.35555555555555,37,8,16,38.9532592149614,0.5892454954954955,47.88925438596492,1008.4429824561411,27.255215742057867,8
3975,4,1,0,42,0.023809523809523808,0.0,1.0,42,1000,700,300,0.7,13,7,6,361.31843059709524,0.44699719318621756,0.1489830267659047,0.19035845249232713,127150.37321030536,788.354659636506,127938.72786994187,1732,0,245.38095238095238,35,7,17,38.74846989518781,0.593452380952381,47.858796296296305,1008.564814814816,28.816137566137602,0
3976,4,1,2,41,0.023255813953488372,0.046511627906976744,0.9534883720930233,43,1000,700,300,0.7,13,7,6,353.1519035954107,0.4476974898486526,0.1477846050141296,0.18788686685948036,127546.62390430998,408.6666057950162,127955.290510105,1733,0,240.65116279069767,36,7,16,38.54793756967671,0.5954861111111112,47.46621621621623,1010.1351351351373,28.05930930930937,0
3977,4,0,0,41,0.0,0.0,1.0,41,1250,900,350,0.72,16,9,7,367.41637163637887,0.44593495934959354,0.14654277423566575,0.1948754376390327,127422.33737244911,1163.410572562375,128585.74794501149,1734,1,242.6341463414634,34,7,16,38.31530283378533,0.5983455882352942,47.58928571428572,1009.6428571428582,29.695378151260538,0
3978,4,0,1,40,0.0,0.024390243902439025,0.975609756097561,41,1600,1300,300,0.8125,19,13,6,371.7711834361236,0.44568089430894314,0.14795119076706342,0.1977729461727592,127542.56129535148,1283.3297902494317,128825.89108560092,1735,2,243.6341463414634,34,7,17,38.08190925162049,0.5995710784313726,47.470238095238095,1010.1190476190477,29.709383753501402,0
3979,4,2,0,42,0.047619047619047616,0.0,1.0,42,1200,1100,100,0.9166666666666666,13,11,2,363.8516417793011,0.44957413859852885,0.16174356293295,0.19590632732254953,128027.37054183791,916.5937928669118,128943.96433470483,1736,0,230.71428571428572,35,7,19,37.7849573040561,0.6023809523809525,46.990740740740726,1012.0370370370352,28.915343915343865,0
3980,4,0,2,40,0.0,0.047619047619047616,0.9523809523809523,42,1550,1100,450,0.7096774193548387,20,11,9,365.8916998166942,0.44935636856368566,0.1646069805449215,0.19802840852674491,128234.94897959159,984.0742752862152,129219.0232548778,1737,1,231.71428571428572,34,8,19,37.52081374392728,0.6066176470588236,46.78571428571427,1012.8571428571408,29.789915966386495,0
3981,4,2,0,42,0.047619047619047616,0.0,1.0,42,900,600,300,0.6666666666666666,12,6,6,351.6923773097062,0.45114692218350755,0.16464908944944412,0.19334502889172633,128858.14868922984,663.6857296485729,129521.83441887841,1738,0,219.8095238095238,36,6,18,37.24420474711623,0.6087962962962963,46.171171171171174,1015.315315315316,28.20320320320322,0
3982,4,0,2,40,0.0,0.047619047619047616,0.9523809523809523,42,1200,1000,200,0.8333333333333334,14,10,4,351.3416232024257,0.45150987224157957,0.1615340747077274,0.19343093760924773,128915.32368517177,658.6638158428807,129573.98750101465,1739,1,220.8095238095238,36,6,18,37.194823316330286,0.609375,46.11486486486487,1015.5405405405414,28.209459459459485,0
3983,4,1,0,41,0.024390243902439025,0.0,1.0,41,900,600,300,0.6666666666666666,12,6,6,360.2058817908127,0.4491107723577236,0.17662360762167317,0.1985657549369455,128966.1565500686,1090.8736282578916,130057.03017832649,1740,0,226.90243902439025,35,6,19,36.917920085080524,0.611904761904762,46.06481481481482,1015.7407407407408,29.021164021164022,0
3984,4,0,1,40,0.0,0.024390243902439025,0.975609756097561,41,1050,700,350,0.6666666666666666,14,7,7,360.2058817908127,0.44898373983739837,0.17662360762167317,0.1985657549369455,128966.1565500686,1090.8736282578916,130057.03017832649,1741,1,227.90243902439025,35,6,19,36.917920085080524,0.611904761904762,46.06481481481482,1015.7407407407408,29.021164021164022,0
3985,4,0,0,40,0.0,0.0,1.0,40,1300,1000,300,0.7692307692307693,16,10,6,359.73879881216374,0.44903846153846155,0.15374238227146853,0.19905840952052617,129115.53603857249,1289.5735685009527,130405.10960707345,1286,2,191.075,36,4,19,36.777469990766406,0.611400462962963,45.9177927927928,1016.32882882883,28.231356356356386,0
3986,4,0,0,40,0.0,0.0,1.0,40,800,700,100,0.875,9,7,2,361.90518826691374,0.44882478632478634,0.15500443115099127,0.20054746068050552,129172.76810171679,1349.6589917620565,130522.42709347885,1287,3,192.075,36,4,19,36.66408182858832,0.6119791666666667,45.8614864864865,1016.5540540540558,28.23761261261266,0
3987,4,0,2,38,0.0,0.05,0.95,40,800,700,100,0.875,9,7,2,360.747439559399,0.4484107905982906,0.1622893258426965,0.2006657632549158,129322.44897959198,1330.5548101880302,130653.00378978,1288,4,193.075,34,6,19,36.540993679775276,0.6176470588235294,45.71428571428572,1017.1428571428582,29.915966386554654,0
3988,4,0,0,38,0.0,0.0,1.0,38,1150,900,250,0.782608695652174,14,9,5,374.79693479691065,0.4477684921763869,0.15669239875696728,0.20720638830482058,129080.38548752839,2075.786564625858,131156.17205215426,1289,5,201.47368421052633,34,4,19,36.43075406123086,0.6151960784313726,45.952380952380956,1016.1904761904766,29.88795518207284,0
3989,4,1,0,39,0.02564102564102564,0.0,1.0,39,950,600,350,0.631578947368421,13,6,7,367.66807333098257,0.44840868196131356,0.17278465328493753,0.20557156420508513,129525.18332315236,1724.4549200531424,131249.6382432055,1290,0,197.28205128205127,35,4,18,36.158447034299776,0.6175595238095238,45.51504629629629,1017.9398148148143,29.083994708994695,0
3990,4,0,0,39,0.0,0.0,1.0,39,1550,1100,450,0.7096774193548387,20,11,9,369.7268181409236,0.4467780026990553,0.18117328441008151,0.20828180638073146,129819.89354263118,1799.5792341820957,131619.4727768133,1291,1,198.28205128205127,35,4,19,35.80600511073252,0.6205357142857143,45.22569444444444,1019.0972222222223,29.117063492063494,0
3991,4,1,1,39,0.025,0.025,0.975,40,1050,700,350,0.6666666666666666,14,7,7,361.238174759349,0.4479700854700855,0.1845663687520691,0.20551798982071443,130205.11379200149,1407.0115301111973,131612.1253221127,1292,0,194.3,36,4,21,35.63090772003383,0.6223958333333333,44.847972972972975,1020.6081081081084,28.35022522522523,0
3992,4,0,0,39,0.0,0.0,1.0,39,1350,1100,250,0.8148148148148148,16,11,5,368.5271369718513,0.4474527665317139,0.18375826086450875,0.20981541775046852,130233.05047850228,1798.8826463906084,132031.93312489288,1293,1,199.0,35,4,21,35.41654855047815,0.624702380952381,44.820601851851855,1020.717592592593,29.1633597883598,0
3993,4,1,1,39,0.025,0.025,0.975,40,1400,1100,300,0.7857142857142857,17,11,6,361.45734877126654,0.4478632478632478,0.18063858695652169,0.20783797554347833,130617.28395061736,1442.5187810785435,132059.8027316959,1294,0,195.0,35,5,15,35.20720108695654,0.6285714285714286,44.44444444444445,1022.2222222222229,29.206349206349223,0
3994,4,0,1,38,0.0,0.02564102564102564,0.9743589743589743,39,800,700,100,0.875,9,7,2,370.3405971087345,0.4468904633378317,0.18143198989057074,0.21233355677917642,130505.75573979598,1866.315901360548,132372.07164115654,1295,3,201.0,34,5,16,35.09335313992777,0.6295955882352942,44.55357142857143,1021.7857142857148,30.052521008403374,0
3995,4,0,0,38,0.0,0.0,1.0,38,1550,1200,350,0.7741935483870968,19,12,7,369.3785814595026,0.4450865339023234,0.1694092348786056,0.2131182937084347,130749.15143140614,2059.187216553316,132808.33864795946,1296,4,203.78947368421052,34,4,18,34.87103751988516,0.632046568627451,44.315476190476204,1022.7380952380971,30.08053221288521,0
3996,4,0,0,38,0.0,0.0,1.0,38,1300,1000,300,0.7692307692307693,16,10,6,373.05646776945207,0.44425675675675674,0.17630079036138602,0.21626206698678244,130931.8470096374,2168.994472789139,133100.84148242653,1297,5,204.78947368421052,34,4,19,34.59176650769649,0.6338848039215687,44.13690476190477,1023.4523809523826,30.101540616246545,0
3997,4,0,0,38,0.0,0.0,1.0,38,1350,900,450,0.6666666666666666,18,9,9,370.87909119065176,0.44378259838786155,0.17797719542929813,0.216195372669673,131145.15306122473,2127.7990362812106,133272.95209750594,1298,6,205.78947368421052,34,4,20,34.431417557725084,0.6360294117647058,43.928571428571445,1024.2857142857163,30.126050420168127,0
3998,4,0,0,38,0.0,0.0,1.0,38,1350,900,450,0.6666666666666666,18,9,9,369.74477500678967,0.44366405879563775,0.17443495485141014,0.21639243834353886,131297.6208191612,2109.321853741526,133406.94267290275,1299,7,206.78947368421052,34,4,20,34.30615247609093,0.6375612745098039,43.77976190476192,1024.880952380954,30.143557422969238,0
3999,4,0,0,38,0.0,0.0,1.0,38,1150,700,450,0.6086956521739131,16,7,9,369.68975556752343,0.44237494073020384,0.17487154976699704,0.21742330037558733,131485.18786344212,2121.748935481078,133606.93679892318,1300,8,207.78947368421052,33,5,20,34.117850599434426,0.641729797979798,43.59681372549021,1025.6127450980407,31.07917409388002,0
4000,4,0,0,38,0.0,0.0,1.0,38,900,500,400,0.5555555555555556,13,5,8,411.39419004998115,0.44237494073020384,0.10107091846796479,0.23210433259258048,129878.87577428395,3086.28298075272,132965.15875503668,1301,9,208.78947368421052,35,3,16,34.68417641270201,0.6211309523809524,45.16782407407406,1019.3287037037023,29.12367724867721,8
4001,4,0,2,36,0.0,0.05263157894736842,0.9473684210526316,38,1150,700,450,0.6086956521739131,16,7,9,413.99074905894355,0.442315670934092,0.10261006740283984,0.23374554600712638,129908.37191358006,3156.1728395061523,133064.54475308623,1302,10,209.78947368421052,35,3,16,34.58787465940054,0.6214285714285714,45.13888888888888,1019.444444444443,29.126984126984084,0
4002,4,0,1,35,0.0,0.027777777777777776,0.9722222222222222,36,1000,700,300,0.7,13,7,6,426.60410419829293,0.4416170634920635,0.1278686662122246,0.23978092753214394,129731.4453125,3868.7934027777783,133600.23871527778,1303,11,221.19444444444446,33,3,17,34.44742672119972,0.6240530303030303,45.3125,1018.75,30.87121212121212,0
4003,4,0,0,35,0.0,0.0,1.0,35,950,600,350,0.631578947368421,13,6,7,427.9227891258546,0.44054621848739495,0.13388540503393198,0.24090575433862407,129793.87622849373,4108.351505430587,133902.22773392432,1304,12,226.68571428571428,33,2,17,34.349944878733204,0.6246843434343434,45.25122549019607,1018.9950980392147,30.878639334521658,0
4004,4,1,0,36,0.027777777777777776,0.0,1.0,36,550,200,350,0.36363636363636365,9,2,7,418.7934164023735,0.44365079365079363,0.13180745236890945,0.237131738157246,130019.64462868469,3690.274234693864,133709.91886337855,1305,0,221.36111111111111,34,2,18,34.351776195478784,0.6246936274509804,45.0297619047619,1019.8809523809515,29.99649859943975,0
4005,4,1,0,37,0.02702702702702703,0.0,1.0,37,650,500,150,0.7692307692307693,8,5,3,409.6611988845499,0.4438188188188188,0.12884192532241512,0.23381099866467547,130329.0557861328,3279.058478046167,133608.11426417896,1306,0,216.35135135135135,31,6,19,34.26900025503699,0.6350806451612903,44.7265625,1021.0937499999999,32.93850806451613,0
4006,4,0,1,36,0.0,0.02702702702702703,0.972972972972973,37,1100,700,400,0.6363636363636364,15,7,8,410.6338944496495,0.44319319319319317,0.139850312910081,0.2353721088200438,130495.30241224496,3317.158847384973,133812.46125962993,1307,1,217.35135135135135,31,6,16,34.07472600994009,0.636760752688172,44.56380208333333,1021.7447916666662,32.95950940860214,0
4007,4,1,1,36,0.02702702702702703,0.02702702702702703,0.972972972972973,37,1100,800,300,0.7272727272727273,14,8,6,408.277762935855,0.4431619119119119,0.14699260534136505,0.23613666759951707,130843.25140610657,3284.0779958677736,134127.32940197433,1308,0,206.7027027027027,32,5,17,33.780698506725905,0.6376953125,44.22348484848485,1023.106060606061,31.972064393939405,0
4008,4,0,0,36,0.0,0.0,1.0,36,1200,800,400,0.6666666666666666,16,8,8,416.73975432336823,0.4416170634920635,0.14802673456397208,0.2405209970764186,130761.5174187554,3698.7045288085887,134460.221947564,1309,1,212.36111111111111,31,5,18,33.64749098238914,0.6394489247311828,44.303385416666664,1022.786458333333,32.99311155913978,0
4009,4,0,1,35,0.0,0.027777777777777776,0.9722222222222222,36,1500,1200,300,0.8,18,12,6,417.7405953876864,0.4414847883597883,0.14400817388598974,0.24151492700228516,130828.11355590832,3730.442810058608,134558.5563659669,1310,2,213.36111111111111,31,5,18,33.55407598319971,0.6401209677419355,44.23828125000001,1023.0468750000009,33.00151209677422,0
4010,4,0,0,35,0.0,0.0,1.0,35,1000,700,300,0.7,13,7,6,431.75676423743784,0.43781512605042017,0.15286408951805197,0.24907029712529674,130743.26014929471,4289.857389582608,135033.11753887733,1311,3,220.31428571428572,30,5,18,33.28213300039427,0.6420138888888889,44.321236559139784,1022.7150537634408,34.090501792114694,0
4011,4,0,1,34,0.0,0.02857142857142857,0.9714285714285714,35,1250,900,350,0.72,16,9,7,429.99885794175174,0.43676470588235294,0.15419408791768152,0.24881671765142024,130861.41798231345,4254.052056206607,135115.47003852006,1312,4,221.31428571428572,31,4,18,33.206604734029014,0.6404569892473118,44.20572916666667,1023.177083333334,33.00571236559142,0
4012,4,0,0,34,0.0,0.0,1.0,34,950,800,150,0.8421052631578947,11,8,3,437.46750228985445,0.4347147950089127,0.15524249636796417,0.25303971333057546,130846.37674875717,4648.207523991223,135494.58427274838,1313,5,225.91176470588235,30,4,18,33.03090514976353,0.6430555555555555,44.22043010752689,1023.1182795698932,34.10394265232977,0
4013,4,0,0,34,0.0,0.0,1.0,34,800,500,300,0.625,11,5,6,436.57291750110693,0.43504901960784315,0.15273721781856953,0.25297307411365505,130915.14373048901,4630.801248699263,135545.94497918827,1314,6,226.91176470588235,30,4,18,32.98364854215917,0.64375,44.15322580645161,1023.3870967741931,34.112903225806434,0
4014,4,0,0,34,0.0,0.0,1.0,34,1000,600,400,0.6,14,6,8,437.3035330163096,0.43508615567439096,0.15491174154093246,0.2543036881311638,131052.73189097003,4661.964533472071,135714.6964244421,1315,7,227.91176470588235,30,4,18,32.82466964207578,0.6451388888888889,44.01881720430107,1023.9247311827954,34.13082437275985,0
4015,4,0,0,34,0.0,0.0,1.0,34,750,400,350,0.5333333333333333,11,4,7,433.6707848055274,0.43460338680926913,0.15432671098183803,0.2529049713910365,131161.34855482308,4576.168992784284,135737.51754760736,1316,8,228.91176470588235,31,3,20,32.807004999788155,0.643481182795699,43.912760416666664,1024.348958333333,33.043514784946225,0
4016,4,1,0,35,0.02857142857142857,0.0,1.0,35,550,400,150,0.7272727272727273,7,4,3,383.4253453449064,0.43616946778711485,0.11193747120159725,0.22587287585378,131548.0392907776,3162.746234381952,134710.78552515956,1317,0,223.34285714285716,33,2,22,33.70204177119421,0.6423611111111112,43.53553921568628,1025.8578431372553,31.086601307189554,8
4017,4,0,0,35,0.0,0.0,1.0,35,1000,800,200,0.8,12,8,4,383.4253453449064,0.43609943977591037,0.11193747120159725,0.22587287585378,131548.0392907776,3087.7704789023514,134635.80976967997,1318,1,224.34285714285716,33,2,22,33.70204177119421,0.6423611111111112,43.53553921568628,1025.8578431372553,31.086601307189554,0
4018,4,0,1,34,0.0,0.02857142857142857,0.9714285714285714,35,1100,800,300,0.7272727272727273,14,8,6,386.88448097032585,0.43606442577030813,0.11311229362805286,0.22885200654007412,131705.23356401385,3190.9421856978092,134896.17574971166,1319,2,225.34285714285716,33,2,18,33.45421442215855,0.6439393939393939,43.38235294117647,1026.4705882352941,31.10516934046346,0
4019,4,1,0,35,0.02857142857142857,0.0,1.0,35,1050,700,350,0.6666666666666666,14,7,7,387.0834632935908,0.4351190476190476,0.11980709258533451,0.2302995509432343,131925.46323829782,3213.233041378323,135138.69627967614,1320,0,226.25714285714287,33,2,19,33.226345977971285,0.6461489898989898,43.16789215686275,1027.3284313725494,31.131164587046953,0
4020,4,0,0,35,0.0,0.0,1.0,35,1050,700,350,0.6666666666666666,14,7,7,389.0855535917841,0.43462885154061626,0.12426152430922288,0.2320676708691821,132019.90370290267,3273.4074634755752,135293.31116637823,1321,1,227.25714285714287,33,2,20,33.07943795214245,0.6470959595959596,43.07598039215686,1027.696078431372,31.14230540701127,0
4021,4,0,0,35,0.0,0.0,1.0,35,600,500,100,0.8333333333333334,7,5,2,390.0784320967838,0.43375350140056024,0.12417503831091437,0.23343495330185546,132145.8768862936,3309.451292771995,135455.3281790656,1322,2,228.25714285714287,33,2,20,32.926599125943596,0.6483585858585859,42.95343137254901,1028.1862745098028,31.157159833630388,0
4022,4,0,0,35,0.0,0.0,1.0,35,1150,800,350,0.6956521739130435,15,8,7,385.6903659516172,0.43238795518207285,0.11571496631048839,0.23196678456517017,132334.9492983467,3208.0630046136034,135543.0123029603,1323,3,229.25714285714287,33,2,20,32.84847943465142,0.6502525252525253,42.76960784313725,1028.9215686274504,31.179441473559102,0
4023,4,0,1,34,0.0,0.02857142857142857,0.9714285714285714,35,1050,900,150,0.8571428571428571,12,9,3,386.6742474773901,0.432703081232493,0.1178924445805476,0.23275295025574502,132366.47450800164,3236.5413843233287,135603.01589232497,1324,4,230.25714285714287,33,2,20,32.79134909293002,0.6505681818181819,42.73897058823529,1029.044117647058,31.183155080213883,0
4024,4,0,0,34,0.0,0.0,1.0,34,950,500,450,0.5263157894736842,14,5,9,399.3543958129537,0.4309640522875817,0.13020878454474571,0.2399660484575182,132300.56244260792,3766.9622359963305,136067.52467860424,1325,5,237.5,32,2,20,32.531756259204705,0.65234375,42.803030303030305,1028.787878787879,32.14962121212122,0
4025,4,0,0,34,0.0,0.0,1.0,34,1400,900,500,0.6428571428571429,19,9,10,405.21803003652786,0.429812834224599,0.12459696324881886,0.24496316048538802,132527.98064291908,3940.5454481685533,136468.52609108764,1326,6,238.5,32,2,20,32.151032086654396,0.6546223958333333,42.582070707070706,1029.671717171717,32.17724116161616,0
4026,4,0,0,34,0.0,0.0,1.0,34,1300,1100,200,0.8461538461538461,15,11,4,404.7415657439447,0.42931149732620316,0.11760380622837374,0.24573595063025214,132690.54178145083,3941.075528007343,136631.61730945818,1327,7,239.5,32,2,18,31.99908088235294,0.65625,42.42424242424242,1030.30303030303,32.19696969696969,0
4027,4,0,0,34,0.0,0.0,1.0,34,650,400,250,0.6153846153846154,9,4,5,406.4255296676415,0.4286244800950683,0.1206412002507733,0.24740131235473214,132788.1262913223,3993.6969123048657,136781.82320362717,1328,8,240.5,32,2,18,31.85716035771162,0.6572265625,42.32954545454545,1030.681818181818,32.20880681818181,0
4028,4,0,1,33,0.0,0.029411764705882353,0.9705882352941176,34,1000,600,400,0.6,14,6,8,406.45599874986283,0.4284016636957813,0.11842853953139953,0.248281685997766,132918.2947690287,4005.0876504948524,136923.38241952355,1329,9,241.5,32,2,18,31.7249806130362,0.6585286458333333,42.20328282828283,1031.186868686869,32.22458964646466,0
4029,4,0,0,33,0.0,0.0,1.0,33,650,500,150,0.7692307692307693,8,5,3,406.899564367086,0.4262941919191919,0.09336849953816562,0.2489859581509159,132983.40292125818,4222.177743342531,137205.5806646007,1330,10,229.21212121212122,32,1,18,31.64784551352675,0.6591796875,42.14015151515152,1031.439393939395,32.23248106060609,0
4030,4,0,1,32,0.0,0.030303030303030304,0.9696969696969697,33,750,500,250,0.6666666666666666,10,5,5,405.3677432988111,0.42586016414141414,0.08690428514217063,0.24869858845629783,133081.09504132243,4189.356634527107,137270.45167584953,1331,11,230.21212121212122,32,1,19,31.588809348996584,0.66015625,42.045454545454554,1031.818181818183,32.244318181818215,0
4031,4,0,0,32,0.0,0.0,1.0,32,950,600,350,0.631578947368421,13,6,7,413.6437242205503,0.42338709677419356,0.09491807677737074,0.25255548589842247,132901.0030958388,4594.733174641931,137495.73627048073,1332,24,238.0625,31,1,19,31.557146314770385,0.6609543010752688,42.220052083333336,1031.119791666667,33.26192876344087,0
4032,4,0,0,32,0.0,0.0,1.0,32,1100,800,300,0.7272727272727273,14,8,6,412.759048254038,0.4224000336021505,0.09018533123028383,0.2533784242767814,133102.4699740939,4587.849765353722,137690.31973944762,1333,25,239.0625,31,1,19,31.37657728706625,0.6629704301075269,42.02473958333333,1031.901041666666,33.28713037634407,0
4033,4,0,1,31,0.0,0.03125,0.96875,32,700,500,200,0.7142857142857143,9,5,4,414.45664868783746,0.42164398521505375,0.09526362260343091,0.2551096514594079,133203.26063368047,4641.3953993055475,137844.656032986,1334,26,240.0625,31,1,19,31.231079717457124,0.663978494623656,41.92708333333333,1032.291666666666,33.29973118279568,0
4034,4,0,0,31,0.0,0.0,1.0,31,750,500,250,0.6666666666666666,10,5,5,423.7812300796677,0.4221774193548387,0.09136633513595283,0.260061431120832,133090.55102107176,5080.255484738112,138170.8065058099,1335,27,244.1290322580645,30,1,19,31.10427250227953,0.665625,42.03629032258064,1031.854838709677,34.39516129032257,0
4035,4,0,0,31,0.0,0.0,1.0,31,700,600,100,0.8571428571428571,8,6,2,423.0789368430437,0.4215949820788531,0.0977611282133124,0.26059898266972104,133229.2773189098,5073.300200890287,138302.57751980008,1336,28,245.1290322580645,30,1,19,30.98229397213904,0.6670138888888889,41.90188172043011,1032.3924731182801,34.413082437276,0
4036,4,0,0,31,0.0,0.0,1.0,31,950,600,350,0.631578947368421,13,6,7,400.72315824806066,0.42092293906810035,0.09690146103069686,0.2301434210965448,130571.48947855236,4264.603928199784,134836.09340675216,1337,29,246.1290322580645,30,1,20,34.2503397334736,0.6402777777777777,44.48924731182795,1022.0430107526877,34.068100358422925,8
4037,4,0,0,31,0.0,0.0,1.0,31,650,400,250,0.6153846153846154,9,4,5,402.31412852031076,0.4204301075268817,0.09996734756188075,0.23167324569674505,130674.53833174348,4314.442601745856,134988.98093348934,1338,30,247.1290322580645,30,1,20,34.10482669471101,0.6413194444444444,44.38844086021505,1022.4462365591392,34.08154121863797,0
4038,4,0,0,31,0.0,0.0,1.0,31,700,600,100,0.8571428571428571,8,6,2,400.8160643457932,0.4210125448028674,0.10197956847950507,0.23142718131043122,130777.62783269734,4283.554818476113,135061.18265117344,1339,31,248.1290322580645,30,1,20,34.038272010512486,0.6423611111111112,44.287634408602145,1022.8494623655907,34.09498207885302,0
4039,4,0,0,31,0.0,0.0,1.0,31,850,500,350,0.5882352941176471,12,5,7,402.96987995556424,0.42038530465949825,0.10191887173054415,0.23308561749405426,130846.37674875707,4345.429746213433,135191.80649497051,1340,32,249.1290322580645,30,1,20,33.9132838500613,0.6430555555555555,44.22043010752688,1023.1182795698924,34.10394265232974,0
4040,4,0,1,30,0.0,0.03225806451612903,0.967741935483871,31,550,500,50,0.9090909090909091,6,5,1,399.8482435253515,0.41931003584229387,0.10337320412035789,0.23210702916837467,130983.92877789329,4274.738770378064,135258.66754827136,1341,33,250.1290322580645,30,1,20,33.85334602591037,0.6444444444444444,44.08602150537634,1023.6559139784937,34.121863799283126,0
4041,4,0,0,30,0.0,0.0,1.0,30,700,300,400,0.42857142857142855,11,3,8,408.7974408216534,0.41829501915708817,0.09609120521172665,0.23679398930612744,130901.38888888885,4702.430555555551,135603.8194444444,1342,34,248.96666666666667,29,1,20,33.7082654723127,0.646551724137931,44.166666666666664,1023.3333333333329,35.28735632183906,0
4042,4,0,1,29,0.0,0.03333333333333333,0.9666666666666667,30,500,300,200,0.6,7,3,4,409.356940473407,0.4179597701149425,0.09981908638625048,0.2375559567944101,130972.46334876532,4722.897376543196,135695.3607253085,1343,35,249.96666666666667,29,1,20,33.62166440524649,0.6472701149425287,44.097222222222214,1023.6111111111103,35.296934865900354,0
4043,4,0,0,29,0.0,0.0,1.0,29,700,400,300,0.5714285714285714,10,4,6,416.27758033595006,0.4164100985221675,0.10069894867277229,0.24149523471606732,130960.20775531765,5103.159680935382,136063.36743625303,1344,36,253.93103448275863,28,1,20,33.45703490548381,0.6502976190476191,44.109195402298845,1023.5632183908039,36.55582922824299,0
4044,4,0,1,28,0.0,0.034482758620689655,0.9655172413793104,29,850,700,150,0.8235294117647058,10,7,3,416.24554680325366,0.4154351395730706,0.10452722284851679,0.24216996016871725,131070.52873976075,5111.504781014648,136182.03352077538,1345,37,254.93103448275863,28,1,20,33.345610588840565,0.6514136904761905,44.001436781609186,1023.9942528735622,36.571223316912935,0
4045,4,0,0,28,0.0,0.0,1.0,28,850,700,150,0.8235294117647058,10,7,3,415.44547366184804,0.4123677248677249,0.10313564415948684,0.2423998549270847,131180.89617188528,5299.701909102909,136480.5980809882,1346,38,256.64285714285717,28,0,20,33.25385694249648,0.6525297619047619,43.893678160919535,1024.4252873563214,36.586617405582906,0
4046,4,0,0,28,0.0,0.0,1.0,28,700,300,400,0.42857142857142855,11,3,8,418.07125388327063,0.4113756613756614,0.10365853658536572,0.24487030584591565,131328.125,5380.902777777779,136709.02777777778,1347,39,257.64285714285717,28,0,20,33.036924119241185,0.6540178571428572,43.75,1025.0,36.607142857142854,0
4047,4,0,0,28,0.0,0.0,1.0,28,550,300,250,0.5454545454545454,8,3,5,418.9450722353803,0.41134810405643735,0.10553108419261159,0.245618166836437,131364.9451091623,5406.939283590952,136771.88439275324,1348,40,258.64285714285717,28,0,20,32.977108152300865,0.6543898809523809,43.71408045977011,1025.143678160919,36.61227422003282,0
4048,4,0,0,28,0.0,0.0,1.0,28,1000,800,200,0.8,12,8,4,396.91050688044425,0.4103835978835979,0.0037821027287319176,0.22938334488545162,130813.18536134236,4784.225541683186,135597.41090302553,1349,41,259.64285714285717,28,0,20,34.10200140449438,0.6488095238095238,44.252873563218394,1022.9885057471269,36.5353037766831,8
4049,4,1,0,29,0.034482758620689655,0.0,1.0,29,900,500,400,0.5555555555555556,13,5,8,385.9459911061151,0.4120484400656814,0.026622202917233162,0.22668570026542953,131434.91753472228,4345.355902777782,135780.27343750006,1350,0,251.6551724137931,29,0,21,33.75194704049844,0.6519396551724138,43.645833333333336,1025.416666666667,35.35919540229886,0
4050,4,0,0,29,0.0,0.0,1.0,29,1050,800,250,0.7619047619047619,13,8,5,384.70713361948145,0.4114839901477832,0.026607787212390877,0.2268022023980137,131577.3750964507,4323.750964506185,135901.12606095689,1351,1,252.6551724137931,29,0,17,33.639473624836434,0.6533764367816092,43.50694444444445,1025.9722222222229,35.37835249042148,0
4051,4,1,0,30,0.03333333333333333,0.0,1.0,30,650,400,250,0.6153846153846154,9,4,5,370.7248054422863,0.4125478927203065,0.026759089720115092,0.22110466945489232,132017.8723696381,3788.460009827727,135806.3323794658,1352,0,245.2,30,0,20,33.55321954834772,0.6548611111111111,43.07795698924731,1027.6881720430106,34.256272401433684,0
4052,4,0,0,30,0.0,0.0,1.0,30,850,700,150,0.8235294117647058,10,7,3,369.9563409297258,0.4129549808429119,0.025532749379003405,0.22125066862951326,132121.4902915078,3775.8366212857118,135897.3269127935,1353,1,246.2,30,0,20,33.46842724539156,0.6559027777777777,42.977150537634415,1028.0913978494632,34.269713261648775,0
4053,4,0,0,30,0.0,0.0,1.0,30,1000,400,600,0.4,16,4,12,368.6782176808313,0.4121168582375479,0.02241093981360498,0.22149631696460623,132294.27715631868,3754.803662273101,136049.08081859178,1354,2,247.2,30,0,22,33.327072990157646,0.6576388888888889,42.80913978494624,1028.7634408602153,34.29211469534051,0
4054,4,0,0,30,0.0,0.0,1.0,30,1000,600,400,0.6,14,6,8,366.8027093153543,0.41180555555555554,0.01848370109239683,0.2213823444165721,132467.17693158166,3717.863878772113,136185.04081035376,1355,3,248.2,30,0,24,33.201135918527235,0.659375,42.641129032258064,1029.4354838709676,34.31451612903225,0
4055,4,0,0,30,0.0,0.0,1.0,30,750,700,50,0.9333333333333333,8,7,1,366.52646074347757,0.4115421455938697,0.019155787641427224,0.22141898180560243,132501.77043588858,3713.080992022204,136214.8514279108,1356,4,249.2,30,0,24,33.17341166231505,0.6597222222222222,42.60752688172043,1029.5698924731187,34.31899641577062,0
4056,4,0,0,30,0.0,0.0,1.0,30,450,100,350,0.2222222222222222,8,1,7,367.2771540396006,0.4101532567049808,0.0223816979819067,0.22269083137337828,132640.18961729694,3743.1422707827737,136383.33188807973,1357,5,250.2,30,0,18,33.01474425887265,0.6611111111111111,42.4731182795699,1030.1075268817217,34.336917562724054,0
4057,4,0,0,30,0.0,0.0,1.0,30,550,400,150,0.7272727272727273,7,4,3,389.1944543160336,0.4100814176245211,0.02305999383775692,0.21751805184762535,129509.0314812406,4080.8393672678926,133589.8708485085,1358,6,251.2,30,0,20,35.62711827105066,0.6295138888888889,45.530913978494624,1017.8763440860215,33.92921146953405,8
4058,4,0,0,30,0.0,0.0,1.0,30,1100,800,300,0.7272727272727273,14,8,6,389.50183372379183,0.4095785440613027,0.024551214361140383,0.21825931156001827,129611.66030755009,4096.795872355199,133708.45617990528,1359,7,252.2,30,0,21,35.51456353396693,0.6305555555555555,45.43010752688173,1018.2795698924738,33.94265232974912,0
4059,4,0,0,30,0.0,0.0,1.0,30,650,500,150,0.7692307692307693,8,5,3,391.0467393975701,0.408213601532567,0.020042221929014614,0.2196992763450098,129714.3297816221,4144.873142848884,133859.202924471,1360,8,253.2,30,0,21,35.370486431807194,0.6315972222222221,45.329301075268816,1018.6827956989242,33.95609318996414,0
4060,4,0,0,30,0.0,0.0,1.0,30,550,400,150,0.7272727272727273,7,4,3,393.322937044437,0.40838122605363986,0.017176781002638197,0.22117120643893426,129748.56197248239,4206.617094461791,133955.17906694417,1361,9,254.2,30,0,21,35.27759454705365,0.6319444444444444,45.295698924731184,1018.8172043010755,33.96057347670252,0
4061,4,1,0,31,0.03225806451612903,0.0,1.0,31,800,600,200,0.75,10,6,4,384.4086631194549,0.4103942652329749,0.030294673323811194,0.21846342950450826,130162.91512383362,3807.1504380967976,133970.06556193042,1362,0,246.96774193548387,31,0,22,35.082647484156354,0.6334005376344086,44.88932291666667,1020.4427083333339,32.917506720430126,0
4062,4,0,0,31,0.0,0.0,1.0,31,250,100,150,0.4,4,1,3,382.6185278685937,0.41008064516129034,0.026866629900649475,0.21763164161350076,130196.13477918853,3763.0906846788403,133959.22546386736,1363,1,247.96774193548387,31,0,22,35.09451815939439,0.633736559139785,44.85677083333334,1020.572916666668,32.921706989247355,0
4063,4,1,0,32,0.03125,0.0,1.0,32,650,400,250,0.6153846153846154,9,4,5,371.9884756629982,0.41284442204301075,0.03134266123054119,0.21353721432739786,130552.75769054188,3312.824265381097,133865.58195592297,1364,0,241.1875,32,0,19,35.00355201383743,0.634765625,44.507575757575765,1021.9696969696977,31.936553030303052,0
4064,4,0,0,32,0.0,0.0,1.0,32,750,300,450,0.4,12,3,9,373.3090146502833,0.4127604166666667,0.03515624999999978,0.2146526834239131,130617.2839506175,3352.121913580272,133969.40586419776,1365,1,242.1875,32,0,20,34.904325181159415,0.6354166666666667,44.44444444444446,1022.2222222222239,31.944444444444496,0
4065,4,0,0,32,0.0,0.0,1.0,32,800,700,100,0.875,9,7,2,373.0512583041193,0.4124033938172043,0.0390904741326088,0.21504214526726434,130714.10323245087,3352.6121377920754,134066.71537024295,1366,2,243.1875,32,0,20,34.812682635716335,0.6363932291666667,44.34974747474748,1022.601010101011,31.956281565656592,0
4066,4,0,0,32,0.0,0.0,1.0,32,1050,600,450,0.5714285714285714,15,6,9,371.1992128002306,0.4122563844086022,0.041229639684106534,0.21487131575236224,130875.54841342728,3316.180109172544,134191.72852259982,1367,3,244.1875,32,0,21,34.69634336952946,0.6380208333333333,44.1919191919192,1023.2323232323239,31.97601010101012,0
4067,4,0,0,32,0.0,0.0,1.0,32,1100,800,300,0.7272727272727273,14,8,6,380.6333427760573,0.41265540994623656,0.04362832272557138,0.2045617019225047,127952.84162649213,3340.623565197424,131293.46519168955,1368,4,245.1875,32,0,17,37.43682141520029,0.6083984375,47.06439393939394,1011.7424242424237,31.61695075757574,8
4068,4,1,1,32,0.030303030303030304,0.030303030303030304,0.9696969696969697,33,900,500,400,0.5555555555555556,13,5,8,368.12915982326285,0.4133128156565657,0.045586425180236256,0.20033976381960705,128454.92118415982,2857.600442137627,131312.52162629744,1369,0,238.72727272727272,33,0,18,37.23907962604771,0.6111111111111112,46.56862745098039,1013.7254901960774,30.718954248365982,0
4069,4,1,1,32,0.030303030303030304,0.030303030303030304,0.9696969696969697,33,800,300,500,0.375,13,3,10,367.8507921251372,0.4136679292929293,0.05127867220160032,0.20112740140104926,128641.33536380238,2864.163422722026,131505.4987865244,1370,0,239.54545454545453,33,0,20,37.05554884432632,0.6130050505050505,46.384803921568626,1014.4607843137254,30.74123588829471,0
4070,4,0,0,32,0.0,0.0,1.0,32,700,600,100,0.8571428571428571,8,6,2,405.2651778733964,0.41313844086021506,0.08725454181138081,0.21038939816645258,126550.47729506312,3859.7332966669064,130410.21059173002,1371,1,247.46875,30,2,17,38.26002983346691,0.5993055555555555,48.45430107526882,1006.1827956989256,33.53942652329752,8
4071,4,0,0,32,0.0,0.0,1.0,32,850,400,450,0.47058823529411764,13,4,9,408.1347448578524,0.4132224462365592,0.08849299065420557,0.21258200549272005,126685.75304948549,3940.971499595329,130626.72454908081,1372,2,248.46875,30,2,18,38.04795282599022,0.6006944444444444,48.31989247311828,1006.7204301075268,33.55734767025089,0
4072,4,1,0,33,0.030303030303030304,0.0,1.0,33,900,600,300,0.6666666666666666,12,6,6,396.4893108394234,0.41654829545454547,0.08740295517155028,0.20858785483291414,127092.01388888895,3478.125000000008,130570.13888888896,1373,0,241.9090909090909,31,2,20,37.921831955922855,0.6021505376344086,47.91666666666667,1008.3333333333339,32.526881720430126,0
4073,4,1,0,34,0.029411764705882353,0.0,1.0,34,950,600,350,0.631578947368421,13,6,7,384.9739401967118,0.4181706773618538,0.08690374599064299,0.2041280918974077,127410.50020406082,3009.9444571982494,130420.44466125907,1374,0,235.76470588235293,32,2,18,37.88430673670169,0.6028645833333333,47.601010101010104,1009.5959595959597,31.54987373737374,0
4074,4,2,1,35,0.05555555555555555,0.027777777777777776,0.9722222222222222,36,700,500,200,0.7142857142857143,9,5,4,366.68512110726624,0.42673611111111115,0.09372549019607801,0.19726731198808636,127993.90589569177,2186.692176870765,130180.59807256254,1375,0,223.61111111111111,34,2,20,37.747549019607845,0.6041666666666667,47.02380952380953,1011.9047619047632,29.7619047619048,0
4075,4,1,0,36,0.027777777777777776,0.0,1.0,36,350,100,250,0.2857142857142857,6,1,5,366.08078318796333,0.427281746031746,0.10020319625752983,0.19738648696558356,128084.27047902497,2177.8380102040815,130262.10848922905,1376,0,224.41666666666666,34,2,21,37.67028303735936,0.6050857843137255,46.93452380952381,1012.2619047619049,29.772408963585438,0
4076,4,0,1,35,0.0,0.027777777777777776,0.9722222222222222,36,950,800,150,0.8421052631578947,11,8,3,352.6642553586871,0.4264219576719577,0.05578428382637002,0.18988277394435685,128027.3705418379,1830.1354595335777,129857.50600137147,1377,1,225.41666666666666,35,1,20,38.068008539188774,0.6023809523809525,46.990740740740726,1012.0370370370351,28.91534391534386,8
4077,4,1,1,35,0.027777777777777776,0.027777777777777776,0.9722222222222222,36,900,500,400,0.5555555555555556,13,5,8,354.38395987382347,0.4251818783068783,0.07472705427571436,0.19180017370270255,128234.94897959159,1888.9353863973263,130123.88436598891,1378,0,226.33333333333334,34,2,21,37.812206158909255,0.6066176470588236,46.78571428571427,1012.8571428571408,29.789915966386495,0
4078,4,2,0,37,0.05405405405405406,0.0,1.0,37,900,600,300,0.6666666666666666,12,6,6,348.1899252674036,0.4272084584584585,0.10372534696859037,0.19094918415696416,128760.50407503839,1566.6220582561496,130327.12613329454,1379,0,221.02702702702703,35,2,20,37.43264625384879,0.6098214285714285,46.2673611111111,1014.930555555554,28.998015873015827,0
4079,4,0,0,37,0.0,0.0,1.0,37,950,700,250,0.7368421052631579,12,7,5,346.76559308947685,0.4271146146146146,0.10576007543286048,0.19044965666798977,128819.24518014808,1534.0163912465405,130353.26157139461,1380,1,222.02702702702703,35,2,21,37.408909094364006,0.6104166666666666,46.209490740740726,1015.1620370370351,29.004629629629576,0
4080,4,1,0,38,0.02631578947368421,0.0,1.0,38,600,100,500,0.16666666666666666,11,1,10,340.0648220890054,0.4292614983404457,0.10611149009113019,0.18844476052777479,129172.76810171656,1185.4228806509168,130358.19098236748,1381,0,217.1578947368421,36,2,22,37.21912964809275,0.6119791666666667,45.861486486486484,1016.5540540540538,28.237612612612608,0
4081,4,2,2,38,0.05,0.05,0.95,40,900,400,500,0.4444444444444444,14,4,10,328.222158365451,0.43262553418803423,0.11615748709122209,0.18514279030128822,129871.11418898107,525.3186520867839,130396.43284106786,1382,0,207.25,37,3,17,36.81153184165231,0.6171171171171171,45.17543859649122,1019.2982456140339,27.548601232811727,0
4082,4,2,1,39,0.05,0.025,0.975,40,1350,800,550,0.5925925925925926,19,8,11,326.0220574924445,0.43385416666666665,0.12788360895959872,0.18562662319921397,130235.32238476122,491.91755241431804,130727.23993717555,1383,0,205.675,38,2,20,36.49889226153095,0.6189692982456141,44.818376068376054,1020.7264957264936,26.861223571749832,0
4083,4,0,0,39,0.0,0.0,1.0,39,750,500,250,0.6666666666666666,10,5,5,334.1179542704994,0.43078047683310844,0.1273125957268635,0.190095960779328,130206.62607725442,900.8743074792158,131107.50038473363,1384,1,211.74358974358975,37,2,20,36.32135439048848,0.6204954954954955,44.84649122807017,1020.6140350877183,27.584163110478872,0
4084,4,0,0,39,0.0,0.0,1.0,39,1250,1000,250,0.8,15,10,5,332.6947105372759,0.43052744039586144,0.12579801151229697,0.1895586141433319,130262.58680555577,867.546745152378,131130.13355070815,1385,2,212.74358974358975,36,3,20,36.30102040816326,0.622974537037037,44.79166666666668,1020.8333333333351,28.35648148148153,0
4085,4,0,0,39,0.0,0.0,1.0,39,1000,900,100,0.9,11,9,2,333.78064446253296,0.43052744039586144,0.12620576732190258,0.19045872267726813,130320.07250071033,899.6635571382329,131219.73605784855,1386,3,213.74358974358975,36,3,20,36.21512076761882,0.6235532407407407,44.73536036036037,1021.0585585585599,28.362737737737774,0
4086,4,0,0,39,0.0,0.0,1.0,39,300,100,200,0.3333333333333333,5,1,4,332.97747995880377,0.4307242465137202,0.12672344564713356,0.19014104460116074,130348.82010388773,880.6443267592007,131229.46443064694,1387,4,214.74358974358975,36,3,20,36.20653212762829,0.6238425925925926,44.70720720720721,1021.1711711711716,28.365865865865878,0
4087,4,1,0,40,0.025,0.0,1.0,40,950,700,250,0.7368421052631579,12,7,5,324.3176793914584,0.4325988247863248,0.1252873262981924,0.1868780559575946,130699.20562358461,477.612613229598,131176.8182368142,1388,0,210.35,38,2,18,36.07359906662488,0.6236293859649122,44.36431623931624,1022.5427350427349,26.909019343229865,0
4088,4,0,0,40,0.0,0.0,1.0,40,1150,900,250,0.782608695652174,14,9,5,323.86534946388537,0.4320913461538462,0.1212406015037597,0.18727865860302945,130835.79881656807,474.63634122288545,131310.43515779095,1389,1,211.35,38,2,18,35.94729010025063,0.625,44.23076923076923,1023.0769230769232,26.923076923076927,0
4089,4,0,0,40,0.0,0.0,1.0,40,1000,500,500,0.5,15,5,10,323.6824756207083,0.4321581196581197,0.12083898924506609,0.18730556308275081,130863.1260158706,471.62011925635284,131334.74613512694,1390,2,212.35,38,2,18,35.92439351223416,0.6252741228070176,44.20405982905984,1023.1837606837622,26.925888439046375,0
4090,4,0,2,38,0.0,0.05,0.95,40,950,600,350,0.631578947368421,13,6,7,324.73925758691746,0.43201121794871794,0.12065240083507267,0.1883173176563362,130945.12473518902,504.6045182263299,131449.72925341534,1391,3,213.35,38,2,18,35.814631176061226,0.6260964912280702,44.12393162393163,1023.504273504275,26.934322986954605,0
4091,4,0,0,38,0.0,0.0,1.0,38,650,400,250,0.6153846153846154,9,4,5,340.40518633617694,0.4266239924134661,0.1287264758061708,0.1958300558656411,130636.47050766998,1293.8664170927857,131930.33692476276,1392,4,225.1578947368421,36,2,18,35.72579312623927,0.6267361111111112,44.425675675675684,1022.2972972972984,28.39714714714718,0
4092,4,0,0,38,0.0,0.0,1.0,38,1300,1000,300,0.7692307692307693,16,10,6,338.65507543862736,0.4266091749644381,0.1271092700655776,0.1951976040507194,130710.70545744854,1253.1687634656944,131963.87422091424,1393,5,226.1578947368421,37,1,19,35.695457144899564,0.6255630630630631,44.3530701754386,1022.5877192982464,27.63750592697963,0
4093,4,0,1,37,0.0,0.02631578947368421,0.9736842105263158,38,1000,800,200,0.8,12,8,4,339.20934112303866,0.42683143669985774,0.12126809897963176,0.19622829274761794,130850.90033712306,1277.169537742391,132128.06987486547,1394,6,227.1578947368421,37,1,20,35.53957685850033,0.6269707207207207,44.21600877192983,1023.1359649122816,27.652323376007608,0
4094,4,0,0,37,0.0,0.0,1.0,37,900,500,400,0.5555555555555556,13,5,8,343.12338078911887,0.42492492492492495,0.17481365042340635,0.1885409917119593,128838.54875283457,1459.6883666324477,130298.23711946701,1395,7,233.97297297297297,34,3,20,37.48167800187618,0.6127450980392157,46.1904761904762,1015.2380952380961,29.859943977591062,8
4095,4,2,1,38,0.05128205128205128,0.02564102564102564,0.9743589743589743,39,1100,700,400,0.6363636363636364,15,7,8,330.7609657773412,0.43027440395861444,0.1788628959943701,0.18449111646691718,129430.4693206722,762.1094067040252,130192.57872737623,1396,0,222.92307692307693,36,3,16,37.193817323299406,0.6145833333333333,45.60810810810812,1017.5675675675691,28.265765765765806,0
4096,4,0,0,38,0.0,0.0,1.0,38,950,700,250,0.7368421052631579,12,7,5,337.52824294802787,0.427290777619725,0.1899700052086759,0.1881554079743892,129407.39300679465,1135.7299972136811,130543.12300400833,1397,1,229.78947368421052,35,3,21,37.04510768589089,0.6163690476190475,45.63078703703705,1017.4768518518539,29.070767195767253,0
4097,4,1,0,39,0.02564102564102564,0.0,1.0,39,1300,1100,200,0.8461538461538461,15,11,4,328.34992826836765,0.4254948268106163,0.18878028049298723,0.18502906916741807,129831.84831791285,726.0556164272798,130557.90393434014,1398,0,224.87179487179486,36,3,20,36.84806629834256,0.6186342592592593,45.213963963963984,1019.1441441441469,28.309559559559638,0
4098,4,0,0,39,0.0,0.0,1.0,39,850,600,250,0.7058823529411765,11,6,5,326.0414441900739,0.42535425101214575,0.18280629612637567,0.1842683667725927,129946.64216581476,673.5981758786179,130620.24034169338,1399,1,225.87179487179486,36,3,20,36.790598998601,0.6197916666666667,45.10135135135137,1019.594594594597,28.32207207207214,0
4099,4,0,0,39,0.0,0.0,1.0,39,1400,900,500,0.6428571428571429,19,9,10,327.0738989746634,0.42414529914529914,0.18660418417619606,0.18580668329839667,130147.65346004802,713.5800919162579,130861.23355196428,1400,2,226.87179487179486,36,3,20,36.5607640804915,0.6218171296296297,44.90427927927929,1020.3828828828839,28.343968968968998,0
4100,4,1,0,40,0.025,0.0,1.0,40,750,500,250,0.6666666666666666,10,5,5,319.00397861798615,0.4256143162393162,0.18640802747370633,0.18280929106779792,130486.54994806096,325.14571791320293,130811.69566597416,1401,0,222.175,37,3,21,36.42412534878731,0.6233108108108107,44.57236842105263,1021.7105263157896,27.613798008534854,0
4101,4,0,0,40,0.0,0.0,1.0,40,1250,1000,250,0.8,15,10,5,320.4352273593995,0.42545405982905987,0.1934295215618964,0.1841613556994034,130598.60365689441,369.6786511234143,130968.28230801782,1402,1,223.175,37,3,17,36.27440463419867,0.6244369369369369,44.46271929824561,1022.1491228070174,27.62565196775723,0
4102,4,0,0,40,0.0,0.0,1.0,40,1150,900,250,0.782608695652174,14,9,5,318.3254312437299,0.4253205128205128,0.18246140651801102,0.18374626377732114,130766.77439212051,325.27797014464943,131092.05236226515,1403,2,224.175,37,3,18,36.15860849056605,0.6261261261261262,44.29824561403508,1022.8070175438585,27.64343290659077,0
4103,4,0,0,40,0.0,0.0,1.0,40,1100,800,300,0.7272727272727273,14,8,6,321.717014622198,0.42513354700854705,0.186626660951565,0.18624461417210605,130878.94833025528,421.1969067405173,131300.1452369958,1404,3,225.175,37,3,18,35.95870838691241,0.6272522522522522,44.18859649122806,1023.2456140350863,27.655286865813142,0
4104,4,0,1,39,0.0,0.025,0.975,40,750,300,450,0.4,12,3,9,321.4838713689597,0.42541399572649574,0.098665835411472,0.18075579419370802,129744.38707325309,342.1455689404247,130086.53264219352,1405,4,226.175,40,0,16,37.111596009975074,0.6106770833333333,45.29979674796747,1018.800813008128,25.4700203252032,8
4105,4,0,0,39,0.0,0.0,1.0,39,1500,1300,200,0.8666666666666667,17,13,4,337.54654921570824,0.4251293297345929,0.13306451612903136,0.17439905042811638,126355.00365230136,741.8121410707588,127096.81579337211,1406,5,232.7948717948718,36,3,18,40.16437051971323,0.5833333333333333,48.64864864864867,1005.4054054054087,27.92792792792802,8
4106,4,4,2,41,0.09302325581395349,0.046511627906976744,0.9534883720930233,43,1600,1500,100,0.9375,17,15,2,309.8536828312552,0.43701550387596905,0.14256155021916772,0.16401398220021324,127340.90206842516,-702.16093234548,126638.74113607968,1407,0,212.04651162790697,37,6,15,39.85141680246242,0.5914977477477478,47.66995614035089,1009.3201754385987,27.278923660502667,0
4107,4,1,1,41,0.023809523809523808,0.023809523809523808,0.9761904761904762,42,1650,1200,450,0.7272727272727273,21,12,9,312.27681755538816,0.4324549941927991,0.14325526084483764,0.1658632923693846,127479.27847991708,-438.23532240687047,127041.04315751021,1408,0,218.07142857142858,37,5,16,39.6489323199421,0.5929054054054055,47.53289473684212,1009.868421052633,27.29374110953062,0
4108,4,0,0,41,0.0,0.0,1.0,41,1300,1100,200,0.8461538461538461,15,11,4,296.15603574168915,0.4304878048780488,0.1061764348986769,0.15263426457456333,126253.12500000042,-721.8749999999584,125531.25000000047,1409,2,224.390243902439,39,2,16,41.309079601990035,0.5769230769230769,48.75000000000002,1005.0000000000035,25.76923076923086,8
4109,4,0,0,41,0.0,0.0,1.0,41,1300,900,400,0.6923076923076923,17,9,8,296.8725784529213,0.43089430894308944,0.1031292475758816,0.15359098994557913,126410.20507812515,-694.4552951388753,125715.74978298627,1410,3,225.390243902439,39,2,11,41.13018783233203,0.578525641025641,48.59375000000001,1005.6250000000011,25.78525641025644,0
4110,4,1,1,41,0.023809523809523808,0.023809523809523808,0.9761904761904762,42,800,500,300,0.625,11,5,6,288.958431703913,0.433894696089818,0.10491815100598534,0.15040111750011875,126656.87715852025,-1080.285482351756,125576.5916761685,1411,0,221.0,40,2,12,41.07689718997139,0.5794270833333333,48.34857723577237,1006.6056910569122,25.165142276422806,0
4111,4,3,0,44,0.06818181818181818,0.0,1.0,44,1500,1200,300,0.8,18,12,6,280.32830702007743,0.4407813601127555,0.1248515698669368,0.1480110716375783,127238.61621897714,-1666.2828255513577,125572.33339342578,1412,0,211.6590909090909,42,2,15,40.700633883980025,0.5823412698412698,47.77131782945736,1008.9147286821699,24.02177925433738,0
4112,4,2,1,45,0.043478260869565216,0.021739130434782608,0.9782608695652174,46,1400,800,600,0.5714285714285714,20,8,12,277.38641672429804,0.44348832528180354,0.15439938212379012,0.14856974286640787,127816.61629801086,-2109.0813614540584,125707.53493655681,1413,0,203.41304347826087,44,2,14,40.18671977535633,0.5854640151515151,47.19907407407407,1011.2037037037028,22.981902356902335,0
4113,4,0,1,44,0.0,0.022222222222222223,0.9777777777777777,45,950,600,350,0.631578947368421,13,6,7,283.8967361198712,0.44132996632996635,0.15300130106687515,0.15175751918275535,127737.36230379067,-1747.1559522784755,125990.20635151218,1414,1,208.9111111111111,43,2,15,40.10275175644028,0.5859980620155039,47.27746212121212,1010.8901515151508,23.50907329105002,0
4114,4,4,1,47,0.08333333333333333,0.020833333333333332,0.9791666666666666,48,1200,700,500,0.5833333333333334,17,7,10,278.0025559602339,0.44611591312056736,0.18909802757739058,0.15153837682033403,128519.80559842197,-2452.9373043532046,126066.86829406876,1415,0,196.70833333333334,44,4,11,39.45739354092471,0.5925662878787878,46.504629629629605,1013.9814814814773,23.045033670033575,0
4115,4,0,2,45,0.0,0.0425531914893617,0.9574468085106383,47,1500,1100,400,0.7333333333333333,19,11,8,305.90040407451136,0.44385985198889916,0.20420693481044627,0.16477275197297572,128044.10450522786,-1532.2942911732791,126511.81021405458,1416,1,201.89361702127658,41,6,17,39.23413709730116,0.5919715447154472,46.97420634920634,1012.1031746031733,24.68544328300423,8
4116,4,0,0,45,0.0,0.0,1.0,45,1600,1200,400,0.75,20,12,8,315.75113404243666,0.4395833333333334,0.21339098802292522,0.16972278721384532,127960.02739800338,-919.2952473958389,127040.73215060754,1417,2,211.75555555555556,39,6,19,39.07059696626516,0.594284188034188,47.057291666666664,1011.7708333333326,25.94284188034186,0
4117,4,1,0,46,0.021739130434782608,0.0,1.0,46,1400,800,600,0.5714285714285714,20,8,12,312.77357396488594,0.44245169082125607,0.22898282505878487,0.16956721183848839,128302.78320312512,-1173.9230685763737,127128.86013454874,1418,0,208.1304347826087,39,7,20,38.796781821920625,0.5977564102564102,46.71875000000001,1013.1250000000009,25.977564102564127,0
4118,4,0,0,46,0.0,0.0,1.0,46,1350,800,550,0.5925925925925926,19,8,11,335.73315676710723,0.4417673107890499,0.19411676968497882,0.17540597346962536,126810.36962332248,-670.2562584172251,126140.11336490525,1419,1,209.1304347826087,40,6,21,39.74224767093802,0.5809895833333334,48.1961382113821,1007.2154471544693,25.18038617886173,8
4119,4,2,0,48,0.041666666666666664,0.0,1.0,48,1600,900,700,0.5625,23,9,14,321.85662172975185,0.4449985224586288,0.19663058073178918,0.17018297410950117,127297.04231112418,-1405.0959663560275,125891.94634476816,1420,0,201.375,40,8,23,39.59340382678751,0.5859375,47.71341463414633,1009.1463414634134,25.228658536585336,0
4120,4,2,3,47,0.04,0.06,0.94,50,1250,800,450,0.64,17,8,9,315.9212693683101,0.44837585034013605,0.21074829931972827,0.1693513245196224,127850.36886492677,-1921.8698357971457,125928.49902912963,1421,0,194.28,42,8,20,39.17812430136375,0.5885416666666667,47.165697674418595,1011.3372093023238,24.079457364341042,0
4121,4,1,2,46,0.020833333333333332,0.041666666666666664,0.9583333333333334,48,1150,800,350,0.6956521739130435,15,8,7,278.253781225229,0.4462821365248227,0.04449230059495379,0.15287178111676597,128832.22467287137,-2385.3010824169123,126446.92359045445,1422,0,202.47916666666666,42,6,12,39.13453278610289,0.5984623015873016,46.196705426356594,1015.2131782945748,24.17174234034702,8
4122,4,2,1,47,0.041666666666666664,0.020833333333333332,0.9791666666666666,48,1400,1100,300,0.7857142857142857,17,11,6,278.3583439128101,0.4454602541371158,0.07122656498252367,0.15416995922098112,129152.13647767597,-2409.8850354545602,126742.25144222142,1423,0,203.41666666666666,42,6,15,38.80819034000637,0.6016865079365079,45.881782945736454,1016.4728682170571,24.20173495754898,0
4123,4,0,1,46,0.0,0.02127659574468085,0.9787234042553191,47,1450,800,650,0.5517241379310345,21,8,13,281.41522143481797,0.4429155103299414,0.0634510872259133,0.15558303664178455,129081.07284672039,-2134.9242603592425,126946.14858636115,1424,1,208.70212765957447,43,4,16,38.80239881340664,0.5995639534883721,45.95170454545456,1016.1931818181846,23.632399577167085,0
4124,4,0,0,46,0.0,0.0,1.0,46,1550,1300,250,0.8387096774193549,18,13,5,291.7233666925903,0.44226046698872784,0.0575681692861969,0.16127058231445446,129078.27546609315,-1668.9701828315235,127409.30528326162,1425,2,214.15217391304347,42,4,18,38.543355265249055,0.6009424603174602,45.9544573643411,1016.1821705426386,24.194813584348537,0
4125,4,0,0,46,0.0,0.0,1.0,46,1450,1100,350,0.7586206896551724,18,11,7,294.9475947325986,0.44200885668276974,0.053278688524589946,0.16356184798807777,129201.38888888923,-1578.472222222187,127622.91666666704,1426,3,215.15217391304347,42,4,20,38.33674863387981,0.6021825396825398,45.83333333333335,1016.6666666666694,24.20634920634927,0
4126,4,1,1,46,0.02127659574468085,0.02127659574468085,0.9787234042553191,47,950,800,150,0.8421052631578947,11,8,3,314.374589189376,0.4443802035152637,0.07369435279690628,0.16933735791499557,128044.10450522805,-1240.7305051650299,126803.37400006302,1427,0,211.5531914893617,41,6,17,39.0197183558779,0.5919715447154472,46.97420634920635,1012.1031746031749,24.685443283004265,8
4127,4,1,3,44,0.02127659574468085,0.06382978723404255,0.9361702127659575,47,1450,900,550,0.6206896551724138,20,9,11,310.463142557715,0.44503546099290775,0.08534797314183873,0.16870699278561796,128395.77034517522,-1427.5691295036388,126968.20121567158,1428,0,211.31914893617022,41,6,16,38.76068585225791,0.5955284552845528,46.626984126984134,1013.4920634920644,24.71931862175767,0
4128,4,1,0,45,0.022222222222222223,0.0,1.0,45,1500,1000,500,0.6666666666666666,20,10,10,323.5691014465936,0.44168771043771043,0.08799771493858954,0.1753041510622912,128276.40109592033,-698.7440321180305,127577.6570638023,1429,0,220.88888888888889,39,6,20,38.55023564695802,0.5974893162393162,46.74479166666668,1013.020833333335,25.974893162393204,0
4129,4,2,1,46,0.0425531914893617,0.02127659574468085,0.9787234042553191,47,950,800,150,0.8421052631578947,11,8,3,311.5683966457136,0.44347440641381436,0.10582996187094396,0.17124548717895985,128848.62075617282,-1370.9683641975266,127477.6523919753,1430,0,212.4468085106383,41,6,19,38.27234382124944,0.6001016260162602,46.18055555555556,1015.2777777777776,24.76287262872628,0
4130,4,1,0,47,0.02127659574468085,0.0,1.0,47,1400,500,900,0.35714285714285715,23,5,18,301.66621875839814,0.44411039161270427,0.10987094523892549,0.16728763040238456,129201.38888888895,-1604.8611111111068,127596.52777777784,1431,0,212.27659574468086,42,5,20,38.16598360655738,0.6021825396825398,45.833333333333336,1016.6666666666672,24.20634920634922,0
4131,4,2,4,45,0.04081632653061224,0.08163265306122448,0.9183673469387755,49,950,700,250,0.7368421052631579,12,7,5,292.2150106744598,0.4469954648526077,0.11981028090450585,0.16380125827715136,129625.34722222232,-2224.3055555555447,127401.04166666677,1432,0,204.57142857142858,44,5,13,37.977359519912696,0.6036931818181819,45.41666666666667,1018.3333333333342,23.143939393939412,0
4132,4,0,0,45,0.0,0.0,1.0,45,1250,800,450,0.64,17,8,9,305.23729676418145,0.4423190235690236,0.11328848591206042,0.17024572881512803,129428.42306193287,-1098.723604024966,128329.6994579079,1433,2,219.64444444444445,41,4,16,37.84519108901238,0.6059451219512195,45.61011904761904,1017.5595238095219,24.81852497096395,0
4133,4,0,3,42,0.0,0.06666666666666667,0.9333333333333333,45,900,500,400,0.5555555555555556,13,5,8,304.56018870352955,0.441813973063973,0.10966659086725405,0.1703047463916571,129529.39111118948,-1110.100840104595,128419.29027108489,1434,3,220.64444444444445,41,4,16,37.76018825325668,0.6069613821138211,45.51091269841268,1017.9563492063463,24.82820363917918,0
4134,4,0,1,41,0.0,0.023809523809523808,0.9761904761904762,42,1500,1000,500,0.6666666666666666,20,10,10,322.8394411071899,0.4380202284165699,0.11189250313974464,0.179152359242981,129228.5448740776,-55.98575955147976,129172.55911452613,1435,5,236.57142857142858,38,4,19,37.6002591853175,0.6088267543859649,45.806623931623925,1016.7735042735034,26.75719748088167,0
4135,4,1,1,41,0.023809523809523808,0.023809523809523808,0.9761904761904762,42,1100,700,400,0.6363636363636364,15,7,8,318.17029133477763,0.4393873403019744,0.1206722453835618,0.1776606210583287,129473.07715136219,-161.10266454820143,129311.97448681398,1436,0,236.61904761904762,38,4,16,37.470912940023794,0.6112938596491229,45.566239316239304,1017.735042735041,26.78250112460634,0
4136,4,1,1,41,0.023809523809523808,0.023809523809523808,0.9761904761904762,42,950,600,350,0.631578947368421,13,6,7,322.3229558469353,0.4367257065427797,0.13716323533818797,0.180979214431371,129690.63321827735,-39.5463510848283,129651.08686719251,1437,0,237.5952380952381,38,4,17,37.14469267883364,0.6134868421052632,45.352564102564095,1018.5897435897427,26.80499325236165,0
4137,4,0,0,41,0.0,0.0,1.0,41,1050,600,450,0.5714285714285714,15,6,9,329.2989778154891,0.4377794715447154,0.13539695495954196,0.18535284075344294,129787.30384589494,347.7652979763054,130135.06914387125,1438,1,240.65853658536585,37,4,18,36.86903673015531,0.6162725225225225,45.25767543859649,1018.9692982456145,27.539710763394986,0
4138,4,0,1,40,0.0,0.024390243902439025,0.975609756097561,41,1200,900,300,0.75,15,9,6,329.8931526450034,0.4373983739837399,0.1428676377985807,0.1860853608609192,129871.11418898108,368.71825946443226,130239.83244844551,1439,2,241.65853658536585,37,4,19,36.76895080321283,0.6171171171171171,45.17543859649122,1019.298245614034,27.54860123281173,0
4139,4,0,0,40,0.0,0.0,1.0,40,1000,800,200,0.8,12,8,4,337.26223624514483,0.43643162393162394,0.14650436608820594,0.18963402432006388,129745.78622118752,751.6708008684483,130497.45702205597,1440,3,247.075,36,4,20,36.7083010942854,0.6177662037037037,45.29842342342343,1018.8063063063072,28.300175175175198,0
4140,4,1,0,41,0.024390243902439025,0.0,1.0,41,1450,1000,450,0.6896551724137931,19,10,9,327.4979277037542,0.43795731707317076,0.14149592796723476,0.18552897219855793,130038.81602993226,317.4885541705079,130356.30458410276,1441,0,242.02439024390245,37,4,22,36.660126854439895,0.6188063063063063,45.0109649122807,1019.956140350877,27.566382171645326,0
4141,4,1,0,42,0.023809523809523808,0.0,1.0,42,900,500,400,0.5555555555555556,13,5,8,330.56199223027266,0.43759678668215257,0.16012741326548863,0.1898440129130235,130570.58572108728,232.52695540935986,130803.11267649663,1442,0,237.23809523809524,37,5,15,36.04394646497157,0.6241554054054055,44.49013157894737,1022.0394736842107,27.62268847795164,0
4142,4,1,0,43,0.023255813953488372,0.0,1.0,43,1250,1100,150,0.88,14,11,3,322.02414836309265,0.4376845699520118,0.1628756881190636,0.18634593769627444,130863.12601587061,-171.78265852142442,130691.3433573492,1443,0,232.69767441860466,38,5,16,35.96681285023145,0.6252741228070176,44.20405982905984,1023.1837606837623,26.92588843904638,0
4143,4,0,1,42,0.0,0.023255813953488372,0.9767441860465116,43,1300,700,600,0.5384615384615384,19,7,12,322.6384474019657,0.4371308600959764,0.16427604083237446,0.18736494563670533,130999.80481591077,-146.8852728467872,130852.91954306398,1444,1,233.69767441860466,38,5,17,35.81324358171573,0.6266447368421053,44.07051282051283,1023.7179487179502,26.939946018893426,0
4144,4,0,2,40,0.0,0.047619047619047616,0.9523809523809523,42,1450,900,550,0.6206896551724138,20,9,11,330.21110030183377,0.43480207123499803,0.16419771979493403,0.1915799018842525,130963.11034404837,249.09455313175027,131212.2048971801,1445,2,240.1904761904762,37,5,17,35.65646759507229,0.6280968468468469,44.106359649122815,1023.5745614035104,27.66417733523001,0
4145,4,0,0,40,0.0,0.0,1.0,40,1550,1200,350,0.7741935483870968,19,12,7,339.49504931802556,0.43051549145299145,0.17962993511492353,0.19750662082206072,131068.54056336754,899.4241285204268,131967.96469188796,1446,3,249.975,36,4,18,35.31241981011034,0.6310763888888888,44.003378378378386,1023.9864864864875,28.444069069069098,0
4146,4,0,1,39,0.0,0.025,0.975,40,1500,1200,300,0.8,18,12,6,337.76013641737285,0.429821047008547,0.18108308605341228,0.1973846808774361,131241.5683208549,865.6340039363981,132107.2023247913,1447,4,250.975,36,4,20,35.182208667619165,0.6328125,43.834459459459474,1024.6621621621641,28.462837837837892,0
4147,4,1,0,40,0.025,0.0,1.0,40,1550,1100,450,0.7096774193548387,20,11,9,336.7945505584201,0.42994123931623934,0.19099188000451095,0.19895784675559694,131654.57182623885,868.1370030370373,132522.70882927589,1448,0,250.225,35,5,15,34.79063287094471,0.6389880952380953,43.43171296296296,1026.273148148148,29.322089947089943,0
4148,4,0,0,40,0.0,0.0,1.0,40,1300,800,500,0.6153846153846154,18,8,10,338.7897956754614,0.4289529914529915,0.1926225352112676,0.20139045121364482,131892.24222232925,936.7491587362665,132828.9913810655,1449,1,251.225,35,5,15,34.50011737089203,0.6413690476190477,43.200231481481474,1027.199074074073,29.348544973544943,0
4149,4,0,0,40,0.0,0.0,1.0,40,1200,800,400,0.6666666666666666,16,8,8,340.2168035038429,0.429286858974359,0.1977953598378197,0.2028734048563209,132011.15779588892,982.4828264317414,132993.64062232067,1450,2,252.225,35,5,16,34.34379340766602,0.6425595238095239,43.08449074074073,1027.662037037036,29.36177248677246,0
4150,4,0,0,40,0.0,0.0,1.0,40,900,400,500,0.4444444444444444,14,4,10,339.72278254173864,0.4290598290598291,0.19977198513680916,0.20289697590808203,132070.63567654742,973.4807688185795,133044.116445366,1451,3,253.225,35,5,17,34.29664921367713,0.643154761904762,43.02662037037037,1027.893518518518,29.36838624338623,0
4151,4,1,0,41,0.024390243902439025,0.0,1.0,41,1400,1000,400,0.7142857142857143,18,10,8,332.1112382630513,0.4296493902439025,0.19163686822863846,0.20023065420344915,132426.97934420907,596.097617888157,133023.07696209723,1452,0,248.02439024390245,36,5,18,34.13429978118162,0.6446759259259259,42.68018018018018,1029.2792792792793,28.59109109109109,0
4152,4,0,0,41,0.0,0.0,1.0,41,1600,1300,300,0.8125,19,13,6,329.0098381551585,0.42980182926829263,0.18882769472856054,0.19912607345657984,132571.90626014516,523.4922845142315,133095.3985446594,1453,1,249.02439024390245,36,5,19,34.06870785492984,0.6461226851851851,42.53941441441441,1029.8423423423415,28.606731731731706,0
4153,4,0,0,41,0.0,0.0,1.0,41,1150,700,450,0.6086956521739131,16,7,9,331.2476335513152,0.42891260162601624,0.19726509396241476,0.2012560323369545,132716.91243608482,592.4326353380484,133309.34507142287,1454,2,250.02439024390245,36,5,14,33.86566484517303,0.6475694444444444,42.39864864864865,1030.405405405406,28.622372372372393,0
4154,4,0,0,41,0.0,0.0,1.0,41,1300,1100,200,0.8461538461538461,15,11,4,333.63527394481196,0.42881097560975606,0.18719174115059545,0.19062878563290234,130371.67302441734,499.31776882897907,130870.99079324631,1455,3,251.02439024390245,38,3,20,36.166614359940006,0.6203399122807017,44.684829059829056,1021.260683760683,26.875281151596923,8
4155,4,0,0,41,0.0,0.0,1.0,41,1000,700,300,0.7,13,7,6,332.5549186967094,0.42873475609756095,0.18641278976329145,0.1902787299616542,130426.23325525982,474.77707922420757,130901.01033448403,1456,4,252.02439024390245,38,3,20,36.13900219642297,0.6208881578947368,44.63141025641026,1021.47435897436,26.88090418353579,0
4156,4,0,0,41,0.0,0.0,1.0,41,1300,700,600,0.5384615384615384,19,7,12,335.6084476666266,0.42804878048780487,0.19305778889990388,0.1933840128005588,130699.2056235846,572.7515021184881,131271.95712570308,1457,5,253.02439024390245,38,3,15,35.784966739804275,0.6236293859649122,44.36431623931624,1022.5427350427348,26.90901934322986,0
4157,4,0,1,40,0.0,0.024390243902439025,0.975609756097561,41,1200,800,400,0.6666666666666666,16,8,8,329.12808599752293,0.42761686991869924,0.18943819423577346,0.19059182634125005,130890.45606874133,415.94505624954036,131306.40112499087,1458,6,254.02439024390245,38,3,15,35.75750852648431,0.6255482456140351,44.177350427350426,1023.2905982905984,26.928699955015748,0
4158,4,0,1,39,0.0,0.025,0.975,40,1550,1200,350,0.7741935483870968,19,12,7,336.13061164471924,0.42570779914529916,0.19578242229367615,0.1943059855418358,130822.85534972294,794.7132771621957,131617.56862688513,1459,11,261.225,37,3,15,35.64665952125759,0.6266891891891893,44.243421052631575,1023.0263157894732,27.649359886201978,0
4159,4,0,0,39,0.0,0.0,1.0,39,950,700,250,0.7368421052631579,12,7,5,341.66939742244284,0.42451079622132254,0.1978171183873827,0.19736432251108182,130794.81336805565,1137.7170138888941,131932.53038194455,1460,12,267.79487179487177,37,2,15,35.53335030549897,0.6264076576576576,44.270833333333336,1022.9166666666674,27.646396396396415,0
4160,4,0,0,39,0.0,0.0,1.0,39,1350,1000,350,0.7407407407407407,17,10,7,344.7036267628066,0.4240328385065227,0.1344758310168852,0.1941022475778865,129803.15778193728,1149.8089199841606,130952.96670192144,1461,13,268.79487179487177,36,3,19,36.460520499502685,0.6183449074074074,45.24211711711711,1019.031531531531,28.306431431431417,8
4161,4,0,0,39,0.0,0.0,1.0,39,900,600,300,0.6666666666666666,12,6,6,344.74832527168627,0.42338618983355825,0.1391544779015783,0.19441227987750972,129860.5420242878,1153.8408763493283,131014.38290063714,1462,14,269.79487179487177,36,3,21,36.40113431296727,0.6189236111111112,45.185810810810814,1019.2567567567568,28.31268768768769,0
4162,4,0,0,39,0.0,0.0,1.0,39,1150,800,350,0.6956521739130435,15,8,7,340.6078957027798,0.4239766081871345,0.14074539576858003,0.19306797992964816,130061.48674011849,1059.9938621053493,131121.48060222383,1463,15,270.79487179487177,36,3,21,36.30285383086773,0.6209490740740741,44.98873873873874,1020.045045045045,28.334584584584583,0
4163,4,0,0,39,0.0,0.0,1.0,39,1200,800,400,0.6666666666666666,16,8,8,344.1351448832232,0.423836032388664,0.13570733473646102,0.19593222067974478,130233.84871357857,1163.6088791494335,131397.457592728,1464,16,271.79487179487177,36,3,22,36.03817299205649,0.6226851851851851,44.81981981981983,1020.7207207207217,28.35335335335338,0
4164,4,1,1,39,0.025,0.025,0.975,40,750,300,450,0.4,12,3,9,361.32285295187665,0.4269230769230769,0.13807929969104027,0.19383673492611672,127880.99500868017,1250.4213065472088,129131.41631522738,1465,0,265.975,35,5,17,37.99884140061791,0.6008928571428571,47.13541666666664,1011.4583333333301,28.89880952380943,8
4165,4,2,1,40,0.04878048780487805,0.024390243902439025,0.975609756097561,41,800,400,400,0.5,12,4,8,360.3402669943342,0.4285823170731707,0.1764514324362696,0.19673905044681272,128584.36113522347,1067.0958719135497,129651.45700713703,1466,0,259.1707317073171,35,6,17,37.30421944539542,0.6080357142857142,46.44097222222221,1014.2361111111087,28.978174603174534,0
4166,4,1,1,40,0.024390243902439025,0.024390243902439025,0.975609756097561,41,900,500,400,0.5555555555555556,13,5,8,360.36180541074975,0.43056402439024394,0.18013825962084384,0.19689593906607272,128613.70991940991,1069.4937414265846,129683.2036608365,1467,0,260.1463414634146,35,6,18,37.27369542066028,0.6083333333333334,46.412037037037024,1014.3518518518499,28.981481481481428,0
4167,4,0,0,40,0.0,0.0,1.0,40,1150,800,350,0.6956521739130435,15,8,7,368.11427267368845,0.4305555555555556,0.1783278553820875,0.20089465015420532,128566.7534722219,1465.45138888885,130032.20486111075,1468,1,254.675,34,6,19,37.12510271158586,0.6099877450980392,46.458333333333314,1014.166666666664,29.82843137254894,0
4168,4,0,0,40,0.0,0.0,1.0,40,1550,1200,350,0.7741935483870968,19,12,7,370.92157022190486,0.4296207264957265,0.183911181508859,0.20304203872840654,128687.51594387728,1546.5950963718553,130234.11104024913,1469,2,255.675,34,6,20,36.93046266963903,0.6112132352941176,46.3392857142857,1014.642857142855,29.84243697478985,0
4169,4,0,1,39,0.0,0.025,0.975,40,700,400,300,0.5714285714285714,10,4,6,369.52152579196104,0.42922008547008544,0.18107482115632667,0.20289182552659693,128808.3351048752,1519.490504535132,130327.82560941033,1470,3,256.675,34,6,20,36.84252961182126,0.6124387254901961,46.22023809523809,1015.1190476190468,29.856442577030787,0
4170,4,1,0,40,0.025,0.0,1.0,40,1000,800,200,0.8,12,8,4,370.2150575006009,0.4293002136752137,0.19664694857678366,0.20482993816478468,129110.63102324256,1559.7399376417154,130670.37096088428,1471,0,256.575,34,6,21,36.516291827730264,0.6155024509803921,45.922619047619044,1016.3095238095232,29.891456582633033,0
4171,4,1,1,40,0.024390243902439025,0.024390243902439025,0.975609756097561,41,800,600,200,0.75,10,6,4,358.5352138459378,0.43191056910569103,0.18054144743599965,0.20004954360020083,129443.56575963719,1082.0471938775497,130525.61295351473,1472,0,251.29268292682926,34,7,16,36.473931523943214,0.6188725490196079,45.595238095238095,1017.6190476190477,29.929971988795522,0
4172,4,0,0,40,0.0,0.0,1.0,40,1000,700,300,0.7,13,7,6,363.1447597324051,0.4293135683760683,0.18646869514335895,0.20215452585755042,129352.72285997719,1394.75269274375,130747.47555272093,1473,2,258.575,34,6,21,36.44919055978155,0.617953431372549,45.6845238095238,1017.2619047619037,29.919467787114815,0
4173,4,1,1,40,0.024390243902439025,0.024390243902439025,0.975609756097561,41,1250,900,350,0.72,16,9,7,357.9801705411251,0.43274898373983745,0.19522166150573628,0.20181647770711558,129849.38298396765,1096.7008530521118,130946.08383701976,1474,0,253.2439024390244,35,6,20,36.075308501779084,0.6208333333333333,45.19675925925925,1019.2129629629619,29.120370370370342,0
4174,4,0,0,40,0.0,0.0,1.0,40,1450,1100,350,0.7586206896551724,18,11,7,365.3766789384702,0.4321848290598291,0.19201692936368953,0.20656443928105597,129958.94451530614,1496.7935090702977,131455.73802437645,1475,1,258.2,34,6,20,35.775442693130955,0.6240808823529411,45.089285714285715,1019.6428571428573,29.989495798319332,0
4175,4,0,0,40,0.0,0.0,1.0,40,1200,1000,200,0.8333333333333334,14,10,4,368.8752189328892,0.43116987179487176,0.19452614379084987,0.20902929072863718,130050.0,1594.4444444444443,131644.44444444444,1476,2,259.2,34,6,20,35.59368191721134,0.625,45.0,1020.0,30.0,0
4176,4,1,1,40,0.024390243902439025,0.024390243902439025,0.975609756097561,41,1250,800,450,0.64,17,8,9,357.41535537962375,0.43089430894308944,0.1866326209149245,0.2045750925149518,130439.8750964505,1124.2428626543094,131564.1179591048,1477,0,253.85365853658536,35,6,21,35.49031271244052,0.6267857142857143,44.61805555555555,1021.5277777777768,29.18650793650791,0
4177,4,1,1,40,0.024390243902439025,0.024390243902439025,0.975609756097561,41,950,700,250,0.7368421052631579,12,7,5,373.24051842432044,0.4332063008130081,0.1921463080292214,0.2024378871305139,128320.37278163552,1393.4606481481123,129713.83342978364,1478,0,253.5121951219512,35,6,18,37.24725839616174,0.6053571428571429,46.70138888888887,1013.1944444444421,28.948412698412632,8
4178,4,0,1,39,0.0,0.025,0.975,40,750,600,150,0.8,9,6,3,379.25568576917925,0.43433493589743594,0.1869962401597931,0.20572626778721997,128325.39859693863,1733.6274092970345,130059.02600623567,1479,1,255.775,34,6,18,37.089746602436065,0.6075367647058824,46.69642857142856,1013.2142857142845,29.80042016806719,0
4179,4,4,3,40,0.09302325581395349,0.06976744186046512,0.9302325581395349,43,1600,1100,500,0.6875,21,11,10,357.51969250821685,0.4408222591362126,0.18779457772767727,0.1984129755498818,129231.6485969388,649.5110544217723,129881.15965136058,1480,0,238.7906976744186,34,9,20,36.715548530617035,0.6167279411764706,45.80357142857143,1016.7857142857146,29.905462184873958,0
4180,4,1,0,41,0.024390243902439025,0.0,1.0,41,1150,900,250,0.782608695652174,14,9,5,360.95640689789775,0.4378302845528455,0.20448743939558311,0.20047396799231768,129261.91184807263,1131.583049886625,130393.49489795926,1481,0,250.1951219512195,34,7,21,36.59735229844688,0.6170343137254901,45.773809523809526,1016.9047619047624,29.908963585434186,0
4181,4,0,0,41,0.0,0.0,1.0,41,1200,1000,200,0.8333333333333334,14,10,4,363.3537681459078,0.4372713414634146,0.2098432154836849,0.20255186910403775,129407.39300679442,1204.1327749914294,130611.52578178585,1482,1,251.1951219512195,35,6,21,36.3881858339969,0.6163690476190475,45.63078703703704,1017.476851851852,29.0707671957672,0
4182,4,0,0,41,0.0,0.0,1.0,41,850,300,550,0.35294117647058826,14,3,11,368.05145833992475,0.4364837398373984,0.21655076032342846,0.2059402434833322,129554.63927469155,1336.5547839506387,130891.19405864218,1483,2,252.1951219512195,35,6,18,36.11869031377899,0.6178571428571429,45.48611111111112,1018.0555555555571,29.08730158730163,0
4183,4,1,0,42,0.023809523809523808,0.0,1.0,42,850,500,350,0.5882352941176471,12,5,7,361.77993765800227,0.43777826171118855,0.21233971830393306,0.20446663892356787,129946.64216581466,1002.4176203230465,130949.0597861377,1484,0,247.16666666666666,36,6,19,35.879629629629626,0.6197916666666667,45.10135135135136,1019.5945945945962,28.322072072072118,0
4184,4,0,1,41,0.0,0.023809523809523808,0.9761904761904762,42,1250,1000,250,0.8,15,10,5,360.2967671210005,0.43740321331784743,0.2068941950814327,0.20422829265219206,130061.48674011877,972.1466398831558,131033.63338000192,1485,1,248.16666666666666,36,6,20,35.80076543755061,0.6209490740740741,44.98873873873875,1020.0450450450472,28.334584584584647,0
4185,4,1,0,42,0.023809523809523808,0.0,1.0,42,1150,700,450,0.6086956521739131,16,7,9,361.57151633491145,0.43707655826558267,0.20845352374647286,0.20570763669449543,130205.11379200188,1015.6920856667957,131220.80587766867,1486,0,248.71428571428572,36,6,22,35.622402442164116,0.6223958333333333,44.847972972973,1020.6081081081115,28.35022522522532,0
4186,4,1,0,43,0.023255813953488372,0.0,1.0,43,1350,1000,350,0.7407407407407407,17,10,7,352.5178684151056,0.43830749354005166,0.206687922405145,0.20285279033945472,130646.86381440761,611.0961525957584,131257.95996700338,1487,0,243.90697674418604,35,8,18,35.405699271670635,0.6288690476190476,44.41550925925926,1022.3379629629633,29.209656084656093,0
4187,4,0,1,42,0.0,0.023255813953488372,0.9767441860465116,43,1550,1000,550,0.6451612903225806,21,10,11,351.8884107910445,0.43789221114802507,0.21006813319262774,0.20311155363556246,130765.21675936645,602.952862439987,131368.16962180645,1488,1,244.90697674418604,35,8,18,35.30197370902643,0.6300595238095238,44.29976851851852,1022.8009259259262,29.222883597883605,0
4188,4,1,0,43,0.023255813953488372,0.0,1.0,43,1450,1100,350,0.7586206896551724,18,11,7,349.5181421332453,0.43747692875599853,0.21906516233018647,0.20288122043366533,130982.06948502557,556.121915834754,131538.19140086032,1489,0,245.8372093023256,36,7,19,35.14324349101577,0.6302083333333333,44.08783783783784,1023.6486486486486,28.434684684684683,0
4189,4,0,2,41,0.0,0.046511627906976744,0.9534883720930233,43,1150,700,450,0.6086956521739131,16,7,9,348.6623542770238,0.43736157253599117,0.22095452395259318,0.20314440180330134,131126.2038009294,543.7541849281782,131669.95798585756,1490,1,246.8372093023256,36,7,19,35.019470404984425,0.6316550925925926,43.947072072072075,1024.2117117117123,28.45032532532534,0
4190,4,0,0,41,0.0,0.0,1.0,41,850,600,250,0.7058823529411765,11,6,5,365.4788224704564,0.4324695121951219,0.2345636083652083,0.2111177668623458,130794.81336805545,1360.5468749999907,132155.36024305545,1491,2,259.5121951219512,35,6,19,34.9244738628649,0.6303571428571428,44.27083333333333,1022.9166666666657,29.22619047619045,0
4191,4,1,0,42,0.023809523809523808,0.0,1.0,42,1100,700,400,0.6363636363636364,15,7,8,350.25084721245645,0.43470528455284557,0.22965091929471915,0.20422318629772457,131155.04017531042,787.4327875172478,131942.47296282768,1492,0,254.3095238095238,36,6,20,34.94965735854589,0.6319444444444444,43.91891891891892,1024.3243243243242,28.45345345345345,0
4192,4,0,0,42,0.0,0.0,1.0,42,1000,600,400,0.6,14,6,8,349.51346805620875,0.43475367789392183,0.22731460397724024,0.20394637709476165,131183.8797200918,770.1065508075754,131953.98627089936,1493,1,255.3095238095238,36,6,20,34.939403099923055,0.6322337962962963,43.89076576576577,1024.4369369369376,28.456581581581602,0
4193,4,0,0,42,0.0,0.0,1.0,42,1150,800,350,0.6956521739130435,15,8,7,349.7197778608295,0.43403987611304684,0.2318760984182775,0.20514490062145554,131385.84530476414,789.6457268078791,132175.49103157202,1494,2,256.3095238095238,36,6,21,34.730155243116556,0.6342592592592593,43.69369369369369,1025.2252252252247,28.478478478478465,0
4194,4,0,0,42,0.0,0.0,1.0,42,1100,700,400,0.6363636363636364,15,7,8,350.66976254366364,0.4332534843205575,0.2391511159897548,0.20663658064506965,131559.0823086601,826.7584307280292,132385.8407393881,1495,3,257.3095238095238,36,6,17,34.530964141968525,0.6359953703703703,43.52477477477478,1025.9009009009014,28.497247247247262,0
4195,4,0,0,42,0.0,0.0,1.0,42,950,500,450,0.5263157894736842,14,5,9,351.53726880486374,0.43263646922183513,0.2369589635086069,0.20793395231384393,131703.53366457685,859.7401032789626,132563.2737678558,1496,4,258.3095238095238,36,6,17,34.36300054854635,0.6374421296296297,43.38400900900901,1026.4639639639647,28.51288788788791,0
4196,4,0,0,42,0.0,0.0,1.0,42,1200,900,300,0.75,15,9,6,353.11887473978027,0.43280584591560206,0.23497511736353704,0.20950494591750535,131819.15181651246,909.5661117198305,132728.71792823228,1497,5,259.3095238095238,36,6,17,34.20582483459443,0.638599537037037,43.2713963963964,1026.9144144144145,28.525400400400404,0
4197,4,0,0,42,0.0,0.0,1.0,42,1050,600,450,0.5714285714285714,15,6,9,353.8201658202526,0.43268486256291133,0.23380325814536373,0.2100807234557749,131848.06428049668,930.1007933609251,132778.1650738576,1498,6,260.3095238095238,36,6,17,34.15867141812866,0.6388888888888888,43.24324324324324,1027.0270270270266,28.52852852852852,0
4198,4,2,1,43,0.045454545454545456,0.022727272727272728,0.9772727272727273,44,1000,700,300,0.7,13,7,6,339.45811273746483,0.43417459478505993,0.23435774751564198,0.20450281425891187,132398.0034722223,191.0043066715402,132589.00777889384,1499,0,249.4318181818182,36,8,19,33.97435897435897,0.6443865740740741,42.708333333333336,1029.1666666666672,28.587962962962976,0
4199,4,0,0,43,0.0,0.0,1.0,43,1250,900,350,0.72,16,9,7,347.836101100935,0.43157069029162054,0.2411734234848273,0.2090804699955204,132313.381581352,604.6741545475522,132918.05573589954,1500,1,256.06976744186045,37,6,20,33.843897651781575,0.6416103603603603,42.790570175438596,1028.837719298246,27.80642484589854,0
4200,4,1,0,44,0.022727272727272728,0.0,1.0,44,1250,900,350,0.72,16,9,7,337.1413859409666,0.4317080690627202,0.23581934297740625,0.20448310657943058,132652.03145438977,144.52499807632498,132796.5564524661,1501,0,251.22727272727272,37,7,18,33.77893826503461,0.6449887387387387,42.46162280701754,1030.1535087719294,27.84198672356566,0
4201,4,0,0,44,0.0,0.0,1.0,44,1450,1200,250,0.8275862068965517,17,12,5,335.6215482118606,0.43152087737843553,0.23634429400386847,0.2043291809061844,132793.26331178815,113.65612496151647,132906.91943674965,1502,1,252.22727272727272,37,7,19,33.67641843971632,0.6463963963963963,42.32456140350877,1030.7017543859643,27.856804172593627,0
4202,4,0,0,44,0.0,0.0,1.0,44,1450,1200,250,0.8275862068965517,17,12,5,336.40250448747315,0.4310143587033122,0.2383232924930616,0.20495916686239385,132821.5187004656,136.2983081332786,132957.81700859885,1503,2,253.22727272727272,37,7,19,33.62796067794206,0.646677927927928,42.29714912280702,1030.8114035087724,27.859767662399253,0
4203,4,0,2,42,0.0,0.045454545454545456,0.9545454545454546,44,1200,900,300,0.75,15,9,6,336.9056689897451,0.4302325581395349,0.24031565925038167,0.20604256973456067,132962.84072983998,159.18696137273278,133122.02769121272,1504,3,254.22727272727272,37,7,19,33.47331490537954,0.6480855855855856,42.16008771929825,1031.3596491228072,27.874585111427223,0
4204,4,0,0,42,0.0,0.0,1.0,42,1050,900,150,0.8571428571428571,12,9,3,351.674788536801,0.4280512001548587,0.2417656500802572,0.21320882956250176,132636.34366426605,928.9716220850396,133565.3152863511,1505,4,265.8809523809524,35,7,19,33.42041198501872,0.6488095238095238,42.47685185185185,1030.0925925925922,29.43121693121692,0
4205,4,0,2,40,0.0,0.047619047619047616,0.9523809523809523,42,700,400,300,0.5714285714285714,10,4,6,352.70687368945175,0.42776084010840104,0.2450045741248983,0.21400435464961184,132666.15125868042,958.4526909722038,133624.6039496526,1506,5,266.8809523809524,35,7,19,33.36387765419615,0.6491071428571429,42.44791666666666,1030.2083333333321,29.434523809523775,0
4206,4,0,0,40,0.0,0.0,1.0,40,800,500,300,0.625,11,5,6,360.3244282584017,0.4260817307692308,0.2462806474648902,0.21780185944079775,132524.15687475956,1550.3382112648853,134074.49508602446,1507,6,266.675,33,7,22,33.31052130445133,0.6521464646464646,42.58578431372548,1029.6568627450968,31.20172311348778,0
4207,4,0,0,40,0.0,0.0,1.0,40,1250,1000,250,0.8,15,10,5,361.5172938432117,0.4261351495726496,0.24902427415516382,0.21888986581112047,132587.25610342182,1586.5172049211826,134173.773308343,1508,7,267.675,33,7,22,33.216325559257484,0.6527777777777778,42.52450980392157,1029.901960784314,31.209150326797396,0
4208,4,0,0,40,0.0,0.0,1.0,40,1350,800,550,0.5925925925925926,19,8,11,359.52914219704644,0.4250801282051282,0.24298287345385328,0.21841914939254098,132713.4996155325,1542.8741349480906,134256.3737504806,1509,8,268.675,33,7,21,33.14056057722804,0.654040404040404,42.40196078431372,1030.392156862745,31.224004753416516,0
4209,4,0,0,40,0.0,0.0,1.0,40,1100,500,600,0.45454545454545453,17,5,12,355.94787729969914,0.4238782051282051,0.24391813878305113,0.21725613567954127,132888.5363520406,1460.2784863945371,134348.81483843512,1510,9,269.675,34,6,21,33.05695069853366,0.6534926470588236,42.23214285714285,1031.0714285714268,30.32563025210079,0
4210,4,0,0,40,0.0,0.0,1.0,40,1350,1100,250,0.8148148148148148,16,11,5,358.6351429294738,0.4232905982905983,0.2508885298869148,0.21979718165677636,133042.0138888888,1542.7083333333244,134584.7222222221,1511,10,270.675,34,6,21,32.833535271944,0.6550245098039216,42.08333333333333,1031.6666666666658,30.343137254901936,0
4211,4,0,0,40,0.0,0.0,1.0,40,950,400,550,0.42105263157894735,15,4,11,359.05809487421834,0.4220753205128205,0.2551569506726461,0.22118772142804052,133233.1318587105,1567.68689986282,134800.81875857332,1512,11,271.675,35,5,21,32.63079222720477,0.6547619047619048,41.898148148148145,1032.407407407407,29.497354497354483,0
4212,4,0,0,40,0.0,0.0,1.0,40,1000,800,200,0.8,12,8,4,357.95325188899096,0.4215678418803419,0.2561428571428572,0.2213952025716732,133382.53821855705,1548.9426601080227,134931.48087866508,1513,12,272.675,35,5,21,32.50945378151261,0.65625,41.75347222222222,1032.9861111111109,29.513888888888882,0
4213,4,0,0,40,0.0,0.0,1.0,40,1150,800,350,0.6956521739130435,15,8,7,355.53938166488524,0.42095352564102567,0.2556863987101232,0.22098414108777387,133564.50007086183,1497.5180943326623,135062.0181651945,1514,13,273.675,34,6,23,32.38943913393988,0.6602328431372548,41.57738095238096,1033.6904761904775,30.40266106442581,0
4214,4,0,1,39,0.0,0.025,0.975,40,1150,800,350,0.6956521739130435,15,8,7,349.8603512465987,0.41980502136752135,0.25247062115276964,0.21814391056443558,133681.60211173285,1353.9784540037926,135035.58056573663,1515,14,274.675,35,5,23,32.41897500466331,0.6592261904761905,41.46412037037038,1034.1435185185198,29.54695767195771,0
4215,4,0,0,39,0.0,0.0,1.0,39,1800,1600,200,0.8888888888888888,20,16,4,353.5928030110327,0.41978744939271256,0.25465127260707376,0.22069068049998963,133718.3673469389,1656.3704648526257,135374.73781179154,1516,15,278.79487179487177,34,5,20,32.2856718078576,0.6617647058823529,41.42857142857144,1034.2857142857154,30.42016806722692,0
4216,4,1,0,40,0.025,0.0,1.0,40,1150,500,650,0.43478260869565216,18,5,13,367.2250970859095,0.42130074786324784,0.2741668543120923,0.2194948393214699,132100.37964034613,1777.4692560923236,133877.84889643846,1517,0,272.8,35,5,20,33.559915184267794,0.6434523809523809,42.99768518518517,1028.0092592592573,29.371693121693067,8
4217,4,0,0,40,0.0,0.0,1.0,40,1550,1000,550,0.6451612903225806,21,10,11,367.84549909127765,0.42160790598290593,0.27241136747327,0.2203848455445717,132189.63162562138,1725.0722040037522,133914.70382962513,1518,1,273.8,35,5,20,33.453972050272014,0.6443452380952381,42.91087962962962,1028.35648148148,29.381613756613714,0
4218,4,0,0,40,0.0,0.0,1.0,40,1300,900,400,0.6923076923076923,17,9,8,367.2279864304601,0.4216880341880342,0.2716925413432332,0.22070923403518297,132308.68115837176,1717.4901138117086,134026.17127218348,1519,2,274.8,35,5,20,33.34985656429294,0.6455357142857143,42.79513888888888,1028.8194444444432,29.394841269841233,0
4219,4,0,0,40,0.0,0.0,1.0,40,1050,800,250,0.7619047619047619,13,8,5,364.05734126927723,0.42069978632478633,0.2625210792580104,0.2198431806239116,132487.35592689033,1646.5989101080124,134133.95483699834,1520,3,275.8,35,5,21,33.25147554806071,0.6473214285714286,42.62152777777777,1029.513888888888,29.414682539682513,0
4220,4,0,0,40,0.0,0.0,1.0,40,1200,800,400,0.6666666666666666,16,8,8,359.6467822876509,0.42119391025641023,0.2661490508817259,0.21856213670354618,132725.77649444848,1546.8796885716483,134272.65618302012,1521,4,276.8,35,5,16,33.12518720281553,0.649702380952381,42.39004629629628,1030.439814814813,29.441137566137513,0
4221,4,0,0,40,0.0,0.0,1.0,40,1050,800,250,0.7619047619047619,13,8,5,361.3073273948693,0.4212473290598291,0.2684658134051874,0.2202713460031549,132845.06715374195,1599.5792341820588,134444.646387924,1522,5,277.8,35,5,16,32.962487369484684,0.6508928571428572,42.274305555555536,1030.902777777775,29.454365079365004,0
4222,4,0,0,40,0.0,0.0,1.0,40,1000,600,400,0.6,14,6,8,358.9780663621441,0.4209001068376068,0.2662897070378272,0.21920052044005048,132904.7325772674,1541.9767821930407,134446.70935946042,1523,6,278.8,35,5,16,32.96257062146892,0.6514880952380953,42.21643518518517,1031.134259259257,29.460978835978775,0
4223,4,0,0,40,0.0,0.0,1.0,40,1300,900,400,0.6923076923076923,17,9,8,380.14393106311024,0.4203659188034188,0.24293327712874868,0.21197683409113535,129419.51600646396,1896.283498790096,131315.79950525405,1524,7,279.8,33,7,20,35.94872837127143,0.6208964646464646,45.61887254901961,1017.5245098039225,30.834076054664315,8
4224,4,1,0,41,0.024390243902439025,0.0,1.0,41,1200,800,400,0.6666666666666666,16,8,8,370.81486169813064,0.42149390243902435,0.24602886737233876,0.20952585738927718,129937.87140185609,1436.5787626457459,131374.45016450185,1525,0,273.9512195121951,35,6,18,35.6582519771446,0.6217261904761905,45.1099537037037,1019.5601851851848,29.130291005290992,0
4225,4,0,0,41,0.0,0.0,1.0,41,1300,1100,200,0.8461538461538461,15,11,4,344.2096966707456,0.4213160569105691,0.1424331700812289,0.18693681715992977,128372.67324334457,637.8290101326498,129010.50225347723,1526,1,274.9512195121951,36,5,16,37.92921435715079,0.6038773148148149,46.64977477477477,1013.4009009008998,28.150025025024995,8
4226,4,0,2,39,0.0,0.04878048780487805,0.9512195121951219,41,800,500,300,0.625,11,5,6,343.6445360755946,0.4213668699186992,0.14695921231596287,0.18703072029942558,128458.27880245095,628.797124827518,129087.07592727846,1527,2,275.9512195121951,36,5,16,37.85617085092203,0.6047453703703703,46.56531531531531,1013.7387387387375,28.159409409409378,0
4227,4,0,0,39,0.0,0.0,1.0,39,1100,800,300,0.7272727272727273,14,8,6,347.361155666067,0.42189608636977055,0.14731769008596407,0.1890535141055581,128458.27880245085,1124.2832359386148,129582.56203838946,1528,3,279.7692307692308,36,3,17,37.76197881952159,0.6047453703703703,46.5653153153153,1013.7387387387367,28.159409409409353,0
4228,4,1,0,40,0.025,0.0,1.0,40,550,300,250,0.5454545454545454,8,3,5,340.00589187911396,0.4251869658119658,0.14958396369137672,0.18617837416859856,128700.23108071688,751.7673707294232,129451.9984514463,1529,0,273.75,37,3,19,37.70171457387796,0.6052927927927928,46.3267543859649,1014.6929824561382,27.42413466097671,0
4229,4,1,0,41,0.024390243902439025,0.0,1.0,41,1150,800,350,0.6956521739130435,15,8,7,332.00449800475735,0.42954776422764224,0.13787797183965522,0.18335440046604126,129038.51290269509,368.27333990789896,129406.78624260299,1530,0,268.0487804878049,38,3,21,37.56046267087277,0.606907894736842,45.993589743589716,1016.025641025637,26.73751686909571,0
4230,4,0,0,41,0.0,0.0,1.0,41,1450,1000,450,0.6896551724137931,19,10,9,325.8116495560356,0.4291666666666667,0.1415488640796536,0.17082343816711507,126953.84787867434,78.38699529874964,127032.23487397308,1531,1,269.0487804878049,37,4,22,39.84502502448048,0.5875563063063063,48.053728070175445,1007.7850877192993,27.237434803224307,8
4231,4,2,0,43,0.046511627906976744,0.0,1.0,43,950,600,350,0.631578947368421,13,6,7,310.40753313658917,0.43283960871170174,0.1477402137419599,0.16516056419844993,127550.2698905145,-681.4119311625061,126868.85795935198,1532,0,257.48837209302326,38,5,17,39.623655913978496,0.5918311403508771,47.46260683760685,1010.1495726495743,26.582883490778272,0
4232,4,1,0,44,0.022727272727272728,0.0,1.0,44,1250,600,650,0.48,19,6,13,306.1279685546129,0.4364979739252995,0.15244359142402364,0.16422666158371807,127880.99500868093,-970.4101562499606,126910.58485243097,1533,0,252.61363636363637,39,5,19,39.39452454514248,0.593482905982906,47.135416666666686,1011.4583333333363,25.934829059829138,0
4233,4,2,1,45,0.043478260869565216,0.021739130434782608,0.9782608695652174,46,1150,700,450,0.6086956521739131,16,7,9,304.68795230043247,0.4378119967793881,0.1843316165128499,0.16612985727069518,128530.68300119002,-1367.3786103571529,127163.30439083287,1534,0,242.58695652173913,40,6,15,38.76987706287165,0.5984375,46.4939024390244,1014.0243902439045,25.35060975609761,0
4234,4,2,0,47,0.0425531914893617,0.0,1.0,47,1050,900,150,0.8571428571428571,12,9,3,304.82113296491616,0.4390417823003392,0.20964896422315205,0.16807019819212599,128974.5540143142,-1537.1660643423888,127437.38794997182,1535,0,238.27659574468086,41,6,17,38.31581453266922,0.6013719512195121,46.05654761904763,1015.7738095238107,24.774970963995383,0
4235,4,0,2,45,0.0,0.0425531914893617,0.9574468085106383,47,1250,900,350,0.72,16,9,7,303.4116648368174,0.4392345050878816,0.21657983997922625,0.16783657915656883,129102.89345592231,-1565.7352322576564,127537.15822366465,1536,1,239.27659574468086,42,5,19,38.22145944571574,0.6011904761904762,45.930232558139544,1016.2790697674434,24.197120708748653,0
4236,4,0,0,45,0.0,0.0,1.0,45,1500,1300,200,0.8666666666666667,17,13,4,310.1606789174252,0.4375420875420875,0.2133831310301897,0.17110188446239433,128994.83194527085,-998.1750694031145,127996.65687586773,1537,2,248.46666666666667,40,5,20,38.15963885554221,0.603125,46.03658536585367,1015.8536585365869,25.39634146341467,0
4237,4,1,0,46,0.021739130434782608,0.0,1.0,46,900,400,500,0.4444444444444444,14,4,10,303.8593588460319,0.4399557165861514,0.21317173534506972,0.1688434217651569,129280.82817925337,-1343.0315965638304,127937.79658268954,1538,0,244.04347826086956,39,7,21,38.029742394755715,0.6076388888888888,45.75520833333333,1016.9791666666657,26.076388888888864,0
4238,4,1,2,45,0.02127659574468085,0.0425531914893617,0.9574468085106383,47,1100,700,400,0.6363636363636364,15,7,8,294.5409809793371,0.4412195497995683,0.21268525970868146,0.16495282774913234,129589.12854658261,-1766.1381907264317,127822.99035585618,1539,0,239.82978723404256,40,7,12,37.954760954187044,0.6091145833333333,45.45223577235772,1018.1910569105681,25.454776422764205,0
4239,4,0,0,45,0.0,0.0,1.0,45,1700,1300,400,0.7647058823529411,21,13,8,305.0215136048455,0.4369949494949495,0.20852547729843862,0.17043636129697115,129500.26167223658,-1099.9268345021837,128400.3348377344,1540,1,250.15555555555557,38,7,14,37.777938140722846,0.6115679824561404,45.5395299145299,1017.8418803418783,26.785312640575746,0
4240,4,0,0,45,0.0,0.0,1.0,45,1450,900,550,0.6206896551724138,20,9,11,303.916439365826,0.4369318181818182,0.20577581987273685,0.1706442481103524,129690.63321827739,-1116.9769066403674,128573.65631163702,1541,2,251.15555555555557,38,7,14,37.61340990140552,0.6134868421052632,45.3525641025641,1018.5897435897431,26.80499325236166,0
4241,4,0,0,45,0.0,0.0,1.0,45,1400,700,700,0.5,21,7,14,304.6707067643605,0.43577441077441076,0.19971847613858196,0.17217764883427042,129943.77170138899,-1081.9878472222126,128861.78385416677,1542,3,252.15555555555557,39,6,16,37.338237297370924,0.6143162393162394,45.10416666666667,1019.5833333333342,26.143162393162413,0
4242,4,0,1,44,0.0,0.022222222222222223,0.9777777777777777,45,850,400,450,0.47058823529411764,13,4,9,303.9295783672945,0.4360690235690236,0.19651416122004361,0.1722267610748003,130050.00000000003,-1094.7916666666665,128955.20833333336,1543,4,253.15555555555557,39,6,17,37.24979575163396,0.6153846153846154,45.0,1020.0000000000002,26.15384615384616,0
4243,4,0,0,44,0.0,0.0,1.0,44,1350,900,450,0.6666666666666666,18,9,9,311.85794948303925,0.4341525722339676,0.20265965045954548,0.17644837746387726,129990.07100819999,-692.3126004456186,129297.75840775437,1544,5,259.70454545454544,38,6,17,37.108215470577946,0.6165021929824561,45.05876068376068,1019.764957264957,26.835919928025184,0
4244,4,0,0,44,0.0,0.0,1.0,44,1100,700,400,0.6363636363636364,15,7,8,312.2825952551298,0.43396538054968287,0.20630249700017145,0.17681196051633852,130017.30974687697,-679.5714168310419,129337.73833004593,1545,6,260.70454545454544,38,6,17,37.0698460087995,0.6167763157894737,45.03205128205128,1019.8717948717941,26.838731443994583,0
4245,4,1,0,45,0.022222222222222223,0.0,1.0,45,1800,1400,400,0.7777777777777778,22,14,8,303.8882164511524,0.4365530303030303,0.20605638058053888,0.17399875004227058,130453.5176510336,-1071.111499196441,129382.40615183716,1546,0,255.88888888888889,38,7,19,36.84353865997351,0.6211622807017544,44.60470085470085,1021.5811965811961,26.88371569950516,0
4246,4,0,0,45,0.0,0.0,1.0,45,1550,1400,150,0.9032258064516129,17,14,3,302.8529494565291,0.4352483164983165,0.20912163339256562,0.1740176677147515,130589.9824334319,-1090.0877301117687,129499.89470332013,1547,1,256.8888888888889,38,7,14,36.73238737326227,0.622532894736842,44.47115384615385,1022.1153846153842,26.897773279352215,0
4247,4,1,0,46,0.021739130434782608,0.0,1.0,46,1050,600,450,0.5714285714285714,15,6,9,296.7249954919414,0.43731884057971016,0.216173983869397,0.17163915816972034,130848.0957031251,-1434.819878472209,129413.2758246529,1548,0,252.2826086956522,39,7,15,36.62908097468269,0.6233974358974359,44.21875000000001,1023.1250000000008,26.23397435897438,0
4248,4,0,0,46,0.0,0.0,1.0,46,1750,1000,750,0.5714285714285714,25,10,15,295.83479725929857,0.436664653784219,0.2074374900461855,0.17183595670593318,131008.00781250013,-1448.6545138888748,129559.35329861126,1549,1,253.2826086956522,39,7,18,36.49097815764482,0.625,44.06250000000001,1023.750000000001,26.250000000000025,0
4249,4,1,0,47,0.02127659574468085,0.0,1.0,47,1550,1100,450,0.7096774193548387,20,11,9,292.32948177709284,0.4382708911501696,0.2180391817857641,0.17181992525943182,131461.62245008702,-1713.587782118032,129748.03466796898,1550,0,248.87234042553192,39,8,21,36.12504232266801,0.6295405982905983,43.61979166666668,1025.520833333335,26.29540598290603,0
4250,4,0,0,47,0.0,0.0,1.0,47,1150,900,250,0.782608695652174,14,9,5,291.63338400886386,0.43753854455750846,0.21881412679555012,0.17201130733456957,131595.18771701405,-1724.4900173610904,129870.69769965296,1551,1,249.87234042553192,39,8,15,36.00888324873095,0.6308760683760684,43.48958333333334,1026.041666666668,26.30876068376072,0
4251,4,0,0,47,0.0,0.0,1.0,47,1700,1300,400,0.7647058823529411,21,13,8,291.71592865705446,0.4365942028985507,0.22166089143646728,0.17266429290782423,131728.82080078137,-1714.5209418402621,130014.2998589411,1552,2,250.87234042553192,39,8,17,35.87275917469983,0.6322115384615384,43.35937500000001,1026.562500000001,26.322115384615408,0
4252,4,0,1,46,0.0,0.02127659574468085,0.9787234042553191,47,1050,700,350,0.6666666666666666,14,7,7,291.916444832112,0.43607385137218624,0.22398688015191404,0.1733913340990739,131862.521701389,-1701.4322916666556,130161.08940972234,1553,3,251.87234042553192,39,8,18,35.733603786342115,0.6335470085470085,43.22916666666667,1027.0833333333342,26.335470085470106,0
4253,4,0,0,46,0.0,0.0,1.0,46,1100,700,400,0.6363636363636364,15,7,8,298.1019084636213,0.4346316425120773,0.17950020316944304,0.1678784431874077,129807.25623582759,-1460.841836734702,128346.41439909289,1554,4,256.95652173913044,41,5,16,37.64359423676011,0.6097560975609756,45.238095238095234,1019.0476190476185,24.854819976771182,8
4254,4,0,1,45,0.0,0.021739130434782608,0.9782608695652174,46,1400,1000,400,0.7142857142857143,18,10,8,299.6341406268153,0.4338969404186796,0.1819128451360712,0.16932064595463725,129941.30179225984,-1413.029941109329,128528.27185115051,1555,5,257.95652173913044,42,4,17,37.469112336057776,0.6096230158730158,45.10658914728681,1019.5736434108508,24.27556293835359,0
4255,4,0,0,45,0.0,0.0,1.0,45,800,500,300,0.625,11,5,6,303.6253888587784,0.43362794612794614,0.19103844989403584,0.17143156570949475,129908.3719135802,-1111.3040123456851,128797.0679012345,1556,6,264.02222222222224,41,4,18,37.40065849227974,0.6107723577235773,45.138888888888886,1019.444444444444,24.86449864498644,0
4256,4,0,0,45,0.0,0.0,1.0,45,1350,900,450,0.6666666666666666,18,9,9,307.70250250120387,0.4332281144781145,0.19511383405188742,0.17452315682404165,130085.41907793196,-994.4782021605081,129090.94087577146,1557,7,265.02222222222224,41,4,20,37.11779555253007,0.6125508130081301,44.96527777777777,1020.1388888888878,24.881436314363118,0
4257,4,0,0,45,0.0,0.0,1.0,45,1400,1000,400,0.7142857142857143,18,10,8,310.3761397633731,0.43333333333333335,0.19613453179727336,0.17650548077688136,130188.40889970551,-918.5248407547724,129269.88405895073,1558,8,266.02222222222224,42,3,20,36.945538992277484,0.6121031746031746,44.86434108527131,1020.5426356589144,24.298634182355105,0
4258,4,0,0,45,0.0,0.0,1.0,45,1250,900,350,0.72,16,9,7,310.18396908540285,0.43331228956228957,0.20322123612953003,0.17709571630426332,130342.35161675335,-913.9150282646262,129428.43658848872,1559,9,267.02222222222224,39,6,21,36.79496497670783,0.6183226495726496,44.713541666666664,1021.1458333333323,26.18322649572647,0
4259,4,0,0,45,0.0,0.0,1.0,45,1550,900,650,0.5806451612903226,22,9,13,314.43190211189653,0.4326599326599327,0.20685052594360465,0.1804752972395679,130548.03688280778,-790.3064891929498,129757.73039361482,1560,10,268.02222222222224,40,5,13,36.47884347653142,0.61875,44.512195121951216,1021.9512195121945,25.548780487804862,0
4260,4,0,0,45,0.0,0.0,1.0,45,1500,900,600,0.6,21,9,12,313.0766153051248,0.4321759259259259,0.2087369420702765,0.18042250304697358,130703.86860499678,-815.9350419723875,129887.93356302439,1561,11,269.02222222222224,40,5,13,36.35625786788579,0.6203125,44.35975609756097,1022.5609756097541,25.56402439024385,0
4261,4,0,0,45,0.0,0.0,1.0,45,1200,700,500,0.5833333333333334,17,7,10,315.40609276072524,0.4319654882154882,0.2149649053105558,0.18250049091465373,130859.79327781043,-745.2047805539419,130114.58849725648,1562,12,270.02222222222224,40,5,15,36.13946000529733,0.621875,44.207317073170714,1023.1707317073138,25.579268292682848,0
4262,4,0,2,43,0.0,0.044444444444444446,0.9555555555555556,45,1300,1000,300,0.7692307692307693,16,10,6,314.79947836550554,0.4317971380471381,0.21219563322631574,0.1825184540367876,130937.79047070172,-756.170372298262,130181.62009840345,1563,13,271.02222222222224,40,5,15,36.076357859199675,0.62265625,44.1310975609756,1023.4756097560957,25.586890243902392,0
4263,4,1,1,43,0.022727272727272728,0.022727272727272728,0.9772727272727273,44,1600,1200,400,0.75,20,12,8,323.00128759225225,0.43173009161381254,0.21880896880896894,0.18761564151635074,131008.00781249999,-336.8489583333319,130671.15885416666,1564,0,273.47727272727275,39,5,16,35.79568579568579,0.625,44.0625,1023.7499999999999,26.249999999999996,0
4264,4,0,1,42,0.0,0.023255813953488372,0.9767441860465116,43,650,300,350,0.46153846153846156,10,3,7,367.8027457140904,0.42960963455149503,0.2677301556794158,0.19349622709306508,127092.01388888896,794.878472222232,127886.8923611112,1565,1,280.4651162790698,37,6,20,38.64497245179062,0.5889639639639639,47.91666666666667,1008.333333333334,27.252252252252273,8
4265,4,2,1,43,0.045454545454545456,0.022727272727272728,0.9772727272727273,44,1200,800,400,0.6666666666666666,16,8,8,363.6433624260398,0.4319943622269204,0.2865057126507089,0.1936768752250597,127590.03371229624,479.453774238244,128069.48748653448,1566,0,274.45454545454544,37,7,20,38.238459590478264,0.5940315315315315,47.423245614035096,1010.3070175438609,27.305595068752996,0
4266,4,0,0,43,0.0,0.0,1.0,43,900,600,300,0.6666666666666666,12,6,6,362.53187597062174,0.43046327057954964,0.2979942837971121,0.19374964432308206,127728.54538175222,661.1338344490737,128389.6792162013,1567,1,280.69767441860466,37,6,21,38.12450283834109,0.5954391891891893,47.28618421052632,1010.8552631578959,27.320412517780973,0
4267,4,5,2,46,0.10416666666666667,0.041666666666666664,0.9583333333333334,48,1500,1100,400,0.7333333333333333,19,11,8,327.6158125520465,0.4411476802600473,0.2988276575375248,0.18034593769451762,128910.32036675372,-1151.3592598804203,127758.96110687329,1568,0,252.35416666666666,39,9,18,37.80227459226586,0.6038995726495726,46.11979166666668,1015.5208333333353,26.038995726495777,0
4268,4,0,0,46,0.0,0.0,1.0,46,1400,1000,400,0.7142857142857143,18,10,8,340.28826094240225,0.4372081320450885,0.3055251371179608,0.18594251045352425,128616.79945993004,-446.6425967605353,128170.15686316951,1569,1,264.32608695652175,37,9,18,37.779586891507236,0.6044481981981982,46.40899122807018,1014.3640350877199,27.41524419156,0
4269,4,2,1,47,0.041666666666666664,0.020833333333333332,0.9791666666666666,48,1300,1000,300,0.7692307692307693,16,10,6,325.86226621142885,0.4398640661938534,0.3123161378440853,0.18095432029173716,129255.70371283498,-1174.7631654294405,128080.94054740554,1570,0,254.27083333333334,38,10,21,37.49584121314,0.6091008771929824,45.77991452991452,1016.8803418803407,26.76000899685107,0
4270,4,1,0,48,0.020833333333333332,0.0,1.0,48,1400,1100,300,0.7857142857142857,17,11,6,329.70178479672757,0.4391068262411348,0.3221729315413693,0.18384542145222657,129418.71667031912,-1066.0836255387676,128352.63304478035,1571,0,255.16666666666666,38,10,22,37.23269284614307,0.6107456140350878,45.61965811965811,1017.5213675213665,26.77687809266754,0
4271,4,0,1,47,0.0,0.020833333333333332,0.9791666666666666,48,1000,600,400,0.6,14,6,8,329.5280612244897,0.43829417848699764,0.24785539215686292,0.1832422396528705,129310.0299510556,-1061.018541347065,128249.01140970855,1572,1,256.1666666666667,38,10,17,37.34747023809524,0.6096491228070176,45.72649572649573,1017.0940170940172,26.765632028789927,8
4272,4,0,0,47,0.0,0.0,1.0,47,1500,1100,400,0.7333333333333333,19,11,8,338.438343226219,0.4362858464384829,0.25866376096805643,0.18807762932433655,129285.00987082551,-648.9990910665016,128636.010779759,1573,2,262.5744680851064,37,10,19,37.1463387241689,0.611204954954955,45.75109649122806,1016.9956140350866,27.486367946894234,0
4273,4,2,2,47,0.04081632653061224,0.04081632653061224,0.9591836734693877,49,1500,1000,500,0.6666666666666666,20,10,10,329.55669878977,0.43725198412698413,0.26904911346371585,0.186114911197662,129917.22140842033,-1236.9818793402571,128680.23952908008,1574,0,252.81632653061226,39,10,17,36.73080361704303,0.6140491452991452,45.13020833333334,1019.4791666666682,26.140491452991494,0
4274,4,1,1,47,0.020833333333333332,0.020833333333333332,0.9791666666666666,48,1400,900,500,0.6428571428571429,19,9,10,332.9648853005253,0.43497894503546103,0.2925177015250542,0.18868010167029783,130050.00000000015,-939.5833333333187,129110.41666666683,1575,0,258.7708333333333,39,9,18,36.50939542483661,0.6153846153846154,45.00000000000001,1020.0000000000011,26.15384615384618,0
4275,4,0,0,47,0.0,0.0,1.0,47,1300,900,400,0.6923076923076923,17,9,8,339.65608717483315,0.4325855689176688,0.28758842959733566,0.1923106173292386,130017.30974687728,-567.7658612754558,129449.54388560182,1576,1,265.1276595744681,38,9,18,36.371909700398064,0.6167763157894737,45.03205128205129,1019.8717948717966,26.838731443994646,0
4276,4,0,0,47,0.0,0.0,1.0,47,1050,600,450,0.5714285714285714,15,6,9,340.1333486843711,0.4320844896700586,0.28757721345229936,0.19284995328018859,130071.79578493688,-551.648906055947,129520.14687888094,1577,2,266.1276595744681,38,9,18,36.30450530652145,0.6173245614035088,44.978632478632484,1020.0854700854707,26.84435447593344,0
4277,4,0,2,45,0.0,0.0425531914893617,0.9574468085106383,47,700,300,400,0.42857142857142855,11,3,8,340.5254647169828,0.43191103916127044,0.2881798918456424,0.19320722891161438,130099.04308431958,-539.5925788954567,129559.45050542412,1578,3,267.1276595744681,38,9,18,36.266886584982714,0.6175986842105263,44.95192307692308,1020.1923076923082,26.84716599190285,0
4278,4,0,2,43,0.0,0.044444444444444446,0.9555555555555556,45,1400,1000,400,0.7142857142857143,18,10,8,322.32959231238164,0.43082912457912453,0.12696385007762334,0.18063436884620016,129614.99851278975,-644.2500743605232,128970.74843842923,1579,4,279.5111111111111,40,5,15,37.22118263473055,0.609375,45.42682926829267,1018.2926829268272,25.457317073170678,8
4279,4,0,0,43,0.0,0.0,1.0,43,950,500,450,0.5263157894736842,14,5,9,333.99157622806393,0.4260105204872647,0.14981439766490112,0.186882309446695,129554.63927469112,54.03163580244687,129608.67091049356,1580,6,293.30232558139534,38,5,15,36.9855616189177,0.6121162280701755,45.4861111111111,1018.0555555555535,26.790935672514564,0
4280,4,0,2,41,0.0,0.046511627906976744,0.9534883720930233,43,1100,600,500,0.5454545454545454,16,6,10,339.41534176349904,0.426172019195275,0.0832608634667713,0.1815324634335103,127758.9604402143,72.67024423294725,127831.63068444724,1581,7,294.30232558139534,40,3,18,38.67758175847743,0.590625,47.25609756097562,1010.9756097560987,25.274390243902467,8
4281,4,2,1,42,0.046511627906976744,0.023255813953488372,0.9767441860465116,43,1450,1100,350,0.7586206896551724,18,11,7,332.2847144415161,0.4294250645994832,0.08112148370323102,0.17978877454172879,128223.64501953148,-78.06760460298912,128145.5774149285,1582,0,280.5581395348837,39,4,20,38.383322191367554,0.5969551282051282,46.796875000000014,1012.8125000000018,25.969551282051327,0
4282,4,0,2,40,0.0,0.047619047619047616,0.9523809523809523,42,1250,800,450,0.64,17,8,9,333.05473301025825,0.4279786101432443,0.10540831493854408,0.1711053164847053,126122.29953342007,1.1257595486010246,126123.42529296866,1583,1,287.0,39,3,17,40.51654481662001,0.5755876068376069,48.88020833333333,1004.4791666666661,25.755876068376054,8
4283,4,4,2,42,0.09090909090909091,0.045454545454545456,0.9545454545454546,44,1300,1000,300,0.7692307692307693,16,10,6,329.29620531933693,0.433216613812544,0.1634525055694238,0.17291879804908414,127017.00015943863,-434.7567672902602,126582.24339214836,1584,0,274.5681818181818,41,3,18,39.69251304005514,0.5815548780487805,47.99107142857142,1008.0357142857131,24.58623693379788,0
4284,4,3,1,44,0.06666666666666667,0.022222222222222223,0.9777777777777777,45,1500,1300,200,0.8666666666666667,17,13,4,321.4099727913661,0.4371843434343434,0.20713041147299327,0.1719024951251884,127758.9604402139,-787.3549116627864,126971.60552855111,1585,0,269.1777777777778,40,5,17,39.132656480364574,0.590625,47.2560975609756,1010.9756097560954,25.274390243902385,0
4285,4,1,0,45,0.022222222222222223,0.0,1.0,45,1300,1000,300,0.7692307692307693,16,10,6,327.2553505639712,0.43545875420875424,0.22311964974188014,0.17627555894686564,128044.10450522804,-619.3763384983647,127424.72816672968,1586,0,270.15555555555557,41,4,18,38.693801868914576,0.5919715447154472,46.97420634920635,1012.1031746031748,24.685443283004265,0
4286,4,0,0,45,0.0,0.0,1.0,45,1600,1200,400,0.75,20,12,8,326.7044988182213,0.43489057239057244,0.21291509887353266,0.1766589814203036,128198.62349559875,-623.2684895402326,127575.35500605851,1587,1,271.15555555555557,38,7,19,38.55012835390511,0.5984100877192983,46.8215811965812,1012.713675213676,26.650359874044103,0
4287,4,2,1,46,0.0425531914893617,0.02127659574468085,0.9787234042553191,47,1400,1000,400,0.7142857142857143,18,10,8,315.0525566863187,0.4393308664816528,0.22703631225083565,0.17283124436770647,128773.09032698725,-1285.9417320168823,127487.14859497036,1588,0,260.5744680851064,41,6,19,38.26065796761477,0.599339430894309,46.254960317460316,1014.9801587301585,24.75561362756484,0
4288,4,0,0,46,0.0,0.0,1.0,46,1100,700,400,0.6363636363636364,15,7,8,320.1651352868938,0.4383554750402576,0.22553586042381268,0.17570381160689524,128788.44024720725,-953.2863209729759,127835.15392623428,1589,1,267.10869565217394,40,6,19,38.1153217193966,0.6010416666666667,46.23983739837398,1015.0406504065033,25.376016260162583,0
4289,4,1,0,47,0.02127659574468085,0.0,1.0,47,1450,1100,350,0.7586206896551724,18,11,7,315.89941027548394,0.43908032685784765,0.2302732002118324,0.1748454596581485,129125.75511975602,-1241.8500212585177,127883.9050984975,1590,0,262.40425531914894,41,6,21,37.88097852611031,0.6028963414634146,45.90773809523809,1016.3690476190459,24.789488966318192,0
4290,4,1,1,47,0.020833333333333332,0.020833333333333332,0.9791666666666666,48,1400,1000,400,0.7142857142857143,18,10,8,294.8792867484875,0.4423943557919621,0.11474638360358669,0.1570677538851533,127593.81030654593,-2075.0456446567628,125518.76466188916,1591,0,257.9166666666667,43,5,12,39.971432030493325,0.5845445736434108,47.41950757575759,1010.3219696969726,23.495859760394712,8
4291,4,3,1,49,0.06,0.02,0.98,50,1600,1300,300,0.8125,19,13,6,289.35488849600114,0.4467942176870748,0.1500402132236045,0.15634521590135103,128168.50254139393,-2580.391539686653,125588.11100170728,1592,0,248.52,43,7,15,39.52634511674304,0.5903585271317829,46.85132575757575,1012.594696969696,23.548713883016184,0
4292,4,0,1,48,0.0,0.02040816326530612,0.9795918367346939,49,1550,1100,450,0.7096774193548387,20,11,9,296.51193530419687,0.4445330215419501,0.14825402032225132,0.1604111153105314,128218.12466197945,-2196.359143080339,126021.76551889912,1593,1,254.51020408163265,42,7,15,39.29471233575712,0.5922619047619048,46.80232558139535,1012.7906976744187,24.114064230343303,0
4293,4,2,1,49,0.04,0.02,0.98,50,1800,1300,500,0.7222222222222222,23,13,10,288.7192646663158,0.4441751700680272,0.1564240388204554,0.15817564622516547,128720.46100206595,-2567.184630394875,126153.27637167108,1594,0,250.28,43,7,15,38.982207291277845,0.5959302325581395,46.30681818181817,1014.772727272726,23.599365750528513,0
4294,4,1,3,47,0.02,0.06,0.94,50,1700,1300,400,0.7647058823529411,21,13,8,293.2375429714296,0.44429421768707483,0.17104140069305163,0.16126594263915223,128872.1236282578,-2441.9710219478793,126430.15260630993,1595,0,251.26,44,6,16,38.71378959207249,0.5961174242424243,46.157407407407405,1015.3703703703696,23.07659932659931,0
4295,4,1,1,47,0.020833333333333332,0.020833333333333332,0.9791666666666666,48,950,700,250,0.7368421052631579,12,7,5,300.64753847683244,0.4443059249408983,0.19099585158944743,0.1658121411434951,128984.86036680728,-1844.2038459882922,127140.65652081899,1596,0,248.97916666666666,43,5,17,38.41134908797117,0.5985949612403101,46.046401515151516,1015.8143939393939,23.62359055673009,0
4296,4,1,0,48,0.020833333333333332,0.0,1.0,48,1350,900,450,0.6666666666666666,18,9,9,303.07776646565924,0.4421357860520094,0.20035514671634913,0.1679679826024188,129177.32119669708,-1769.845202737598,127407.47599395948,1597,0,249.70833333333334,43,5,20,38.15449852507376,0.6005329457364341,45.85700757575758,1016.5719696969696,23.641208597603946,0
4297,4,0,0,48,0.0,0.0,1.0,48,1100,700,400,0.6363636363636364,15,7,8,305.35764966522015,0.4417756353427896,0.2015026981113217,0.16966762910604444,129278.89034511539,-1704.7336529405125,127574.15669217487,1598,1,250.70833333333334,40,8,21,37.993612804370265,0.6059895833333333,45.75711382113821,1016.9715447154475,25.424288617886187,0
4298,4,0,0,48,0.0,0.0,1.0,48,1950,1600,350,0.8205128205128205,23,16,7,307.84921880288283,0.44132313829787234,0.19592986485586805,0.17183958066288024,129459.8174449734,-1629.1792666402139,127830.63817833319,1599,2,251.70833333333334,40,8,14,37.74694594234736,0.6078125,45.57926829268293,1017.6829268292697,25.442073170731742,0
4299,4,0,0,48,0.0,0.0,1.0,48,1200,800,400,0.6666666666666666,16,8,8,307.48518785307726,0.4397809544917258,0.18829137041005173,0.17260527193480285,129680.91699932292,-1625.0077751007736,128055.90922422214,1600,3,252.70833333333334,41,7,15,37.53236502061621,0.6084857723577235,45.36210317460318,1018.5515873015877,24.842721641502138,0
4300,4,0,1,47,0.0,0.020833333333333332,0.9791666666666666,48,600,400,200,0.6666666666666666,8,4,4,307.1626646618576,0.43918993794326244,0.18981301129723382,0.17253535233850956,129706.17992567403,-1631.820830183922,128074.35909549012,1601,4,253.70833333333334,41,7,15,37.51501428385924,0.608739837398374,45.33730158730159,1018.6507936507942,24.845141308555956,0
4301,4,1,1,47,0.020833333333333332,0.020833333333333332,0.9791666666666666,48,1700,1200,500,0.7058823529411765,22,12,10,312.366135649209,0.43958702718676124,0.1990936739659368,0.17625272069168707,129883.08930342968,-1485.7842616213186,128397.30504180836,1602,0,254.54166666666666,41,7,17,37.20346715328467,0.6105182926829269,45.163690476190474,1019.3452380952378,24.86207897793263,0
4302,4,0,0,47,0.0,0.0,1.0,47,1500,1000,500,0.6666666666666666,20,10,10,328.88495517972456,0.4380010792476103,0.15179332530874,0.17434061604884668,127399.61848932524,-1019.4828297854333,126380.1356595398,1603,1,260.82978723404256,40,7,17,39.31112005905644,0.5869791666666666,47.611788617886184,1009.5528455284561,25.238821138211403,8
4303,4,1,2,46,0.020833333333333332,0.041666666666666664,0.9583333333333334,48,1400,900,500,0.6428571428571429,19,9,10,330.88209487860485,0.43937463061465726,0.17404450004906336,0.17700889390592447,127768.13394628682,-1144.7624362244887,126623.37151006234,1604,0,256.375,41,7,18,38.88388038465313,0.5891768292682926,47.24702380952381,1011.0119047619045,24.658826945412304,0
4304,4,2,0,48,0.041666666666666664,0.0,1.0,48,1600,1400,200,0.875,18,14,4,338.98546093522316,0.44181257387706857,0.10258724428399502,0.18411563270403328,128376.15258774559,-855.2596537759762,127520.8929339696,1605,0,256.8958333333333,40,8,16,38.05802079154966,0.596875,46.64634146341464,1013.414634146343,25.335365853658576,8
4305,4,1,3,46,0.02040816326530612,0.061224489795918366,0.9387755102040817,49,1150,800,350,0.6956521739130435,15,8,7,334.6558782977539,0.44347009637188206,0.11850982692871814,0.18312068846180468,128672.4175347223,-1187.8038194444343,127484.61371527787,1606,0,252.6326530612245,41,8,17,37.86575975359344,0.5983231707317074,46.35416666666667,1014.583333333334,24.74593495934961,0
4306,4,0,1,45,0.0,0.021739130434782608,0.9782608695652174,46,900,500,400,0.5555555555555556,13,5,8,345.80596734847074,0.44180756843800323,0.1354377605717687,0.18838683295849512,128496.3348765431,-313.04012345680314,128183.2947530863,1607,1,264.89130434782606,38,8,17,37.76255707762556,0.6014254385964912,46.52777777777777,1013.888888888888,26.68128654970758,0
4307,4,0,0,45,0.0,0.0,1.0,45,1950,1300,650,0.6666666666666666,26,13,13,356.96001229166046,0.4410143097643098,0.1474756208867758,0.19518877267863097,128644.6069944595,184.19609879959364,128828.80309325909,1608,2,270.5111111111111,37,8,17,37.32841547773454,0.6047297297297297,46.3815789473684,1014.4736842105236,27.418207681365505,0
4308,4,1,1,45,0.021739130434782608,0.021739130434782608,0.9782608695652174,46,950,600,350,0.631578947368421,13,6,7,352.0461656716165,0.44236111111111115,0.1584889612408782,0.19415631921146864,128984.24373584581,-118.31831214848944,128865.92542369732,1609,0,265.60869565217394,38,8,18,37.10669085682233,0.606359649122807,46.047008547008524,1015.8119658119618,26.73189383715689,0
4309,4,1,1,45,0.021739130434782608,0.021739130434782608,0.9782608695652174,46,1300,1000,300,0.7692307692307693,16,10,6,352.0880258429811,0.44209943639291466,0.21970918973382436,0.1814844963893107,126258.49364681482,-308.9966168091316,125949.49703000569,1610,0,266.0652173913044,38,8,19,39.89825838914283,0.5786732456140351,48.74465811965811,1005.0213675213664,26.447930724246486,8
4310,4,2,1,46,0.0425531914893617,0.02127659574468085,0.9787234042553191,47,1300,500,800,0.38461538461538464,21,5,16,344.95271507544584,0.4452667283379587,0.2521168827170004,0.18077316173563696,126934.51063368036,-642.7191840277973,126291.79144965256,1611,0,260.82978723404256,39,8,18,39.382623526979536,0.5838675213675213,48.07291666666666,1007.7083333333318,25.838675213675174,0
4311,4,0,2,44,0.0,0.043478260869565216,0.9565217391304348,46,1400,900,500,0.6428571428571429,19,9,10,352.1150259845366,0.44328703703703703,0.2692782488933525,0.1853660753077544,127118.9472957299,-247.80405771744245,126871.14323801246,1612,1,265.8478260869565,38,8,18,39.01278384009606,0.5874451754385965,47.88995726495725,1008.4401709401689,26.537899235267602,0
4312,4,0,0,44,0.0,0.0,1.0,44,1650,1200,450,0.7272727272727273,21,12,9,362.03293643856586,0.4407813601127555,0.27499710848947534,0.18970525869380828,126930.47337278086,390.6023997369929,127321.07577251786,1613,2,278.6818181818182,38,6,18,38.95647794741307,0.5855263157894737,48.076923076923066,1007.692307692306,26.518218623481737,0
4313,4,4,0,48,0.08333333333333333,0.0,1.0,48,1400,1200,200,0.8571428571428571,16,12,4,337.18203520334146,0.4496712470449173,0.28787767314106416,0.18071680688027664,127843.36911848064,-978.599794207631,126864.769324273,1614,0,256.375,41,7,19,38.647733961153634,0.5899390243902439,47.172619047619044,1011.3095238095231,24.666085946573734,0
4314,4,0,1,47,0.0,0.020833333333333332,0.9791666666666666,48,1550,1200,350,0.7741935483870968,19,12,7,336.87214024862294,0.4495050236406619,0.2797744502172985,0.18134209512803223,128019.00397022266,-974.7928280108013,127044.21114221186,1615,1,257.375,41,7,19,38.47610936836258,0.5917174796747968,46.99900793650795,1012.0039682539708,24.683023615950507,0
4315,4,0,1,46,0.0,0.02127659574468085,0.9787234042553191,47,1700,1000,700,0.5882352941176471,24,10,14,346.0948599973815,0.4474637681159421,0.2784181099956624,0.18641204492774083,128041.65556423113,-537.0882287328817,127504.56733549824,1616,2,263.7659574468085,40,7,20,38.21961709676337,0.5934895833333333,46.97662601626017,1012.0934959349609,25.30233739837402,0
4316,4,2,0,48,0.041666666666666664,0.0,1.0,48,1100,700,400,0.6363636363636364,15,7,8,338.2713665417808,0.4506316489361702,0.28521295535469715,0.18460818523827255,128566.75347222241,-901.8270994447539,127664.92637277766,1617,0,250.625,39,9,16,37.88174472747194,0.6004273504273504,46.45833333333334,1014.1666666666682,26.004273504273545,0
4317,4,0,0,48,0.0,0.0,1.0,48,1050,600,450,0.5714285714285714,15,6,9,334.35790595053004,0.45064088356973997,0.2863588927667142,0.18320105285545946,128725.2658420141,-991.9379340277599,127733.32790798633,1618,1,251.625,39,9,18,37.81949291726544,0.6020299145299146,46.30208333333334,1014.7916666666683,26.020299145299187,0
4318,4,0,0,48,0.0,0.0,1.0,48,900,600,300,0.6666666666666666,12,6,6,329.592394673723,0.45030843676122934,0.2780378826748757,0.18095086682227804,128804.55864800367,-1109.3994140624793,127695.15923394119,1619,2,252.625,39,9,18,37.859693004959816,0.6028311965811965,46.22395833333334,1015.1041666666683,26.02831196581201,0
4319,4,0,0,48,0.0,0.0,1.0,48,1300,1000,300,0.7692307692307693,16,10,6,337.0918339791941,0.4505300679669031,0.15747433971711122,0.177757535423088,127187.51793503223,-1025.2252640036609,126162.29267102857,1620,3,253.625,43,5,16,39.32125422455877,0.5804263565891472,47.8219696969697,1008.7121212121219,23.458421423537718,8
4320,4,2,2,48,0.04,0.04,0.96,50,1550,1100,450,0.7096774193548387,20,11,9,328.6011504296466,0.45435374149659863,0.1684065244667503,0.17543213571741603,127686.3817015857,-1608.421615731998,126077.9600858537,1621,0,244.44,45,5,15,39.02506422895381,0.5828703703703704,47.32789855072463,1010.6884057971007,22.459742351046682,0
4321,4,0,1,47,0.0,0.020833333333333332,0.9791666666666666,48,1050,900,150,0.8571428571428571,12,9,3,333.1814715033089,0.45256168735224583,0.1656715804880966,0.1779785562712024,127709.26969288212,-1089.9275198225305,126619.34217305959,1219,1,221.77083333333334,45,3,15,38.88593287929025,0.5831018518518518,47.3052536231884,1010.7789855072452,22.461755233494337,0
4322,4,1,0,48,0.020833333333333332,0.0,1.0,48,1000,600,400,0.6,14,6,8,330.04602909859796,0.45279255319148937,0.16419352432109857,0.17741165279265322,127961.17297442738,-1153.3845961982988,126807.78837822907,1220,0,222.125,45,3,16,38.707848403461654,0.5856481481481481,47.056159420289845,1011.7753623188385,22.48389694041863,0
4323,4,0,2,46,0.0,0.041666666666666664,0.9583333333333334,48,1200,700,500,0.5833333333333334,17,7,10,328.20270837252326,0.45294954196217496,0.15947112085682802,0.17672331858535892,128029.91694398479,-1196.046901255009,126833.87004272979,1221,1,223.125,45,3,16,38.68430964527579,0.5863425925925926,46.98822463768115,1012.0471014492738,22.48993558776164,0
4324,4,2,0,48,0.041666666666666664,0.0,1.0,48,1150,700,450,0.6086956521739131,16,7,9,330.97314610203057,0.45195220153664306,0.1699834065625878,0.17926175918245138,128264.41012576017,-1109.4823710025964,127154.92775475758,1222,0,223.72916666666666,43,5,18,38.37495325792276,0.591327519379845,46.756628787878775,1012.9734848484827,23.557522903453087,0
4325,4,2,2,48,0.04,0.04,0.96,50,1500,1200,300,0.8,18,12,6,321.56426132739523,0.45429421768707484,0.18364112868000326,0.17620613209261335,128728.63950662692,-1721.0940250741976,127007.54548155272,1223,0,215.74,46,4,11,38.14063364491422,0.5921648550724637,46.298758865248224,1014.804964539007,22.060977489978413,0
4326,4,0,4,44,0.0,0.08333333333333333,0.9166666666666666,48,1350,900,450,0.6666666666666666,18,9,9,343.27476618913016,0.45075169917257685,0.18096451269528235,0.1804862437341069,127068.14348205042,-874.4095838164064,126193.73389823402,1224,1,225.6875,43,5,16,39.287768855076536,0.5792151162790697,47.9403409090909,1008.2386363636348,23.447410147991505,8
4327,4,2,1,45,0.043478260869565216,0.021739130434782608,0.9782608695652174,46,1400,1000,400,0.7142857142857143,18,10,8,341.9602676826933,0.44532004830917876,0.22446957229565911,0.16973664195886412,124695.30785246877,-627.6331847698136,124067.67466769896,1225,0,235.17391304347825,40,6,14,41.766296974630286,0.559375,50.30487804878049,998.7804878048781,24.969512195121954,8
4328,4,3,0,48,0.0625,0.0,1.0,48,1250,1100,150,0.88,14,11,3,339.15189099484644,0.44957890070921985,0.2559968847352023,0.16057191299313547,122695.90192043914,-1277.4905692729585,121418.41135116619,1226,0,226.02083333333334,44,4,17,43.914524922118396,0.5331439393939394,52.314814814814824,990.7407407407422,22.51683501683505,8
4329,4,8,5,51,0.14285714285714285,0.08928571428571429,0.9107142857142857,56,1300,900,400,0.6923076923076923,17,9,8,314.9829367898497,0.46110660173160173,0.3377199522815384,0.15554312033230755,124479.70920138912,-3331.196952160475,121148.51224922865,1227,0,194.58928571428572,43,13,14,42.66266527487821,0.5528100775193798,50.52083333333334,997.9166666666686,23.207364341085317,0
4330,4,5,3,53,0.08928571428571429,0.05357142857142857,0.9464285714285714,56,1850,1300,550,0.7027027027027027,24,13,11,319.8389479583893,0.46214826839826845,0.36901773314816877,0.16002204125272482,125026.71082849371,-3196.892321161142,121829.81850733257,1228,0,195.33928571428572,38,18,19,41.976462628636575,0.5660635964912281,49.9732905982906,1000.1068376068379,26.31860098965363,0
4331,4,2,0,55,0.03636363636363636,0.0,1.0,55,1900,1300,600,0.6842105263157895,25,13,12,326.2834374503286,0.4640712682379349,0.365087083017815,0.1635719825987253,125109.67316866736,-2835.757156048006,122273.91601261936,1229,0,199.34545454545454,37,18,21,41.72968727166448,0.5686936936936937,49.890350877192986,1000.4385964912287,27.038880986249424,0
4332,4,1,2,54,0.017857142857142856,0.03571428571428571,0.9642857142857143,56,2000,1400,600,0.7,26,14,12,321.08416636500914,0.46547619047619043,0.36586671033988893,0.16230761336952518,125454.47216971658,-3143.711077324859,122310.76109239172,1230,0,196.76785714285714,38,18,18,41.50425686964558,0.5704495614035088,49.54594017094017,1001.8162393162395,26.3635852451642,0
4333,4,5,5,54,0.0847457627118644,0.0847457627118644,0.9152542372881356,59,1450,1000,450,0.6896551724137931,19,10,9,295.934019379559,0.46985193843756085,0.3613170190318298,0.15316752383787202,126426.81274373717,-4314.438775114986,122112.37396862218,1231,0,184.96610169491527,40,19,14,41.13678085421722,0.5770833333333334,48.577235772357724,1005.6910569105689,25.142276422764223,0
4334,4,0,0,54,0.0,0.0,1.0,54,1350,800,550,0.5925925925925926,19,8,11,327.5383092894534,0.46333420684835774,0.3642212042659474,0.16664510077507297,125722.19397189331,-2564.2330292570814,123157.96094263623,1232,1,202.9814814814815,38,16,20,41.06676787045916,0.5731907894736843,49.278846153846146,1002.8846153846139,26.39170040485826,0
4335,4,1,0,55,0.01818181818181818,0.0,1.0,55,1650,1000,650,0.6060606060606061,23,10,13,326.3322162517233,0.4651795735129069,0.3663556101381866,0.16755047323770866,126097.48389445888,-2769.6548095186117,123327.82908494027,1233,0,200.27272727272728,38,17,21,40.71087295677765,0.5770285087719298,48.90491452991452,1004.3803418803404,26.43106162843001,0
4336,4,0,1,54,0.0,0.01818181818181818,0.9818181818181818,55,2050,1500,550,0.7317073170731707,26,15,11,323.3357143112622,0.4653058361391695,0.3622984953692805,0.16674860007425785,126279.2982313366,-2833.8785807291906,123445.41965060741,1234,1,201.27272727272728,39,16,16,40.59930649117353,0.577190170940171,48.72395833333332,1005.1041666666649,25.771901709401664,0
4337,4,0,0,54,0.0,0.0,1.0,54,1350,1000,350,0.7407407407407407,17,10,7,333.52491826658144,0.4634506755182856,0.35856867817110216,0.17191610444568356,126258.49364681472,-2377.929245196901,123880.56440161783,1235,2,205.7962962962963,38,16,23,40.36466638318981,0.5786732456140351,48.744658119658105,1005.0213675213656,26.447930724246465,0
4338,4,0,2,52,0.0,0.037037037037037035,0.962962962962963,54,1550,1100,450,0.7096774193548387,20,11,9,331.20744702698465,0.4635598648963429,0.34760874402473774,0.1713545923686231,126410.20507812484,-2426.3997395833476,123983.8053385415,1236,3,206.7962962962963,39,15,18,40.2669877770872,0.578525641025641,48.59374999999999,1005.6249999999987,25.785256410256377,0
4339,4,3,2,53,0.05454545454545454,0.03636363636363636,0.9636363636363636,55,1700,1200,500,0.7058823529411765,22,12,10,333.20629317502755,0.46582491582491586,0.328137444532939,0.17331065434196352,126628.33067611624,-2513.5313558661587,124114.79932025008,1237,0,200.74545454545455,42,13,19,39.992699207342504,0.576140873015873,48.376937984496124,1006.4922480620156,23.964101144333704,7
4340,4,2,1,54,0.03636363636363636,0.01818181818181818,0.9818181818181818,55,1950,1500,450,0.7692307692307693,24,15,9,332.1894962971336,0.4666245791245791,0.3340259740259741,0.17394174412408986,126901.11340679541,-2568.9566115702287,124332.15679522518,1238,0,201.16363636363636,43,12,21,39.738408521303285,0.5775193798449613,48.106060606060616,1007.5757575757591,23.431994362226956,0
4341,4,2,1,55,0.03571428571428571,0.017857142857142856,0.9821428571428571,56,1650,1400,250,0.8484848484848485,19,14,5,326.55278407659364,0.46768804112554113,0.34102040816326507,0.1731719309497088,127415.40310650901,-2877.568194722896,124537.8349117861,1239,0,198.39285714285714,38,18,18,39.35383597883599,0.5904605263157895,47.596153846153854,1009.6153846153858,26.568825910931206,0
4342,4,0,0,55,0.0,0.0,1.0,55,1450,900,550,0.6206896551724138,20,9,11,330.21839861199635,0.46585297418630756,0.3405276978867071,0.175232683059067,127442.37075617308,-2583.236882716022,124859.13387345706,1240,1,203.0,38,17,19,39.233723062815216,0.590734649122807,47.56944444444446,1009.7222222222242,26.571637426900637,0
4343,4,1,1,55,0.017857142857142856,0.017857142857142856,0.9821428571428571,56,1650,1100,550,0.6666666666666666,22,11,11,326.0547905050373,0.46536120129870134,0.3484950132740181,0.17516866915691595,127938.8211898509,-2856.986891896328,125081.83429795457,1241,0,200.35714285714286,40,16,21,38.83161727774987,0.5924479166666667,47.07825203252034,1011.686991869921,25.292174796748025,0
4344,4,0,0,55,0.0,0.0,1.0,55,1950,1400,550,0.717948717948718,25,14,11,330.3841645530917,0.46360830527497193,0.3460181050542488,0.17735547937949603,127907.3364257817,-2548.288302951347,125359.04812283035,1242,1,204.94545454545454,39,16,21,38.75426921360656,0.59375,47.10937500000002,1011.5625000000036,25.937500000000092,0
4345,4,2,2,55,0.03508771929824561,0.03508771929824561,0.9649122807017544,57,1800,1400,400,0.7777777777777778,22,14,8,317.10098150117074,0.4652908312447786,0.34605060877579863,0.1724517551522728,128427.65239771326,-3254.8733479962657,125172.77904971699,1243,0,198.71929824561403,40,17,17,38.560047790923065,0.5973958333333333,46.595528455284565,1013.617886178864,25.340447154471597,0
4346,4,0,2,53,0.0,0.03636363636363636,0.9636363636363636,55,1500,800,700,0.5333333333333333,22,8,14,326.00177736803033,0.46440796857463523,0.3428251058223306,0.17708940770595044,128381.94580078148,-2629.4514973958026,125752.49430338568,1244,1,206.29090909090908,39,16,18,38.3810643437147,0.5985576923076923,46.640625000000014,1013.4375000000018,25.98557692307697,0
4347,4,0,3,50,0.0,0.05660377358490566,0.9433962264150944,53,1650,1300,350,0.7878787878787878,20,13,7,314.89463514817544,0.4644412191582003,0.16399097871695512,0.17313913856706897,128863.62234199709,-2481.700452408652,126381.92188958844,1245,2,212.22641509433961,46,7,14,38.17267673680841,0.5935235507246377,46.16578014184396,1015.3368794326217,22.072540857230905,7
4348,4,0,1,49,0.0,0.02,0.98,50,1050,700,350,0.6666666666666666,14,7,7,321.93540925170333,0.4605102040816327,0.17807786997355723,0.17715331827714115,128895.62864368972,-1700.786608367656,127194.84203532207,1246,5,223.52,44,6,15,37.961422145223544,0.5963541666666667,46.134259259259245,1015.4629629629608,23.078703703703653,0
4349,4,1,1,49,0.02,0.02,0.98,50,1350,900,450,0.6666666666666666,18,9,9,314.4316044074171,0.4624319727891157,0.17590163934426206,0.17436661698956782,129201.38888888895,-1873.1888717421093,127328.20001714684,1247,0,217.68,40,10,16,37.8415300546448,0.6052083333333333,45.833333333333336,1016.6666666666672,25.41666666666668,0
4350,4,1,2,48,0.02,0.04,0.96,50,1300,900,400,0.6923076923076923,17,9,8,319.1614406864168,0.4613095238095238,0.177067940345063,0.1782404583561215,129478.90216561173,-1735.065409265545,127743.83675634618,1248,0,218.34,41,9,13,37.43978864086819,0.6064532520325203,45.56051587301588,1017.7579365079374,24.823364305071646,0
4351,4,0,1,47,0.0,0.020833333333333332,0.9791666666666666,48,1450,800,650,0.5517241379310345,21,8,13,326.92750520958555,0.45934914302600477,0.1734106277837386,0.181876707049044,129327.49438027527,-1143.856981449984,128183.63739882529,1249,2,228.20833333333334,41,7,17,37.39586381221757,0.6049288617886179,45.7093253968254,1017.1626984126984,24.80884630274874,0
4352,4,1,0,48,0.020833333333333332,0.0,1.0,48,1450,1000,450,0.6896551724137931,19,10,9,325.23235109733105,0.45780695921985815,0.18968315803142488,0.18268521778268015,129706.17992567384,-1163.0708301839384,128543.10909548991,1250,0,228.9375,41,7,16,37.054846773146345,0.608739837398374,45.33730158730158,1018.6507936507926,24.845141308555917,0
4353,4,0,2,46,0.0,0.041666666666666664,0.9583333333333334,48,1950,1300,650,0.6666666666666666,26,13,13,337.47474519742394,0.45726211583924353,0.09206484132665271,0.18202788379953747,128098.67937408132,-943.9080583048643,127154.77131577645,1251,1,229.9375,45,3,12,38.379488785492725,0.587037037037037,46.920289855072475,1012.3188405797121,22.49597423510471,8
4354,4,2,3,45,0.041666666666666664,0.0625,0.9375,48,1250,900,350,0.72,16,9,7,336.2895532957527,0.45519355791962174,0.11957201572551845,0.18306190080185117,128465.72411258129,-959.6638048729335,127506.06030770835,1252,0,230.20833333333334,45,3,12,38.034980343102205,0.5907407407407408,46.55797101449275,1013.7681159420282,22.528180354267292,0
4355,4,3,3,45,0.0625,0.0625,0.9375,48,900,600,300,0.6666666666666666,12,6,6,333.4557925290339,0.4552951388888889,0.13306745500520645,0.182886547003809,128764.33460834093,-1012.5573507404143,127751.77725760051,1253,0,223.47916666666666,45,3,13,37.80259928603303,0.59375,46.26358695652173,1014.9456521739107,22.554347826086904,0
4356,4,2,0,47,0.0425531914893617,0.0,1.0,47,1150,700,450,0.6086956521739131,16,7,9,370.45594393501005,0.45453669441874806,0.1474150022718741,0.19654238995960902,127433.6059570314,203.546797670868,127637.15275470227,1254,0,228.61702127659575,39,8,16,38.227006602702986,0.5889423076923077,47.57812500000001,1009.6875000000011,25.889423076923105,8
4357,4,0,1,46,0.0,0.02127659574468085,0.9787234042553191,47,1600,1100,500,0.6875,21,11,10,377.8118604465428,0.45330326857847675,0.1454649910863277,0.20175610797538873,127696.68104383713,249.06412760420085,127945.74517144133,1255,1,229.61702127659575,39,8,17,37.77107166168539,0.5916132478632479,47.31770833333335,1010.7291666666692,25.916132478632544,0
4358,4,0,1,45,0.0,0.021739130434782608,0.9782608695652174,46,1250,600,650,0.48,19,6,13,387.55078688949504,0.4534722222222222,0.1548855593344971,0.20689788058547587,127685.20801373407,696.9005679743323,128382.1085817084,1256,2,235.5,38,8,17,37.536777660324184,0.5932017543859649,47.32905982905985,1010.683760683764,26.59694107062537,0
4359,4,3,2,46,0.0625,0.041666666666666664,0.9583333333333334,48,1250,800,450,0.64,17,8,9,386.88424530868735,0.45605237884160754,0.19893522322651291,0.21113817333662524,128566.75347222279,348.91495909130515,128915.66843131409,1257,0,226.0625,39,9,16,36.64920569706931,0.6004273504273504,46.458333333333364,1014.1666666666713,26.004273504273623,0
4360,4,0,0,46,0.0,0.0,1.0,46,1900,1700,200,0.8947368421052632,21,17,4,393.29145504466027,0.45450885668276975,0.20797437495417537,0.21396498425824237,128442.17985243663,903.0423606545812,129345.22221309121,1258,1,236.2608695652174,38,8,17,36.61445158797078,0.6008771929824561,46.5811965811966,1013.6752136752166,26.675663517768857,0
4361,4,0,0,46,0.0,0.0,1.0,46,1450,1200,250,0.8275862068965517,17,12,5,391.4347536368602,0.45396537842190016,0.21359296654990056,0.2139708109258488,128631.77237426066,870.1892258383039,129501.96160009896,1259,2,237.2608695652174,38,8,17,36.46721958925752,0.602796052631579,46.39423076923079,1014.4230769230794,26.695344129554723,0
4362,4,0,0,46,0.0,0.0,1.0,46,1500,1000,500,0.6666666666666666,20,10,10,396.43409812411653,0.4539553140096619,0.2050424898065646,0.21759216442964951,128794.3915392835,1011.6976906640507,129806.08922994755,1260,3,238.2608695652174,38,8,17,36.17382380802019,0.6044407894736843,46.233974358974365,1015.0641025641037,26.712213225371148,0
4363,4,1,1,46,0.02127659574468085,0.02127659574468085,0.9787234042553191,47,1450,1000,450,0.6896551724137931,19,10,9,391.97335360001614,0.4543632439099599,0.21367292166750662,0.2172213491074709,129174.91455078148,726.6248914930852,129901.53944227457,1261,0,234.17021276595744,39,8,18,35.8977396932746,0.6065705128205128,45.859375000000014,1016.5625000000018,26.065705128205174,0
4364,4,1,1,46,0.02127659574468085,0.02127659574468085,0.9787234042553191,47,1700,1400,300,0.8235294117647058,20,14,6,393.65768549702557,0.4552304964539007,0.2269403323246617,0.20515342925928645,126708.03098560724,655.35055101648,127363.38153662372,1262,0,231.04255319148936,40,7,15,38.389312270784984,0.5799479166666667,48.29776422764228,1006.808943089432,25.1702235772358,8
4365,4,1,1,46,0.02127659574468085,0.02127659574468085,0.9787234042553191,47,1150,1000,150,0.8695652173913043,13,10,3,393.301960059171,0.4563482886216466,0.2269721767594104,0.2061663500310174,126945.49606393864,585.5824845261841,127531.07854846482,1263,0,229.2340425531915,42,5,16,38.15324519230769,0.5793650793650793,48.062015503875976,1007.7519379844975,23.994093761535655,0
4366,4,0,3,43,0.0,0.06521739130434782,0.9347826086956522,46,1250,700,550,0.56,18,7,11,381.7318162798702,0.45615942028985507,0.23931998086487072,0.1949949267253591,125886.98459201398,436.68658523188634,126323.67117724587,1264,1,235.17391304347825,39,7,19,39.537488755103446,0.5731837606837606,49.114583333333336,1003.5416666666674,25.731837606837626,7
4367,4,1,1,43,0.022727272727272728,0.022727272727272728,0.9772727272727273,44,1450,1000,450,0.6896551724137931,19,10,9,386.88666010562895,0.4552611874559549,0.25669500953591884,0.19758854426823166,125878.7319175129,940.1604339796644,126818.89235149256,1265,0,245.52272727272728,37,7,20,39.41670308857809,0.5765765765765766,49.12280701754385,1003.508771929823,27.121858700806026,0
4368,4,4,3,44,0.0851063829787234,0.06382978723404255,0.9361702127659575,47,1400,900,500,0.6428571428571429,19,9,10,363.5844528888399,0.4598943879124268,0.25692195802122586,0.18998218340369064,126815.75701177276,-178.02785472454138,126637.72915704822,1266,0,229.93617021276594,37,10,20,39.035398069526074,0.5861486486486487,48.190789473684205,1007.2368421052624,27.22261735419628,0
4369,4,2,0,46,0.043478260869565216,0.0,1.0,46,1200,700,500,0.5833333333333334,17,7,10,374.3638554173526,0.4569041867954911,0.2720112339896208,0.19612457718234652,126921.74437951499,302.98271244221155,127224.7270919572,1267,0,235.8695652173913,36,10,22,38.654820444047104,0.5891203703703703,48.085585585585605,1007.6576576576604,27.990490490490565,0
4370,4,1,2,45,0.02127659574468085,0.0425531914893617,0.9574468085106383,47,1400,1000,400,0.7142857142857143,18,10,8,364.35447798365675,0.45923913043478265,0.26268149551326503,0.1922344812412563,127208.74592764069,-129.9564877064138,127078.78943993428,1268,0,231.82978723404256,35,12,23,38.61193972770383,0.594047619047619,47.80092592592593,1008.796296296297,28.822751322751344,0
4371,4,1,2,44,0.021739130434782608,0.043478260869565216,0.9565217391304348,46,1150,1000,150,0.8695652173913043,13,10,3,362.2017026115966,0.45734702093397744,0.27691133221982,0.19282582486587246,127572.62613378682,41.40447845804985,127614.03061224487,1269,0,236.3695652173913,34,12,18,38.29272723701783,0.5998774509803921,47.44047619047619,1010.2380952380951,29.71288515406162,0
4372,4,2,0,46,0.043478260869565216,0.0,1.0,46,1950,1500,450,0.7692307692307693,24,15,9,358.38729724104934,0.4543075684380032,0.2790123646260174,0.1926586742094672,127963.79145408154,-27.880527210894172,127935.91092687065,1270,0,236.3913043478261,34,12,21,37.98829274032239,0.6038602941176471,47.05357142857142,1011.7857142857135,29.758403361344516,0
4373,4,0,2,44,0.0,0.043478260869565216,0.9565217391304348,46,1200,700,500,0.5833333333333334,17,7,10,355.98391581241896,0.45421698872785826,0.27776527569646503,0.1916541651881807,128024.02388038542,-85.10133219955827,127938.92254818586,1271,1,237.3913043478261,34,12,21,37.9874426538054,0.6044730392156863,46.99404761904761,1012.023809523809,29.76540616246497,0
4374,4,3,3,44,0.06382978723404255,0.06382978723404255,0.9361702127659575,47,1150,900,250,0.782608695652174,14,9,5,344.78388326831094,0.45415124884366326,0.2645839576465887,0.18830504393884642,128596.93877550992,-532.3129251701071,128064.62585033981,1272,0,231.70212765957447,34,13,20,37.68583724569638,0.6102941176470589,46.42857142857141,1014.285714285712,29.831932773109173,0
4375,4,1,0,45,0.022222222222222223,0.0,1.0,45,900,700,200,0.7777777777777778,11,7,4,353.6862934803443,0.4522727272727273,0.2708613628734473,0.19293039410348356,128548.11137843598,93.14100946748289,128641.25238790346,1273,0,241.35555555555555,33,12,22,37.509944612285985,0.6120580808080809,46.476715686274495,1014.0931372549003,30.73009506833031,0
4376,4,0,1,44,0.0,0.022222222222222223,0.9777777777777777,45,1450,1000,450,0.6896551724137931,19,10,9,352.5334255320047,0.4515361952861953,0.27369381702030604,0.19290312161133263,128672.41753472207,72.26562499998062,128744.68315972206,1274,1,242.35555555555555,33,12,22,37.412303216974664,0.6133207070707071,46.35416666666666,1014.5833333333321,30.74494949494946,0
4377,4,0,1,43,0.0,0.022727272727272728,0.9772727272727273,44,1550,1100,450,0.7096774193548387,20,11,9,353.2412919998401,0.4508566772374912,0.2657057719535083,0.19389646266631352,128796.78376405689,299.2684604478808,129096.05222450478,1275,2,235.6818181818182,33,11,22,37.26747052195261,0.6145833333333333,46.23161764705881,1015.073529411763,30.759803921568576,0
4378,4,0,0,43,0.0,0.0,1.0,43,750,700,50,0.9333333333333333,8,7,1,360.3951317431164,0.44984311554079,0.26918734911509823,0.19696697200164615,128624.38303489445,671.1202938475753,129295.50332874202,1276,3,242.04651162790697,32,11,22,37.261949215832715,0.615234375,46.401515151515156,1014.3939393939398,31.69981060606062,0
4379,4,2,0,45,0.044444444444444446,0.0,1.0,45,1150,700,450,0.6086956521739131,16,7,9,341.53951309643793,0.45199915824915826,0.26452746223211143,0.18925411436278267,129171.13272392274,-176.59084467122574,128994.54187925151,1277,0,232.24444444444444,34,11,24,37.18331576687355,0.6161151960784313,45.86309523809523,1016.5476190476178,29.898459383753465,0
4380,4,1,2,44,0.021739130434782608,0.043478260869565216,0.9565217391304348,46,1650,1500,150,0.9090909090909091,18,15,3,330.1947369106755,0.4530193236714976,0.2499258556260746,0.18475781843933214,129554.63927469133,-644.3479938271678,128910.29128086417,1278,0,228.17391304347825,35,11,17,37.08219645293313,0.6178571428571429,45.48611111111111,1018.0555555555554,29.087301587301585,0
4381,4,1,2,43,0.022222222222222223,0.044444444444444446,0.9555555555555556,45,1550,1300,250,0.8387096774193549,18,13,5,329.66616149136865,0.4521885521885522,0.23919504096756694,0.1851558319901428,129701.96926708258,-448.32993076987896,129253.6393363127,1279,0,223.2,35,10,18,36.9462040298451,0.6193452380952381,45.34143518518519,1018.63425925926,29.103835978836003,0
4382,4,0,0,43,0.0,0.0,1.0,43,1550,1100,450,0.7096774193548387,20,11,9,347.3472380740475,0.4510889627168697,0.24707657593343813,0.19430393984384603,129544.24267409174,399.36698024799,129943.60965433973,1280,1,231.11627906976744,33,10,18,36.65620861923679,0.6221590909090908,45.49632352941177,1018.0147058823534,30.848930481283436,0
4383,4,0,0,43,0.0,0.0,1.0,43,1350,800,550,0.5925925925925926,19,8,11,351.3787089049467,0.45106589147286824,0.2014245622097126,0.18931696977882487,128054.14540816328,457.76514343482836,128511.9105515981,1281,2,232.11627906976744,34,9,20,38.07314945503019,0.6047794117647058,46.964285714285715,1012.1428571428573,29.768907563025216,8
4384,4,2,2,43,0.044444444444444446,0.044444444444444446,0.9555555555555556,45,1400,900,500,0.6428571428571429,19,9,10,337.773775479819,0.45519781144781146,0.20231930344853843,0.18496331602945493,128701.7763658479,-305.55112943454185,128396.22523641335,1282,0,222.75555555555556,35,10,19,37.756763050834564,0.6092261904761904,46.32523148148148,1014.6990740740739,28.99140211640211,0
4385,4,0,2,41,0.0,0.046511627906976744,0.9534883720930233,43,1800,1300,500,0.7222222222222222,23,13,10,359.68922274079546,0.4518733850129199,0.15448343202562853,0.1951783973780204,128338.88942992063,632.4230772929981,128971.31250721363,1283,1,229.02325581395348,37,6,17,37.571578653103906,0.6016328828828829,46.68311403508771,1013.2675438596482,27.385609293504004,8
4386,4,1,1,41,0.023809523809523808,0.023809523809523808,0.9761904761904762,42,1350,900,450,0.6666666666666666,18,9,9,358.99972009814985,0.4509412504839334,0.16469604589539788,0.19671654289569984,128728.04763244433,842.666613765744,129570.71424621007,878,0,204.76190476190476,37,5,16,37.19149558797046,0.6055743243243243,46.29934210526314,1014.8026315789452,27.427098150782303,0
4387,4,1,0,42,0.023809523809523808,0.0,1.0,42,1050,800,250,0.7619047619047619,13,8,5,355.41113309094396,0.4513162988772745,0.1745547609030993,0.1960121260689494,128984.243735846,768.4872434070811,129752.73097925309,879,0,205.33333333333334,38,4,17,37.02123650259429,0.606359649122807,46.04700854700853,1015.8119658119634,26.73189383715693,0
4388,4,0,1,41,0.0,0.023809523809523808,0.9761904761904762,42,1450,1200,250,0.8275862068965517,17,12,5,351.71996775060427,0.4495620402632598,0.16491022638563568,0.1950447093889716,129201.38888888898,688.7242950544285,129890.11318394341,880,1,206.33333333333334,37,5,17,36.89378415300545,0.6103603603603603,45.833333333333336,1016.6666666666674,27.4774774774775,0
4389,4,2,2,41,0.046511627906976744,0.046511627906976744,0.9534883720930233,43,1150,800,350,0.6956521739130435,15,8,7,347.42275104844873,0.44783591731266154,0.19203243227421107,0.1950723503236696,129690.63321827743,411.4953155818533,130102.12853385929,881,0,202.1860465116279,38,5,17,36.505532829872045,0.6134868421052632,45.3525641025641,1018.5897435897434,26.80499325236167,0
4390,4,0,1,40,0.0,0.024390243902439025,0.975609756097561,41,1200,700,500,0.5833333333333334,17,7,10,356.84862475483123,0.44357215447154474,0.20729213427103588,0.20057353736219818,129731.44531249999,1058.8975694444432,130790.34288194442,882,1,212.1951219512195,37,4,17,36.224011588275395,0.6157094594594594,45.3125,1018.7499999999999,27.533783783783782,0
4391,4,0,1,39,0.0,0.025,0.975,40,1700,1300,400,0.7647058823529411,21,13,8,358.747327222922,0.4427350427350427,0.20008564482263202,0.20201024045054314,129803.15778193761,1313.3071838730925,131116.4649658107,883,2,211.925,36,4,17,36.10274615979666,0.6183449074074074,45.24211711711713,1019.0315315315337,28.30643143143149,0
4392,4,0,0,39,0.0,0.0,1.0,39,1250,1000,250,0.8,15,10,5,372.7357945723499,0.44213900134952766,0.21713187437207893,0.20997688235505702,129819.89354263124,1877.704234182109,131697.59777681335,884,3,217.92307692307693,35,4,17,35.7293441226576,0.6205357142857143,45.22569444444445,1019.0972222222227,29.117063492063508,0
4393,4,0,0,39,0.0,0.0,1.0,39,1250,900,350,0.72,16,9,7,372.01887157131563,0.4419421952316689,0.21326950738715422,0.20973099763489164,129849.38298396787,1861.2841863854737,131710.66717035335,885,4,218.92307692307693,35,4,17,35.71759784995079,0.6208333333333333,45.19675925925927,1019.2129629629638,29.120370370370395,0
4394,4,1,1,39,0.025,0.025,0.975,40,950,500,450,0.5263157894736842,14,5,9,363.3238251164307,0.44147970085470084,0.19242900372439475,0.20979020869626158,130779.59183673469,1578.3399798962785,132357.93181663097,886,0,214.425,34,6,17,34.99500504345127,0.6323529411764706,44.285714285714285,1022.8571428571428,30.084033613445374,8
4395,4,0,0,39,0.0,0.0,1.0,39,1250,1000,250,0.8,15,10,5,372.3644750104737,0.4412393162393162,0.20168154995038923,0.21509524380016765,130794.81336805549,1940.6684027777685,132735.48177083326,887,1,220.28205128205127,33,6,17,34.748387644263396,0.6347853535353536,44.27083333333333,1022.9166666666661,30.99747474747473,0
4396,4,0,0,39,0.0,0.0,1.0,39,1400,1300,100,0.9285714285714286,15,13,2,374.6731208210346,0.44064889788573997,0.20539232396939888,0.21678072666214956,130857.49959450695,2005.7575511822401,132863.2571456892,888,2,221.28205128205127,33,6,17,34.62577853635165,0.6354166666666667,44.20955882352941,1023.1617647058827,31.004901960784323,0
4397,4,0,0,39,0.0,0.0,1.0,39,1500,1100,400,0.7333333333333333,19,11,8,380.7709497324078,0.43988978857399913,0.1538286335006529,0.2106836616005214,129113.15164448309,2032.507474922848,131145.65911940593,889,3,222.28205128205127,35,4,15,36.245515886573294,0.6133928571428571,45.92013888888889,1016.3194444444449,29.037698412698425,7
4398,4,0,0,39,0.0,0.0,1.0,39,850,600,250,0.7058823529411765,11,6,5,384.26041388092915,0.43943994601889336,0.160651852889504,0.2134078379492946,129260.23046339149,2133.917931241411,131394.1483946329,890,4,223.28205128205127,35,4,17,36.00662038090901,0.6148809523809524,45.775462962962955,1016.898148148147,29.05423280423277,0
4399,4,1,0,40,0.025,0.0,1.0,40,1150,800,350,0.6956521739130435,15,8,7,379.57703857166126,0.44017094017094016,0.17225785050862408,0.2129587305733316,129659.75265806349,1843.1729871763641,131502.92564523985,891,0,218.675,36,4,14,35.71820175438596,0.6168981481481481,45.38288288288288,1018.4684684684686,28.290790790790794,0
4400,4,1,0,41,0.024390243902439025,0.0,1.0,41,1100,700,400,0.6363636363636364,15,7,8,379.85933660652773,0.44085365853658537,0.19481792496841788,0.2158101945335988,130150.67737188366,1687.7899930747953,131838.46736495846,892,0,214.3170731707317,37,4,16,35.211154094132816,0.6199324324324325,44.901315789473685,1020.3947368421054,27.578236130867715,0
4401,4,1,1,41,0.023809523809523808,0.023809523809523808,0.9761904761904762,42,600,200,400,0.3333333333333333,10,2,8,376.0754903279697,0.44284746418892756,0.20674351938436075,0.21567061503792906,130514.5588666704,1416.7134358648668,131931.27230253528,893,0,210.1904761904762,37,5,16,34.937918052723816,0.6235923423423424,44.54495614035087,1021.8201754385956,27.61676149834042,0
4402,4,0,0,41,0.0,0.0,1.0,41,1150,500,650,0.43478260869565216,18,5,13,352.1858146280095,0.4423526422764228,0.13159077665861973,0.19617955073385335,129377.95380015443,1030.0351897806281,130407.98898993505,894,1,216.02439024390245,35,6,21,36.70221843003413,0.6160714285714286,45.65972222222223,1017.361111111112,29.06746031746034,8
4403,4,0,1,40,0.0,0.024390243902439025,0.975609756097561,41,1050,800,250,0.7619047619047619,13,8,5,354.4274708277859,0.441869918699187,0.1319771206561624,0.19826883269079146,129545.08562616697,982.8674113302811,130527.95303749725,895,2,217.02439024390245,36,5,20,36.47515671091445,0.6157407407407407,45.49549549549551,1018.0180180180201,28.278278278278336,0
4404,4,0,0,40,0.0,0.0,1.0,40,1100,600,500,0.5454545454545454,16,6,10,360.56667708689514,0.44095886752136754,0.15771973466003342,0.2024410673029776,129688.42734203815,1352.2650606687973,131040.69240270695,896,3,222.65,36,4,20,36.17306983600517,0.6171875,45.35472972972974,1018.5810810810824,28.293918918918955,0
4405,4,1,1,40,0.024390243902439025,0.024390243902439025,0.975609756097561,41,850,600,250,0.7058823529411765,11,6,5,355.45405353152523,0.44275914634146346,0.1638885901709859,0.2009341789537785,129954.9515836605,1038.602863381056,130993.55444704155,897,0,218.1951219512195,37,4,21,36.03243628347135,0.6179617117117118,45.09320175438597,1019.6271929824572,27.557491702228575,0
4406,4,1,0,41,0.024390243902439025,0.0,1.0,41,1150,700,450,0.6086956521739131,16,7,9,358.18307173781295,0.44418191056910566,0.17417559088550205,0.20349521767961498,130150.67737188392,1123.5538819637125,131274.23125384763,898,0,218.78048780487805,37,4,22,35.764112758793615,0.6199324324324325,44.9013157894737,1020.3947368421075,27.57823613086777,0
4407,4,0,1,40,0.0,0.024390243902439025,0.975609756097561,41,950,600,350,0.631578947368421,13,6,7,356.6847147022072,0.44433434959349594,0.17302140368342456,0.2032273374466067,130262.58680555575,1092.5347222222472,131355.12152777798,899,1,219.78048780487805,37,4,22,35.68877551020409,0.6210585585585586,44.79166666666668,1020.833333333335,27.590090090090133,0
4408,4,2,2,40,0.047619047619047616,0.047619047619047616,0.9523809523809523,42,1600,1200,400,0.75,20,12,8,345.2101274239528,0.4483885017421603,0.1661663807890219,0.1992648557308563,130766.77439212095,628.4029701446933,131395.17736226565,900,0,209.71428571428572,37,5,18,35.47116209262437,0.6261261261261262,44.2982456140351,1022.807017543862,27.643432906590863,0
4409,4,0,0,40,0.0,0.0,1.0,40,1550,1300,250,0.8387096774193549,18,13,5,355.1755841235781,0.4467815170940171,0.18140778897316823,0.2043821455741738,130646.86381440764,1280.5152338391654,131927.3790482468,901,1,220.3,35,5,18,35.337772180082254,0.6288690476190476,44.41550925925926,1022.3379629629635,29.2096560846561,0
4410,4,0,1,39,0.0,0.025,0.975,40,1500,1000,500,0.6666666666666666,20,10,10,354.1261533810957,0.44595352564102564,0.1771188772702259,0.2047890581455922,130838.01442912505,1266.6325531612672,132104.6469822863,902,2,221.3,36,4,19,35.17106952852688,0.6287615740740741,44.2286036036036,1023.0855855855854,28.41904404404404,0
4411,4,1,2,38,0.025,0.05,0.95,40,1050,600,450,0.5714285714285714,15,6,9,345.5711207078908,0.44587339743589743,0.10928224649674512,0.19660458675302053,130205.11379200162,1085.3395625355283,131290.45335453714,903,0,211.375,36,4,19,36.030655779911,0.6223958333333333,44.84797297297298,1020.6081081081094,28.35022522522526,8
4412,4,0,0,38,0.0,0.0,1.0,38,950,300,650,0.3157894736842105,16,3,13,350.86382329095164,0.44332325746799434,0.11931475701386351,0.19975907408669485,130233.05047850228,1538.8132019461646,131771.86368044844,904,1,221.23684210526315,35,3,20,35.86727992591752,0.624702380952381,44.820601851851855,1020.717592592593,29.1633597883598,0
4413,4,0,0,38,0.0,0.0,1.0,38,850,500,350,0.5882352941176471,12,5,7,354.8336191556711,0.4427157420578473,0.1198891772979136,0.20248888566188902,130323.35778061223,1648.6250893425722,131971.9828699548,905,2,222.23684210526315,34,4,20,35.67438109673157,0.6277573529411764,44.732142857142854,1021.0714285714286,30.031512605042018,0
4414,4,0,1,37,0.0,0.02631578947368421,0.9736842105263158,38,1200,800,400,0.6666666666666666,16,8,8,357.3409956364869,0.4422415836889521,0.1201399665110805,0.20455924506715764,130444.94224773237,1722.665107709742,132167.6073554421,906,3,223.23684210526315,34,4,21,35.48707415608126,0.6289828431372548,44.613095238095234,1021.5476190476186,30.0455182072829,0
4415,4,0,0,37,0.0,0.0,1.0,37,800,600,200,0.75,10,6,4,375.54572411432974,0.44006506506506504,0.12345256649054126,0.20698682933743265,128959.43877551005,2286.033163265286,131245.47193877533,907,4,229.1891891891892,34,3,16,36.53524964838255,0.6139705882352942,46.07142857142856,1015.7142857142844,29.873949579831894,8
4416,4,2,2,37,0.05128205128205128,0.05128205128205128,0.9487179487179487,39,1150,900,250,0.782608695652174,14,9,5,356.32013949557955,0.4450348627980207,0.12115022934803887,0.19918229690170325,129516.42679419275,1429.8622524551506,130946.2890466479,908,0,218.3846153846154,36,3,15,36.4561437474647,0.6154513888888888,45.523648648648646,1017.9054054054047,28.275150150150132,0
4417,4,1,0,38,0.02631578947368421,0.0,1.0,38,800,600,200,0.75,10,6,4,361.0871490611878,0.4424045756282598,0.1402292387025763,0.20234679856307825,129613.56122470844,1760.3582604595317,131373.91948516798,909,0,224.8421052631579,35,3,16,36.23598166249907,0.618452380952381,45.42824074074074,1018.2870370370365,29.093915343915327,0
4418,4,0,0,38,0.0,0.0,1.0,38,1200,800,400,0.6666666666666666,16,8,8,362.4350486507725,0.442345305832148,0.142681621695953,0.2038668200174278,129760.92470689707,1805.9814118226757,131566.90611871975,910,1,225.8421052631579,35,3,17,36.05174845696542,0.6199404761904762,45.2835648148148,1018.865740740739,29.110449735449688,0
4419,4,0,0,38,0.0,0.0,1.0,38,1250,800,450,0.64,17,8,9,360.9735359761933,0.4423897581792318,0.1270211611502987,0.19238699444885,127617.73003472202,1622.7319369427046,129240.46197166471,911,2,226.8421052631579,35,3,13,38.2774914089347,0.5982142857142857,47.39583333333332,1010.4166666666649,28.86904761904757,8
4420,4,0,1,37,0.0,0.02631578947368421,0.9736842105263158,38,650,300,350,0.46153846153846156,10,3,7,360.6282587159474,0.44188596491228066,0.132109361814982,0.19248202659582192,127676.20991940988,1608.7298525376912,129284.93977194758,912,3,227.8421052631579,35,3,14,38.226255916933894,0.5988095238095238,47.33796296296295,1010.6481481481459,28.87566137566131,0
4421,4,1,1,37,0.02631578947368421,0.02631578947368421,0.9736842105263158,38,1450,1000,450,0.6896551724137931,19,10,9,356.732395875274,0.4438418681839735,0.14698800982327742,0.1920731569909725,128027.37054183798,1534.3021262002594,129561.67266803824,913,0,228.26315789473685,35,3,16,37.96508081732237,0.6023809523809525,46.99074074074073,1012.0370370370358,28.91534391534388,0
4422,4,1,0,38,0.02631578947368421,0.0,1.0,38,1150,900,250,0.782608695652174,14,9,5,362.2248441559047,0.4453977003319109,0.15493387709616435,0.18099011768487766,124971.84843204684,1453.5816644346946,126425.43009648153,914,0,217.47368421052633,36,2,19,40.973551826406876,0.5691550925925926,50.02815315315315,999.8873873873868,27.774649649649632,8
4423,4,3,1,40,0.07317073170731707,0.024390243902439025,0.975609756097561,41,950,600,350,0.631578947368421,13,6,7,342.40894340101136,0.45193089430894307,0.16450756011871848,0.1748910932770906,125882.96402449036,420.6937111627732,126303.65773565313,915,0,202.4878048780488,38,3,17,40.52818588310445,0.5748355263157895,49.11858974358974,1003.5256410256401,26.40856950067474,0
4424,4,4,1,43,0.09090909090909091,0.022727272727272728,0.9772727272727273,44,1400,700,700,0.5,21,7,14,327.39473447736054,0.4561420894996477,0.18547325567182882,0.17101997232099403,126803.33251953124,-496.84586684849637,126306.48665268274,916,0,189.5909090909091,39,5,19,39.95942789671459,0.5825320512820513,48.203125,1007.1874999999999,25.82532051282051,0
4425,4,1,1,43,0.022727272727272728,0.022727272727272728,0.9772727272727273,44,1000,600,400,0.6,14,6,8,326.281139621684,0.4561200669485553,0.19207188160676547,0.17109864638698066,126960.75439453124,-515.0200737847225,126445.73432074652,917,0,190.54545454545453,39,5,20,39.82611972437553,0.5841346153846154,48.046875,1007.8124999999999,25.84134615384615,0
4426,4,1,1,43,0.022727272727272728,0.022727272727272728,0.9772727272727273,44,1350,1100,250,0.8148148148148148,16,11,5,320.42864400118856,0.457551532769556,0.19605497701472951,0.16966959346292454,127354.73632812513,-638.3789062499852,126716.35742187515,918,0,190.52272727272728,39,5,13,39.570433436532504,0.5881410256410257,47.65625000000001,1009.375000000001,25.881410256410284,0
4427,4,1,1,43,0.022727272727272728,0.022727272727272728,0.9772727272727273,44,1550,1000,550,0.6451612903225806,21,10,11,323.0825292319218,0.45700096899224807,0.2016289363617607,0.17152037450023294,127459.90125868075,-563.9865451388692,126895.91471354188,919,0,191.5,39,5,15,39.39593219173373,0.5892094017094017,47.55208333333334,1009.7916666666682,25.892094017094056,0
4428,4,1,0,44,0.022727272727272728,0.0,1.0,44,850,500,350,0.5882352941176471,12,5,7,325.4688572992395,0.4562301797040169,0.2155120721801127,0.173804310532445,127696.681043837,-487.7414279513689,127208.93961588563,920,0,192.22727272727272,39,5,16,39.093686660483016,0.5916132478632479,47.31770833333334,1010.7291666666682,25.91613247863252,0
4429,4,2,2,44,0.043478260869565216,0.043478260869565216,0.9565217391304348,46,1150,600,550,0.5217391304347826,17,6,11,316.0482726103943,0.4575583735909823,0.21690714634656905,0.17121571637937075,128273.18395135221,-1091.112395314311,127182.0715560379,921,0,184.82608695652175,40,6,20,38.74398073836275,0.5958333333333333,46.74796747967482,1013.0081300813049,25.325203252032622,0
4430,4,3,2,45,0.06382978723404255,0.0425531914893617,0.9574468085106383,47,900,500,400,0.5555555555555556,13,5,8,311.01267926423185,0.4583911501695961,0.23133121781199595,0.16996817987582982,128622.09590143958,-1399.3794682224434,127222.71643321714,922,0,181.61702127659575,41,6,18,38.516605541972304,0.5978150406504066,46.403769841269856,1014.384920634923,24.741095625242025,0
4431,4,0,0,45,0.0,0.0,1.0,45,1300,900,400,0.6923076923076923,17,9,8,327.01600357032964,0.4558712121212121,0.22954511711835202,0.1776403516882045,128381.94580078151,-603.4098307291374,127778.53597005237,923,1,190.48888888888888,39,6,18,38.35536797204236,0.5985576923076923,46.640625000000014,1013.437500000002,25.985576923076977,0
4432,4,1,0,46,0.021739130434782608,0.0,1.0,46,1200,900,300,0.75,15,9,6,323.61314727670015,0.4580414653784219,0.23743692887710455,0.1774807524356073,128762.6529037777,-866.1425284222189,127896.51037535549,924,0,187.32608695652175,40,6,20,38.054053603017245,0.60078125,46.26524390243903,1014.9390243902454,25.373475609756134,0
4433,4,0,0,46,0.0,0.0,1.0,46,950,300,650,0.3157894736842105,16,3,13,325.3764676201991,0.45754830917874395,0.2390216629901798,0.17914529151122047,128917.41569378354,-810.6613333663726,128106.75436041717,925,1,188.32608695652175,40,6,20,37.85191300577069,0.60234375,46.112804878048784,1015.5487804878055,25.388719512195138,0
4434,4,1,1,46,0.02127659574468085,0.02127659574468085,0.9787234042553191,47,1250,700,550,0.56,18,7,11,321.31281709873855,0.45800570459451123,0.2433509340564648,0.17806881756683476,129176.17517203647,-1098.8078506865622,128077.36732134991,926,0,185.29787234042553,41,6,21,37.692231059497104,0.6034044715447154,45.858134920634924,1016.5674603174609,24.794328300425875,0
4435,4,0,1,45,0.0,0.021739130434782608,0.9782608695652174,46,1200,600,600,0.5,18,6,12,319.19479370117205,0.4581018518518518,0.13516474184782612,0.1761074723868534,128999.74804736694,-750.6651155832851,128249.08293178366,927,1,189.58695652173913,41,5,15,37.925211588541664,0.6016260162601625,46.031746031746025,1015.8730158730147,24.777390631049137,8
4436,4,0,2,43,0.0,0.044444444444444446,0.9555555555555556,45,1250,800,450,0.64,17,8,9,328.33001147637935,0.45662878787878786,0.14833933573429392,0.18112509904624105,128994.8319452707,-529.4250694031285,128465.40687586757,928,2,194.66666666666666,40,5,15,37.698204281712684,0.603125,46.03658536585366,1015.8536585365855,25.396341463414636,0
4437,4,1,0,44,0.022727272727272728,0.0,1.0,44,1200,800,400,0.6666666666666666,16,8,8,326.35291919884014,0.45507399577167024,0.18383646978853352,0.1813422623869253,129280.82817925353,-361.59961989649037,128919.22855935704,929,0,199.72727272727272,39,5,17,37.457855338181574,0.6076388888888888,45.755208333333336,1016.9791666666671,26.0763888888889,0
4438,4,0,2,42,0.0,0.045454545454545456,0.9545454545454546,44,900,600,300,0.6666666666666666,12,6,6,333.2331348282051,0.45514006342494717,0.23056463801329619,0.17614845145456476,127285.5725439559,-175.71365858965112,127109.85888536625,930,1,200.72727272727272,37,7,17,39.31813448513167,0.5909346846846847,47.72478070175439,1009.100877192983,27.272996680891435,8
4439,4,0,1,41,0.0,0.023809523809523808,0.9761904761904762,42,1600,1100,500,0.6875,21,11,10,350.84777162304033,0.45323993418505615,0.24575132335829863,0.1852416732427644,127237.93730977793,528.2293542095348,127766.16666398746,931,2,210.73809523809524,35,7,18,38.92262724178808,0.5943452380952381,47.77199074074074,1008.9120370370368,28.826058201058196,0
4440,4,0,0,41,0.0,0.0,1.0,41,1350,1200,150,0.8888888888888888,15,12,3,357.5389225999499,0.4538109756097561,0.24867869866499626,0.18945652994634024,127383.9444551611,908.9436514060255,128292.88810656712,932,3,214.1951219512195,35,6,17,38.60400901933807,0.5958333333333333,47.62731481481481,1009.4907407407401,28.842592592592574,0
4441,4,1,0,42,0.023809523809523808,0.0,1.0,42,1150,700,450,0.6086956521739131,16,7,9,352.1025428237354,0.45424409601238874,0.24593269445063526,0.18785780138526756,127660.40322417009,589.9105186267326,128250.31374279682,933,0,210.07142857142858,36,6,18,38.45785974296115,0.5966435185185186,47.3536036036036,1010.5855855855854,28.071821821821814,0
4442,4,2,1,43,0.045454545454545456,0.022727272727272728,0.9772727272727273,44,1550,1000,550,0.6451612903225806,21,10,11,336.6091559651016,0.4558447850599014,0.1631413141314133,0.1789343408025014,127512.49999999999,-128.39461082704366,127384.10538917294,934,0,201.47727272727272,39,5,14,39.000618811881196,0.5897435897435898,47.5,1009.9999999999999,25.897435897435894,8
4443,4,0,0,43,0.0,0.0,1.0,43,1500,900,600,0.6,21,9,12,347.5013342918451,0.4546419342930971,0.17418834906746494,0.18472439349198086,127512.49999999999,262.1527777777776,127774.65277777777,935,1,207.13953488372093,39,4,14,38.72559130913092,0.5897435897435898,47.5,1009.9999999999999,25.897435897435894,0
4444,4,0,1,42,0.0,0.023255813953488372,0.9767441860465116,43,1500,1000,500,0.6666666666666666,20,10,10,352.53563178237397,0.4537421557770395,0.16971184263501948,0.18838137504494268,127723.00347222232,405.3819444444543,128128.38541666677,936,2,208.13953488372093,39,4,14,38.38279747183292,0.5918803418803419,47.29166666666667,1010.8333333333342,25.91880341880344,0
4445,4,1,2,41,0.023255813953488372,0.046511627906976744,0.9534883720930233,43,1450,1100,350,0.7586206896551724,18,11,7,354.66534790155544,0.45309616094499816,0.17630372595722266,0.1908905182749924,128012.7292209202,480.33582899305975,128493.06504991326,937,0,207.13953488372093,39,4,16,38.03235975295934,0.5948183760683761,47.005208333333336,1011.9791666666672,25.948183760683776,0
4446,4,0,0,41,0.0,0.0,1.0,41,1150,800,350,0.6956521739130435,15,8,7,338.6922873093756,0.44913617886178864,0.11184182522453523,0.17483845101646148,126319.25207756231,399.0568086454451,126718.30888620776,938,1,217.73170731707316,37,4,15,40.172338568935444,0.5810810810810811,48.68421052631579,1005.2631578947367,27.169274537695586,7
4447,4,2,1,42,0.046511627906976744,0.023255813953488372,0.9767441860465116,43,850,400,450,0.47058823529411764,13,4,9,328.88198265309734,0.453234588409007,0.1297171512228894,0.1723512621985953,126934.51063368077,-250.70529513886316,126683.8053385419,939,0,208.5581395348837,39,4,17,39.78748880159878,0.5838675213675213,48.07291666666668,1007.7083333333351,25.83867521367526,0
4448,4,1,0,43,0.023255813953488372,0.0,1.0,43,1250,1000,250,0.8,15,10,5,327.57117013667005,0.45381136950904394,0.1428763466671783,0.1732265008888682,127302.17013888911,-259.8958333333126,127042.2743055558,940,0,209.2325581395349,39,4,18,39.44398568676026,0.5876068376068376,47.70833333333334,1009.1666666666684,25.87606837606842,0
4449,4,0,1,42,0.0,0.023255813953488372,0.9767441860465116,43,1250,1100,150,0.88,14,11,3,327.92027120640495,0.45371908453303805,0.14259214375361395,0.1737493356075054,127381.02349175369,-245.83604600692456,127135.18744574676,941,1,210.2325581395349,39,4,13,39.35449128056958,0.5884081196581197,47.63020833333334,1009.4791666666684,25.884081196581242,0
4450,4,0,1,41,0.0,0.023809523809523808,0.9761904761904762,42,1500,1000,500,0.6666666666666666,20,10,10,336.1644206084383,0.451945412311266,0.1473297753856544,0.17815017444358586,127388.43831041355,164.69211136679723,127553.13042178034,942,3,216.21428571428572,38,4,14,39.13884185275337,0.5901864035087719,47.62286324786325,1009.5085470085477,26.56601439496178,0
4451,4,2,0,43,0.046511627906976744,0.0,1.0,43,1250,1100,150,0.88,14,11,3,330.04483469922604,0.4550110741971207,0.16605479760425124,0.17717332171167444,127907.3364257815,-156.96885850691405,127750.36756727459,943,0,210.8372093023256,39,4,16,38.762850547489116,0.59375,47.109375000000014,1011.5625000000019,25.93750000000005,0
4452,4,0,0,43,0.0,0.0,1.0,43,1500,600,900,0.4,24,6,18,329.4831630586191,0.4551264304171281,0.16780995489908945,0.17723737734060915,127990.23321311738,-165.87462406633978,127824.35858905103,944,1,211.8372093023256,40,3,16,38.69241906866194,0.59296875,47.027439024390254,1011.8902439024405,25.29725609756101,0
4453,4,2,2,43,0.044444444444444446,0.044444444444444446,0.9555555555555556,45,800,500,300,0.625,11,5,6,315.4858660636611,0.4584175084175084,0.16968360562627338,0.17190619801841348,128504.92147737811,-891.5168096040481,127613.40466777407,945,0,203.37777777777777,40,5,16,38.52235140823895,0.5981770833333333,46.51930894308944,1013.9227642276442,25.348069105691103,0
4454,4,1,1,43,0.022727272727272728,0.022727272727272728,0.9772727272727273,44,2000,1700,300,0.85,23,17,6,321.1702000928408,0.45861962649753346,0.17168320436109696,0.1756247377150016,128645.9974500869,-536.5478515624943,128109.4495985244,946,0,206.75,39,5,18,38.234696409624526,0.6012286324786325,46.380208333333336,1014.4791666666674,26.012286324786345,0
4455,4,1,2,42,0.022727272727272728,0.045454545454545456,0.9545454545454546,44,1600,1300,300,0.8125,19,13,6,322.06095030972546,0.45911513389711067,0.18005558249710907,0.17716987266474063,128883.87586805562,-498.3072916666615,128385.56857638896,947,0,207.13636363636363,39,5,19,37.97018191765832,0.6036324786324787,46.145833333333336,1015.4166666666672,26.0363247863248,0
4456,4,1,0,43,0.023255813953488372,0.0,1.0,43,1550,1200,350,0.7741935483870968,19,12,7,317.39331900675967,0.45930232558139533,0.16409313754669919,0.17683859365311003,129386.78521050338,-386.30913628472626,129000.47607421866,948,0,203.93023255813952,39,4,20,37.57817565953383,0.6087072649572649,45.651041666666664,1017.3958333333326,26.08707264957263,0
4457,4,1,1,43,0.022727272727272728,0.022727272727272728,0.9772727272727273,44,1500,1000,500,0.6666666666666666,20,10,10,312.7277019107987,0.45973176532769555,0.1804852837168811,0.17594881814577276,129770.27253123143,-683.4481789939864,129086.82435223744,949,0,200.27272727272728,40,4,16,37.30841478821728,0.6109375,45.27439024390244,1018.9024390243904,25.47256097560976,0
4458,4,1,2,42,0.022727272727272728,0.045454545454545456,0.9545454545454546,44,800,600,200,0.75,10,6,4,316.8343781319441,0.4595005285412262,0.18967477465235305,0.17932504143000905,130003.3578413147,-562.0933926564859,129441.26444865821,950,0,201.22727272727272,40,4,17,36.967904002657356,0.61328125,45.045731707317074,1019.8170731707319,25.495426829268297,0
4459,4,0,0,42,0.0,0.0,1.0,42,1250,700,550,0.56,18,7,11,326.1358205137762,0.4573654665118079,0.1869934726420468,0.18368374968832887,129811.04736328124,67.20648871527749,129878.25385199652,951,1,210.47619047619048,39,3,18,36.92555538519202,0.6129807692307692,45.234375,1019.0624999999999,26.12980769230769,0
4460,4,1,1,42,0.023255813953488372,0.023255813953488372,0.9767441860465116,43,1400,1000,400,0.7142857142857143,18,10,8,320.5507287392497,0.4588639719453673,0.18972982113941672,0.1819111795259089,130107.0184434695,-258.8200847709676,129848.19835869853,952,0,206.5581395348837,40,3,19,36.76827041205964,0.6143229166666666,44.94410569105691,1020.2235772357724,25.50558943089431,0
4461,4,0,1,41,0.0,0.023809523809523808,0.9761904761904762,42,650,400,250,0.6153846153846154,9,4,5,327.95879789824437,0.4579824816105304,0.19460006224712156,0.18584331880900504,130049.99999999999,130.20833333333235,130180.20833333331,953,1,211.61904761904762,39,3,19,36.63705065359478,0.6153846153846154,45.0,1019.9999999999999,26.15384615384615,0
4462,4,0,3,38,0.0,0.07317073170731707,0.926829268292683,41,950,400,550,0.42105263157894735,15,4,11,329.45548512057957,0.4587906504065041,0.18416831005343948,0.18679578218119303,130071.79578493666,370.5733161662465,130442.36910110292,954,2,214.85365853658536,38,3,19,36.57681364334589,0.6173245614035088,44.97863247863247,1020.085470085469,26.844354475933393,0
4463,4,1,1,38,0.02564102564102564,0.02564102564102564,0.9743589743589743,39,1100,700,400,0.6363636363636364,15,7,8,351.56230912726886,0.4538911381016644,0.21456491773303799,0.19942410509605069,130090.2058096949,1346.9626298595995,131437.16843955452,955,0,225.23076923076923,36,3,20,35.99436104058578,0.6212384259259259,44.96058558558559,1020.1576576576582,28.33771271271273,0
4464,4,1,1,38,0.02564102564102564,0.02564102564102564,0.9743589743589743,39,1000,700,300,0.7,13,7,6,343.1511424504607,0.4538911381016644,0.19695723102934481,0.19609563395609503,130377.57087746533,1147.9566137083063,131525.52749117365,956,0,219.4102564102564,36,3,22,35.917686624765686,0.6241319444444444,44.679054054054056,1021.2837837837841,28.368993993994003,0
4465,4,0,0,38,0.0,0.0,1.0,38,1100,900,200,0.8181818181818182,13,9,4,353.7634223371323,0.45236190137505927,0.20291164838311415,0.20202295632883596,130351.21588059393,1622.6984471450387,131973.91432773895,957,1,225.73684210526315,35,3,22,35.673452907174436,0.6258928571428571,44.7048611111111,1021.1805555555538,29.17658730158725,0
4466,4,0,0,38,0.0,0.0,1.0,38,950,600,350,0.631578947368421,13,6,7,354.9216984554442,0.45193219535324797,0.20336012209954002,0.2034577112964062,130498.99798525347,1663.385202331928,132162.3831875854,958,2,226.73684210526315,35,3,16,35.49407189246338,0.6273809523809524,44.56018518518517,1021.7592592592569,29.193121693121626,0
4467,4,0,0,38,0.0,0.0,1.0,38,1050,500,550,0.47619047619047616,16,5,11,351.79120224098904,0.45088015647226176,0.20273795514228854,0.20253090203842355,130665.2529852488,1593.3772877607312,132258.63027300953,959,3,227.73684210526315,36,2,16,35.405652237764784,0.627025462962963,44.39752252252252,1022.4099099099102,28.400275275275284,0
4468,4,1,1,38,0.02564102564102564,0.02564102564102564,0.9743589743589743,39,1150,700,450,0.6086956521739131,16,7,9,345.5026437543736,0.4524010346378768,0.20658932612660164,0.20059780361261376,130991.17036011073,1251.559133579552,132242.72949369028,960,0,222.87179487179486,37,2,20,35.236807340759775,0.6283783783783784,44.07894736842105,1023.6842105263152,27.667140825035546,0
4469,4,0,0,38,0.0,0.0,1.0,38,1150,900,250,0.782608695652174,14,9,5,350.5684205575387,0.4517395685158843,0.21016536196900337,0.2029469293202821,130878.9483302553,1576.4052400738499,132455.35357032914,961,1,229.6315789473684,37,1,20,35.220656522360336,0.6272522522522522,44.18859649122806,1023.2456140350864,27.655286865813146,0
4470,4,0,0,38,0.0,0.0,1.0,38,1350,1100,250,0.8148148148148148,16,11,5,349.4787387224662,0.45135431484115696,0.205114328237046,0.20290631248214785,130991.17036011054,1555.7258002462042,132546.89616035676,962,2,230.6315789473684,37,1,20,35.13505069980006,0.6283783783783784,44.07894736842104,1023.6842105263137,27.667140825035506,0
4471,4,0,1,37,0.0,0.02631578947368421,0.9736842105263158,38,1100,800,300,0.7272727272727273,14,8,6,351.22725125980713,0.45034672830725464,0.2156993125211324,0.20451761388819165,131103.44048168647,1609.42020621728,132712.86068790374,963,3,231.6315789473684,37,1,20,34.9768022840828,0.6295045045045045,43.96929824561403,1024.1228070175423,27.6789947842579,0
4472,4,0,0,37,0.0,0.0,1.0,37,700,500,200,0.7142857142857143,9,5,4,358.13361314129224,0.44785410410410414,0.22339369072042348,0.207882154754428,130982.06948502545,1981.8163602791838,132963.88584530464,964,4,238.59459459459458,36,1,20,34.92276310964429,0.6302083333333333,44.08783783783783,1023.6486486486477,28.434684684684658,0
4473,4,0,0,37,0.0,0.0,1.0,37,900,400,500,0.4444444444444444,14,4,10,355.2823549358809,0.4469469469469469,0.21840334011856832,0.20700147457667106,131126.20380092924,1917.3652960392726,133043.5690969685,965,5,239.59459459459458,36,1,20,34.84996334982591,0.6316550925925926,43.94707207207207,1024.2117117117111,28.45032532532531,0
4474,4,0,0,37,0.0,0.0,1.0,37,1300,800,500,0.6153846153846154,18,8,10,354.3905131882381,0.44654029029029024,0.2147962427144663,0.20694768221993504,131212.72243527306,1900.1088081324456,133112.8312434055,966,6,240.59459459459458,36,1,21,34.785346596321524,0.6325231481481481,43.86261261261261,1024.549549549549,28.459709709709696,0
4475,4,1,0,38,0.02631578947368421,0.0,1.0,38,1100,700,400,0.6363636363636364,15,7,8,347.3664571958477,0.4457236842105263,0.21556854220860222,0.20440647700329365,131506.1366705247,1536.2656117547792,133042.40228227948,967,0,235.23684210526315,35,3,22,34.66909275558565,0.6375,43.57638888888889,1025.6944444444446,29.30555555555556,0
4476,4,0,1,37,0.0,0.02631578947368421,0.9736842105263158,38,900,800,100,0.8888888888888888,10,8,2,348.6627293715511,0.4450865339023234,0.21748588794643675,0.20596884885659844,131654.57182623883,1580.6084694358665,133235.18029567468,968,1,236.23684210526315,35,3,16,34.486133040111284,0.6389880952380953,43.43171296296296,1026.2731481481478,29.32208994708994,0
4477,4,0,1,36,0.0,0.02702702702702703,0.972972972972973,37,700,500,200,0.7142857142857143,9,5,4,357.01593154532844,0.4447572572572573,0.22624881453720413,0.2102479867964284,131535.8170037081,1992.0764478309436,133527.89345153904,969,9,243.59459459459458,35,2,22,34.39168923238933,0.6377976190476191,43.54745370370371,1025.810185185186,29.308862433862455,0
4478,4,1,0,37,0.02702702702702703,0.0,1.0,37,850,400,450,0.47058823529411764,13,4,9,351.98663643956553,0.44572697697697694,0.21248835041938507,0.2090715804394047,131862.52170138896,1882.7690972222308,133745.29079861118,970,0,236.51351351351352,35,2,17,34.19117647058823,0.6410714285714285,43.22916666666667,1027.083333333334,29.345238095238113,0
4479,4,0,0,37,0.0,0.0,1.0,37,1500,1200,300,0.8,18,12,6,349.70318291795365,0.4438188188188188,0.20822037843314423,0.2091860857818306,132130.12695312512,1841.2651909722367,133971.39214409736,971,1,237.51351351351352,35,2,20,33.98028537656198,0.64375,42.96875000000001,1028.125000000001,29.375000000000025,0
4480,4,0,0,37,0.0,0.0,1.0,37,1650,1400,250,0.8484848484848485,19,14,5,381.26752794309755,0.4442254754754755,0.23630087919244547,0.21209922801124068,129326.01042868129,2634.087700643983,131960.09812932526,972,2,238.51351351351352,33,4,18,36.01556224899598,0.619949494949495,45.71078431372549,1017.1568627450981,30.822935234699944,8
4481,4,0,0,37,0.0,0.0,1.0,37,1100,800,300,0.7272727272727273,14,8,6,379.5608783547458,0.44394394394394393,0.23257373745266796,0.21131689143009696,129357.17520004333,2419.784608083442,131776.95980812676,973,3,239.51351351351352,33,4,18,36.02716038228328,0.6202651515151515,45.680147058823536,1017.2794117647065,30.826648841354743,0
4482,4,0,0,37,0.0,0.0,1.0,37,1200,1000,200,0.8333333333333334,14,10,4,379.3235525460821,0.44284909909909914,0.23568831989884598,0.2119749264228109,129504.1454081635,2424.794501133813,131928.9399092973,974,4,240.51351351351352,34,3,17,35.88328460038987,0.6194852941176471,45.5357142857143,1017.8571428571448,29.936974789916025,0
4483,4,0,1,36,0.0,0.02702702702702703,0.972972972972973,37,1150,900,250,0.782608695652174,14,9,5,384.5618114169838,0.4418793793793794,0.24244702968107124,0.21556629979429118,129625.34722222235,2569.7916666666756,132195.13888888902,975,5,241.51351351351352,34,3,17,35.6263638843426,0.6207107843137255,45.41666666666667,1018.3333333333344,29.950980392156893,0
4484,4,0,0,36,0.0,0.0,1.0,36,1050,700,350,0.6666666666666666,14,7,7,388.2821640338631,0.4406084656084656,0.25104266923323704,0.21806765861145058,129700.23548635133,2872.0576220684206,132572.29310841975,976,6,248.16666666666666,33,3,17,35.45526547962784,0.6237373737373737,45.343137254901954,1018.6274509803916,30.867498514557322,0
4485,4,0,0,36,0.0,0.0,1.0,36,950,600,350,0.631578947368421,13,6,7,388.42277310564907,0.43989748677248675,0.2457182744846571,0.21901777653692747,129856.32216274976,2887.8305519511537,132744.1527147009,977,7,249.16666666666666,33,3,17,35.29254839485392,0.6253156565656566,45.18995098039215,1019.2401960784302,30.88606654783122,0
4486,4,0,0,36,0.0,0.0,1.0,36,850,600,250,0.7058823529411765,11,6,5,390.3456823486128,0.43999669312169315,0.24908509302667303,0.2204538853671492,129918.78311526799,2942.64720900613,132861.43032427412,978,8,250.16666666666666,33,3,17,35.17988440117,0.6259469696969697,45.128676470588225,1019.4852941176456,30.893493761140775,0
4487,4,0,0,36,0.0,0.0,1.0,36,1150,800,350,0.6956521739130435,15,8,7,394.0645622005868,0.4389880952380953,0.2544521873790171,0.2232674847648387,130043.75007509111,3049.126688052647,133092.87676314375,979,9,251.16666666666666,33,3,17,34.957722575994225,0.627209595959596,45.00612745098038,1019.9754901960769,30.908348187759906,0
4488,4,0,0,36,0.0,0.0,1.0,36,1850,1400,450,0.7567567567567568,23,14,9,391.26019089005405,0.4380952380952381,0.24993129414351278,0.22311212295747368,130294.81207274769,2996.0185824254318,133290.83065517314,980,10,252.16666666666666,32,4,17,34.77357984994641,0.6321614583333333,44.76010101010101,1020.9595959595961,31.904987373737377,0
4489,4,0,0,36,0.0,0.0,1.0,36,1050,800,250,0.7619047619047619,13,8,5,390.9677357630997,0.43811177248677247,0.252445021359597,0.22350091975884884,130391.51178770013,2995.7748252729193,133387.28661297305,981,11,253.16666666666666,32,4,17,34.68264515597313,0.6331380208333333,44.665404040404034,1021.338383838383,31.91682449494947,0
4490,4,0,1,35,0.0,0.027777777777777776,0.9722222222222222,36,1200,1000,200,0.8333333333333334,14,10,4,393.7597118223565,0.4365244708994709,0.26109052227026286,0.22622319852391595,130585.01882779814,3083.8238763901563,133668.84270418828,982,12,254.16666666666666,32,4,17,34.41450483837759,0.6350911458333333,44.4760101010101,1022.0959595959592,31.940498737373726,0
4491,4,0,0,35,0.0,0.0,1.0,35,1450,1200,250,0.8275862068965517,17,12,5,392.64182906552435,0.43546918767507004,0.25241211437038147,0.22633495897520853,130714.10323245073,3264.764915569839,133978.86814802056,983,13,258.9428571428571,32,3,17,34.311849199489664,0.6363932291666667,44.349747474747474,1022.6010101010097,31.956281565656553,0
4492,4,0,0,35,0.0,0.0,1.0,35,1100,800,300,0.7272727272727273,14,8,6,387.5084914567858,0.43452380952380953,0.24807966863488162,0.22450009458593628,130907.84940631059,3145.580648658303,134053.4300549689,984,14,259.9428571428571,32,3,17,34.24634998971828,0.6383463541666667,44.160353535353536,1023.3585858585859,31.97995580808081,0
4493,4,0,0,35,0.0,0.0,1.0,35,1050,600,450,0.5714285714285714,15,6,9,384.80844830262026,0.4336134453781513,0.2482709106138563,0.2241006412867594,131108.39468293445,3090.3235834775023,134198.71826641195,985,15,260.9428571428571,33,2,17,34.11199692872242,0.6379419191919191,43.96446078431372,1024.142156862745,31.034610814022574,0
4494,4,0,1,34,0.0,0.02857142857142857,0.9714285714285714,35,1250,1000,250,0.8,15,10,5,384.68062116975335,0.4332983193277311,0.24793795059281787,0.22494401078471862,131265.326136582,3099.045439254121,134364.37157583612,986,16,261.9428571428571,33,2,17,33.95619070397831,0.639520202020202,43.811274509803916,1024.7549019607836,31.053178847296472,0
4495,4,0,0,34,0.0,0.0,1.0,34,850,600,250,0.7058823529411765,11,6,5,391.0471361997899,0.43189245395127746,0.2377327178253339,0.22884856557560887,131295.77219480163,3468.567142383439,134764.33933718505,987,17,255.7941176470588,32,2,17,33.76221715740627,0.6422526041666667,43.78156565656566,1024.8737373737379,32.02730429292931,0
4496,4,0,0,34,0.0,0.0,1.0,34,1250,1000,250,0.8,15,10,5,391.61820259124397,0.43176247771836,0.23945524361636994,0.22977658175882693,131394.86524793843,3491.3281771859797,134886.19342512442,988,18,256.79411764705884,31,3,17,33.647129794259605,0.6458333333333333,43.68489583333334,1025.2604166666674,33.07291666666669,0
4497,4,0,0,34,0.0,0.0,1.0,34,850,500,350,0.5882352941176471,12,5,7,391.23168894399475,0.43116830065359474,0.23740029277327968,0.22995080463603781,131461.622450087,3486.390516493079,134948.01296658008,989,19,257.79411764705884,31,3,17,33.589385474860336,0.646505376344086,43.61979166666668,1025.5208333333348,33.08131720430112,0
4498,4,0,0,34,0.0,0.0,1.0,34,1100,800,300,0.7272727272727273,14,8,6,390.6619598546731,0.43049985145573383,0.23520453866825952,0.23042037751907374,131595.18771701396,3481.846788194464,135077.03450520843,990,20,258.79411764705884,31,3,16,33.468697123519476,0.6478494623655914,43.48958333333334,1026.0416666666674,33.09811827956992,0
4499,4,0,0,34,0.0,0.0,1.0,34,750,500,250,0.6666666666666666,10,5,5,395.8885838719158,0.4297756981580511,0.24225073669290165,0.23452903710218315,131762.23966810445,3632.6332939995746,135394.872962104,991,21,259.79411764705884,31,3,16,33.16542485732403,0.6495295698924731,43.32682291666667,1026.692708333334,33.11911962365593,0
4500,4,0,1,33,0.0,0.029411764705882353,0.9705882352941176,34,1150,800,350,0.6956521739130435,15,8,7,396.57855097186723,0.43010992275698157,0.2460201471893102,0.23576550027257434,131895.95752292217,3661.421542697487,135557.37906561967,992,22,260.79411764705884,31,3,17,33.01234313601216,0.6508736559139785,43.196614583333336,1027.2135416666672,33.13592069892475,0
4501,4,0,0,33,0.0,0.0,1.0,33,900,600,300,0.6666666666666666,12,6,6,397.3647792973133,0.42960858585858586,0.2374952975409017,0.23727666927178462,132063.20020887593,3895.4528808593845,135958.6530897353,993,23,263.75757575757575,31,2,17,32.82292458407229,0.6525537634408602,43.03385416666667,1027.864583333334,33.15692204301077,0
4502,4,0,0,33,0.0,0.0,1.0,33,1600,1400,200,0.875,18,14,4,401.369011376382,0.42830650252525254,0.24718066743383216,0.240943403485822,132264.0313042534,4017.336697048606,136281.368001302,994,24,264.75757575757575,31,2,17,32.5168776371308,0.6545698924731183,42.838541666666664,1028.645833333333,33.18212365591397,0
4503,4,0,0,33,0.0,0.0,1.0,33,1300,900,400,0.6923076923076923,17,9,8,403.52914334251,0.42803030303030304,0.24973440262644164,0.24245503890107764,132297.51798841692,4077.180820041237,136374.69880845817,995,25,265.75757575757575,31,2,17,32.427461713707125,0.6549059139784946,42.805989583333336,1028.776041666667,33.18632392473119,0
4504,4,0,0,33,0.0,0.0,1.0,33,1000,800,200,0.8,12,8,4,403.85955773833865,0.426925505050505,0.25135606539781064,0.24351714751499384,132431.50711059582,4096.745978461387,136528.2530890572,996,26,266.75757575757575,31,2,17,32.283496732026144,0.65625,42.67578125000001,1029.296875000001,33.20312500000003,0
4505,4,0,0,33,0.0,0.0,1.0,33,850,700,150,0.8235294117647058,10,7,3,406.2065293618134,0.4270833333333333,0.2553302371208286,0.2455872503205828,132532.04345703137,4167.076280381958,136699.11973741333,997,27,267.75757575757575,31,2,17,32.121480357443936,0.657258064516129,42.57812500000001,1029.687500000001,33.215725806451644,0
4506,4,0,0,33,0.0,0.0,1.0,33,1250,1000,250,0.8,15,10,5,405.3299031573282,0.42680713383838387,0.25248566075472056,0.24527576159688683,132565.56404961488,4146.557447645408,136712.1214972603,998,28,268.75757575757575,31,2,17,32.11017511695536,0.6575940860215054,42.54557291666667,1029.8177083333342,33.219926075268845,0
4507,4,0,0,33,0.0,0.0,1.0,33,750,600,150,0.8,9,6,3,414.27966408968405,0.4259785353535353,0.16430709671610932,0.2346810046645487,130037.12153096609,4174.347005407599,134211.4685363737,999,29,269.75757575757575,32,1,18,34.44901790872328,0.6295572916666667,45.012626262626256,1019.9494949494939,31.873421717171684,8
4508,4,1,0,34,0.029411764705882353,0.0,1.0,34,1000,500,500,0.5,15,5,10,398.44507379274376,0.4294229055258467,0.1802762109969629,0.21177157111416334,127506.12381708507,3373.5911832976326,130879.7150003827,1000,0,262.79411764705884,32,2,14,37.44582656165355,0.6038411458333333,47.506313131313135,1009.9747474747481,31.56171085858588,7
4509,4,0,0,34,0.0,0.0,1.0,34,1250,900,350,0.72,16,9,7,394.1101770793627,0.42879159239453357,0.1748282323547783,0.21046377368380922,127697.47865332628,3265.375184930121,130962.8538382564,1001,1,263.79411764705884,32,2,15,37.358421819696034,0.6057942708333333,47.3169191919192,1010.732323232324,31.585385101010125,0
4510,4,1,0,35,0.02857142857142857,0.0,1.0,35,950,600,350,0.631578947368421,13,6,7,386.842865017782,0.43186274509803924,0.17442443741027103,0.20841064723952138,128051.4874837803,2907.16085760285,130958.64834138316,1002,0,257.22857142857146,33,2,16,37.17850728498204,0.6070075757575757,46.966911764705884,1012.1323529411767,30.67067736185384,0
4511,4,1,0,36,0.027777777777777776,0.0,1.0,36,1200,800,400,0.6666666666666666,16,8,8,377.3019816909228,0.4334656084656085,0.1732375433925828,0.2051308475170187,128415.88010204064,2490.3132086167607,130906.1933106574,1003,0,251.05555555555554,34,2,14,37.04658014251038,0.6084558823529411,46.60714285714285,1013.5714285714271,29.810924369747855,0
4512,4,2,1,37,0.05263157894736842,0.02631578947368421,0.9736842105263158,38,800,600,200,0.75,10,6,4,369.5683162472963,0.44006341868183974,0.18523119634191842,0.20434953957203442,129086.92476260044,1941.2874868111307,131028.21224941156,1004,0,238.78947368421052,36,2,16,36.5569130466903,0.6111111111111112,45.945945945945944,1016.2162162162161,28.228228228228225,0
4513,4,1,0,38,0.02631578947368421,0.0,1.0,38,1200,700,500,0.5833333333333334,17,7,10,372.19127852117845,0.439900426742532,0.19498150467480246,0.20744899453663476,129401.8231702988,2032.4460017450021,131434.2691720438,1005,0,239.71052631578948,36,2,17,36.16906474820143,0.6142939814814814,45.63626126126127,1017.454954954956,28.262637637637667,0
4514,4,0,0,38,0.0,0.0,1.0,38,1150,900,250,0.782608695652174,14,9,5,376.2050669590411,0.43896692745376953,0.20355728924080085,0.2104513493384738,129545.08562616688,2147.1035224413786,131692.18914860825,1006,1,240.71052631578948,36,2,13,35.920907079646014,0.6157407407407407,45.495495495495504,1018.0180180180195,28.278278278278318,0
4515,4,1,1,38,0.02564102564102564,0.02564102564102564,0.9743589743589743,39,1150,800,350,0.6956521739130435,15,8,7,389.26438938888674,0.4435166441745389,0.20159407133355023,0.2088633659194135,127888.11404309717,2189.5123163704247,130077.6263594676,1007,0,235.51282051282053,36,3,15,37.28498663994656,0.5989583333333333,47.12837837837838,1011.4864864864867,28.09684684684685,8
4516,4,1,1,38,0.02564102564102564,0.02564102564102564,0.9743589743589743,39,800,400,400,0.5,12,4,8,364.0962088136755,0.44371345029239767,0.17536520473218298,0.19128574536188195,127036.73846760548,1450.9757736324389,128487.71424123792,1008,0,236.3846153846154,37,2,16,38.795228772387794,0.5884009009009009,47.97149122807018,1008.1140350877199,27.24632527264108,8
4517,4,4,2,40,0.09523809523809523,0.047619047619047616,0.9523809523809523,42,1250,900,350,0.72,16,9,7,333.89159405328405,0.45107433217189313,0.1657436500762801,0.17960878454827395,127990.23321311727,146.98462108599944,128137.21783420327,1009,0,215.9047619047619,40,2,16,38.58089786080145,0.59296875,47.02743902439025,1011.8902439024397,25.297256097560993,0
4518,4,1,1,40,0.024390243902439025,0.024390243902439025,0.975609756097561,41,900,600,300,0.6666666666666666,12,6,6,339.62515931765444,0.45147357723577236,0.17409120354328933,0.18267545944693783,127986.37695312512,493.478732638904,128479.85568576402,1010,0,222.02439024390245,39,2,17,38.439794797886236,0.594551282051282,47.03125000000001,1011.8750000000009,25.945512820512842,0
4519,4,1,0,41,0.024390243902439025,0.0,1.0,41,850,500,350,0.5882352941176471,12,5,7,339.54851055902714,0.44979674796747965,0.17384321991368035,0.1833561957018748,128144.53125000015,502.2569444444597,128646.7881944446,1011,0,222.85365853658536,39,2,18,38.28017832647465,0.5961538461538461,46.87500000000001,1012.5000000000011,25.961538461538492,0
4520,4,1,0,42,0.023809523809523808,0.0,1.0,42,1150,900,250,0.782608695652174,14,9,5,335.72339546651773,0.45210269066976383,0.18048807933735467,0.18285371058061678,128487.53390842033,227.25423177085236,128714.78814019119,1012,0,218.52380952380952,39,3,17,38.02709424980308,0.5996260683760684,46.53645833333334,1013.8541666666682,25.996260683760724,0
4521,4,0,4,38,0.0,0.09523809523809523,0.9047619047619048,42,1300,600,700,0.46153846153846156,20,6,14,331.92234957962177,0.45159456058846303,0.06171840517875582,0.17806442068608433,127880.99500868049,103.46679687499554,127984.46180555549,1013,1,219.52380952380952,39,3,16,38.742276004119475,0.593482905982906,47.135416666666664,1011.4583333333328,25.934829059829045,8
4522,4,0,3,35,0.0,0.07894736842105263,0.9210526315789473,38,750,400,350,0.5333333333333333,11,4,7,361.4073320395451,0.44117472735893787,0.0897672234126865,0.19160359146862946,127404.47108848726,1608.9819971999154,129013.45308568717,1014,5,243.3684210526316,36,2,16,38.4853132552519,0.5940393518518519,47.60698198198199,1009.5720720720731,28.043668668668698,0
4523,4,2,0,37,0.05405405405405406,0.0,1.0,37,650,200,450,0.3076923076923077,11,2,9,354.95498261254045,0.4380630630630631,0.12650346681760305,0.18978146985781885,127745.77100326687,1668.7995850580423,129414.57058832492,1015,0,247.32432432432432,36,1,18,38.29833648954737,0.5975115740740741,47.26914414414415,1010.9234234234242,28.08120620620623,0
4524,4,2,0,39,0.05128205128205128,0.0,1.0,39,700,400,300,0.5714285714285714,10,4,6,339.7567853921688,0.44258884390463343,0.13495246646997683,0.18399231093332677,128258.57688347125,916.587153031405,129175.16403650265,1016,0,235.5897435897436,36,3,20,38.15846766722254,0.6027199074074074,46.762387387387385,1012.9504504504499,28.137512512512497,0
4525,4,0,0,39,0.0,0.0,1.0,39,800,600,200,0.75,10,6,4,343.86340159154713,0.44258884390463343,0.14006378194440883,0.18648215938029838,128315.61872260776,1024.609026255985,129340.22774886375,1017,1,236.5897435897436,36,3,20,37.99623022488976,0.6032986111111112,46.70608108108108,1013.1756756756758,28.143768768768773,0
4526,4,1,0,40,0.025,0.0,1.0,40,800,400,400,0.5,12,4,8,334.4011687363041,0.44376335470085465,0.14239459459459503,0.18259804077985894,128588.99493113252,600.0620383194716,129189.056969452,1018,0,231.65,37,3,17,37.957207207207226,0.6041666666666667,46.436403508771924,1014.2543859649112,27.412280701754355,0
4527,4,2,1,41,0.047619047619047616,0.023809523809523808,0.9761904761904762,42,1050,700,350,0.6666666666666666,14,7,7,322.3806425019331,0.4464043747580333,0.15578091821044215,0.1781769500060259,129069.04432508672,-78.12771267361626,128990.91661241312,1019,0,221.57142857142858,39,3,19,37.77389800102513,0.6055021367521367,45.963541666666664,1016.1458333333327,26.055021367521352,0
4528,4,0,0,41,0.0,0.0,1.0,41,1100,900,200,0.8181818181818182,13,9,4,335.36805023435386,0.44392784552845527,0.16725398168808137,0.18521197199353695,129038.51290269563,455.07889546351277,129493.59179815913,1020,1,227.8780487804878,38,3,19,37.47502628811777,0.606907894736842,45.993589743589745,1016.0256410256413,26.737516869095824,0
4529,4,1,0,42,0.023809523809523808,0.0,1.0,42,1500,1200,300,0.8,18,12,6,332.9267612960763,0.44596883468834686,0.1736555829228248,0.18567069379973444,129424.4382887039,217.97727134062114,129642.41556004452,1021,0,223.42857142857142,37,5,20,37.14484554597702,0.6126126126126126,45.61403508771928,1017.5438596491202,27.501185395922167,0
4530,4,0,0,42,0.0,0.0,1.0,42,1200,900,300,0.75,15,9,6,335.2404515769263,0.4454969996128533,0.17706746672821017,0.18762553302542256,129563.94184989601,287.0148747691479,129850.95672466516,1022,1,224.42857142857142,37,5,16,36.94433225632741,0.6140202702702703,45.47697368421052,1018.092105263157,27.51600284495019,0
4531,4,0,0,42,0.0,0.0,1.0,42,1150,800,350,0.6956521739130435,15,8,7,349.8063130645283,0.44556958962446763,0.17121591150189253,0.18063032249255015,126331.65283203124,438.32194010416583,126769.9747721354,1023,2,225.42857142857142,39,3,18,39.880258522432904,0.577724358974359,48.671875,1005.3124999999999,25.777243589743588,8
4532,4,1,1,42,0.023255813953488372,0.023255813953488372,0.9767441860465116,43,1750,1500,250,0.8571428571428571,20,15,5,345.7680170983861,0.44758213362864524,0.18214159998122637,0.18053535560827208,126784.78109095109,167.62447121421735,126952.40556216531,1024,0,221.1627906976744,40,3,19,39.51585099226372,0.5807291666666667,48.22154471544715,1007.1138211382108,25.177845528455272,0
4533,4,1,2,41,0.023255813953488372,0.046511627906976744,0.9534883720930233,43,1000,700,300,0.7,13,7,6,332.99996827592315,0.44896640826873385,0.16215570265362267,0.17551910170677304,127168.88018251368,-130.18158420914455,127038.69859830453,1025,0,203.04651162790697,40,3,20,39.443534844668335,0.5846354166666667,47.84044715447154,1008.6382113821135,25.215955284552837,0
4534,4,0,0,41,0.0,0.0,1.0,41,950,400,550,0.42105263157894735,15,4,11,347.3123420531383,0.4470020325203252,0.16952227373513384,0.1827164929931728,127092.01388888898,628.1250000000075,127720.13888888899,1026,1,213.0731707317073,39,2,20,39.161501377410445,0.5854700854700854,47.91666666666667,1008.3333333333342,25.854700854700877,0
4535,4,2,1,42,0.046511627906976744,0.023255813953488372,0.9767441860465116,43,1400,1200,200,0.8571428571428571,16,12,4,337.11848629646164,0.45053525286083423,0.18882402313657698,0.18018901575448226,127733.27637525655,12.249756262848223,127745.5261315194,1027,0,204.11627906976744,40,3,20,38.76189638416945,0.5903645833333333,47.28150406504067,1010.8739837398408,25.27184959349602,0
4536,4,1,0,43,0.023255813953488372,0.0,1.0,43,800,600,200,0.75,10,6,4,338.4404908541852,0.4500507567368033,0.19569845732461144,0.18135817579375366,127836.0281268594,52.97762162077049,127889.00574848017,1028,0,205.04651162790697,40,3,21,38.623421431681926,0.59140625,47.17987804878051,1011.2804878048811,25.28201219512203,0
4537,4,3,3,43,0.06521739130434782,0.06521739130434782,0.9347826086956522,46,1200,900,300,0.75,15,9,6,324.62722972185486,0.452878421900161,0.21978890406922202,0.177397304322751,128619.580078125,-847.82919625595,127771.75088186905,1029,0,192.6086956521739,39,7,19,38.17390634627233,0.6009615384615384,46.40625,1014.375,26.009615384615383,0
4538,4,2,0,45,0.044444444444444446,0.0,1.0,45,1200,700,500,0.5833333333333334,17,7,10,329.97264048932993,0.45286195286195285,0.23685620177568123,0.18164332423096977,128910.32036675338,-492.62424045139414,128417.69612630199,1030,0,195.48888888888888,39,6,21,37.74243939549357,0.6038995726495726,46.119791666666664,1015.5208333333326,26.038995726495706,0
4539,4,0,0,45,0.0,0.0,1.0,45,1050,500,550,0.47619047619047616,16,5,11,329.5481499300439,0.45250420875420877,0.23497790533460927,0.1822603033286568,129095.50781249987,-491.3628472222376,128604.14496527764,1031,1,196.48888888888888,39,6,23,37.56491731583982,0.6057692307692308,45.93749999999999,1016.249999999999,26.05769230769228,0
4540,4,1,2,44,0.021739130434782608,0.043478260869565216,0.9565217391304348,46,1500,1100,400,0.7333333333333333,19,11,8,321.3553924230019,0.45281803542673105,0.23291416561281042,0.17868531045661656,129307.31336805537,-889.2361111111304,128418.07725694425,1032,0,193.19565217391303,39,7,24,37.55803632391097,0.607905982905983,45.72916666666666,1017.0833333333319,26.07905982905979,0
4541,4,0,1,43,0.0,0.022727272727272728,0.9772727272727273,44,1100,900,200,0.8181818181818182,13,9,4,332.23595807578636,0.45291578576462294,0.22988077496274295,0.1842399403874811,129201.38888888853,-214.9305555555935,128986.45833333294,1033,1,197.0,37,7,24,37.38900273224045,0.6103603603603603,45.833333333333314,1016.6666666666638,27.4774774774774,0
4542,4,1,1,43,0.022727272727272728,0.022727272727272728,0.9772727272727273,44,1500,1200,300,0.8,18,12,6,332.98988184859854,0.45540433403805497,0.22731192912305498,0.18518070407839302,129312.88954293601,-188.02323791938954,129124.86630501662,1034,0,197.6590909090909,37,7,25,37.25654017536294,0.6114864864864865,45.7236842105263,1017.1052631578925,27.489331436699796,0
4543,4,0,0,43,0.0,0.0,1.0,43,1150,800,350,0.6956521739130435,15,8,7,338.45289575653067,0.4545035068290882,0.22037922013718658,0.18823316222124278,129315.90374157931,153.46841774205137,129469.37215932137,1035,1,200.34883720930233,36,7,25,37.11456488042514,0.6134259259259259,45.72072072072071,1017.1171171171163,28.25325325325323,0
4544,4,0,0,43,0.0,0.0,1.0,43,1000,700,300,0.7,13,7,6,336.05880874971666,0.4544342930970838,0.2158412218638237,0.18728466584916623,129396.54659366321,96.96986091872117,129493.51645458193,1036,2,201.34883720930233,37,6,25,37.09350414915401,0.6123310810810811,45.64144736842104,1017.434210526314,27.498221906116594,0
4545,4,0,0,43,0.0,0.0,1.0,43,1250,900,350,0.72,16,9,7,339.91842790673536,0.4535806570690291,0.21601588617246947,0.19051432950934524,129619.76431450054,212.02930228531142,129831.79361678586,1037,3,202.34883720930233,37,6,18,36.768578837801954,0.6145833333333333,45.422149122807014,1018.3114035087714,27.52192982456139,0
4546,4,0,1,42,0.0,0.023255813953488372,0.9767441860465116,43,700,300,400,0.42857142857142855,11,3,8,338.0521608398838,0.4537421557770395,0.21697132905000993,0.18981091292387822,129690.63321827743,168.43976002629879,129859.07297830374,1038,4,203.34883720930233,38,5,18,36.74415250681771,0.6134868421052632,45.3525641025641,1018.5897435897434,26.80499325236167,0
4547,4,0,1,41,0.0,0.023809523809523808,0.9761904761904762,42,950,500,450,0.5263157894736842,14,5,9,345.789986561026,0.45108643050716224,0.22290083382049852,0.19366741949370855,129591.85157933211,562.312923207146,130154.16450253926,1039,7,209.0952380952381,37,5,18,36.64746212937039,0.6143018018018018,45.449561403508774,1018.2017543859649,27.51896633475581,0
4548,4,1,0,42,0.023809523809523808,0.0,1.0,42,750,500,250,0.6666666666666666,10,5,5,347.35736974250614,0.45062669376693765,0.22895113065133543,0.1955173856461,129787.30384589492,616.5152979763049,130403.81914387122,1040,0,209.9047619047619,37,5,19,36.4090130564224,0.6162725225225225,45.25767543859649,1018.9692982456143,27.53971076339498,0
4549,4,0,2,40,0.0,0.047619047619047616,0.9523809523809523,42,1000,900,100,0.9,11,9,2,352.5823559350579,0.4507234804490902,0.21520272483133618,0.18710027209108518,127442.37075617263,639.6480834914825,128082.01883966412,1041,1,210.9047619047619,35,7,17,38.669188445667146,0.5964285714285714,47.569444444444436,1009.7222222222206,28.849206349206302,8
4550,4,1,0,41,0.024390243902439025,0.0,1.0,41,1550,1100,450,0.7096774193548387,20,11,9,356.0697554454392,0.4515243902439024,0.23063157259767197,0.1902698737248094,127723.00347222213,895.6597222222169,128618.66319444435,1042,0,211.390243902439,34,7,20,38.29348722176424,0.6014093137254901,47.291666666666664,1010.8333333333326,29.730392156862724,0
4551,4,1,0,42,0.023809523809523808,0.0,1.0,42,950,600,350,0.631578947368421,13,6,7,349.56394134735723,0.4542803910181959,0.24189323078473213,0.18904897959580194,128204.80619331052,563.8499149659708,128768.6561082765,1043,0,207.33333333333334,34,8,21,37.96505818737512,0.6063112745098039,46.81547619047618,1012.738095238094,29.786414565826295,0
4552,4,0,0,42,0.0,0.0,1.0,42,1500,1000,500,0.6666666666666666,20,10,10,353.3159161977641,0.45401422764227645,0.2502167044151786,0.19223546494721772,128446.04768990907,676.4066043083685,129122.45429421744,1044,1,208.33333333333334,34,8,18,37.62355646897632,0.6087622549019608,46.57738095238094,1013.6904761904743,29.81442577030807,0
4553,4,1,0,43,0.023255813953488372,0.0,1.0,43,1150,700,450,0.6086956521739131,16,7,9,322.0815432400612,0.45348837209302323,0.20098963978361617,0.16911465512393228,127013.2500542534,-418.27528211805964,126594.97477213533,1045,0,204.46511627906978,39,4,18,39.878169026213364,0.5846688034188035,47.994791666666664,1008.0208333333327,25.846688034188016,8
4554,4,2,0,45,0.044444444444444446,0.0,1.0,45,1100,800,300,0.7272727272727273,14,8,6,311.30067264001354,0.4552188552188552,0.22263450834879417,0.16612976490392817,127670.36132812512,-1051.177300347208,126619.18402777791,1046,0,196.33333333333334,39,6,17,39.47854394282967,0.5913461538461539,47.34375000000001,1010.6250000000009,25.91346153846156,0
4555,4,0,0,45,0.0,0.0,1.0,45,1050,600,450,0.5714285714285714,15,6,9,307.89538155600525,0.45490319865319867,0.2178029652527338,0.1646349684849055,127749.32861328148,-1133.3143446180245,126616.01426866346,1047,1,197.33333333333334,39,6,17,39.48405031770567,0.5921474358974359,47.265625000000014,1010.9375000000018,25.921474358974404,0
4556,4,4,2,47,0.08163265306122448,0.04081632653061224,0.9591836734693877,49,1650,1100,550,0.6666666666666666,22,11,11,281.78443558796107,0.46001629818594103,0.16897473275024355,0.15241976288621512,128211.86057039369,-2524.940170135362,125686.92040025833,1048,0,182.14285714285714,46,3,18,39.673968545751656,0.5869565217391304,46.80851063829787,1012.7659574468073,22.016651248843637,8
4557,4,0,0,47,0.0,0.0,1.0,47,950,700,250,0.7368421052631579,12,7,5,286.2822188233545,0.4584104224483503,0.16742334940068426,0.15486423884717357,128214.85339506163,-2058.8734567901374,126155.97993827148,1049,1,189.5744680851064,44,3,18,39.55704882062533,0.5894886363636364,46.80555555555555,1012.7777777777769,23.017676767676747,0
4558,4,0,1,46,0.0,0.02127659574468085,0.9787234042553191,47,1400,1000,400,0.7142857142857143,18,10,8,285.14952439188244,0.45740826395312983,0.16912507154633283,0.15495570803403447,128396.86322627854,-2077.5391035234275,126319.32412275512,1050,2,190.5744680851064,45,2,12,39.4009555515834,0.5900462962962962,46.625905797101446,1013.4963768115936,22.5221417069243,0
4559,4,0,0,46,0.0,0.0,1.0,46,1600,1200,400,0.75,20,12,8,295.50694673107284,0.4565318035426731,0.1706758077201116,0.16060670501084057,128402.4734224968,-1611.2354252400335,126791.23799725676,1051,3,195.2608695652174,44,2,13,39.13282629880017,0.5913825757575757,46.62037037037038,1013.5185185185204,23.034511784511828,0
4560,4,0,4,42,0.0,0.08695652173913043,0.9130434782608696,46,1650,1200,450,0.7272727272727273,21,12,9,312.7972098163168,0.457055152979066,0.0841538263444781,0.16117170577005543,126243.1549587427,-1273.067707021084,124970.08725172162,1052,4,196.2608695652174,41,5,15,40.90120105297796,0.5736788617886179,48.75992063492063,1004.960317460317,24.511227255129683,8
4561,4,2,3,41,0.045454545454545456,0.06818181818181818,0.9318181818181819,44,1400,900,500,0.6428571428571429,19,9,10,321.8658900133091,0.4564063601127555,0.11834375235369388,0.166734819418912,126462.58680555581,-659.2013888888638,125803.38541666695,1053,0,202.9090909090909,39,5,12,40.448080640706976,0.579059829059829,48.54166666666668,1005.8333333333354,25.790598290598343,0
4562,4,2,0,43,0.046511627906976744,0.0,1.0,43,1550,1100,450,0.7096774193548387,20,11,9,354.67637132322034,0.4556570690291621,0.17282690578600768,0.17406424992631894,124219.970703125,309.84157986111177,124529.81228298611,1054,0,208.02325581395348,35,8,15,41.94204980842913,0.5633928571428571,50.78125,996.875,28.482142857142858,8
4563,4,4,2,45,0.0851063829787234,0.0425531914893617,0.9574468085106383,47,1450,1100,350,0.7586206896551724,18,11,7,365.6892821542647,0.4599329324699353,0.17098064977174343,0.18136901955576487,124661.68755425341,-90.72536892361632,124570.9621853298,1055,0,191.2340425531915,39,8,17,41.20868971871632,0.5606303418803419,50.338541666666664,998.6458333333328,25.606303418803407,8
4564,4,5,3,47,0.1,0.06,0.94,50,1000,600,400,0.6,14,6,8,346.4079106094093,0.46437074829931974,0.22745400593471832,0.1763436040413458,125745.15483276639,-1287.2598453443902,124457.894987422,1056,0,180.24,41,9,17,40.56998021760634,0.5685975609756098,49.25595238095238,1002.9761904761901,24.46283391405342,0
4565,4,0,1,46,0.0,0.02127659574468085,0.9787234042553191,47,1700,1100,600,0.6470588235294118,23,11,12,360.5546242058221,0.45931621954979956,0.2333328299835402,0.18283548887105538,125585.03252239089,-343.9471586026729,125241.08536378821,1057,1,192.40425531914894,40,7,18,40.38071580654971,0.5684895833333333,49.41565040650407,1002.3373983739847,25.05843495934962,0
4566,4,2,2,46,0.041666666666666664,0.041666666666666664,0.9583333333333334,48,1300,700,600,0.5384615384615384,19,7,12,321.7460638259581,0.4610667848699764,0.2262201885745978,0.16249528097428667,125417.01388888908,-1476.2015417410062,123940.81234714808,1058,0,189.04166666666666,39,9,15,41.52627565169162,0.5683760683760684,49.58333333333334,1001.6666666666682,25.683760683760724,7
4567,4,2,0,48,0.041666666666666664,0.0,1.0,48,1250,900,350,0.72,16,9,7,317.17088430961593,0.46155622044917255,0.22926553951618245,0.16184996588836809,125844.67612276389,-1617.1465576971532,124227.52956506674,850,0,167.91666666666666,41,7,17,41.200728363324764,0.5696138211382114,49.15674603174603,1003.3730158730157,24.472512582268674,0
4568,4,1,1,48,0.02040816326530612,0.02040816326530612,0.9795918367346939,49,1650,1300,350,0.7878787878787878,20,13,7,317.8941831230286,0.4628684807256236,0.24363496030427556,0.16381738285063227,126248.01834432234,-1772.982926714963,124475.03541760737,851,0,165.46938775510205,40,9,18,40.768151481444036,0.5752604166666666,48.75508130081302,1004.9796747967494,25.124491869918735,0
4569,4,3,4,47,0.058823529411764705,0.0784313725490196,0.9215686274509804,51,2200,1800,400,0.8181818181818182,26,18,8,345.9721479407834,0.46733660130718957,0.2984228516289944,0.17288315711924368,124975.19964293548,-1524.1347024597762,123451.0649404757,852,0,159.8235294117647,41,10,17,41.376355954625126,0.5607215447154472,50.02480158730157,999.9007936507903,24.38782423538513,8
4570,4,5,2,50,0.09615384615384616,0.038461538461538464,0.9615384615384616,52,950,600,350,0.631578947368421,13,6,7,332.0484765470109,0.47172731271995977,0.3052558125029241,0.16869156898109247,125661.44180877804,-2054.8570163890026,123606.58479238904,853,0,157.26923076923077,40,12,15,41.01628488411379,0.5692708333333334,49.339430894308954,1002.6422764227658,25.066056910569145,0
4571,4,1,2,49,0.0196078431372549,0.0392156862745098,0.9607843137254902,51,1300,1000,300,0.7692307692307693,16,10,6,344.69373525152525,0.47076797385620917,0.3275766220913534,0.1755185603774163,125756.34901258706,-1530.5148654513637,124225.8341471357,854,0,161.33333333333334,39,12,18,40.60141672724756,0.5718482905982907,49.24479166666668,1003.0208333333354,25.71848290598296,0
4572,4,2,0,51,0.0392156862745098,0.0,1.0,51,1250,800,450,0.64,17,8,9,337.9223029845821,0.47248366013071896,0.3196423508311519,0.1737524417824472,126156.94400058854,-1672.4380551370475,124484.5059454515,855,0,159.0392156862745,36,15,20,40.35865747487204,0.5813078703703703,48.84572072072073,1004.617117117118,27.906031031031056,0
4573,4,2,1,52,0.03773584905660377,0.018867924528301886,0.9811320754716981,53,1350,1000,350,0.7407407407407407,17,10,7,324.90326221842196,0.47325532172230284,0.32072069187060004,0.16968770376360465,126795.93474915993,-2360.7174327927514,124435.21731636718,856,0,154.0,38,15,13,40.029746119302715,0.5841557017543859,48.210470085470085,1007.1581196581199,26.504161043634735,0
4574,4,1,4,49,0.018867924528301886,0.07547169811320754,0.9245283018867925,53,1450,1100,350,0.7586206896551724,18,11,7,325.48314506759624,0.472045839380745,0.33111918235662174,0.1713460907023444,127118.94729572983,-2324.985047300788,124793.96224842904,857,0,154.96226415094338,38,15,15,39.684200303704486,0.5874451754385965,47.889957264957246,1008.4401709401683,26.537899235267588,0
4575,4,1,1,49,0.02,0.02,0.98,50,1550,1200,350,0.7741935483870968,19,12,7,352.8617158607109,0.4680187074829932,0.35365483982087476,0.18523644866973688,127004.50002411279,-1036.99483989196,125967.50518422082,858,0,164.78,35,15,16,39.11147950396142,0.5919642857142857,48.00347222222223,1007.9861111111122,28.799603174603206,0
4576,4,2,4,47,0.0392156862745098,0.0784313725490196,0.9215686274509804,51,1450,1100,350,0.7586206896551724,18,11,7,383.29027529571556,0.4694281045751634,0.3277582877811316,0.19325334859315438,125347.46334876532,-539.656876929025,124807.80647183629,859,0,162.07843137254903,35,16,16,40.05721220527046,0.575,49.65277777777777,1001.388888888888,28.611111111111086,8
4577,4,5,3,49,0.09615384615384616,0.057692307692307696,0.9423076923076923,52,1750,1300,450,0.7428571428571429,22,13,9,358.80516484466267,0.47138166163901457,0.3390389136219203,0.18602475551696868,126496.56994409939,-1320.5464614389325,125176.02348266046,860,0,157.15384615384616,36,16,15,39.48421582894884,0.5847800925925926,48.507882882882875,1005.9684684684676,27.943568568568544,0
4578,4,4,2,51,0.07547169811320754,0.03773584905660377,0.9622641509433962,53,1750,1500,250,0.8571428571428571,20,15,5,349.7028891469162,0.47363328495403967,0.32699204740371135,0.18397412863816037,127092.01388888895,-1709.7129646538342,125382.30092423511,861,0,154.20754716981133,36,17,19,39.10123966942148,0.5908564814814814,47.91666666666667,1008.3333333333339,28.009259259259277,0
4579,4,2,3,50,0.03773584905660377,0.05660377358490566,0.9433962264150944,53,1400,1100,300,0.7857142857142857,17,11,6,343.09647635293607,0.47375423318819543,0.3256319863657684,0.18235785595423523,127506.962779413,-1850.562071983675,125656.40070742933,862,0,154.1509433962264,37,16,16,38.84248452936705,0.5931869369369369,47.505482456140356,1009.9780701754395,27.296704599336202,0
4580,4,2,3,49,0.038461538461538464,0.057692307692307696,0.9423076923076923,52,950,700,250,0.7368421052631579,12,7,5,338.6642814903171,0.4765035822021116,0.32119263300135126,0.18136829290962325,127811.68845221649,-1742.949272853137,126068.73917936336,863,0,153.53846153846155,37,15,18,38.64264801561484,0.5962837837837838,47.203947368421076,1011.1842105263192,27.329302987197817,0
4581,4,2,1,50,0.0392156862745098,0.0196078431372549,0.9803921568627451,51,1500,1100,400,0.7333333333333333,19,11,8,345.803778009618,0.47547385620915034,0.32253079345954094,0.18567575241245723,127916.59216226409,-1353.191832034682,126563.4003302294,864,0,157.31372549019608,36,15,21,38.35485546773537,0.5992476851851851,47.10022522522525,1011.5990990991029,28.09997497497508,0
4582,4,0,3,47,0.0,0.06,0.94,50,1450,900,550,0.6206896551724138,20,9,11,353.02952541963515,0.4746683673469388,0.326153846153846,0.1889746283128639,127793.20987654355,-977.0447530863769,126816.16512345718,865,1,161.38,35,15,21,38.298420329670336,0.6,47.22222222222224,1011.1111111111138,28.888888888888967,0
4583,4,0,0,47,0.0,0.0,1.0,47,1550,1000,550,0.6451612903225806,21,10,11,357.4447530491486,0.47396315140302187,0.3030745849894789,0.19133807369101508,127793.20987654342,-264.19753086417063,127529.01234567925,866,2,166.51063829787233,35,12,21,38.1868131868132,0.6,47.222222222222236,1011.1111111111128,28.888888888888935,0
4584,4,3,3,47,0.06,0.06,0.94,50,1300,1000,300,0.7692307692307693,16,10,6,360.0066305965972,0.4747278911564626,0.33275535733710493,0.18900862107792765,127009.10526556222,-846.9776891821687,126162.12757638005,867,0,157.46,37,13,20,38.92669694332646,0.5881193693693694,47.99890350877192,1008.0043859649102,27.24336178283541,8
4585,4,2,2,47,0.04081632653061224,0.04081632653061224,0.9591836734693877,49,1450,1100,350,0.7586206896551724,18,11,7,363.64221320273145,0.473515447845805,0.3568817077485553,0.19258727831017883,127362.24666950126,-537.0880453404651,126825.15862416079,868,0,161.22448979591837,34,15,18,38.47225498289894,0.5977328431372548,47.64880952380953,1009.4047619047628,29.688375350140085,0
4586,4,2,1,48,0.04081632653061224,0.02040816326530612,0.9795918367346939,49,1500,1300,200,0.8666666666666667,17,13,4,360.2883145884922,0.4723462301587302,0.34829433376648855,0.1923005845346404,127676.20991941023,-599.9507030178227,127076.25921639241,869,0,161.12244897959184,35,14,20,38.234845014506035,0.5988095238095238,47.33796296296297,1010.6481481481488,28.875661375661394,0
4587,4,2,0,50,0.04,0.0,1.0,50,750,500,250,0.6666666666666666,10,5,5,354.03655450010046,0.47422619047619047,0.3566088117489976,0.19077221533854352,128059.03031409805,-932.4844269945468,127126.54588710351,870,0,158.86,36,14,23,38.00089934727785,0.6006944444444444,46.95945945945947,1012.1621621621637,28.115615615615656,0
4588,4,0,1,49,0.0,0.02,0.98,50,1000,500,500,0.5,15,5,10,353.08512653061246,0.47381802721088434,0.3543268571428573,0.1909452940137736,128203.13169795946,-946.6476709598815,127256.48402699958,871,1,159.86,35,15,23,37.87761904761904,0.6041666666666667,46.817129629629626,1012.7314814814808,28.935185185185166,0
4589,4,1,2,48,0.02,0.04,0.96,50,1500,800,700,0.5333333333333333,22,8,14,350.92679520300806,0.47490646258503405,0.3579851682829436,0.19188230567400888,128643.0620525762,-971.1405017575545,127671.92155081865,872,0,159.78,35,15,15,37.483005324206125,0.6086309523809523,46.38310185185185,1014.4675925925918,28.984788359788336,0
4590,4,0,0,48,0.0,0.0,1.0,48,1450,900,550,0.6206896551724138,20,9,11,352.27489191460097,0.4741522606382979,0.35316385308543374,0.1929040585518616,128701.7763658478,-532.3191283007714,128169.45723754703,873,1,165.89583333333334,35,13,15,37.38890631534921,0.6092261904761904,46.325231481481474,1014.6990740740732,28.991402116402092,0
4591,4,0,4,44,0.0,0.08333333333333333,0.9166666666666666,48,800,600,200,0.75,10,6,4,353.6663245786157,0.4736997635933806,0.3098256924546319,0.18781124053246645,127471.58893014837,-573.1431916580902,126898.44573849028,874,2,166.89583333333334,35,13,21,38.61186723973254,0.5967261904761905,47.54050925925926,1009.8379629629634,28.85251322751324,8
4592,4,2,1,45,0.043478260869565216,0.021739130434782608,0.9782608695652174,46,1200,600,600,0.5,18,6,12,369.4412343967899,0.47334943639291466,0.36092439411432853,0.1972027093896652,127679.65032980111,234.0255250384506,127913.67585483956,875,0,174.3913043478261,33,13,22,38.000055575764904,0.603219696969697,47.33455882352941,1010.6617647058829,30.62611408199645,0
4593,4,0,1,44,0.0,0.022222222222222223,0.9777777777777777,45,1250,700,550,0.56,18,7,11,381.39074010574325,0.47243265993266,0.36993709119693374,0.20302776524191968,127569.89282024797,730.7951675849462,128300.68798783292,876,1,179.26666666666668,32,13,22,37.810898637670284,0.6044921875,47.44318181818182,1010.227272727273,31.56960227272728,0
4594,4,1,0,45,0.022222222222222223,0.0,1.0,45,1350,800,550,0.5925925925925926,19,8,11,383.14066213931227,0.47335858585858587,0.3693276801938219,0.20577919101886946,127927.48169273845,802.8440083141195,128730.32570105257,877,0,179.86666666666667,33,12,23,37.399429638602875,0.6057449494949495,47.08946078431373,1011.6421568627458,30.65582293523472,0
4595,4,2,1,46,0.0425531914893617,0.02127659574468085,0.9787234042553191,47,1900,1200,700,0.631578947368421,26,12,14,364.8771530429913,0.4727104532839963,0.3716750502242754,0.20012666102662605,128765.68657487507,-2.9006271626224134,128762.78594771244,878,0,173.17021276595744,33,14,20,37.003944296868724,0.6142676767676767,46.26225490196079,1014.950980392157,30.75609031491385,0
4596,4,1,2,45,0.02127659574468085,0.0425531914893617,0.9574468085106383,47,1850,1600,250,0.8648648648648649,21,16,5,324.50268356198103,0.47309589885908104,0.2764376196918321,0.17160382087054973,127302.1701388888,-1138.0208333333424,126164.14930555546,879,0,174.14893617021278,39,8,19,39.52140104596751,0.5876068376068376,47.70833333333333,1009.166666666666,25.876068376068357,8
4597,4,2,0,47,0.0425531914893617,0.0,1.0,47,1900,1500,400,0.7894736842105263,23,15,8,319.3508439443603,0.47126503237742834,0.30181935396159565,0.17053721732482802,127696.68104383672,-1243.9914279513991,126452.68961588532,880,0,174.91489361702128,39,8,20,39.24827802397885,0.5916132478632479,47.31770833333333,1010.729166666666,25.91613247863246,0
4598,4,0,1,46,0.0,0.02127659574468085,0.9787234042553191,47,1050,500,550,0.47619047619047616,16,5,11,321.14561427118036,0.47113012642614865,0.307080140747805,0.17172001027558143,127749.32861328122,-1194.772677951389,126554.55593532983,881,1,175.91489361702128,39,8,20,39.14917138931823,0.5921474358974359,47.265625,1010.9374999999998,25.921474358974354,0
4599,4,1,1,46,0.02127659574468085,0.02127659574468085,0.9787234042553191,47,1600,1000,600,0.625,22,10,12,321.90091820643664,0.4715155720012334,0.30251721561642086,0.17280153768395298,127907.33642578141,-1165.3021918402642,126742.03423394114,882,0,176.17021276595744,39,8,21,38.968802560670014,0.59375,47.10937500000001,1011.5625000000013,25.937500000000032,0
4600,4,2,0,48,0.041666666666666664,0.0,1.0,48,1200,900,300,0.75,15,9,6,314.4920000463393,0.4723699763593381,0.31077869694789806,0.1710632561459437,128434.73442925372,-1521.4409722221985,126913.29345703151,883,0,172.70833333333334,39,9,16,38.61895403007571,0.5990918803418803,46.58854166666668,1013.6458333333353,25.990918803418854,0
4601,4,2,2,48,0.04,0.04,0.96,50,1150,900,250,0.782608695652174,14,9,5,303.47504487461083,0.47218537414965983,0.31314972165250476,0.16732800131777817,128974.55401431408,-2171.8882865646233,126802.66572774945,884,0,166.76,41,9,18,38.349997558355305,0.6013719512195121,46.05654761904762,1015.7738095238097,24.774970963995358,0
4602,4,0,1,47,0.0,0.020833333333333332,0.9791666666666666,48,1350,900,450,0.6666666666666666,18,9,9,313.8561914043015,0.4703660608747045,0.3144308317955029,0.17334956347438019,129042.58355034713,-1499.8372395833428,127542.74631076379,885,1,173.85416666666666,39,9,19,38.017309138131374,0.6052350427350428,45.98958333333333,1016.0416666666658,26.052350427350405,0
4603,4,1,0,48,0.020833333333333332,0.0,1.0,48,1150,900,250,0.782608695652174,14,9,5,313.84672760754165,0.47127105496453897,0.3204686379009942,0.17369271249386167,129121.97401258671,-1495.0981987847326,127626.87581380198,886,0,174.72916666666666,39,9,20,37.93697260086776,0.6060363247863247,45.91145833333333,1016.3541666666658,26.060363247863226,0
4604,4,2,2,48,0.04,0.04,0.96,50,1600,1400,200,0.875,18,14,4,302.1301636867379,0.47095238095238096,0.3173682672640501,0.1695992559087881,129680.91699932274,-2163.896663989678,127517.02033533306,887,0,168.7,41,9,16,37.6687242297328,0.6084857723577235,45.36210317460317,1018.5515873015862,24.842721641502102,0
4605,4,2,1,49,0.04,0.02,0.98,50,1000,600,400,0.6,14,6,8,301.4720346262629,0.4700085034013606,0.32362186345069155,0.17087847078430157,130060.11924445679,-2158.1022455278653,127902.01699892891,888,0,169.2,41,9,18,37.302243402710246,0.6122967479674797,44.99007936507935,1020.0396825396804,24.879016647309278,0
4606,4,0,1,48,0.0,0.02040816326530612,0.9795918367346939,49,1350,800,550,0.5925925925925926,19,8,11,307.70638816966533,0.46738591269841273,0.3254490080551051,0.17450602962977968,130081.0994199881,-1794.6429456672645,128286.45647432083,889,1,173.6122448979592,40,9,20,37.12206116756325,0.6140625,44.96951219512195,1020.1219512195121,25.503048780487802,0
4607,4,0,0,48,0.0,0.0,1.0,48,1750,1200,550,0.6857142857142857,23,12,11,319.5210763830062,0.46643210697399523,0.336545333877885,0.18130877300667197,130103.13042534703,-1285.8615451389092,128817.26888020812,890,2,178.125,39,9,20,36.79846504662718,0.6159188034188035,44.94791666666666,1020.2083333333318,26.159188034187995,0
4608,4,3,2,49,0.058823529411764705,0.0392156862745098,0.9607843137254902,51,1950,1500,450,0.7692307692307693,24,15,9,310.7252487076473,0.4654575163398693,0.3562016929005949,0.18113359061448098,131145.8965913972,-2049.736420430147,129096.16017096706,891,0,168.58823529411765,40,11,20,35.97103713992789,0.6247395833333333,43.92784552845528,1024.2886178861781,25.607215447154452,0
4609,4,0,0,49,0.0,0.0,1.0,49,1700,1500,200,0.8823529411764706,19,15,4,322.86452282807,0.4645337301587302,0.35383379946279736,0.18736311285376966,130972.4633487653,-1342.7276234568074,129629.73572530849,892,1,175.9387755102041,38,11,21,35.83502939846222,0.6263706140350878,44.097222222222214,1023.6111111111102,26.937134502923954,0
4610,4,0,1,48,0.0,0.02040816326530612,0.9795918367346939,49,1900,1400,500,0.7368421052631579,24,14,10,323.41741319327514,0.4636656746031746,0.3500038313197622,0.18862081251199034,131163.9135437212,-1315.8612754766632,129848.05226824453,893,2,176.9387755102041,38,11,21,35.62786816854401,0.6282894736842105,43.91025641025641,1024.3589743589741,26.956815114709844,0
4611,4,0,1,47,0.0,0.020833333333333332,0.9791666666666666,48,1400,1000,400,0.7142857142857143,18,10,8,332.75822635667123,0.46352319739952713,0.35860983583750694,0.19351667726955923,131054.49631090644,-878.1076503031766,130176.38866060326,894,3,181.52083333333334,38,10,21,35.49905223984419,0.6271929824561404,44.01709401709401,1023.9316239316229,26.94556905083218,0
4612,4,0,0,47,0.0,0.0,1.0,47,1500,1200,300,0.8,18,12,6,340.2696962567276,0.4615325316065371,0.3587628678062189,0.19784797158439096,131047.29940943346,-481.7150469375415,130565.58436249591,895,4,185.87234042553192,37,10,21,35.314039408866996,0.6289414414414414,44.024122807017534,1023.9035087719282,27.673067804646706,0
4613,4,0,0,47,0.0,0.0,1.0,47,1200,900,300,0.75,15,9,6,339.6373704002996,0.4611663583102066,0.3549196718548584,0.19805819689635434,131159.5935768697,-490.66010695599914,130668.9334699137,896,5,186.87234042553192,37,10,21,35.21685220866338,0.6300675675675675,43.91447368421052,1024.342105263157,27.68492176386911,0
4614,4,0,1,46,0.0,0.02127659574468085,0.9787234042553191,47,1200,700,500,0.5833333333333334,17,7,10,323.7026296946354,0.4610892691951896,0.26616399459062245,0.1826847712913324,129890.673828125,-990.7012554343644,128899.97257269063,897,6,187.87234042553192,39,8,20,36.90689079637576,0.6137820512820513,45.15625,1019.375,26.137820512820515,8
4615,4,0,0,46,0.0,0.0,1.0,46,1350,800,550,0.5925925925925926,19,8,11,323.4470040028133,0.4604669887278583,0.28769725573089366,0.18287785581770438,129962.83512309153,-792.7820695448905,129170.05305354664,898,7,192.82608695652175,38,8,20,36.84033598770605,0.6162280701754386,45.085470085470085,1019.6581196581196,26.83310841205578,0
4616,4,0,0,46,0.0,0.0,1.0,46,1600,1200,400,0.75,20,12,8,324.4502365750525,0.4598228663446055,0.2915930493069343,0.1839578894785392,130071.79578493677,-759.6350171670712,129312.16076776969,899,8,193.82608695652175,38,8,21,36.704458176232386,0.6173245614035088,44.97863247863248,1020.0854700854698,26.844354475933415,0
4617,4,1,0,47,0.02127659574468085,0.0,1.0,47,1500,900,600,0.6,21,9,12,316.2162679711669,0.46045328399629976,0.2861963547362627,0.18134273238297297,130514.55886667078,-1145.5550061368672,129369.0038605339,900,0,190.68085106382978,37,10,17,36.46705207997998,0.6235923423423424,44.54495614035089,1021.8201754385987,27.616761498340505,0
4618,4,0,0,47,0.0,0.0,1.0,47,1650,1100,550,0.6666666666666666,22,11,11,315.4487453071752,0.4592969472710453,0.2824557079876229,0.18155827785457437,130654.64854570657,-1157.0310095413738,129497.6175361652,901,1,191.68085106382978,37,10,17,36.34527384527386,0.625,44.40789473684212,1022.3684210526332,27.631578947368464,0
4619,4,0,0,47,0.0,0.0,1.0,47,1600,1100,500,0.6875,21,11,10,317.07168226656376,0.45864168979340114,0.2815532470418307,0.1832203595475167,130808.4744708345,-1104.8673889619151,129703.60708187259,902,2,192.68085106382978,38,9,18,36.148607484769364,0.6247258771929824,44.257478632478644,1022.9700854700874,26.920265407107564,0
4620,4,0,2,45,0.0,0.0425531914893617,0.9574468085106383,47,1700,1300,400,0.7647058823529411,21,13,8,315.6807398342776,0.45765880357693495,0.2839632822179885,0.18332441509648797,130999.80481591077,-1129.176939513453,129870.62787639732,903,3,193.68085106382978,38,9,20,35.991311834690066,0.6266447368421053,44.07051282051283,1023.7179487179502,26.939946018893426,0
4621,4,1,0,46,0.021739130434782608,0.0,1.0,46,2000,1700,300,0.85,23,17,6,321.95405902513403,0.4568840579710145,0.292818900274908,0.18843485220462913,131300.02891514695,-745.4845481301969,130554.54436701674,904,0,197.19565217391303,37,9,21,35.528222067686606,0.6314752252252251,43.77741228070175,1024.8903508771928,27.6997392128971,0
4622,4,0,0,46,0.0,0.0,1.0,46,950,600,350,0.631578947368421,13,6,7,319.6960892611712,0.45632045088566825,0.2938653387454495,0.187663410588902,131412.4312889542,-797.5919273238023,130614.8393616304,905,1,198.19565217391303,37,9,21,35.47292179089579,0.6326013513513513,43.66776315789473,1025.3289473684204,27.711593172119468,0
4623,4,0,1,45,0.0,0.021739130434782608,0.9782608695652174,46,1400,1100,300,0.7857142857142857,17,11,6,319.50542332011696,0.45591787439613524,0.29165020291094645,0.18782741824720625,131468.650510253,-799.0106330794288,130669.63987717358,906,2,199.19565217391303,37,9,21,35.421232937738324,0.6331644144144144,43.61293859649122,1025.548245614034,27.717520151730646,0
4624,4,0,0,45,0.0,0.0,1.0,45,1850,1300,550,0.7027027027027027,24,13,11,319.3799363657501,0.45496632996632996,0.276852940128931,0.188585288608647,131637.3803117305,-591.5323705370947,131045.8479411934,907,3,198.0,37,8,17,35.25472361719556,0.6348536036036037,43.4484649122807,1026.206140350877,27.735301090564242,0
4625,4,0,0,45,0.0,0.0,1.0,45,1100,900,200,0.8181818181818182,13,9,4,321.4461083291165,0.454229797979798,0.2782286772034739,0.19050768091100306,131778.07113727307,-528.0903739612141,131249.98076331185,908,4,199.0,37,8,17,35.06024846931509,0.6362612612612613,43.31140350877193,1026.754385964913,27.75011853959224,0
4626,4,1,3,43,0.021739130434782608,0.06521739130434782,0.9347826086956522,46,1450,1100,350,0.7586206896551724,18,11,7,315.45247607538346,0.454669887278583,0.27899831003226283,0.188526939428406,132095.8034279347,-866.0103458981872,131229.7930820365,909,0,195.65217391304347,38,8,19,34.895075521374615,0.637609649122807,43.00213675213674,1027.9914529914518,27.05240665766978,0
4627,4,0,0,43,0.0,0.0,1.0,43,750,500,250,0.6666666666666666,10,5,5,329.60431847076126,0.45445736434108525,0.26605028539082043,0.19577702289889753,131862.5217013886,92.49131944441066,131955.01302083302,910,1,188.0,35,8,19,34.76588911426639,0.6410714285714285,43.22916666666665,1027.083333333331,29.345238095238027,0
4628,4,0,1,42,0.0,0.023255813953488372,0.9767441860465116,43,1300,1000,300,0.7692307692307693,16,10,6,330.6062819576334,0.4537421557770395,0.2664362036455057,0.19729729729729711,132040.8950617282,130.70987654318404,132171.60493827137,911,2,189.0,35,8,20,34.56081081081081,0.6428571428571428,43.05555555555554,1027.7777777777762,29.36507936507932,0
4629,4,1,0,43,0.023255813953488372,0.0,1.0,43,1350,1000,350,0.7407407407407407,17,10,7,327.7075683621037,0.45353451458102617,0.24907966407420767,0.19772771500976793,132455.95838659574,81.3640075886347,132537.32239418436,912,0,184.93023255813952,36,7,21,34.21853918243811,0.6449652777777778,42.65202702702701,1029.3918918918894,28.59421921921915,0
4630,4,0,0,43,0.0,0.0,1.0,43,1050,700,350,0.6666666666666666,14,7,7,328.70472057301356,0.4535806570690291,0.2482773706660839,0.198634980845939,132513.92598257013,111.59060242672183,132625.51658499686,913,1,185.93023255813952,36,7,21,34.134720551241394,0.6455439814814814,42.595720720720706,1029.6171171171147,28.60047547547541,0
4631,4,1,0,44,0.022727272727272728,0.0,1.0,44,850,400,450,0.47058823529411764,13,4,9,324.5088275237666,0.45358747357293866,0.2501450676982593,0.1975636644250906,132793.2633117879,-181.4827639274015,132611.7805478605,914,0,182.6818181818182,37,7,15,33.96276595744681,0.6463963963963963,42.32456140350875,1030.7017543859622,27.856804172593574,0
4632,4,0,1,43,0.0,0.022727272727272728,0.9772727272727273,44,1300,1100,200,0.8461538461538461,15,11,4,324.9653726350056,0.45291578576462294,0.2526883020181605,0.19799089229693353,132821.51870046533,-167.5211363111971,132653.99756415412,915,1,183.6818181818182,37,7,15,33.92269882636597,0.646677927927928,42.29714912280701,1030.8114035087704,27.8597676623992,0
4633,4,0,2,41,0.0,0.046511627906976744,0.9534883720930233,43,1400,900,500,0.6428571428571429,19,9,10,332.64823917793666,0.45233480989294944,0.2569194369404286,0.20226339114400654,132745.92318247302,231.53952093986362,132977.4627034129,916,2,188.88372093023256,36,7,16,33.80049539212473,0.6478587962962963,42.3704954954955,1030.5180180180182,28.625500500500507,0
4634,4,0,0,41,0.0,0.0,1.0,41,1300,900,400,0.6923076923076923,17,9,8,349.7297982419806,0.45198170731707316,0.2643860693261726,0.21103374496848598,132459.27047902482,1064.9907879818488,133524.26126700666,917,3,194.4878048780488,34,7,21,33.648471531552374,0.649203431372549,42.64880952380952,1029.404761904761,30.276610644257676,0
4635,4,1,0,42,0.023809523809523808,0.0,1.0,42,750,400,350,0.5333333333333333,11,4,7,343.3414817504825,0.452852787456446,0.26222557291499626,0.20915179456017763,132815.2394654492,720.1962234224952,133535.43568887172,918,0,190.83333333333334,35,7,19,33.455442024103604,0.6505952380952381,42.30324074074074,1030.7870370370367,29.451058201058192,0
4636,4,0,1,41,0.0,0.023809523809523808,0.9761904761904762,42,1550,1000,550,0.6451612903225806,21,10,11,342.20094182414766,0.45178813395276807,0.2637642130460802,0.20945705999565956,132994.25582990394,702.1519204389504,133696.40775034289,919,1,191.83333333333334,35,7,20,33.305281268701385,0.6523809523809524,42.129629629629626,1031.481481481481,29.470899470899457,0
4637,4,0,0,41,0.0,0.0,1.0,41,950,700,250,0.7368421052631579,12,7,5,342.79421142852794,0.4513719512195122,0.2498296541363263,0.2099879592070426,133024.10361207562,919.9785397376525,133944.08215181326,920,2,183.1951219512195,35,6,20,33.26005553685627,0.6526785714285714,42.10069444444444,1031.5972222222222,29.474206349206348,0
4638,4,0,1,40,0.0,0.024390243902439025,0.975609756097561,41,1150,700,450,0.6086956521739131,16,7,9,343.2122873150756,0.4510162601626016,0.2479729507927655,0.21074936320256274,133113.66705246904,937.2492283950553,134050.9162808641,921,3,184.1951219512195,35,6,20,33.159488559892324,0.6535714285714286,42.013888888888886,1031.944444444444,29.48412698412697,0
4639,4,0,1,39,0.0,0.025,0.975,40,850,300,550,0.35294117647058826,14,3,11,349.8072645048408,0.44889155982905987,0.243069649446495,0.2154494742745722,133226.30385487515,1320.7057823129117,134547.00963718805,922,4,188.075,34,6,21,32.87640298277984,0.6568627450980392,41.9047619047619,1032.3809523809514,30.364145658263276,0
4640,4,0,1,38,0.0,0.02564102564102564,0.9743589743589743,39,950,600,350,0.631578947368421,13,6,7,353.58184750850893,0.4481275303643724,0.23606539925303638,0.2175946202800766,133195.58000283435,1619.1078514739106,134814.68785430826,923,5,192.10256410256412,34,5,21,32.80979702456464,0.6565563725490196,41.9345238095238,1032.261904761904,30.360644257703058,0
4641,4,0,0,38,0.0,0.0,1.0,38,650,400,250,0.6153846153846154,9,4,5,358.27794135089687,0.4470424371740161,0.23058581616135143,0.2200626217444128,133124.2059093856,1939.0932874375019,135063.29919682312,924,6,196.57894736842104,33,5,21,32.7602373035665,0.6581439393939394,42.003676470588225,1031.9852941176455,31.27228163992865,0
4642,4,0,0,38,0.0,0.0,1.0,38,1250,800,450,0.64,17,8,9,360.78576202032997,0.4465830962541489,0.2352676563202878,0.22216807450725576,133219.07439446362,2012.70905420991,135231.78344867352,925,7,197.57894736842104,33,5,21,32.600308641975296,0.6590909090909092,41.91176470588235,1032.35294117647,31.283422459893032,0
4643,4,0,0,38,0.0,0.0,1.0,38,1300,900,400,0.6923076923076923,17,9,8,388.62160124096187,0.4449828117591275,0.2107190270223971,0.22635826915883533,131114.67013888902,2590.79861111113,133705.46875000015,926,8,198.57894736842104,34,4,18,34.00800108489287,0.6357230392156863,43.95833333333334,1024.1666666666679,30.122549019607877,8
4644,4,0,1,37,0.0,0.02631578947368421,0.9736842105263158,38,1200,1000,200,0.8333333333333334,14,10,4,386.85376100385565,0.44516062114746324,0.2073713558990411,0.22622535154355905,131267.12018140592,2556.2358276644018,133823.35600907032,927,9,199.57894736842104,34,4,18,33.89869888475836,0.6372549019607843,43.80952380952381,1024.7619047619048,30.140056022408967,0
4645,4,0,0,37,0.0,0.0,1.0,37,1300,900,400,0.6923076923076923,17,9,8,393.52781701540493,0.44281781781781787,0.2232933758983764,0.23068970009733372,131360.48179076108,2938.8149005776095,134299.2966913387,928,14,205.72972972972974,32,5,18,33.6330418360225,0.6429036458333333,43.71843434343434,1025.1262626262621,32.03519570707069,0
4646,4,0,1,36,0.0,0.02702702702702703,0.972972972972973,37,600,200,400,0.3333333333333333,10,2,8,395.41240991045623,0.44284909909909914,0.22399813606710128,0.2319905179532447,131392.84256708508,2990.872104887268,134383.71467197235,929,15,206.72972972972974,32,5,18,33.551929392446624,0.6432291666666667,43.68686868686869,1025.252525252526,32.03914141414144,0
4647,4,0,0,36,0.0,0.0,1.0,36,1300,700,600,0.5384615384615384,19,7,12,398.3652506928697,0.4419973544973545,0.20839153439153435,0.23393932507131604,131428.24172973624,3271.288892957885,134699.53062269412,930,16,187.86111111111111,31,5,19,33.44034391534392,0.6461693548387097,43.65234374999999,1025.3906249999993,33.07711693548385,0
4648,4,0,1,35,0.0,0.027777777777777776,0.9722222222222222,36,1000,700,300,0.7,13,7,6,398.3652506928697,0.44151785714285713,0.20839153439153435,0.23393932507131604,131428.24172973624,3271.288892957885,134699.53062269412,931,17,188.86111111111111,31,5,19,33.44034391534392,0.6461693548387097,43.65234374999999,1025.3906249999993,33.07711693548385,0
4649,4,0,0,35,0.0,0.0,1.0,35,1350,800,550,0.5925925925925926,19,8,11,399.67333246661485,0.4385504201680672,0.19269282814614397,0.23628687415426236,131684.26890432075,3526.1381172839247,135210.40702160468,932,18,189.5142857142857,32,3,17,33.14727108705458,0.6461588541666667,43.402777777777764,1026.388888888887,32.07465277777772,0
4650,4,0,0,35,0.0,0.0,1.0,35,1300,800,500,0.6153846153846154,18,8,10,403.247291688467,0.43764005602240896,0.19181315304240942,0.23962138187623658,131878.73247946633,3635.9483407305293,135514.68082019687,933,19,190.5142857142857,32,3,18,32.85853308748207,0.6481119791666667,43.213383838383834,1027.1464646464642,32.09832702020201,0
4651,4,0,0,35,0.0,0.0,1.0,35,850,700,150,0.8235294117647058,10,7,3,404.10338122993545,0.4371498599439776,0.193080933073561,0.24095219192897033,132008.45457415062,3669.0125688705216,135677.46714302115,934,20,191.5142857142857,32,3,18,32.70518491215137,0.6494140625,43.08712121212121,1027.6515151515152,32.11410984848485,0
4652,4,0,1,34,0.0,0.02857142857142857,0.9714285714285714,35,1050,800,250,0.7619047619047619,13,8,5,401.1803985944533,0.4370798319327731,0.18716864616410245,0.24003027081224362,132138.24043783805,3602.2543936843226,135740.49483152237,935,21,192.5142857142857,32,3,18,32.64895206516844,0.6507161458333333,42.96085858585859,1028.1565656565663,32.129892676767696,0
4653,4,1,0,35,0.02857142857142857,0.0,1.0,35,700,600,100,0.8571428571428571,8,6,2,391.88822747070947,0.43606442577030813,0.17121085843552786,0.23628637634791747,132429.53619100832,3379.5152405324916,135809.0514315408,936,0,189.37142857142857,33,2,19,32.59353792118108,0.651199494949495,42.677696078431374,1029.289215686275,31.190582293523484,0
4654,4,0,2,33,0.0,0.05714285714285714,0.9428571428571428,35,1050,800,250,0.7619047619047619,13,8,5,390.45520327875573,0.43539915966386555,0.16662699357295874,0.2360147207156911,132524.15687475976,3348.949322376009,135873.10619713578,937,1,190.37142857142857,33,2,19,32.534912322462894,0.6521464646464646,42.58578431372549,1029.6568627450984,31.20172311348783,0
4655,4,0,1,32,0.0,0.030303030303030304,0.9696969696969697,33,750,600,150,0.8,9,6,3,394.41056387188615,0.43166035353535354,0.13079166898909422,0.2384298108506472,132527.98064291905,3854.0871148352194,136382.06775775427,938,2,176.6060606060606,32,1,19,32.429235642754975,0.6546223958333333,42.582070707070706,1029.6717171717169,32.17724116161615,0
4656,4,0,0,32,0.0,0.0,1.0,32,700,400,300,0.5714285714285714,10,4,6,402.6041510757627,0.4304855510752688,0.14031676783004565,0.2434092986779153,132532.04345703125,4271.590169270834,136803.6336263021,939,3,181.25,31,1,19,32.214213454729396,0.657258064516129,42.578125,1029.6875,33.215725806451616,0
4657,4,0,0,32,0.0,0.0,1.0,32,800,500,300,0.625,11,5,6,399.86063185553,0.43056955645161293,0.1350110619469025,0.24218205191249953,132599.08888075093,4204.231092664935,136803.31997341587,940,4,182.25,31,1,20,32.21713021491782,0.6579301075268817,42.513020833333336,1029.9479166666672,33.22412634408604,0
4658,4,0,0,32,0.0,0.0,1.0,32,400,200,200,0.5,6,2,4,399.0406094951442,0.43044354838709675,0.1345108695652173,0.24211727778570408,132666.15125868062,4187.836371527788,136853.9876302084,941,5,183.25,31,1,18,32.170542635658926,0.6586021505376345,42.44791666666667,1030.208333333334,33.23252688172045,0
4659,4,0,0,32,0.0,0.0,1.0,32,900,600,300,0.6666666666666666,12,6,6,400.4139928841019,0.43038054435483875,0.13653560596486813,0.24316776098940135,132699.68880547423,4226.962449815544,136926.65125528976,942,6,184.25,31,1,18,32.10131534605502,0.6589381720430108,42.415364583333336,1030.338541666667,33.23672715053765,0
4660,4,0,0,32,0.0,0.0,1.0,32,1000,600,400,0.6,14,6,8,399.9258374596243,0.42907846102150543,0.13705323313968165,0.24396092303584782,132867.44011772997,4227.424452039926,137094.8645697699,943,7,185.25,31,1,18,31.944619853498356,0.6606182795698925,42.252604166666664,1030.989583333333,33.25772849462365,0
4661,4,0,0,32,0.0,0.0,1.0,32,700,500,200,0.7142857142857143,9,5,4,383.6852824149173,0.4282384072580645,0.12309519255292045,0.21898544284554447,130329.05578613281,3601.068115234376,133930.1239013672,944,8,186.25,31,1,19,34.93209640397858,0.6350806451612903,44.7265625,1021.09375,32.93850806451613,8
4662,4,1,1,32,0.030303030303030304,0.030303030303030304,0.9696969696969697,33,1100,800,300,0.7272727272727273,14,8,6,371.26547044933193,0.4296875,0.12163122955911265,0.21383412373390404,130681.82615294354,3103.529933170078,133785.3560861136,945,0,181.57575757575756,32,1,18,34.89107392771877,0.6360677083333333,44.38131313131313,1022.4747474747472,31.95233585858585,0
4663,4,0,0,32,0.0,0.0,1.0,32,950,700,250,0.7368421052631579,12,7,5,382.8178965752811,0.42783938172043007,0.13714901948300073,0.22056265163651353,130694.93823581259,3606.4722696940016,134301.4105055066,946,1,187.96875,31,1,20,34.58245787172631,0.6387768817204301,44.36848958333333,1022.5260416666656,32.98471102150534,0
4664,4,0,0,32,0.0,0.0,1.0,32,700,500,200,0.7142857142857143,9,5,4,388.35607308214134,0.42777637768817206,0.14473052660449803,0.21008104487499812,128214.85339506165,3580.6523452570295,131795.50574031868,947,2,188.96875,29,3,20,36.97259553848968,0.6192528735632183,46.80555555555555,1012.7777777777771,34.923371647509555,8
4665,4,1,0,33,0.030303030303030304,0.0,1.0,33,650,300,350,0.46153846153846156,10,3,7,377.0944956238988,0.4284248737373737,0.14221183612994892,0.206077636384762,128621.28434284306,3100.4756691524926,131721.76001199556,948,0,184.21212121212122,30,3,18,36.841625811580755,0.6204861111111111,46.40456989247311,1014.3817204301072,33.81272401433691,0
4666,4,3,2,34,0.08333333333333333,0.05555555555555555,0.9444444444444444,36,650,300,350,0.46153846153846156,10,3,7,346.22101009426046,0.43549933862433865,0.13575786769428455,0.19321366047195798,129450.69204152231,1763.7098712033649,131214.40191272568,949,0,169.77777777777777,33,3,14,36.77996547848428,0.6212121212121212,45.58823529411764,1017.6470588235279,30.83778966131903,0
4667,4,0,0,34,0.0,0.0,1.0,34,850,700,150,0.8235294117647058,10,7,3,361.8428063433566,0.4299799465240642,0.15480153649167794,0.20099518616938927,129267.58660210497,2554.9092610677035,131822.4958631727,950,1,180.64705882352942,31,3,20,36.56903542466924,0.6243279569892473,45.768229166666664,1016.9270833333328,32.80409946236558,0
4668,4,1,0,35,0.02857142857142857,0.0,1.0,35,750,500,250,0.6666666666666666,10,5,5,351.3521293934242,0.43263305322128853,0.15233843537415015,0.19675719246031748,129586.77685950408,2106.11799816345,131692.89485766753,951,0,176.45714285714286,32,3,16,36.51103670634922,0.625,45.45454545454545,1018.1818181818178,31.818181818181806,0
4669,4,0,1,34,0.0,0.02857142857142857,0.9714285714285714,35,900,500,400,0.5555555555555556,13,5,8,355.54252195631966,0.4324229691876751,0.151236348832682,0.2002500833712108,129811.8515489489,2230.726615906517,132042.5781648554,952,1,177.45714285714286,32,3,16,36.1755565192252,0.6272786458333333,45.23358585858585,1019.065656565655,31.84580176767672,0
4670,4,0,0,34,0.0,0.0,1.0,34,1300,1000,300,0.7692307692307693,16,10,6,359.61534486322876,0.43142825311942956,0.1439707572900153,0.20298691672200572,129897.31046888568,2542.613220214849,132439.92368910054,953,2,180.64705882352942,31,3,16,35.984933154511005,0.6307123655913979,45.149739583333336,1019.4010416666671,32.883904569892486,0
4671,4,1,0,35,0.02857142857142857,0.0,1.0,35,950,600,350,0.631578947368421,13,6,7,352.6680073662318,0.4353641456582633,0.13877158979812387,0.20077729551287365,130231.31315179245,2185.6835411860648,132416.99669297852,954,0,176.45714285714286,33,2,17,35.82300296153999,0.6291035353535354,44.82230392156862,1020.7107843137244,30.93062982768862,0
4672,4,0,0,35,0.0,0.0,1.0,35,1250,1000,250,0.8,15,10,5,354.35235318617237,0.4351890756302521,0.13690962099125348,0.2018984337921216,130262.58680555563,2231.774587898895,132494.36139345454,955,1,177.45714285714286,32,3,17,35.74829931972789,0.6318359375,44.79166666666667,1020.833333333334,31.90104166666669,0
4673,4,1,1,35,0.027777777777777776,0.027777777777777776,0.9722222222222222,36,950,600,350,0.631578947368421,13,6,7,339.1060497247016,0.43657407407407406,0.10821962313190392,0.1895004395520391,129504.14540816327,1583.1278344671182,131087.27324263038,956,0,173.5,34,2,20,36.90667641325537,0.6194852941176471,45.535714285714285,1017.8571428571429,29.93697478991597,7
4674,4,0,0,35,0.0,0.0,1.0,35,1600,1400,200,0.875,18,14,4,347.8358387210071,0.43126750700280114,0.115985206846134,0.19426877206307777,129481.87183114674,2007.687097510582,131489.55892865732,957,1,179.4,33,2,20,36.70717940999398,0.6215277777777778,45.55759803921569,1017.7696078431378,30.841503267973874,0
4675,4,1,0,36,0.027777777777777776,0.0,1.0,36,1200,900,300,0.75,15,9,6,340.06129003057276,0.43381283068783066,0.11284357237405551,0.1918053205034102,129867.9209183674,1632.6105442176909,131500.5314625851,958,0,175.38888888888889,34,2,21,36.51308105582806,0.6231617647058824,45.17857142857143,1019.2857142857148,29.97899159663867,0
4676,4,1,1,36,0.02702702702702703,0.02702702702702703,0.972972972972973,37,1200,800,400,0.6666666666666666,16,8,8,340.15473162964213,0.4363738738738739,0.14329224795141693,0.1792084843664271,127150.37321030536,1307.6573807249413,128458.0305910303,959,0,171.6216216216216,35,2,21,39.28209394843546,0.593452380952381,47.858796296296305,1008.564814814816,28.816137566137602,8
4677,4,0,1,35,0.0,0.027777777777777776,0.9722222222222222,36,1350,1000,350,0.7407407407407407,17,10,7,377.0364009334853,0.4349371693121693,0.06291706692283117,0.1931949662196091,126014.78273158852,2302.4320291066397,128317.21476069516,960,1,177.11111111111111,35,1,19,39.52317483189241,0.5818452380952381,48.98726851851851,1004.0509259259248,28.68716931216928,8
4678,4,2,3,34,0.05405405405405406,0.08108108108108109,0.9189189189189189,37,850,300,550,0.35294117647058826,14,3,11,367.3208902103662,0.4387825325325325,0.07764151033951006,0.1900036472508856,126402.72285997728,1886.0788351477404,128288.80169512502,961,0,173.21621621621622,34,3,14,39.36678702497929,0.5879289215686274,48.601190476190474,1005.5952380952377,29.576330532212875,0
4679,4,5,2,37,0.1282051282051282,0.05128205128205128,0.9487179487179487,39,900,500,400,0.5555555555555556,13,5,8,350.27795230330946,0.4434604138551507,0.09673177900191687,0.18389078891888086,127006.86486740102,1097.5409108432573,128104.40577824427,962,0,164.94871794871796,36,3,18,39.17416117379809,0.5899884259259259,48.00112612612612,1007.9954954954941,27.999874874874834,0
4680,4,2,0,39,0.05128205128205128,0.0,1.0,39,1050,900,150,0.8571428571428571,12,9,3,343.11816878176273,0.44680611785874946,0.11365898071100333,0.18144807964834708,127302.170138889,935.994567202344,128238.16470609135,963,0,165.56410256410257,34,5,20,39.051747866776765,0.5971200980392157,47.708333333333336,1009.1666666666677,29.68137254901964,0
4681,4,0,3,36,0.0,0.07692307692307693,0.9230769230769231,39,950,900,50,0.9473684210526315,10,9,1,345.9443974724101,0.44680611785874946,0.11620101596516719,0.18335053066037746,127392.29024943324,1014.1298185941218,128406.42006802736,964,1,166.56410256410257,34,5,13,38.88806996855347,0.5980392156862745,47.61904761904763,1009.5238095238105,29.69187675070031,0
4682,4,0,0,36,0.0,0.0,1.0,36,750,600,150,0.8,9,6,3,369.3413032030379,0.4419146825396825,0.10695373184734924,0.19386293674824429,126999.35308835552,2181.2213151191995,129180.57440347472,965,3,161.88888888888889,33,3,20,38.70149442755827,0.5962752525252526,48.008578431372555,1007.9656862745104,30.544414735591225,0
4683,4,0,2,34,0.0,0.05555555555555555,0.9444444444444444,36,650,300,350,0.46153846153846156,10,3,7,371.0430684471923,0.4421296296296296,0.08370900158936578,0.18698041915851304,125325.73276095923,2172.858431008365,127498.5911919676,966,4,162.88888888888889,31,5,18,40.38632423060252,0.584005376344086,49.67447916666667,1001.3020833333337,32.30006720430109,8
4684,4,4,2,36,0.10526315789473684,0.05263157894736842,0.9473684210526316,38,900,600,300,0.6666666666666666,12,6,6,350.5223081499108,0.4450124466571835,0.12233632862644406,0.18054540997671306,126228.49384851998,1249.1806036140215,127477.674452134,967,0,155.0,33,5,22,39.96849593495936,0.5883838383838385,48.77450980392158,1004.9019607843152,30.451574569221673,0
4685,4,2,2,36,0.05263157894736842,0.05263157894736842,0.9473684210526316,38,1000,700,300,0.7,13,7,6,346.2695462593914,0.44690908013276437,0.12120901376675985,0.17997250087861566,126598.21342752808,1167.4211841599672,127765.63461168804,968,0,153.52631578947367,33,5,20,39.69495859717486,0.5921717171717171,48.40686274509805,1006.3725490196097,30.49613784907908,0
4686,4,4,3,37,0.1,0.075,0.925,40,1000,700,300,0.7,13,7,6,346.05960343762314,0.45129540598290596,0.07186577735804556,0.1821921007284092,127122.02558106568,824.8517666870603,127946.87734775274,969,0,146.725,34,6,21,39.16228898595208,0.595281862745098,47.88690476190476,1008.4523809523803,29.660364145658242,8
4687,4,5,3,39,0.11904761904761904,0.07142857142857142,0.9285714285714286,42,1200,800,400,0.6666666666666666,16,8,8,327.916677040853,0.45056620209059234,0.12273572897287766,0.1778551791087748,128320.37278163576,19.77385282816232,128340.14663446392,970,0,140.38095238095238,35,7,22,38.39530500342701,0.6053571428571429,46.701388888888886,1013.1944444444441,28.94841269841269,0
4688,4,1,0,40,0.025,0.0,1.0,40,1550,1100,450,0.7096774193548387,20,11,9,337.26134042896945,0.44755608974358974,0.12849588719154004,0.18280853548092538,128295.24518140583,653.8052721088402,128949.05045351468,971,0,148.3,34,6,24,38.18424402663533,0.6072303921568627,46.726190476190474,1013.0952380952376,29.796918767506988,0
4689,4,0,0,40,0.0,0.0,1.0,40,1450,1000,450,0.6896551724137931,19,10,9,339.1095565407641,0.44748931623931626,0.12421893352125912,0.18436646005032364,128415.88010204089,709.4104308390104,129125.2905328799,972,1,149.3,34,6,17,38.014348915511704,0.6084558823529411,46.60714285714286,1013.5714285714291,29.810924369747916,0
4690,4,0,0,40,0.0,0.0,1.0,40,1050,600,450,0.5714285714285714,15,6,9,340.43193893142137,0.4468082264957265,0.11928923582580109,0.18578729582042156,128566.75347222236,753.6458333333524,129320.39930555572,973,2,150.3,34,6,17,37.826965215009594,0.6099877450980392,46.45833333333334,1014.1666666666679,29.828431372549055,0
4691,4,0,2,38,0.0,0.05,0.95,40,1150,900,250,0.782608695652174,14,9,5,345.39319677944235,0.44675480769230774,0.10338899803536283,0.17758094662700652,126153.96684556802,714.5443790397171,126868.51122460773,974,3,151.3,37,3,13,40.17408862693733,0.5793918918918919,48.84868421052632,1004.605263157896,27.151493598862054,8
4692,4,0,0,38,0.0,0.0,1.0,38,600,200,400,0.3333333333333333,10,2,8,356.24542393225835,0.44277501185395923,0.104582056867625,0.18254836860367607,126016.31180988395,1378.5468846183608,127394.85869450231,975,4,160.0,37,1,14,40.043477667358324,0.5779842342342343,48.985745614035096,1004.0570175438608,27.136676149834074,0
4693,4,0,0,38,0.0,0.0,1.0,38,1100,900,200,0.8181818181818182,13,9,4,382.4849064505678,0.4424193930772878,0.14551416134320783,0.18527234542428606,123668.09687522802,1860.2360928482437,125528.33296807625,976,5,161.0,38,0,17,41.824427139276764,0.5520833333333333,51.33547008547007,994.6581196581174,26.175213675213616,8
4694,4,5,4,39,0.11627906976744186,0.09302325581395349,0.9069767441860466,43,1050,600,450,0.5714285714285714,15,6,9,372.5872281521598,0.45051218161683276,0.22117086262696728,0.18789835199965077,125356.61363352183,763.6922504280587,126120.30588394988,977,0,143.1627906976744,37,6,14,40.315682141683986,0.5712274774774775,49.64364035087719,1001.4254385964911,27.065552394499758,0
4695,4,0,0,39,0.0,0.0,1.0,39,1000,800,200,0.8,12,8,4,389.7086522807971,0.4474527665317139,0.2229588052704352,0.19499359069749692,125029.76367630374,1945.0361394557663,126974.79981575951,978,1,150.71794871794873,34,5,18,40.22636194103875,0.5738357843137255,49.97023809523809,1000.1190476190467,29.415266106442548,0
4696,4,1,0,40,0.025,0.0,1.0,40,1000,700,300,0.7,13,7,6,371.0919630925372,0.4513087606837607,0.20326999300536164,0.17783390276021155,123212.45525763048,1156.917794767097,124369.37305239758,979,0,147.925,35,5,14,42.58325561513948,0.5529761904761905,51.79398148148149,992.8240740740755,28.366402116402156,8
4697,4,4,1,43,0.09090909090909091,0.022727272727272728,0.9772727272727273,44,1150,800,350,0.6956521739130435,15,8,7,344.3686151761238,0.4614825581395349,0.2234811957569911,0.16924656584722314,124279.88627958595,-238.11762320819554,124041.76865637775,980,0,135.38636363636363,38,6,14,42.13677274188364,0.5583881578947368,50.721153846153854,997.1153846153859,26.239878542510155,0
4698,4,4,1,46,0.0851063829787234,0.02127659574468085,0.9787234042553191,47,1400,1200,200,0.8571428571428571,16,12,4,323.68328177383717,0.4666011409189022,0.23810207026931218,0.1622277442051381,125099.22603300597,-1301.494394053902,123797.73163895206,981,0,127.65957446808511,41,6,18,41.80550046277932,0.5619918699186992,49.90079365079366,1000.3968253968269,24.399922570654315,0
4699,4,3,2,47,0.061224489795918366,0.04081632653061224,0.9591836734693877,49,1600,1300,300,0.8125,19,13,6,318.16531976211013,0.47022037981859416,0.25939707706412096,0.16239305049129668,125853.72546487609,-1791.5418388429725,124062.18362603312,982,0,123.18367346938776,43,6,17,41.16647791619476,0.5668604651162791,49.14772727272727,1003.4090909090913,23.33509513742073,0
4700,4,2,2,47,0.04081632653061224,0.04081632653061224,0.9591836734693877,49,1600,1100,500,0.6875,21,11,10,319.1301463865926,0.4664824263038549,0.2627680675008306,0.16374314748872498,126069.98833550357,-1752.879312478468,124317.1090230251,983,0,124.10204081632654,39,10,20,40.91996421533037,0.5750534188034189,48.93229166666667,1004.2708333333342,25.75053418803421,0
4701,4,0,5,42,0.0,0.10638297872340426,0.8936170212765957,47,1500,800,700,0.5333333333333333,22,8,14,339.2202806841417,0.4645968239284613,0.22606275085235827,0.17169979299515592,125508.6464736599,-656.8973204142279,124851.74915324568,984,1,129.80851063829786,40,7,13,40.994126098715334,0.5677083333333333,49.49186991869919,1002.0325203252036,25.05081300813009,8
4702,4,4,2,44,0.08695652173913043,0.043478260869565216,0.9565217391304348,46,1700,1100,600,0.6470588235294118,23,11,12,354.96150579922823,0.4637580515297906,0.2783382127554579,0.1826228117708213,126181.50686990216,-239.80717318538825,125941.69969671678,985,0,130.84782608695653,37,9,17,39.90539397577212,0.5796734234234234,48.821271929824555,1004.7149122807008,27.154457088667588,0
4703,4,5,3,46,0.10204081632653061,0.061224489795918366,0.9387755102040817,49,1750,1400,350,0.8,21,14,7,333.90973237426533,0.4665355725623583,0.29690466601461396,0.17677992867490416,127348.32523630113,-1292.15771767863,126056.1675186225,986,0,123.04081632653062,40,9,15,39.236810310108766,0.5864583333333333,47.66260162601626,1009.3495934959348,25.233739837398367,0
4704,4,2,1,47,0.041666666666666664,0.020833333333333332,0.9791666666666666,48,1450,1100,350,0.7586206896551724,18,11,7,343.0148833997226,0.46320921985815605,0.3203847409851841,0.18245832826808084,127538.80343967032,-850.4584418402601,126688.34499783005,987,0,126.41666666666667,39,9,18,38.811939259564824,0.5900106837606838,47.47395833333334,1010.1041666666681,25.900106837606874,0
4705,4,1,1,47,0.020833333333333332,0.020833333333333332,0.9791666666666666,48,1600,1200,400,0.75,20,12,8,348.5762999697877,0.4630891696217494,0.3382453903491567,0.1870570502364189,127893.5382023181,-683.8687326782418,127209.66946963986,988,0,127.27083333333333,41,7,19,38.308323525565605,0.5904471544715447,47.12301587301588,1011.5079365079376,24.670925280681406,0
4706,4,0,2,45,0.0,0.0425531914893617,0.9574468085106383,47,1750,1300,450,0.7428571428571429,22,13,9,354.5692071905897,0.4617252543940795,0.33182430945600316,0.19097645940568353,128041.65556423122,-320.07433984397767,127721.58122438724,989,1,130.87234042553192,40,7,19,38.00519630484989,0.5934895833333333,46.97662601626018,1012.0934959349615,25.30233739837404,0
4707,4,3,0,48,0.0625,0.0,1.0,48,1550,1000,550,0.6451612903225806,21,10,11,338.94757491814744,0.4626366725768321,0.33811741387778005,0.18616646571515827,128821.5047209439,-867.0874299509783,127954.41729099293,990,0,128.4375,38,10,19,37.605021749807044,0.6047149122807017,46.20726495726496,1015.1709401709409,26.71502474134055,0
4708,4,1,0,49,0.02040816326530612,0.0,1.0,49,1300,1000,300,0.7692307692307693,16,10,6,332.51639339615696,0.4628153344671202,0.34067205524345545,0.18403411457415417,129123.91067031864,-1212.8365845396174,127911.07408577902,991,0,126.79591836734694,40,9,20,37.46062893710629,0.6044270833333334,45.90955284552846,1016.3617886178865,25.409044715447163,0
4709,4,1,3,47,0.02,0.06,0.94,50,1400,1000,400,0.7142857142857143,18,10,8,328.3937624120451,0.46265306122448985,0.352670025188917,0.1836229910951856,129527.44904667966,-1492.7290214168177,128034.72002526284,992,0,125.24,38,12,15,37.15562027707809,0.611842105263158,45.512820512820504,1017.9487179487166,26.788124156545177,0
4710,4,0,0,47,0.0,0.0,1.0,47,750,400,350,0.5333333333333333,11,4,7,343.423239135207,0.4602412889300031,0.35204165783087094,0.19072028594040086,129258.63997443387,-521.9158347536767,128736.7241396802,993,1,131.4255319148936,36,11,21,37.046419342930946,0.6128472222222222,45.777027027027025,1016.8918918918918,28.246996996996995,0
4711,4,0,2,45,0.0,0.0425531914893617,0.9574468085106383,47,1400,900,500,0.6428571428571429,19,9,10,343.10272419666865,0.4598751156336725,0.35321579498891387,0.19121022089014317,129396.5465936632,-520.7384724146148,128875.80812124858,994,2,132.4255319148936,37,10,21,36.91433613535942,0.6123310810810811,45.64144736842104,1017.4342105263139,27.49822190611659,0
4712,4,0,0,45,0.0,0.0,1.0,45,1450,1000,450,0.6896551724137931,19,10,9,356.7589357699544,0.4585016835016835,0.34699453551912596,0.19783904619970177,129201.3888888887,218.74999999997453,129420.13888888867,995,3,138.0222222222222,35,10,21,36.76571038251366,0.6142857142857143,45.83333333333332,1016.6666666666652,29.047619047619005,0
4713,4,1,1,45,0.021739130434782608,0.021739130434782608,0.9782608695652174,46,1350,900,450,0.6666666666666666,18,9,9,354.87109375922296,0.45887681159420285,0.356263495284765,0.19866189217815095,129573.74762854083,-3.604491315626433,129570.14313722521,996,0,136.0,36,10,16,36.43471408030086,0.6160300925925926,45.46734234234235,1018.1306306306317,28.281406406406436,0
4714,4,0,0,45,0.0,0.0,1.0,45,1500,800,700,0.5333333333333333,22,8,14,357.09083731464244,0.45930134680134677,0.3444633859908326,0.20025763400455943,129643.02722318663,258.86742862653097,129901.89465181316,997,1,136.95555555555555,35,10,16,36.30774803954995,0.61875,45.39930555555555,1018.4027777777769,29.097222222222197,0
4715,4,0,2,43,0.0,0.044444444444444446,0.9555555555555556,45,850,600,250,0.7058823529411765,11,6,5,355.42975206611567,0.45909090909090905,0.34070707070707074,0.19947588126159557,129672.49657064477,217.89266117970408,129890.38923182448,998,2,137.95555555555555,35,10,16,36.320075757575765,0.6190476190476191,45.370370370370374,1018.5185185185189,29.100529100529112,0
4716,4,0,0,43,0.0,0.0,1.0,43,1250,1000,250,0.8,15,10,5,365.425218128239,0.4585871170173496,0.33588408791268565,0.20499755679259565,129655.65653344664,875.8893140589512,130531.5458475056,999,3,142.51162790697674,34,9,16,36.08270017533607,0.6210171568627452,45.38690476190476,1018.4523809523804,29.954481792717072,0
4717,4,0,0,43,0.0,0.0,1.0,43,1100,900,200,0.8181818181818182,13,9,4,366.8854907041523,0.4584948320413436,0.33866313037712636,0.20629474569291265,129746.60572562339,920.4294217686856,130667.03514739207,1000,4,143.51162790697674,34,9,16,35.95295824569604,0.6219362745098039,45.29761904761904,1018.8095238095223,29.964985994397715,0
4718,4,1,3,41,0.022727272727272728,0.06818181818181818,0.9318181818181819,44,1050,900,150,0.8571428571428571,12,9,3,358.5464201969623,0.4593243481324876,0.3343325222557738,0.20326370183378029,130066.77685682113,526.9954457140457,130593.77230253517,1001,0,141.22727272727272,37,7,17,35.84002920204952,0.6190878378378378,44.98355263157894,1020.0657894736826,27.569345661450882,0
4719,4,0,0,41,0.0,0.0,1.0,41,1950,1600,350,0.8205128205128205,23,16,7,380.5186495539914,0.4568089430894309,0.33438076712055476,0.2138777237148298,129731.44531250012,1673.0468750000148,131404.49218750015,1002,1,151.65853658536585,35,6,18,35.62116564417179,0.6196428571428572,45.31250000000001,1018.7500000000009,29.107142857142883,0
4720,4,2,1,42,0.046511627906976744,0.023255813953488372,0.9767441860465116,43,1000,700,300,0.7,13,7,6,368.6627244280939,0.4584256183093392,0.343743982317432,0.21055973150509288,130356.43029423774,1015.8516255766933,131372.28191981444,1003,0,145.5581395348837,33,10,20,35.287786511460446,0.6303661616161615,44.69975490196078,1021.2009803921565,30.94548425430777,0
4721,4,0,1,41,0.0,0.023809523809523808,0.9761904761904762,42,1100,700,400,0.6363636363636364,15,7,8,373.260105027585,0.45826074332171896,0.34119176164767073,0.21352937374090034,130419.01139285351,1336.042778018045,131755.05417087156,985,1,126.14285714285714,33,9,21,35.10685362927415,0.6309974747474747,44.63848039215685,1021.446078431371,30.9529114676173,0
4722,4,0,1,40,0.0,0.024390243902439025,0.975609756097561,41,1050,600,450,0.5714285714285714,15,6,9,372.92771243533184,0.4564024390243902,0.3241201248625971,0.21448963608052188,130627.42524092962,1542.9173752834342,132170.34261621305,986,2,126.1951219512195,34,7,18,34.90377896820774,0.6308210784313726,44.4345238095238,1022.261904761904,30.066526610644235,0
4723,4,1,1,40,0.024390243902439025,0.024390243902439025,0.975609756097561,41,1400,1000,400,0.7142857142857143,18,10,8,370.3420535788408,0.4561737804878048,0.31552550340569563,0.21442004555930141,130883.62328800157,1494.3419656635847,132377.96525366517,987,0,123.63414634146342,35,6,19,34.710086528673216,0.63125,44.18402777777778,1023.2638888888891,29.236111111111118,0
4724,4,1,1,40,0.024390243902439025,0.024390243902439025,0.975609756097561,41,1150,800,350,0.6956521739130435,15,8,7,370.18945677742397,0.4558434959349593,0.32325137086569233,0.21532321657527068,131061.33355034716,1503.5047743055516,132564.83832465272,988,0,124.53658536585365,35,6,21,34.53395218718211,0.6330357142857144,44.010416666666664,1023.9583333333328,29.255952380952365,0
4725,4,0,1,39,0.0,0.025,0.975,40,1050,900,150,0.8571428571428571,12,9,3,378.6918211160517,0.45495459401709404,0.31945736884959874,0.219528899941652,130931.84700963728,1916.5639172335689,132848.41092687086,989,1,127.9,34,6,21,34.44757861269435,0.6338848039215687,44.136904761904766,1023.4523809523816,30.10154061624652,0
4726,4,1,0,40,0.025,0.0,1.0,40,1700,1400,300,0.8235294117647058,20,14,6,375.84337428819595,0.4534321581196581,0.31828219432821925,0.21908918647531436,131145.15306122453,1858.0073696145175,133003.16043083905,990,0,128.7,34,6,22,34.304296451262985,0.6360294117647058,43.92857142857143,1024.2857142857147,30.126050420168077,0
4727,4,1,1,40,0.024390243902439025,0.024390243902439025,0.975609756097561,41,650,400,250,0.6153846153846154,9,4,5,367.7533818880291,0.4533790650406504,0.3239350499354574,0.21643190835705334,131511.22448979606,1472.8670634920734,132984.09155328813,991,0,126.53658536585365,34,7,23,34.14118113587123,0.6397058823529411,43.57142857142858,1025.7142857142867,30.168067226890784,0
4728,4,0,0,40,0.0,0.0,1.0,40,1100,700,400,0.6363636363636364,15,7,8,377.9173812843849,0.45373931623931624,0.2598965848965853,0.21292418311388506,129825.09731833905,1812.6321607074162,131637.72947904645,992,1,124.1,33,7,18,35.592031425364766,0.625,45.220588235294116,1019.1176470588231,30.882352941176457,8
4729,4,2,0,42,0.047619047619047616,0.0,1.0,42,1300,1000,300,0.7692307692307693,16,10,6,360.22029492940163,0.4544376693766938,0.2563701162442129,0.205723681085513,130353.74858276638,991.949046775565,131345.69762954194,993,0,119.14285714285714,34,8,20,35.50604258957022,0.6280637254901961,44.70238095238095,1021.1904761904757,30.035014005602225,0
4730,4,0,1,41,0.0,0.023809523809523808,0.9761904761904762,42,1100,700,400,0.6363636363636364,15,7,8,359.9741361979125,0.45397793263646924,0.25915750915750935,0.20590520590520603,130414.54081632655,989.1723356009122,131403.71315192746,994,1,120.14285714285714,34,8,21,35.45066045066046,0.6286764705882353,44.642857142857146,1021.4285714285716,30.042016806722692,0
4731,4,0,1,40,0.0,0.024390243902439025,0.975609756097561,41,1300,800,500,0.6153846153846154,18,8,10,363.8969886642031,0.4528963414634146,0.26802350077243564,0.20834102318027473,130450.30757401012,1294.0948193002876,131744.40239331042,995,2,123.92682926829268,33,8,21,35.31419945617403,0.6313131313131313,44.60784313725491,1021.5686274509815,30.956625074272164,0
4732,4,1,1,40,0.024390243902439025,0.024390243902439025,0.975609756097561,41,1350,1000,350,0.7407407407407407,17,10,7,357.9051238839686,0.45299796747967475,0.25624068935300137,0.2072474191699818,130888.84833958092,1169.1578960015404,132058.00623558246,996,0,123.82926829268293,33,8,17,35.022954091816366,0.6357323232323233,44.17892156862745,1023.2843137254902,31.008615567439097,0
4733,4,1,0,41,0.024390243902439025,0.0,1.0,41,950,900,50,0.9473684210526315,10,9,1,358.39468608633456,0.45241361788617884,0.26870726452057436,0.20820787257060072,131014.28086553245,1190.9644127258719,132205.2452782583,997,0,124.73170731707317,33,8,18,34.88348894741043,0.6369949494949495,44.056372549019606,1023.7745098039213,31.02346999405822,0
4734,4,1,0,42,0.023809523809523808,0.0,1.0,42,1100,700,400,0.6363636363636364,15,7,8,366.0832023549471,0.45388114595431667,0.2870611748348977,0.2006135948905109,128731.13854595325,1072.3587586208407,129803.49730457409,998,0,122.73809523809524,35,7,19,37.00862986618004,0.6095238095238096,46.29629629629629,1014.814814814814,28.994708994708972,8
4735,4,1,2,41,0.023255813953488372,0.046511627906976744,0.9534883720930233,43,1150,900,250,0.782608695652174,14,9,5,359.88723830853365,0.455172572905131,0.2868380289131911,0.19885257509233903,129058.31665702852,689.28823248923,129747.60488951775,999,0,120.86046511627907,36,7,20,36.83203110569286,0.6108217592592593,45.97409909909909,1016.1036036036026,28.22510010010007,0
4736,4,1,1,41,0.023809523809523808,0.023809523809523808,0.9761904761904762,42,750,400,350,0.5333333333333333,11,4,7,350.9544003179078,0.4569178281068525,0.22685264065509148,0.1880797463179582,127839.40882050236,573.1606119190446,128412.5694324214,1000,0,123.88095238095238,37,5,17,38.303584336260805,0.5965653153153153,47.176535087719294,1011.2938596491219,27.332266477003294,8
4737,4,2,2,41,0.046511627906976744,0.046511627906976744,0.9534883720930233,43,1400,1000,400,0.7142857142857143,18,10,8,347.584153284197,0.4568567737172388,0.2450842787389076,0.18849997752247866,128315.61872260776,320.8225246401048,128636.44124724786,1001,0,121.93023255813954,36,7,19,37.90198584713422,0.6032986111111112,46.70608108108108,1013.1756756756758,28.143768768768773,0
4738,4,1,2,40,0.023809523809523808,0.047619047619047616,0.9523809523809523,42,1600,1000,600,0.625,22,10,12,347.4624938870487,0.4586841850561363,0.25126050420168067,0.19019666281423517,128686.69979100728,542.7603278954709,129229.46011890276,1002,0,122.95238095238095,36,6,18,37.526359600443946,0.6070601851851851,46.340090090090094,1014.6396396396401,28.184434434434447,0
4739,4,0,2,38,0.0,0.05,0.95,40,1500,1100,400,0.7333333333333333,19,11,8,362.42718066894747,0.4568242521367521,0.2667928848185981,0.19749150977334776,128506.3934948979,1314.8419784580421,129821.23547335595,1003,1,129.725,34,6,18,37.33097530429337,0.609375,46.51785714285714,1013.928571428571,29.82142857142856,0
4740,4,0,0,38,0.0,0.0,1.0,38,950,700,250,0.7368421052631579,12,7,5,371.5757595504984,0.45498458985301093,0.24421727150665906,0.20205806096266754,128423.86529519898,1943.839058294892,130367.70435349387,1004,2,122.02631578947368,33,5,18,37.1835076371257,0.6107954545454546,46.599264705882355,1013.6029411764707,30.715240641711233,0
4741,4,1,0,39,0.02564102564102564,0.0,1.0,39,1150,700,450,0.6086956521739131,16,7,9,360.848281299856,0.45611223571749887,0.24934537069605667,0.19843165642852828,128868.76594387753,1500.4145408163247,130369.18048469386,1005,0,119.87179487179488,34,5,19,37.00096728807598,0.6130514705882353,46.160714285714285,1015.3571428571427,29.863445378151255,0
4742,4,0,1,38,0.0,0.02564102564102564,0.9743589743589743,39,1200,900,300,0.75,15,9,6,363.5883402736466,0.45602789023841656,0.21867417135709832,0.18727540139723026,126228.49384851998,1409.7850537274003,127638.27890224739,1006,1,120.87179487179488,33,6,22,39.64024390243904,0.5883838383838385,48.77450980392158,1004.9019607843152,30.451574569221673,8
4743,4,2,0,40,0.05,0.0,1.0,40,1250,1000,250,0.8,15,10,5,367.8007071813946,0.45918803418803417,0.16937514849132818,0.18629039428718303,125536.28826530614,1450.9854064174715,126987.27367172361,1007,0,118.4,34,6,17,40.24956442543757,0.5790441176470589,49.464285714285715,1002.1428571428573,29.474789915966394,8
4744,4,2,0,42,0.047619047619047616,0.0,1.0,42,950,700,250,0.7368421052631579,12,7,5,352.8621956062275,0.4641163375919473,0.1716443419000624,0.18081145609339788,126015.5679327976,493.22599626653164,126508.79392906412,1008,0,113.71428571428571,36,6,19,40.129168535965306,0.5798611111111112,48.986486486486484,1004.0540540540535,27.890390390390376,0
4745,4,2,1,43,0.045454545454545456,0.022727272727272728,0.9772727272727273,44,1350,900,450,0.6666666666666666,18,9,9,369.6300189525187,0.4666028012684989,0.218239962461237,0.1888843307858284,125902.52414576741,516.6297632091545,126419.15390897657,1009,0,109.5,36,8,17,39.82504862357868,0.5787037037037037,49.0990990990991,1003.6036036036038,27.877877877877882,8
4746,4,3,4,42,0.06521739130434782,0.08695652173913043,0.9130434782608696,46,950,800,150,0.8421052631578947,11,8,3,352.8418443219394,0.4705112721417069,0.2232000800520335,0.1827291792108254,126450.94548396766,-276.3252558270385,126174.62022814063,1010,0,105.65217391304348,35,11,16,39.68114691215957,0.5863095238095238,48.55324074074073,1005.7870370370362,28.736772486772463,0
4747,4,2,3,41,0.045454545454545456,0.06818181818181818,0.9318181818181819,44,1350,900,450,0.6666666666666666,18,9,9,366.4032306640098,0.4679351656095842,0.24271398516221843,0.1901498434735474,126536.55595203764,472.6805795847618,127009.2365316224,1011,0,110.95454545454545,33,11,18,39.25192854242792,0.591540404040404,48.468137254901954,1006.1274509803918,30.48871063576945,0
4748,4,2,1,42,0.046511627906976744,0.023255813953488372,0.9767441860465116,43,1250,900,350,0.72,16,9,7,371.24691423801653,0.4656238464377999,0.27152153001754065,0.1941252948496498,126844.99351211065,818.1624855824591,127663.15599769312,1012,0,114.18604651162791,33,10,20,38.812347931873475,0.5946969696969697,48.16176470588235,1007.35294117647,30.525846702317274,0
4749,4,1,0,43,0.023255813953488372,0.0,1.0,43,1250,800,450,0.64,17,8,9,372.6812034480751,0.4652316352897748,0.27614219331875955,0.195773227717016,127032.00113378672,868.4878117913661,127900.48894557808,1013,0,114.90697674418605,34,9,21,38.583736813100295,0.5943627450980392,47.97619047619047,1008.095238095237,29.64985994397756,0
4750,4,1,1,43,0.022727272727272728,0.022727272727272728,0.9772727272727273,44,1150,1000,150,0.8695652173913043,13,10,3,361.4688785112918,0.46672392529950674,0.2659852653599528,0.19166479791619934,127410.50020406062,411.02864087169115,127821.52884493231,1014,0,113.27272727272727,32,12,15,38.477572119393024,0.6028645833333333,47.60101010101009,1009.5959595959581,31.54987373737369,0
4751,4,3,4,42,0.06521739130434782,0.08695652173913043,0.9130434782608696,46,1050,500,550,0.47619047619047616,16,5,11,345.4151208188558,0.4673812399355877,0.27385338205682785,0.18611554106967906,128056.65569540884,-353.4589602623559,127703.19673514648,1015,0,109.28260869565217,35,11,18,38.22148370497426,0.6026785714285714,46.96180555555555,1012.1527777777769,28.91865079365077,0
4752,4,2,0,44,0.045454545454545456,0.0,1.0,44,1650,1500,150,0.9090909090909091,18,15,3,360.83761916903495,0.4644225687103594,0.29334051235547465,0.1950079316533465,128176.49347005412,450.2102882518433,128626.70375830596,1016,0,114.72727272727273,32,12,20,37.70859310058188,0.6106770833333333,46.843434343434346,1012.626262626263,31.64457070707072,0
4753,4,0,2,42,0.0,0.045454545454545456,0.9545454545454546,44,850,400,450,0.47058823529411764,13,4,9,362.3999968672538,0.4640702078928823,0.292666757326443,0.1961655043771329,128240.42986685035,494.8662764003694,128735.29614325071,1017,1,115.72727272727273,32,12,20,37.60362129144851,0.611328125,46.78030303030303,1012.8787878787881,31.652462121212128,0
4754,4,0,0,42,0.0,0.0,1.0,42,950,800,150,0.8421052631578947,11,8,3,383.9220593725582,0.4602327719705768,0.30728774206196063,0.20680708021503086,128045.67337036131,1431.9117228190094,129477.58509318033,1018,2,121.85714285714286,31,11,20,37.25837836099318,0.6118951612903225,46.97265625,1012.1093749999999,32.64868951612903,0
4755,4,2,2,42,0.045454545454545456,0.045454545454545456,0.9545454545454546,44,900,500,400,0.5555555555555556,13,5,8,365.9540961561266,0.46192300916138124,0.2935379529254125,0.19993412896925797,128610.25694744803,613.0900675221039,129223.34701497013,1019,0,117.27272727272727,33,11,19,37.13541037412912,0.6126893939393939,46.41544117647059,1014.3382352941171,30.73752228163991,0
4756,4,0,0,42,0.0,0.0,1.0,42,1400,1000,400,0.7142857142857143,18,10,8,389.06349966525715,0.4598093302361595,0.31387283236994223,0.21166033157889774,128441.33377075195,1594.3669637044272,130035.70073445638,1020,4,123.85714285714286,31,11,19,36.72246307000643,0.6159274193548387,46.58203125,1013.671875,32.69909274193548,0
4757,4,0,0,42,0.0,0.0,1.0,42,1250,800,450,0.64,17,8,9,383.6012236843582,0.45925280681378244,0.2809973862318469,0.20570896030324906,127865.50132461046,1412.114749308565,129277.61607391902,1021,5,124.85714285714286,33,9,18,37.45140655923098,0.6051136363636364,47.15073529411763,1011.3970588235272,30.648395721925066,8
4758,4,2,2,42,0.045454545454545456,0.045454545454545456,0.9545454545454546,44,1350,1000,350,0.7407407407407407,17,10,7,368.8049265027741,0.4630351479915433,0.2695621593107089,0.20070752315993062,128454.92118415986,675.5697928681162,129130.49097702798,1022,0,120.13636363636364,33,11,17,37.22195357833655,0.6111111111111112,46.56862745098039,1013.7254901960778,30.718954248365993,0
4759,4,1,1,42,0.023255813953488372,0.023255813953488372,0.9767441860465116,43,800,400,400,0.5,12,4,8,385.7158040174304,0.45824104835732743,0.2378326540397988,0.2055738076356632,127617.73003472203,1259.6280577181612,128877.35809244019,1023,0,123.90697674418605,33,10,19,37.652491408934715,0.6025883838383839,47.39583333333332,1010.416666666665,30.61868686868682,8
4760,4,2,2,42,0.045454545454545456,0.045454545454545456,0.9545454545454546,44,2000,1600,400,0.8,24,16,8,372.9740041540963,0.46000704721634955,0.23636470537928655,0.2012545007186824,128114.39909297053,756.668083900227,128871.06717687075,1024,0,121.86363636363636,34,10,21,37.464967466290375,0.6053921568627452,46.904761904761905,1012.3809523809524,29.77591036414566,0
4761,4,1,1,42,0.023255813953488372,0.023255813953488372,0.9767441860465116,43,1400,1100,300,0.7857142857142857,17,11,6,366.7007979789876,0.46075581395348836,0.222387761814139,0.19971795271100484,128485.98082768639,823.1858828089943,129309.16671049538,1025,0,117.65116279069767,33,10,16,37.24351807083282,0.6114267676767677,46.537990196078425,1013.8480392156856,30.722667855020777,0
4762,4,0,2,40,0.0,0.047619047619047616,0.9523809523809523,42,1350,900,450,0.6666666666666666,18,9,9,381.7226496528429,0.45826074332171896,0.22954990215264193,0.20795338376610098,128496.33487654322,1409.9922839506185,129906.32716049383,1026,2,121.45238095238095,32,10,16,36.852168949771695,0.6139322916666667,46.52777777777778,1013.8888888888889,31.68402777777778,0
4763,4,1,2,39,0.024390243902439025,0.04878048780487805,0.9512195121951219,41,1100,900,200,0.8181818181818182,13,9,4,377.11804288587473,0.46021341463414633,0.229363559962257,0.2069386994375117,128784.53290799403,1513.3942008468434,130297.92710884087,1027,0,121.09756097560975,32,9,18,36.67407845088527,0.6168619791666667,46.243686868686865,1015.0252525252521,31.719539141414128,0
4764,4,0,0,39,0.0,0.0,1.0,39,1100,700,400,0.6363636363636364,15,7,8,397.71265261726484,0.4566183085919928,0.23804766661909538,0.2171591661830594,128587.20119377962,2428.151375881603,131015.35256966122,1028,1,128.15384615384616,30,9,19,36.353697323085086,0.6201388888888889,46.43817204301075,1014.2473118279569,33.808243727598565,0
4765,4,3,2,40,0.07142857142857142,0.047619047619047616,0.9523809523809523,42,1150,1000,150,0.8695652173913043,13,10,3,372.1513378253333,0.457909891598916,0.24646725116039203,0.20867595258626992,129637.8270977509,1248.9781574394501,130886.80525519034,1029,0,119.92857142857143,33,9,16,35.92960288808665,0.6231060606060606,45.404411764705884,1018.3823529411767,30.86007130124778,0
4766,4,1,0,41,0.024390243902439025,0.0,1.0,41,1150,800,350,0.6956521739130435,15,8,7,369.8937657571616,0.4578252032520325,0.23483382019967336,0.20840356070708377,129825.09731833909,1404.2988273740839,131229.39614571317,1030,0,121.5609756097561,33,8,18,35.79645662978996,0.625,45.220588235294116,1019.1176470588234,30.882352941176467,0
4767,4,0,1,40,0.0,0.024390243902439025,0.975609756097561,41,1000,500,500,0.5,15,5,10,372.0864922337278,0.45752032520325203,0.2407598499061916,0.2103097564799331,129950.01922337557,1470.5293637062591,131420.54858708184,1031,1,122.5609756097561,33,8,18,35.61348157051281,0.6262626262626263,45.09803921568627,1019.6078431372545,30.89720736779559,0
4768,4,0,1,39,0.0,0.025,0.975,40,1150,800,350,0.6956521739130435,15,8,7,372.61981269291937,0.45663728632478634,0.22418288872867165,0.21094844090003223,130012.5027032872,1689.0468810073098,131701.54958429452,1032,2,122.575,33,7,18,35.53632940799489,0.6268939393939394,45.036764705882355,1019.8529411764706,30.90463458110517,0
4769,4,1,1,39,0.025,0.025,0.975,40,1150,700,450,0.6086956521739131,16,7,9,372.94043004327347,0.4547008547008547,0.22826648252672066,0.2119778130355178,130168.77710796316,1709.0399425701496,131877.8170505333,1033,0,123.425,33,7,19,35.36925563428205,0.6284722222222222,44.88357843137254,1020.4656862745088,30.923202614379054,0
4770,4,1,0,40,0.025,0.0,1.0,40,1050,800,250,0.7619047619047619,13,8,5,372.21486437199997,0.4547409188034188,0.23091410748560492,0.21310323553605703,130450.30757400989,1711.108708189146,132161.41628219903,1034,0,123.875,33,7,22,35.10176743442099,0.6313131313131313,44.607843137254896,1021.5686274509795,30.956625074272107,0
4771,4,0,0,40,0.0,0.0,1.0,40,1250,900,350,0.72,16,9,7,375.79549183756177,0.45468749999999997,0.2357981783317351,0.21654955689866154,130700.81218762034,1823.355199923129,132524.16738754348,1035,1,124.875,33,7,19,34.75601230425057,0.6338383838383839,44.36274509803923,1022.5490196078447,30.986333927510444,0
4772,4,0,1,39,0.0,0.025,0.975,40,750,600,150,0.8,9,6,3,385.4146407829853,0.45471420940170937,0.1375165324035108,0.2173215977892941,129856.32216274987,2009.7055519511687,131866.02771470105,1036,2,125.875,33,7,16,35.36919862931345,0.6253156565656566,45.189950980392155,1019.2401960784312,30.88606654783125,8
4773,4,0,0,39,0.0,0.0,1.0,39,1200,800,400,0.6666666666666666,16,8,8,394.68867338948866,0.4520355375618534,0.15159612995891414,0.2229066581077498,129918.78311526812,2455.494431228368,132374.27754649648,1037,4,130.05128205128204,33,6,17,35.06919401370357,0.6259469696969697,45.12867647058823,1019.4852941176466,30.893493761140807,0
4774,4,0,0,39,0.0,0.0,1.0,39,1550,1200,350,0.7741935483870968,19,12,7,395.802068138516,0.451951192082771,0.14823987481363798,0.22443163591178517,130075.00120146098,2496.7908977316442,132571.79209919262,1038,5,131.05128205128204,33,6,17,34.881567355438094,0.6275252525252526,44.97549019607843,1020.0980392156863,30.912061794414736,0
4775,4,1,1,39,0.025,0.025,0.975,40,750,500,250,0.6666666666666666,10,5,5,387.9436225375547,0.45408653846153846,0.1503419726421884,0.2217504904134418,130387.71896626303,2116.751970396007,132504.47093665903,1039,0,128.75,33,7,18,34.763718902487796,0.6306818181818181,44.669117647058826,1021.3235294117652,30.94919786096258,0
4776,4,0,1,38,0.0,0.02564102564102564,0.9743589743589743,39,950,600,350,0.631578947368421,13,6,7,396.62644170266685,0.4522604588394062,0.15265428517993707,0.22673577999525607,130391.51178770025,2543.3442697173787,132934.85605741764,1040,1,132.89743589743588,32,7,18,34.538158816499774,0.6331380208333333,44.66540404040404,1021.338383838384,31.9168244949495,0
4777,4,2,1,39,0.05,0.025,0.975,40,950,600,350,0.631578947368421,13,6,7,379.2320173066521,0.4533253205128205,0.13453488372093014,0.22036455059710874,131023.24263038556,1937.6417233560173,132960.88435374157,1041,0,120.775,34,6,18,34.34108527131782,0.6348039215686274,44.04761904761905,1023.8095238095243,30.112044817927185,0
4778,4,2,0,41,0.04878048780487805,0.0,1.0,41,1050,700,350,0.6666666666666666,14,7,7,366.4266865477722,0.45172764227642276,0.12530192073858415,0.21629420791827922,131624.8780971367,1446.5278980676865,133071.4059952044,1042,0,114.48780487804878,35,6,16,34.060361681329425,0.6386904761904761,43.46064814814816,1026.1574074074092,29.31878306878312,0
4779,4,0,2,39,0.0,0.04878048780487805,0.9512195121951219,41,800,500,300,0.625,11,5,6,365.50508037596063,0.4512957317073171,0.12799102280603347,0.216086603518268,131684.2689043211,1426.2538580247083,133110.52276234582,1043,1,115.48780487804878,35,6,16,34.02401894451963,0.6392857142857142,43.402777777777786,1026.3888888888898,29.32539682539685,0
4780,4,0,0,39,0.0,0.0,1.0,39,1500,1100,400,0.7333333333333333,19,11,8,372.1369267271181,0.44880229419703105,0.12389001818765366,0.22112929778247775,131877.8061224491,2015.3202947845969,133893.1264172337,1044,2,119.71794871794872,34,5,16,33.65834106011436,0.6433823529411764,43.21428571428572,1027.1428571428582,30.210084033613477,0
4781,4,1,1,39,0.025,0.025,0.975,40,950,700,250,0.7368421052631579,12,7,5,363.06386266797676,0.44878472222222227,0.12341235081572322,0.21771912394922105,132224.214818704,1601.166834063814,133825.38165276783,1045,0,117.7,36,4,18,33.54205445454215,0.642650462962963,42.87725225225226,1028.4909909909923,28.56919419419423,0
4782,4,0,0,39,0.0,0.0,1.0,39,900,700,200,0.7777777777777778,11,7,4,368.13662044982436,0.4475933423301844,0.12566377148569696,0.22042331025097373,132166.3106307322,1931.0517865838972,134097.3624173161,1046,1,121.61538461538461,36,3,18,33.470001460227074,0.6420717592592593,42.933558558558566,1028.2657657657667,28.562937937937964,0
4783,4,0,0,39,0.0,0.0,1.0,39,1300,900,400,0.6923076923076923,17,9,8,373.03047299688853,0.4470310391363023,0.13916527770762888,0.2245554981716448,132369.03077063555,2075.5364317019826,134444.56720233752,1047,2,122.61538461538461,36,3,20,33.13977347340776,0.6440972222222222,42.73648648648649,1029.0540540540546,28.58483483483485,0
4784,4,0,0,39,0.0,0.0,1.0,39,1350,1000,350,0.7407407407407407,17,10,7,374.45406458703076,0.44683423301844355,0.13797502739295386,0.2261530263548269,132492.61289227687,2122.488996254203,134615.10188853106,1048,3,123.61538461538461,33,6,21,32.97858885846923,0.6518308080808081,42.616421568627445,1029.5343137254893,31.198009506833007,0
4785,4,0,0,39,0.0,0.0,1.0,39,1100,600,500,0.5454545454545454,16,6,10,369.9997475066281,0.44638439046333783,0.12399884759435365,0.2243186480115114,132636.34366426602,2015.0827331961502,134651.42639746217,1049,4,124.61538461538461,35,4,17,32.94850187265918,0.6488095238095238,42.47685185185185,1030.092592592592,29.431216931216913,0
4786,4,0,1,38,0.0,0.02564102564102564,0.9743589743589743,39,1450,1300,150,0.896551724137931,16,13,3,368.1775707745078,0.4454003598740441,0.11973489494262024,0.22428108381106446,132815.23946544906,1979.9184456447028,134795.15791109376,1050,5,125.61538461538461,35,4,19,32.81542405868702,0.6505952380952381,42.30324074074073,1030.7870370370358,29.451058201058167,0
4787,4,0,0,38,0.0,0.0,1.0,38,1400,800,600,0.5714285714285714,20,8,12,370.0814666386278,0.44318990042674256,0.13493451329524864,0.22598051996460125,132904.7325772675,2237.115671081944,135141.84824834944,1051,6,128.78947368421052,35,3,19,32.67634321098514,0.6514880952380953,42.216435185185176,1031.134259259258,29.4609788359788,0
4788,4,0,0,38,0.0,0.0,1.0,38,1400,900,500,0.6428571428571429,19,9,10,368.3090034133876,0.44299727358937885,0.13337427950486647,0.2254374889024799,132994.2558299039,2196.5963648833954,135190.8521947873,1052,7,129.78947368421052,35,3,19,32.63203171753442,0.6523809523809524,42.129629629629626,1031.4814814814808,29.470899470899454,0
4789,4,0,0,38,0.0,0.0,1.0,38,900,500,400,0.5555555555555556,13,5,8,363.3266299756761,0.4427157420578473,0.1350967696239589,0.22327936316286023,133143.5282305598,2074.917883016116,135218.44611357592,1053,8,130.78947368421052,35,3,19,32.610579978318576,0.6538690476190476,41.9849537037037,1032.060185185185,29.487433862433857,0
4790,4,0,1,37,0.0,0.02631578947368421,0.9736842105263158,38,1100,500,600,0.45454545454545453,17,5,12,367.75605560119186,0.44210822664770033,0.17883444619010191,0.2096991976619561,130292.97052154192,1983.6110088647042,132276.58153040663,1054,9,131.78947368421052,34,4,17,35.37536924751243,0.6274509803921569,44.76190476190476,1020.9523809523807,30.028011204481786,8
4791,4,0,0,37,0.0,0.0,1.0,37,1350,900,450,0.6666666666666666,18,9,9,377.5864383212143,0.4402527527527527,0.19005496198057692,0.21600432144182005,130419.01139285351,2448.89000024027,132867.90139309378,1055,10,134.78378378378378,33,4,17,34.99637572485502,0.6309974747474747,44.63848039215685,1021.446078431371,30.9529114676173,0
4792,4,0,1,36,0.0,0.02702702702702703,0.972972972972973,37,1200,1000,200,0.8333333333333334,14,10,4,377.2452541563874,0.4390640640640641,0.193674249789358,0.21668219143693293,130575.52984429043,2451.7997885428395,133027.32963283328,1056,11,135.78378378378378,33,4,13,34.84612310151878,0.6325757575757576,44.485294117647044,1022.0588235294099,30.97147950089121,0
4793,4,0,2,34,0.0,0.05555555555555555,0.9444444444444444,36,1050,800,250,0.7619047619047619,13,8,5,388.5864339629606,0.43885582010582014,0.19716317899708935,0.22269415181503355,130488.2473727169,2941.1925441281273,133429.43991684503,1057,12,138.36111111111111,32,4,13,34.64507126379963,0.6341145833333333,44.57070707070706,1021.7171717171702,31.92866161616157,0
4794,4,0,0,34,0.0,0.0,1.0,34,750,500,250,0.6666666666666666,10,5,5,399.3625223389529,0.43762997623291744,0.16716453717390123,0.22875316746785085,130468.48127312402,3620.8443533934505,134089.32562651747,1058,13,137.1764705882353,30,4,22,34.389937727492,0.6392361111111111,44.59005376344086,1021.6397849462363,34.054659498207876,0
4795,4,0,0,34,0.0,0.0,1.0,34,1000,600,400,0.6,14,6,8,401.3176962007813,0.43766711229946526,0.17549238704289416,0.2310994485237958,130674.53833174346,3688.40093507919,134362.93926682265,1059,14,138.1764705882353,30,4,13,34.130296656588236,0.6413194444444444,44.38844086021505,1022.446236559139,34.081541218637966,0
4796,4,0,0,34,0.0,0.0,1.0,34,650,500,150,0.7692307692307693,8,5,3,401.21556807179303,0.43755570409982175,0.17379187185453748,0.23145180117196912,130743.26014929471,3691.246278471498,134434.5064277662,1060,15,139.1764705882353,30,4,14,34.063006527357956,0.6420138888888889,44.321236559139784,1022.7150537634408,34.090501792114694,0
4797,4,1,0,35,0.02857142857142857,0.0,1.0,35,1150,800,350,0.6956521739130435,15,8,7,387.1140872259727,0.4387254901960784,0.16849369801314906,0.22555847482366695,131128.0059814454,3152.299669053835,134280.30565049924,1061,0,136.17142857142858,31,4,16,34.03307483685059,0.6431451612903225,43.94531250000001,1024.2187500000007,33.03931451612905,0
4798,4,1,2,34,0.027777777777777776,0.05555555555555555,0.9444444444444444,36,1550,1200,350,0.7741935483870968,19,12,7,381.5722414201182,0.43806216931216935,0.1645162393162396,0.22482048307022942,131554.70623214485,2839.5248252729543,134394.2310574178,1062,0,133.36111111111111,32,4,15,33.742820512820515,0.6448567708333333,43.529040404040416,1025.8838383838397,32.05886994949499,0
4799,4,1,2,33,0.02857142857142857,0.05714285714285714,0.9428571428571428,35,750,600,150,0.8,9,6,3,384.3220353162458,0.4369047619047619,0.15267087047908956,0.22747709657907533,131728.82080078137,3125.2577039930698,134854.07850477443,1063,0,126.37142857142857,31,4,16,33.496110265516656,0.6491935483870968,43.35937500000001,1026.562500000001,33.11491935483874,0
4800,4,0,1,32,0.0,0.030303030303030304,0.9696969696969697,33,1250,1000,250,0.8,15,10,5,399.1706457323131,0.43458017676767674,0.1327920377160816,0.2359185023848252,131672.7728639148,3911.9811538906088,135584.75401780542,1064,1,127.0909090909091,30,3,16,33.17181770560502,0.6513888888888889,43.41397849462365,1026.3440860215046,34.21146953405015,0
4801,4,0,1,31,0.0,0.03125,0.96875,32,1100,800,300,0.7272727272727273,14,8,6,409.57119489434285,0.43382476478494625,0.13688844904587882,0.24191219496996796,131648.6328125,4383.897569444444,136032.53038194444,1065,2,130.96875,29,3,16,32.92943903099202,0.6540948275862069,43.4375,1026.25,35.38793103448276,0
4802,4,0,1,30,0.0,0.03225806451612903,0.967741935483871,31,950,700,250,0.7368421052631579,12,7,5,411.62683258449266,0.4322132616487455,0.11127744728767786,0.24358157883362574,131719.90981867287,4643.889853395066,136363.79967206792,1066,3,129.2258064516129,29,2,16,32.80439611238894,0.6548132183908046,43.36805555555556,1026.5277777777778,35.39750957854406,0
4803,4,1,0,31,0.03225806451612903,0.0,1.0,31,1050,800,250,0.7619047619047619,13,8,5,408.52999921201695,0.43310931899641575,0.10646819129721541,0.2424294393397797,131826.86149691365,4571.045524691366,136397.90702160503,1067,0,130.03225806451613,29,2,17,32.77544856189702,0.6558908045977012,43.26388888888889,1026.944444444445,35.411877394636036,0
4804,4,0,0,31,0.0,0.0,1.0,31,1100,800,300,0.7272727272727273,14,8,6,415.322349895316,0.43194444444444446,0.10721293462051662,0.24738766058981854,131969.53125,4761.979166666667,136731.51041666666,1068,1,131.03225806451613,29,2,17,32.456407137064076,0.6573275862068966,43.125,1027.5,35.43103448275862,0
4805,4,0,1,30,0.0,0.03225806451612903,0.967741935483871,31,1200,1100,100,0.9166666666666666,13,11,2,416.7706448045518,0.43100358422939067,0.10702148794897282,0.249657755188746,132183.6805555555,4818.055555555549,137001.73611111107,1069,2,132.03225806451613,29,2,18,32.202188006482984,0.6594827586206897,42.916666666666664,1028.333333333333,35.459770114942515,0
4806,4,0,0,30,0.0,0.0,1.0,30,1100,800,300,0.7272727272727273,14,8,6,397.78298353725296,0.4283045977011494,0.12028985507246337,0.21941061399634007,128989.67013888896,4261.979166666678,133251.64930555565,1070,3,136.5,29,1,21,35.93963631391851,0.6271551724137931,46.04166666666667,1015.8333333333339,35.02873563218393,8
4807,4,0,0,30,0.0,0.0,1.0,30,1100,1000,100,0.9090909090909091,12,10,2,399.707027362213,0.42696360153256707,0.12434180559351349,0.22125991121306193,129130.79668209898,4322.897376543239,133453.69405864223,1071,4,137.5,29,1,21,35.74633324223375,0.6285919540229885,45.90277777777779,1016.3888888888907,35.04789272030658,0
4808,4,0,0,30,0.0,0.0,1.0,30,950,700,250,0.7368421052631579,12,7,5,400.4379644764344,0.4266522988505747,0.12867549970404735,0.222259767849278,129236.6922260803,4350.25559413581,133586.9478202161,1072,5,138.5,29,1,21,35.61942243773619,0.6296695402298851,45.798611111111114,1016.805555555556,35.06226053639848,0
4809,4,0,1,29,0.0,0.03333333333333333,0.9666666666666667,30,850,500,350,0.5882352941176471,12,5,7,404.4191887932837,0.42581417624521073,0.1300018204988167,0.2250734147965054,129342.63117283958,4461.72839506174,133804.35956790132,1073,6,139.5,29,1,21,35.40983979610413,0.6307471264367817,45.69444444444445,1017.2222222222229,35.076628352490445,0
4810,4,0,0,29,0.0,0.0,1.0,29,1150,600,550,0.5217391304347826,17,6,11,413.26248612348604,0.42272167487684725,0.11592241987686469,0.23109429472651125,129530.26169655826,4905.999595389074,134436.26129194733,1074,7,133.0344827586207,28,1,19,34.99294283697953,0.6357886904761905,45.51005747126436,1017.9597701149419,36.35570607553364,0
4811,4,0,0,29,0.0,0.0,1.0,29,900,700,200,0.7777777777777778,11,7,4,416.06803178601734,0.4220032840722496,0.11446583098632646,0.23353177176018022,129676.56157104636,4990.854348328707,134667.41591937508,1075,8,134.0344827586207,28,1,19,34.77188837165562,0.6372767857142857,45.366379310344826,1018.5344827586206,36.376231527093594,0
4812,4,1,1,29,0.03333333333333333,0.03333333333333333,0.9666666666666667,30,800,600,200,0.75,10,6,4,405.4530308855569,0.42545498084291183,0.10468409586056637,0.22975671750181556,130050.0,4545.833333333334,134595.83333333334,1076,0,130.53333333333333,29,1,21,34.6609477124183,0.6379310344827587,45.0,1020.0,35.172413793103445,0
4813,4,1,0,30,0.03333333333333333,0.0,1.0,30,650,500,150,0.7692307692307693,8,5,3,404.9731980587742,0.42521551724137935,0.09593540192342531,0.23032067022723468,130191.70524691357,4544.8302469135715,134736.53549382713,1077,0,129.93333333333334,29,1,22,34.528669932861526,0.639367816091954,44.86111111111111,1020.5555555555554,35.19157088122605,0
4814,4,1,1,30,0.03225806451612903,0.03225806451612903,0.967741935483871,31,550,400,150,0.7272727272727273,7,4,3,422.6569579191077,0.42804659498207887,0.07608872617827078,0.236707269557294,129589.99083719132,4795.240162037033,134385.23099922834,1078,0,126.70967741935483,29,2,19,34.692714727413275,0.6332614942528736,45.451388888888886,1018.1944444444441,35.11015325670497,8
4815,4,0,0,30,0.0,0.0,1.0,30,650,400,250,0.6153846153846154,9,4,5,422.8947610329712,0.4251197318007663,0.1022388410705044,0.23692135742613965,129603.40131209532,4961.719885387756,134565.12119748307,1079,1,131.9,28,2,19,34.67293401062978,0.6365327380952381,45.43821839080459,1018.2471264367811,36.365968801313606,0
4816,4,0,0,30,0.0,0.0,1.0,30,1150,1000,150,0.8695652173913043,13,10,3,423.0967370685365,0.4248802681992337,0.10014106361969222,0.23747686215984584,129676.56157104626,4973.146014995357,134649.70758604162,1080,2,132.9,28,2,19,34.59291390417078,0.6372767857142857,45.36637931034482,1018.5344827586198,36.376231527093566,0
4817,4,1,0,31,0.03225806451612903,0.0,1.0,31,900,600,300,0.6666666666666666,12,6,6,413.32343821960086,0.4268817204301076,0.10977135357454815,0.2352838069307395,130227.14361496911,4565.186149691352,134792.32976466048,1081,0,129.58064516129033,29,2,20,34.279465460153304,0.6397270114942528,44.826388888888886,1020.6944444444442,35.1963601532567,0
4818,4,0,0,31,0.0,0.0,1.0,31,850,600,250,0.7058823529411765,11,6,5,414.60358647608166,0.42634408602150536,0.10992221739645425,0.23687491618948164,130368.94531250001,4610.286458333334,134979.23177083334,1082,1,130.58064516129033,29,2,20,34.10215218278254,0.6411637931034483,44.6875,1021.2500000000001,35.21551724137932,0
4819,4,0,0,31,0.0,0.0,1.0,31,1000,600,400,0.6,14,6,8,412.03926086599296,0.4257168458781362,0.10691595013745947,0.23627224023313403,130510.82417052466,4555.116705246906,135065.94087577157,1083,2,131.58064516129033,29,2,16,34.02301096461418,0.6426005747126438,44.54861111111111,1021.8055555555553,35.23467432950191,0
4820,4,0,0,31,0.0,0.0,1.0,31,1150,800,350,0.6956521739130435,15,8,7,431.8630693267758,0.4259856630824373,0.11415380520332796,0.2294456171049062,127490.73368757438,4814.259031034859,132304.99271860922,1084,3,132.58064516129033,28,3,19,36.61793996301038,0.6149553571428572,47.521551724137936,1009.9137931034488,36.0683497536946,8
4821,4,1,0,32,0.03125,0.0,1.0,32,1200,900,300,0.75,15,9,6,417.5840716832006,0.4294984879032258,0.10789075993091513,0.2243508427951073,127940.47948100949,4285.181270956196,132225.66075196568,1085,0,129.40625,30,2,20,36.51493512244807,0.6135416666666667,47.076612903225815,1011.6935483870978,33.72311827956993,0
4822,4,0,0,32,0.0,0.0,1.0,32,950,700,250,0.7368421052631579,12,7,5,416.3147134449751,0.42960349462365593,0.10437964684014878,0.22461908464667274,128110.51133078964,4266.858162793381,132377.369493583,1086,1,130.40625,30,2,20,36.37203487342892,0.6152777777777778,46.90860215053763,1012.3655913978491,33.745519713261636,0
4823,4,2,0,34,0.058823529411764705,0.0,1.0,34,800,400,400,0.5,12,4,8,391.17523339064593,0.4340463458110517,0.10427878287552272,0.21487611183996724,128825.87808200372,3278.7076179327078,132104.58569993643,1087,0,123.67647058823529,30,4,20,36.27504523588862,0.6225694444444445,46.20295698924731,1015.1881720430108,33.83960573476703,0
4824,4,0,1,33,0.0,0.029411764705882353,0.9705882352941176,34,1100,700,400,0.6363636363636364,15,7,8,389.8849909957113,0.43393493761140817,0.10486097491061042,0.21440924963219746,128870.65463595929,3248.946804470495,132119.60144042977,1088,1,124.67647058823529,31,3,21,36.26196888090963,0.6202956989247312,46.15885416666667,1015.3645833333342,32.753696236559165,0
4825,4,0,1,32,0.0,0.030303030303030304,0.9696969696969697,33,750,400,350,0.5333333333333333,11,4,7,401.55572124029646,0.429726957070707,0.11342564720048198,0.22001057295821777,128723.56088854224,3737.9364666435736,132461.49735518583,1089,2,129.36363636363637,30,3,22,36.116445916114785,0.6215277777777778,46.30376344086023,1014.7849462365608,33.82616487455203,0
4826,4,0,0,32,0.0,0.0,1.0,32,1100,700,400,0.6363636363636364,15,7,8,409.5659864749482,0.4293724798387097,0.12869570255595253,0.22459206709312546,128757.66210327798,4146.951779107433,132904.61388238543,1090,3,133.03125,30,2,22,35.878250121396725,0.621875,46.27016129032259,1014.9193548387109,33.83064516129036,0
4827,4,0,0,32,0.0,0.0,1.0,32,1150,700,450,0.6086956521739131,16,7,9,430.6657955283001,0.4290574596774193,0.105222099853157,0.23387831479646917,128370.63536352033,4675.982480390253,133046.6178439106,1091,4,134.03125,27,5,16,35.74094468918258,0.6273148148148149,46.65178571428571,1013.3928571428565,37.533068783068764,8
4828,4,1,0,33,0.030303030303030304,0.0,1.0,33,650,400,250,0.6153846153846154,9,4,5,447.19279180067747,0.43047664141414144,0.07787859275302944,0.23931440581200972,127782.23885430234,4828.659227159301,132610.89808146164,1092,0,130.93939393939394,31,2,15,35.929518136939265,0.6092069892473118,47.23307291666667,1011.0677083333337,32.61508736559141,8
4829,4,1,0,34,0.029411764705882353,0.0,1.0,34,900,500,400,0.5555555555555556,13,5,8,437.5354864160974,0.43432486631016043,0.08373803463514418,0.23647003978901573,128178.55568562844,4417.559071714062,132596.1147573425,1093,0,128.05882352941177,30,4,16,35.764810636226876,0.6159722222222221,46.84139784946237,1012.6344086021509,33.754480286738364,0
4830,4,0,0,34,0.0,0.0,1.0,34,950,700,250,0.7368421052631579,12,7,5,444.15078295529526,0.43348930481283426,0.07846916715799668,0.24103078054101174,128342.36145019541,4600.672064887169,132943.03351508258,1094,1,129.05882352941177,31,3,17,35.428445986464496,0.6149193548387097,46.67968750000001,1013.2812500000008,32.68649193548389,0
4831,4,1,0,35,0.02857142857142857,0.0,1.0,35,1050,800,250,0.7619047619047619,13,8,5,435.8466933725268,0.436484593837535,0.07509100005175395,0.2388647563082659,128734.59314025872,4221.70934856788,132956.3024888266,1095,0,126.34285714285714,33,2,15,35.2351517530089,0.6139520202020202,46.292892156862756,1014.8284313725503,30.7523767082591,0
4832,4,1,0,36,0.027777777777777776,0.0,1.0,36,1050,800,250,0.7619047619047619,13,8,5,425.5495101071133,0.4372023809523809,0.08387143507595507,0.23617851170865523,129233.48263251218,3800.738599238628,133034.22123175082,1096,0,123.80555555555556,32,4,16,34.9843743532431,0.6214192708333333,45.80176767676769,1016.7929292929309,31.77477904040409,0
4833,4,0,0,36,0.0,0.0,1.0,36,1150,900,250,0.782608695652174,14,9,5,422.2404440022124,0.4365244708994709,0.0829816285998013,0.23491498735371746,129329.78777675769,3721.653402714036,133051.44117947173,1097,1,124.80555555555556,32,4,16,34.969794769943725,0.6223958333333333,45.70707070707072,1017.1717171717189,31.786616161616216,0
4834,4,0,0,36,0.0,0.0,1.0,36,1200,700,500,0.5833333333333334,17,7,10,424.34223959667474,0.43549933862433865,0.07622832369942234,0.2368103466136285,129450.69204152268,3786.2793156478524,133236.97135717052,1098,2,125.80555555555556,33,3,14,34.792469492614,0.6212121212121212,45.58823529411766,1017.6470588235309,30.837789661319118,0
4835,4,0,0,36,0.0,0.0,1.0,36,700,500,200,0.7142857142857143,9,5,4,423.73684157213046,0.4358796296296296,0.07950791166753635,0.23703582107337984,129544.24267409185,3778.53364691467,133322.7763210065,1099,3,126.80555555555556,33,3,14,34.71206512579753,0.6221590909090908,45.496323529411775,1018.0147058823542,30.84893048128346,0
4836,4,0,2,34,0.0,0.05555555555555555,0.9444444444444444,36,900,400,500,0.4444444444444444,14,4,10,425.9130026164743,0.43535052910052907,0.07539205069586496,0.23901167891597017,129669.02941476837,3845.545132881586,133514.57454764997,1100,4,127.80555555555556,33,3,15,34.52891248546103,0.6234217171717171,45.37377450980392,1018.5049019607844,30.86378490790256,0
4837,4,0,0,34,0.0,0.0,1.0,34,950,800,150,0.8421052631578947,11,8,3,427.85869915231194,0.4341391859774213,0.07464212678936621,0.2404860964200927,129731.44531250009,4301.345486111126,134032.7907986112,1101,5,131.47058823529412,31,3,15,34.41547375596456,0.6290322580645161,45.31250000000001,1018.7500000000007,32.86290322580648,0
4838,4,0,3,31,0.0,0.08823529411764706,0.9117647058823529,34,1350,1100,250,0.8148148148148148,16,11,5,430.1553403280392,0.43300653594771243,0.07846644022964355,0.24259769481901225,129864.12896050343,4372.349717881941,134236.47867838538,1102,6,132.47058823529412,31,3,15,34.221171861693065,0.6303763440860215,45.182291666666664,1019.2708333333329,32.87970430107526,0
4839,4,1,1,31,0.03125,0.03125,0.96875,32,1150,800,350,0.6956521739130435,15,8,7,450.61737712836646,0.42815440188172044,0.11813186813186793,0.24121283128636065,127793.209876543,5166.606686439013,132959.816562982,1103,0,139.9375,29,3,18,35.83161630036629,0.6149425287356323,47.22222222222221,1011.1111111111094,34.8659003831417,8
4840,4,0,0,31,0.0,0.0,1.0,31,650,400,250,0.6153846153846154,9,4,5,439.49779029444176,0.4285394265232975,0.013357376611233596,0.22825530399162935,126567.38281249999,4925.699266975308,131493.08207947528,1104,1,138.0,29,2,16,37.381383712905446,0.6023706896551724,48.4375,1006.2499999999999,34.69827586206896,7
4841,4,4,4,31,0.11428571428571428,0.11428571428571428,0.8857142857142857,35,500,300,200,0.6,7,3,4,395.159619073376,0.43781512605042017,0.004866466785671264,0.21028410200270098,127555.82475790555,3080.982224384846,130636.80698229039,1105,0,123.11428571428571,33,2,14,37.47763253669781,0.6019570707070707,47.45710784313725,1010.1715686274504,30.611259655377285,0
4842,4,0,1,30,0.0,0.03225806451612903,0.967741935483871,31,1050,800,250,0.7619047619047619,13,8,5,434.1073268227759,0.42782258064516127,0.02934572375002764,0.22739701488081185,126917.01630015454,4819.121334876573,131736.1376350311,1106,1,139.58064516129033,29,2,18,37.15469216632208,0.6059626436781609,48.09027777777779,1007.6388888888907,34.746168582375546,0
4843,4,2,0,32,0.0625,0.0,1.0,32,900,400,500,0.4444444444444444,14,4,10,420.73591807298845,0.43386676747311825,0.02466142020497819,0.2233914454051142,127464.9909852297,4325.820000867178,131790.81098609688,1107,0,131.9375,30,2,16,36.92544034784152,0.6086805555555556,47.5470430107527,1009.8118279569908,33.66039426523302,0
4844,4,2,0,34,0.058823529411764705,0.0,1.0,34,850,600,250,0.7058823529411765,11,6,5,388.73375081019026,0.44019236482471774,0.05982523712010912,0.19994534293449776,126170.65741059573,3009.358579481669,129180.0159900774,1108,0,125.11764705882354,32,2,22,39.0683255833438,0.5901692708333333,48.8320707070707,1004.6717171717161,31.395991161616127,8
4845,4,4,3,35,0.10526315789473684,0.07894736842105263,0.9210526315789473,38,1050,700,350,0.6666666666666666,14,7,7,368.40070145628425,0.44514580369843526,0.10413409762028802,0.19583405708991952,127512.5,1801.8426053463936,129314.34260534639,1109,0,112.84210526315789,34,4,15,38.197882288228826,0.5992647058823529,47.5,1010.0,29.705882352941178,0
4846,4,1,1,35,0.027777777777777776,0.027777777777777776,0.9722222222222222,36,750,400,350,0.5333333333333333,11,4,7,385.957015998678,0.44502314814814814,0.1080711769707281,0.20382194436928244,127246.52364775557,2622.337712658582,129868.86136041416,1110,0,120.02777777777777,33,3,21,38.02823494878336,0.598800505050505,47.76348039215686,1008.9460784313717,30.574123588829444,0
4847,4,0,0,35,0.0,0.0,1.0,35,800,600,200,0.75,10,6,4,390.9286538791046,0.44331232492997197,0.11066066066066083,0.2066337170503836,127283.05785123953,2951.7188934802407,130234.77674471977,1111,1,123.8,32,3,21,37.86520895895895,0.6015625,47.72727272727272,1009.090909090908,31.534090909090875,0
4848,4,1,0,36,0.027777777777777776,0.0,1.0,36,1200,1000,200,0.8333333333333334,14,10,4,382.7719868454285,0.44505621693121694,0.12332417762082315,0.20515129515784938,127843.36911848052,2586.972080498843,130430.34119897937,1112,0,121.33333333333333,34,2,17,37.49509515401217,0.6026348039215687,47.17261904761904,1011.3095238095221,29.74439775910359,0
4849,4,2,2,36,0.05263157894736842,0.05263157894736842,0.9473684210526316,38,800,100,700,0.125,15,1,14,365.8104555395473,0.4482574679943101,0.11668088473474003,0.19888315571288032,128415.88010204077,1795.8829365079282,130211.7630385487,1113,0,115.89473684210526,34,4,15,37.337767206953245,0.6084558823529411,46.607142857142854,1013.5714285714282,29.810924369747887,0
4850,4,2,2,36,0.05263157894736842,0.05263157894736842,0.9473684210526316,38,1250,800,450,0.64,17,8,9,369.0322869249723,0.44923541963015645,0.13182601498465085,0.20170135451492552,128627.12762188211,1893.512613378687,130520.6402352608,1114,0,116.84210526315789,34,4,17,37.040106794977106,0.6106004901960784,46.398809523809526,1014.4047619047622,29.835434173669476,0
4851,4,1,1,36,0.02702702702702703,0.02702702702702703,0.972972972972973,37,1500,1200,300,0.8,18,12,6,380.3787719666736,0.446727977977978,0.15274840057448746,0.20830266083889273,128703.50346020768,2391.2161188004684,131094.71957900815,1115,0,120.72972972972973,33,4,18,36.6742149758454,0.6136363636363636,46.32352941176471,1014.7058823529417,30.748663101604294,0
4852,4,2,0,38,0.05263157894736842,0.0,1.0,38,1300,900,400,0.6923076923076923,17,9,8,366.5007983742197,0.44842045993361784,0.14369055168040545,0.20388449239316514,129326.01042868129,1881.5395520953466,131207.54998077665,1116,0,114.36842105263158,33,5,20,36.391064257028106,0.619949494949495,45.71078431372549,1017.1568627450981,30.822935234699944,0
4853,4,0,1,37,0.0,0.02631578947368421,0.9736842105263158,38,1100,800,300,0.7272727272727273,14,8,6,367.5363644475526,0.4474276908487435,0.14039945758931394,0.20543452510776417,129513.05537533657,1920.1515042291646,131433.20687956573,1117,1,115.36842105263158,33,5,19,36.17415121598845,0.6218434343434344,45.52696078431374,1017.8921568627463,30.845216874628676,0
4854,4,0,1,36,0.0,0.02702702702702703,0.972972972972973,37,1200,800,400,0.6666666666666666,16,8,8,374.7754126926462,0.4451951951951952,0.1417007578297904,0.20918904614284828,129458.25043362926,2303.5538465462755,131761.80428017554,1118,2,119.29729729729729,32,5,19,36.045802315963606,0.6236979166666667,45.58080808080808,1017.676767676768,31.802398989899,0
4855,4,0,0,36,0.0,0.0,1.0,36,1000,800,200,0.8,12,8,4,384.03940346384985,0.4441798941798942,0.14831158864159644,0.21476538313879664,129532.54699707033,2749.1204155815967,132281.66741265194,1119,3,122.19444444444444,31,5,19,35.73430971262897,0.627016129032258,45.5078125,1017.9687500000001,32.83770161290323,0
4856,4,1,0,37,0.02702702702702703,0.0,1.0,37,1100,1000,100,0.9090909090909091,12,10,2,375.1234325000558,0.444507007007007,0.14522424331688621,0.21180046111926212,129908.3719135802,2346.334876543203,132254.7067901234,1120,0,119.86486486486487,32,5,21,35.57845140781109,0.6282552083333333,45.138888888888886,1019.444444444444,31.857638888888875,0
4857,4,0,1,36,0.0,0.02702702702702703,0.972972972972973,37,600,400,200,0.6666666666666666,8,4,4,375.9004766376467,0.4444757257257257,0.0725991949396203,0.20456899623333008,128454.92118416009,2258.217726088274,130713.13891024837,1121,1,120.86486486486487,33,4,15,37.04213007736944,0.6111111111111112,46.5686274509804,1013.7254901960796,30.71895424836605,8
4858,4,0,0,36,0.0,0.0,1.0,36,1000,800,200,0.8,12,8,4,387.63082186151365,0.44303902116402116,0.09219482837338666,0.211341692489465,128528.34093778713,2764.309286042263,131292.6502238294,1122,2,124.86111111111111,32,4,15,36.66962395716598,0.6142578125,46.49621212121213,1014.0151515151529,31.687973484848527,0
4859,4,0,0,36,0.0,0.0,1.0,36,1500,1200,300,0.8,18,12,6,392.4500361639287,0.4420800264550264,0.0955891501804158,0.2150048357634286,128720.46100206621,2903.2699150596986,131623.7309171259,1123,3,125.86111111111111,32,4,16,36.35062834390942,0.6162109375,46.30681818181819,1014.772727272728,31.71164772727275,0
4860,4,1,3,34,0.02702702702702703,0.08108108108108109,0.9189189189189189,37,1000,600,400,0.6,14,6,8,379.16868663261823,0.4451013513513513,0.09019003327456221,0.20976957426579732,129107.96215698285,2390.7392889753887,131498.70144595823,1124,0,123.43243243243244,33,4,17,36.29152598577113,0.617739898989899,45.92524509803921,1016.2990196078429,30.79693998811645,0
4861,4,0,0,34,0.0,0.0,1.0,34,900,700,200,0.7777777777777778,11,7,4,396.66972130002574,0.4442401960784314,0.09795370174750229,0.2177772638911974,128804.55864800354,3418.5736762152833,132223.13232421884,1125,1,131.52941176470588,31,3,17,36.15743116127929,0.6196236559139785,46.223958333333336,1015.1041666666672,32.74529569892475,0
4862,4,2,0,36,0.05555555555555555,0.0,1.0,36,900,500,400,0.5555555555555556,13,5,8,375.8230982060933,0.44442791005291005,0.09146980541420136,0.20926100222850672,129361.89746263128,2524.048170407504,131885.9456330388,1126,0,125.16666666666667,32,4,19,36.117403086343124,0.6227213541666667,45.675505050505045,1017.2979797979792,31.79056186868685,0
4863,4,1,4,33,0.02702702702702703,0.10810810810810811,0.8918918918918919,37,1150,900,250,0.782608695652174,14,9,5,363.1842270784913,0.4458521021021021,0.09017246312722715,0.2039721145592174,129700.23548635133,2021.0159554017555,131721.2514417531,1127,0,122.75675675675676,33,4,16,36.09440166827076,0.6237373737373737,45.343137254901954,1018.6274509803916,30.867498514557322,0
4864,4,2,2,33,0.05714285714285714,0.05714285714285714,0.9428571428571428,35,1000,600,400,0.6,14,6,8,380.5954322695953,0.4461834733893557,0.09742137100458725,0.21266007820238939,129499.41211276597,2857.3769463433355,132356.78905910932,1128,0,128.62857142857143,31,4,17,35.855747089676335,0.6266801075268817,45.54036458333334,1017.8385416666678,32.83350134408606,0
4865,4,2,1,34,0.05714285714285714,0.02857142857142857,0.9714285714285714,35,800,500,300,0.625,11,5,6,372.15915038004783,0.4465336134453781,0.08060858027421536,0.21029986979138482,129940.55333958288,2671.713186154503,132612.2665257374,350,0,97.34285714285714,32,3,20,35.621259029927764,0.6285807291666667,45.107323232323246,1019.5707070707085,31.86158459595964,0
4866,4,0,1,33,0.0,0.029411764705882353,0.9705882352941176,34,1200,900,300,0.75,15,9,6,385.3058854424072,0.44459298871063574,0.09122530238148907,0.217672805412269,129930.49621582031,3212.5969780815976,133143.0931939019,351,1,100.82352941176471,31,3,20,35.29640272456364,0.6310483870967742,45.1171875,1019.53125,32.88810483870968,0
4867,4,0,1,32,0.0,0.030303030303030304,0.9696969696969697,33,800,400,400,0.5,12,4,8,393.2458003011265,0.441366792929293,0.0978522862179374,0.22132118872181428,129782.79867976058,3607.3081064284825,133390.10678618908,352,2,104.6969696969697,30,3,21,35.24463571208724,0.6322916666666667,45.262096774193544,1018.9516129032252,33.96505376344084,0
4868,4,0,0,32,0.0,0.0,1.0,32,1200,1000,200,0.8333333333333334,14,10,4,400.4803009101246,0.4393271169354838,0.09671402289452158,0.22570848295533757,129837.58680555562,3999.4791666666724,133837.0659722223,353,3,108.09375,29,3,21,35.00442899972744,0.6357758620689655,45.208333333333336,1019.1666666666672,35.143678160919556,0
4869,4,0,1,31,0.0,0.03125,0.96875,32,900,600,300,0.6666666666666666,12,6,6,402.44937844418826,0.4386340725806452,0.09395424836601296,0.22805464778503992,130050.0,4067.708333333335,134117.70833333334,354,4,109.09375,29,3,21,34.73754084967321,0.6379310344827587,45.0,1020.0,35.172413793103445,0
4870,4,1,0,32,0.03125,0.0,1.0,32,900,700,200,0.7777777777777778,11,7,4,401.9728148987323,0.43838205645161293,0.1010479041916168,0.22861426036191046,130191.70524691354,4066.705246913573,134258.4104938271,355,0,109.5,29,3,22,34.60522137543094,0.639367816091954,44.86111111111111,1020.5555555555552,35.19157088122604,0
4871,4,1,1,32,0.030303030303030304,0.030303030303030304,0.9696969696969697,33,750,300,450,0.4,12,3,9,391.75305501853654,0.44061710858585856,0.09699276302511284,0.22463969023938996,130510.82417052465,3625.6221064814736,134136.44627700612,356,0,107.15151515151516,29,4,18,34.54122491051605,0.6426005747126438,44.54861111111111,1021.8055555555552,35.23467432950191,0
4872,4,0,0,32,0.0,0.0,1.0,32,850,400,450,0.47058823529411764,13,4,9,401.5207918986554,0.4378360215053763,0.10425604867069937,0.22963888251066294,130409.29954832201,4072.409045118237,134481.70859344024,357,2,111.5,28,4,23,34.395074318938455,0.6447172619047619,44.64798850574712,1021.4080459770108,36.47885878489324,0
4873,4,0,0,32,0.0,0.0,1.0,32,1600,1200,400,0.75,20,12,8,401.1105860113421,0.43613491263440857,0.11311141304347827,0.23063858695652176,130617.28395061727,4078.3950617283926,134695.67901234567,358,3,112.5,29,3,20,34.19384057971015,0.6436781609195402,44.44444444444444,1022.2222222222222,35.24904214559387,0
4874,4,0,0,32,0.0,0.0,1.0,32,850,500,350,0.5882352941176471,12,5,7,399.4093271556032,0.435525873655914,0.11449847250509149,0.23071762309811913,130794.8133680556,4048.1336805555607,134842.94704861115,359,4,113.5,29,3,21,34.05677189409368,0.6454741379310345,44.270833333333336,1022.9166666666671,35.27298850574714,0
4875,4,0,1,31,0.0,0.03125,0.96875,32,1100,800,300,0.7272727272727273,14,8,6,404.97705630801,0.4338877688172043,0.11895174962701716,0.23566660111751853,131079.11120756186,4216.806520061746,135295.9177276236,360,5,114.5,29,3,22,33.625361680003614,0.6483477011494253,43.993055555555564,1024.0277777777787,35.31130268199237,0
4876,4,0,1,30,0.0,0.03225806451612903,0.967741935483871,31,900,500,400,0.5555555555555556,13,5,8,409.4793331423283,0.43185483870967745,0.11077396619417801,0.23939290966118057,131256.95408950624,4549.402006172851,135806.35609567908,361,6,114.7741935483871,29,2,22,33.329380139152434,0.6501436781609196,43.81944444444445,1024.7222222222229,35.33524904214561,0
4877,4,1,0,31,0.03225806451612903,0.0,1.0,31,700,600,100,0.8571428571428571,8,6,2,407.8260294798072,0.4318100358422939,0.10936270653029134,0.23886953155245833,131328.12499999997,4511.824845679012,135839.949845679,362,0,115.3225806451613,28,3,23,33.29945799457996,0.6540178571428572,43.75,1024.9999999999998,36.60714285714285,0
4878,4,0,0,31,0.0,0.0,1.0,31,700,600,100,0.8571428571428571,8,6,2,407.689490556138,0.43158602150537634,0.1123090902736521,0.2396798724734492,131470.52469135806,4519.830246913584,135990.35493827166,363,1,116.3225806451613,29,2,23,33.15840556157458,0.6522988505747127,43.611111111111114,1025.5555555555557,35.36398467432951,0
4879,4,0,0,31,0.0,0.0,1.0,31,800,500,300,0.625,11,5,6,409.90088140038944,0.43104838709677423,0.10485508100533036,0.24210692347461868,131648.6328125001,4592.578125000013,136241.2109375001,364,2,117.3225806451613,29,2,18,32.920980511571265,0.6540948275862069,43.43750000000001,1026.2500000000007,35.38793103448278,0
4880,4,0,1,30,0.0,0.03225806451612903,0.967741935483871,31,950,500,450,0.5263157894736842,14,5,9,406.7188850852714,0.4300179211469534,0.10387332393763904,0.24112852585688946,131791.2061149692,4520.3944830246965,136311.60059799388,365,3,118.3225806451613,29,2,18,32.85808084223815,0.6555316091954023,43.298611111111114,1026.8055555555559,35.40708812260537,0
4881,4,0,0,30,0.0,0.0,1.0,30,450,200,250,0.4444444444444444,7,2,5,418.4530146978041,0.42696360153256707,0.11262018108839733,0.24699102735303444,131622.8303771965,5015.594034879118,136638.4244120756,366,11,123.16666666666667,28,2,19,32.727760664613086,0.6569940476190477,43.46264367816092,1026.1494252873565,36.648193760262735,0
4882,4,0,0,30,0.0,0.0,1.0,30,1100,900,200,0.8181818181818182,13,9,4,418.11325041955575,0.42660440613026823,0.11734546302775839,0.24750780234032524,131733.43004772757,5015.898525234509,136749.32857296208,367,12,124.16666666666667,28,2,20,32.624212736179146,0.6581101190476191,43.354885057471265,1026.5804597701149,36.66358784893267,0
4883,4,0,0,30,0.0,0.0,1.0,30,900,700,200,0.7777777777777778,11,7,4,418.1049573280895,0.4255986590038314,0.124350906633105,0.24894825560809047,131954.7687318337,5034.188589972243,136988.95732180594,368,13,125.16666666666667,28,2,20,32.39989745024006,0.6603422619047619,43.13936781609195,1027.4425287356314,36.69437602627255,0
4884,4,0,0,30,0.0,0.0,1.0,30,850,400,450,0.47058823529411764,13,4,9,418.44610040088287,0.42586206896551726,0.12430089485458584,0.24939387583892628,131991.67657550535,5046.280469678958,137037.9570451843,369,14,126.16666666666667,28,2,20,32.353712248322154,0.6607142857142857,43.10344827586207,1027.5862068965519,36.69950738916257,0
4885,4,0,0,30,0.0,0.0,1.0,30,1350,1000,350,0.7407407407407407,17,10,7,424.4387569551679,0.4248323754789272,0.131512781114681,0.25469883160453005,132250.17598510356,5226.4200604438975,137476.59604554746,370,15,127.16666666666667,28,2,20,31.93765423476277,0.6633184523809523,42.852011494252864,1028.5919540229872,36.7354269293924,0
4886,4,0,0,30,0.0,0.0,1.0,30,1150,1000,150,0.8695652173913043,13,10,3,422.5144638061146,0.4240421455938697,0.12569114772409962,0.2542897974604529,132361.0388591622,5184.890672479826,137545.929531642,371,16,128.16666666666666,28,2,20,31.87482546774644,0.6644345238095238,42.744252873563205,1029.0229885057456,36.75082101806235,0
4887,4,0,0,30,0.0,0.0,1.0,30,850,600,250,0.7058823529411765,11,6,5,410.9889037368907,0.4230603448275862,0.1046614973019544,0.2343816471194633,130298.0348186728,4710.209297839505,135008.2441165123,372,17,129.16666666666666,29,1,19,34.26673808552125,0.6404454022988506,44.75694444444444,1020.972222222222,35.205938697318,8
4888,4,0,0,30,0.0,0.0,1.0,30,950,800,150,0.8421052631578947,11,8,3,413.27189578321844,0.42291666666666666,0.11044471644226861,0.2361140831153071,130368.94531249988,4775.564236111098,135144.50954861098,373,18,130.16666666666666,29,1,19,34.13615191078472,0.6411637931034483,44.68749999999999,1021.2499999999991,35.21551724137928,0
4889,4,1,1,30,0.03225806451612903,0.03225806451612903,0.967741935483871,31,800,500,300,0.625,11,5,6,401.54753759533264,0.42544802867383513,0.10868284162642694,0.23164330656276616,130743.26014929471,4299.926834027055,135043.18698332176,374,0,126.93548387096774,30,1,18,34.054518771630086,0.6420138888888889,44.321236559139784,1022.7150537634408,34.090501792114694,0
4890,4,0,0,30,0.0,0.0,1.0,30,1350,1100,250,0.8148148148148148,16,11,5,411.6510608125572,0.42358716475095787,0.11473236505135498,0.23822728711752603,130865.85889274678,4774.213927469118,135640.0728202159,375,1,130.8,29,1,19,33.67141192706212,0.6461925287356323,44.20138888888888,1023.1944444444434,35.28256704980839,0
4891,4,2,1,31,0.0625,0.03125,0.96875,32,750,600,150,0.8,9,6,3,392.1835790462666,0.4259282594086022,0.12911090320943797,0.23192671820117913,131695.40617201055,3929.755147298169,135625.1613193087,376,0,123.5625,31,1,19,33.32817983847097,0.6488575268817205,43.39192708333333,1026.432291666666,33.11071908602148,0
4892,4,0,0,31,0.0,0.0,1.0,31,1150,800,350,0.6956521739130435,15,8,7,405.68131352992344,0.4244175627240143,0.1148839841539333,0.24020107540632207,131741.75663371483,4489.033775580987,136230.79040929582,377,1,121.96774193548387,30,1,19,32.93483241686305,0.6520833333333333,43.346774193548384,1026.6129032258061,34.22043010752687,0
4893,4,0,0,31,0.0,0.0,1.0,31,1150,800,350,0.6956521739130435,15,8,7,407.6809329633623,0.4227598566308244,0.12328530137766625,0.24292445304013285,131983.3420951844,4561.418408197477,136544.76050338187,378,2,122.96774193548387,30,1,19,32.63870721604534,0.6545138888888888,43.111559139784944,1027.5537634408602,34.25179211469534,0
4894,4,0,0,31,0.0,0.0,1.0,31,1300,1000,300,0.7692307692307693,16,10,6,409.04862292079207,0.4221774193548387,0.12520295716496754,0.2446296260141626,132121.4902915077,4608.822732396809,136730.3130239045,379,3,123.96774193548387,30,1,20,32.463666274458525,0.6559027777777777,42.97715053763441,1028.0913978494625,34.269713261648754,0
4895,4,0,0,31,0.0,0.0,1.0,31,950,700,250,0.7368421052631579,12,7,5,410.9790526637648,0.42195340501792117,0.13099700228939049,0.24623341675258156,132190.59148817792,4665.512812174828,136856.10430035274,380,4,124.96774193548387,30,1,20,32.344083562061606,0.6565972222222223,42.90994623655914,1028.3602150537643,34.278673835125474,0
4896,4,0,0,31,0.0,0.0,1.0,31,900,400,500,0.4444444444444444,14,4,10,411.3282947090622,0.42244623655913977,0.1338031136997735,0.24711984047905497,132294.2771563186,4683.2758844953105,136977.55304081392,381,5,125.96774193548387,30,1,20,32.23015199024475,0.6576388888888889,42.80913978494623,1028.7634408602146,34.29211469534049,0
4897,4,1,0,32,0.03125,0.0,1.0,32,950,600,350,0.631578947368421,13,6,7,393.63034347702853,0.42420614919354843,0.01754441624365466,0.23217119061369657,131595.18771701393,3979.053654595189,135574.24137160913,382,0,123.0,31,1,17,33.39255499153977,0.6478494623655914,43.489583333333336,1026.041666666667,33.0981182795699,8
4898,4,0,1,31,0.0,0.03125,0.96875,32,1050,1000,50,0.9523809523809523,11,10,1,394.4905649410334,0.4239751344086022,0.01758134593428884,0.23329100700901476,131695.40617201067,3990.51903618707,135685.92520819773,383,1,124.0,31,1,17,33.26898071800076,0.6488575268817205,43.391927083333336,1026.432291666667,33.11071908602152,0
4899,4,0,0,31,0.0,0.0,1.0,31,700,400,300,0.5714285714285714,10,4,6,398.5113936054872,0.4215949820788531,0.035891110022135964,0.23552887009067366,131672.77286391502,4294.620042779527,135967.39290669456,384,2,128.70967741935485,30,1,17,33.18873319364414,0.6513888888888889,43.41397849462366,1026.3440860215064,34.21146953405022,0
4900,4,0,0,31,0.0,0.0,1.0,31,650,500,150,0.7692307692307693,8,5,3,400.7846269331463,0.42132616487455193,0.03612294981562614,0.23708692454596728,131707.26249060588,4357.249212336691,136064.51170294257,385,3,129.70967741935485,30,1,17,33.09545633102003,0.6517361111111111,43.380376344086024,1026.4784946236562,34.21594982078854,0
4901,4,0,0,31,0.0,0.0,1.0,31,950,600,350,0.631578947368421,13,6,7,429.1691810715689,0.42087813620071685,0.12513020618045334,0.23719803747043353,129069.04432508675,4878.491210937495,133947.53553602425,386,4,130.70967741935485,31,0,18,35.061079788142834,0.6223118279569892,45.963541666666664,1016.1458333333329,32.77889784946235,8
4902,4,0,0,31,0.0,0.0,1.0,31,900,700,200,0.7777777777777778,11,7,4,426.2966944369796,0.4207437275985663,0.12453728186144919,0.23640089418777946,129201.38888888879,4815.62499999999,134017.0138888888,387,5,131.70967741935485,31,0,18,34.99829234972678,0.6236559139784946,45.83333333333333,1016.6666666666658,32.795698924731155,0
4903,4,0,0,31,0.0,0.0,1.0,31,1250,1000,250,0.8,15,10,5,414.14627229727597,0.4203405017921147,0.027542232160648217,0.22266092942329552,127968.81028163576,4442.963927469129,132411.7742091049,388,6,132.70967741935485,29,2,20,36.57272363303592,0.6167385057471264,47.04861111111111,1011.8055555555552,34.88984674329501,8
4904,4,1,0,32,0.03125,0.0,1.0,32,900,500,400,0.5555555555555556,13,5,8,403.6013989910185,0.42279905913978494,0.02966614700809367,0.2186875445143999,128280.65609102185,3954.8504523644096,132235.50654338626,389,0,129.53125,30,2,21,36.51900623590289,0.6170138888888889,46.74059139784945,1013.0376344086003,33.76792114695334,0
4905,4,3,1,34,0.08571428571428572,0.02857142857142857,0.9714285714285714,35,900,600,300,0.6666666666666666,12,6,6,375.17831693929037,0.42937675070028014,0.032271177098762704,0.20772556479936433,129139.10064638611,2690.0380863129644,131829.13873269907,390,0,119.34285714285714,33,2,21,36.36112450767623,0.6180555555555556,45.89460784313726,1016.4215686274518,30.80065359477127,0
4906,4,1,0,35,0.02857142857142857,0.0,1.0,35,950,600,350,0.631578947368421,13,6,7,375.3510259424555,0.4286764705882353,0.040521415270018624,0.20865786845869427,129297.68207644635,2706.4185421373286,132004.10061858367,391,0,120.28571428571429,32,3,22,36.19490999379267,0.6220703125,45.73863636363637,1017.0454545454551,31.78267045454547,0
4907,4,0,0,35,0.0,0.0,1.0,35,1400,1200,200,0.8571428571428571,16,12,4,375.29939532981393,0.4295168067226891,0.04053378701685384,0.20965269755742394,129490.37606175386,2719.5319674012812,132209.90802915514,392,1,121.28571428571429,32,3,19,35.999720878302945,0.6240234375,45.54924242424242,1017.80303030303,31.80634469696969,0
4908,4,1,3,33,0.027777777777777776,0.08333333333333333,0.9166666666666666,36,1600,1400,200,0.875,18,14,4,369.96703207988725,0.4312830687830688,0.04966208545364714,0.20894472096894634,129918.78311526799,2413.133320117241,132331.91643538524,393,0,118.88888888888889,33,3,20,35.69927775774332,0.6259469696969697,45.128676470588225,1019.4852941176456,30.893493761140775,0
4909,4,1,0,34,0.029411764705882353,0.0,1.0,34,800,600,200,0.75,10,6,4,380.0413922309336,0.42988710635769456,0.04115241803340286,0.21397150615822177,129797.77865939651,3065.7057020399066,132863.48436143642,394,0,121.1470588235294,31,3,21,35.56574239713775,0.6297043010752688,45.24739583333332,1019.0104166666652,32.871303763440814,0
4910,4,0,0,34,0.0,0.0,1.0,34,1100,700,400,0.6363636363636364,15,7,8,381.33388965351025,0.4296457219251337,0.03741368817293167,0.21524607224926662,129897.31046888548,3106.8493313259323,133004.1598002114,395,1,122.1470588235294,31,3,21,35.431435474943584,0.6307123655913979,45.14973958333332,1019.4010416666654,32.88390456989243,0
4911,4,1,0,35,0.02857142857142857,0.0,1.0,35,650,300,350,0.46153846153846156,10,3,7,373.4063608704351,0.43273809523809526,0.039040079168728425,0.21257866347018262,130230.36552392594,2725.7693730231363,132956.13489694908,396,0,119.62857142857143,32,3,22,35.29476950354611,0.6315104166666667,44.82323232323231,1020.7070707070691,31.89709595959591,0
4912,4,0,1,34,0.0,0.02857142857142857,0.9714285714285714,35,850,500,350,0.5882352941176471,12,5,7,374.6045861551763,0.4321778711484594,0.042358927246387346,0.21361443467212662,130294.81207274766,2761.80683093562,133056.6189036833,397,1,120.62857142857143,32,3,22,35.198697336961004,0.6321614583333333,44.76010101010101,1020.9595959595958,31.90498737373737,0
4913,4,0,0,34,0.0,0.0,1.0,34,900,600,300,0.6666666666666666,12,6,6,378.02386472281796,0.4319295900178253,0.0419535832695741,0.21575423196188775,130329.05578613281,3053.498670789932,133382.55445692275,398,2,123.20588235294117,31,3,23,35.07661735951714,0.6350806451612903,44.7265625,1021.09375,32.93850806451613,0
4914,4,0,0,34,0.0,0.0,1.0,34,1050,700,350,0.6666666666666666,14,7,7,377.25905038288363,0.4312797088532383,0.03846845901246043,0.216056533525847,130462.0446099175,3043.5974121093705,133505.64202202688,399,3,124.20588235294117,31,3,23,34.96102047752571,0.6364247311827957,44.596354166666664,1021.614583333333,32.95530913978494,0
4915,4,0,0,34,0.0,0.0,1.0,34,1100,800,300,0.7272727272727273,14,8,6,377.6536167795857,0.43085264408793816,0.04409891345073125,0.21702641959881008,130595.10125054244,3063.9424641927,133659.04371473513,400,4,125.20588235294117,31,3,19,34.81581740976646,0.637768817204301,44.46614583333333,1022.1354166666658,32.97211021505374,0
4916,4,0,0,34,0.0,0.0,1.0,34,1250,1100,150,0.88,14,11,3,381.22397480430845,0.43137254901960786,0.04064477477814843,0.22002309493665265,130761.51741875538,3169.8850843641453,133931.40250311952,401,5,126.20588235294117,31,3,19,34.55561744112031,0.6394489247311828,44.303385416666664,1022.7864583333329,32.99311155913977,0
4917,4,0,1,33,0.0,0.029411764705882353,0.9705882352941176,34,1100,1000,100,0.9090909090909091,12,10,2,392.4906675029914,0.43092691622103385,-0.033196088522902456,0.211249132121416,128012.72922092005,3248.7603081597135,131261.48952907976,402,6,127.20588235294117,31,3,18,37.07539886773032,0.6115591397849462,47.00520833333333,1011.979166666666,32.6444892473118,8
4918,4,0,1,32,0.0,0.030303030303030304,0.9696969696969697,33,1300,1100,200,0.8461538461538461,15,11,4,400.1107566193836,0.4272411616161616,-0.031445933437965534,0.2155103002391958,128042.48504162322,3646.235113885986,131688.72015550922,403,7,131.8181818181818,30,3,20,36.85203629924745,0.6145833333333333,46.9758064516129,1012.0967741935476,33.73655913978492,0
4919,4,1,1,32,0.030303030303030304,0.030303030303030304,0.9696969696969697,33,800,500,300,0.625,11,5,6,421.3564907682098,0.4307528409090909,0.017913161344258022,0.21535037074375266,125908.90429890761,4123.2546753960305,130032.15897430365,404,0,131.1818181818182,30,3,19,38.520601758850056,0.5927083333333334,49.092741935483886,1003.6290322580664,33.45430107526888,8
4920,4,3,1,34,0.08571428571428572,0.02857142857142857,0.9714285714285714,35,900,600,300,0.6666666666666666,12,6,6,399.73365041617075,0.43841036414565826,0.02947783251231506,0.20849417018109653,126742.13927469157,3132.619598765455,129874.75887345702,405,0,124.37142857142857,32,3,21,38.20114942528735,0.5960286458333333,48.2638888888889,1006.9444444444462,31.467013888888943,0
4921,4,0,0,34,0.0,0.0,1.0,34,1200,700,500,0.5833333333333334,17,7,10,401.6082172513973,0.4369058229352347,0.048112095516939624,0.2097528400026711,126796.77539401593,3384.5253838433246,130181.30077785926,406,1,128.58823529411765,31,3,22,38.09752747252746,0.5991263440860215,48.20963541666667,1007.1614583333342,32.48907930107529,0
4922,4,1,1,34,0.02857142857142857,0.02857142857142857,0.9714285714285714,35,850,600,250,0.7058823529411765,11,6,5,392.0539760080001,0.43984593837535013,0.05796516607975666,0.206771966966974,127193.68071814664,2974.044295236113,130167.72501338276,407,0,125.88571428571429,30,5,23,37.92888074616923,0.6059027777777778,47.81586021505377,1008.7365591397852,33.62455197132617,0
4923,4,3,2,35,0.08108108108108109,0.05405405405405406,0.9459459459459459,37,1100,800,300,0.7272727272727273,14,8,6,366.6291798851506,0.4429742242242242,0.05680489649955289,0.1966075777512768,127865.50132461081,1975.8447772491454,129841.34610185996,408,0,119.62162162162163,33,4,20,37.88054343874954,0.6051136363636364,47.15073529411765,1011.3970588235301,30.648395721925155,0
4924,4,0,0,35,0.0,0.0,1.0,35,450,300,150,0.6666666666666666,6,3,3,386.7281641377112,0.4411764705882353,0.06433360347749217,0.20544271514055415,127486.19927300354,2860.500759548621,130346.70003255217,409,1,127.45714285714286,31,4,20,37.762162626783564,0.6061827956989247,47.52604166666667,1009.8958333333339,32.57728494623658,0
4925,4,0,0,35,0.0,0.0,1.0,35,900,600,300,0.6666666666666666,12,6,6,385.2410018849679,0.44079131652661063,0.059175519673006605,0.20515339283633963,127584.84098646382,2830.1823933919377,130415.02337985576,410,2,128.45714285714286,31,4,20,37.698291231687925,0.6071908602150538,47.42838541666667,1010.2864583333339,32.58988575268819,0
4926,4,2,1,36,0.05405405405405406,0.02702702702702703,0.972972972972973,37,750,400,350,0.5333333333333333,11,4,7,366.37919751125605,0.44134759759759756,0.07011598411324216,0.1984780757348282,128272.4040435924,2000.4930329437066,130272.8970765361,411,0,122.45945945945945,32,5,22,37.47013793676516,0.6116536458333333,46.74873737373737,1013.0050505050497,31.656407828282802,0
4927,4,0,0,36,0.0,0.0,1.0,36,1200,700,500,0.5833333333333334,17,7,10,366.4397431244834,0.43940145502645506,0.0752874489576616,0.19942036546879743,128454.92118415974,2214.1976643598337,130669.11884851957,412,1,125.16666666666667,33,3,16,37.28189474532558,0.6111111111111112,46.56862745098038,1013.7254901960769,30.718954248365964,0
4928,4,0,0,36,0.0,0.0,1.0,36,900,600,300,0.6666666666666666,12,6,6,368.6400909062813,0.43910383597883595,0.07263046222437097,0.20093070567579507,128517.04422577842,2275.306973279493,130792.35119905791,413,2,126.16666666666667,33,3,16,37.16259769559263,0.6117424242424243,46.507352941176464,1013.970588235293,30.726381461675544,0
4929,4,1,1,36,0.02702702702702703,0.02702702702702703,0.972972972972973,37,850,600,250,0.7058823529411765,11,6,5,362.5794077962696,0.43940815815815815,0.08254157333983847,0.1996878584835361,128929.21095521527,1949.4153911564442,130878.62634637172,414,0,123.72972972972973,34,3,19,36.89534247645842,0.6136642156862745,46.10119047619047,1015.5952380952369,29.870448179271676,0
4930,4,0,0,36,0.0,0.0,1.0,36,1150,900,250,0.782608695652174,14,9,5,372.78650918261246,0.4374173280423281,0.08725703247615613,0.2046249606069967,128796.78376405714,2402.7406826701313,131199.52444672727,415,1,128.0,33,3,19,36.77147470723167,0.6145833333333333,46.231617647058826,1015.0735294117651,30.75980392156864,0
4931,4,0,0,36,0.0,0.0,1.0,36,800,400,400,0.5,12,4,8,375.5523990312769,0.4368055555555555,0.08657843216134298,0.206628630702069,128890.09785899644,2480.997092464423,131371.09495146087,416,2,129.0,33,3,19,36.605921634886144,0.615530303030303,46.139705882352935,1015.4411764705874,30.77094474153295,0
4932,4,0,0,36,0.0,0.0,1.0,36,950,600,350,0.631578947368421,13,6,7,372.99848687853404,0.43733465608465605,0.08392969618997825,0.2060313427521603,129045.69644187331,2426.7699022010715,131472.46634407438,417,3,130.0,33,3,20,36.51185522454067,0.6171085858585859,45.986519607843135,1016.0539215686274,30.78951277480689,0
4933,4,0,0,36,0.0,0.0,1.0,36,950,600,350,0.631578947368421,13,6,7,372.82566431182386,0.4370701058201058,0.08621359483428459,0.20642296794407664,129139.10064638594,2429.27419742406,131568.37484381,418,4,131.0,33,3,20,36.42090667952737,0.6180555555555556,45.89460784313725,1016.4215686274504,30.800653594771223,0
4934,4,1,2,35,0.02702702702702703,0.05405405405405406,0.9459459459459459,37,1150,900,250,0.782608695652174,14,9,5,353.0295254196353,0.4391891891891892,0.02673002673002678,0.1889746283128635,127793.20987654309,1622.9552469135642,129416.16512345665,419,0,128.43243243243242,35,2,15,38.29842032967033,0.6,47.222222222222214,1011.1111111111102,28.88888888888886,8
4935,4,1,0,36,0.027777777777777776,0.0,1.0,36,900,600,300,0.6666666666666666,12,6,6,360.58131487889295,0.4369543650793651,0.07000000000000028,0.1939836187639611,127993.90589569138,2030.4421768707211,130024.3480725621,420,0,132.44444444444446,34,2,18,37.90196078431373,0.6041666666666667,47.02380952380951,1011.9047619047601,29.76190476190471,0
4936,4,0,1,35,0.0,0.027777777777777776,0.9722222222222222,36,1050,900,150,0.8571428571428571,12,9,3,364.38647764929544,0.43644179894179896,0.07118729337358065,0.19647293718782222,128084.27047902484,2134.43523242629,130218.70571145113,421,1,133.44444444444446,34,2,18,37.71316006115489,0.6050857843137255,46.9345238095238,1012.2619047619039,29.77240896358541,0
4937,4,3,1,37,0.07894736842105263,0.02631578947368421,0.9736842105263158,38,1100,600,500,0.5454545454545454,16,6,10,347.2529468684779,0.44126363205310576,0.08822117980156663,0.19114161579824512,128907.38195516127,1352.7078237416474,130260.08977890291,422,0,126.55263157894737,35,3,18,37.30672061393509,0.6113095238095239,46.12268518518519,1015.50925925926,29.014550264550287,0
4938,4,0,0,37,0.0,0.0,1.0,37,1150,800,350,0.6956521739130435,15,8,7,358.04452787871855,0.4379692192192192,0.09735051507203374,0.19734082117966598,128959.43877551032,1834.6442743764283,130794.08304988676,423,1,130.48648648648648,34,3,19,36.97965502422254,0.6139705882352942,46.07142857142858,1015.7142857142867,29.87394957983196,0
4939,4,0,0,37,0.0,0.0,1.0,37,1200,700,500,0.5833333333333334,17,7,10,357.648383076165,0.4374061561561562,0.08987689657792797,0.1977258159286364,129080.38548752839,1833.078231292525,130913.46371882092,424,2,131.48648648648648,34,3,20,36.866408934707906,0.6151960784313726,45.952380952380956,1016.1904761904766,29.88795518207284,0
4940,4,2,0,39,0.05128205128205128,0.0,1.0,39,1200,800,400,0.6666666666666666,16,8,8,342.71074380165277,0.4411268556005398,0.09652680652680634,0.19233766233766217,129672.49657064468,1088.0882394109838,130760.58481005566,425,0,125.6923076923077,35,4,17,36.64393939393938,0.6190476190476191,45.37037037037037,1018.5185185185182,29.100529100529094,0
4941,4,0,0,39,0.0,0.0,1.0,39,1700,1300,400,0.7647058823529411,21,13,8,342.49270541766595,0.44000224921277553,0.08984838957591013,0.19337665059735895,129908.37191358021,1098.5339506172786,131006.90586419748,426,1,126.6923076923077,35,4,18,36.410081743869206,0.6214285714285714,45.138888888888886,1019.4444444444441,29.126984126984116,0
4942,4,0,0,39,0.0,0.0,1.0,39,800,400,400,0.5,12,4,8,343.9231001177958,0.4399460188933873,0.08559231031141179,0.19462469076030145,129996.880425347,1141.7860243055322,131138.66644965252,427,2,127.6923076923077,35,4,19,36.28383554647601,0.6223214285714286,45.05208333333332,1019.7916666666648,29.13690476190471,0
4943,4,0,2,37,0.0,0.05128205128205128,0.9487179487179487,39,900,800,100,0.8888888888888888,10,8,2,344.2647944054597,0.4391587944219523,0.08636609589638877,0.19526061118981483,130085.4190779321,1156.766010802472,131242.18508873458,428,3,128.69230769230768,35,4,19,36.18533015656911,0.6232142857142857,44.96527777777778,1020.1388888888889,29.1468253968254,0
4944,4,0,0,37,0.0,0.0,1.0,37,1250,700,550,0.56,18,7,11,361.8216065287949,0.4344344344344344,0.08528557410500182,0.20418128379284364,129887.55076172622,1999.2244569396337,131886.77521866586,429,4,136.32432432432432,33,4,19,35.938627073815816,0.6256313131313131,45.15931372549019,1019.3627450980389,30.889780154486026,0
4945,4,0,2,35,0.0,0.05405405405405406,0.9459459459459459,37,1300,1100,200,0.8461538461538461,15,11,4,362.20043572984764,0.43412162162162166,0.0895159865748103,0.20524691358024683,130049.99999999988,2020.8333333333187,132070.8333333332,430,5,137.32432432432432,34,3,19,35.76388888888889,0.625,44.99999999999999,1019.9999999999991,29.99999999999997,0
4946,4,0,0,35,0.0,0.0,1.0,35,1350,1200,150,0.8888888888888888,15,12,3,369.2814585442548,0.4321778711484594,0.10008583101589608,0.20905852367382907,130012.5027032872,2602.241325451753,132614.74402873896,431,6,142.74285714285713,33,2,21,35.621445165424994,0.6268939393939394,45.036764705882355,1019.8529411764706,30.90463458110517,0
4947,4,0,0,35,0.0,0.0,1.0,35,1400,900,500,0.6428571428571429,19,9,10,372.0975794450951,0.4320728291316527,0.09213649851632044,0.2125370919881305,130359.27456382001,2701.5143968785014,133060.78896069853,432,7,143.74285714285713,32,3,21,35.19720573689415,0.6328125,44.696969696969695,1021.2121212121211,31.912878787878785,0
4948,4,0,0,35,0.0,0.0,1.0,35,1650,1400,250,0.8484848484848485,19,14,5,378.69863835748566,0.43203781512605044,-0.019907431483696447,0.20121569817563129,127493.9344993513,2659.9428851764837,130153.87738452778,433,8,144.74285714285713,33,2,17,37.95693787161753,0.6013257575757576,47.51838235294118,1009.926470588236,30.60383244206776,8
4949,4,2,2,35,0.05405405405405406,0.05405405405405406,0.9459459459459459,37,1050,800,250,0.7619047619047619,13,8,5,358.42745442385177,0.4386261261261261,-0.009297495116342036,0.19298581659372901,128027.37054183813,1777.704903978052,129805.07544581618,434,0,137.86486486486487,35,2,20,37.92219426654468,0.6023809523809525,46.99074074074074,1012.037037037037,28.915343915343914,0
4950,4,2,1,36,0.05405405405405406,0.02702702702702703,0.972972972972973,37,1200,900,300,0.75,15,9,6,359.3692548273922,0.43940815815815815,-0.006279743857565689,0.19523359708650875,128385.71605725629,1827.6294056717427,130213.34546292803,435,0,137.83783783783784,34,3,17,37.53181408825718,0.6081495098039216,46.636904761904766,1013.4523809523813,29.807422969187684,0
4951,4,1,1,36,0.02702702702702703,0.02702702702702703,0.972972972972973,37,1050,900,150,0.8571428571428571,12,9,3,360.3402669943336,0.43809434434434436,0.004755868501161276,0.1967390504468128,128584.36113522388,1866.8246045524816,130451.18573977637,436,0,138.8108108108108,35,2,18,37.30421944539543,0.6080357142857142,46.44097222222223,1014.236111111112,28.97817460317463,0
4952,4,0,2,34,0.0,0.05555555555555555,0.9444444444444444,36,1100,800,300,0.7272727272727273,14,8,6,364.64568417994485,0.4355324074074074,0.006144949080050921,0.19930377645268213,128627.12762188223,2180.665391156481,130807.79301303871,437,1,143.36111111111111,34,2,18,37.151351562805615,0.6106004901960784,46.39880952380953,1014.4047619047631,29.8354341736695,0
4953,4,2,0,36,0.05555555555555555,0.0,1.0,36,750,500,250,0.6666666666666666,10,5,5,378.0533017803573,0.4311838624338624,-0.07310802323755683,0.20216805029715323,127753.08956916096,2459.495464852603,130212.58503401357,438,0,144.13888888888889,34,2,18,37.707057622860724,0.6017156862745099,47.26190476190476,1010.9523809523806,29.73389355742296,8
4954,4,0,0,36,0.0,0.0,1.0,36,1100,900,200,0.8181818181818182,13,9,4,378.01899188699804,0.43151455026455027,-0.07636845203060583,0.20260386978423028,127843.36911848077,2465.4443027210973,130308.81342120186,439,1,145.13888888888889,34,2,18,37.61526388071416,0.6026348039215687,47.17261904761905,1011.3095238095241,29.74439775910365,0
4955,4,1,2,35,0.02702702702702703,0.05405405405405406,0.9459459459459459,37,1050,600,450,0.5714285714285714,15,6,9,372.0996208278935,0.4343718718718719,-0.05823922155884387,0.20155802527938213,128268.64216887754,2146.4512398096745,130415.09340868721,440,0,142.1891891891892,33,4,19,37.32911928381322,0.6092171717171717,46.75245098039217,1012.9901960784329,30.69667260843736,0
4956,4,0,0,35,0.0,0.0,1.0,35,1200,800,400,0.6666666666666666,16,8,8,387.92700294152394,0.4309873949579832,-0.052582828642678825,0.20964788164360004,128176.4934700541,2944.624591878388,131121.1180619325,441,1,145.22857142857143,32,3,21,37.02280756442228,0.6106770833333333,46.843434343434346,1012.6262626262629,31.644570707070717,0
4957,4,0,1,34,0.0,0.02857142857142857,0.9714285714285714,35,1350,900,450,0.6666666666666666,18,9,9,387.01940819557944,0.430952380952381,-0.0492512597710153,0.20965946738373628,128272.40404359256,2928.781980155094,131201.18602374766,442,2,146.22857142857143,32,3,21,36.94742199509742,0.6116536458333333,46.74873737373738,1013.005050505051,31.656407828282845,0
4958,4,0,0,34,0.0,0.0,1.0,34,1450,1000,450,0.6896551724137931,19,10,9,404.2469920112567,0.43064839572192515,-0.035585136841774445,0.2121377321968098,126990.38770739388,3503.0661523580407,130493.45385975191,443,3,150.61764705882354,30,4,18,37.83115526514647,0.6038194444444445,48.01747311827957,1007.9301075268813,33.597670250896044,8
4959,4,2,2,34,0.05555555555555555,0.05555555555555555,0.9444444444444444,36,1150,1000,150,0.8695652173913043,13,10,3,387.5588697017267,0.4368716931216931,-0.035637973137973566,0.20745798319327705,127793.20987654314,2705.478395061712,130498.68827160486,444,0,143.19444444444446,32,4,18,37.42559523809523,0.6067708333333333,47.222222222222214,1011.1111111111106,31.597222222222207,0
4960,4,1,1,34,0.02857142857142857,0.02857142857142857,0.9714285714285714,35,1400,1100,300,0.7857142857142857,17,11,6,401.2869082664774,0.43641456582633054,-0.036976953778807276,0.21509975269190684,127848.07205200194,3260.751512315537,131108.82356431748,445,0,148.02857142857144,31,4,19,37.02215033689541,0.6098790322580645,47.16796875,1011.3281249999999,32.6234879032258,0
4961,4,0,0,34,0.0,0.0,1.0,34,1200,700,500,0.5833333333333334,17,7,10,410.7499034226995,0.43425059417706474,-0.036689466484268074,0.22030598882792687,127872.49835602377,3704.7232700312106,131577.221626055,446,1,153.1764705882353,30,4,19,36.7577519379845,0.6128472222222222,47.14381720430107,1011.4247311827953,33.714157706093175,0
4962,4,1,0,35,0.02857142857142857,0.0,1.0,35,1300,1100,200,0.8461538461538461,15,11,4,399.9495711468596,0.43799019607843137,-0.03364556866016921,0.2161563894562725,128178.55568562834,3253.2807260954914,131431.83641172384,447,0,149.77142857142857,30,5,21,36.71633041323776,0.6159722222222221,46.84139784946236,1012.6344086021501,33.754480286738335,0
4963,4,1,2,34,0.027777777777777776,0.05555555555555555,0.9444444444444444,36,1150,700,450,0.6086956521739131,16,7,9,386.1644508758933,0.43915343915343913,-0.022875613634792513,0.21122065097262105,128656.40503838896,2736.506000663195,131392.91103905215,448,0,146.58333333333334,32,4,16,36.575658577058704,0.6155598958333333,46.369949494949495,1014.5202020202021,31.703756313131315,0
4964,4,1,0,35,0.02857142857142857,0.0,1.0,35,800,500,300,0.625,11,5,6,396.67512345909483,0.4332282913165266,-0.0016129623519924863,0.21741813728833914,128738.47961425771,3213.470458984359,131951.95007324207,449,0,151.6,31,4,18,36.224980754426475,0.6189516129032258,46.28906249999999,1014.8437499999992,32.7368951612903,0
4965,4,0,2,33,0.0,0.05714285714285714,0.9428571428571428,35,900,700,200,0.7777777777777778,11,7,4,414.73853911938954,0.43280812324929974,-0.043445516592139355,0.22278433030572542,127933.68055555568,3663.3802625868248,131597.0608181425,450,1,152.6,29,6,18,36.59390444810544,0.6163793103448276,47.08333333333334,1011.6666666666677,34.8850574712644,8
4966,4,1,0,34,0.029411764705882353,0.0,1.0,34,1200,900,300,0.75,15,9,6,404.5837299630416,0.43358214497920383,-0.012992145034597335,0.21924470478086375,128285.19483024694,3580.4205246913643,131865.61535493832,451,0,155.91176470588235,29,5,19,36.48946622794992,0.6199712643678161,46.736111111111114,1013.0555555555558,34.93295019157089,0
4967,4,1,2,33,0.02857142857142857,0.05714285714285714,0.9428571428571428,35,1300,900,400,0.6923076923076923,17,9,8,394.54176897802375,0.43564425770308124,-0.006524989118709801,0.2159822925319148,128689.46419022446,3154.6737700890526,131844.13796031353,452,0,152.42857142857142,30,5,20,36.32931514107829,0.6211805555555556,46.33736559139786,1014.6505376344098,33.821684587813664,0
4968,4,0,0,33,0.0,0.0,1.0,33,1050,800,250,0.7619047619047619,13,8,5,401.0810742721957,0.4316998106060606,0.008994656311195115,0.219273665155997,128637.19135802485,3718.7885802469373,132355.97993827178,453,1,158.57575757575756,29,4,20,36.217027199707914,0.6235632183908046,46.3888888888889,1014.4444444444458,34.980842911877446,0
4969,4,0,0,33,0.0,0.0,1.0,33,900,300,600,0.3333333333333333,15,3,12,397.91936840869903,0.43087121212121215,0.01150412016704605,0.21812429294541383,128742.88435570998,3645.8574459876672,132388.74180169764,454,2,159.57575757575756,29,4,20,36.188899913325116,0.6246408045977012,46.28472222222223,1014.8611111111119,34.99521072796937,0
4970,4,1,1,33,0.029411764705882353,0.029411764705882353,0.9705882352941176,34,900,500,400,0.5555555555555556,13,5,8,386.8029310489626,0.4328022875816993,0.015367258014316931,0.21375951452705833,129064.77627471386,3184.526751647592,132249.30302636145,455,0,155.85294117647058,30,4,21,36.14169973544974,0.625,45.96774193548387,1016.1290322580647,33.870967741935495,0
4971,4,0,0,33,0.0,0.0,1.0,33,950,700,250,0.7368421052631579,12,7,5,394.4973974113809,0.4298847853535353,0.022908510946788585,0.21779233675956625,129024.94454089513,3580.000964506186,132604.94550540132,456,1,161.12121212121212,29,4,21,35.98698450672135,0.6275143678160919,46.00694444444445,1015.9722222222229,35.03352490421458,0
4972,4,0,0,33,0.0,0.0,1.0,33,1350,1000,350,0.7407407407407407,17,10,7,397.7512489915253,0.42980587121212116,0.02442951575583696,0.22076852872380262,129236.69222608022,3680.8111496913516,132917.50337577157,457,2,162.12121212121212,29,4,22,35.687719118517506,0.6296695402298851,45.79861111111111,1016.8055555555554,35.06226053639846,0
4973,4,0,0,33,0.0,0.0,1.0,33,1150,900,250,0.782608695652174,14,9,5,396.55468297257136,0.4293323863636364,0.017014694508894035,0.22129140610358183,129448.61352237647,3666.690779320976,133115.30430169744,458,3,163.12121212121212,29,4,19,35.50154110368043,0.6318247126436782,45.59027777777777,1017.6388888888883,35.09099616858236,0
4974,4,1,1,33,0.029411764705882353,0.029411764705882353,0.9705882352941176,34,900,800,100,0.8888888888888888,10,8,2,383.2570985552528,0.43172534165181226,0.024393459915611704,0.2162665056133212,129885.535900104,3155.910726673596,133041.44662677762,459,0,159.2941176470588,30,4,21,35.39441587552742,0.6333333333333333,45.16129032258064,1019.354838709677,33.9784946236559,0
4975,4,0,2,31,0.0,0.06060606060606061,0.9393939393939394,33,900,500,400,0.5555555555555556,13,5,8,429.81896570686985,0.4310290404040404,0.013708720028422938,0.22136626260337597,126224.2473411282,4251.261574446406,130475.50891557461,460,1,164.0,28,5,19,37.98076923076923,0.6019345238095238,48.7787356321839,1004.8850574712636,35.88875205254513,8
4976,4,3,1,33,0.08823529411764706,0.029411764705882353,0.9705882352941176,34,900,600,300,0.6666666666666666,12,6,6,412.9920537191437,0.43584744503862155,0.04839808029055015,0.21652242353945872,126952.00617283965,3686.0339506173013,130638.04012345696,461,0,159.7058823529412,29,5,19,37.65045020213156,0.6063218390804598,48.055555555555564,1007.777777777779,34.750957854406174,0
4977,4,0,0,33,0.0,0.0,1.0,33,1150,900,250,0.782608695652174,14,9,5,424.3254905318287,0.43067392676767674,0.05130863813498521,0.22243789167341171,126947.17969678964,4173.384859294504,131120.56455608414,462,1,165.54545454545453,28,5,20,37.36990305104076,0.609375,48.06034482758621,1007.758620689656,35.99137931034486,0
4978,4,2,0,35,0.05714285714285714,0.0,1.0,35,1500,1400,100,0.9333333333333333,16,14,2,401.4904937106531,0.4339635854341737,0.05566849695058251,0.21425174039818318,127668.66337510124,3251.5509379697187,130920.21431307096,463,0,157.02857142857144,30,5,20,37.201589307088724,0.6107638888888889,47.34543010752689,1010.618279569893,33.6872759856631,0
4979,4,0,0,35,0.0,0.0,1.0,35,1050,700,350,0.6666666666666666,14,7,7,401.8255576337131,0.43343837535014007,0.053466512219668916,0.21515542135789498,127804.53529671064,3271.02573274367,131075.56102945431,464,1,158.02857142857144,30,5,20,37.05331428065043,0.6121527777777778,47.211021505376344,1011.1559139784949,33.7051971326165,0
4980,4,1,0,36,0.027777777777777776,0.0,1.0,36,1050,800,250,0.7619047619047619,13,8,5,389.6763704719808,0.4349371693121693,0.04698216735253791,0.21042524005486965,128144.53125000001,2786.979166666666,130931.51041666669,465,0,154.61111111111111,31,5,21,37.01131687242798,0.6129032258064516,46.875,1012.5000000000001,32.66129032258065,0
4981,4,0,1,35,0.0,0.027777777777777776,0.9722222222222222,36,1050,600,450,0.5714285714285714,15,6,9,392.6160069066992,0.4343584656084656,0.05014569139135294,0.21253722461567262,128243.42727661146,2870.084465874581,131113.51174248604,466,1,155.61111111111111,31,5,21,36.83541693448173,0.6139112903225806,46.77734375000001,1012.890625000001,32.67389112903229,0
4982,4,1,0,36,0.027777777777777776,0.0,1.0,36,1100,800,300,0.7272727272727273,14,8,6,384.1403257140797,0.4350198412698412,0.058172578303256506,0.21011351375851822,128656.40503838907,2684.4226673298776,131340.82770571896,467,0,153.5,32,4,17,36.62699647376063,0.6155598958333333,46.3699494949495,1014.5202020202031,31.703756313131347,0
4983,4,0,1,35,0.0,0.027777777777777776,0.9722222222222222,36,1200,900,300,0.75,15,9,6,383.65449574351396,0.43460648148148145,0.06235750113999061,0.21086574164549546,128848.620756173,2686.6705246913752,131535.29128086436,468,1,154.5,32,4,18,36.442658458732325,0.6175130208333333,46.180555555555564,1015.2777777777791,31.727430555555596,0
4984,4,0,1,34,0.0,0.02857142857142857,0.9714285714285714,35,1100,700,400,0.6363636363636364,15,7,8,395.43658585655834,0.4317577030812325,0.07747430793445131,0.20325071684765772,126141.91903008334,2983.9420083128134,129125.86103839616,469,2,159.82857142857142,31,4,20,38.929709440483904,0.5924059139784946,48.86067708333332,1004.5572916666649,32.40507392473113,8
4985,4,1,0,35,0.02857142857142857,0.0,1.0,35,1000,700,300,0.7,13,7,6,394.2556265114392,0.43368347338935576,0.08544422041767663,0.20394080398846917,126403.65812513558,2967.070685492617,129370.72881062819,470,0,160.62857142857143,31,4,17,38.688684233242704,0.5950940860215054,48.600260416666664,1005.5989583333329,32.4386760752688,0
4986,4,1,0,36,0.027777777777777776,0.0,1.0,36,1650,1300,350,0.7878787878787878,20,13,7,384.5940252247982,0.4363095238095238,0.10398574927633031,0.2020130721970256,127028.3644526069,2570.870000510152,129599.23445311705,471,0,157.13888888888889,32,4,18,38.28725158650633,0.5989583333333333,47.97979797979798,1008.0808080808082,31.502525252525256,0
4987,4,3,2,37,0.07692307692307693,0.05128205128205128,0.9487179487179487,39,1000,800,200,0.8,12,8,4,358.5094277244926,0.4427856500224921,0.11206317056345716,0.19176851507491974,127763.95486379012,1360.916468407046,129124.87133219716,472,0,145.97435897435898,35,4,19,38.18987311581761,0.5997023809523809,47.2511574074074,1010.9953703703688,28.885582010581967,0
4988,4,1,0,38,0.02631578947368421,0.0,1.0,38,1000,700,300,0.7,13,7,6,365.5891617063559,0.4426120199146515,0.12267482929126405,0.19579535558220595,127813.27239229022,1745.4294217687018,129558.70181405892,473,0,150.55263157894737,34,4,20,37.96037398948277,0.602328431372549,47.20238095238095,1011.190476190476,29.740896358543413,0
4989,4,1,1,38,0.02564102564102564,0.02564102564102564,0.9743589743589743,39,1450,800,650,0.5517241379310345,21,8,13,363.0209157539547,0.44374156545209176,0.1379029852769722,0.19691975869865536,128325.39859693851,1517.3894557822796,129842.78805272079,474,0,147.66666666666666,34,5,21,37.50097912505384,0.6075367647058824,46.696428571428555,1013.2142857142835,29.800420168067163,0
4990,4,1,1,38,0.02564102564102564,0.02564102564102564,0.9743589743589743,39,500,100,400,0.2,9,1,8,363.44455309661765,0.4434041835357625,0.1453292616083317,0.19759686622379286,128415.88010204052,1534.4104308389674,129950.29053287949,475,0,148.53846153846155,34,5,20,37.39771748492678,0.6084558823529411,46.60714285714284,1013.5714285714262,29.810924369747827,0
4991,4,1,0,39,0.02564102564102564,0.0,1.0,39,1300,1100,200,0.8461538461538461,15,11,4,365.7811845913417,0.4448942869995502,0.15140959462874148,0.20038038672600197,128717.71541950089,1616.5036848072282,130334.21910430813,476,0,144.07692307692307,34,5,21,37.03000351947442,0.6115196078431373,46.309523809523796,1014.7619047619028,29.84593837535008,0
4992,4,0,0,39,0.0,0.0,1.0,39,1000,700,300,0.7,13,7,6,367.80481039473267,0.44483805668016196,0.15652085061367815,0.2027203257291897,128959.43877551015,1686.3803854875237,130645.81916099768,477,1,145.07692307692307,34,5,21,36.73181356461947,0.6139705882352942,46.07142857142857,1015.7142857142852,29.87394957983192,0
4993,4,1,1,39,0.025,0.025,0.975,40,1200,800,400,0.6666666666666666,16,8,8,362.402522710804,0.4453392094017094,0.15841193992801283,0.20178832933524168,129361.89746263128,1376.8958687316253,130738.7933313629,478,0,142.425,32,8,22,36.45872119482023,0.6227213541666667,45.675505050505045,1017.2979797979792,31.79056186868685,0
4994,4,2,2,39,0.04878048780487805,0.04878048780487805,0.9512195121951219,41,1350,800,550,0.5925925925925926,19,8,11,356.47510149138475,0.44621443089430896,0.17240307531712018,0.2011641719270921,129887.5507617262,1060.335568050744,130947.88632977694,479,0,139.7560975609756,33,8,19,36.074877775106195,0.6256313131313131,45.15931372549019,1019.3627450980388,30.889780154486022,0
4995,4,0,1,38,0.0,0.02564102564102564,0.9743589743589743,39,1450,900,550,0.6206896551724138,20,9,11,371.95685593219474,0.44410706252811516,0.16746149585213854,0.20888862052818088,129698.28499688051,1848.4332614474881,131546.718258328,480,1,147.43589743589743,31,8,20,35.872986705867305,0.6286962365591398,45.345052083333336,1018.6197916666673,32.85870295698927,0
4996,4,2,0,40,0.05,0.0,1.0,40,950,800,150,0.8421052631578947,11,8,3,362.59528797141917,0.44415064102564106,0.18491369255889922,0.2064337316777522,130232.20663265302,1444.3168934240325,131676.52352607704,481,0,144.575,34,6,22,35.56877381230077,0.6268382352941176,44.82142857142857,1020.7142857142853,30.021008403361332,0
4997,4,0,2,38,0.0,0.05,0.95,40,1150,800,350,0.6956521739130435,15,8,7,355.90584917635647,0.44337606837606836,0.10483835252435814,0.1979397555271461,129315.9037415795,1204.8608497148698,130520.76459129437,482,1,145.575,36,4,20,36.67077243873635,0.6134259259259259,45.72072072072073,1017.1171171171178,28.253253253253273,8
4998,4,0,0,38,0.0,0.0,1.0,38,1650,1300,350,0.7878787878787878,20,13,7,406.56757050475545,0.4399745139876719,0.2068655891697746,0.21643028154414842,127569.89282024806,2890.7305675119137,130460.62338775997,483,2,154.0,32,6,20,37.17504061992252,0.6044921875,47.44318181818183,1010.2272727272737,31.569602272727302,8
4999,4,1,1,38,0.02564102564102564,0.02564102564102564,0.9743589743589743,39,1000,800,200,0.8,12,8,4,396.9503753758556,0.44371345029239767,0.20528974296844416,0.2130317554195263,127896.48963139186,2353.7119136870524,130250.2015450789,484,0,151.02564102564102,33,6,21,37.08202083838139,0.6054292929292929,47.12009803921569,1011.5196078431379,30.652109328579936,0
5000,4,1,0,39,0.02564102564102564,0.0,1.0,39,1150,900,250,0.782608695652174,14,9,5,395.3660981772773,0.44632816014394966,0.21165952691376422,0.21316736102769632,128082.49831795455,2327.8955209534674,130410.39383890801,485,0,151.87179487179486,33,6,22,36.93099273607747,0.6073232323232323,46.936274509803916,1012.2549019607836,30.674390968508593,0
