period,mktsize,entries,exits,surviv,entryrate,exitrate,survivrate,firms,totresinv,totinninv,totimiinv,costshareinn,firmsres,firmsinn,firmsimi,hindex,div,gini,pcm,cs,totprofits,ts,maxage,minage,avgage,actfirms,inactfirms,profitablefirms,wmc,avgproxopt,price,totoutput,avgoutput,magtechshock
1,4,40,25,15,1.0,0.625,0.375,40,0,0,0,0,0,0,0,443.29994142914904,0.49643429487179486,0.0375213988750307,0.19060499058925232,118480.1658163265,3704.45011337868,122184.61592970518,0,0,0.0,34,6,15,45.81753892557267,0.505514705882353,56.607142857142854,973.5714285714283,28.634453781512597,0
2,4,34,31,18,0.6938775510204082,0.6326530612244898,0.36734693877551017,49,500,300,200,0.6,7,3,4,315.9402270750104,0.4968112244897959,-0.25106125652772826,0.1469006749246584,121918.45441980673,-696.2111651943742,121222.24325461236,1,0,0.30612244897959184,42,7,16,45.30023547880691,0.5277777777777777,53.10077519379846,987.5968992248081,23.514211886304956,0
3,4,33,30,21,0.6470588235294118,0.5882352941176471,0.4117647058823529,51,350,100,250,0.2857142857142857,6,1,5,294.69325705938917,0.4974019607843137,-0.17808724345429483,0.14269156887998616,123651.70518491237,-1912.1352516221873,121739.56993329019,2,0,0.6078431372549019,46,5,12,44.02445999346347,0.5405344202898552,51.35195035460991,994.5921985815573,21.62156953438168,0
4,4,25,27,19,0.5434782608695652,0.5869565217391305,0.4130434782608695,46,800,600,200,0.75,10,6,4,290.2961108035735,0.4985607890499195,-0.19665233996377773,0.14354167376097673,124535.00770993682,-1969.5943205824472,122565.41338935438,3,0,1.0434782608695652,46,0,12,43.221533884003904,0.5495923913043477,50.4654255319149,998.138297872342,21.69865864939874,0
5,4,23,24,18,0.5476190476190477,0.5714285714285714,0.4285714285714286,42,450,200,250,0.4444444444444444,7,2,5,338.24717956525865,0.49239014711575685,-0.21136007542879387,0.16746567472661478,124588.51748880745,28.3429293611847,124616.86041816864,4,0,1.3571428571428572,42,0,15,41.969571969329316,0.5553075396825399,50.41182170542634,998.3527131782921,23.77030269472124,0
6,4,20,16,22,0.5263157894736842,0.42105263157894735,0.5789473684210527,38,300,200,100,0.6666666666666666,4,2,2,349.7829506134003,0.4941619250829777,-0.18748100197016615,0.1737763330624492,124733.04866133393,1125.8987599532477,125858.94742128717,5,0,1.6578947368421053,38,0,19,41.53186274509803,0.5630482456140351,50.26709401709402,998.931623931624,26.287674313990106,0
7,4,8,7,23,0.26666666666666666,0.23333333333333334,0.7666666666666666,30,600,500,100,0.8333333333333334,7,5,2,371.177751133851,0.4903256704980843,-0.057237608676167784,0.18528994046534106,124932.80473176074,3274.455500635891,128207.26023239663,6,0,2.8333333333333335,30,0,21,40.79025499686295,0.5826388888888889,50.06720430107526,999.7311827956977,33.32437275985659,0
8,4,10,10,23,0.30303030303030304,0.30303030303030304,0.696969696969697,33,600,500,100,0.8333333333333334,7,5,2,342.94597347034403,0.4873342803030303,-0.0459979152343144,0.17637836201442134,126166.92648260265,2053.6878844674843,128220.61436707013,7,0,3.090909090909091,33,0,20,40.22220866878099,0.5877525252525254,48.835784313725476,1004.6568627450964,30.444147355912012,0
9,4,9,7,25,0.28125,0.21875,0.78125,32,650,300,350,0.46153846153846156,10,3,7,343.1963367064276,0.48286290322580644,-0.028171992481202945,0.17970516843289341,126901.11340679538,2310.399449035833,129211.51285583121,8,0,3.40625,32,0,17,39.461152882205525,0.59765625,48.106060606060616,1007.5757575757589,31.486742424242465,0
10,4,8,8,25,0.24242424242424243,0.24242424242424243,0.7575757575757576,33,550,300,250,0.5454545454545454,8,3,5,330.3766521121496,0.47593118686868685,-0.029726284545050996,0.17662197040007274,127741.58564314213,1840.5674800557495,129582.15312319787,9,0,3.696969696969697,33,0,17,38.92378369095244,0.6038510101010102,47.27328431372549,1010.9068627450986,30.633541295306017,0
11,4,2,1,26,0.07407407407407407,0.037037037037037035,0.962962962962963,27,600,400,200,0.6666666666666666,8,4,4,388.36294452238496,0.4728157644824311,-0.008578149789375322,0.20318524995491055,126867.03913336151,4454.091376133765,131321.13050949527,10,0,4.777777777777778,27,0,23,38.358567208271786,0.6118827160493827,48.13988095238094,1007.4404761904748,37.31261022927684,0
12,4,3,3,26,0.10344827586206896,0.10344827586206896,0.896551724137931,29,1000,800,200,0.8,12,8,4,368.2850849542727,0.4742918719211822,-0.03983704750567929,0.19560269194320787,127477.43296682098,3589.6074459876536,131067.04041280864,11,0,5.344827586206897,29,0,19,38.23680259478292,0.6117097701149425,47.53472222222222,1009.8611111111111,34.8227969348659,0
13,4,3,5,24,0.10344827586206896,0.1724137931034483,0.8275862068965517,29,600,400,200,0.6666666666666666,8,4,4,365.3452153238026,0.4736761083743843,-0.025023222308581783,0.19488649462580562,127652.81635802473,3527.469135802476,131180.28549382722,12,0,6.241379310344827,29,0,20,38.13107018508338,0.6135057471264367,47.361111111111114,1010.5555555555559,34.84674329501917,0
14,4,3,4,23,0.1111111111111111,0.14814814814814814,0.8518518518518519,27,750,600,150,0.8,9,6,3,394.76737306689097,0.47447768281101615,-0.0345781012644395,0.20806634950601752,127167.04976261324,4640.280435090673,131807.3301977039,13,0,7.148148148148148,27,0,21,37.88789711812727,0.6149691358024693,47.84226190476189,1008.6309523809513,37.35670194003523,0
15,4,2,1,24,0.08,0.04,0.96,25,350,200,150,0.5714285714285714,5,2,3,465.8088441872221,0.473125,0.0009979209979209536,0.23584637268847802,125521.37586805572,6693.7934027778,132215.16927083352,14,0,8.12,25,0,19,37.809684684684676,0.6054166666666667,49.47916666666668,1002.0833333333347,40.08333333333339,7
16,4,7,7,24,0.22580645161290322,0.22580645161290322,0.7741935483870968,31,700,500,200,0.7142857142857143,9,5,4,404.06666699565596,0.478494623655914,-0.04446557051185118,0.2061761906440581,125841.46514409166,3996.7950142357286,129838.2601583274,15,0,6.870967741935484,30,1,18,39.02433578923866,0.5920138888888891,49.15994623655913,1003.3602150537623,33.445340501792074,4
17,4,5,2,27,0.1724137931034483,0.06896551724137931,0.9310344827586207,29,750,500,250,0.6666666666666666,10,5,5,418.2939761084283,0.47516420361247946,-0.01086821808890992,0.21521611829078038,126183.34297839514,4756.346450617297,130939.68942901245,16,0,7.482758620689655,29,0,22,38.312713113998704,0.5984195402298851,48.81944444444445,1004.722222222223,34.645593869731826,0
18,4,3,4,26,0.1,0.13333333333333333,0.8666666666666667,30,550,400,150,0.7272727272727273,7,4,3,401.68478109677824,0.47696360153256706,0.020120921134524572,0.21061765654990522,126956.52134639848,4199.30049716731,131155.8218435658,17,0,8.133333333333333,30,0,21,37.930670400995815,0.6034722222222222,48.05107526881721,1007.7956989247317,33.59318996415772,0
19,4,5,4,27,0.16129032258064516,0.12903225806451613,0.8709677419354839,31,1000,800,200,0.8,12,8,4,377.538787428975,0.4763888888888889,-0.020746232680303622,0.20154443383931964,127683.52084689686,3441.0963270399543,131124.61717393683,18,0,8.290322580645162,31,0,19,37.79148415356867,0.6081989247311826,47.33072916666668,1010.6770833333347,32.60248655913983,0
20,4,3,4,26,0.1,0.13333333333333333,0.8666666666666667,30,650,400,250,0.6153846153846154,9,4,5,384.8856209670703,0.4765325670498084,-0.009346457391150143,0.20521773747733565,127634.70668574396,3824.952667938484,131459.65935368245,19,0,9.466666666666667,30,0,19,37.65601445419881,0.6104166666666666,47.37903225806451,1010.4838709677415,33.682795698924714,0
21,4,2,2,26,0.07142857142857142,0.07142857142857142,0.9285714285714286,28,1150,1000,150,0.8695652173913043,13,10,3,400.8096618099893,0.474619708994709,0.0004419204746328731,0.21333025981726206,127563.29528752128,4625.720248711825,132189.0155362331,20,0,10.714285714285714,28,0,21,37.32725311714787,0.6156994047619049,47.44971264367815,1010.2011494252857,36.078612479474494,0
22,4,5,5,26,0.16129032258064516,0.16129032258064516,0.8387096774193549,31,800,400,400,0.5,12,4,8,368.67177667810984,0.4732078853046595,0.004768547455739958,0.20190155696785014,128705.44645521358,3290.013122558569,131995.45957777216,21,0,10.03225806451613,31,0,15,36.96920847769365,0.6186155913978496,46.32161458333332,1014.7135416666652,32.73269489247307,0
23,4,3,3,26,0.10344827586206896,0.10344827586206896,0.896551724137931,29,1000,800,200,0.8,12,8,4,388.91426054388245,0.4735221674876848,0.0005670729113995687,0.21131104684949426,128390.74315200602,4186.598186728376,132577.3413387344,22,0,11.10344827586207,29,0,15,36.778099447261454,0.6210488505747127,46.631944444444436,1013.4722222222209,34.94731800766279,0
24,4,2,3,25,0.07142857142857142,0.10714285714285714,0.8928571428571429,28,850,600,250,0.7058823529411765,11,6,5,399.9038277752628,0.4711199294532628,0.0017629179331304368,0.21653778692900155,128253.6600772888,4657.8259182190295,132911.48599550783,23,0,12.428571428571429,28,0,23,36.64036643026004,0.6227678571428572,46.767241379310335,1012.9310344827576,36.1761083743842,0
25,4,2,2,25,0.07407407407407407,0.07407407407407407,0.9259259259259259,27,800,500,300,0.625,11,5,6,408.64366881742296,0.46877967711301044,-0.015241579027586827,0.2206675811614084,128144.53124999997,5073.090277777777,133217.62152777775,24,0,13.11111111111111,27,0,23,36.531207133059,0.625,46.875,1012.4999999999998,37.49999999999999,0
26,4,2,2,25,0.07407407407407407,0.07407407407407407,0.9259259259259259,27,850,600,250,0.7058823529411765,11,6,5,409.17507708495293,0.46895773979107314,-0.011576794185489847,0.2217885290441367,128295.24518140568,5099.043367346906,133394.28854875258,25,0,14.037037037037036,27,0,23,36.362857422640026,0.6265432098765433,46.72619047619046,1013.0952380952364,37.522045855379126,0
27,4,3,2,26,0.10714285714285714,0.07142857142857142,0.9285714285714286,28,750,600,150,0.8,9,6,3,395.956558233161,0.4678130511463845,0.0008794630221176103,0.2175605785750788,128836.4649392257,4602.728646452615,133439.19358567832,26,0,14.428571428571429,28,0,16,36.14285545806206,0.6287202380952381,46.19252873563217,1015.2298850574705,36.25821018062395,0
28,4,1,2,25,0.037037037037037035,0.07407407407407407,0.9259259259259259,27,700,400,300,0.5714285714285714,10,4,6,412.6685831995692,0.46640550807217473,0.04735328936242178,0.21973388324249996,127580.14289700249,5129.663362740917,132709.8062597434,27,0,15.925925925925926,27,0,21,37.01039058280551,0.619212962962963,47.43303571428571,1010.2678571428567,37.41732804232802,4
29,4,2,2,25,0.07407407407407407,0.07407407407407407,0.9259259259259259,27,950,600,350,0.631578947368421,13,6,7,409.4243213287702,0.4652184235517569,0.015872237211457696,0.21923075361930588,127805.7487643494,5065.356389951804,132871.10515430119,28,0,15.592592592592593,27,0,21,36.85997669855286,0.6215277777777777,47.20982142857142,1011.1607142857135,37.4503968253968,0
30,4,3,1,27,0.10714285714285714,0.03571428571428571,0.9642857142857143,28,800,500,300,0.625,11,5,6,400.3747722393407,0.4630456349206349,-0.000738635205901117,0.20932345474795072,126838.60824167672,4556.595777183267,131395.20401885998,29,0,15.928571428571429,28,0,21,38.08538962582609,0.6082589285714285,48.16810344827587,1007.3275862068978,35.97598522167492,7
31,4,3,3,27,0.1,0.1,0.9,30,750,600,150,0.8,9,6,3,382.9254758141214,0.4649185823754789,-0.017498739283913656,0.20337846125964032,127477.43296682101,3763.1242166971247,131240.55718351813,30,0,15.766666666666667,29,1,17,37.86718356026222,0.6117097701149425,47.53472222222222,1009.8611111111113,34.822796934865906,0
32,4,0,1,26,0.0,0.037037037037037035,0.962962962962963,27,750,400,350,0.5333333333333333,11,4,7,435.64512606469475,0.4601139601139601,0.020274584929757422,0.22108990147783242,125618.04602956856,5544.977899710393,131163.02392927895,31,1,17.962962962962962,26,1,17,38.464696223316906,0.6025641025641026,49.38271604938271,1002.4691358024683,38.556505223171854,4
33,4,5,5,26,0.16129032258064516,0.16129032258064516,0.8387096774193549,31,550,300,250,0.5454545454545454,8,3,5,387.0563658455835,0.4649641577060932,-0.014864474767015468,0.20110277661942255,126584.28945904132,3599.0510102323697,130183.3404692737,32,0,16.419354838709676,30,1,16,38.68316192511464,0.5996527777777779,48.42069892473117,1006.3172043010737,33.54390681003579,0
34,4,7,4,29,0.21212121212121213,0.12121212121212122,0.8787878787878788,33,500,300,200,0.6,7,3,4,421.24730095079144,0.47072285353535354,-0.003650967506389158,0.21852203736822287,126519.74288337912,4059.220041322299,130578.96292470142,33,0,15.515151515151516,32,1,16,37.88984061244981,0.59375,48.48484848484848,1006.060606060605,31.439393939393906,6
35,4,5,6,28,0.14705882352941177,0.17647058823529413,0.8235294117647058,34,950,800,150,0.8421052631578947,11,8,3,407.03920742666986,0.469864081996435,0.007489686040941468,0.21397517952071618,127061.12320081203,3543.771776480181,130604.8949772922,34,0,15.882352941176471,33,1,19,37.68777095741664,0.5969065656565657,47.94730392156862,1008.2107843137242,30.551841948900734,0
36,4,1,1,28,0.034482758620689655,0.034482758620689655,0.9655172413793104,29,750,400,350,0.5333333333333333,11,4,7,453.9744789696581,0.4669027093596059,0.02615525618156922,0.23463171372449523,126368.66866494901,5673.630103051906,132042.2987680009,35,0,17.862068965517242,28,1,19,37.223730589692295,0.6034226190476191,48.63505747126436,1005.4597701149415,35.909277504105056,0
37,4,0,1,27,0.0,0.03571428571428571,0.9642857142857143,28,900,700,200,0.7777777777777778,11,7,4,469.2642463093849,0.46577380952380953,0.03461440839290941,0.24193974958576986,126268.08080002833,6250.619153911558,132518.69995393988,36,2,19.5,27,1,19,36.944156549205395,0.6057098765432098,48.735119047619044,1005.0595238095236,37.22442680776013,0
38,4,4,4,27,0.12903225806451613,0.12903225806451613,0.8709677419354839,31,750,500,250,0.6666666666666666,10,5,5,420.3315443235753,0.46505376344086025,0.012793139113181029,0.222472638936593,127337.21305941361,4507.448940224243,131844.66199963784,37,0,18.193548387096776,29,2,15,37.06753703958534,0.6102729885057471,47.673611111111114,1009.3055555555558,34.8036398467433,0
39,4,6,4,29,0.18181818181818182,0.12121212121212122,0.8787878787878788,33,850,600,250,0.7058823529411765,11,6,5,397.11991384116357,0.4713541666666667,0.009525035397091042,0.21321524606993786,127913.92220391179,3559.433152940557,131473.35535685235,38,0,17.90909090909091,31,2,18,37.05981572059896,0.6105510752688171,47.10286458333334,1011.5885416666677,32.631888440860244,0
40,4,5,6,28,0.14705882352941177,0.17647058823529413,0.8235294117647058,34,850,700,150,0.8235294117647058,10,7,3,377.46774946722076,0.46737596553773025,0.0016952131281995353,0.20613177644256894,128592.36501696278,2907.894124324082,131500.25914128686,39,0,17.58823529411765,32,2,15,36.86174737540978,0.6149088541666665,46.433080808080824,1014.2676767676786,31.695864898989957,0
41,4,2,1,29,0.06666666666666667,0.03333333333333333,0.9666666666666667,30,1000,900,100,0.9,11,9,2,415.4886960341469,0.46479885057471265,0.053108146466080086,0.22416028730908105,128108.16529594395,4645.498910027741,132753.6642059717,40,0,20.5,28,2,21,36.395354338158775,0.6212797619047619,46.910919540229884,1012.3563218390802,36.155582922824294,0
42,4,2,2,29,0.06451612903225806,0.06451612903225806,0.935483870967742,31,1000,800,200,0.8,12,8,4,391.10319722819196,0.46241039426523295,0.024917752616962607,0.21428368208075826,128723.56088854201,3868.8392444213227,132592.40013296332,41,0,19.612903225806452,30,1,17,36.381622516556284,0.6215277777777778,46.303763440860216,1014.784946236559,33.826164874551964,0
43,4,0,1,28,0.0,0.034482758620689655,0.9655172413793104,29,1050,700,350,0.6666666666666666,14,7,7,416.444248666823,0.4599240558292283,0.04870109240206255,0.22652383765184564,128435.6446731735,4897.257109591763,133332.90178276526,42,1,21.93103448275862,28,1,17,36.03443184502717,0.624627976190476,46.58764367816092,1013.6494252873566,36.201765188834166,0
44,4,2,5,25,0.06666666666666667,0.16666666666666666,0.8333333333333334,30,850,700,150,0.8235294117647058,10,7,3,404.49224840155887,0.4602729885057471,0.022711926270644778,0.22153076213056885,128707.6485339506,4412.249228395059,133119.89776234567,43,0,21.433333333333334,29,1,17,36.05826261520211,0.6242816091954023,46.31944444444444,1014.7222222222222,34.990421455938694,0
45,4,4,3,26,0.13793103448275862,0.10344827586206896,0.896551724137931,29,700,500,200,0.7142857142857143,9,5,4,414.33514100928835,0.4595135467980296,0.01545694659395469,0.22703251365000826,128727.08839096985,4867.231264037534,133594.3196550074,44,0,22.20689655172414,28,1,18,35.7886167350984,0.6276041666666666,46.300287356321846,1014.7988505747135,36.242816091954055,0
46,4,2,2,26,0.07142857142857142,0.07142857142857142,0.9285714285714286,28,700,500,200,0.7142857142857143,9,5,4,420.8306993469791,0.4537588183421517,0.05478842570297937,0.23137210810994668,128861.2113139526,5245.750735189903,134106.96204914252,45,0,23.928571428571427,27,1,19,35.48613146709659,0.6323302469135803,46.16815476190476,1015.3273809523805,37.60471781305113,0
47,4,2,1,27,0.07142857142857142,0.03571428571428571,0.9642857142857143,28,1250,900,350,0.72,16,9,7,419.9430211644866,0.4525738536155203,0.04700899393432345,0.2324319963171346,129125.75511975611,5245.091943027196,134370.84706278332,46,0,24.428571428571427,27,1,20,35.23731088335776,0.635030864197531,45.90773809523809,1016.3690476190466,37.643298059964685,0
48,4,1,0,28,0.03571428571428571,0.0,1.0,28,1000,600,400,0.6,14,6,8,414.760268727689,0.4510582010582011,0.05533441985833365,0.23110969497075837,129390.5701929207,5133.213532808919,134523.78372572962,47,0,25.392857142857142,27,1,22,35.0977828969821,0.6377314814814816,45.64732142857141,1017.4107142857125,37.68187830687824,0
49,4,0,1,27,0.0,0.03571428571428571,0.9642857142857143,28,600,400,200,0.6666666666666666,8,4,4,415.5662111889738,0.45072751322751325,0.052529609592045334,0.23200467904664412,129466.28146701379,5160.362413194426,134626.64388020823,48,1,26.392857142857142,27,1,21,34.999786762197196,0.6385030864197532,45.57291666666666,1017.7083333333325,37.69290123456787,0
50,4,1,0,28,0.03571428571428571,0.0,1.0,28,1350,1200,150,0.8888888888888888,15,12,3,404.05632142006743,0.4477788800705467,0.02874957225386976,0.2284930448699776,129969.4090409895,4902.99226284845,134872.40130383795,49,0,25.857142857142858,28,0,22,34.77877976609834,0.6402529761904763,45.07902298850574,1019.6839080459765,36.41728243021345,0
51,4,1,1,28,0.034482758620689655,0.034482758620689655,0.9655172413793104,29,950,800,150,0.8421052631578947,11,8,3,404.99959418878325,0.44745484400656815,0.02908864977830472,0.22580114360936282,129413.2812500001,4682.465277777792,134095.7465277779,50,0,25.93103448275862,29,0,23,35.32282282282283,0.6314655172413792,45.62500000000001,1017.5000000000008,35.08620689655175,2
52,4,0,0,28,0.0,0.0,1.0,28,550,300,250,0.5454545454545454,8,3,5,416.79577494808746,0.4476135361552028,0.04112416479945047,0.23134617249471498,129237.90966854942,5173.162942594802,134411.07261114422,51,1,27.821428571428573,28,0,23,35.2023574019123,0.6328125,45.79741379310345,1016.8103448275868,36.314655172413815,0
53,4,1,1,28,0.034482758620689655,0.034482758620689655,0.9655172413793104,29,800,400,400,0.5,12,4,8,405.91076575666426,0.44750615763546797,0.035842125315735274,0.22732863435921363,129589.99083719142,4720.3944830247,134310.38532021613,52,0,27.82758620689655,29,0,20,35.118986723048245,0.6332614942528736,45.45138888888889,1018.1944444444449,35.110153256705,0
54,4,1,1,28,0.034482758620689655,0.034482758620689655,0.9655172413793104,29,350,100,250,0.2857142857142857,6,1,5,405.12052630310103,0.44612068965517243,0.03047576048309697,0.22709049685430704,129625.3472222222,4702.777777777775,134328.12499999997,53,0,28.79310344827586,29,0,20,35.102973267866886,0.6336206896551724,45.416666666666664,1018.3333333333331,35.114942528735625,0
55,4,2,1,29,0.06666666666666667,0.03333333333333333,0.9666666666666667,30,1100,700,400,0.6363636363636364,15,7,8,390.7609420550877,0.44803639846743293,0.03292083552747038,0.22283934803682026,130296.89125910502,4182.987195051436,134479.87845415645,54,0,28.766666666666666,30,0,22,34.7842065999649,0.6375000000000001,44.758064516129025,1020.9677419354832,34.03225806451611,0
56,4,0,0,29,0.0,0.0,1.0,29,1050,700,350,0.6666666666666666,14,7,7,402.30619080540407,0.4464285714285714,0.04955606029320703,0.22880386145805767,130191.70524691339,4675.385802469114,134867.09104938252,55,1,30.75862068965517,29,0,22,34.596715659589925,0.6393678160919541,44.8611111111111,1020.555555555554,35.191570881226,0
57,4,1,1,29,0.03333333333333333,0.03333333333333333,0.9666666666666667,30,750,400,350,0.5333333333333333,11,4,7,389.0497931802954,0.44734195402298854,0.03765732579046599,0.2228460797259551,130468.48127312402,4151.747131171228,134620.22840429525,56,0,30.7,30,0,22,34.653335087488486,0.6392361111111111,44.59005376344086,1021.6397849462363,34.054659498207876,0
58,4,0,0,29,0.0,0.0,1.0,29,650,500,150,0.7692307692307693,8,5,3,397.72224192831203,0.4464798850574712,0.06530004570060899,0.22035799308654935,129166.09037422853,4474.445408950634,133640.53578317916,57,3,32.758620689655174,29,0,23,35.760662886550975,0.6289511494252873,45.868055555555564,1016.5277777777789,35.0526819923372,2
59,4,0,1,28,0.0,0.034482758620689655,0.9655172413793104,29,600,500,100,0.8333333333333334,7,5,2,399.0765431659508,0.4455049261083744,0.06611196654847484,0.221901102931227,129307.31336805565,4520.703125000009,133828.01649305565,58,4,33.758620689655174,29,0,23,35.58181414720742,0.6303879310344827,45.72916666666667,1017.0833333333342,35.071839080459796,0
60,4,2,2,28,0.06666666666666667,0.06666666666666667,0.9333333333333333,30,1200,1000,200,0.8333333333333334,14,10,4,391.052718285481,0.44705459770114947,0.048375752780341896,0.2204723243686842,129851.28564357152,4155.73964475662,134007.02528832815,59,0,32.93333333333333,30,0,20,35.23066947997715,0.632986111111111,45.19489247311828,1019.2204301075269,33.97401433691756,0
61,4,1,1,28,0.034482758620689655,0.034482758620689655,0.9655172413793104,29,850,600,250,0.7058823529411765,11,6,5,405.52766179602787,0.4455049261083744,0.057533937502350474,0.22814040850733563,129766.82098765414,4724.8070987654055,134491.62808641954,60,0,35.03448275862069,29,0,20,34.94808705925117,0.635057471264368,45.277777777777764,1018.8888888888874,35.13409961685819,0
62,4,0,1,27,0.0,0.03571428571428571,0.9642857142857143,28,1150,1000,150,0.8695652173913043,13,10,3,422.17589286247147,0.4420745149911816,0.07625428168446513,0.237181226655699,129713.14944180199,5352.352936319181,135065.50237812116,61,7,37.285714285714285,28,0,20,34.578925716972265,0.6376488095238096,45.330459770114935,1018.6781609195394,36.38136288998355,0
63,4,2,2,27,0.06896551724137931,0.06896551724137931,0.9310344827586207,29,1050,600,450,0.5714285714285714,15,6,9,410.3072125655156,0.4430931855500821,0.06476076061044012,0.23335428776558892,130191.70524691355,4883.719135802462,135075.424382716,62,0,36.41379310344828,29,0,21,34.39257847940481,0.639367816091954,44.86111111111111,1020.5555555555553,35.19157088122604,0
64,4,3,1,29,0.1,0.03333333333333333,0.9666666666666667,30,700,300,400,0.42857142857142855,11,3,8,388.3747320449029,0.44425287356321835,0.05457172884918515,0.22464350002475672,130846.376748757,4163.485301768975,135009.86205052596,63,0,34.733333333333334,30,0,22,34.28659791557188,0.6430555555555557,44.22043010752687,1023.1182795698918,34.10394265232973,0
65,4,0,1,28,0.0,0.034482758620689655,0.9655172413793104,29,1150,900,250,0.782608695652174,14,9,5,402.3977804329777,0.4424774220032841,0.07214710148317982,0.2335174521095311,130972.4633487653,4740.6057098765295,135713.06905864182,64,1,36.93103448275862,29,0,23,33.79975124378109,0.6472701149425288,44.097222222222214,1023.6111111111102,35.296934865900354,0
66,4,1,1,28,0.034482758620689655,0.034482758620689655,0.9655172413793104,29,900,600,300,0.6666666666666666,12,6,6,391.95380668028963,0.4425800492610838,0.04150269674054252,0.22914700362022017,131256.95408950624,4489.332561728409,135746.28665123464,65,0,35.96551724137931,29,0,23,33.7783500496973,0.6501436781609196,43.81944444444445,1024.7222222222229,35.33524904214561,0
67,4,0,0,28,0.0,0.0,1.0,28,1000,700,300,0.7,13,7,6,399.28641252625977,0.44088955026455023,0.046635472817265544,0.2327483920604831,131144.10186699044,4872.811591689806,136016.91345868024,66,3,38.25,28,0,23,33.705054472343015,0.652157738095238,43.92959770114943,1024.281609195403,36.581486042692966,0
68,4,1,1,28,0.034482758620689655,0.034482758620689655,0.9655172413793104,29,900,600,300,0.6666666666666666,12,6,6,385.8440570810657,0.4408866995073892,0.02549436182382747,0.22704847502340014,131506.13667052472,4348.172260802478,135854.3089313272,67,0,37.89655172413793,29,0,23,33.68243624464004,0.6526580459770115,43.57638888888889,1025.6944444444448,35.368773946360164,0
69,4,0,0,28,0.0,0.0,1.0,28,800,400,400,0.5,12,4,8,398.5555197425324,0.4380787037037037,0.04482920777219701,0.2345661875879586,131512.27715434667,4882.98879475492,136395.2659491016,68,5,40.25,28,0,23,33.35025913993557,0.655877976190476,43.570402298850574,1025.7183908045977,36.63279967159277,0
70,4,3,2,29,0.0967741935483871,0.06451612903225806,0.935483870967742,31,750,700,50,0.9333333333333333,8,7,1,368.1380698965595,0.43987455197132613,0.02194348409954583,0.22158379028122682,132364.5040724012,3545.682610405811,135910.18668280702,69,0,37.25806451612903,31,0,22,33.27019802606603,0.6555779569892474,42.740885416666664,1029.036458333333,33.194724462365585,0
71,4,0,0,29,0.0,0.0,1.0,29,1000,600,400,0.6,14,6,8,387.3439905331646,0.437192118226601,0.04696476245055359,0.2313747275170262,132076.584201389,4431.814236111119,136508.39843750012,70,1,40.827586206896555,29,0,23,33.066899743277915,0.6584051724137931,43.020833333333336,1027.9166666666674,35.4454022988506,0
72,4,0,0,29,0.0,0.0,1.0,29,750,400,350,0.5333333333333333,11,4,7,389.89021871000716,0.4364224137931034,0.04274837598081449,0.23377628093502867,132219.38898533958,4510.20929783952,136729.5982831791,71,2,41.827586206896555,29,0,23,32.857162952959705,0.6598419540229885,42.88194444444445,1028.4722222222229,35.4645593869732,0
73,4,0,0,29,0.0,0.0,1.0,29,1100,800,300,0.7272727272727273,14,8,6,392.2372109033093,0.4351395730706076,0.046907720228954286,0.23629900266614026,132398.00347222245,4586.284722222257,136984.2881944447,72,3,42.827586206896555,29,0,23,32.61639676113361,0.6616379310344827,42.70833333333335,1029.1666666666686,35.4885057471265,0
74,4,0,0,29,0.0,0.0,1.0,29,1150,1000,150,0.8695652173913043,13,10,3,393.38301563348557,0.4350369458128079,0.04102211101085551,0.2378908383284391,132540.98186728402,4627.874228395076,137168.8560956791,73,4,43.827586206896555,29,0,24,32.44256361837965,0.663074712643678,42.56944444444445,1029.7222222222229,35.507662835249064,0
75,4,0,0,29,0.0,0.0,1.0,29,1200,900,300,0.75,15,9,6,396.41267363133096,0.43457512315270935,0.04295816228329152,0.2404082420542587,132648.2663001544,4716.690779321005,137364.95707947543,74,5,44.827586206896555,29,0,18,32.25627499887648,0.6641522988505746,42.465277777777786,1030.1388888888896,35.52203065134102,0
76,4,1,1,29,0.03333333333333333,0.03333333333333333,0.9666666666666667,30,350,100,250,0.2857142857142857,6,1,5,386.04257431296526,0.4353448275862069,0.030717079530638625,0.23536935969637876,132847.9538819518,4256.993221759761,137104.94710371157,75,0,44.3,30,0,18,32.322088222511965,0.6631944444444444,42.271505376344095,1030.9139784946246,34.36379928315416,0
77,4,0,0,29,0.0,0.0,1.0,29,1200,1000,200,0.8333333333333334,14,10,4,400.31676607987447,0.43370279146141216,0.03820057626173412,0.2434713446157926,132755.59413580253,4828.858024691365,137584.4521604939,76,7,46.827586206896555,29,0,18,32.04739442946991,0.6652298850574712,42.361111111111114,1030.5555555555559,35.53639846743296,0
78,4,0,0,29,0.0,0.0,1.0,29,950,700,250,0.7368421052631579,12,7,5,397.8777675747374,0.43313834154351394,0.03371647509578546,0.24314752462900613,132934.5703125,4778.34201388889,137712.91232638888,77,8,47.827586206896555,29,0,19,31.9297138047138,0.6670258620689655,42.1875,1031.25,35.560344827586206,0
79,4,0,1,28,0.0,0.034482758620689655,0.9655172413793104,29,1000,700,300,0.7,13,7,6,399.8710724734511,0.4325225779967159,0.02646092139713674,0.2450694988723429,133042.01388888893,4839.930555555561,137881.9444444445,78,9,48.827586206896555,29,0,20,31.76999192245559,0.6681034482758621,42.083333333333336,1031.666666666667,35.57471264367817,0
80,4,0,2,26,0.0,0.07142857142857142,0.9285714285714286,28,950,700,250,0.7368421052631579,12,7,5,427.5299923930494,0.43259479717813054,0.008139208532135678,0.24849744908587854,131033.74991742641,5604.171621086018,136637.92153851243,79,10,48.785714285714285,28,0,19,33.09418561137619,0.6510416666666666,44.037356321839084,1023.8505747126442,36.56609195402301,6
81,4,1,0,27,0.037037037037037035,0.0,1.0,27,800,500,300,0.625,11,5,6,465.3164478009287,0.4347103513770181,0.023437584928633015,0.253653302025242,128521.48216057246,6560.6319090135885,135082.11406958604,80,0,50.592592592592595,27,0,17,34.707342725760675,0.628858024691358,46.50297619047618,1013.9880952380944,37.55511463844794,7
82,4,0,0,27,0.0,0.0,1.0,27,1000,700,300,0.7,13,7,6,468.36836991546915,0.4344729344729345,0.062164039131409776,0.24572106657145415,126979.50159881661,6494.6364353032895,133474.1380341199,81,1,51.592592592592595,27,0,19,36.226715143461796,0.6130401234567902,48.02827380952381,1007.8869047619047,37.329144620811284,8
83,4,2,3,26,0.06896551724137931,0.10344827586206896,0.896551724137931,29,1200,900,300,0.75,15,9,6,439.11349733939954,0.44006568144499175,0.04054776251856973,0.23413837958968906,127635.87753088263,5409.377138331186,133045.2546692138,82,0,48.96551724137931,28,1,18,36.28489501872125,0.6164434523809523,47.377873563218394,1010.4885057471271,36.08887520525454,0
84,4,2,1,27,0.07142857142857142,0.03571428571428571,0.9642857142857143,28,1250,1100,150,0.88,14,11,3,447.6762394015433,0.4401179453262787,0.026479373961335595,0.2388192727239497,127655.32270851042,5829.650961947273,133484.9736704577,83,0,48.714285714285715,27,1,19,36.0484771511314,0.6199845679012346,47.35863095238095,1010.5654761904757,37.42835097001762,0
85,4,1,1,27,0.03571428571428571,0.03571428571428571,0.9642857142857143,28,600,400,200,0.6666666666666666,8,4,4,448.4782722871698,0.44259810405643735,0.026653001156312417,0.24014262097646308,127805.74876434941,5863.620278840692,133669.3690431901,84,0,49.67857142857143,27,1,19,35.8727311748835,0.6215277777777778,47.20982142857142,1011.1607142857137,37.4503968253968,0
86,4,0,1,26,0.0,0.037037037037037035,0.962962962962963,27,850,700,150,0.8235294117647058,10,7,3,462.2337812551871,0.43625356125356124,0.03902207292037829,0.2467130426601646,127676.20991941013,6403.2514574759925,134079.46137688612,85,2,52.51851851851852,26,1,20,35.659070087036184,0.6237980769230769,47.33796296296296,1010.648148148148,38.871082621082614,0
87,4,3,1,28,0.10344827586206896,0.034482758620689655,0.9655172413793104,29,900,600,300,0.6666666666666666,12,6,6,427.8514713077888,0.4410919540229885,0.03015660181647961,0.23345138326361756,128559.20770000722,5201.706571742652,133760.91427174988,86,0,48.724137931034484,27,2,21,35.618274639276095,0.6292438271604937,46.46577380952382,1014.1369047619058,37.56062610229281,0
88,4,4,1,31,0.125,0.03125,0.96875,32,1000,700,300,0.7,13,7,6,393.5802265750184,0.4446614583333333,0.041571857274765645,0.22150940591427007,129782.79867976082,3815.988661984064,133598.78734174487,87,0,45.03125,30,2,19,35.236116607307736,0.6322916666666665,45.26209677419356,1018.9516129032271,33.965053763440906,0
89,4,0,0,31,0.0,0.0,1.0,31,850,700,150,0.8235294117647058,10,7,3,407.1660040020618,0.4420250896057348,0.05391290586342423,0.2294765082463235,129837.58680555568,4373.090277777796,134210.6770833335,88,1,47.483870967741936,29,2,19,34.83408285636413,0.6357758620689654,45.20833333333334,1019.1666666666677,35.14367816091958,0
90,4,1,2,30,0.03125,0.0625,0.9375,32,700,300,400,0.42857142857142855,11,3,8,398.90106330566465,0.4419102822580645,0.04725770345009206,0.2270805603255786,130228.28686842424,3989.6404208579224,134217.92728928218,89,0,46.96875,30,2,20,34.64632165744886,0.6368055555555554,44.82526881720431,1020.698924731184,34.023297491039465,0
91,4,0,0,30,0.0,0.0,1.0,30,400,100,300,0.25,7,1,6,420.04945629629077,0.4400383141762452,0.06292641669016064,0.2368704962611992,129859.55253335972,4909.486887303469,134769.03942066318,90,1,50.9,28,2,20,34.48336622497884,0.6391369047619049,45.1867816091954,1019.2528735632181,36.401888341543504,0
92,4,2,3,29,0.0625,0.09375,0.90625,32,550,400,150,0.7272727272727273,7,4,3,397.92005061415307,0.44050319220430106,0.04625883872722336,0.22755085942585374,130404.4077932098,3978.7301731477673,134383.13796635758,91,0,48.65625,29,3,20,34.491999818692776,0.6415229885057472,44.65277777777777,1021.3888888888882,35.22030651340994,0
93,4,3,2,30,0.09375,0.0625,0.9375,32,950,800,150,0.8421052631578947,11,8,3,399.22329438781355,0.44144825268817206,0.042129535262943385,0.22934303071037607,130581.79253472218,4026.2586805555497,134608.05121527772,92,0,49.3125,29,3,20,34.2781797798614,0.6433189655172413,44.479166666666664,1022.0833333333329,35.244252873563205,0
94,4,1,1,30,0.03225806451612903,0.03225806451612903,0.967741935483871,31,650,300,350,0.46153846153846156,10,3,7,406.83751318244003,0.44027777777777777,0.05579969433522458,0.23356216555824827,130556.09486474434,4423.023393116662,134979.118257861,93,0,51.87096774193548,28,3,20,34.10978724401331,0.6462053571428572,44.50431034482759,1021.9827586206897,36.4993842364532,0
95,4,1,2,29,0.03225806451612903,0.06451612903225806,0.935483870967742,31,1500,1300,200,0.8666666666666667,17,13,4,399.6220661813654,0.4383512544802867,0.05330279938405669,0.22831554410501773,130368.9453124999,4219.661458333319,134588.60677083323,94,0,52.83870967741935,29,2,23,34.48464912280702,0.6411637931034484,44.68749999999999,1021.2499999999992,35.21551724137928,1
96,4,0,0,29,0.0,0.0,1.0,29,900,600,300,0.6666666666666666,12,6,6,404.515992901662,0.4358066502463054,0.028357531760435206,0.21959439614661638,128355.55555555546,4584.374999999983,132939.93055555545,95,3,55.758620689655174,29,0,22,36.418928179824555,0.6206896551724139,46.66666666666666,1013.3333333333326,34.94252873563216,8
97,4,3,1,31,0.09375,0.03125,0.96875,32,1050,800,250,0.7619047619047619,13,8,5,370.9052125879835,0.44182627688172044,0.011760752688171783,0.20637546443998056,129333.80126953128,3196.8939887152783,132530.69525824656,96,0,51.4375,31,1,21,36.2711213517665,0.625,45.703125,1017.1875000000002,32.81250000000001,0
98,4,0,0,31,0.0,0.0,1.0,31,750,400,350,0.5333333333333333,11,4,7,381.7226251098107,0.4360215053763441,0.022139308786218725,0.21186585905764616,129235.55333347771,3666.4269351948037,132901.98026867252,97,1,54.096774193548384,30,1,22,36.09633179114343,0.6267361111111112,45.79973118279569,1016.801075268816,33.8933691756272,0
99,4,1,1,31,0.03125,0.03125,0.96875,32,900,600,300,0.6666666666666666,12,6,6,376.0846313229521,0.4353578629032258,0.013552256384825156,0.21095261726362508,129651.06398581761,3351.9545199469244,133003.01850576454,98,0,53.375,32,0,15,35.81597652698568,0.6256510416666667,45.39141414141413,1018.4343434343422,31.826073232323193,0
100,4,1,1,31,0.03125,0.03125,0.96875,32,1200,900,300,0.75,15,9,6,375.9379589896329,0.437478998655914,0.01776034568207141,0.2117372831127234,129811.85154894905,3360.240504795422,133172.09205374448,99,0,54.34375,32,0,17,35.65594928344278,0.6272786458333334,45.233585858585855,1019.0656565656562,31.845801767676758,0
101,4,2,3,30,0.06060606060606061,0.09090909090909091,0.9090909090909091,33,800,600,200,0.75,10,6,4,371.893253257967,0.43742108585858586,0.02480193421997634,0.20741091543293805,129426.12879106712,3027.3219888276553,132453.45077989477,100,0,53.54545454545455,32,1,14,36.151869545435744,0.6233723958333335,45.61237373737373,1017.5505050505042,31.798453282828255,3
102,4,3,0,33,0.09090909090909091,0.0,1.0,33,900,700,200,0.7777777777777778,11,7,4,370.520450173641,0.44022253787878785,0.04976503600527371,0.20800198131877257,129683.21352731864,3010.0565312213043,132693.27005853996,101,0,54.42424242424242,32,1,17,35.92491012768067,0.6259765625,45.359848484848484,1018.5606060606061,31.83001893939394,0
103,4,1,0,34,0.029411764705882353,0.0,1.0,34,1000,800,200,0.8,12,8,4,358.26488985366177,0.4422162804515746,0.04056575766571968,0.20282179682735868,130012.50270328711,2515.782992118406,132528.28569540553,102,0,53.794117647058826,33,1,18,35.90232716494432,0.6268939393939394,45.03676470588235,1019.8529411764699,30.90463458110515,0
104,4,1,0,35,0.02857142857142857,0.0,1.0,35,550,400,150,0.7272727272727273,7,4,3,349.65714161518366,0.44345238095238093,0.044322344322344165,0.2000038850038849,130414.54081632648,2120.075113378678,132534.61592970515,103,0,53.22857142857143,34,1,20,35.71411227661227,0.6286764705882353,44.64285714285714,1021.428571428571,30.042016806722675,0
105,4,2,3,34,0.05405405405405406,0.08108108108108109,0.9189189189189189,37,900,700,200,0.7777777777777778,11,7,4,332.5637613816071,0.44625875875875876,0.036591351946333006,0.19231965449725658,130838.01442912515,1302.3964420501713,132140.41087117532,104,0,51.2972972972973,36,1,14,35.72257383966246,0.6287615740740741,44.22860360360361,1023.0855855855862,28.41904404404406,0
106,4,0,0,34,0.0,0.0,1.0,34,1000,600,400,0.6,14,6,8,345.68207262260876,0.44357174688057044,0.0356044362545298,0.19881928718086686,130627.42524092972,2231.111819727894,132858.5370606576,105,1,54.205882352941174,34,0,14,35.600083459493035,0.6308210784313726,44.43452380952381,1022.2619047619048,30.06652661064426,0
107,4,0,1,33,0.0,0.029411764705882353,0.9705882352941176,34,1000,700,300,0.7,13,7,6,347.82882305729817,0.4441844919786096,0.013864131511190259,0.1959718490883801,129825.09731833899,2243.3010949477657,132068.39841328675,106,2,55.205882352941174,33,1,15,36.358625941959275,0.625,45.22058823529411,1019.1176470588226,30.882352941176443,5
108,4,0,0,33,0.0,0.0,1.0,33,900,500,400,0.5555555555555556,13,5,8,355.11947043296817,0.4431818181818182,0.030663512447899333,0.1998475680888461,129779.68606519741,2617.458677685951,132397.14474288336,107,4,57.81818181818182,32,1,16,36.21902106567536,0.626953125,45.265151515151516,1018.9393939393938,31.841856060606055,0
109,4,0,0,33,0.0,0.0,1.0,33,1200,800,400,0.6666666666666666,16,8,8,355.6882908344302,0.4426688762626263,0.020359672533585726,0.2006618848292352,129876.19447314051,2639.088326446283,132515.2827995868,108,5,58.81818181818182,32,1,16,36.106465997770336,0.6279296875,45.17045454545455,1019.318181818182,31.853693181818187,0
110,4,0,1,32,0.0,0.030303030303030304,0.9696969696969697,33,950,700,250,0.7368421052631579,12,7,5,348.5058279324875,0.4423137626262626,0.02896634791932895,0.18674481117525216,127834.51677239509,2310.21482122259,130144.73159361767,109,6,59.81818181818182,33,0,19,38.37049604136372,0.6047979797979799,47.1813725490196,1011.2745098039204,30.644682115270314,8
111,4,3,2,33,0.08571428571428572,0.05714285714285714,0.9428571428571428,35,1200,900,300,0.75,15,9,6,333.9278170117145,0.4448879551820728,0.037803903663965466,0.18204988206842762,128525.6736137902,1583.6595239626122,130109.33313775282,110,0,56.68571428571428,35,0,19,38.03373378229274,0.6074404761904761,46.49884259259259,1014.0046296296289,28.971560846560823,0
112,4,1,1,33,0.029411764705882353,0.029411764705882353,0.9705882352941176,34,850,500,350,0.5882352941176471,12,5,7,342.8377964939799,0.4440173796791444,0.04097341648882136,0.1868169873793491,128506.39349489793,2011.3697562358216,130517.76325113376,111,0,59.3235294117647,34,0,21,37.827531212085624,0.609375,46.51785714285714,1013.9285714285712,29.821428571428566,0
113,4,2,1,34,0.05714285714285714,0.02857142857142857,0.9714285714285714,35,1050,900,150,0.8571428571428571,12,9,3,338.9049514933521,0.44432773109243695,0.04781327821090908,0.1869622098841704,128995.54887099197,1743.4460465963748,130738.99491758835,112,0,58.57142857142857,35,0,23,37.42890984011244,0.6122023809523809,46.03587962962963,1015.8564814814818,29.024470899470906,0
114,4,1,1,34,0.02857142857142857,0.02857142857142857,0.9714285714285714,35,1000,700,300,0.7,13,7,6,338.44829439729585,0.4445378151260504,0.05597826970934139,0.1875451968259591,129171.97312510728,1743.6067976251888,130915.57992273248,113,0,59.22857142857143,35,0,24,37.261020342327974,0.6139880952380952,45.862268518518526,1016.5509259259269,29.044312169312196,0
115,4,0,0,34,0.0,0.0,1.0,34,1150,800,350,0.6956521739130435,15,8,7,349.70884958060464,0.44149212715389186,0.0649939019768615,0.1934844101665345,129110.63102324288,2230.226048752858,131340.85707199574,114,1,61.61764705882353,34,0,24,37.03730818788801,0.6155024509803921,45.92261904761906,1016.3095238095259,29.891456582633115,0
116,4,1,1,34,0.02857142857142857,0.02857142857142857,0.9714285714285714,35,1000,600,400,0.6,14,6,8,342.45710491677227,0.4436624649859944,0.06342272062408583,0.19076032650306907,129377.95380015447,1861.2798996913723,131239.23369984585,115,0,60.82857142857143,35,0,24,36.94965870307166,0.6160714285714286,45.65972222222223,1017.3611111111123,29.067460317460352,0
117,4,1,0,35,0.02857142857142857,0.0,1.0,35,900,700,200,0.7777777777777778,11,7,4,343.2603310322749,0.44131652661064424,0.069927889300331,0.19206856690584548,129554.63927469144,1894.1936728395142,131448.83294753096,116,0,61.8,35,0,19,36.749658935879935,0.6178571428571428,45.486111111111114,1018.0555555555562,29.087301587301607,0
118,4,0,1,34,0.0,0.02857142857142857,0.9714285714285714,35,550,200,350,0.36363636363636365,9,2,7,342.6950037367094,0.44124649859943976,0.07645024596950978,0.19218440649326354,129643.02722318674,1885.603539737659,131528.6307629244,117,1,62.8,35,0,20,36.674266962154796,0.6187499999999999,45.39930555555556,1018.4027777777778,29.097222222222225,0
119,4,1,0,35,0.02857142857142857,0.0,1.0,35,750,500,250,0.6666666666666666,10,5,5,334.5745851857335,0.44061624649859943,0.07494527943966078,0.1893344039866089,129996.88042534735,1698.7304687500064,131695.61089409736,118,0,62.22857142857143,35,0,21,36.52217398706161,0.6223214285714285,45.052083333333336,1019.7916666666677,29.13690476190479,0
120,4,0,1,34,0.0,0.02857142857142857,0.9714285714285714,35,750,400,350,0.5333333333333333,11,4,7,334.1842136369073,0.43970588235294117,0.06346181888883473,0.1899743527812128,130173.98787133487,1700.4183545524681,131874.40622588733,119,1,63.22857142857143,35,0,23,36.35271350799592,0.6241071428571429,44.87847222222222,1020.4861111111111,29.15674603174603,0
121,4,0,1,33,0.0,0.029411764705882353,0.9705882352941176,34,1000,600,400,0.6,14,6,8,345.6001174810813,0.43685011883541297,0.07098149025098333,0.19629811841818057,130141.08737244883,2195.355017006786,132336.44238945562,120,2,65.88235294117646,34,0,23,36.094825574612074,0.6259191176470589,44.91071428571428,1020.3571428571416,30.010504201680636,0
122,4,1,3,31,0.029411764705882353,0.08823529411764706,0.9117647058823529,34,700,400,300,0.5714285714285714,10,4,6,338.2981897870388,0.438595513963161,0.06611561747907024,0.19335510794024016,130384.14292800445,2021.7439058956834,132405.88683390015,121,0,64.52941176470588,34,0,23,36.03493996969345,0.6283700980392157,44.672619047619044,1021.3095238095232,30.038515406162446,0
123,4,0,0,31,0.0,0.0,1.0,31,600,400,200,0.6666666666666666,8,4,4,361.21236970616087,0.43620071684587813,0.07091748674622411,0.20423495069811873,129963.68620130743,3188.898213704421,133152.58441501184,122,4,67.03225806451613,31,0,23,35.8767771251011,0.6313844086021505,45.084635416666664,1019.6614583333327,32.89230510752686,0
124,4,0,0,31,0.0,0.0,1.0,31,850,500,350,0.5882352941176471,12,5,7,363.53162517872704,0.43606630824372755,0.009215414426237745,0.20730556167464748,130295.81917656815,3273.330179850293,133569.14935641843,123,5,68.03225806451613,31,0,21,35.48030119457554,0.6347446236559138,44.75911458333335,1020.9635416666684,32.934307795698984,3
125,4,0,0,31,0.0,0.0,1.0,31,850,700,150,0.8235294117647058,10,7,3,389.245394679823,0.43615591397849457,-0.056355496025102036,0.21495271158433543,129035.96878051758,3845.331319173177,132881.30009969076,124,6,69.03225806451613,31,0,21,36.10910867615019,0.6219758064516129,45.99609375,1016.015625,32.77469758064516,6
126,4,0,2,29,0.0,0.06451612903225806,0.935483870967742,31,1050,700,350,0.6666666666666666,14,7,7,388.1435508239937,0.4358870967741935,-0.05290917808898632,0.21452353191433757,129069.04432508675,3819.4634331597176,132888.50775824647,125,7,70.03225806451613,31,0,21,36.103280369041514,0.6223118279569892,45.963541666666664,1016.1458333333329,32.77889784946235,0
127,4,0,0,29,0.0,0.0,1.0,29,700,300,400,0.42857142857142855,11,3,8,384.0077292876928,0.4346264367816092,0.003112928558289818,0.2112475928383991,128883.87586805568,4098.4809027777965,132982.3567708335,126,8,74.10344827586206,29,0,20,36.39763712214473,0.6260775862068965,46.14583333333334,1015.4166666666677,35.01436781609199,6
128,4,2,2,29,0.06451612903225806,0.06451612903225806,0.935483870967742,31,950,600,350,0.631578947368421,13,6,7,361.93320504681003,0.4381272401433692,-0.008981899985552655,0.20189207690512617,129433.15505981431,3169.231330023857,132602.38638983815,127,0,70.25806451612904,31,0,16,36.39808594583068,0.6260080645161291,45.60546874999999,1017.5781249999989,32.82510080645157,0
129,4,4,3,30,0.12121212121212122,0.09090909090909091,0.9090909090909091,33,700,500,200,0.7142857142857143,9,5,4,344.91147325900334,0.44333964646464646,-0.019065929664344283,0.19526212792254574,130012.50270328706,2368.5607698961694,132381.06347318323,128,0,66.87878787878788,33,0,17,36.242790194664735,0.6268939393939394,45.03676470588234,1019.8529411764695,30.904634581105135,0
130,4,2,2,30,0.0625,0.0625,0.9375,32,800,600,200,0.75,10,6,4,356.6908481842321,0.44071320564516125,-0.01009150873281306,0.20122747850393446,129876.19447314029,2865.129993112921,132741.32446625322,129,0,69.90625,32,0,17,36.08091787439612,0.6279296875000002,45.17045454545453,1019.3181818181802,31.85369318181813,0
131,4,0,0,30,0.0,0.0,1.0,30,550,400,150,0.7272727272727273,7,4,3,375.7443116797498,0.43402777777777773,0.007228014605604294,0.2107338748776807,129645.87894915603,3742.7403095733653,133388.6192587294,130,2,75.56666666666666,30,0,17,35.829923892481624,0.6309027777777778,45.39650537634409,1018.4139784946242,33.94713261648747,0
132,4,1,1,30,0.03225806451612903,0.03225806451612903,0.967741935483871,31,1050,900,150,0.8571428571428571,12,9,3,365.5538602224969,0.4347670250896057,0.005799943153966147,0.20668969526370945,129963.6862013076,3301.745435926659,133265.43163723426,131,0,74.09677419354838,31,0,18,35.76610586132038,0.6313844086021505,45.08463541666667,1019.6614583333342,32.89230510752691,0
133,4,2,0,32,0.0625,0.0,1.0,32,900,600,300,0.6666666666666666,12,6,6,355.2840846627178,0.43712197580645157,0.00790718525847156,0.20259711626112398,130294.81207274778,2858.3346087134128,133153.1466814612,132,0,72.15625,32,0,20,35.69183362189793,0.6321614583333333,44.76010101010102,1020.9595959595968,31.9049873737374,0
134,4,0,1,31,0.0,0.03125,0.96875,32,1300,1000,300,0.7692307692307693,16,10,6,355.65722319866273,0.43691196236559143,0.013253830944142342,0.20382282224671242,130488.24737271712,2881.8175441281555,133370.06491684527,133,1,73.15625,32,0,16,35.48617976602406,0.6341145833333334,44.57070707070707,1021.717171717172,31.928661616161627,0
135,4,0,0,31,0.0,0.0,1.0,31,1250,900,350,0.72,16,9,7,362.15879608134173,0.4349910394265233,0.01315816525833191,0.20723090847980494,130428.79104614259,3247.1867879231772,133675.97783406576,134,2,76.03225806451613,31,0,20,35.380417463352444,0.6360887096774194,44.62890625,1021.4843750000001,32.951108870967744,0
136,4,1,1,31,0.03125,0.03125,0.96875,32,550,400,150,0.7272727272727273,7,4,3,351.5292052371847,0.4371849798387097,0.0014009818451281575,0.20229793708638846,130649.55305899907,2785.426710284668,133434.97976928373,135,0,74.625,32,0,16,35.4282450290231,0.6357421875,44.41287878787879,1022.3484848484848,31.94839015151515,0
137,4,0,2,29,0.0,0.06451612903225806,0.935483870967742,31,700,400,300,0.5714285714285714,10,4,6,386.38771334362286,0.43512544802867387,0.02981250727844409,0.2052618564858316,127486.19927300356,3651.8202039930643,131138.01947699662,136,4,78.03225806451613,31,0,19,37.770758122743686,0.6061827956989246,47.52604166666667,1009.895833333334,32.57728494623658,8
138,4,3,1,31,0.09375,0.03125,0.96875,32,1150,900,250,0.782608695652174,14,9,5,369.66928228276277,0.4359038978494623,0.057577268195413644,0.20042069736735743,128304.38220589745,3086.037776757484,131390.41998265494,137,0,76.25,32,0,22,37.35408358258559,0.6119791666666666,46.71717171717172,1013.1313131313138,31.660353535353558,0
139,4,1,1,31,0.03125,0.03125,0.96875,32,850,700,150,0.8235294117647058,10,7,3,365.50418098522226,0.43468581989247307,0.06804812001991989,0.19943815092889308,128560.3509845934,2997.869158759306,131558.22014335272,138,0,77.21875,32,0,19,37.197823290172636,0.6145833333333334,46.464646464646464,1014.1414141414141,31.69191919191919,0
140,4,1,0,32,0.03125,0.0,1.0,32,1200,1000,200,0.8333333333333334,14,10,4,367.3907312563845,0.43350974462365593,0.07905052264808354,0.20111389076132885,128688.43102744622,3055.787355882057,131744.21838332826,139,0,78.15625,32,0,20,37.0190911730546,0.6158854166666666,46.33838383838384,1014.6464646464649,31.707702020202028,0
141,4,1,1,32,0.030303030303030304,0.030303030303030304,0.9696969696969697,33,1500,1200,300,0.8,18,12,6,357.1906714162463,0.4339883207070707,0.06461917449735566,0.19729965734257818,129045.69644187328,2618.7837910899616,131664.48023296325,140,0,76.75757575757575,33,0,20,36.91339504683795,0.6171085858585859,45.986519607843135,1016.0539215686272,30.789512774806884,0
142,4,0,0,32,0.0,0.0,1.0,32,1100,900,200,0.8181818181818182,13,9,4,366.1933144945762,0.43338373655913975,0.0705281646356628,0.20143137039434908,128880.67065860632,3039.04799255179,131919.71865115812,141,2,80.15625,32,0,21,36.85313562132141,0.6178385416666666,46.1489898989899,1015.4040404040409,31.731376262626277,0
143,4,0,0,32,0.0,0.0,1.0,32,950,700,250,0.7368421052631579,12,7,5,401.4318255755944,0.43353074596774194,0.08254621561060649,0.21921834499311693,128592.36501696258,3924.2135687684968,132516.57858573107,142,3,81.15625,32,0,17,36.254097680401664,0.6149088541666666,46.43308080808081,1014.2676767676769,31.695864898989903,7
144,4,0,0,32,0.0,0.0,1.0,32,800,500,300,0.625,11,5,6,403.32803359211664,0.43287970430107525,0.08236657128638947,0.22114261487131226,128752.4949622489,3985.8981226405617,132738.39308488945,143,4,82.15625,32,0,18,36.041822177987875,0.6165364583333333,46.27525252525253,1014.8989898989911,31.71559343434347,0
145,4,5,3,34,0.13513513513513514,0.08108108108108109,0.9189189189189189,37,1050,600,450,0.5714285714285714,15,6,9,362.787371021306,0.440940940940941,0.07121346995208278,0.20462354879344002,129867.92091836725,2033.2547705721302,131901.17568893937,144,0,71.91891891891892,34,3,17,35.93397181343924,0.6231617647058825,45.17857142857142,1019.2857142857134,29.97899159663863,5
146,4,0,0,34,0.0,0.0,1.0,34,750,300,450,0.4,12,3,9,382.69911397571815,0.43441770647653,0.1087309827998737,0.21401585644221494,129532.5469970703,3114.398193359374,132646.94519042966,145,1,79.11764705882354,31,3,17,35.76841903300076,0.627016129032258,45.5078125,1017.9687499999999,32.837701612903224,0
147,4,0,2,32,0.0,0.058823529411764705,0.9411764705882353,34,1250,800,450,0.64,17,8,9,390.5047851379246,0.43436200237670824,0.09234488315874279,0.21273768145573507,128496.33487654322,3235.6867283950633,131732.0216049383,146,2,80.11764705882354,32,2,17,36.62956621004565,0.6139322916666666,46.52777777777778,1013.8888888888889,31.68402777777778,6
148,4,2,1,33,0.058823529411764705,0.029411764705882353,0.9705882352941176,34,950,500,450,0.5263157894736842,14,5,9,378.6536995125259,0.4380756090314914,0.07508375148119462,0.20828543443773803,128880.67065860609,2960.2285481073163,131840.8992067134,147,0,76.76470588235294,32,2,19,36.536827489015984,0.6178385416666667,46.14898989898989,1015.404040404039,31.73137626262622,0
149,4,1,1,33,0.029411764705882353,0.029411764705882353,0.9705882352941176,34,950,500,450,0.5263157894736842,14,5,9,394.4768074453941,0.43894830659536543,0.10302773582820746,0.2073665113529606,127060.18717796655,3231.828703703708,130292.01588167026,148,0,77.73529411764706,32,2,21,38.00537466082238,0.5992838541666666,47.948232323232325,1008.2070707070709,31.506470959595966,5
150,4,1,0,34,0.029411764705882353,0.0,1.0,34,950,800,150,0.8421052631578947,11,8,3,394.7055474009967,0.43915255496137845,0.11692636817430069,0.20933972739721823,127420.45932345926,3258.7164150331882,130679.17573849246,149,0,78.41176470588235,31,3,18,37.628428338062065,0.605510752688172,47.591145833333336,1009.6354166666672,32.568884408602166,0
151,4,5,6,33,0.1282051282051282,0.15384615384615385,0.8461538461538461,39,1150,900,250,0.782608695652174,14,9,5,348.79730992991233,0.4475089968511021,0.08583994272378193,0.18996709315669277,128485.98082768646,1169.2672735358715,129655.24810122233,150,0,69.23076923076923,33,6,16,37.69730347717474,0.6114267676767677,46.53799019607843,1013.8480392156862,30.722667855020795,0
152,4,1,0,34,0.029411764705882353,0.0,1.0,34,800,500,300,0.625,11,5,6,386.31115956985303,0.4398581402257873,0.13918337674925785,0.20724206405653453,127880.99500868063,3080.3710937500095,130961.36610243065,151,0,80.0,31,3,20,37.36697562650188,0.6102150537634408,47.13541666666667,1011.458333333334,32.62768817204304,0
153,4,0,1,33,0.0,0.029411764705882353,0.9705882352941176,34,800,700,100,0.875,9,7,2,386.808959019161,0.43991384432560904,0.1348414542757015,0.20802023671542544,127979.78931003138,3100.7458157009487,131080.53512573233,152,1,81.0,31,3,20,37.25295436022823,0.61122311827957,47.037760416666664,1011.8489583333326,32.6402889784946,0
154,4,0,0,33,0.0,0.0,1.0,33,900,700,200,0.7777777777777778,11,7,4,398.87012284632624,0.44038036616161613,0.1405496828752646,0.2139342604717466,127872.49835602377,3600.903825586768,131473.40218161055,153,2,80.87878787878788,30,3,20,37.058139534883736,0.6128472222222222,47.14381720430107,1011.4247311827953,33.714157706093175,0
155,4,0,0,33,0.0,0.0,1.0,33,700,500,200,0.7142857142857143,9,5,4,396.35861690633766,0.44057765151515155,0.13909759299076319,0.212767114895656,127906.48666030755,3539.367629205688,131445.85428951323,154,3,81.87878787878788,30,3,20,37.08671051466027,0.6131944444444444,47.11021505376344,1011.5591397849463,33.718637992831546,0
156,4,0,0,33,0.0,0.0,1.0,33,1200,800,400,0.6666666666666666,16,8,8,396.52911814365615,0.4400647095959596,0.1445660964981108,0.21376240434787958,128076.4959279976,3557.211997051703,131633.7079250493,155,4,82.87878787878788,30,3,20,36.90772584428805,0.6149305555555554,46.94220430107528,1012.2311827957001,33.741039426523336,0
157,4,2,2,33,0.05714285714285714,0.05714285714285714,0.9428571428571428,35,1250,900,350,0.72,16,9,7,375.7064708731905,0.44355742296918765,0.12283402969152779,0.20550044203308965,128656.40503838906,2667.408778440989,131323.81381683005,156,0,79.08571428571429,32,3,20,36.84090437668533,0.6155598958333333,46.3699494949495,1014.520202020203,31.703756313131343,0
158,4,5,4,34,0.13157894736842105,0.10526315789473684,0.8947368421052632,38,900,600,300,0.6666666666666666,12,6,6,348.72545057420893,0.4492798719772404,0.10776851746140426,0.19368967796953057,129263.69214965402,1417.8115127940498,130681.50366244807,157,0,73.71052631578948,33,5,21,36.9064834899976,0.6193181818181819,45.77205882352941,1016.9117647058827,30.815508021390382,0
159,4,0,0,34,0.0,0.0,1.0,34,950,600,350,0.631578947368421,13,6,7,386.7084546201478,0.4415292632204397,0.1428371836602147,0.21107723567178244,128573.3562045629,3144.0807766384787,131717.43698120138,158,1,83.38235294117646,31,3,21,36.646900543501516,0.617271505376344,46.45182291666668,1014.1927083333348,32.71589381720435,0
160,4,3,1,36,0.08108108108108109,0.02702702702702703,0.972972972972973,37,1450,1000,450,0.6896551724137931,19,10,9,360.49046939546304,0.4460397897897898,0.12967336750852176,0.20056016722719988,129329.78777675766,1927.4914154093478,131257.279192167,159,0,77.54054054054055,32,5,23,36.54005296259517,0.6223958333333333,45.70707070707072,1017.1717171717187,31.78661616161621,0
161,4,2,3,35,0.05263157894736842,0.07894736842105263,0.9210526315789473,38,800,600,200,0.75,10,6,4,365.1737390124351,0.447694404931247,0.15039865136453345,0.20085700390947295,128877.99968117705,1812.5722040037658,130690.57188518082,160,0,76.44736842105263,35,3,21,36.88174417721038,0.6110119047619048,46.15162037037037,1015.393518518518,29.011243386243372,2
162,4,3,2,36,0.07894736842105263,0.05263157894736842,0.9473684210526316,38,800,400,400,0.5,12,4,8,360.3477991360337,0.4480648411569464,0.1314112545816064,0.20042635815237123,129319.08543381348,1720.3747910236689,131039.46022483715,161,0,74.13157894736842,35,3,22,36.55458200576544,0.6154761904761905,45.717592592592595,1017.12962962963,29.06084656084657,0
163,4,2,2,36,0.05263157894736842,0.05263157894736842,0.9473684210526316,38,1000,600,400,0.6,14,6,8,365.10550430435825,0.44877607871028924,0.15802036347973814,0.20459861317641687,129613.56122470848,1864.5249271262,131478.0861518347,162,0,75.07894736842105,35,3,18,36.133685686140794,0.618452380952381,45.42824074074074,1018.2870370370368,29.093915343915338,0
164,4,0,1,35,0.0,0.027777777777777776,0.9722222222222222,36,1400,800,600,0.5714285714285714,20,8,12,383.83294621544434,0.44348544973544973,0.17531481258447434,0.21403391218447504,129419.51600646382,2735.0948253075717,132154.6108317714,163,1,79.88888888888889,33,3,23,35.854886787907986,0.6208964646464646,45.618872549019606,1017.5245098039213,30.834076054664283,0
165,4,2,1,36,0.05405405405405406,0.02702702702702703,0.972972972972973,37,600,300,300,0.5,9,3,6,370.8938612323569,0.4450075075075075,0.1663585135450656,0.20984655319130574,129989.29280045349,2242.446145124719,132231.73894557822,164,0,74.51351351351352,34,3,22,35.60393804965369,0.6243872549019608,45.05952380952381,1019.7619047619045,29.992997198879543,0
166,4,0,1,35,0.0,0.027777777777777776,0.9722222222222222,36,850,500,350,0.5882352941176471,12,5,7,379.1004068047336,0.4424768518518518,0.1674278846153845,0.21427414297658862,129950.01922337558,2652.821030372926,132602.8402537485,165,1,77.47222222222223,33,3,22,35.434695512820504,0.6262626262626263,45.09803921568627,1019.6078431372546,30.897207367795595,0
167,4,1,0,36,0.027777777777777776,0.0,1.0,36,950,700,250,0.7368421052631579,12,7,5,376.1785569353137,0.4427248677248677,0.16801134467801182,0.2134755614510216,130106.2560823962,2588.6367322664373,132694.89281466263,166,0,78.22222222222223,33,3,24,35.35022522522522,0.6278409090909091,44.94485294117647,1020.2205882352941,30.91577540106952,0
168,4,0,0,36,0.0,0.0,1.0,36,700,500,200,0.7142857142857143,9,5,4,378.1884440566551,0.4425925925925926,0.16632303135937887,0.21566367926168972,130295.81917656798,2655.4623525722955,132951.28152914028,167,1,79.22222222222223,31,5,24,35.10619925179612,0.634744623655914,44.759114583333336,1020.9635416666671,32.934307795698935,0
169,4,0,0,36,0.0,0.0,1.0,36,1200,600,600,0.5,18,6,12,378.4645219418131,0.44209656084656085,0.16744210749946897,0.21656120894482309,130428.79104614259,2672.5340101453994,133101.32505628798,168,2,80.22222222222223,31,5,25,34.96401635861481,0.6360887096774194,44.62890625,1021.4843750000001,32.951108870967744,0
170,4,1,0,37,0.02702702702702703,0.0,1.0,37,950,800,150,0.8421052631578947,11,8,3,360.7249507738927,0.4445382882882883,0.1431758182409788,0.20085424522358344,129361.89746263134,1935.9027236301622,131297.8001862615,169,0,79.02702702702703,32,5,25,36.50138595837985,0.6227213541666667,45.675505050505045,1017.2979797979797,31.790561868686865,3
171,4,2,2,37,0.05128205128205128,0.05128205128205128,0.9487179487179487,39,1250,900,350,0.72,16,9,7,341.06391125075226,0.4484649122807018,0.129732449283956,0.19237083057502916,129867.92091836738,1058.6522108843594,130926.57312925174,170,0,75.92307692307692,34,5,18,36.48753211866385,0.6231617647058822,45.17857142857143,1019.2857142857146,29.978991596638664,0
172,4,0,0,37,0.0,0.0,1.0,37,1050,800,250,0.7619047619047619,13,8,5,357.0634595716109,0.4443818818818819,0.1426670440754949,0.1997391352633919,129544.24267409161,1851.103091359087,131395.3457654507,171,1,81.0,33,4,19,36.40892720998356,0.6221590909090909,45.49632352941176,1018.0147058823524,30.848930481283404,0
173,4,1,2,36,0.02631578947368421,0.05263157894736842,0.9473684210526316,38,1250,1000,250,0.8,15,10,5,348.3041641191373,0.44599039829302983,0.12976512543039864,0.1961502397934087,129807.25623582758,1442.4815759637113,131249.73781179127,172,0,79.84210526315789,34,4,19,36.3646320093458,0.6225490196078431,45.238095238095234,1019.0476190476184,29.971988795518186,0
174,4,3,3,36,0.07692307692307693,0.07692307692307693,0.9230769230769231,39,650,500,150,0.7692307692307693,8,5,3,341.37945103919174,0.4477620332883491,0.12620633271943826,0.19347762713880362,130055.90284475737,1079.6825435099436,131135.5853882673,173,0,78.56410256410257,35,4,20,36.2888394039109,0.6229166666666666,44.99421296296296,1020.023148148148,29.143518518518515,0
175,4,1,2,35,0.02702702702702703,0.05405405405405406,0.9459459459459459,37,1050,700,350,0.6666666666666666,14,7,7,358.52697709359563,0.44247372372372373,0.14118014118014122,0.20199934563078195,129825.09731833907,1909.159938485195,131734.25725682426,174,0,83.78378378378379,33,4,21,36.086059002725676,0.625,45.220588235294116,1019.1176470588233,30.882352941176464,0
176,4,3,3,35,0.07894736842105263,0.07894736842105263,0.9210526315789473,38,1050,600,450,0.5714285714285714,15,6,9,346.38735236907394,0.44387150308202944,0.13233416017879485,0.1968986992379111,130171.45691609973,1417.9492630385455,131589.40617913828,175,0,82.23684210526316,34,4,22,36.04395123658424,0.6262254901960784,44.88095238095238,1020.4761904761901,30.014005602240886,0
177,4,1,1,35,0.027777777777777776,0.027777777777777776,0.9722222222222222,36,1250,900,350,0.72,16,9,7,353.4941067193319,0.44303902116402116,0.13986319652986356,0.2006024838744675,130106.2560823962,1998.358954488659,132104.61503688485,176,0,85.33333333333333,33,3,22,35.92880380380381,0.6278409090909091,44.94485294117647,1020.2205882352941,30.91577540106952,0
178,4,0,0,35,0.0,0.0,1.0,35,650,300,350,0.46153846153846156,10,3,7,365.5359752453209,0.4398109243697479,0.15423689842409716,0.20689797281404743,130004.92814827565,2504.2956394755597,132509.2237877512,177,2,88.77142857142857,32,3,22,35.72463992406422,0.6292317708333334,45.04419191919192,1019.823232323232,31.869476010101,0
179,4,0,0,35,0.0,0.0,1.0,35,1250,800,450,0.64,17,8,9,366.30705899614395,0.4393207282913165,0.15651159599286424,0.2083746712650194,130200.04325259502,2538.6389850057503,132738.68223760076,178,3,89.77142857142857,33,2,23,35.50672430355428,0.6287878787878789,44.85294117647058,1020.5882352941165,30.926916221033835,0
180,4,1,1,35,0.027777777777777776,0.027777777777777776,0.9722222222222222,36,900,600,300,0.6666666666666666,12,6,6,356.78555760812526,0.4393849206349207,0.14947678490503846,0.20429950082146775,130455.99819214865,2108.9932481864744,132564.9914403351,179,0,88.25,32,4,24,35.49005067358793,0.6337890625,44.60227272727272,1021.5909090909082,31.92471590909088,0
181,4,1,0,36,0.027777777777777776,0.0,1.0,36,800,600,200,0.75,10,6,4,355.115269696704,0.43945105820105823,0.1610027702350587,0.2052171123454134,130810.95838434853,2090.593753188451,132901.552137537,180,0,89.22222222222223,32,4,20,35.1731568337036,0.6373697916666667,44.255050505050505,1022.979797979798,31.96811868686869,0
182,4,2,0,38,0.05263157894736842,0.0,1.0,38,1500,1200,300,0.8,18,12,6,334.7502842846416,0.441708155523945,0.15539632507452472,0.19700877386587912,131511.22448979577,1204.683956916082,132715.90844671187,181,0,85.47368421052632,34,4,24,34.987474852986686,0.6397058823529412,43.57142857142856,1025.7142857142844,30.168067226890717,0
183,4,0,1,37,0.0,0.02631578947368421,0.9736842105263158,38,1400,1100,300,0.7857142857142857,17,11,6,337.6598981496682,0.4407746562351826,0.16614779816625735,0.19967789038727268,131694.4515306121,1293.5870181405671,132988.03854875267,182,1,86.47368421052632,34,4,19,34.728262970695106,0.641544117647059,43.39285714285713,1026.4285714285702,30.189075630252063,0
184,4,0,0,37,0.0,0.0,1.0,37,1100,800,300,0.7272727272727273,14,8,6,347.9981919506226,0.43793793793793795,0.16851235189344105,0.20584977795045298,131705.23356401385,1766.6366301422538,133471.8701941561,183,2,89.78378378378379,33,4,20,34.452105221267125,0.6439393939393939,43.38235294117647,1026.4705882352941,31.10516934046346,0
185,4,1,0,38,0.02631578947368421,0.0,1.0,38,1400,1100,300,0.7857142857142857,17,11,6,343.2355561337376,0.43929291133238507,0.1740316338036756,0.20510996728130285,132091.8810232427,1467.726048752847,133559.60707199553,184,0,88.39473684210526,34,4,21,34.185002895194,0.6455269607843137,43.00595238095239,1027.976190476191,30.23459383753503,0
186,4,0,1,37,0.0,0.02631578947368421,0.9736842105263158,38,1000,700,300,0.7,13,7,6,343.2128110962672,0.4388780227596017,0.17653851544456778,0.20542820855429406,132153.07716836748,1471.325821995476,133624.40299036296,185,1,89.39473684210526,34,4,21,34.124020686195045,0.6461397058823529,42.94642857142858,1028.2142857142867,30.24159663865549,0
187,4,0,1,36,0.0,0.02702702702702703,0.972972972972973,37,1200,1000,200,0.8333333333333334,14,10,4,338.23520950445055,0.43828203203203203,0.11420940432726479,0.19330229848881286,130380.76560356648,1426.4242759861104,131807.1898795526,186,2,91.8108108108108,35,2,22,36.03996675732851,0.6261904761904762,44.675925925925924,1021.296296296296,29.17989417989417,8
188,4,1,1,36,0.02702702702702703,0.02702702702702703,0.972972972972973,37,1250,900,350,0.72,16,9,7,337.92657661968235,0.4365928428428429,0.11049446548654163,0.19460517456703233,130676.44702717768,1431.8088777434884,132108.25590492116,187,0,92.35135135135135,35,2,20,35.748717077956385,0.6291666666666667,44.386574074074076,1022.453703703704,29.212962962962973,0
189,4,0,0,36,0.0,0.0,1.0,36,1200,700,500,0.5833333333333334,17,7,10,345.91275823602535,0.4337466931216931,0.11976042256178143,0.19935676575442116,130706.03358892715,1842.5769193672484,132548.6105082944,188,4,95.91666666666667,35,1,20,35.51464346349746,0.6294642857142858,44.35763888888887,1022.5694444444418,29.216269841269767,0
190,4,1,1,36,0.02702702702702703,0.02702702702702703,0.972972972972973,37,1300,900,400,0.6923076923076923,17,9,8,336.51473841869756,0.43502877877877877,0.10545088143240577,0.19577277776335358,131068.54056336732,1421.299128520399,132489.83969188773,189,0,94.29729729729729,36,1,20,35.38871476227134,0.6310763888888891,44.00337837837837,1023.9864864864858,28.444069069069048,0
191,4,0,2,34,0.0,0.05555555555555555,0.9444444444444444,36,1050,900,150,0.8571428571428571,12,9,3,334.67768595041315,0.43321759259259257,0.09176767676767694,0.18782931354359952,129672.496570645,1479.9550191458086,131152.4515897908,190,6,97.91666666666667,35,1,17,36.84848484848485,0.6190476190476188,45.37037037037039,1018.5185185185208,29.100529100529165,5
192,4,0,0,34,0.0,0.0,1.0,34,1200,900,300,0.75,15,9,6,345.3399651104125,0.4303141711229947,0.08531302643792738,0.19373005911603794,129655.65653344667,2155.0559807256186,131810.71251417228,191,7,96.67647058823529,34,0,17,36.59409701928695,0.6210171568627452,45.38690476190476,1018.4523809523806,29.954481792717075,0
193,4,1,0,35,0.02857142857142857,0.0,1.0,35,1050,800,250,0.7619047619047619,13,8,5,346.20579360748377,0.43340336134453783,0.05496272096521193,0.19922057165699683,130646.86381440733,2046.140233839134,132693.00404824645,192,0,94.88571428571429,35,0,17,35.567026114193,0.6288690476190477,44.415509259259245,1022.337962962961,29.20965608465603,6
194,4,0,0,35,0.0,0.0,1.0,35,1550,1300,250,0.8387096774193549,18,13,5,343.8129727435573,0.4332282913165266,0.04932861505647401,0.19906028107569015,130883.62328800143,1999.8975212191235,132883.52080922056,193,1,95.88571428571429,35,0,17,35.38874278927723,0.6312500000000001,44.18402777777777,1023.263888888888,29.236111111111086,0
195,4,0,0,35,0.0,0.0,1.0,35,900,600,300,0.6666666666666666,12,6,6,344.62570581163493,0.43315826330532214,0.04721845318860263,0.19999145290013795,130972.46334876554,2027.295524691372,132999.7588734569,194,2,96.88571428571429,35,0,17,35.27815468113976,0.6321428571428571,44.09722222222223,1023.611111111112,29.246031746031772,0
196,4,0,1,34,0.0,0.02857142857142857,0.9714285714285714,35,1350,1100,250,0.8148148148148148,16,11,5,345.683330763364,0.43203781512605044,0.03952913820665671,0.2010690616215306,131061.33355034715,2061.14366319444,133122.4772135416,195,3,97.88571428571429,35,0,18,35.161283485927434,0.6330357142857144,44.010416666666664,1023.9583333333327,29.255952380952362,0
197,4,1,0,35,0.02857142857142857,0.0,1.0,35,800,500,300,0.625,11,5,6,344.88555659105344,0.4321078431372549,0.04715979672501436,0.2018480901264892,131298.46810967525,2056.589050711616,133355.05716038687,196,0,98.28571428571429,35,0,19,34.94224073028422,0.6354166666666665,43.7789351851852,1024.8842592592607,29.282407407407447,0
198,4,0,1,34,0.0,0.02857142857142857,0.9714285714285714,35,1150,800,350,0.6956521739130435,15,8,7,345.29852379488767,0.4311624649859944,0.050162887462503525,0.20255988899172978,131387.4488275894,2073.5784250686097,133461.027252658,197,1,99.28571428571429,35,0,20,34.84185670203957,0.6363095238095237,43.69212962962964,1025.2314814814833,29.292328042328094,0
199,4,0,0,34,0.0,0.0,1.0,34,850,700,150,0.8235294117647058,10,7,3,353.2117616663561,0.4290515448603684,0.049349629579051646,0.20770780387410645,131480.6990504536,2488.105867346949,133968.80491780056,198,2,102.08823529411765,34,0,20,34.54488295608434,0.6393995098039215,43.60119047619048,1025.5952380952388,30.164565826330552,0
200,4,0,1,33,0.0,0.029411764705882353,0.9705882352941176,34,950,600,350,0.631578947368421,13,6,7,360.0215659424657,0.42734328579916814,0.04667749043256397,0.21307247516279224,131725.001771542,2684.7682823129308,134409.77005385494,199,3,103.08823529411765,34,0,16,34.123613204994385,0.6418504901960784,43.36309523809524,1026.5476190476195,30.192577030812338,0
201,4,2,2,33,0.05714285714285714,0.05714285714285714,0.9428571428571428,35,900,600,300,0.6666666666666666,12,6,6,349.7031829179536,0.42997198879551823,0.05071645679548409,0.2091860857818304,132130.12695312503,2241.2651909722235,134371.39214409725,200,0,100.65714285714286,35,0,17,33.98028537656197,0.64375,42.96875,1028.1250000000002,29.375000000000007,0
202,4,0,1,32,0.0,0.030303030303030304,0.9696969696969697,33,550,0,550,0.0,11,0,11,371.4720074030008,0.4256234217171717,0.0707070707070705,0.21757646147890053,131328.125,3157.2157118055557,134485.34071180556,201,1,107.63636363636364,32,1,19,34.2310298102981,0.642578125,43.75,1025.0,32.03125,1
203,4,0,0,32,0.0,0.0,1.0,32,900,600,300,0.6666666666666666,12,6,6,379.30436558800477,0.4215809811827957,0.0793073699778164,0.22141551240151575,131198.7376925823,3552.850793286393,134751.5884858687,202,2,111.71875,32,0,19,34.161377454605216,0.6412760416666667,43.87626262626262,1024.494949494949,32.015467171717155,0
204,4,1,0,33,0.030303030303030304,0.0,1.0,33,1100,700,400,0.6363636363636364,15,7,8,372.2777674183327,0.4238873106060606,0.08686337943562705,0.2198486618026175,131642.34459102261,3201.5036284121384,134843.84821943476,203,0,109.3030303030303,33,0,18,33.89260409203089,0.6433080808080809,43.44362745098039,1026.2254901960778,31.09774212715387,0
205,4,0,0,33,0.0,0.0,1.0,33,850,500,350,0.5882352941176471,12,5,7,374.7569271246108,0.4233743686868687,0.09272481318315662,0.22204480448726924,131768.13755526708,3276.2044646289737,135044.34201989605,204,1,110.3030303030303,33,0,18,33.701858040900774,0.6445707070707072,43.32107843137254,1026.7156862745087,31.112596553772992,0
206,4,0,0,33,0.0,0.0,1.0,33,950,500,450,0.5263157894736842,14,5,9,373.85000119118365,0.421875,0.08896116803093568,0.22279546979303996,131988.4197934687,3268.7741794021304,135257.19397287082,205,2,111.3030303030303,33,0,19,33.50265851719339,0.6467803030303032,43.10661764705881,1027.5735294117633,31.138591800356462,0
207,4,1,0,34,0.029411764705882353,0.0,1.0,34,1050,800,250,0.7619047619047619,13,8,5,363.1621289889518,0.4220142602495544,0.08552622622758932,0.21825084274843629,132306.12953514708,2809.7151360543867,135115.84467120146,206,0,109.0,34,0,20,33.45700262284964,0.6476715686274512,42.79761904761903,1028.8095238095214,30.25910364145651,0
208,4,0,0,34,0.0,0.0,1.0,34,900,700,200,0.7777777777777778,11,7,4,363.1621289889518,0.4220142602495544,0.08552622622758932,0.21825084274843629,132306.12953514708,2809.7151360543867,135115.84467120146,207,1,110.0,34,0,20,33.45700262284964,0.6476715686274512,42.79761904761903,1028.8095238095214,30.25910364145651,0
209,4,0,0,34,0.0,0.0,1.0,34,900,800,100,0.8888888888888888,10,8,2,362.66726996024175,0.4216800356506239,0.08741187358793634,0.21830751264180506,132367.3752834463,2801.062925170016,135168.43820861634,208,2,111.0,34,0,20,33.408047971618075,0.6482843137254903,42.73809523809521,1029.0476190476156,30.26610644257693,0
210,4,0,0,34,0.0,0.0,1.0,34,1300,800,500,0.6153846153846154,18,8,10,361.3506086794727,0.42104872251931075,0.08570058186350393,0.21823914187751586,132492.61289227675,2775.260805915477,135267.87369819224,209,3,112.0,33,1,20,33.31585029559972,0.6518308080808082,42.61642156862744,1029.5343137254883,31.19800950683298,0
211,4,0,0,34,0.0,0.0,1.0,34,700,300,400,0.42857142857142855,11,3,8,361.5945120076083,0.42093731431966724,0.08539452417103433,0.21948917418396804,132681.93310565618,2795.4117707131536,135477.34487636935,210,4,113.0,33,1,16,33.119102137107966,0.6537247474747476,42.43259803921567,1030.269607843135,31.220291146761667,0
212,4,0,0,34,0.0,0.0,1.0,34,950,900,50,0.9473684210526315,10,9,1,363.41054080758687,0.419897504456328,0.08669669270632974,0.2213357030219124,132808.22167255366,2852.7815323433056,135661.00320489696,211,5,114.0,33,1,17,32.94532457496135,0.6549873737373739,42.31004901960783,1030.7598039215673,31.235145573380827,0
213,4,0,0,34,0.0,0.0,1.0,34,1200,900,300,0.75,15,9,6,388.0704473839789,0.42080733808674986,0.07854481408452685,0.2308867679503121,131925.46323829785,3450.632268838916,135376.09550713675,212,6,115.0,33,1,17,33.20099705753708,0.6461489898989898,43.16789215686275,1027.3284313725496,31.131164587046957,3
214,4,0,1,33,0.0,0.029411764705882353,0.9705882352941176,34,650,300,350,0.46153846153846156,10,3,7,389.08555359178433,0.4207144979203803,0.07981790378922882,0.2320676708691821,132019.90370290264,3473.4074634755757,135493.3111663782,213,7,116.0,33,1,18,33.07943795214247,0.6470959595959596,43.07598039215686,1027.6960784313717,31.142305407011264,0
215,4,0,0,33,0.0,0.0,1.0,33,900,600,300,0.6666666666666666,12,6,6,406.49262083905313,0.4200994318181818,0.033048023874880705,0.2333987257473101,130561.83073255756,4015.024808643882,134576.85554120145,214,11,120.3030303030303,31,2,16,34.11275852550219,0.6374327956989246,44.49869791666667,1022.0052083333338,32.967909946236574,7
216,4,0,0,33,0.0,0.0,1.0,33,550,300,250,0.5454545454545454,8,3,5,407.35003577389045,0.41966540404040403,0.02667531144352342,0.23449504991910472,130661.65500217018,4045.005967881954,134706.66097005215,215,12,121.3030303030303,31,2,16,33.989217184581435,0.6384408602150538,44.40104166666667,1022.3958333333337,32.98051075268818,0
217,4,1,2,32,0.029411764705882353,0.058823529411764705,0.9411764705882353,34,1150,700,450,0.6086956521739131,16,7,9,393.179380064421,0.42051024955436717,0.021102958779873005,0.22841589298040166,131014.2808655326,3502.422746059219,134516.7036115918,216,0,118.70588235294117,33,1,16,33.99319687175803,0.6369949494949494,44.05637254901961,1023.7745098039225,31.023469994058257,0
218,4,2,0,34,0.058823529411764705,0.0,1.0,34,950,700,250,0.7368421052631579,12,7,5,392.2143722901935,0.4256350267379679,0.041086663673103097,0.2305039892721382,131457.5760764207,3512.2855932759076,134969.8616696966,217,0,117.52941176470588,32,2,19,33.568291882130836,0.6438802083333334,43.62373737373737,1025.50505050505,32.04703282828281,0
219,4,0,0,34,0.0,0.0,1.0,34,1300,900,400,0.6923076923076923,17,9,8,392.63067431250914,0.4252636660724896,0.03698368345615366,0.23153242811781205,131587.09092184482,3533.025647893086,135120.1165697379,218,1,118.52941176470588,32,2,16,33.4263988021987,0.6451822916666666,43.497474747474755,1026.010101010102,32.06281565656569,0
220,4,0,2,32,0.0,0.058823529411764705,0.9411764705882353,34,1050,1000,50,0.9523809523809523,11,10,1,396.402968820657,0.4253379382055853,0.037520615722924644,0.2349525468257711,131781.48275686146,3647.7142000816148,135429.19695694308,219,2,119.52941176470588,32,2,17,33.13273692408591,0.6471354166666667,43.3080808080808,1026.7676767676762,32.08648989898988,0
221,4,0,0,32,0.0,0.0,1.0,32,800,600,200,0.75,10,6,4,416.00740182044785,0.421875,0.03200350543834385,0.24476117835711916,131500.39247673136,4541.0273225228275,136041.4197992542,218,3,121.09375,30,2,18,32.91481020399249,0.6496527777777779,43.581989247311824,1025.672043010752,34.189068100358405,0
222,4,1,2,31,0.030303030303030304,0.06060606060606061,0.9393939393939394,33,1200,900,300,0.75,15,9,6,406.46124855481827,0.42341382575757575,0.029503964595242183,0.24142818739460867,131862.5217013888,4119.401041666647,135981.92274305545,219,0,118.39393939393939,31,2,18,32.792427315753876,0.6505376344086022,43.22916666666666,1027.0833333333323,33.13172043010749,0
223,4,0,1,30,0.0,0.03225806451612903,0.967741935483871,31,850,700,150,0.8235294117647058,10,7,3,422.29787917958987,0.4182795698924731,0.0364208044019394,0.24891117465465676,131569.33108235046,4912.289896230765,136481.62097858122,220,5,125.70967741935483,30,1,18,32.68346871042403,0.6503472222222222,43.51478494623655,1025.940860215053,34.1980286738351,0
224,4,0,0,30,0.0,0.0,1.0,30,1150,700,450,0.6086956521739131,16,7,9,431.6715936576186,0.4180795019157088,0.021584699453551348,0.23938152011922503,129201.38888888895,5216.339136027291,134417.72802491623,221,6,128.96666666666667,28,2,19,34.86168032786884,0.632440476190476,45.833333333333336,1016.6666666666672,36.30952380952383,6
225,4,1,0,31,0.03225806451612903,0.0,1.0,31,700,500,200,0.7142857142857143,9,5,4,417.0393374252216,0.42195340501792117,0.028206560708770922,0.2339823612348241,129660.70842978395,4614.723186728394,134275.43161651233,222,0,125.7741935483871,29,2,18,34.76336992590571,0.6339798850574713,45.38194444444444,1018.4722222222223,35.11973180076629,0
226,4,0,1,30,0.0,0.03225806451612903,0.967741935483871,31,950,700,250,0.7368421052631579,12,7,5,415.8925459032937,0.4212365591397849,0.028224742811922665,0.234271714936016,129817.03990345716,4597.987845415668,134415.02774887282,223,1,126.7741935483871,30,1,19,34.63273762419765,0.6326388888888889,45.22849462365592,1019.0860215053773,33.96953405017924,0
227,4,1,1,30,0.03225806451612903,0.03225806451612903,0.967741935483871,31,750,500,250,0.6666666666666666,10,5,5,408.67258364136813,0.4226254480286738,0.04083245521601686,0.23223370172195126,130159.70054341551,4438.540221412892,134598.2407648284,224,0,126.3225806451613,30,1,19,34.466927906568316,0.6361111111111111,44.892473118279575,1020.4301075268825,34.01433691756275,0
228,4,0,0,30,0.0,0.0,1.0,30,900,400,500,0.4444444444444444,14,4,10,421.3185264347824,0.4192768199233716,0.05240170707345859,0.23831437758737856,129979.17631172847,4952.527006172851,134931.70331790132,225,3,131.53333333333333,29,1,19,34.32874784345774,0.6372126436781609,45.06944444444445,1019.7222222222229,35.16283524904217,0
229,4,0,0,30,0.0,0.0,1.0,30,650,300,350,0.46153846153846156,10,3,7,420.1975846644121,0.4192049808429119,0.054980712502836315,0.23832828257607022,130085.41907793224,4932.315779321005,135017.73485725324,226,4,132.53333333333333,29,1,20,34.24878034944407,0.6382902298850575,44.965277777777786,1020.1388888888899,35.17720306513414,0
230,4,1,1,30,0.03225806451612903,0.03225806451612903,0.967741935483871,31,650,400,250,0.6153846153846154,9,4,5,409.3058405491136,0.4235663082437276,0.04294640036505304,0.23363482451219583,130333.4876543209,4469.372106481465,134802.85976080236,227,0,129.2258064516129,29,2,20,34.2735536815379,0.6408045977011495,44.722222222222214,1021.1111111111104,35.21072796934863,0
231,4,1,0,31,0.03225806451612903,0.0,1.0,31,1000,700,300,0.7,13,7,6,412.4084357277882,0.42025089605734767,0.06434081346423537,0.23713485054347822,130617.28395061729,4573.53395061728,135190.81790123458,228,0,130.19354838709677,29,2,19,33.90511775362319,0.6436781609195403,44.44444444444444,1022.2222222222223,35.24904214559387,0
232,4,0,0,31,0.0,0.0,1.0,31,450,200,250,0.4444444444444444,7,2,5,413.1020745727968,0.42025089605734767,0.030738742706154953,0.2301119921099416,129377.9538001541,4489.260223765403,133867.21402391949,229,1,131.19354838709677,29,2,20,35.152872582480086,0.6311063218390807,45.65972222222221,1017.3611111111093,35.08141762452101,7
233,4,2,3,30,0.06060606060606061,0.09090909090909091,0.9090909090909091,33,850,500,350,0.5882352941176471,12,5,7,393.32299225724137,0.4236505681818182,0.012632067804481117,0.22220195017129876,129930.49621582036,3620.930311414932,133551.42652723528,230,0,124.18181818181819,31,2,18,35.09206045125584,0.6310483870967742,45.1171875,1019.5312500000003,32.88810483870969,0
234,4,1,0,31,0.03225806451612903,0.0,1.0,31,450,200,250,0.4444444444444444,7,2,5,415.78826613223595,0.4206989247311828,0.023857384439370355,0.23078694583669304,129237.90966854953,4547.5451311799,133785.45479972943,231,0,132.67741935483872,28,3,22,35.22796853657389,0.6328124999999998,45.797413793103466,1016.8103448275878,36.31465517241385,1
235,4,2,2,31,0.06060606060606061,0.06060606060606061,0.9393939393939394,33,800,500,300,0.625,11,5,6,401.74203421377524,0.4280697601010101,0.05003913675500393,0.227493922060756,130022.58209041522,3847.1073245462117,133869.68941496144,232,0,125.57575757575758,30,3,19,34.78353979968373,0.6347222222222221,45.02688172043012,1019.8924731182807,33.99641577060935,0
236,4,2,2,31,0.06060606060606061,0.06060606060606061,0.9393939393939394,33,850,600,250,0.7058823529411765,11,6,5,401.24011074208244,0.4276357323232323,0.04288503695540191,0.22740935029288006,130056.8549290381,3836.8053748988423,133893.66030393695,233,0,126.48484848484848,30,3,20,34.761387095357314,0.6350694444444444,44.99327956989248,1020.0268817204307,34.00089605734769,0
237,4,0,0,31,0.0,0.0,1.0,31,1000,800,200,0.8,12,8,4,421.06537894149034,0.41796594982078855,0.06941397336522348,0.23709567807319396,129802.20148533964,4731.042631172856,134533.2441165125,234,2,135.6451612903226,29,2,20,34.516122620507936,0.6354166666666665,45.243055555555564,1019.0277777777789,35.13888888888893,0
238,4,0,0,31,0.0,0.0,1.0,31,800,400,400,0.5,12,4,8,402.90484257876943,0.41796594982078855,0.04036793041354603,0.2177597633240773,128179.68991126512,4128.843557098725,132308.53346836384,235,3,136.6451612903226,29,2,23,36.64034997485486,0.6188936781609197,46.84027777777776,1012.6388888888864,34.91858237547884,8
239,4,2,2,31,0.06060606060606061,0.06060606060606061,0.9393939393939394,33,1000,700,300,0.7,13,7,6,380.454777568064,0.4253866792929293,0.029595778249278837,0.2092232972831989,128870.6546359591,3205.891248914913,132076.545884874,236,0,129.3030303030303,31,2,21,36.501346499102304,0.6202956989247312,46.15885416666666,1015.3645833333325,32.753696236559115,0
240,4,4,3,32,0.11428571428571428,0.08571428571428572,0.9142857142857143,35,800,500,300,0.625,11,5,6,357.8178032422143,0.4313375350140056,0.015534381342230619,0.2000023333600157,129513.05537533641,2268.415393118026,131781.47076845443,237,0,120.62857142857143,33,2,15,36.42146239666103,0.6218434343434345,45.52696078431372,1017.8921568627451,30.84521687462864,0
241,4,1,0,33,0.030303030303030304,0.0,1.0,33,1150,1100,50,0.9565217391304348,12,11,1,376.6162098888292,0.42625473484848486,0.03302681100376392,0.20920146509471937,129267.58660210497,3136.853705512149,132404.44030761713,238,0,128.9090909090909,31,2,24,36.19344857020915,0.6243279569892474,45.768229166666664,1016.9270833333328,32.80409946236558,0
242,4,1,1,33,0.029411764705882353,0.029411764705882353,0.9705882352941176,34,1200,900,300,0.75,15,9,6,366.824670748055,0.4291629530600119,0.030658211239886546,0.20643480424942828,129779.68606519734,2721.2781221303812,132500.9641873277,239,0,126.08823529411765,32,2,18,35.920848822800494,0.626953125,45.26515151515151,1018.9393939393932,31.841856060606037,0
243,4,1,2,32,0.029411764705882353,0.058823529411764705,0.9411764705882353,34,800,500,300,0.625,11,5,6,365.82136786390464,0.427157605466429,0.024163568773234445,0.20587018400709267,129779.68606519734,2695.236455463715,132474.92252066106,240,0,127.02941176470588,32,2,18,35.946406443618336,0.626953125,45.26515151515151,1018.9393939393932,31.841856060606037,0
244,4,0,0,32,0.0,0.0,1.0,32,1050,900,150,0.8571428571428571,12,9,3,393.0344245588186,0.42342909946236557,0.052631796533932906,0.2170158667085546,129030.63441221538,3742.696229332883,132773.33064154827,241,2,135.84375,30,2,20,36.0183225294351,0.6246527777777777,46.00134408602151,1015.9946236559148,33.86648745519716,1
245,4,0,0,32,0.0,0.0,1.0,32,850,400,450,0.47058823529411764,13,4,9,390.9103676326751,0.4233450940860215,0.044183029221208425,0.21659011797845615,129167.22896071822,3698.561791825674,132865.7907525439,242,3,136.84375,30,2,22,35.93261051610913,0.6260416666666665,45.86693548387098,1016.5322580645178,33.88440860215059,0
246,4,0,0,32,0.0,0.0,1.0,32,850,800,50,0.9411764705882353,9,8,1,389.6187407470577,0.42361811155913975,0.04726526364477324,0.21662343947340088,129303.89577191006,3675.8442088680813,132979.73998077813,243,4,137.84375,30,2,23,35.825789612792384,0.6274305555555555,45.73252688172043,1017.0698924731184,33.90232974910395,0
247,4,2,2,32,0.058823529411764705,0.058823529411764705,0.9411764705882353,34,850,300,550,0.35294117647058826,14,3,11,367.57917332024203,0.4312425727866904,0.03245096824506066,0.20702941436620212,129811.85154894927,2743.226615906562,132555.07816485583,244,0,130.6764705882353,32,2,16,35.86890306859952,0.6272786458333333,45.23358585858587,1019.065656565658,31.84580176767681,0
248,4,1,0,33,0.030303030303030304,0.0,1.0,33,950,800,150,0.8421052631578947,11,8,3,380.0363540168015,0.42700441919191917,0.04741242459519479,0.19784922915177733,126665.66848754887,3027.51176622179,129693.18025377067,245,0,135.6060606060606,31,2,20,38.77584292674511,0.5977822580645162,48.33984375,1006.6406250000003,32.47227822580646,8
249,4,4,3,34,0.10810810810810811,0.08108108108108109,0.9189189189189189,37,500,300,200,0.6,7,3,4,342.7061967396896,0.43728103103103105,0.052665766614871545,0.182719233538096,127632.76643990948,1348.824308572741,128981.59074848222,246,0,121.83783783783784,34,3,14,38.723541077599776,0.6004901960784312,47.380952380952394,1010.4761904761921,29.71988795518212,0
250,4,2,0,36,0.05555555555555555,0.0,1.0,36,650,600,50,0.9230769230769231,7,6,1,344.6474274594309,0.43412698412698414,0.07152663371773715,0.18513361811316362,127933.68055555577,1618.4027777777983,129552.08333333356,247,0,122.38888888888889,34,2,17,38.36662548050522,0.6035539215686274,47.08333333333334,1011.6666666666683,29.754901960784363,0
251,4,0,0,36,0.0,0.0,1.0,36,1000,700,300,0.7,13,7,6,344.98269896193773,0.4345568783068783,0.07042483660130738,0.1855919583023083,127993.90589569163,1631.1366213151975,129625.04251700682,248,1,123.38888888888889,34,2,18,38.29656862745099,0.6041666666666666,47.023809523809526,1011.904761904762,29.761904761904766,0
252,4,1,0,37,0.02702702702702703,0.0,1.0,37,800,500,300,0.625,11,5,6,337.6052153286888,0.43465340340340336,0.08487153210771314,0.18337911075794056,128379.01341735266,1268.2848936900032,129647.29831104266,249,0,121.02702702702703,35,2,16,38.09007156997107,0.6059523809523808,46.643518518518526,1013.425925925927,28.955026455026484,0
253,4,1,1,37,0.02631578947368421,0.02631578947368421,0.9736842105263158,38,1000,500,500,0.5,15,5,10,328.5751064608199,0.43643314366998576,0.08089841696360822,0.17985794102138458,128686.69979100738,856.6492167843751,129543.34900779175,250,0,118.8157894736842,36,2,17,38.005456899741034,0.6070601851851851,46.3400900900901,1014.6396396396409,28.18443443443447,0
254,4,0,0,37,0.0,0.0,1.0,37,1150,900,250,0.782608695652174,14,9,5,329.6504453630174,0.43496621621621623,0.08362382224852305,0.1807820359842589,128760.50407503854,1089.191502700611,129849.69557773916,251,1,122.27027027027027,35,2,18,37.90305336982553,0.6098214285714285,46.26736111111111,1014.9305555555552,28.998015873015863,0
255,4,4,4,37,0.0975609756097561,0.0975609756097561,0.9024390243902439,41,1050,700,350,0.6666666666666666,14,7,7,301.98966250861525,0.4406758130081301,0.0834911202748112,0.16939488986498769,129651.86767578138,-369.295247395818,129282.57242838557,252,0,111.2439024390244,39,2,13,37.70168507722205,0.6113782051282051,45.39062500000001,1018.437500000001,26.113782051282076,0
256,4,1,0,38,0.02631578947368421,0.0,1.0,38,1150,700,450,0.6086956521739131,16,7,9,323.4853617127366,0.4356478188715031,0.09903606874566528,0.17977823394632175,129287.27027280678,764.5078778102632,130051.77815061704,253,0,120.86842105263158,36,2,20,37.52422212379581,0.6131365740740741,45.74887387387388,1017.004504504506,28.250125125125166,0
257,4,2,3,37,0.05,0.075,0.925,40,1300,1000,300,0.7692307692307693,16,10,6,307.46857251024403,0.439690170940171,0.0847200377477193,0.1729986888513393,129772.26382725194,-19.821457922403567,129752.44236932954,254,0,115.775,38,2,15,37.440363846073204,0.6143092105263157,45.272435897435905,1018.9102564102575,26.813427800269935,0
258,4,0,0,37,0.0,0.0,1.0,37,1100,500,600,0.45454545454545453,17,5,12,325.92654068344393,0.43574824824824826,0.09987527877957536,0.1826434206963656,129613.56122470848,1048.8999271262003,130662.46115183468,255,2,123.21621621621621,35,2,16,37.131071455633865,0.618452380952381,45.42824074074074,1018.2870370370368,29.093915343915338,0
259,4,0,0,37,0.0,0.0,1.0,37,1250,800,450,0.64,17,8,9,327.6297730101204,0.43531031031031026,0.09641809005734547,0.18442791058702693,129790.40745027439,1104.640346364892,130895.04779663928,256,3,124.21621621621621,35,2,17,36.90841284264728,0.6202380952380953,45.25462962962963,1018.9814814814818,29.11375661375662,0
260,4,1,1,37,0.02631578947368421,0.02631578947368421,0.9736842105263158,38,800,600,200,0.75,10,6,4,321.47444800179323,0.4372184684684685,0.10081329150691332,0.1824911340160558,130118.92804967145,765.9821138706485,130884.9101635421,257,0,121.92105263157895,36,2,18,36.73266188373807,0.6215277777777777,44.93243243243244,1020.2702702702716,28.340840840840876,0
261,4,0,1,36,0.0,0.02702702702702703,0.972972972972973,37,1750,1500,250,0.8571428571428571,20,15,5,332.5171072323362,0.43493493493493496,0.11237504942846965,0.1890266495465831,130173.98787133473,1257.0155767746762,131431.0034481094,258,1,126.02702702702703,35,2,19,36.39524498128616,0.624107142857143,44.878472222222214,1020.48611111111,29.156746031746,0
262,4,0,1,35,0.0,0.027777777777777776,0.9722222222222222,36,850,400,450,0.47058823529411764,13,4,9,333.84521671181255,0.4328042328042328,0.10944526319767256,0.19035867205009022,130292.12648158851,1499.4806402177492,131791.60712180624,259,2,126.13888888888889,35,1,19,36.2417573593319,0.6252976190476192,44.762731481481474,1020.9490740740729,29.169973544973512,0
263,4,1,0,36,0.027777777777777776,0.0,1.0,36,700,300,400,0.42857142857142855,11,3,8,328.7767550388617,0.43333333333333335,0.10506474749700168,0.18914039177710915,130636.4705076696,1390.0469726482986,132026.51748031788,260,0,120.77777777777777,36,0,16,36.022985973415594,0.6267361111111112,44.42567567567566,1022.2972972972955,28.397147147147095,0
264,4,1,1,36,0.02702702702702703,0.02702702702702703,0.972972972972973,37,800,500,300,0.625,11,5,6,317.66997897772876,0.43487237237237236,0.09658630352717767,0.18443824152587507,130991.1703601106,922.3924669128726,131913.56282702347,261,0,118.48648648648648,37,0,18,35.94910382747785,0.6283783783783785,44.07894736842104,1023.6842105263141,27.667140825035517,0
265,4,0,1,35,0.0,0.027777777777777776,0.9722222222222222,36,1250,800,450,0.64,17,8,9,341.9363232077575,0.43472222222222223,0.04997973580556536,0.1880756967712634,128877.99968117691,1636.890263406644,130514.88994458356,262,1,119.11111111111111,35,1,18,37.471622212090125,0.6110119047619048,46.15162037037036,1015.3935185185168,29.011243386243336,5
266,4,0,1,34,0.0,0.02857142857142857,0.9714285714285714,35,1000,500,500,0.5,15,5,10,352.1435562065281,0.4325980392156863,0.06279618868998793,0.19394039238204577,128929.21095521527,2080.3181689342223,131009.52912414949,263,2,123.25714285714285,34,1,18,37.16030750595866,0.6136642156862746,46.10119047619047,1015.5952380952369,29.870448179271676,0
267,4,0,0,34,0.0,0.0,1.0,34,550,300,250,0.5454545454545454,8,3,5,359.41283731094654,0.4300913547237077,0.06869183700218695,0.19734148510949384,128808.33510487516,2459.073837868466,131267.40894274364,264,4,127.82352941176471,34,0,19,37.099067667409415,0.6124387254901962,46.22023809523809,1015.1190476190466,29.85644257703078,0
268,4,5,3,36,0.1282051282051282,0.07692307692307693,0.9230769230769231,39,1300,900,400,0.6923076923076923,17,9,8,319.35869879889054,0.43803418803418803,0.061836113338259224,0.18023323105224562,129890.67382812488,496.34331597220773,130387.01714409709,265,0,112.3076923076923,39,0,13,37.017593160297025,0.6137820512820513,45.15624999999999,1019.3749999999991,26.13782051282049,0
269,4,0,0,36,0.0,0.0,1.0,36,850,400,450,0.47058823529411764,13,4,9,341.8074264322124,0.4341435185185185,0.07605169044722238,0.19134866516245397,129573.74762854066,1657.8538420176928,131231.60147055835,266,1,122.66666666666667,36,0,14,36.767227076650826,0.6160300925925927,45.46734234234234,1018.1306306306302,28.281406406406393,0
270,4,0,0,36,0.0,0.0,1.0,36,1200,900,300,0.75,15,9,6,341.61101802484154,0.43239087301587303,0.07395637596256632,0.19207923431141952,129745.7862211874,1664.5180230906558,131410.30424427806,267,2,123.66666666666667,36,0,17,36.59753693673777,0.6177662037037037,45.29842342342342,1018.8063063063063,28.300175175175173,0
271,4,0,0,36,0.0,0.0,1.0,36,850,600,250,0.7058823529411765,11,6,5,341.38762553035593,0.4318121693121693,0.07767955801104942,0.19237596581878721,129831.84831791263,1664.5972830939163,131496.44560100656,268,3,124.66666666666667,36,0,18,36.51588397790054,0.6186342592592593,45.21396396396397,1019.1441441441452,28.309559559559588,0
272,4,0,0,36,0.0,0.0,1.0,36,700,400,300,0.5714285714285714,10,4,6,353.47500309537344,0.43156415343915344,0.09672845133191554,0.19485531577669557,128966.1565500685,1917.9758571759846,130884.13240724448,269,4,125.66666666666667,35,1,16,37.088840777879064,0.611904761904762,46.06481481481481,1015.74074074074,29.021164021163997,2
273,4,0,0,36,0.0,0.0,1.0,36,1100,600,500,0.5454545454545454,16,6,10,357.57585590561536,0.4306547619047619,0.10631856660213335,0.19784962764380637,129113.151644483,2033.549141589501,131146.7007860725,270,5,126.66666666666667,35,1,19,36.834856508370336,0.6133928571428571,45.920138888888886,1016.3194444444442,29.037698412698408,0
274,4,0,0,36,0.0,0.0,1.0,36,1300,1100,200,0.8461538461538461,15,11,4,358.5947615343975,0.43105158730158727,0.11498450641876956,0.19900536829309415,129230.80800165022,2068.2981556498444,131299.10615730006,271,6,127.66666666666667,35,1,20,36.6890770252324,0.6145833333333335,45.80439814814814,1016.7824074074061,29.05092592592589,0
275,4,1,0,37,0.02702702702702703,0.0,1.0,37,1000,600,400,0.6,14,6,8,360.7770214584413,0.431275025025025,0.13292519038375405,0.20330211981313173,129831.84831791249,1968.0695053161244,131799.9178232286,272,0,125.1891891891892,36,1,15,36.02186924493554,0.6186342592592593,45.21396396396396,1019.1441441441441,28.30955955955956,0
276,4,0,0,37,0.0,0.0,1.0,37,1300,900,400,0.6923076923076923,17,9,8,358.7911275726303,0.4314627127127127,0.1320418960719445,0.20247988072240966,129889.23890106328,1920.6212969726514,131809.86019803592,273,1,126.1891891891892,36,1,15,36.01414052143172,0.619212962962963,45.15765765765766,1019.3693693693698,28.315815815815828,0
277,4,0,1,36,0.0,0.02702702702702703,0.972972972972973,37,800,600,200,0.75,10,6,4,389.5587852428178,0.43099349349349353,0.11690937103555621,0.21652574510926437,129292.17864229016,2730.054883378953,132022.23352566911,274,2,127.1891891891892,34,3,20,35.83928362401966,0.6173406862745099,45.74404761904761,1017.0238095238088,29.912464985994376,4
278,4,1,1,36,0.02702702702702703,0.02702702702702703,0.972972972972973,37,500,300,200,0.6,7,3,4,388.70763653773815,0.4316816816816817,0.134913861229651,0.21721897335932425,129504.14540816324,2667.850056689339,132171.99546485257,275,0,127.91891891891892,34,3,18,35.64449317738791,0.619485294117647,45.535714285714285,1017.8571428571427,29.93697478991596,0
279,4,2,3,35,0.05263157894736842,0.07894736842105263,0.9210526315789473,38,600,200,400,0.3333333333333333,10,2,8,378.0850860059959,0.43421052631578944,0.12881735855823484,0.2129903507538575,129819.89354263117,2216.5931230709843,132036.48666570216,276,0,125.10526315789474,35,3,18,35.593057921635435,0.6205357142857143,45.22569444444444,1019.0972222222222,29.11706349206349,0
280,4,3,3,35,0.07894736842105263,0.07894736842105263,0.9210526315789473,38,900,500,400,0.5555555555555556,13,5,8,375.3074002468589,0.4380630630630631,0.12437503360034396,0.21238493921484106,129996.8804253473,2157.7582465277824,132154.6386718751,277,0,124.76315789473684,35,3,20,35.48369935308137,0.6223214285714285,45.052083333333336,1019.7916666666673,29.13690476190478,0
281,4,1,0,36,0.027777777777777776,0.0,1.0,36,700,400,300,0.5714285714285714,10,4,6,385.36057875742824,0.432473544973545,0.15003031681067158,0.21562542307572155,129554.63927469152,2798.6135223765637,132353.2527970681,278,0,132.66666666666666,32,4,20,35.67814915870849,0.6246744791666665,45.48611111111112,1018.0555555555569,31.814236111111153,2
282,4,2,1,37,0.05263157894736842,0.02631578947368421,0.9736842105263158,38,950,500,450,0.5263157894736842,14,5,9,370.4886248058067,0.4359145329540066,0.15556101455505722,0.210270696330183,130110.72137188209,2040.908446712016,132151.6298185941,279,0,126.63157894736842,34,4,21,35.49081096849474,0.6256127450980392,44.94047619047619,1020.2380952380953,30.00700280112045,0
283,4,0,0,37,0.0,0.0,1.0,37,1150,900,250,0.782608695652174,14,9,5,371.9401261591452,0.4323073073073073,0.13844251360763948,0.21140924440458694,130168.77710796316,2283.0868530009893,132451.86396096414,280,1,131.05405405405406,33,4,21,35.39477502902204,0.6284722222222223,44.88357843137254,1020.4656862745088,30.923202614379054,2
284,4,0,0,37,0.0,0.0,1.0,37,500,400,100,0.8,6,4,2,372.6644782889458,0.43177552552552556,0.13859098623175958,0.2121614791297763,130231.31315179243,2306.516874519398,132537.83002631183,281,2,132.05405405405406,33,4,22,35.31273762356425,0.6291035353535355,44.82230392156862,1020.7107843137243,30.930629827688616,0
285,4,0,0,37,0.0,0.0,1.0,37,1300,900,400,0.6923076923076923,17,9,8,372.0152913971838,0.4305242742742743,0.13697456909556305,0.21213274419096073,130293.86421388392,2294.2619725586114,132588.12618644253,282,3,133.05405405405406,33,4,22,35.265749409834754,0.6297348484848486,44.761029411764696,1020.9558823529399,30.938057040998178,0
286,4,1,1,37,0.02631578947368421,0.02631578947368421,0.9736842105263158,38,1250,1000,250,0.8,15,10,5,360.87647597621844,0.432684329065908,0.13016342813022774,0.2078851812313709,130688.28124999999,1832.465277777778,132520.74652777775,283,0,130.52631578947367,34,4,19,35.15009508285792,0.6314338235294117,44.375,1022.4999999999999,30.073529411764703,0
287,4,1,0,38,0.02631578947368421,0.0,1.0,38,1250,900,350,0.72,16,9,7,360.70526819135705,0.43135075865339023,0.13978445240500892,0.20877183704408833,130870.93431122435,1841.1670918367163,132712.10140306107,284,0,131.5,34,4,20,34.96945898778359,0.6332720588235294,44.19642857142856,1023.2142857142845,30.094537815126017,0
288,4,0,0,38,0.0,0.0,1.0,38,1000,600,400,0.6,14,6,8,362.97383515459717,0.430906235182551,0.14169757960847718,0.21058360557754538,130962.3086734692,1907.1782879818395,132869.48696145104,285,1,132.5,34,4,21,34.818901682561844,0.6341911764705883,44.10714285714285,1023.5714285714271,30.105042016806678,0
289,4,0,0,38,0.0,0.0,1.0,38,1300,1000,300,0.7692307692307693,16,10,6,360.95052499556425,0.4294689426268374,0.14723262130220993,0.21040774505838974,131145.15306122435,1867.3823696145025,133012.53543083885,286,2,133.5,34,4,22,34.68565977064932,0.636029411764706,43.92857142857142,1024.2857142857133,30.12605042016804,0
290,4,0,1,37,0.0,0.02631578947368421,0.9736842105263158,38,1050,700,350,0.6666666666666666,14,7,7,361.95933423675683,0.42895033191085824,0.14507469440418763,0.21149925253060162,131236.62308673444,1900.464143990904,133137.08723072536,287,3,134.5,34,4,22,34.5673095542388,0.6369485294117648,43.8392857142857,1024.6428571428553,30.136554621848685,0
291,4,1,1,37,0.02631578947368421,0.02631578947368421,0.9736842105263158,38,1050,800,250,0.7619047619047619,13,8,5,364.1819691956946,0.4306987908961593,0.13393182933427283,0.21365682708914285,131390.93888168,1970.0740590353628,133361.01294071536,288,0,134.39473684210526,33,5,22,34.35433102239222,0.6407828282828283,43.68872549019607,1025.2450980392146,31.068033273915592,0
292,4,0,0,37,0.0,0.0,1.0,37,1350,1000,350,0.7407407407407407,17,10,7,363.7476779961281,0.4270207707707708,0.13276313229877168,0.21373277614315458,131450.177154195,2162.939342403626,133613.11649659864,289,5,139.02702702702703,34,3,22,34.30558780280163,0.639093137254902,43.63095238095238,1025.4761904761906,30.161064425770313,0
293,4,0,0,37,0.0,0.0,1.0,37,1250,900,350,0.72,16,9,7,366.40495044707995,0.42627002002002,0.1360130432056188,0.21632949814067315,131633.36167800447,2246.223072562352,133879.5847505668,290,6,140.02702702702703,34,3,19,34.05234918793504,0.6409313725490196,43.45238095238095,1026.1904761904757,30.182072829131638,0
294,4,0,1,36,0.0,0.02702702702702703,0.972972972972973,37,1400,1100,300,0.7857142857142857,17,11,6,367.8584501001469,0.4257695195195195,0.14355523813103743,0.21858696332397182,131877.80612244914,2302.473072562376,134180.2791950115,291,7,141.02702702702703,34,3,20,33.7682062277855,0.6433823529411764,43.21428571428572,1027.1428571428585,30.210084033613484,0
295,4,0,0,36,0.0,0.0,1.0,36,700,300,400,0.42857142857142855,11,3,8,373.8500011911835,0.4255787037037037,0.1285397204001857,0.22279546979304016,131988.4197934689,2668.7741794021586,134657.19397287106,292,8,138.05555555555554,33,3,20,33.502658517193396,0.646780303030303,43.106617647058826,1027.573529411765,31.13859180035652,0
296,4,0,0,36,0.0,0.0,1.0,36,1300,1000,300,0.7692307692307693,16,10,6,371.43578234434244,0.42514880952380957,0.1279857716306989,0.22172469085565824,132051.391366902,2609.7223724048317,134661.11373930683,293,9,139.05555555555554,33,3,20,33.501127737371334,0.6474116161616161,43.045343137254896,1027.8186274509794,31.14601901366604,0
297,4,0,0,36,0.0,0.0,1.0,36,1100,800,300,0.7272727272727273,14,8,6,373.4434083574988,0.42437169312169315,0.12795254739963968,0.22385264878115205,132208.88600538252,2674.5074009996133,134883.39340638212,294,10,140.05555555555554,33,3,21,33.29063393708294,0.648989898989899,42.8921568627451,1028.4313725490194,31.16458704693998,0
298,4,0,1,35,0.0,0.027777777777777776,0.9722222222222222,36,850,600,250,0.7058823529411765,11,6,5,371.5873685624928,0.42390873015873015,0.12369646921814614,0.2234847812643761,132334.94929834688,2634.7991157247284,134969.7484140716,295,11,141.05555555555554,33,3,21,33.21125138955058,0.6502525252525253,42.76960784313726,1028.9215686274515,31.179441473559137,0
299,4,0,0,35,0.0,0.0,1.0,35,1450,1300,150,0.896551724137931,16,13,3,386.23191863630353,0.4204481792717087,0.13027561540079957,0.23208094933986728,132300.56244260792,3219.7400137741065,135520.30245638202,296,12,144.65714285714284,32,3,21,32.869262395679925,0.65234375,42.803030303030305,1028.787878787879,32.14962121212122,0
300,4,0,1,34,0.0,0.02857142857142857,0.9714285714285714,35,1000,700,300,0.7,13,7,6,384.6973397367602,0.4199229691876751,0.13302486986697537,0.23175669003653593,132398.00347222216,3186.6678145087144,135584.67128673088,297,13,145.65714285714284,31,4,22,32.81039136302295,0.6559139784946237,42.70833333333333,1029.166666666666,33.19892473118278,0
301,4,0,0,34,0.0,0.0,1.0,34,550,300,250,0.5454545454545454,8,3,5,395.25836703959067,0.418356357694593,0.14037145431663012,0.2370649841492579,132230.54885864258,3653.0461629231777,135883.59502156576,298,14,149.76470588235293,31,3,22,32.7078585896949,0.654233870967742,42.87109375,1028.515625,33.177923387096776,0
302,4,0,0,34,0.0,0.0,1.0,34,1150,1000,150,0.8695652173913043,13,10,3,395.3274063716057,0.4180964052287582,0.1426662298889938,0.2375271359499664,132297.51798841695,3660.1669311523488,135957.6849195693,299,15,150.76470588235293,31,3,22,32.638405476100054,0.6549059139784945,42.805989583333336,1028.7760416666672,33.1863239247312,0
303,4,1,1,34,0.02857142857142857,0.02857142857142857,0.9714285714285714,35,1000,800,200,0.8,12,8,4,385.574726450795,0.42016806722689076,0.13278416070525334,0.2331135272762147,132532.04345703125,3220.2394273546,135752.28288438584,300,0,147.42857142857142,31,4,22,32.65258809644243,0.657258064516129,42.578125,1029.6875,33.215725806451616,0
304,4,0,0,34,0.0,0.0,1.0,34,850,500,350,0.5882352941176471,12,5,7,393.9976012048084,0.41746509209744503,0.13682864450127874,0.23779571533708652,132467.1769315817,3638.349989883223,136105.52692146492,301,17,152.76470588235293,30,4,23,32.501251251251254,0.6593749999999999,42.641129032258064,1029.4354838709678,34.31451612903226,0
305,4,0,0,34,0.0,0.0,1.0,34,900,700,200,0.7777777777777778,11,7,4,394.42482472562864,0.4164438502673797,0.1407711087567367,0.23871113799745414,132570.9709937566,3657.8563995837794,136228.82739334038,302,18,153.76470588235293,30,4,23,32.385473766640565,0.6604166666666667,42.54032258064517,1029.8387096774202,34.32795698924734,0
306,4,0,0,34,0.0,0.0,1.0,34,500,200,300,0.4,8,2,6,394.436573563574,0.416369578134284,0.14315976912685735,0.23915837814804058,132640.18961729694,3663.6283818938823,136303.81799919083,303,19,154.76470588235293,30,4,21,32.31531619693807,0.6611111111111111,42.4731182795699,1030.1075268817217,34.336917562724054,0
307,4,0,2,32,0.0,0.058823529411764705,0.9411764705882353,34,550,200,350,0.36363636363636365,9,2,7,393.34861542756806,0.4156268568033274,0.14317714566264717,0.23938072881734848,132778.68106139434,3645.6620707596207,136424.34313215397,304,20,155.76470588235293,30,4,21,32.20363849765259,0.6624999999999999,42.33870967741935,1030.6451612903222,34.35483870967741,0
308,4,0,0,32,0.0,0.0,1.0,32,850,800,50,0.9411764705882353,9,8,1,403.5050314825209,0.41639364919354843,0.12340758964680498,0.24494274333366117,132684.03742283946,4307.735339506161,136991.77276234562,305,21,151.28125,29,3,21,32.03749887660645,0.6645114942528736,42.43055555555555,1030.2777777777774,35.52681992337163,0
309,4,0,0,32,0.0,0.0,1.0,32,1100,800,300,0.7272727272727273,14,8,6,402.7047930523942,0.41544858870967744,0.11713657105606257,0.2455282800247905,132847.95388195172,4299.701555093077,137147.6554370448,306,22,152.28125,30,2,22,31.892655367231647,0.6631944444444444,42.27150537634409,1030.913978494624,34.36379928315413,0
310,4,0,0,32,0.0,0.0,1.0,32,600,300,300,0.5,9,3,6,403.6333604549586,0.41479754704301075,0.1158294240291895,0.24700816651765167,132986.5537200832,4335.561914672208,137322.1156347554,307,23,153.28125,30,2,22,31.728889757623143,0.6645833333333333,42.137096774193544,1031.4516129032254,34.381720430107514,0
311,4,0,0,32,0.0,0.0,1.0,32,950,700,250,0.7368421052631579,12,7,5,407.3203405012142,0.41446152553763443,0.1185611487366498,0.25019244594946605,133125.22582090425,4444.92246213436,137570.1482830386,308,24,154.28125,30,2,22,31.493932881826865,0.6659722222222222,42.002688172043015,1031.9892473118286,34.399641577060954,0
312,4,0,0,32,0.0,0.0,1.0,32,950,700,250,0.7368421052631579,12,7,5,409.07060862869014,0.41465053763440857,0.11297763963025664,0.25197043663808905,133229.27731890976,4500.036312001395,137729.31363091117,309,25,155.28125,30,2,22,31.343846287375776,0.6670138888888888,41.90188172043011,1032.39247311828,34.413082437275996,0
313,4,0,1,31,0.0,0.03125,0.96875,32,650,600,50,0.9230769230769231,7,6,1,408.87176215243244,0.41462953629032256,0.11473249153866183,0.2520828954137228,133263.97018441436,4497.574864146142,137761.5450485605,310,26,156.28125,30,2,22,31.314002429922763,0.6673611111111111,41.86827956989247,1032.5268817204299,34.41756272401433,0
314,4,0,0,31,0.0,0.0,1.0,31,1300,1100,200,0.8461538461538461,15,11,4,407.4812281982448,0.4131272401433692,0.10029964138433489,0.2523940763169644,133436.34500385795,4674.56114969135,138110.9061535493,311,27,155.06451612903226,29,2,23,31.17620535914325,0.6720545977011494,41.701388888888886,1033.194444444444,35.6273946360153,0
315,4,0,0,31,0.0,0.0,1.0,31,1000,500,500,0.5,15,5,10,409.3135259895013,0.4127688172043011,0.09622803443403205,0.25426638233838617,133543.9911265431,4732.272376543192,138276.2635030863,312,28,156.06451612903226,29,2,23,31.02044701245185,0.6731321839080461,41.597222222222214,1033.6111111111102,35.641762452107244,0
316,4,1,1,31,0.03125,0.03125,0.96875,32,900,500,400,0.5555555555555556,13,5,8,398.3954965038005,0.41530157930107525,0.0895606001558844,0.24933727903140288,133819.67026534857,4262.630795467679,138082.30106081624,313,0,152.15625,30,2,22,31.025374556161776,0.6729166666666667,41.33064516129032,1034.6774193548385,34.48924731182795,0
317,4,0,0,31,0.0,0.0,1.0,31,700,600,100,0.8571428571428571,8,6,2,397.6400846785612,0.41223118279569887,0.11622301313121675,0.24046521923383793,132540.9818672839,4342.713190991891,136883.6950582758,314,30,158.06451612903226,29,2,22,32.332973653448434,0.6630747126436782,42.56944444444444,1029.722222222222,35.507662835249036,3
318,4,0,0,31,0.0,0.0,1.0,31,1650,1300,350,0.7878787878787878,20,13,7,396.0854716332319,0.4114247311827957,0.11171371783218143,0.24020980728566452,132648.26630015415,4308.010223765405,136956.27652391954,315,31,159.06451612903226,29,2,21,32.26470158644555,0.6641522988505748,42.465277777777764,1030.1388888888875,35.52203065134095,0
319,4,0,0,31,0.0,0.0,1.0,31,950,700,250,0.7368421052631579,12,7,5,397.5630402082278,0.41111111111111115,0.11640027646043705,0.24202750790691202,132791.3797260802,4358.58892746913,137149.96865354932,316,32,160.06451612903226,29,2,21,32.0822384674123,0.6655890804597702,42.326388888888886,1030.6944444444441,35.54118773946359,0
320,4,0,0,31,0.0,0.0,1.0,31,550,400,150,0.7272727272727273,7,4,3,397.5630402082278,0.41111111111111115,0.11640027646043705,0.24202750790691202,132791.3797260802,4358.58892746913,137149.96865354932,317,33,161.06451612903226,29,2,21,32.0822384674123,0.6655890804597702,42.326388888888886,1030.6944444444441,35.54118773946359,0
321,4,0,0,31,0.0,0.0,1.0,31,1250,900,350,0.72,16,9,7,399.3673245206599,0.4104390681003584,0.12466977196885409,0.24382426128629753,132898.76543209868,4415.084876543194,137313.85030864188,318,34,162.06451612903226,29,2,21,31.92742007902299,0.6666666666666667,42.222222222222214,1031.1111111111104,35.55555555555553,0
322,4,0,0,31,0.0,0.0,1.0,31,750,600,150,0.8,9,6,3,401.27389597652603,0.4095430107526881,0.12974466347532232,0.24545798612204942,132970.380015432,4471.508487654311,137441.8885030863,319,35,163.06451612903226,29,2,21,31.806041834994165,0.6673850574712643,42.15277777777777,1031.388888888888,35.56513409961683,0
323,4,0,0,31,0.0,0.0,1.0,31,1050,800,250,0.7619047619047619,13,8,5,401.7200477538849,0.408915770609319,0.13293258685615283,0.24596659477890373,133006.194540895,4486.250964506162,137492.44550540115,320,36,164.06451612903226,29,2,21,31.758420851846868,0.6677442528735632,42.11805555555555,1031.5277777777771,35.56992337164749,0
324,4,0,0,31,0.0,0.0,1.0,31,1000,800,200,0.8,12,8,4,404.9459377700168,0.408826164874552,0.13441583814527025,0.24865688575464664,133113.66705246907,4580.767746913574,137694.43479938264,321,37,165.06451612903226,29,2,21,31.566846119336027,0.6688218390804599,42.013888888888886,1031.9444444444441,35.58429118773945,0
325,4,0,2,29,0.0,0.06451612903225806,0.935483870967742,31,800,600,200,0.75,10,6,4,404.481750048403,0.408826164874552,0.13511672011908527,0.2490897140107522,133221.18296682092,4577.107445987638,137798.29041280856,322,38,166.06451612903226,29,2,21,31.470441499618804,0.6698994252873562,41.909722222222214,1032.3611111111106,35.5986590038314,0
326,4,0,0,29,0.0,0.0,1.0,29,750,500,250,0.6666666666666666,10,5,5,424.0784020452245,0.4080972906403941,0.1284597170543409,0.2596918271181534,133011.3112953515,5481.444869614517,138492.75616496603,323,39,168.51724137931035,27,2,21,31.17666859011348,0.6743827160493827,42.11309523809524,1031.5476190476193,38.205467372134045,0
327,4,0,0,29,0.0,0.0,1.0,29,800,600,200,0.75,10,6,4,418.87890561058714,0.40676313628899835,0.1312111204976576,0.2576392172865119,133175.45250363325,5356.877559783331,138532.3300634166,324,40,169.51724137931035,28,1,21,31.14502134372679,0.6726190476190477,41.95402298850575,1032.1839080459772,36.863711001642045,0
328,4,0,0,29,0.0,0.0,1.0,29,1350,1200,150,0.8888888888888888,15,12,3,421.63597604621725,0.40532635467980294,0.1380461849220096,0.26011139569477787,133286.70244170286,5439.693775597814,138726.39621730067,325,41,170.51724137931035,28,1,21,30.96157413849079,0.6737351190476191,41.84626436781608,1032.6149425287347,36.87910509031195,0
329,4,0,0,29,0.0,0.0,1.0,29,450,300,150,0.6666666666666666,6,3,3,421.55408646513746,0.40542898193760263,0.13846832844012025,0.2603205131882653,133323.79607609985,5440.63821178491,138764.43428788477,326,42,171.51724137931035,28,1,21,30.926254405490624,0.6741071428571429,41.810344827586206,1032.7586206896551,36.88423645320197,0
330,4,1,1,29,0.03333333333333333,0.03333333333333333,0.9666666666666667,30,750,500,250,0.6666666666666666,10,5,5,409.43898793752703,0.40830938697318003,0.11827867333703912,0.25487222813135324,133620.7309420002,4941.989942528728,138562.7208845289,327,0,166.76666666666668,28,2,21,30.939931906614788,0.6770833333333334,41.52298850574712,1033.908045977011,36.92528735632182,0
331,4,0,0,29,0.0,0.0,1.0,29,1050,800,250,0.7619047619047619,13,8,5,419.9621795515385,0.4038895730706076,0.13028585045225705,0.2609174686194085,133549.11821499435,5417.115752551022,138966.23396754538,328,44,173.51724137931035,27,2,22,30.740114214415957,0.6797839506172839,41.592261904761905,1033.6309523809525,38.2826278659612,0
332,4,0,0,29,0.0,0.0,1.0,29,700,500,200,0.7142857142857143,9,5,4,420.540226827278,0.4026067323481117,0.13671439040862965,0.2625732084067279,133732.16667079527,5447.951141167908,139180.11781196317,329,45,174.51724137931035,28,1,20,30.54070009723574,0.6781994047619048,41.415229885057464,1034.3390804597693,36.94068144499176,0
333,4,0,0,29,0.0,0.0,1.0,29,500,200,300,0.4,8,2,6,421.1417714586209,0.40214490968801314,0.13214720049028505,0.263744612003912,133843.64884727183,5473.430274805133,139317.07912207698,330,46,175.51724137931035,28,1,21,30.41284828288438,0.679315476190476,41.30747126436782,1034.770114942529,36.95607553366175,0
334,4,0,0,29,0.0,0.0,1.0,29,850,500,350,0.5882352941176471,12,5,7,421.8592184612173,0.4018370279146141,0.13395759429739496,0.26446057011106594,133880.81989447086,5495.771609525693,139376.59150399655,331,47,176.51724137931035,28,1,21,30.356853625804064,0.6796875,41.27155172413793,1034.9137931034481,36.96120689655172,0
335,4,0,0,29,0.0,0.0,1.0,29,600,500,100,0.8333333333333334,7,5,2,420.3766266569882,0.4015291461412151,0.13244709868213267,0.26433106210211677,133992.3640011891,5465.451595323033,139457.81559651214,332,48,177.51724137931035,28,1,21,30.282923952261996,0.6808035714285714,41.16379310344828,1035.3448275862072,36.97660098522169,0
336,4,0,0,29,0.0,0.0,1.0,29,850,500,350,0.5882352941176471,12,5,7,420.7343508612261,0.40055418719211827,0.13038299826366484,0.26536079924397027,134103.95455558857,5484.428053573786,139588.38260916236,333,49,178.51724137931035,28,1,21,30.16137235862579,0.6819196428571428,41.05603448275862,1035.7758620689654,36.99199507389162,0
337,4,0,0,29,0.0,0.0,1.0,29,700,200,500,0.2857142857142857,12,2,10,420.0521395598925,0.4004515599343186,0.13039465567452013,0.26546853447558144,134178.37406278893,5472.38262154841,139650.75668433734,334,50,179.51724137931035,28,1,22,30.1041811121897,0.6826636904761905,40.984195402298845,1036.063218390804,37.00225779967157,0
338,4,0,0,29,0.0,0.0,1.0,29,750,500,250,0.6666666666666666,10,5,5,416.9359188070208,0.399373973727422,0.12681434750400267,0.2645727928049828,134327.2750074316,5401.173165213369,139728.44817264497,335,51,180.51724137931035,28,1,22,30.035227535227534,0.6841517857142858,40.84051724137931,1036.6379310344826,37.02278325123152,0
339,4,0,0,29,0.0,0.0,1.0,29,800,600,200,0.75,10,6,4,416.11851714412927,0.39901477832512317,0.12932109530657976,0.26459271702459736,134401.75644487378,5385.411918681453,139787.16836355525,336,52,181.51724137931035,28,1,22,29.981582836820476,0.6848958333333334,40.768678160919535,1036.9252873563214,37.033045977011476,0
340,4,0,0,29,0.0,0.0,1.0,29,800,700,100,0.875,9,7,2,417.1924294912067,0.39845032840722494,0.1326575941839303,0.2658174888346886,134476.25852573002,5420.495400647386,139896.75392637742,337,53,182.51724137931035,28,1,22,29.87890751258254,0.6856398809523809,40.696839080459775,1037.2126436781614,37.04330870279148,0
341,4,0,0,29,0.0,0.0,1.0,29,550,400,150,0.7272727272727273,7,4,3,419.00230968147866,0.3980398193760262,0.13335562135829582,0.26724352260603146,134513.51730743825,5472.294887039237,139985.81219447748,338,54,183.51724137931035,28,1,22,29.794552169898427,0.6860119047619048,40.660919540229884,1037.3563218390805,37.04844006568145,0
342,4,0,0,29,0.0,0.0,1.0,29,950,500,450,0.5263157894736842,14,5,9,418.7036045714485,0.3973214285714286,0.1361457975331275,0.2681484786723531,134662.60404280608,5476.743542740117,140139.3475855462,339,55,184.51724137931035,28,1,22,29.652604743447775,0.6875,40.51724137931034,1037.931034482758,37.06896551724135,0
343,4,0,0,29,0.0,0.0,1.0,29,950,800,150,0.8421052631578947,11,8,3,416.8295295176797,0.39670566502463056,0.13657596274507022,0.26777128976215736,134774.47328329366,5435.596057933677,140210.06934122732,340,56,185.51724137931035,28,1,22,29.588983441723173,0.6886160714285714,40.40948275862069,1038.362068965517,37.084359605911324,0
344,4,0,0,29,0.0,0.0,1.0,29,1100,700,400,0.6363636363636364,15,7,8,420.7156295380828,0.3958333333333333,0.14019141722182726,0.271382222764485,134923.7045225591,5552.902257563744,140476.60678012285,341,57,186.51724137931035,28,1,20,29.338381044576586,0.6901041666666667,40.26580459770115,1038.9367816091954,37.104885057471265,0
345,4,0,0,29,0.0,0.0,1.0,29,650,500,150,0.7692307692307693,8,5,3,421.4612775764734,0.3955254515599343,0.1332875660883781,0.2724244343798598,134998.35110731263,5579.315505681056,140577.6666129937,342,58,187.51724137931035,28,1,20,29.244147195723304,0.6908482142857144,40.193965517241374,1039.2241379310337,37.1151477832512,0
346,4,0,0,29,0.0,0.0,1.0,29,850,700,150,0.8235294117647058,10,7,3,422.45940417906456,0.3956793924466338,0.13232532199479463,0.27335163951979874,135035.68214096958,5609.418764037497,140645.10090500707,343,59,188.51724137931035,28,1,20,29.180778269283937,0.6912202380952381,40.15804597701148,1039.3678160919528,37.12027914614117,0
347,4,0,0,29,0.0,0.0,1.0,29,1100,900,200,0.8181818181818182,13,9,4,429.47941149537553,0.39490968801313625,0.13125357210897293,0.2796250844628164,135259.77672083493,5818.2578610120145,141078.03458184694,344,60,189.51724137931035,28,1,20,28.773595764272557,0.6934523809523809,39.94252873563218,1040.229885057471,37.15106732348111,0
348,4,0,0,29,0.0,0.0,1.0,29,450,200,250,0.4444444444444444,7,2,5,429.47941149537553,0.39490968801313625,0.13125357210897293,0.2796250844628164,135259.77672083493,5818.2578610120145,141078.03458184694,345,61,190.51724137931035,28,1,20,28.773595764272557,0.6934523809523809,39.94252873563218,1040.229885057471,37.15106732348111,0
349,4,0,0,29,0.0,0.0,1.0,29,650,400,250,0.6153846153846154,9,4,5,428.5375605391082,0.3945504926108374,0.13010450715897082,0.27910837638590585,135272.23186728384,5793.846450617273,141066.07831790112,346,62,191.51724137931035,29,0,20,28.78560302625724,0.6903735632183908,39.93055555555555,1040.277777777777,35.871647509578516,0
350,4,0,0,29,0.0,0.0,1.0,29,600,300,300,0.5,9,3,6,429.5438867850873,0.3943452380952381,0.1336776545647882,0.28004466979173964,135308.35503472228,5824.175347222227,141132.5303819445,347,63,192.51724137931035,29,0,20,28.723217861433714,0.6907327586206897,39.895833333333336,1040.416666666667,35.87643678160921,0
351,4,0,0,29,0.0,0.0,1.0,29,1100,800,300,0.7272727272727273,14,8,6,426.3714289237103,0.39321633825944174,0.12473955099281087,0.2796593703098037,135525.1953125,5756.814236111111,141282.00954861112,348,64,193.51724137931035,29,0,20,28.588518740829667,0.6928879310344829,39.6875,1041.25,35.9051724137931,0
352,4,0,0,29,0.0,0.0,1.0,29,800,400,400,0.5,12,4,8,426.55999999999995,0.3924466338259442,0.1246896551724137,0.2806315789473684,135633.6805555556,5771.2239583333385,141404.90451388893,349,65,194.51724137931035,28,1,21,28.475,0.6971726190476191,39.583333333333336,1041.666666666667,37.20238095238096,0
353,4,0,0,29,0.0,0.0,1.0,29,900,900,0,1.0,9,9,0,425.26526718079765,0.3920361247947455,0.12511174087528731,0.2803657925086497,135708.52325274155,5742.424279957731,141450.94753269927,350,66,195.51724137931035,28,1,21,28.433822853465713,0.6979166666666666,39.51149425287357,1041.9540229885065,37.212643678160944,0
354,4,0,0,29,0.0,0.0,1.0,29,1000,600,400,0.6,14,6,8,427.2347168069174,0.3909585385878489,0.12409040138786587,0.28255130997576894,135820.82600492137,5805.474426938835,141626.3004318602,351,67,196.51724137931035,28,1,21,28.270158511371488,0.699032738095238,39.40373563218391,1042.3850574712642,37.228037766830866,0
355,4,0,0,29,0.0,0.0,1.0,29,1050,700,350,0.6666666666666666,14,7,7,422.69851487843005,0.3901375205254516,0.12233595547412057,0.2806404198251223,135959.39670138896,5693.967013888893,141653.36371527787,352,68,197.51724137931035,29,0,20,28.249850179784247,0.697198275862069,39.270833333333336,1042.9166666666672,35.96264367816094,0
356,4,0,0,29,0.0,0.0,1.0,29,1050,800,250,0.7619047619047619,13,8,5,423.2534054420138,0.38926518883415434,0.1258508240888203,0.2821564183749647,136104.28481867295,5721.32040895063,141825.60522762357,353,69,198.51724137931035,29,0,20,28.0906151559519,0.6986350574712643,39.13194444444445,1043.472222222223,35.981800766283556,0
357,4,0,0,29,0.0,0.0,1.0,29,1000,600,400,0.6,14,6,8,427.3770683567091,0.38844417077175697,0.1255253161072467,0.2857798973104116,136213.00154321,5842.862654321005,142055.86419753102,354,70,199.51724137931035,29,0,20,27.87442345219089,0.6997126436781609,39.027777777777786,1043.8888888888898,35.99616858237551,0
358,4,0,0,29,0.0,0.0,1.0,29,900,700,200,0.7777777777777778,11,7,4,425.9827756295745,0.38813628899835795,0.12107259310895158,0.2857238617269199,136321.76167052475,5814.144483024697,142135.90615354944,355,71,200.51724137931035,29,0,22,27.80220663208761,0.7007902298850575,38.923611111111114,1044.3055555555559,36.010536398467444,0
359,4,0,0,29,0.0,0.0,1.0,29,950,900,50,0.9473684210526315,10,9,1,425.4583101221227,0.3866995073891626,0.10724302920310169,0.2868412477920118,136503.125,5815.277777777778,142318.40277777778,356,72,201.51724137931035,29,0,22,27.634901648059547,0.7025862068965517,38.75,1045.0,36.03448275862069,0
360,4,0,0,29,0.0,0.0,1.0,29,1250,800,450,0.64,17,8,9,420.2687578841331,0.38613505747126436,0.10663637363040013,0.28451287853882673,136648.30246913584,5685.802469135809,142334.10493827166,357,73,202.51724137931035,29,0,23,27.625752745306418,0.7040229885057472,38.611111111111114,1045.5555555555559,36.05363984674331,0
361,4,0,0,29,0.0,0.0,1.0,29,850,600,250,0.7058823529411765,11,6,5,424.9584964246317,0.3858784893267652,0.1087624939193963,0.2835824282535242,136140.51890432107,5770.814043209891,141911.33294753096,358,74,203.51724137931035,29,0,21,28.009937006476797,0.6989942528735631,39.09722222222223,1043.6111111111118,35.9865900383142,1
362,4,0,0,29,0.0,0.0,1.0,29,600,300,300,0.5,9,3,6,425.3767913275244,0.38603243021346473,0.10984926698327446,0.28415169660678646,136176.75781250012,5785.286458333348,141962.04427083346,359,75,204.51724137931035,29,0,21,27.962824351297403,0.699353448275862,39.06250000000001,1043.750000000001,35.99137931034486,0
363,4,0,0,29,0.0,0.0,1.0,29,900,500,400,0.5555555555555556,13,5,8,428.8482388924694,0.38495484400656815,0.11556929342218081,0.28764584373171076,136321.76167052475,5892.2694830246965,142214.03115354944,360,76,205.51724137931035,29,0,21,27.72739615197057,0.7007902298850575,38.923611111111114,1044.3055555555559,36.010536398467444,0
364,4,0,0,29,0.0,0.0,1.0,29,700,500,200,0.7142857142857143,9,5,4,424.17381936853,0.3844930213464696,0.11194748278612598,0.2853877879508124,136430.56520061736,5774.05478395063,142204.61998456798,361,77,206.51724137931035,29,0,21,27.740849064964998,0.701867816091954,38.81944444444445,1044.7222222222229,36.024904214559406,0
365,4,0,0,29,0.0,0.0,1.0,29,550,400,150,0.7272727272727273,7,4,3,424.1552484295912,0.3834154351395731,0.11023852941985002,0.2865522800431873,136575.70408950633,5785.860339506191,142361.5644290125,362,78,207.51724137931035,29,0,21,27.596554167773935,0.7033045977011494,38.680555555555564,1045.277777777779,36.04406130268203,0
366,4,0,0,29,0.0,0.0,1.0,29,450,0,450,0.0,9,0,9,425.7117581171712,0.3831588669950739,0.10939926609035067,0.28790048547600616,136612.00086805568,5831.467013888908,142443.46788194458,363,79,208.51724137931035,29,0,21,27.519679155041857,0.7036637931034482,38.64583333333334,1045.4166666666677,36.04885057471268,0
367,4,0,0,29,0.0,0.0,1.0,29,500,200,300,0.4,8,2,6,425.7117581171712,0.3831588669950739,0.10939926609035067,0.28790048547600616,136612.00086805568,5831.467013888908,142443.46788194458,364,80,209.51724137931035,29,0,21,27.519679155041857,0.7036637931034482,38.64583333333334,1045.4166666666677,36.04885057471268,0
368,4,0,0,29,0.0,0.0,1.0,29,1100,800,300,0.7272727272727273,14,8,6,424.9138902557102,0.38223522167487683,0.10386042038741561,0.288252395822117,136720.92013888896,5818.9670138889,142539.88715277787,365,81,210.51724137931035,28,1,21,27.43193891102258,0.7079613095238095,38.54166666666667,1045.833333333334,37.351190476190496,0
369,4,0,0,29,0.0,0.0,1.0,29,500,300,200,0.6,7,3,4,422.7500154239707,0.38095238095238093,0.10299509743336221,0.2876762300080189,136829.88281249997,5768.96701388889,142598.84982638885,366,82,211.51724137931035,29,0,22,27.379944909066783,0.7058189655172413,38.4375,1046.2499999999998,36.07758620689654,0
370,4,0,0,29,0.0,0.0,1.0,29,750,500,250,0.6666666666666666,10,5,5,421.5717054101427,0.3804392446633826,0.09829988787955002,0.28746993667560444,136902.5487075619,5742.848186728414,142645.3968942903,367,83,212.51724137931035,29,0,22,27.338393054633922,0.706537356321839,38.368055555555564,1046.527777777779,36.087164750957896,0
371,4,0,0,29,0.0,0.0,1.0,29,1000,600,400,0.6,14,6,8,418.4153107159533,0.3782840722495895,0.09959348664084589,0.28710371775332155,137120.66213348764,5674.676890432098,142795.33902391975,368,84,213.51724137931035,29,0,21,27.20392410378818,0.7086925287356322,38.15972222222222,1047.361111111111,36.11590038314176,0
372,4,0,0,29,0.0,0.0,1.0,29,700,600,100,0.8571428571428571,8,6,2,416.8517479356176,0.3783353858784893,0.09900537536109999,0.2869278819732025,137229.7839506173,5640.895061728398,142870.6790123457,369,85,214.51724137931035,29,0,21,27.136355602686468,0.7097701149425287,38.05555555555556,1047.7777777777778,36.13026819923372,0
373,4,0,0,29,0.0,0.0,1.0,29,600,400,200,0.6666666666666666,8,4,4,419.04150479854195,0.3772064860426929,0.09676004605010635,0.2896451719981131,137375.3472222222,5713.194444444441,143088.54166666663,370,86,215.51724137931035,29,0,21,26.934287228404873,0.7112068965517241,37.916666666666664,1048.3333333333333,36.14942528735632,0
374,4,0,0,29,0.0,0.0,1.0,29,950,800,150,0.8421052631578947,11,8,3,420.98235011630004,0.3769499178981937,0.0959250140461625,0.2912920037605821,137411.75009645073,5769.584297839519,143181.33439429026,371,87,216.51724137931035,29,0,21,26.847236940875167,0.711566091954023,37.88194444444445,1048.472222222223,36.154214559387,0
375,4,0,0,29,0.0,0.0,1.0,29,1200,900,300,0.75,15,9,6,422.0006065438901,0.37592364532019706,0.10299629742920136,0.2932263644182157,137557.40981867298,5809.862075617302,143367.2718942903,372,88,217.51724137931035,29,0,21,26.675796592965263,0.7130028735632183,37.743055555555564,1049.0277777777787,36.17337164750961,0
376,4,0,0,29,0.0,0.0,1.0,29,1000,800,200,0.8,12,8,4,423.86277380830853,0.37535919540229884,0.10023049362148817,0.2951413139282742,137630.2686149693,5867.269483024715,143497.53809799402,373,89,218.51724137931035,29,0,21,26.554572027354954,0.7137212643678159,37.67361111111112,1049.305555555557,36.18295019157093,0
377,4,0,0,29,0.0,0.0,1.0,29,850,600,250,0.7058823529411765,11,6,5,422.47441869845017,0.37438423645320196,0.09416831674133785,0.2951073619706924,137739.59297839538,5838.290895061772,143577.88387345715,374,90,219.51724137931035,29,0,22,26.482424803739974,0.7147988505747125,37.569444444444464,1049.7222222222247,36.19731800766292,0
378,4,0,1,28,0.0,0.034482758620689655,0.9655172413793104,29,850,600,250,0.7058823529411765,11,6,5,421.64791217921936,0.3740250410509031,0.093202509552337,0.2958009825364776,137887.9413561899,5828.051807629095,143715.993163819,375,91,220.51724137931035,28,1,22,26.356874145006838,0.7194940476190474,37.42816091954024,1050.2873563218404,37.51026272578002,0
379,4,0,1,27,0.0,0.03571428571428571,0.9642857142857143,28,750,400,350,0.5333333333333333,11,4,7,426.0546709059978,0.3708664021164021,0.08897791674809441,0.2988924802613096,137887.94135618987,6149.560295283415,144037.50165147329,376,92,221.07142857142858,28,0,22,26.24116507067944,0.7194940476190476,37.42816091954024,1050.2873563218402,37.51026272578001,0
380,4,0,0,27,0.0,0.0,1.0,27,700,500,200,0.7142857142857143,9,5,4,436.6692814118556,0.36918328584995247,0.08675058157547899,0.30463189335289975,137695.3374123086,6625.464808319152,144320.80222062775,377,93,223.66666666666666,27,0,22,26.15391204688312,0.7210648148148148,37.61160714285714,1049.5535714285709,38.87235449735448,0
381,4,0,0,27,0.0,0.0,1.0,27,850,600,250,0.7058823529411765,11,6,5,436.4683480660458,0.36864909781576444,0.08466808410111026,0.3051817835090142,137773.44026803426,6626.749176232992,144400.18944426725,378,94,224.66666666666666,27,0,22,26.08153201039452,0.7218364197530864,37.53720238095238,1049.8511904761904,38.88337742504409,0
382,4,0,0,27,0.0,0.0,1.0,27,600,400,200,0.6666666666666666,8,4,4,436.4683480660458,0.36864909781576444,0.08466808410111026,0.3051817835090142,137773.44026803426,6626.749176232992,144400.18944426725,379,95,225.66666666666666,27,0,22,26.08153201039452,0.7218364197530864,37.53720238095238,1049.8511904761904,38.88337742504409,0
383,4,0,0,27,0.0,0.0,1.0,27,700,400,300,0.5714285714285714,10,4,6,432.46015426084216,0.367818138651472,0.08433823452242284,0.30340991737306405,137890.63607213722,6526.441149376424,144417.07722151364,380,96,226.66666666666666,27,0,22,26.07029847926702,0.7229938271604939,37.42559523809524,1050.2976190476193,38.89991181657849,0
384,4,0,0,27,0.0,0.0,1.0,27,700,600,100,0.8571428571428571,8,6,2,435.2911908449632,0.36775878442545107,0.08313922988143951,0.3060912158730519,137968.79428854882,6611.320153061236,144580.11444161006,381,97,227.66666666666666,27,0,22,25.918319169027377,0.7237654320987654,37.35119047619048,1050.5952380952385,38.9109347442681,0
385,4,0,0,27,0.0,0.0,1.0,27,1050,700,350,0.6666666666666666,14,7,7,433.89094882703216,0.3671652421652422,0.07839436265257338,0.30650056625141564,138125.17715419506,6586.252834467127,144711.4299886622,382,98,228.66666666666666,27,0,21,25.79983012457531,0.7253086419753085,37.202380952380956,1051.1904761904766,38.93298059964728,0
386,4,0,0,27,0.0,0.0,1.0,27,1000,900,100,0.9,11,9,2,449.6513429752067,0.3671652421652422,0.09132996632996626,0.3091352982954544,137188.20861677994,6937.372448979577,144125.58106575953,383,99,229.66666666666666,27,0,20,26.318655303030305,0.7160493827160495,38.09523809523809,1047.6190476190468,38.800705467372104,3
387,4,0,0,27,0.0,0.0,1.0,27,450,0,450,0.0,9,0,9,450.37923552126597,0.3660375118708452,0.09277667329357175,0.3103298020098587,137266.16753472228,6964.36631944445,144230.53385416672,384,100,230.66666666666666,27,0,20,26.221835652750162,0.716820987654321,38.020833333333336,1047.916666666667,38.81172839506174,0
388,4,0,0,27,0.0,0.0,1.0,27,950,700,250,0.7368421052631579,12,7,5,449.7971200808536,0.3649097815764482,0.09772815676874713,0.3113232326217777,137422.15180342985,6962.417623299337,144384.5694267292,385,101,231.66666666666666,27,0,21,26.08158293121393,0.7183641975308641,37.87202380952382,1048.5119047619057,38.83377425044095,0
389,4,0,0,27,0.0,0.0,1.0,27,800,600,200,0.75,10,6,4,450.1524852734844,0.3639601139601139,0.09146866662465092,0.3136833326233804,137656.29428854867,6993.264597505659,144649.55888605432,386,102,232.66666666666666,27,0,21,25.839005483078097,0.720679012345679,37.64880952380952,1049.4047619047612,38.866843033509674,0
390,4,0,0,27,0.0,0.0,1.0,27,400,200,200,0.5,6,2,4,449.02183962367667,0.3633072174738841,0.09702926629493125,0.31360396601043716,137734.38607213725,6969.1494827097595,144703.535554847,387,103,233.66666666666666,27,0,21,25.790922408089973,0.7214506172839505,37.574404761904766,1049.7023809523814,38.87786596119931,0
391,4,0,0,27,0.0,0.0,1.0,27,800,400,400,0.5,12,4,8,446.86434067449187,0.3627730294396961,0.09554558101687793,0.31245073572433507,137773.44026803426,6913.207509566326,144686.6477776006,388,104,234.66666666666666,27,0,21,25.808675879990556,0.7218364197530864,37.53720238095238,1049.8511904761904,38.88337742504409,0
392,4,0,0,27,0.0,0.0,1.0,27,750,600,150,0.8,9,6,3,447.2539837308023,0.36170465337132,0.09844358385021468,0.3137891269554674,137890.63607213716,6934.427260487518,144825.06333262468,389,105,235.66666666666666,27,0,21,25.68185038254462,0.7229938271604939,37.425595238095234,1050.2976190476188,38.899911816578474,0
393,4,0,0,27,0.0,0.0,1.0,27,600,500,100,0.8333333333333334,7,5,2,444.73812601018255,0.36146723646723644,0.09519762005949839,0.3123787494035699,137929.71241230867,6868.520363874711,144798.23277618337,390,106,236.66666666666666,27,0,21,25.709053454219195,0.7233796296296295,37.388392857142854,1050.4464285714284,38.90542328042328,0
394,4,0,0,27,0.0,0.0,1.0,27,700,500,200,0.7142857142857143,9,5,4,467.54070809430317,0.36099240265906934,0.11959534294632324,0.3039666984996356,135207.73820595938,7243.024332128673,142450.76253808805,391,107,237.66666666666666,27,0,19,27.836153240806983,0.6963734567901234,39.99255952380952,1040.0297619047612,38.51962081128745,5
395,4,0,0,27,0.0,0.0,1.0,27,600,300,300,0.5,9,3,6,465.6314662980566,0.3605175688509022,0.11481428503313751,0.30337647538580753,135285.13244490515,7198.602917729601,142483.73536263476,392,108,238.66666666666666,27,0,19,27.8079256663329,0.6971450617283951,39.918154761904766,1040.3273809523816,38.5306437389771,0
396,4,0,0,27,0.0,0.0,1.0,27,550,500,50,0.9090909090909091,6,5,1,464.1787410522127,0.3602801519468186,0.11390795830155098,0.3027553878206223,135323.8378684807,7162.889739229023,142486.72760770973,393,109,239.66666666666666,27,0,19,27.806779176201374,0.6975308641975309,39.88095238095238,1040.4761904761904,38.53615520282187,0
397,4,0,0,27,0.0,0.0,1.0,27,850,700,150,0.8235294117647058,10,7,3,465.3055033326241,0.35778727445394115,0.1197721449293776,0.3048012454414829,135478.71492346935,7207.798327664394,142686.51325113373,394,110,240.66666666666666,27,0,19,27.621736230226784,0.6990740740740741,39.732142857142854,1041.0714285714282,38.55820105820104,0
398,4,0,0,27,0.0,0.0,1.0,27,550,300,250,0.5454545454545454,8,3,5,465.71726395164467,0.3581433998100665,0.11619794726840604,0.30540053382096155,135517.4480273881,7222.563022604887,142740.011049993,395,111,241.66666666666666,27,0,19,27.57208446477063,0.6994598765432098,39.69494047619048,1041.2202380952385,38.56371252204587,0
399,4,0,0,27,0.0,0.0,1.0,27,600,500,100,0.8333333333333334,7,5,2,465.47656085301315,0.35844017094017094,0.11321753305177129,0.30557269914159324,135556.18666737518,7219.645514455768,142775.83218183095,396,112,242.66666666666666,27,0,19,27.539416023625797,0.6998456790123457,39.65773809523809,1041.3690476190468,38.56922398589062,0
400,4,0,0,27,0.0,0.0,1.0,27,1650,1400,250,0.8484848484848485,19,14,5,445.336847551814,0.3588556505223172,0.042577173785901756,0.282533377053364,134319.29607780612,6563.466376133787,140882.7624539399,397,113,243.66666666666666,27,0,20,29.307230356971953,0.6875,40.848214285714285,1036.607142857143,38.392857142857146,6
401,4,2,1,28,0.06896551724137931,0.034482758620689655,0.9655172413793104,29,900,600,300,0.6666666666666666,12,6,6,418.78214209692663,0.3727935139573071,0.024610790034012675,0.2705810006191024,134983.42013888893,5505.729166666673,140489.14930555562,398,0,227.79310344827587,29,0,18,29.3287222667736,0.6875,40.208333333333336,1039.166666666667,35.83333333333334,0
402,4,0,1,27,0.0,0.03571428571428571,0.9642857142857143,28,500,200,300,0.4,8,2,6,432.1115564116208,0.36397707231040566,0.056116778470209905,0.2695267749610787,133695.01626701024,5954.23231272296,139649.2485797332,399,1,236.92857142857142,28,0,18,30.278954802259893,0.6778273809523809,41.45114942528736,1034.1954022988511,36.93555008210183,6
403,4,0,0,27,0.0,0.0,1.0,27,400,400,0,1.0,4,4,0,440.7618509750967,0.3577279202279202,0.07196254705612626,0.27384005517647775,133549.11821499432,6372.671308106578,139921.7895231009,400,116,246.66666666666666,27,0,18,30.202634609847394,0.6797839506172839,41.592261904761905,1033.6309523809523,38.282627865961196,0
404,4,0,0,27,0.0,0.0,1.0,27,450,100,350,0.2222222222222222,8,1,7,441.1386887443183,0.35713437796771125,0.07344497225021196,0.2743590394545013,133587.5745154833,6386.129490858847,139973.70400634216,401,117,247.66666666666666,27,0,18,30.154053308382522,0.6801697530864197,41.555059523809526,1033.7797619047622,38.28813932980601,0
405,4,0,0,27,0.0,0.0,1.0,27,900,600,300,0.6666666666666666,12,6,6,442.47770012220076,0.3566001899335232,0.0707477771381051,0.27547805201156356,133626.0363520408,6425.308248299313,140051.34460034012,402,118,248.66666666666666,27,0,18,30.080598733448475,0.6805555555555556,41.51785714285714,1033.928571428571,38.293650793650784,0
406,4,0,0,27,0.0,0.0,1.0,27,900,700,200,0.7777777777777778,11,7,4,439.9274275416332,0.3560660018993352,0.06922531796650655,0.2747471292760012,133741.455078125,6367.306857638889,140108.76193576388,403,119,249.66666666666666,27,0,18,30.030001678415573,0.681712962962963,41.40625,1034.375,38.31018518518518,0
407,4,0,0,27,0.0,0.0,1.0,27,700,600,100,0.8571428571428571,8,6,2,439.9274275416332,0.3560660018993352,0.06922531796650655,0.2747471292760012,133741.455078125,6367.306857638889,140108.76193576388,404,120,250.66666666666666,27,0,18,30.030001678415573,0.681712962962963,41.40625,1034.375,38.31018518518518,0
408,4,1,1,27,0.03571428571428571,0.03571428571428571,0.9642857142857143,28,700,400,300,0.5714285714285714,10,4,6,431.0911587084786,0.3621307319223986,0.06364564136099693,0.2718929276578671,134103.95455558857,5962.205831351564,140066.16038694014,405,0,242.67857142857142,28,0,18,29.893189069219027,0.6819196428571428,41.05603448275862,1035.7758620689654,36.99199507389162,0
409,4,0,0,27,0.0,0.0,1.0,27,750,600,150,0.8,9,6,3,443.4341486752712,0.35582858499525166,0.07635360410741532,0.2778055017916969,133856.92362882648,6471.346194727886,140328.26982355438,406,122,252.66666666666666,27,0,18,29.822763876905388,0.6828703703703703,41.294642857142854,1034.821428571428,38.326719576719555,0
410,4,0,0,27,0.0,0.0,1.0,27,600,400,200,0.6666666666666666,8,4,4,445.98236273962056,0.3555911680911681,0.07962297308091681,0.2796940787064078,133895.42421786432,6542.999530541394,140438.4237484057,407,123,253.66666666666666,27,0,18,29.71797867241792,0.6832561728395061,41.25744047619048,1034.9702380952388,38.3322310405644,0
411,4,0,0,27,0.0,0.0,1.0,27,650,500,150,0.7692307692307693,8,5,3,445.9246174342893,0.355650522317189,0.0799096969309736,0.2799505089235482,133933.93034297042,6544.887329931956,140478.81767290237,408,124,254.66666666666666,27,0,18,29.680611462526347,0.683641975308642,41.22023809523809,1035.1190476190468,38.33774250440914,0
412,4,0,0,27,0.0,0.0,1.0,27,650,600,50,0.9230769230769231,7,6,1,444.2350636259217,0.35529439696106363,0.07810944479048554,0.27918187331938005,133972.4420041454,6503.051259566329,140475.49326371175,409,125,255.66666666666666,27,0,18,29.685478654592504,0.6840277777777779,41.183035714285715,1035.267857142857,38.34325396825397,0
413,4,0,0,27,0.0,0.0,1.0,27,650,500,150,0.7692307692307693,8,5,3,442.44179274246085,0.3549382716049383,0.07957720617585551,0.2786382294746409,134049.4819347008,6461.8186206774135,140511.30055537823,410,126,256.6666666666667,27,0,19,29.65419480768309,0.6847993827160495,41.10863095238094,1035.565476190475,38.35427689594352,0
414,4,0,0,27,0.0,0.0,1.0,27,850,500,350,0.5882352941176471,12,5,7,435.80696712722255,0.3529202279202279,0.07476555975766108,0.2756152508725567,134203.62822863512,6297.375239158153,140501.00346779329,411,127,257.6666666666667,27,0,19,29.67066996984058,0.6863425925925926,40.95982142857142,1036.1607142857138,38.37632275132273,0
415,4,1,0,28,0.03571428571428571,0.0,1.0,28,650,400,250,0.6153846153846154,9,4,5,421.29455973972887,0.35796957671957674,0.0570775804090673,0.2692556911894088,134588.05035341508,5740.242683974078,140328.29303738914,412,0,249.42857142857142,28,0,20,29.660239545832177,0.6867559523809524,40.5890804597701,1037.6436781609182,37.058702791461364,0
416,4,0,0,28,0.0,0.0,1.0,28,700,500,200,0.7142857142857143,9,5,4,422.3863220028496,0.35722552910052907,0.056623826000988364,0.27078448770812646,134699.88862878174,5779.078106420907,140478.96673520264,413,1,250.42857142857142,28,0,20,29.519607843137244,0.687872023809524,40.48132183908045,1038.0747126436772,37.07409688013133,0
417,4,0,0,28,0.0,0.0,1.0,28,500,400,100,0.8,6,4,2,425.846650847646,0.3568948412698412,0.05746802664610873,0.27356388850452773,134774.4732832936,5878.65161348922,140653.12489678283,414,2,251.42857142857142,28,0,20,29.35490752271573,0.6886160714285715,40.40948275862068,1038.3620689655165,37.0843596059113,0
418,4,0,0,28,0.0,0.0,1.0,28,700,600,100,0.8571428571428571,8,6,2,426.43893872350674,0.3573082010582011,0.05386287295000969,0.2747908669314575,134886.3889714625,5904.161712247319,140790.55068370982,415,3,252.42857142857142,28,0,17,29.227178423236513,0.6897321428571429,40.30172413793103,1038.7931034482756,37.099753694581274,0
419,4,0,1,27,0.0,0.03571428571428571,0.9642857142857143,28,700,600,100,0.8571428571428571,8,6,2,428.566329139216,0.35576499118165783,0.05096962755243095,0.2773031149367698,135035.68214096958,5974.349319593053,141010.03146056263,416,4,253.42857142857142,28,0,17,29.022094737812182,0.6912202380952381,40.15804597701148,1039.3678160919528,37.12027914614117,0
420,4,0,0,27,0.0,0.0,1.0,27,1000,800,200,0.8,12,8,4,440.32807612417,0.3496557454890788,0.06388623580600705,0.28353228517958523,134859.7381660996,6476.505810657575,141336.24397675716,417,133,263.6666666666667,27,0,17,28.893266475644705,0.6929012345679013,40.32738095238094,1038.6904761904748,38.470017636684254,0
421,4,0,0,27,0.0,0.0,1.0,27,500,300,200,0.6,7,3,4,441.2613515133606,0.3501899335232668,0.06565970066901183,0.284436333787144,134898.3826929209,6505.0885328089535,141403.47122572985,418,134,264.6666666666667,27,0,17,28.830187890942085,0.6932870370370371,40.29017857142857,1038.8392857142853,38.47552910052909,0
422,4,0,0,27,0.0,0.0,1.0,27,400,200,200,0.5,6,2,4,441.2613515133606,0.3501899335232668,0.06565970066901183,0.284436333787144,134898.3826929209,6505.0885328089535,141403.47122572985,419,135,265.6666666666667,27,0,17,28.830187890942085,0.6932870370370371,40.29017857142857,1038.8392857142853,38.47552910052909,0
423,4,0,0,27,0.0,0.0,1.0,27,950,700,250,0.7368421052631579,12,7,5,444.37680109725795,0.3501899335232668,0.06712598320789676,0.2870567254451573,134975.68835476888,6596.012923398512,141571.7012781674,420,136,266.6666666666667,27,0,17,28.671565468518786,0.6940586419753088,40.2157738095238,1039.136904761904,38.48655202821866,0
424,4,0,0,27,0.0,0.0,1.0,27,800,600,200,0.75,10,6,4,447.8846799846179,0.34882478632478636,0.07361820099761962,0.29056362665297353,135130.36611128828,6704.564156391721,141834.93026768,421,137,267.6666666666667,27,0,17,28.42496183388197,0.6956018518518519,40.066964285714285,1039.732142857143,38.508597883597886,0
425,4,0,0,27,0.0,0.0,1.0,27,500,500,0,1.0,5,5,0,453.07434552977804,0.34882478632478636,0.07078957604045133,0.25714219478080796,130110.72137188216,6389.965986394571,136500.68735827674,422,138,268.6666666666667,27,0,17,33.384383508362504,0.6450617283950617,44.9404761904762,1020.2380952380959,37.78659611992948,7
426,4,1,0,28,0.03571428571428571,0.0,1.0,28,900,500,400,0.5555555555555556,13,5,8,442.201224462149,0.35653659611992944,0.08414996586208279,0.25410496856411374,130592.80659598364,5949.659796538517,136542.46639252215,423,0,260.0357142857143,28,0,16,33.16875175709868,0.6465773809523809,44.4683908045977,1022.1264367816094,36.50451559934319,0
427,4,1,1,28,0.034482758620689655,0.034482758620689655,0.9655172413793104,29,500,300,200,0.6,7,3,4,429.99419067795134,0.36627668308702793,0.07269869338834822,0.24976258309591642,131008.0078125,5466.536458333333,136474.54427083334,424,0,252.0344827586207,29,0,17,33.057336182336186,0.6476293103448276,44.0625,1023.75,35.30172413793103,0
428,4,1,0,29,0.034482758620689655,0.0,1.0,29,700,500,200,0.7142857142857143,9,5,4,428.9204251651824,0.3606834975369458,0.08219754529514889,0.2500623032089503,131150.23389274697,5450.602816358032,136600.836709105,425,0,253.0,29,0,18,32.93997175141244,0.649066091954023,43.923611111111114,1024.3055555555559,35.32088122605365,0
429,4,1,1,29,0.03333333333333333,0.03333333333333333,0.9666666666666667,30,750,400,350,0.5333333333333333,11,4,7,417.5918338797353,0.368845785440613,0.06975575654301558,0.24525081606378013,131431.4719367847,4976.941879118987,136408.4138159037,426,0,245.53333333333333,30,0,18,32.94419321011929,0.6489583333333333,43.6491935483871,1025.4032258064524,34.18010752688175,0
430,4,1,1,29,0.03333333333333333,0.03333333333333333,0.9666666666666667,30,1100,900,200,0.8181818181818182,13,9,4,416.66751814345344,0.3682710727969349,0.07244572576770181,0.2451495629107706,131500.39247673156,4958.388433633969,136458.78091036552,427,0,246.5,30,0,18,32.89788363255144,0.6496527777777776,43.58198924731184,1025.672043010754,34.18906810035846,0
431,4,0,0,29,0.0,0.0,1.0,29,500,300,200,0.6,7,3,4,424.5820331507145,0.3607861247947455,0.07958637503678045,0.24937861183386842,131434.9175347223,5360.980902777782,136795.8984375001,428,3,256.0,29,0,18,32.761496004334276,0.6519396551724137,43.645833333333336,1025.4166666666672,35.359195402298866,0
432,4,0,0,29,0.0,0.0,1.0,29,1100,800,300,0.7272727272727273,14,8,6,421.1587377476985,0.36037561576354676,0.07732355893820153,0.2478292652005385,131506.13667052487,5276.991705246937,136783.1283757718,429,4,257.0,29,0,18,32.77688445046265,0.6526580459770115,43.5763888888889,1025.694444444446,35.36877394636021,0
433,4,0,0,29,0.0,0.0,1.0,29,1000,800,200,0.8,12,8,4,421.88139856581256,0.36022167487684725,0.07645202845247678,0.24895046107062496,131613.00154320995,5305.0154320987795,136918.01697530874,430,5,258.0,29,0,18,32.64979245623534,0.6537356321839081,43.47222222222223,1026.1111111111118,35.38314176245213,0
434,4,0,0,29,0.0,0.0,1.0,29,950,700,250,0.7368421052631579,12,7,5,424.1733669891359,0.3591954022988506,0.07192264817138283,0.2514766401083146,131791.20611496922,5380.463927469144,137171.67004243837,431,6,259.0,29,0,18,32.41002186753234,0.6555316091954022,43.298611111111114,1026.805555555556,35.40708812260538,0
435,4,0,0,29,0.0,0.0,1.0,29,600,500,100,0.8333333333333334,7,5,2,425.9358763496324,0.35827175697865354,0.0699352865481806,0.25323325896156623,131898.18672839514,5436.033950617295,137334.22067901245,432,7,260.0,29,0,18,32.25617450874346,0.6566091954022988,43.19444444444445,1027.2222222222229,35.42145593869734,0
436,4,0,0,29,0.0,0.0,1.0,29,850,500,350,0.5882352941176471,12,5,7,425.0744974802348,0.3576559934318555,0.07328227193689885,0.2529586530861862,131933.85657793196,5416.34355709875,137350.20013503073,433,8,261.0,29,0,18,32.24209702131495,0.6569683908045978,43.159722222222214,1027.3611111111102,35.426245210727934,0
437,4,0,0,29,0.0,0.0,1.0,29,850,600,250,0.7058823529411765,11,6,5,426.93586968472346,0.35662972085385874,0.07242358007372829,0.25454460111178656,132005.21074459888,5471.551890432115,137476.762635031,434,9,262.0,29,0,18,32.121880209037265,0.6576867816091954,43.090277777777786,1027.6388888888898,35.435823754789304,0
438,4,0,0,29,0.0,0.0,1.0,29,700,400,300,0.5714285714285714,10,4,6,425.71219868517176,0.3563218390804597,0.0729729729729729,0.2540540540540541,132040.8950617284,5442.283950617287,137483.17901234567,435,10,263.0,29,0,18,32.11711711711713,0.6580459770114943,43.05555555555556,1027.7777777777778,35.440613026819925,0
439,4,1,0,30,0.03333333333333333,0.0,1.0,30,550,300,250,0.5454545454545454,8,3,5,414.1294034278577,0.36240421455938693,0.06019679554162316,0.2492590182895974,132363.4235171696,4963.117123366864,137326.54064053646,436,0,255.2,30,0,19,32.08812260536399,0.6583333333333334,42.74193548387097,1029.032258064516,34.3010752688172,0
440,4,1,1,30,0.03225806451612903,0.03225806451612903,0.967741935483871,31,700,300,400,0.42857142857142855,11,3,8,403.03059451555873,0.36630824372759857,0.0527021683387483,0.24475679926336286,132699.68880547423,4496.406894259987,137196.09569973423,437,0,247.93548387096774,31,0,16,32.033915708328074,0.6589381720430108,42.415364583333336,1030.338541666667,33.23672715053765,0
441,4,0,0,30,0.0,0.0,1.0,30,350,300,50,0.8571428571428571,4,3,1,413.0405142853245,0.36235632183908045,0.06016536118363747,0.24951816556984127,132501.77043588858,4945.7198809110905,137447.49031679967,438,2,257.2,30,0,20,31.976174934725833,0.6597222222222221,42.60752688172043,1029.5698924731187,34.31899641577062,0
442,4,0,0,30,0.0,0.0,1.0,30,600,400,200,0.6666666666666666,8,4,4,414.39578386244546,0.36192528735632185,0.056373444705472675,0.25079782748452273,132570.97099375652,4987.370288472654,137558.34128222917,439,3,258.2,30,0,20,31.871302096928552,0.6604166666666667,42.54032258064516,1029.8387096774195,34.32795698924732,0
443,4,0,0,30,0.0,0.0,1.0,30,750,600,150,0.8,9,6,3,416.4973108837943,0.3620450191570881,0.05510931455643897,0.2537027702277855,132813.31521346405,5063.2777271939085,137876.59294065795,440,4,259.2,30,0,16,31.572184552527503,0.6628472222222221,42.30510752688173,1030.7795698924738,34.359318996415794,0
444,4,0,1,29,0.0,0.03333333333333333,0.9666666666666667,30,400,300,100,0.75,5,3,2,416.42662024957116,0.36240421455938693,0.05873967840069527,0.2538944497070121,132847.9538819518,5064.284888426427,137912.23877037823,441,5,260.2,30,0,16,31.539004780530217,0.6631944444444444,42.271505376344095,1030.9139784946246,34.36379928315416,0
445,4,0,0,29,0.0,0.0,1.0,29,550,400,150,0.7272727272727273,7,4,3,414.7248534203404,0.35688628899835795,0.0753420501066644,0.2444990017730292,131577.3750964507,5113.681520061739,136691.05661651245,442,17,270.0,29,0,16,32.86953995758314,0.6533764367816092,43.50694444444445,1025.9722222222229,35.37835249042148,4
446,4,0,1,28,0.0,0.034482758620689655,0.9655172413793104,29,700,500,200,0.7142857142857143,9,5,4,414.7248534203404,0.35688628899835795,0.0753420501066644,0.2444990017730292,131577.3750964507,5113.681520061739,136691.05661651245,443,18,271.0,29,0,16,32.86953995758314,0.6533764367816092,43.50694444444445,1025.9722222222229,35.37835249042148,0
447,4,0,0,28,0.0,0.0,1.0,28,850,500,350,0.5882352941176471,12,5,7,426.60792816354484,0.3551311728395062,0.07007283933323993,0.2510761747040022,131512.27715434664,5620.836016977143,137133.11317132378,444,19,268.64285714285717,28,0,19,32.63091235934072,0.655877976190476,43.570402298850574,1025.7183908045974,36.632799671592764,0
448,4,0,0,28,0.0,0.0,1.0,28,700,600,100,0.8571428571428571,8,6,2,431.6117926025271,0.3556547619047619,0.026361506140918145,0.2384655154128959,129055.35737878171,5540.362828643131,134595.72020742483,445,20,269.64285714285717,28,0,17,35.01307975113123,0.6309523809523812,45.977011494252864,1016.0919540229871,36.28899835796383,8
449,4,2,2,28,0.06666666666666667,0.06666666666666667,0.9333333333333333,30,950,800,150,0.8421052631578947,11,8,3,409.44989332664346,0.37147988505747126,0.008589523683863565,0.23003860204022458,129714.32978162212,4622.303698404439,134336.63348002656,446,0,252.6,30,0,17,34.90181202445355,0.6315972222222221,45.329301075268816,1018.6827956989243,33.95609318996414,0
450,4,0,0,28,0.0,0.0,1.0,28,450,300,150,0.6666666666666666,6,3,3,431.5394682243291,0.3559303350970018,0.02691686844229202,0.24019649646448488,129347.50297265152,5563.710529792561,134911.2135024441,447,22,271.64285714285717,28,0,19,34.715160075329564,0.6339285714285715,45.68965517241379,1017.2413793103441,36.330049261083715,0
451,4,2,2,28,0.06666666666666667,0.06666666666666667,0.9333333333333333,30,400,300,100,0.75,5,3,2,409.5401226898928,0.36843869731800766,0.005996658753187223,0.23069340343497524,129817.03990345703,4633.057289860096,134450.09719331714,448,0,254.46666666666667,30,0,17,34.794579266684245,0.632638888888889,45.22849462365591,1019.0860215053762,33.969534050179206,0
452,4,1,1,28,0.034482758620689655,0.034482758620689655,0.9655172413793104,29,350,200,150,0.5714285714285714,5,2,3,421.3909726888582,0.3626334154351396,0.021442980950544754,0.23642387167003795,129660.70842978392,5127.570408950616,134788.27883873452,449,0,264.2068965517241,29,0,17,34.65256943497432,0.6339798850574713,45.38194444444444,1018.4722222222221,35.119731800766274,0
453,4,1,1,28,0.034482758620689655,0.034482758620689655,0.9655172413793104,29,450,300,150,0.6666666666666666,6,3,3,424.5923064756467,0.3649425287356322,0.017767833640431663,0.23886573315225015,129766.82098765425,5219.598765432089,134986.41975308635,450,0,265.17241379310343,29,0,17,34.46246819338421,0.635057471264368,45.27777777777777,1018.8888888888883,35.13409961685822,0
454,4,0,0,28,0.0,0.0,1.0,28,850,600,250,0.7058823529411765,11,6,5,432.54867400995863,0.3563712522045855,0.029216199879105176,0.24300872414664065,129713.14944180199,5621.4501585414055,135334.59960034338,451,26,275.64285714285717,28,0,18,34.31476257639868,0.6376488095238095,45.330459770114935,1018.6781609195394,36.38136288998355,0
455,4,1,1,28,0.034482758620689655,0.034482758620689655,0.9655172413793104,29,650,500,150,0.7692307692307693,8,5,3,418.9810793677555,0.36499384236453203,0.020853098375900547,0.2369922253249661,129979.17631172828,5091.763117283934,135070.9394290122,452,0,267.1034482758621,29,0,18,34.388336511395636,0.6372126436781611,45.069444444444436,1019.7222222222213,35.16283524904211,0
456,4,0,0,28,0.0,0.0,1.0,28,300,200,100,0.6666666666666666,4,2,2,427.36856763664497,0.3557925485008819,0.026429477754727815,0.24077245831983476,129822.94401918996,5496.449126370702,135319.39314556067,453,28,277.64285714285717,28,0,18,34.33432022181493,0.638764880952381,45.222701149425276,1019.1091954022977,36.39675697865349,0
457,4,0,0,28,0.0,0.0,1.0,28,800,600,200,0.75,10,6,4,429.08796631405414,0.35615079365079366,0.025389445719116166,0.24287610724857683,130006.03819857296,5556.805307834566,135562.84350640752,454,29,278.64285714285717,28,0,18,34.10320982436368,0.640625,45.04310344827585,1019.8275862068951,36.422413793103395,0
458,4,1,0,29,0.034482758620689655,0.0,1.0,29,450,300,150,0.6666666666666666,6,3,3,418.57189236629335,0.3641215106732348,0.021434212010679188,0.23547878852754045,129766.82098765424,5063.348765432087,134830.16975308632,455,0,270.0,29,0,20,34.615821519447465,0.635057471264368,45.27777777777777,1018.8888888888882,35.134099616858215,5
459,4,0,0,29,0.0,0.0,1.0,29,350,100,250,0.2857142857142857,6,1,5,415.5231328669831,0.3631978653530377,0.018608847661205852,0.23418653986005553,129837.58680555562,4990.104166666673,134827.6909722223,456,1,271.0,29,0,20,34.62115017715998,0.6357758620689655,45.208333333333336,1019.1666666666672,35.143678160919556,0
460,4,0,0,29,0.0,0.0,1.0,29,400,200,200,0.5,6,2,4,415.31948553200573,0.3627360426929393,0.015223346223059542,0.23428360525129815,129872.97694830243,4987.755594135795,134860.73254243823,457,2,272.0,29,0,20,34.59017463777989,0.6361350574712643,45.17361111111111,1019.3055555555552,35.14846743295018,0
461,4,2,1,30,0.06451612903225806,0.03225806451612903,0.967741935483871,31,1000,800,200,0.8,12,8,4,394.7702478022845,0.37939068100358425,0.00421061288266622,0.22589150940984126,130428.79104614271,4097.881232367636,134526.67227851035,458,0,255.38709677419354,31,0,21,34.547615253877204,0.6360887096774193,44.62890625000001,1021.484375000001,32.95110887096777,0
462,4,2,1,31,0.0625,0.03125,0.96875,32,500,200,300,0.4,8,2,6,383.3402748854642,0.3848916330645162,0.006249999999999867,0.21841480778357858,130262.58680555563,3586.9791666666756,133849.5659722223,459,0,248.34375,32,0,21,35.00850340136054,0.6318359375,44.79166666666667,1020.833333333334,31.90104166666669,1
463,4,0,0,31,0.0,0.0,1.0,31,600,500,100,0.8333333333333334,7,5,2,392.85964622906374,0.3785394265232975,0.016861795847124217,0.22307595564137275,130129.69970703125,4024.5415581597213,134154.24126519097,460,1,257.35483870967744,31,0,21,34.9008848051727,0.6330645161290323,44.921875,1020.3125,32.913306451612904,0
464,4,1,1,31,0.03125,0.03125,0.96875,32,400,300,100,0.75,5,3,2,383.9869812178895,0.38518565188172044,0.007250764915859298,0.21953308168171476,130395.54172092017,3614.1059027777824,134009.64762369797,461,0,250.28125,31,1,22,34.85679075301717,0.635752688172043,44.661458333333336,1021.354166666667,32.94690860215055,0
465,4,1,0,32,0.03125,0.0,1.0,32,450,300,150,0.6666666666666666,6,3,3,383.69326949984196,0.38222446236559143,0.012460972346119537,0.21992995513259755,130495.30241224504,3614.0338473849865,134109.33625963004,462,0,251.25,31,1,20,34.762887090607876,0.636760752688172,44.563802083333336,1021.744791666667,32.95950940860216,0
466,4,0,0,32,0.0,0.0,1.0,32,900,600,300,0.6666666666666666,12,6,6,386.3641315553646,0.3825184811827957,0.011419723602089205,0.222223062039646,130628.37600708005,3694.023810492621,134322.39981757267,463,1,252.25,31,1,20,34.559424489449334,0.6381048387096775,44.43359375,1022.2656249999998,32.97631048387096,0
467,4,0,0,32,0.0,0.0,1.0,32,650,300,350,0.46153846153846156,10,3,7,386.84020034849163,0.3824974798387097,0.014331869111281481,0.22307216839479085,130728.22570800777,3714.1866048177058,134442.41231282547,464,2,253.25,31,1,20,34.44582378405909,0.6391129032258065,44.3359375,1022.6562499999997,32.98891129032257,0
468,4,0,1,31,0.0,0.03125,0.96875,32,1000,700,300,0.7,13,7,6,384.39422315510797,0.3821614583333333,0.014635783043317252,0.2223230828141216,130843.25140610668,3659.077995867787,134502.32940197445,465,3,254.25,32,0,21,34.391583364186104,0.6376953125,44.22348484848486,1023.1060606060619,31.972064393939434,0
469,4,1,0,32,0.03125,0.0,1.0,32,800,700,100,0.875,9,7,2,382.62492888953545,0.3787172379032258,0.026077001356852314,0.22204297054455718,130972.4633487655,3622.6658950617407,134595.12924382722,466,0,255.03125,32,0,22,34.30574400723655,0.6389973958333333,44.09722222222223,1023.6111111111117,31.98784722222224,0
470,4,0,0,32,0.0,0.0,1.0,32,850,600,250,0.7058823529411765,11,6,5,382.62492888953545,0.3787172379032258,0.026077001356852314,0.22204297054455718,130972.4633487655,3622.6658950617407,134595.12924382722,467,1,256.03125,32,0,22,34.30574400723655,0.6389973958333333,44.09722222222223,1023.6111111111117,31.98784722222224,0
471,4,0,0,32,0.0,0.0,1.0,32,600,300,300,0.5,9,3,6,382.6731482770341,0.37863323252688175,0.02734230484646738,0.22244419780490826,131037.0932334711,3628.875401744728,134665.96863521583,468,2,257.03125,32,0,23,34.2389628807498,0.6396484375,44.034090909090914,1023.8636363636365,31.99573863636364,0
472,4,0,0,32,0.0,0.0,1.0,32,800,500,300,0.625,11,5,6,381.6748581982424,0.37882224462365593,0.025933801775148035,0.2224243139155274,131134.06795224975,3610.1153581267176,134744.18331037648,469,3,258.03125,32,0,23,34.16620438856016,0.640625,43.93939393939394,1024.242424242424,32.00757575757575,0
473,4,0,0,32,0.0,0.0,1.0,32,750,400,350,0.5333333333333333,11,4,7,381.5772120499793,0.37959929435483875,0.01995147874306835,0.22293009904863784,131231.07854109266,3614.9578168043895,134846.03635789704,470,4,259.03125,32,0,23,34.07039433148489,0.6416015625,43.84469696969696,1024.6212121212113,32.019412878787854,0
474,4,0,0,32,0.0,0.0,1.0,32,450,300,150,0.6666666666666666,6,3,3,382.0477229162535,0.3792002688172043,0.022103658536585247,0.2237708091366628,131328.125,3634.7580922865004,134962.8830922865,471,5,260.03125,31,1,23,33.960027100271006,0.6451612903225806,43.75,1025.0,33.064516129032256,0
475,4,0,0,32,0.0,0.0,1.0,32,850,700,150,0.8235294117647058,10,7,3,384.3510912828275,0.3787802419354838,0.022598107696215175,0.22551270437861287,131394.86524793843,3700.3519694010465,135095.2172173395,472,6,261.03125,31,1,23,33.833396833460334,0.6458333333333333,43.684895833333336,1025.2604166666672,33.072916666666686,0
476,4,0,0,32,0.0,0.0,1.0,32,850,400,450,0.47058823529411764,13,4,9,379.8001677080015,0.3785492271505377,0.019149898438491686,0.22342687983838136,131495.00740898974,3588.365173339833,135083.37258232958,473,7,262.03125,31,1,24,33.848678642461174,0.6468413978494624,43.58723958333333,1025.651041666666,33.08551747311826,0
477,4,0,0,32,0.0,0.0,1.0,32,750,600,150,0.8,9,6,3,377.13932335283044,0.37894825268817206,0.01545050761421285,0.22244445119912465,131595.18771701393,3525.9440104166715,135121.13172743062,474,8,263.03125,31,1,19,33.81556683587141,0.6478494623655914,43.489583333333336,1026.041666666667,33.0981182795699,0
478,4,2,2,32,0.058823529411764705,0.058823529411764705,0.9411764705882353,34,950,600,350,0.631578947368421,13,6,7,358.0563008808142,0.3887032085561497,0.00046284608263924554,0.21391568744930678,132082.88278546702,2658.6216839676913,134741.5044694347,475,0,248.5,33,1,19,33.813185503099675,0.6477272727272728,43.014705882352935,1027.9411764705874,31.14973262032083,0
479,4,1,1,32,0.030303030303030304,0.030303030303030304,0.9696969696969697,33,1050,600,450,0.5714285714285714,15,6,9,365.6352011699414,0.38360164141414144,0.011147226038490166,0.2180150111591319,132008.45457415047,3053.387568870505,135061.84214302097,476,0,257.0,32,1,20,33.69348200024573,0.6494140625,43.087121212121204,1027.651515151514,32.114109848484816,0
480,4,1,0,33,0.030303030303030304,0.0,1.0,33,800,500,300,0.625,11,5,6,367.3401730539871,0.3814709595959596,0.018470560219086885,0.21997193892291683,132170.6968676665,3110.321332006934,135281.01819967345,477,0,257.969696969697,32,1,22,33.486053127046496,0.6510416666666667,42.92929292929293,1028.282828282828,32.13383838383837,0
481,4,0,0,33,0.0,0.0,1.0,33,550,300,250,0.5454545454545454,8,3,5,367.2927337808541,0.38060290404040403,0.024343607942920675,0.2203215470823885,132235.62168401177,3113.836598306287,135349.45828231805,478,1,258.969696969697,32,1,22,33.421822571405194,0.6516927083333334,42.86616161616161,1028.535353535353,32.14172979797978,0
482,4,0,0,33,0.0,0.0,1.0,33,500,200,300,0.4,8,2,6,367.2927337808541,0.38060290404040403,0.024343607942920675,0.2203215470823885,132235.62168401177,3113.836598306287,135349.45828231805,479,2,259.969696969697,32,1,22,33.421822571405194,0.6516927083333334,42.86616161616161,1028.535353535353,32.14172979797978,0
483,4,0,0,33,0.0,0.0,1.0,33,750,400,350,0.5333333333333333,11,4,7,364.7797056720237,0.38072127525252525,0.023074920989031522,0.21956828664896572,132365.51914345485,3056.851022854825,135422.37016630967,480,3,260.969696969697,32,1,22,33.35557259713702,0.6529947916666666,42.739898989899,1029.0404040404048,32.15751262626265,0
484,4,0,0,33,0.0,0.0,1.0,33,850,800,50,0.9411764705882353,9,8,1,364.7797056720237,0.38072127525252525,0.023074920989031522,0.21956828664896572,132365.51914345485,3056.851022854825,135422.37016630967,481,4,261.969696969697,32,1,22,33.35557259713702,0.6529947916666666,42.739898989899,1029.0404040404048,32.15751262626265,0
485,4,0,0,33,0.0,0.0,1.0,33,850,500,350,0.5882352941176471,12,5,7,363.2981612767043,0.379458648989899,0.021552124556415864,0.21962168311427185,132527.98064291922,3029.4343370574557,135557.4149799767,482,5,262.969696969697,32,1,22,33.23012466789289,0.6546223958333333,42.58207070707071,1029.6717171717182,32.177241161616195,0
486,4,0,0,33,0.0,0.0,1.0,33,600,200,400,0.3333333333333333,10,2,8,365.1627378892734,0.379458648989899,0.01880570409982174,0.2217059480042018,132690.54178145094,3090.728305785134,135781.27008723607,483,6,263.969696969697,32,1,20,33.01853553921569,0.65625,42.42424242424243,1030.303030303031,32.19696969696972,0
487,4,0,1,32,0.0,0.030303030303030304,0.9696969696969697,33,950,700,250,0.7368421052631579,12,7,5,365.1627378892734,0.379458648989899,0.01880570409982174,0.2217059480042018,132690.54178145094,3090.728305785134,135781.27008723607,484,7,264.969696969697,32,1,20,33.01853553921569,0.65625,42.42424242424243,1030.303030303031,32.19696969696972,0
488,4,1,1,32,0.030303030303030304,0.030303030303030304,0.9696969696969697,33,900,600,300,0.6666666666666666,12,6,6,362.19371662762313,0.3792613636363636,0.011898532167974762,0.22085972339541046,132853.20255905026,3023.719040148986,135876.92159919924,485,0,265.1515151515151,32,1,20,32.93146560522556,0.6578776041666665,42.26641414141415,1030.9343434343448,32.216698232323274,0
489,4,0,0,32,0.0,0.0,1.0,32,650,400,250,0.6153846153846154,9,4,5,378.8951724513418,0.3737189180107527,0.02719421866806493,0.22232402888144898,131397.01844143838,3567.9161539267297,134964.9345953651,486,9,274.4375,30,2,24,33.97106056633456,0.648611111111111,43.682795698924735,1025.2688172043015,34.175627240143385,4
490,4,1,1,32,0.030303030303030304,0.030303030303030304,0.9696969696969697,33,1150,1000,150,0.8695652173913043,13,10,3,369.25770112577715,0.37937973484848486,0.006885131267025724,0.21913735807215975,131829.09011840817,3135.781351725259,134964.87147013342,487,0,267.09090909090907,31,2,19,33.78145999746418,0.6502016129032258,43.26171875,1026.9531249999998,33.12752016129031,0
491,4,1,1,32,0.030303030303030304,0.030303030303030304,0.9696969696969697,33,1050,900,150,0.8571428571428571,12,9,3,369.91201903228983,0.3794191919191919,0.008603141682989701,0.22010602037441673,131929.39758300778,3160.4539659288175,135089.8515489366,488,0,268.06060606060606,31,2,19,33.66339247993242,0.6512096774193548,43.1640625,1027.3437499999998,33.14012096774193,0
492,4,0,0,32,0.0,0.0,1.0,32,500,200,300,0.4,8,2,6,379.9333043391937,0.37331989247311825,0.017987465636863487,0.2251598535180063,131776.25529324208,3613.2376214013298,135389.4929146434,489,12,277.4375,30,2,20,33.56078457040625,0.6524305555555555,43.31317204301076,1026.7473118279577,34.22491039426526,0
493,4,0,0,32,0.0,0.0,1.0,32,1100,800,300,0.7272727272727273,14,8,6,379.1379313696899,0.37394993279569894,0.019073234884015466,0.2253970716334201,131895.95752292217,3601.352098253043,135497.3096211752,490,13,278.4375,31,1,21,33.4602241517725,0.6508736559139785,43.196614583333336,1027.2135416666672,33.13592069892475,0
494,4,1,1,32,0.030303030303030304,0.030303030303030304,0.9696969696969697,33,550,400,150,0.7272727272727273,7,4,3,368.306489084243,0.3771701388888889,0.01649645627546148,0.22073998186837082,132203.1572830579,3138.2561409550062,135341.4134240129,491,0,270.969696969697,32,1,22,33.428483732351125,0.6513671875,42.89772727272727,1028.4090909090912,32.1377840909091,0
495,4,1,0,33,0.030303030303030304,0.0,1.0,33,600,300,300,0.5,9,3,6,365.83285347101827,0.37598642676767674,0.02823919648069806,0.2200126880395077,132333.03880025007,3082.3546385572986,135415.39343880737,492,0,271.5151515151515,32,1,23,33.36119973820918,0.6526692708333333,42.77146464646465,1028.9141414141423,32.153566919191945,0
496,4,0,0,33,0.0,0.0,1.0,33,700,600,100,0.8571428571428571,8,6,2,367.45979011818446,0.376104797979798,0.020836353229337634,0.22175423159389773,132462.9840864454,3134.964066166733,135597.9481526121,493,1,272.5151515151515,32,1,23,33.18844801504559,0.6539713541666665,42.64520202020203,1029.4191919191928,32.169349747474776,0
497,4,0,0,33,0.0,0.0,1.0,33,550,400,150,0.7272727272727273,7,4,3,369.5206417957405,0.375591856060606,0.01615666165022356,0.22338330866154696,132527.98064291922,3194.3648926130095,135722.34553553222,494,2,273.5151515151515,32,1,23,33.0699468628653,0.6546223958333333,42.58207070707071,1029.6717171717182,32.177241161616195,0
498,4,1,1,33,0.029411764705882353,0.029411764705882353,0.9705882352941176,34,750,600,150,0.8,9,6,3,362.7569249812293,0.38049613784907904,0.013417303670963054,0.2209376173799508,132808.22167255386,2835.4204212322225,135643.6420937861,495,0,266.44117647058823,33,1,20,32.96216759798676,0.6549873737373737,42.310049019607845,1030.7598039215688,31.235145573380873,0
499,4,0,0,33,0.0,0.0,1.0,33,750,400,350,0.5333333333333333,11,4,7,371.37759515570946,0.37527619949494945,0.0185606060606065,0.22547925420168075,132690.5417814509,3255.6588613406893,135946.2006427916,496,4,275.5151515151515,32,1,20,32.85845588235294,0.65625,42.42424242424243,1030.3030303030307,32.19696969696971,0
500,4,0,0,33,0.0,0.0,1.0,33,750,500,250,0.6666666666666666,10,5,5,373.6168728794471,0.37452651515151514,0.02025647308666123,0.22723255711192614,132755.59413580256,3319.9459876543287,136075.54012345689,497,5,276.5151515151515,32,1,20,32.735287511230915,0.6569010416666666,42.361111111111114,1030.555555555556,32.20486111111113,0
501,4,0,0,33,0.0,0.0,1.0,33,800,500,300,0.625,11,5,6,378.6195805154723,0.37472380050505055,0.01507358671208836,0.2310767933101158,132885.74667125812,3462.6291322314205,136348.37580348953,498,6,277.5151515151515,32,1,20,32.47535513103111,0.658203125,42.23484848484849,1031.0606060606067,32.22064393939396,0
502,4,0,1,32,0.0,0.030303030303030304,0.9696969696969697,33,750,500,250,0.6666666666666666,10,5,5,381.5307129648494,0.37456597222222227,0.004257481188089107,0.23387002667935386,133048.5270157383,3552.4198742475382,136600.94688998585,499,7,278.5151515151515,32,1,20,32.236466364786025,0.6598307291666666,42.07702020202021,1031.69191919192,32.2403724747475,0
503,4,0,0,32,0.0,0.0,1.0,32,1100,900,200,0.8181818181818182,13,9,4,389.75249786147083,0.3709257392473118,0.008386455440545504,0.23861045502771025,133001.71746147997,3967.5503200954763,136969.26778157544,500,8,287.96875,31,1,20,32.07155179668434,0.661962365591398,42.12239583333333,1031.510416666666,33.27452956989245,0
504,4,1,1,32,0.030303030303030304,0.030303030303030304,0.9696969696969697,33,650,300,350,0.46153846153846156,10,3,7,378.49516681511943,0.37693339646464646,0.006142105653108354,0.23384369067580643,133341.78272625245,3493.844059279668,136835.6267855321,501,0,280.2121212121212,32,1,20,32.0199164629177,0.6627604166666666,41.792929292929294,1032.828282828283,32.27588383838384,0
505,4,0,0,32,0.0,0.0,1.0,32,400,300,100,0.75,5,3,2,387.82791038110474,0.3702536962365592,0.014290557587990582,0.2385036342584188,133169.65950859923,3929.3821546766585,137099.0416632759,502,10,289.96875,31,1,21,31.952109877633408,0.6636424731182795,41.95963541666667,1032.161458333334,33.29553091397852,0
506,4,1,0,33,0.030303030303030304,0.0,1.0,33,850,700,150,0.8235294117647058,10,7,3,379.98013206826545,0.37709122474747475,0.02673588578844943,0.2393905901542095,134063.15262241286,3588.953533298291,137652.10615571114,503,0,282.1515151515151,30,3,21,31.25757084144496,0.6753472222222223,41.09543010752687,1035.6182795698912,34.52060931899637,2
507,4,0,0,33,0.0,0.0,1.0,33,800,500,300,0.625,11,5,6,378.88374939687566,0.3774068813131313,0.026024585329023298,0.23892620072441254,134097.95388195146,3561.507110648601,137659.46099260007,504,1,283.1515151515151,30,3,21,31.25108140842633,0.6756944444444446,41.061827956989234,1035.7526881720414,34.52508960573471,0
508,4,0,0,33,0.0,0.0,1.0,33,800,600,200,0.75,10,6,4,400.3658312913892,0.3774068813131313,-0.0038216459296689376,0.2349223508531324,131397.0184414385,3930.1190889120357,135327.13753035053,505,2,284.1515151515151,30,3,18,33.420730641496256,0.648611111111111,43.68279569892474,1025.2688172043024,34.17562724014341,6
509,4,0,1,32,0.0,0.030303030303030304,0.9696969696969697,33,750,500,250,0.6666666666666666,10,5,5,400.0895782302772,0.3774068813131313,-0.007578736638901518,0.23497177769967562,131431.47193678468,3916.8724346745407,135348.3443714592,506,3,285.1515151515151,30,3,18,33.392864945165385,0.6489583333333333,43.6491935483871,1025.4032258064522,34.18010752688174,0
510,4,0,0,32,0.0,0.0,1.0,32,550,300,250,0.5454545454545454,8,3,5,412.43459068826496,0.37132476478494625,-0.0050746505717917945,0.24114860540242541,131261.40170627178,4427.348497178829,135688.75020345062,507,15,294.96875,31,1,18,33.24915290131301,0.644489247311828,43.81510416666667,1024.739583333334,33.05611559139787,0
511,4,0,0,32,0.0,0.0,1.0,32,450,200,250,0.4444444444444444,7,2,5,412.4529050168547,0.37103074596774194,-0.0027947154471545943,0.2415795586527295,131328.12500000023,4433.333333333363,135761.4583333336,508,16,295.96875,31,1,18,33.18089430894309,0.6451612903225805,43.750000000000014,1025.0000000000018,33.06451612903232,0
512,4,1,1,32,0.030303030303030304,0.030303030303030304,0.9696969696969697,33,1100,800,300,0.7272727272727273,14,8,6,400.78462693314634,0.3742503156565657,-0.008324703100138553,0.23708692454596725,131707.26249060576,3957.2492123366756,135664.51170294243,509,0,287.969696969697,30,3,16,33.09545633102004,0.6517361111111111,43.38037634408602,1026.4784946236553,34.21594982078851,0
513,4,0,0,32,0.0,0.0,1.0,32,600,300,300,0.5,9,3,6,412.31790148879844,0.36968665994623656,-0.0022164320519761915,0.2433070811660735,131613.00154320974,4453.279320987639,136066.28086419738,510,18,297.96875,29,3,16,32.895122721530406,0.6537356321839081,43.472222222222214,1026.1111111111102,35.38314176245208,0
514,4,0,0,32,0.0,0.0,1.0,32,750,300,450,0.4,12,3,9,412.86805995480984,0.37004368279569894,-0.00392052375152252,0.24385948001647406,131648.6328125,4470.703125,136119.3359375,511,19,298.96875,29,3,16,32.84485383678442,0.6540948275862069,43.4375,1026.25,35.38793103448276,0
515,4,0,0,32,0.0,0.0,1.0,32,1000,600,400,0.6,14,6,8,416.1025369903838,0.3693086357526882,-0.0045729645658643125,0.24692312668594676,131826.86149691354,4570.69830246913,136397.55979938267,512,20,299.96875,29,3,17,32.58103417185105,0.6558908045977012,43.263888888888886,1026.9444444444441,35.411877394636,0
516,4,0,0,32,0.0,0.0,1.0,32,1400,1100,300,0.7857142857142857,17,11,6,416.0942938746026,0.3684895833333333,0.0019372874705729792,0.24816357027809757,132017.8723696381,4586.376676494393,136604.2490461325,513,21,300.96875,30,2,17,32.38757738250937,0.6548611111111111,43.07795698924731,1027.6881720430106,34.256272401433684,0
517,4,1,1,32,0.030303030303030304,0.030303030303030304,0.9696969696969697,33,850,500,350,0.5882352941176471,12,5,7,405.9631469315814,0.3741319444444444,-0.007119294207901916,0.24370128121272747,132264.03130425353,4138.864474826398,136402.89577907993,514,0,292.8181818181818,31,2,17,32.39873417721519,0.6545698924731183,42.83854166666667,1028.645833333334,33.182123655914,0
518,4,2,2,32,0.058823529411764705,0.058823529411764705,0.9411764705882353,34,1150,1000,150,0.8695652173913043,13,10,3,395.0380481913238,0.38003193701723115,-0.01405712076260146,0.23947478921391285,132632.61795043945,3679.053921169706,136311.67187160917,515,0,285.1470588235294,31,3,17,32.30746745038554,0.658266129032258,42.48046875,1030.078125,33.228326612903224,0
519,4,0,0,32,0.0,0.0,1.0,32,750,400,350,0.5333333333333333,11,4,7,422.3270566436169,0.36922463037634407,-0.0065879702194360235,0.2541930774892714,132363.42351716963,4780.1310122557525,137143.5545294254,516,24,303.96875,30,2,17,31.877231365377913,0.6583333333333334,42.74193548387097,1029.0322580645163,34.30107526881721,0
520,4,0,0,32,0.0,0.0,1.0,32,850,500,350,0.5882352941176471,12,5,7,421.99330209118165,0.36874159946236557,-0.014655288720993198,0.2547080093729509,132469.4830246913,4780.251429998323,137249.7344546896,517,25,304.96875,29,3,18,31.778422378125562,0.6623563218390804,42.638888888888886,1029.4444444444441,35.49808429118773,0
521,4,0,0,32,0.0,0.0,1.0,32,900,700,200,0.7777777777777778,11,7,4,418.3295919766722,0.3680275537634408,-0.014424018008613038,0.25341183109227156,132605.57804731745,4694.567471673,137300.14551899047,518,26,305.96875,30,2,19,31.73501457218669,0.6607638888888889,42.506720430107514,1029.9731182795686,34.33243727598562,0
522,4,0,0,32,0.0,0.0,1.0,32,750,600,150,0.8,9,6,3,415.2982341510981,0.36777553763440857,-0.007096158862658131,0.25250527844856996,132744.0514257428,4625.674030234702,137369.7254559775,519,27,306.96875,30,2,17,31.67307943132906,0.6621527777777778,42.372311827956985,1030.5107526881716,34.35035842293905,0
523,4,0,0,32,0.0,0.0,1.0,32,500,300,200,0.6,7,3,4,414.8633339851671,0.3679855510752688,-0.010003748859042982,0.25270745896205304,132813.31521346397,4619.874949416118,137433.19016288008,520,28,307.96875,30,2,17,31.614291302647015,0.6628472222222221,42.30510752688172,1030.779569892473,34.35931899641577,0
524,4,0,0,32,0.0,0.0,1.0,32,800,700,100,0.875,9,7,2,416.8023710058319,0.3684895833333333,-0.010764205656196957,0.2548306448388642,132951.89698592311,4682.933178691165,137634.83016461428,521,29,308.96875,30,2,17,31.424312524436335,0.6642361111111111,42.17069892473118,1031.3172043010745,34.37724014336915,0
525,4,0,0,32,0.0,0.0,1.0,32,1000,800,200,0.8,12,8,4,416.12314247036613,0.3679645497311828,-0.013227728575149644,0.2555994790309977,133125.22582090422,4679.297462134361,137804.52328303858,522,30,309.96875,30,2,17,31.266822957367367,0.6659722222222222,42.002688172043015,1031.9892473118284,34.39964157706095,0
526,4,0,0,32,0.0,0.0,1.0,32,850,700,150,0.8235294117647058,10,7,3,420.27092143096866,0.367166498655914,-0.017516597240301746,0.2591108522016613,133263.97018441436,4801.394308590588,138065.36449300495,523,31,310.96875,30,2,17,31.01975397032023,0.6673611111111111,41.86827956989247,1032.5268817204299,34.41756272401433,0
527,4,0,0,32,0.0,0.0,1.0,32,850,600,250,0.7058823529411765,11,6,5,416.57983855254975,0.3669984879032258,-0.02041579906298807,0.2573150706943564,133333.36946467805,4708.798705052615,138042.16816973066,524,32,311.96875,30,2,17,31.0450286309214,0.6680555555555556,41.80107526881721,1032.7956989247316,34.42652329749105,0
528,4,0,0,32,0.0,0.0,1.0,32,900,700,200,0.7777777777777778,11,7,4,414.3072457682612,0.36647345430107525,-0.018393937484245004,0.2564051238631346,133404.95639377175,4654.128011067714,138059.08440483946,525,33,312.96875,31,1,17,31.031530963784547,0.665994623655914,41.731770833333336,1033.072916666667,33.324932795698935,0
529,4,0,1,31,0.0,0.03125,0.96875,32,650,500,150,0.7692307692307693,8,5,3,416.558272632674,0.3660744287634408,-0.01990927419354871,0.25826612903225804,133472.2222222223,4719.791666666678,138192.013888889,526,34,313.96875,31,1,17,30.90557795698924,0.6666666666666666,41.66666666666667,1033.3333333333342,33.33333333333336,0
530,4,0,0,31,0.0,0.0,1.0,31,700,600,100,0.8571428571428571,8,6,2,423.4157742001131,0.3635304659498208,-0.012493492972410092,0.26153752483550413,133333.36946467805,5091.090371719281,138424.45983639732,527,35,323.16129032258067,30,1,17,30.86852550754816,0.6680555555555555,41.80107526881721,1032.7956989247316,34.42652329749105,0
531,4,0,0,31,0.0,0.0,1.0,31,650,400,250,0.6153846153846154,9,4,5,423.2604485352721,0.3626344086021505,-0.014051522248243797,0.2619307413399438,133402.78681061396,5092.824676263153,138495.6114868771,528,36,324.16129032258067,30,1,17,30.802487206175737,0.66875,41.733870967741936,1033.0645161290324,34.43548387096775,0
532,4,0,0,31,0.0,0.0,1.0,31,650,300,350,0.46153846153846156,10,3,7,421.43600416233073,0.36236559139784946,-0.013787721123829089,0.2612903225806454,133472.22222222236,5050.0000000000255,138522.2222222224,529,37,325.16129032258067,30,1,17,30.77956989247312,0.6694444444444443,41.66666666666668,1033.3333333333346,34.444444444444485,0
533,4,0,0,31,0.0,0.0,1.0,31,1100,700,400,0.6363636363636364,15,7,8,423.1851801373148,0.36227598566308244,-0.013780551222048798,0.26336087424079496,133611.14724245577,5108.451482830382,138719.59872528617,530,38,326.16129032258067,30,1,18,30.594286271450862,0.6708333333333333,41.53225806451613,1033.8709677419354,34.46236559139785,0
534,4,0,0,31,0.0,0.0,1.0,31,850,700,150,0.8235294117647058,10,7,3,424.4621854735511,0.3612903225806452,-0.015594541910331161,0.2649015829050263,133715.38843002074,5151.425200890272,138866.81363091103,531,39,327.16129032258067,30,1,17,30.456194498592158,0.671875,41.431451612903224,1034.2741935483866,34.47580645161289,0
535,4,0,0,31,0.0,0.0,1.0,31,950,600,350,0.631578947368421,13,6,7,426.3801348325777,0.3607974910394265,-0.012474012474012142,0.2663491491616492,133750.14452537865,5205.68093132154,138955.8254567002,532,40,328.16129032258067,30,1,17,30.371567480942485,0.6722222222222223,41.39784946236559,1034.4086021505375,34.480286738351246,0
536,4,1,0,32,0.03125,0.0,1.0,32,1200,900,300,0.75,15,9,6,414.1180406902172,0.36662046370967744,-0.009122768418405869,0.26100593467907984,134078.37761772997,4704.855007595481,138783.23262532544,533,0,318.875,31,1,18,30.358415053222704,0.6727150537634409,41.080729166666664,1035.677083333333,33.408938172043,0
537,4,0,0,32,0.0,0.0,1.0,32,450,200,250,0.4444444444444444,7,2,5,415.61671142010067,0.3663684475806452,-0.013401835093011405,0.2624322663538349,134145.81298828125,4750.648328993057,138896.4613172743,534,1,319.875,31,1,18,30.251801575330994,0.6733870967741936,41.015625,1035.9375,33.417338709677416,0
538,4,0,0,32,0.0,0.0,1.0,32,350,300,50,0.8571428571428571,4,3,1,415.61671142010067,0.3663684475806452,-0.013401835093011405,0.2624322663538349,134145.81298828125,4750.648328993057,138896.4613172743,535,2,320.875,31,1,18,30.251801575330994,0.6733870967741936,41.015625,1035.9375,33.417338709677416,0
539,4,0,0,32,0.0,0.0,1.0,32,1150,1100,50,0.9565217391304348,12,11,1,411.9036148479207,0.36680947580645157,-0.014292331365406419,0.26128802213580044,134314.47558932827,4664.923604329416,138979.39919365768,536,3,321.875,31,1,18,30.178500397772474,0.6750672043010754,40.85286458333333,1036.588541666666,33.43834005376342,0
540,4,0,0,32,0.0,0.0,1.0,32,1000,800,200,0.8,12,8,4,412.6089001137985,0.36664146505376344,-0.014045428858470821,0.26221904801326223,134381.9702996147,4689.439392089824,139071.40969170452,537,4,322.875,31,1,18,30.092432709615295,0.675739247311828,40.78776041666666,1036.8489583333326,33.44674059139783,0
541,4,0,0,32,0.0,0.0,1.0,32,500,200,300,0.4,8,2,6,410.799825809261,0.3660324260752688,-0.014181726907630532,0.2622798887859128,134550.78125000003,4654.687499999998,139205.46875000003,538,5,323.875,31,1,19,29.969879518072286,0.6774193548387097,40.625,1037.5000000000002,33.46774193548388,0
542,4,0,0,32,0.0,0.0,1.0,32,1050,800,250,0.7619047619047619,13,8,5,412.2792827901282,0.36630544354838707,-0.012561927756176816,0.2644491328789774,134719.69816419802,4708.428107367611,139428.12627156565,539,6,324.875,31,1,19,29.76203541117941,0.6790994623655915,40.46223958333333,1038.1510416666658,33.48874327956987,0
543,4,0,0,32,0.0,0.0,1.0,32,950,600,350,0.631578947368421,13,6,7,419.4467373635561,0.3657174059139785,0.013891440117560938,0.25599417468690594,132885.74667125815,4747.698576675864,137633.44524793403,540,7,325.875,32,0,16,31.422973303943177,0.658203125,42.23484848484849,1031.060606060607,32.220643939393966,4
544,4,0,0,32,0.0,0.0,1.0,32,300,100,200,0.3333333333333333,5,1,4,418.21134065155627,0.3658644153225807,0.014268550263254465,0.25546237988790277,132918.2947690287,4717.587650494853,137635.88241952355,541,8,326.875,32,0,16,31.421931757887428,0.6585286458333333,42.20328282828283,1031.186868686869,32.22458964646466,0
545,4,0,0,32,0.0,0.0,1.0,32,700,400,300,0.5714285714285714,10,4,6,416.10978383197886,0.36599042338709675,0.009213223595642805,0.25506624483804236,133048.52701573842,4672.5587631364415,137721.08577887487,542,9,327.875,32,0,16,31.344592665116455,0.6598307291666665,42.077020202020215,1031.691919191921,32.24037247474753,0
546,4,0,0,32,0.0,0.0,1.0,32,900,700,200,0.7777777777777778,11,7,4,416.79266269382276,0.3657174059139785,0.003280217763640847,0.25615512968866994,133146.2430491788,4698.875433629235,137845.11848280803,543,10,328.875,32,0,16,31.228335780115813,0.6608072916666666,41.98232323232324,1032.070707070708,32.25220959595963,0
547,4,0,0,32,0.0,0.0,1.0,32,1100,1000,100,0.9090909090909091,12,10,2,415.3880272520427,0.365213373655914,0.0002522010271464037,0.25618727653598844,133276.58689164385,4672.2997015610845,137948.88659320492,544,11,329.875,32,0,16,31.13307043286869,0.662109375,41.856060606060616,1032.5757575757586,32.26799242424246,0
548,4,0,0,32,0.0,0.0,1.0,32,900,700,200,0.7777777777777778,11,7,4,412.27701794748583,0.36519237231182794,0.001890814081408232,0.2549386457920171,133374.38662190098,4597.438877410491,137971.82549931147,545,12,330.875,32,0,16,31.114778144481118,0.6630859375,41.76136363636365,1032.9545454545466,32.27982954545458,0
549,4,0,0,32,0.0,0.0,1.0,32,1050,700,350,0.6666666666666666,14,7,7,415.4711842699873,0.364268313172043,0.004157758094074371,0.25781892670582623,133504.84206012142,4693.482967299256,138198.32502742068,546,13,331.875,32,0,16,30.90078395438811,0.6643880208333334,41.63510101010101,1033.459595959596,32.29561237373738,0
550,4,0,0,32,0.0,0.0,1.0,32,950,800,150,0.8421052631578947,11,8,3,417.67487015564143,0.3636172715053763,0.0020151441133366976,0.2598724800026134,133602.7254871952,4760.500204060812,138363.225691256,547,14,332.875,32,0,16,30.745196222113673,0.6653645833333334,41.54040404040404,1033.8383838383838,32.307449494949495,0
551,4,0,0,32,0.0,0.0,1.0,32,800,600,200,0.75,10,6,4,415.08674475707454,0.3631552419354838,-0.0017628205128206176,0.25871845049927245,133668.00103305784,4696.763085399448,138364.76411845727,548,15,333.875,32,0,17,30.746336996337007,0.666015625,41.47727272727273,1034.090909090909,32.31534090909091,0
552,4,0,0,32,0.0,0.0,1.0,32,600,400,200,0.6666666666666666,8,4,4,415.83801052268706,0.3629242271505377,-0.003650219699743884,0.25987496721680986,133765.94424357213,4724.992825987144,138490.93706955927,549,16,334.875,32,0,16,30.62828023922861,0.6669921875,41.38257575757576,1034.4696969696972,32.32717803030304,0
553,4,0,0,32,0.0,0.0,1.0,32,350,100,250,0.2857142857142857,6,1,5,414.98661128841127,0.36290322580645157,-0.0005034171344884264,0.2595725414425376,133798.59995153558,4704.925517804313,138503.5254693399,550,17,335.875,32,0,16,30.617423317874874,0.6673177083333333,41.351010101010104,1034.5959595959598,32.331123737373744,0
554,4,0,0,32,0.0,0.0,1.0,32,850,800,50,0.9411764705882353,9,8,1,411.4016546519035,0.36242019489247307,-0.0003774246675611881,0.2580152534951533,133896.5909888022,4617.055817008477,138513.64680581068,551,18,336.875,32,0,16,30.611555040461962,0.6682942708333333,41.256313131313135,1034.9747474747478,32.34296085858587,0
555,4,0,0,32,0.0,0.0,1.0,32,800,300,500,0.375,13,3,10,409.1210468943733,0.36071908602150543,0.00025146305779055744,0.25772740603899014,134059.98909550052,4569.352617079897,138629.3417125804,552,19,337.875,32,0,16,30.5062789563521,0.669921875,41.09848484848485,1035.6060606060612,32.36268939393941,0
556,4,0,0,32,0.0,0.0,1.0,32,850,700,150,0.8235294117647058,10,7,3,409.82226505437507,0.36046706989247307,0.004776633349585557,0.2586293740389303,134125.3762371187,4593.513098153252,138718.88933527196,553,20,338.875,32,0,16,30.422405737038847,0.6705729166666666,41.035353535353536,1035.8585858585861,32.37058080808082,0
557,4,0,0,32,0.0,0.0,1.0,32,800,600,200,0.75,10,6,4,409.82226505437507,0.36046706989247307,0.004776633349585557,0.2586293740389303,134125.3762371187,4593.513098153252,138718.88933527196,554,21,339.875,32,0,16,30.422405737038847,0.6705729166666666,41.035353535353536,1035.8585858585861,32.37058080808082,0
558,4,0,1,31,0.0,0.03125,0.96875,32,900,700,200,0.7777777777777778,11,7,4,410.1589172638344,0.36076108870967744,-0.000251340482573692,0.2593038578634072,134190.7793209876,4607.908950617281,138798.6882716049,555,22,340.875,32,0,16,30.347966934763186,0.6712239583333334,40.97222222222222,1036.1111111111109,32.378472222222214,0
559,4,0,0,31,0.0,0.0,1.0,31,1050,800,250,0.7619047619047619,13,8,5,416.0054928710008,0.35479390681003586,0.002335719064901154,0.2624364548603339,134112.09318372933,4958.27348497178,139070.3666687011,556,23,349.64516129032256,31,0,16,30.275639011104122,0.6730510752688172,41.04817708333333,1035.8072916666663,33.4131384408602,0
560,4,0,0,31,0.0,0.0,1.0,31,800,700,100,0.875,9,7,2,414.9696129112328,0.35452508960573476,0.0015569503235535187,0.262023669866807,134145.81298828128,4933.287217881946,139079.10020616322,557,24,350.64516129032256,31,0,16,30.268560415619227,0.6733870967741935,41.015625,1035.9375000000002,33.41733870967742,0
561,4,0,0,31,0.0,0.0,1.0,31,750,500,250,0.6666666666666666,10,5,5,410.7270018433877,0.35376344086021505,-0.0007780839682283158,0.2603015075376885,134280.73459201396,4830.544704861121,139111.2792968751,558,25,351.64516129032256,31,0,16,30.242881072026808,0.6747311827956989,40.88541666666667,1036.458333333334,33.434139784946254,0
562,4,0,0,31,0.0,0.0,1.0,31,1300,1000,300,0.7692307692307693,16,10,6,407.61780599336896,0.35353942652329745,0.0028515416146857042,0.25928659799769893,134415.72401258684,4758.048502604172,139173.77251519103,559,26,352.64516129032256,31,0,16,30.18792901389586,0.6760752688172043,40.755208333333336,1036.979166666667,33.45094086021506,0
563,4,0,0,31,0.0,0.0,1.0,31,1000,800,200,0.8,12,8,4,409.1869485976034,0.3532706093189964,0.0036274128773157166,0.26125012872000825,134550.78125,4811.284722222223,139362.06597222222,560,27,353.64516129032256,31,0,16,30.011713520749662,0.6774193548387097,40.625,1037.5,33.46774193548387,0
564,4,2,2,31,0.06060606060606061,0.06060606060606061,0.9393939393939394,33,600,400,200,0.6666666666666666,8,4,4,391.10360242467385,0.3625315656565657,-0.014578040754199106,0.253009126785939,135027.99591803644,3961.98712634565,138989.9830443821,561,0,333.1515151515151,33,0,15,30.00321797743977,0.6770833333333333,40.165441176470594,1039.3382352941185,31.495098039215712,0
565,4,0,0,31,0.0,0.0,1.0,31,350,300,50,0.8571428571428571,4,3,1,409.2975690883973,0.35300179211469535,0.005438389200912885,0.2622926222486098,134685.90630425353,4825.3228081597335,139511.22911241325,562,29,355.64516129032256,31,0,16,29.873306573005518,0.678763440860215,40.49479166666667,1038.020833333334,33.48454301075271,0
566,4,0,0,31,0.0,0.0,1.0,31,950,700,250,0.7368421052631579,12,7,5,409.3797439303844,0.3532706093189964,0.00932178360029634,0.2625892758131098,134719.69816419817,4830.3031073676275,139550.0012715658,563,30,356.64516129032256,31,0,16,29.837289393369293,0.6790994623655914,40.462239583333336,1038.151041666667,33.4887432795699,0
567,4,0,0,31,0.0,0.0,1.0,31,650,500,150,0.7692307692307693,8,5,3,407.6321240552148,0.3528673835125448,0.017083508590286955,0.2621995017309995,134821.09917534728,4791.482204861117,139612.5813802084,564,31,357.64516129032256,31,0,16,29.781009695753937,0.6801075268817204,40.364583333333336,1038.541666666667,33.50134408602152,0
568,4,0,0,31,0.0,0.0,1.0,31,750,300,450,0.4,12,3,9,410.948280075215,0.3526881720430108,0.012416586166338783,0.26556908690528663,134990.185631646,4894.796922471784,139884.98255411777,565,32,358.64516129032256,31,0,16,29.525461512759467,0.6817876344086022,40.201822916666664,1039.192708333333,33.522345430107514,0
569,4,0,0,31,0.0,0.0,1.0,31,700,400,300,0.5714285714285714,10,4,6,409.30755256900096,0.35228494623655915,0.013965159835618302,0.26500423294065983,135057.84988403323,4856.03959825304,139913.88948228626,566,33,359.64516129032256,31,0,16,29.50031838490124,0.6824596774193548,40.13671875,1039.4531250000002,33.53074596774194,0
570,4,0,1,30,0.0,0.03225806451612903,0.967741935483871,31,750,600,150,0.8,9,6,3,411.2031678587633,0.35206093189964155,0.017324972525696314,0.26648101397600393,135091.68836805565,4910.026041666677,140001.71440972234,567,34,360.64516129032256,31,0,16,29.417167668670672,0.6827956989247312,40.10416666666667,1039.5833333333342,33.534946236559165,0
571,4,0,0,30,0.0,0.0,1.0,30,900,600,300,0.6666666666666666,12,6,6,414.31316696535896,0.35165229885057475,0.013492781728075665,0.26862634924367595,135109.15505043944,5195.500382992265,140304.6554334317,568,35,356.76666666666665,30,0,16,29.318842921784103,0.6857638888888888,40.087365591397855,1039.6505376344094,34.65501792114698,0
572,4,0,0,30,0.0,0.0,1.0,30,800,600,200,0.75,10,6,4,416.93282253803113,0.35165229885057475,-0.013056315400981067,0.2558587752697413,133090.5510210717,5097.9638180714455,138188.51483914314,569,36,357.76666666666665,30,0,18,31.280936563761895,0.665625,42.03629032258064,1031.8548387096766,34.395161290322555,8
573,4,0,0,30,0.0,0.0,1.0,30,650,300,350,0.46153846153846156,10,3,7,416.6883285148573,0.3504789272030651,-0.014796493968584734,0.25690206578259484,133263.97018441427,5105.908197479461,138369.87838189374,570,37,358.76666666666665,30,0,18,31.112232057623885,0.6673611111111111,41.868279569892465,1032.5268817204292,34.4175627240143,0
574,4,0,0,30,0.0,0.0,1.0,30,600,400,200,0.6666666666666666,8,4,4,418.62469411002263,0.3501676245210728,-0.006319670353502671,0.25881985311629313,133368.07587943692,5166.23399381431,138534.30987325122,571,38,359.76666666666665,30,0,18,30.957221860767735,0.6684027777777778,41.76747311827957,1032.9301075268816,34.43100358422939,0
575,4,0,0,30,0.0,0.0,1.0,30,750,500,250,0.6666666666666666,10,5,5,417.94504541219305,0.3496168582375479,-0.012362375379280754,0.2596120677883494,133541.67569950287,5162.616342929822,138704.2920424327,572,39,360.76666666666665,30,0,18,30.799739921976595,0.6701388888888888,41.5994623655914,1033.6021505376348,34.453405017921156,0
576,4,0,0,30,0.0,0.0,1.0,30,750,500,250,0.6666666666666666,10,5,5,415.39465659711584,0.349066091954023,-0.018670652974565494,0.25875555410539364,133645.88978855938,5103.157698866922,138749.0474874263,573,40,361.76666666666665,30,0,18,30.760648208327915,0.6711805555555554,41.498655913978496,1034.005376344086,34.4668458781362,0
577,4,0,0,30,0.0,0.0,1.0,30,800,600,200,0.75,10,6,4,402.567168166876,0.3489463601532567,0.013062944429812928,0.2291675468560165,130228.28686842423,4485.126531969034,134713.41340039327,574,41,362.76666666666665,30,0,21,34.55277192520411,0.6368055555555554,44.82526881720431,1020.6989247311839,34.023297491039465,8
578,4,0,0,30,0.0,0.0,1.0,30,850,400,450,0.47058823529411764,13,4,9,404.9766683519605,0.34829980842911873,0.019568371418207997,0.23116370075493886,130333.48765432097,4556.4088374057355,134889.89649172671,575,42,363.76666666666665,29,1,21,34.38406782734857,0.6408045977011494,44.72222222222222,1021.111111111111,35.21072796934865,0
579,4,2,2,30,0.0625,0.0625,0.9375,32,850,500,350,0.5882352941176471,12,5,7,381.2434002086279,0.36565440188172044,-0.00112146856706552,0.2206046125802209,130861.41798231345,3578.01038953994,134439.4283718534,576,0,341.96875,31,1,16,34.453741410027995,0.6404569892473118,44.20572916666667,1023.177083333334,33.00571236559142,0
580,4,1,1,30,0.03225806451612903,0.03225806451612903,0.967741935483871,31,950,800,150,0.8421052631578947,11,8,3,391.5233604030934,0.35663082437275984,0.01180111059302269,0.22606166712196848,130777.62783269756,4040.4992629205844,134818.12709561814,577,0,353.96774193548384,30,1,18,34.2758979413053,0.6423611111111109,44.28763440860216,1022.8494623655926,34.094982078853086,0
581,4,2,2,30,0.0625,0.0625,0.9375,32,850,500,350,0.5882352941176471,12,5,7,379.0066946845094,0.3673765120967742,0.006771363173957212,0.2204518230028834,131061.3335503474,3534.624565972245,134595.95811631964,578,0,343.84375,31,1,18,34.30824008138352,0.6424731182795698,44.01041666666668,1023.9583333333347,33.03091397849467,0
582,4,0,0,30,0.0,0.0,1.0,30,1150,700,450,0.6086956521739131,16,7,9,401.7173201885298,0.3481800766283525,0.018964190320974073,0.23162448148380171,130723.78713348777,4502.801890432115,135226.5890239199,579,46,367.76666666666665,29,1,18,34.06998392865227,0.6447557471264367,44.340277777777786,1022.6388888888898,35.26340996168586,0
583,4,0,0,30,0.0,0.0,1.0,30,550,300,250,0.5454545454545454,8,3,5,400.5613480905916,0.34777298850574717,0.01546746311883429,0.23159614521470168,130830.33371913582,4481.114969135808,135311.44868827163,580,47,368.76666666666665,29,1,19,33.991198298488555,0.6458333333333333,44.236111111111114,1023.0555555555557,35.27777777777778,0
584,4,0,0,30,0.0,0.0,1.0,30,950,800,150,0.8421052631578947,11,8,3,402.58354631285107,0.3476772030651341,0.018249231325736748,0.23405724790365462,131043.55709876555,4551.195987654337,135594.7530864199,581,48,369.76666666666665,29,1,20,33.72275727979743,0.6479885057471264,44.027777777777786,1023.8888888888898,35.30651340996172,0
585,4,2,2,30,0.0625,0.0625,0.9375,32,550,300,250,0.5454545454545454,8,3,5,381.17804911180326,0.36202116935483875,0.007878917650044448,0.22502353595881064,131628.58963012692,3634.7858005099824,135263.3754306369,582,0,347.59375,31,1,14,33.678176415852484,0.6481854838709677,43.45703125,1026.1718749999998,33.10231854838709,0
586,4,0,0,30,0.0,0.0,1.0,30,600,500,100,0.8333333333333334,7,5,2,402.4866954324516,0.34695881226053643,0.020372378886478693,0.23486881847387356,131185.80246913573,4560.108024691352,135745.91049382708,583,50,371.76666666666665,29,1,21,33.58075741142444,0.6494252873563219,43.888888888888886,1024.444444444444,35.32567049808427,0
587,4,1,1,30,0.03225806451612903,0.03225806451612903,0.967741935483871,31,850,700,150,0.8235294117647058,10,7,3,394.5201479295532,0.3548835125448029,0.013833340379655779,0.23190976338231806,131465.92994854887,4173.19162619955,135639.12157474842,584,0,360.741935483871,30,1,21,33.500709916994325,0.6493055555555556,43.61559139784946,1025.5376344086014,34.18458781362005,0
588,4,0,0,30,0.0,0.0,1.0,30,950,700,250,0.7368421052631579,12,7,5,398.66216791860535,0.3464798850574713,0.025400935895688148,0.22448076178195,129802.20148533955,4349.44540895062,134151.64689429017,585,52,373.76666666666665,29,1,20,35.08685997910136,0.6354166666666666,45.24305555555556,1019.027777777778,35.1388888888889,3
589,4,2,1,31,0.0625,0.03125,0.96875,32,600,200,400,0.3333333333333333,10,2,8,378.46452194181325,0.35960601478494625,0.026477852135118107,0.21656120894482309,130428.79104614255,3472.5340101453976,133901.32505628795,586,0,351.34375,31,1,21,34.964016358614835,0.6360887096774194,44.62890625,1021.4843749999998,32.95110887096774,0
590,4,3,1,33,0.08823529411764706,0.029411764705882353,0.9705882352941176,34,1200,1100,100,0.9166666666666666,13,11,2,357.956085603736,0.3738302139037433,0.0249117963958001,0.20778368193523325,130982.91710219627,2577.2264573721627,133560.14355956845,587,0,331.5882352941176,33,1,20,34.92644858134802,0.6366792929292929,44.08700980392157,1023.6519607843137,31.019756387403447,0
591,4,0,0,33,0.0,0.0,1.0,33,1000,800,200,0.8,12,8,4,378.2784189770623,0.36797664141414144,0.07827500628888306,0.21305548636174967,129811.85154894924,3221.0043936843376,133032.85594263359,588,1,342.6363636363636,32,1,20,35.596322223598904,0.6272786458333333,45.23358585858587,1019.0656565656577,31.845801767676804,3
592,4,1,0,34,0.029411764705882353,0.0,1.0,34,900,600,300,0.6666666666666666,12,6,6,370.5619821253414,0.37613265002970886,0.07902248095971487,0.21045696201743488,130137.51471789708,2844.803080545958,132982.31779844305,589,0,333.52941176470586,33,1,21,35.461706301545355,0.6281565656565655,44.91421568627452,1020.343137254903,30.919489007724334,0
593,4,0,0,34,0.0,0.0,1.0,34,700,300,400,0.42857142857142855,11,3,8,372.3074410273875,0.3760398098633393,0.07954738091201952,0.21178800333853018,130200.04325259509,2894.888985005764,133094.93223760085,590,1,334.52941176470586,33,1,21,35.35362632084535,0.6287878787878787,44.85294117647059,1020.5882352941171,30.926916221033853,0
594,4,1,0,35,0.02857142857142857,0.0,1.0,35,950,700,250,0.7368421052631579,12,7,5,362.35759934823153,0.3802170868347339,0.08528158700572486,0.2079196278613114,130536.16780045354,2460.154478458052,132996.3222789116,591,0,325.9428571428571,34,1,16,35.26643561665115,0.6299019607843137,44.523809523809526,1021.904761904762,30.05602240896359,0
595,4,1,2,34,0.027777777777777776,0.05555555555555555,0.9444444444444444,36,1000,900,100,0.9,11,9,2,351.8150734014455,0.38548280423280423,0.0697838109602813,0.20353699272701412,130854.01663237298,2007.2830932784454,132861.29972565142,592,0,317.8611111111111,35,1,18,35.2139894419306,0.630952380952381,44.212962962962955,1023.1481481481471,29.232804232804202,0
596,4,0,0,34,0.0,0.0,1.0,34,1000,800,200,0.8,12,8,4,367.17741078519475,0.3755756090314914,0.07396136730678382,0.2110700746629434,130606.84479827469,2791.1766207708542,133398.02141904554,593,2,337.4117647058824,33,1,18,35.07160911960996,0.6328914141414141,44.4546568627451,1022.1813725490194,30.975193107546044,0
597,4,0,1,33,0.0,0.029411764705882353,0.9705882352941176,34,1100,800,300,0.7272727272727273,14,8,6,370.8143317684715,0.3760026737967914,0.08038181715639281,0.21367919780912478,130700.8121876202,2893.1468665897805,133593.95905421,594,3,338.4117647058824,33,1,18,34.88334931287952,0.6338383838383839,44.36274509803922,1022.5490196078437,30.986333927510415,0
598,4,0,1,32,0.0,0.030303030303030304,0.9696969696969697,33,300,200,100,0.6666666666666666,4,2,2,380.27097669924876,0.36766098484848486,0.08503722344552811,0.21792866455030616,130488.2473727172,3324.1786552392796,133812.42602795648,595,4,349.5151515151515,32,1,18,34.857472400725,0.6341145833333333,44.57070707070708,1021.7171717171727,31.928661616161648,0
599,4,1,1,32,0.030303030303030304,0.030303030303030304,0.9696969696969697,33,950,600,350,0.631578947368421,13,6,7,380.3562168931176,0.3687657828282828,0.09436256627267836,0.2192530249549723,130714.10323245087,3343.5843600142966,134057.68759246517,596,0,348.6060606060606,32,1,18,34.62593118491994,0.6363932291666666,44.34974747474748,1022.601010101011,31.956281565656592,0
600,4,0,0,32,0.0,0.0,1.0,32,850,700,150,0.8235294117647058,10,7,3,392.8629568024475,0.3627772177419355,0.10053430373295913,0.2255728857309738,130561.8307325576,3858.581373426658,134420.41210598426,597,6,360.5,31,1,19,34.46099821633328,0.6374327956989246,44.49869791666667,1022.0052083333342,32.96790994623659,0
601,4,0,0,32,0.0,0.0,1.0,32,1100,900,200,0.8181818181818182,13,9,4,388.20485738615287,0.3639322916666667,0.09000046290581398,0.22415164288561823,130778.6693481532,3753.782936690128,134532.4522848433,598,7,361.5,32,0,19,34.35969839114513,0.6370442708333334,44.28661616161616,1022.853535353535,31.96417297979797,0
602,4,0,0,32,0.0,0.0,1.0,32,700,500,200,0.7142857142857143,9,5,4,385.05765481568454,0.36317624327956993,0.0889601073676416,0.22270679350260472,130843.25140610656,3676.439106978885,134519.69051308546,599,8,362.5,32,0,19,34.37461434036776,0.6376953125,44.22348484848485,1023.1060606060609,31.9720643939394,0
603,4,0,0,32,0.0,0.0,1.0,32,1000,700,300,0.7,13,7,6,386.5138350330201,0.3631342405913978,0.09250077112893251,0.2239238479587297,130907.8494063106,3719.5389819916354,134627.38838830224,600,9,363.5,32,0,19,34.27179724449928,0.6383463541666666,44.160353535353536,1023.358585858586,31.979955808080813,0
604,4,0,0,32,0.0,0.0,1.0,32,1050,700,350,0.6666666666666666,14,7,7,387.64152517399936,0.3626302083333333,0.09347253052164284,0.22533226721404742,131037.09323347113,3759.083735078063,134796.17696854917,601,10,364.5,32,0,19,34.111789369836,0.6396484375,44.034090909090914,1023.8636363636367,31.995738636363647,0
605,4,0,0,32,0.0,0.0,1.0,32,450,300,150,0.6666666666666666,6,3,3,386.3216086636412,0.3631342405913978,0.08938093330045627,0.22494289790888677,131101.73906042744,3729.4869464850435,134831.22600691247,602,11,365.5,32,0,19,34.08000452060987,0.6402994791666667,43.97095959595959,1024.116161616161,32.00363005050503,0
606,4,0,0,32,0.0,0.0,1.0,32,1000,900,100,0.9,11,9,2,385.62341925844095,0.36300823252688175,0.08351180204609876,0.2249146513618787,131166.40082963475,3716.1671959493947,134882.56802558413,603,12,366.5,32,0,19,34.03231439253871,0.6409505208333334,43.907828282828284,1024.368686868687,32.01152146464647,0
607,4,0,0,32,0.0,0.0,1.0,32,700,500,200,0.7142857142857143,9,5,4,387.19971573146205,0.362336189516129,0.08933687615526842,0.2262149527113617,131231.0785410927,3762.5272612488498,134993.60580234154,604,13,367.5,32,0,19,33.92637091805298,0.6416015625,43.84469696969697,1024.6212121212118,32.01941287878787,0
608,4,0,0,32,0.0,0.0,1.0,32,800,700,100,0.875,9,7,2,389.48276582219927,0.36174815188172044,0.09136844277911838,0.22832448364245544,131361.49300469298,3832.643393664549,135194.13639835754,605,14,368.5,31,1,19,33.735684194927806,0.645497311827957,43.71744791666667,1025.130208333334,33.068716397849485,0
609,4,0,0,32,0.0,0.0,1.0,32,850,600,250,0.7058823529411765,11,6,5,387.5031008871583,0.36202116935483875,0.09495588981975134,0.2281576553653986,131528.39660644528,3793.532307942707,135321.928914388,606,15,369.5,31,1,20,33.61735211982736,0.6471774193548387,43.5546875,1025.7812499999998,33.08971774193547,0
610,4,2,1,33,0.058823529411764705,0.029411764705882353,0.9705882352941176,34,900,600,300,0.6666666666666666,12,6,6,372.5978031418143,0.37435011883541297,0.09555580487052384,0.22278852249156678,132114.37795859776,3045.1053981641817,135159.48335676195,607,0,348.70588235294116,33,1,19,33.40771148726507,0.6480429292929293,42.98406862745099,1028.063725490197,31.153446226975664,0
611,4,0,0,33,0.0,0.0,1.0,33,400,100,300,0.25,7,1,6,381.3275450705005,0.3667929292929293,0.105906055764726,0.22698333827642017,131943.58555568318,3462.7447135496527,135406.33026923283,608,1,360.27272727272725,32,1,19,33.35586415960018,0.6487630208333333,43.15025252525253,1027.3989898989907,32.10621843434346,0
612,4,1,0,34,0.029411764705882353,0.0,1.0,34,700,500,200,0.7142857142857143,9,5,4,374.5349046861938,0.3698009506833036,0.12157656584901178,0.22563444257924362,132398.00347222228,3117.5347222222263,135515.5381944445,609,0,350.6470588235294,33,1,21,33.071862348178136,0.6508838383838383,42.708333333333336,1029.166666666667,31.186868686868696,0
613,4,1,1,34,0.02857142857142857,0.02857142857142857,0.9714285714285714,35,650,400,250,0.6153846153846154,9,4,5,367.50767168337137,0.37514005602240896,0.11530282015718907,0.22266641284345465,132612.50000000012,2747.222222222236,135359.72222222236,610,0,341.6,34,1,21,33.036677454153185,0.650735294117647,42.50000000000001,1030.000000000001,30.29411764705885,0
614,4,0,0,34,0.0,0.0,1.0,34,1000,800,200,0.8,12,8,4,379.4439798694937,0.36799985145573383,0.12276656052069868,0.22993703322300593,132618.81134960108,3264.281916810839,135883.09326641192,611,2,352.6470588235294,33,1,21,32.722957564941495,0.6530934343434343,42.493872549019606,1030.0245098039213,31.212863933452162,0
615,4,0,0,34,0.0,0.0,1.0,34,950,700,250,0.7368421052631579,12,7,5,379.4786533780069,0.36764705882352944,0.11936810880394022,0.23053876572270843,132713.49961553258,3272.3880238369943,135985.88763936958,612,3,353.6470588235294,33,1,20,32.626665080875355,0.654040404040404,42.40196078431373,1030.3921568627457,31.224004753416533,0
616,4,0,0,34,0.0,0.0,1.0,34,900,600,300,0.6666666666666666,12,6,6,376.83398204900146,0.36792557932263814,0.11315471154585732,0.22989878832329566,132871.38848339568,3214.0908845155586,136085.47936791123,613,4,354.6470588235294,33,1,20,32.53583244185586,0.6556186868686869,42.248774509803916,1031.0049019607834,31.242572786690406,0
617,4,0,0,34,0.0,0.0,1.0,34,1000,700,300,0.7,13,7,6,377.1451892664014,0.3677770350564468,0.1146167557932265,0.23047761566280087,132934.5703125,3227.1267361111118,136161.69704861112,614,5,355.6470588235294,33,1,20,32.464225589225585,0.65625,42.1875,1031.25,31.25,0
618,4,0,0,34,0.0,0.0,1.0,34,1250,1000,250,0.8,15,10,5,376.23222048308514,0.3680184194890077,0.11075007337218601,0.23050384512566302,133029.37121539787,3209.987144367548,136239.3583597654,615,6,356.6470588235294,33,1,21,32.392393284232206,0.6571969696969697,42.095588235294116,1031.6176470588232,31.26114081996434,0
619,4,0,0,34,0.0,0.0,1.0,34,850,600,250,0.7058823529411765,11,6,5,374.5795513703853,0.36740567439096855,0.1142486919955017,0.23007544873012495,133124.20590938572,3173.1210652152954,136297.32697460102,616,7,357.6470588235294,33,1,21,32.339661758302675,0.6581439393939394,42.00367647058823,1031.9852941176464,31.27228163992868,0
620,4,0,0,34,0.0,0.0,1.0,34,850,400,450,0.47058823529411764,13,4,9,373.49196299813605,0.36688576945929885,0.10706105804145061,0.2299924193199047,133219.0743944636,3151.2507208765765,136370.32511534018,617,8,358.6470588235294,33,1,21,32.27237654320987,0.6590909090909092,41.91176470588235,1032.3529411764698,31.283422459893025,0
621,4,0,0,34,0.0,0.0,1.0,34,950,700,250,0.7368421052631579,12,7,5,375.60990024611317,0.36558600713012473,0.10266555020584756,0.23248101755321085,133408.91273788913,3221.9416810841826,136630.85441897332,618,9,359.6470588235294,33,1,21,32.02698695136417,0.6609848484848486,41.72794117647058,1033.0882352941167,31.305704099821718,0
622,4,0,0,34,0.0,0.0,1.0,34,1200,800,400,0.6666666666666666,16,8,8,375.88337471742625,0.36579025549613786,0.10782221106158585,0.23324683583458808,133503.8825962369,3236.3779856305073,136740.2605818674,619,10,360.6470588235294,33,1,21,31.92455729475473,0.6619318181818183,41.636029411764696,1033.45588235294,31.316844919786064,0
623,4,0,0,34,0.0,0.0,1.0,34,1050,800,250,0.7619047619047619,13,8,5,380.05919986122365,0.3641748366013072,0.12523438099022055,0.23705244550102472,133693.92368620235,3362.321132497105,137056.24481869946,620,11,361.6470588235294,33,1,21,31.625859106529205,0.6638257575757576,41.452205882352935,1034.1911764705876,31.339126559714774,0
624,4,1,1,34,0.02857142857142857,0.02857142857142857,0.9714285714285714,35,1100,800,300,0.7272727272727273,14,8,6,372.96257901835816,0.3692226890756303,0.1175114147751537,0.23473433518825457,134026.36763038547,2997.3639455782295,137023.7315759637,621,0,352.2857142857143,34,1,20,31.476105618149774,0.664828431372549,41.13095238095238,1035.4761904761904,30.45518207282913,0
625,4,0,0,34,0.0,0.0,1.0,34,400,200,200,0.5,6,2,4,383.36780496737106,0.3638591800356506,0.12069830300665951,0.2401452333193235,133852.39451172625,3462.9397347174126,137315.33424644367,622,13,363.6470588235294,33,1,20,31.38125690825833,0.6654040404040404,41.299019607843135,1034.8039215686274,31.357694592988707,0
626,4,0,0,34,0.0,0.0,1.0,34,550,200,350,0.36363636363636365,9,2,7,383.22237912706623,0.3635806595365419,0.1237090787540307,0.2406750510398756,133947.5220618271,3466.3376165417085,137413.8596783688,623,14,364.6470588235294,33,1,20,31.289585059784542,0.6663510101010102,41.20710784313725,1035.1715686274504,31.368835412953043,0
627,4,0,0,34,0.0,0.0,1.0,34,900,600,300,0.6666666666666666,12,6,6,382.2127938658107,0.3636177956030897,0.11829802343472595,0.24045539057127568,134010.95920138882,3444.1406249999905,137455.09982638882,624,15,365.6470588235294,33,1,20,31.252095908786043,0.6669823232323233,41.14583333333333,1035.416666666666,31.37626262626261,0
628,4,0,1,33,0.0,0.029411764705882353,0.9705882352941176,34,700,500,200,0.7142857142857143,9,5,4,383.63642729596313,0.36356209150326796,0.12222067525234981,0.24155944937786042,134042.68340301796,3484.731233179536,137527.4146361975,625,16,366.6470588235294,33,1,20,31.183431952662726,0.6672979797979799,41.11519607843137,1035.5392156862738,31.379976232917386,0
629,4,0,0,33,0.0,0.0,1.0,33,1350,900,450,0.6666666666666666,18,9,9,386.54051181615534,0.3627683080808081,0.12274112237549173,0.24415434175916503,134158.07578627174,3771.506255739203,137929.58204201094,626,17,367.45454545454544,32,1,20,30.992535039609997,0.6708984375,41.003787878787875,1035.984848484848,32.3745265151515,0
630,4,0,0,33,0.0,0.0,1.0,33,1200,900,300,0.75,15,9,6,383.8905941923417,0.3634785353535353,0.1194035359687009,0.24356582521786116,134321.6333154779,3712.962325272922,138034.59564075083,627,18,368.45454545454544,32,1,22,30.897279740154282,0.6725260416666667,40.84595959595959,1036.6161616161608,32.39425505050502,0
631,4,0,0,33,0.0,0.0,1.0,33,950,800,150,0.8421052631578947,11,8,3,381.7228082325905,0.36316287878787884,0.10996746131881285,0.24305977882344945,134452.5510789715,3664.721074380164,138117.27215335166,628,19,369.45454545454544,32,1,22,30.822376430484546,0.673828125,40.71969696969697,1037.121212121212,32.410037878787875,0
632,4,0,0,33,0.0,0.0,1.0,33,1000,700,300,0.7,13,7,6,383.2679228194037,0.36190025252525254,0.10443446388931865,0.24492191210963155,134583.53261146828,3716.310197938991,138299.84280940727,629,20,370.45454545454544,32,1,22,30.651212784943613,0.6751302083333333,40.593434343434346,1037.6262626262633,32.42582070707073,0
633,4,0,0,33,0.0,0.0,1.0,33,400,100,300,0.25,7,1,6,383.19110641985566,0.3612294823232323,0.10570121602842741,0.2455350027963859,134681.81060924896,3721.7744043975035,138403.58501364646,630,21,371.45454545454544,32,1,22,30.554879779426685,0.6761067708333334,40.49873737373737,1038.0050505050497,32.4376578282828,0
634,4,0,0,33,0.0,0.0,1.0,33,750,600,150,0.8,9,6,3,380.7696274735423,0.36205808080808083,0.10113046810517612,0.24464448565175104,134780.12447709424,3664.0355575961726,138444.1600346904,631,22,372.45454545454544,32,1,17,30.519414721141374,0.6770833333333333,40.40404040404041,1038.383838383839,32.44949494949497,0
635,4,0,0,33,0.0,0.0,1.0,33,650,400,250,0.6153846153846154,9,4,5,380.7696274735423,0.36249210858585856,0.10113046810517612,0.24464448565175104,134780.12447709424,3664.0355575961726,138444.1600346904,632,23,373.45454545454544,32,1,17,30.519414721141374,0.6770833333333333,40.40404040404041,1038.383838383839,32.44949494949497,0
636,4,0,0,33,0.0,0.0,1.0,33,700,400,300,0.5714285714285714,10,4,6,386.0111969877131,0.36249210858585856,0.0747561825148031,0.22388649425287346,130951.5570934255,3509.7534602075984,134461.31055363308,633,24,374.45454545454544,33,0,19,34.24030172413792,0.6363636363636365,44.11764705882352,1023.5294117647051,31.016042780748638,7
637,4,2,2,33,0.05714285714285714,0.05714285714285714,0.9428571428571428,35,850,500,350,0.5882352941176471,12,5,7,366.1107815233468,0.3744047619047619,0.06210978298711889,0.21563749859102377,131541.75347222213,2632.311490772776,134174.06496299492,634,0,354.0,34,1,20,34.15245058218251,0.6400122549019608,43.541666666666664,1025.8333333333328,30.171568627450966,0
638,4,0,0,33,0.0,0.0,1.0,33,500,200,300,0.4,8,2,6,377.09035626941625,0.3673453282828283,0.06454791820645478,0.2208672086720867,131328.12500000003,3304.5138888888905,134632.63888888893,635,1,363.3333333333333,32,1,20,34.0870596205962,0.642578125,43.75,1025.0000000000002,32.03125000000001,0
639,4,0,0,33,0.0,0.0,1.0,33,800,500,300,0.625,11,5,6,378.4616740874437,0.36710858585858586,0.06365091625527541,0.22223335179060955,131425.20732897156,3347.8807966023896,134773.08812557397,636,2,364.3333333333333,32,1,20,33.95363871444404,0.6435546875,43.65530303030303,1025.378787878788,32.043087121212125,0
640,4,1,1,33,0.029411764705882353,0.029411764705882353,0.9705882352941176,34,1050,800,250,0.7619047619047619,13,8,5,369.6704465543858,0.37186200237670824,0.05003755888320249,0.21921222021791906,131799.59518274208,2944.4830413783,134744.07822412037,637,0,354.5882352941176,33,1,19,33.80064745196324,0.6448863636363638,43.29044117647058,1026.8382352941167,31.116310160427776,0
641,4,0,0,33,0.0,0.0,1.0,33,600,300,300,0.5,9,3,6,379.56789795668,0.36620107323232326,0.058063722475089063,0.2244005412719892,131684.26890432098,3396.6242283950637,135080.89313271604,638,4,366.3333333333333,32,1,19,33.66317095173659,0.6461588541666666,43.40277777777778,1026.388888888889,32.07465277777778,0
642,4,1,0,34,0.029411764705882353,0.0,1.0,34,900,600,300,0.6666666666666666,12,6,6,373.07918713275484,0.37149064171123,0.053440548748413086,0.22270570409127488,132051.39136690204,3053.125150182612,135104.51651708464,639,0,356.52941176470586,33,1,20,33.45889968602201,0.6474116161616161,43.045343137254896,1027.8186274509796,31.14601901366605,0
643,4,2,1,35,0.05555555555555555,0.027777777777777776,0.9722222222222222,36,1000,700,300,0.7,13,7,6,361.5401366497603,0.3782572751322751,0.062492978317042924,0.2193639234028296,132666.15125868033,2392.82769097219,135058.97894965252,640,0,337.6666666666667,35,1,18,33.13637512639028,0.649107142857143,42.44791666666665,1030.2083333333314,29.434523809523757,0
644,4,0,0,35,0.0,0.0,1.0,35,950,700,250,0.7368421052631579,12,7,5,373.40278336656775,0.3745798319327731,0.06121835625939265,0.22605370741106862,132581.8470096368,2901.2861394557403,135483.13314909255,641,1,348.3142857142857,34,1,21,32.91575155088044,0.6504289215686276,42.529761904761884,1029.8809523809493,30.29061624649851,0
645,4,1,1,35,0.027777777777777776,0.027777777777777776,0.9722222222222222,36,600,500,100,0.8333333333333334,7,5,2,363.601317922888,0.38093584656084656,0.051721879094142054,0.22131713848963164,132785.41512613566,2456.1903881601183,135241.60551429578,642,0,339.6111111111111,35,1,19,32.963339883960316,0.6502976190476192,42.33217592592591,1030.6712962962938,29.44775132275125,0
646,4,0,0,35,0.0,0.0,1.0,35,1050,800,250,0.7619047619047619,13,8,5,371.32524403702365,0.37408963585434174,0.05933456561922412,0.22571568204947132,132735.14739228997,2857.5821995464553,135592.72959183643,643,3,350.3142857142857,34,1,19,32.81490680837954,0.6519607843137256,42.380952380952365,1030.4761904761883,30.308123249299655,0
647,4,0,0,35,0.0,0.0,1.0,35,650,400,250,0.6153846153846154,9,4,5,375.3086847761739,0.37272408963585435,0.05750577367205567,0.2288854373353283,132857.85147392272,2972.541099773225,135830.39257369595,644,4,351.3142857142857,34,1,19,32.58877020785221,0.653186274509804,42.26190476190475,1030.9523809523796,30.322128851540576,0
648,4,0,1,34,0.0,0.02857142857142857,0.9714285714285714,35,750,600,150,0.8,9,6,3,377.17283988510434,0.37212885154061626,0.061680517082179254,0.2307786359296992,132980.6122448978,3031.3350340135844,136011.9472789114,645,5,352.3142857142857,34,1,19,32.41718605724838,0.6544117647058825,42.14285714285713,1031.4285714285702,30.336134453781476,0
649,4,0,1,33,0.0,0.029411764705882353,0.9705882352941176,34,650,400,250,0.6153846153846154,9,4,5,386.7918190612283,0.36686720142602497,0.06499671415987374,0.23617317602185584,132902.97752066504,3481.1568867743044,136384.13440743933,646,6,363.5,33,1,19,32.24734569368514,0.6559343434343434,42.218137254901954,1031.1274509803914,31.246286393345194,0
650,4,0,0,33,0.0,0.0,1.0,33,500,200,300,0.4,8,2,6,396.23702422145334,0.362176452020202,0.06920677361853822,0.24057247899159653,132690.54178145074,3915.3810835628838,136605.92286501362,647,7,375.1515151515151,32,1,19,32.21813725490195,0.65625,42.424242424242415,1030.3030303030293,32.19696969696967,0
651,4,0,0,33,0.0,0.0,1.0,33,600,400,200,0.6666666666666666,8,4,4,397.92723803766205,0.36186079545454547,0.07664294544118166,0.24222819120816044,132788.12629132217,3968.002467860407,136756.12875918258,648,8,376.1515151515151,32,1,19,32.07613622442729,0.6572265625,42.329545454545446,1030.681818181817,32.208806818181785,0
652,4,0,0,33,0.0,0.0,1.0,33,500,300,200,0.6,7,3,4,399.43720471341084,0.36158459595959597,0.08388353838445717,0.2435701849503357,132853.2025590499,4013.3023734822764,136866.50493253217,649,9,377.1515151515151,32,1,19,31.971575831802408,0.6578776041666667,42.26641414141413,1030.934343434342,32.21669823232319,0
653,4,0,0,33,0.0,0.0,1.0,33,900,700,200,0.7777777777777778,11,7,4,401.5579396241575,0.36146622474747475,0.08132506650934457,0.24528973021020872,132918.29476902852,4074.8793171614907,136993.17408619,650,10,378.1515151515151,32,1,19,31.851250969348175,0.6585286458333335,42.203282828282816,1031.1868686868675,32.22458964646461,0
654,4,0,0,33,0.0,0.0,1.0,33,1000,600,400,0.6,14,6,8,400.31702033976063,0.3614267676767677,0.07735286261241248,0.2447447172256857,132950.84685236184,4044.4973727170513,136995.34422507888,651,11,379.1515151515151,32,1,19,31.850412177603673,0.6588541666666667,42.17171717171716,1031.3131313131298,32.22853535353531,0
655,4,0,0,33,0.0,0.0,1.0,33,1000,700,300,0.7,13,7,6,402.1063651320402,0.36107165404040403,0.08056334267788023,0.24669768887830565,133081.0950413222,4102.551078971524,137183.64612029374,652,12,380.1515151515151,32,1,19,31.67293808125306,0.66015625,42.04545454545454,1031.818181818181,32.24431818181816,0
656,4,0,0,33,0.0,0.0,1.0,33,1450,1400,50,0.9655172413793104,15,14,1,399.81943237043396,0.36020359848484845,0.0854830101405446,0.24615389149553185,133211.40699928554,4052.1018263442174,137263.50882562975,653,13,381.1515151515151,32,1,19,31.600619699934764,0.6614583333333335,41.9191919191919,1032.3232323232303,32.260101010100946,0
657,4,0,0,33,0.0,0.0,1.0,33,500,400,100,0.8,6,4,2,400.36076275425637,0.35980902777777773,0.08507374762418163,0.24713590026921212,133309.18281616663,4074.353222885403,137383.53603905204,654,14,382.1515151515151,32,1,19,31.48816073684639,0.6624348958333335,41.82449494949494,1032.7020202020194,32.27193813131311,0
658,4,0,0,33,0.0,0.0,1.0,33,550,300,250,0.5454545454545454,8,3,5,399.36259467027406,0.35961174242424243,0.0823851278234955,0.2469719229989535,133377.2636275709,4053.17801446556,137430.44164203646,655,15,383.1515151515151,33,0,19,31.44538201447382,0.660669191919192,41.758578431372534,1032.965686274508,31.301990493166908,0
659,4,0,0,33,0.0,0.0,1.0,33,300,200,100,0.6666666666666666,4,2,2,399.36259467027406,0.35961174242424243,0.0823851278234955,0.2469719229989535,133377.2636275709,4053.17801446556,137430.44164203646,656,16,384.1515151515151,33,0,19,31.44538201447382,0.660669191919192,41.758578431372534,1032.965686274508,31.301990493166908,0
660,4,0,0,33,0.0,0.0,1.0,33,700,500,200,0.7142857142857143,9,5,4,400.4368914461816,0.359414457070707,0.07939035052554044,0.24849629455890082,133505.86149427615,4092.2020155024056,137598.06350977856,657,17,385.1515151515151,31,2,19,31.288191382134315,0.667002688172043,41.63411458333333,1033.4635416666658,33.33753360215051,0
661,4,0,0,33,0.0,0.0,1.0,33,900,800,100,0.8888888888888888,10,8,2,399.1624843758926,0.3585069444444444,0.08319975574383665,0.24838167131227146,133606.80474175338,4066.164822048603,137672.96956380198,658,18,386.1515151515151,31,2,19,31.219563392107474,0.668010752688172,41.53645833333333,1033.8541666666658,33.35013440860212,0
662,4,1,1,33,0.029411764705882353,0.029411764705882353,0.9705882352941176,34,1000,600,400,0.6,14,6,8,388.38689976184094,0.364434789067142,0.07197396464990802,0.243581286713681,133896.59098880214,3600.7363725640184,137497.32736136616,659,0,375.7647058823529,32,2,17,31.207047293725342,0.6682942708333334,41.25631313131313,1034.9747474747471,32.34296085858585,0
663,4,0,0,33,0.0,0.0,1.0,33,950,800,150,0.8421052631578947,11,8,3,398.834135017631,0.358230744949495,0.07476578473557316,0.2490832050770488,133741.455078125,4068.131510416668,137809.58658854166,660,20,388.1515151515151,31,2,18,31.092648539778452,0.6693548387096775,41.40625,1034.375,33.36693548387097,0
664,4,0,0,33,0.0,0.0,1.0,33,650,400,250,0.6153846153846154,9,4,5,408.77825500388883,0.35838857323232326,0.0845079065557488,0.2456088967897887,132297.5179884167,4216.0697089300975,136513.58769734678,661,21,389.1515151515151,31,2,18,32.29245770577565,0.6549059139784947,42.80598958333332,1028.7760416666652,33.186323924731134,2
665,4,0,0,33,0.0,0.0,1.0,33,700,700,0,1.0,7,7,0,408.95746368078585,0.358270202020202,0.08668307984936718,0.24593469391214362,132331.0089111327,4223.550754123249,136554.55966525595,662,22,390.1515151515151,31,2,18,32.25396524086729,0.655241935483871,42.77343749999999,1028.906249999999,33.190524193548356,0
666,4,0,0,33,0.0,0.0,1.0,33,1000,800,200,0.8,12,8,4,407.31695323640787,0.3585069444444444,0.0861244019138756,0.24538362792534818,132398.00347222225,4185.607231987852,136583.6107042101,663,23,391.1515151515151,30,3,18,32.228407557354934,0.6586805555555555,42.708333333333336,1029.1666666666667,34.30555555555556,0
667,4,0,0,33,0.0,0.0,1.0,33,600,400,200,0.6666666666666666,8,4,4,416.3701609655411,0.3580334595959596,0.10347914597206409,0.25155273050020827,132505.23003472216,4512.369791666662,137017.59982638882,664,24,392.1515151515151,29,4,21,31.886972210980712,0.6627155172413793,42.604166666666664,1029.583333333333,35.50287356321838,5
668,4,0,1,32,0.0,0.030303030303030304,0.9696969696969697,33,550,400,150,0.7272727272727273,7,4,3,415.9782282573474,0.3581123737373737,0.10247606902583972,0.25155486005709393,132540.98186728382,4426.832561728376,136967.81442901219,665,25,393.1515151515151,29,4,21,31.860893804513985,0.6630747126436782,42.569444444444436,1029.7222222222213,35.50766283524901,0
669,4,0,0,32,0.0,0.0,1.0,32,1150,900,250,0.782608695652174,14,9,5,417.5394866249956,0.35567876344086025,0.10327461227242041,0.25273920761831353,132576.73852237646,4671.20466820986,137247.94319058632,666,26,394.25,29,3,21,31.784530231512694,0.663433908045977,42.534722222222214,1029.8611111111104,35.51245210727967,0
670,4,0,0,32,0.0,0.0,1.0,32,400,200,200,0.5,6,2,4,415.16113153402245,0.3553217405913978,0.10285194174757306,0.2515388032235548,132612.5,4611.111111111111,137223.61111111112,667,27,395.25,29,3,21,31.80960086299892,0.6637931034482758,42.5,1030.0,35.51724137931034,0
671,4,1,1,32,0.030303030303030304,0.030303030303030304,0.9696969696969697,33,650,300,350,0.46153846153846156,10,3,7,406.29860493736953,0.3629655934343434,0.09207854292600093,0.24771941970346759,132847.95388195157,4195.187666204174,137043.14154815575,668,0,384.24242424242425,30,3,20,31.800032594524133,0.6631944444444444,42.27150537634408,1030.9139784946228,34.363799283154094,0
672,4,0,0,32,0.0,0.0,1.0,32,550,300,250,0.5454545454545454,8,3,5,420.39305534957487,0.3546286962365592,0.1008264253942579,0.255437844196437,132719.8133680556,4758.89756944445,137478.71093750003,669,29,397.25,29,3,20,31.566333063755224,0.6648706896551724,42.395833333333336,1030.416666666667,35.53160919540231,0
673,4,0,0,32,0.0,0.0,1.0,32,600,400,200,0.6666666666666666,8,4,4,420.9138265487757,0.3549857190860215,0.09888814016172542,0.2559984092616324,132755.5941358025,4775.733024691364,137531.32716049388,670,30,398.25,29,3,20,31.516734052111424,0.6652298850574712,42.361111111111114,1030.5555555555557,35.53639846743295,0
674,4,0,0,32,0.0,0.0,1.0,32,650,400,250,0.6153846153846154,9,4,5,420.9138265487757,0.3549857190860215,0.09888814016172542,0.2559984092616324,132755.5941358025,4775.733024691364,137531.32716049388,671,31,399.25,29,3,20,31.516734052111424,0.6652298850574712,42.361111111111114,1030.5555555555557,35.53639846743295,0
675,4,0,0,32,0.0,0.0,1.0,32,1050,700,350,0.6666666666666666,14,7,7,423.5545224089628,0.3553427419354838,0.09248686337914314,0.2580970168570871,132827.17013888885,4851.909722222218,137679.07986111107,672,32,400.25,29,3,20,31.376313662085693,0.665948275862069,42.291666666666664,1030.833333333333,35.545977011494244,0
676,4,1,0,33,0.030303030303030304,0.0,1.0,33,500,400,100,0.8,6,4,2,410.0878997811676,0.36107165404040403,0.09137079875457266,0.25212690011365785,133159.90513715456,4321.453166551046,137481.3583037056,673,0,389.09090909090907,30,3,21,31.387550462299796,0.6663194444444445,41.969086021505376,1032.1236559139784,34.40412186379928,0
677,4,0,0,33,0.0,0.0,1.0,33,900,600,300,0.6666666666666666,12,6,6,406.5919302967252,0.3612294823232323,0.08852650430364539,0.2506773040561348,133263.9701844143,4236.810975257238,137500.78115967155,674,1,390.09090909090907,30,3,22,31.372852121843252,0.6673611111111111,41.868279569892465,1032.5268817204294,34.41756272401431,0
678,4,0,0,33,0.0,0.0,1.0,33,750,600,150,0.8,9,6,3,404.6613998835403,0.3611505681818182,0.08835295331323567,0.2497563861849307,133304.08944023986,4188.603888617627,137492.69332885748,675,2,391.09090909090907,31,2,22,31.382260538813945,0.6649865591397849,41.829427083333336,1032.682291666667,33.31233198924732,0
679,4,0,0,33,0.0,0.0,1.0,33,950,500,450,0.5263157894736842,14,5,9,404.6613998835403,0.3609532828282828,0.08835295331323567,0.2497563861849307,133304.08944023986,4188.603888617627,137492.69332885748,676,3,392.09090909090907,31,2,22,31.382260538813945,0.6649865591397849,41.829427083333336,1032.682291666667,33.31233198924732,0
680,4,1,1,33,0.029411764705882353,0.029411764705882353,0.9705882352941176,34,1000,600,400,0.6,14,6,8,391.8759787101666,0.3677770350564468,0.07152591583095114,0.24429191702638475,133674.12143283416,3676.8413967556376,137350.9628295898,677,0,381.52941176470586,31,3,22,31.340237555611512,0.6686827956989247,41.471354166666664,1034.114583333333,33.35853494623655,0
681,4,0,0,33,0.0,0.0,1.0,33,1300,1100,200,0.8461538461538461,15,11,4,404.675281289949,0.3623342803030303,0.07814826192783064,0.25231536582211234,133680.63685108098,4219.449864146136,137900.0867152271,678,5,394.09090909090907,30,3,22,31.002783554284726,0.6715277777777777,41.46505376344086,1034.139784946236,34.47132616487453,0
682,4,0,0,33,0.0,0.0,1.0,33,800,500,300,0.625,11,5,6,404.675281289949,0.3623342803030303,0.07814826192783064,0.25231536582211234,133680.63685108098,4219.449864146136,137900.0867152271,679,6,395.09090909090907,30,3,22,31.002783554284726,0.6715277777777777,41.46505376344086,1034.139784946236,34.47132616487453,0
683,4,0,1,32,0.0,0.030303030303030304,0.9696969696969697,33,700,300,400,0.42857142857142855,11,3,8,405.576724481034,0.3623342803030303,0.07433829000673242,0.25359253032741835,133784.9051371546,4252.008722106607,138036.9138592612,680,7,396.09090909090907,30,3,18,30.87458317093241,0.6725694444444444,41.36424731182796,1034.5430107526884,34.48476702508961,0
684,4,0,0,32,0.0,0.0,1.0,32,700,500,200,0.7142857142857143,9,5,4,413.3901591509504,0.35683383736559143,0.10060666953000363,0.24861375696834642,132333.03880024992,4541.035194112841,136874.07399436276,681,41,409.25,32,0,18,32.137890129668264,0.6526692708333334,42.77146464646464,1028.914141414141,32.15356691919191,2
685,4,0,0,32,0.0,0.0,1.0,32,550,300,250,0.5454545454545454,8,3,5,413.44393953547956,0.35635080645161293,0.10170816977428854,0.24928957064299023,132430.49178655236,4550.516847770632,136981.008634323,682,42,410.25,32,0,18,32.03789458619561,0.6536458333333334,42.676767676767675,1029.292929292929,32.165404040404034,0
686,4,0,0,32,0.0,0.0,1.0,32,850,600,250,0.7058823529411765,11,6,5,412.3491650372571,0.3559517809139785,0.0992924383662459,0.24884402239443032,132462.98408644515,4524.200177277816,136987.18426372297,683,43,411.25,32,0,18,32.03319841367185,0.6539713541666667,42.645202020202014,1029.419191919191,32.16934974747472,0
687,4,0,0,32,0.0,0.0,1.0,32,850,700,150,0.8235294117647058,10,7,3,411.9534212815764,0.356476814516129,0.09710642471799913,0.2492501560810486,132560.48489949995,4521.749056218741,137082.2339557187,684,44,412.25,32,0,18,31.944785025339225,0.6549479166666667,42.550505050505045,1029.797979797979,32.181186868686844,0
688,4,0,0,32,0.0,0.0,1.0,32,1100,800,300,0.7272727272727273,14,8,6,406.03017832647447,0.356476814516129,0.11712962962962958,0.23424817980373547,130746.38429752081,4217.395546372839,134963.77984389366,685,45,413.25,32,0,16,33.936728395061735,0.63671875,44.31818181818183,1022.7272727272739,31.96022727272731,3
689,4,1,0,33,0.030303030303030304,0.0,1.0,33,400,200,200,0.5,6,2,4,396.32706458251664,0.3627683080808081,0.1149165179801852,0.23062040053283483,131077.0196559015,3789.8740868896525,134866.89374279114,686,0,401.6969696969697,33,0,17,33.84893090793044,0.6376262626262627,43.995098039215684,1024.0196078431368,31.030897207367783,0
690,4,0,0,33,0.0,0.0,1.0,33,550,300,250,0.5454545454545454,8,3,5,396.0639781107094,0.3631234217171717,0.11613562935807753,0.23065551672970017,131108.39468293442,3785.462472366391,134893.85715530082,687,1,402.6969696969697,33,0,18,33.82381536436519,0.6379419191919192,43.96446078431372,1024.1421568627447,31.034610814022567,0
691,4,0,0,33,0.0,0.0,1.0,33,1150,900,250,0.782608695652174,14,9,5,395.59996259066867,0.36316287878787884,0.11974824171404341,0.2315187184846578,131296.72369100817,3788.1957960880304,135084.9194870962,688,2,403.6969696969697,33,0,18,33.64460022320539,0.6398358585858586,43.780637254901954,1024.8774509803914,31.056892453951253,0
692,4,0,0,33,0.0,0.0,1.0,33,650,400,250,0.6153846153846154,9,4,5,394.5945038262849,0.3630839646464647,0.12095129417305128,0.23130925189256293,131359.53006355732,3766.7497176566703,135126.279781214,689,3,404.6969696969697,33,0,18,33.60666965530981,0.6404671717171717,43.71936274509804,1025.122549019608,31.064319667260847,0
693,4,1,0,34,0.029411764705882353,0.0,1.0,34,850,700,150,0.8235294117647058,10,7,3,389.67614895606005,0.3645090612002377,0.1323921659583469,0.23062302213096117,131725.00177154187,3466.018282312917,135191.0200538548,690,0,393.7647058823529,34,0,16,33.36256716533302,0.6418504901960784,43.363095238095234,1026.5476190476184,30.192577030812306,0
694,4,0,0,34,0.0,0.0,1.0,34,700,500,200,0.7142857142857143,9,5,4,389.68437663037173,0.364657605466429,0.1344786204733428,0.23137007000620896,131847.2381660997,3475.7617630385375,135322.99992913826,691,1,394.7647058823529,34,0,17,33.23866929407673,0.6430759803921569,43.24404761904761,1027.023809523809,30.206582633053205,0
695,4,0,1,33,0.0,0.029411764705882353,0.9705882352941176,34,700,600,100,0.8571428571428571,8,6,2,389.5377786723447,0.36521464646464646,0.1368016793091935,0.2320290246874399,131969.53124999988,3481.4236111110977,135450.95486111098,692,2,395.7647058823529,34,0,17,33.11874831035415,0.6443014705882353,43.12499999999999,1027.499999999999,30.22058823529409,0
696,4,0,0,33,0.0,0.0,1.0,33,350,100,250,0.2857142857142857,6,1,5,397.32728791313696,0.36466224747474746,0.13276784067859126,0.2360028348688873,131862.52170138885,3878.515624999996,135741.03732638885,693,3,394.969696969697,33,0,17,33.02696078431372,0.6455176767676768,43.229166666666664,1027.083333333333,31.123737373737363,0
697,4,1,0,34,0.029411764705882353,0.0,1.0,34,1100,900,200,0.8181818181818182,13,9,4,392.52150780013244,0.36922534165181226,0.08649920822861135,0.2260767546348133,130681.82615294373,3495.9778498367737,134177.8040027805,694,0,384.3235294117647,32,2,17,34.34772989215444,0.6360677083333333,44.38131313131314,1022.4747474747487,31.952335858585897,4
698,4,0,0,34,0.0,0.0,1.0,34,1150,800,350,0.6956521739130435,15,8,7,385.79919179331074,0.370803624480095,0.08357056286817555,0.22303681808106396,130826.15460399872,3294.5249423299056,134120.6795463286,695,1,385.3235294117647,33,1,18,34.37300351381569,0.6351010101010099,44.24019607843139,1023.0392156862765,31.001188354129592,0
699,4,0,1,33,0.0,0.029411764705882353,0.9705882352941176,34,650,500,150,0.7692307692307693,8,5,3,383.2382593543045,0.37078505644682114,0.08155768594109891,0.22209734239193638,130920.20083922074,3234.7259767878027,134154.92681600855,696,2,386.3235294117647,33,1,19,34.343067696483466,0.6360479797979797,44.148284313725505,1023.4068627450999,31.01232917409394,0
700,4,0,0,33,0.0,0.0,1.0,33,850,500,350,0.5882352941176471,12,5,7,396.6615055883709,0.3689630681818182,0.10110860951358847,0.2172300149719025,128705.44645521369,3611.133755247936,132316.58021046163,697,3,398.8484848484849,31,2,18,36.259169553873136,0.6186155913978495,46.32161458333333,1014.7135416666661,32.7326948924731,5
701,4,0,0,33,0.0,0.0,1.0,33,650,500,150,0.7692307692307693,8,5,3,397.0066874620416,0.36762152777777773,0.10165275121662942,0.21796226306014635,128804.55864800356,3627.2542317708385,132431.8128797744,698,4,399.8484848484849,31,2,19,36.14887976740208,0.6196236559139785,46.223958333333336,1015.1041666666673,32.74529569892475,0
702,4,2,0,35,0.05714285714285714,0.0,1.0,35,600,400,200,0.6666666666666666,8,4,4,377.38495682918307,0.37986694677871147,0.10294649505371734,0.21030207345294324,129394.01113406809,2766.881012719533,132160.89214678764,699,0,377.9428571428571,32,3,22,36.04492429883344,0.623046875,45.6439393939394,1017.4242424242435,31.79450757575761,0
703,4,0,0,35,0.0,0.0,1.0,35,1000,500,500,0.5,15,5,10,371.81738467846407,0.379796918767507,0.04201345626713149,0.20190841200469245,128368.35048719529,2548.8223459340975,130917.17283312939,700,1,378.9428571428571,32,3,18,37.23419719245783,0.6126302083333333,46.65404040404041,1013.3838383838392,31.668244949494976,5
704,4,1,2,34,0.027777777777777776,0.05555555555555555,0.9444444444444444,36,850,600,250,0.7058823529411765,11,6,5,360.49527052351254,0.38839285714285715,0.04853229225361577,0.19772330003150537,128765.68657487509,2083.8842031910863,130849.57077806618,701,0,369.3888888888889,33,3,19,37.11512919584642,0.6142676767676767,46.26225490196079,1014.9509803921571,30.756090314913852,0
705,4,1,1,34,0.02857142857142857,0.02857142857142857,0.9714285714285714,35,750,500,250,0.6666666666666666,10,5,5,369.9714495813856,0.3862745098039216,0.04546537469997314,0.20236355325979816,128656.40503838906,2519.839333996544,131176.2443723856,702,0,380.8,32,3,19,36.986361750674135,0.6155598958333333,46.3699494949495,1014.520202020203,31.703756313131343,0
706,4,2,0,36,0.05555555555555555,0.0,1.0,36,1050,700,350,0.6666666666666666,14,7,7,358.19968091383896,0.38950066137566136,0.048509762929012545,0.19785699896446637,129045.69644187331,2044.8254577566283,131090.52189962994,703,0,371.1666666666667,33,3,22,36.88776484541471,0.6171085858585859,45.986519607843135,1016.0539215686274,30.78951277480689,0
707,4,2,2,36,0.05263157894736842,0.05263157894736842,0.9473684210526316,38,800,400,400,0.5,12,4,8,341.1131314720436,0.3986782835467046,0.042248708682456115,0.1904752554509795,129473.85381235811,1233.1402076761915,130706.9940200343,704,0,352.57894736842104,34,4,18,36.88638047334972,0.6191789215686274,45.56547619047618,1017.7380952380938,29.9334733893557,0
708,4,0,0,36,0.0,0.0,1.0,36,1300,1100,200,0.8461538461538461,15,11,4,357.70825927553165,0.38912037037037034,0.05050912703340349,0.19852685127125158,129233.48263251221,2045.5768225181357,131279.05945503034,705,2,373.1666666666667,32,4,22,36.708886957241596,0.6214192708333333,45.80176767676769,1016.7929292929311,31.7747790404041,0
709,4,1,1,36,0.02702702702702703,0.02702702702702703,0.972972972972973,37,700,400,300,0.5714285714285714,10,4,6,347.01219595344173,0.3915165165165165,0.04636272241906059,0.19411651931213758,129544.24267409187,1590.6864246924476,131134.9290987843,706,0,364.05405405405406,33,4,20,36.66473556438344,0.6221590909090908,45.496323529411775,1018.0147058823544,30.848930481283467,0
710,4,1,1,36,0.02702702702702703,0.02702702702702703,0.972972972972973,37,1050,800,250,0.7619047619047619,13,8,5,351.9399503604325,0.3958333333333333,0.0479533799230587,0.1974998600570934,129669.02941476837,1727.1423551038074,131396.1717698722,707,0,365.02702702702703,33,4,20,36.41246039385554,0.6234217171717171,45.37377450980392,1018.5049019607844,30.86378490790256,0
711,4,2,2,36,0.05263157894736842,0.05263157894736842,0.9473684210526316,38,1150,1000,150,0.8695652173913043,13,10,3,346.6981985480614,0.3957592460881934,0.08021072845339439,0.1978554376919487,130325.14537677835,1438.0540236928332,131763.19940047117,708,0,356.36842105263156,33,5,22,35.88024083853417,0.630050505050505,44.730392156862756,1021.0784313725505,30.941770647653048,0
712,4,0,0,36,0.0,0.0,1.0,36,650,400,250,0.6153846153846154,9,4,5,364.34664840947715,0.38597883597883603,0.11576245570148025,0.20020284907448602,128838.54875283457,2188.3786848072687,131026.92743764183,709,1,376.8888888888889,34,2,17,36.94301125703566,0.6127450980392156,46.1904761904762,1015.2380952380961,29.859943977591062,2
713,4,1,0,37,0.02702702702702703,0.0,1.0,37,350,300,50,0.8571428571428571,4,3,1,356.0359275844353,0.3897334834834835,0.11052145539617086,0.19685109850071447,129083.74592764076,1791.6902434842432,130875.43617112501,710,0,367.6756756756757,35,2,18,36.903948367501904,0.613095238095238,45.94907407407408,1016.203703703705,29.03439153439157,0
714,4,1,1,37,0.02631578947368421,0.02631578947368421,0.9736842105263158,38,900,500,400,0.5555555555555556,13,5,8,349.46047231059515,0.3926475817923187,0.10399155135997229,0.19483618113755088,129413.28124999988,1445.0724451303001,130858.35369513018,711,0,358.9736842105263,34,4,19,36.73559923559923,0.6185661764705883,45.62499999999999,1017.4999999999991,29.92647058823527,0
715,4,0,0,37,0.0,0.0,1.0,37,700,500,200,0.7142857142857143,9,5,4,358.42270031575055,0.3903278278278279,0.1092867352354161,0.1995484128317266,129357.17520004313,1872.9096080834133,131230.08480812656,712,2,369.6756756756757,33,4,19,36.56474621531543,0.6202651515151516,45.68014705882352,1017.279411764705,30.826648841354697,0
716,4,1,0,38,0.02631578947368421,0.0,1.0,38,750,500,250,0.6666666666666666,10,5,5,334.56246722211114,0.39423304883831195,0.06788728330648475,0.18172636246878401,128379.01341735228,990.1598936899577,129369.17331104224,713,0,360.92105263157896,35,3,15,38.167161565402765,0.605952380952381,46.643518518518505,1013.4259259259238,28.955026455026395,8
717,4,1,0,39,0.02564102564102564,0.0,1.0,39,850,600,250,0.7058823529411765,11,6,5,328.0497643793218,0.3979982006297796,0.0805616957841524,0.1799581574163619,128772.40997331783,648.7517500608633,129421.1617233787,714,0,352.64102564102564,36,3,16,37.93155257221049,0.6079282407407408,46.25563063063063,1014.9774774774769,28.1938188188188,0
718,4,2,1,40,0.04878048780487805,0.024390243902439025,0.975609756097561,41,750,500,250,0.6666666666666666,10,5,5,314.0956732061275,0.4030741869918699,0.08156737305077977,0.17418032786885235,129201.38888888879,-83.68055555556566,129117.70833333323,715,0,336.390243902439,38,3,17,37.850068306010925,0.6085526315789473,45.83333333333333,1016.6666666666658,26.75438596491226,0
719,4,1,0,41,0.024390243902439025,0.0,1.0,41,1100,900,200,0.8181818181818182,13,9,4,315.7421566449595,0.4029725609756098,0.0898809051109104,0.17569731580459705,129337.19735051849,-32.558874826520736,129304.63847569197,716,0,337.3658536585366,38,3,18,37.67045653467773,0.6099232456140351,45.69978632478632,1017.2008547008533,26.768443544759297,0
720,4,1,1,41,0.023809523809523808,0.023809523809523808,0.9761904761904762,42,1150,900,250,0.782608695652174,14,9,5,310.21151693088865,0.40587495160665893,0.09306030576748836,0.17365448834378608,129572.31445312499,-361.03515625000034,129211.27929687499,717,0,330.3095238095238,39,3,16,37.572897483118496,0.6105769230769231,45.46875,1018.1249999999999,26.105769230769226,0
721,4,2,2,41,0.046511627906976744,0.046511627906976744,0.9534883720930233,43,850,600,250,0.7058823529411765,11,6,5,305.7390924908432,0.40653839055001845,0.10089958949420419,0.17281579239214825,129951.54303200814,-653.7466331218088,129297.79639888633,718,0,323.5813953488372,40,3,17,37.30314960629922,0.6127604166666667,45.09654471544716,1019.613821138212,25.4903455284553,0
722,4,0,0,41,0.0,0.0,1.0,41,1550,800,750,0.5161290322580645,23,8,15,317.9967551849525,0.40190548780487806,0.09701885653790465,0.17904681528654548,129799.47973738049,55.162676236405275,129854.6424136169,719,1,340.2926829268293,38,3,17,37.144623261340605,0.6145833333333333,45.2457264957265,1019.0170940170949,26.81623931623934,0
723,4,2,2,41,0.046511627906976744,0.046511627906976744,0.9534883720930233,43,1000,600,400,0.6,14,6,8,303.180606361213,0.40988372093023256,0.09291474224636698,0.1724056880949583,130186.64301658148,-705.986926020418,129480.65609056107,720,0,325.4186046511628,41,2,17,37.13090551181105,0.6135670731707317,44.86607142857142,1020.5357142857131,24.89111498257837,0
724,4,0,1,40,0.0,0.024390243902439025,0.975609756097561,41,1250,900,350,0.72,16,9,7,315.477036605761,0.4019308943089431,0.09597664355767233,0.17864867931792994,130023.43885633688,3.8818359375102887,130027.3206922744,721,3,342.2926829268293,39,2,17,36.9821987880026,0.6151175213675213,45.02604166666667,1019.895833333334,26.15117521367523,0
725,4,1,1,40,0.024390243902439025,0.024390243902439025,0.975609756097561,41,750,400,350,0.5333333333333333,11,4,7,316.05803720520896,0.4011941056910569,0.09313906123952975,0.1795884299572059,130156.27170138898,27.38715277778354,130183.65885416676,722,0,342.780487804878,39,2,17,36.83306111337959,0.6164529914529915,44.895833333333336,1020.4166666666674,26.164529914529933,0
726,4,1,0,41,0.024390243902439025,0.0,1.0,41,1500,1200,300,0.8,18,12,6,313.87783169460477,0.39997459349593495,0.10237732732284477,0.1793274045416028,130368.9453125,-16.015625,130352.9296875,723,0,343.7560975609756,39,2,18,36.67380660954711,0.6185897435897436,44.6875,1021.25,26.185897435897434,0
727,4,0,0,41,0.0,0.0,1.0,41,1100,700,400,0.6363636363636364,15,7,8,314.24691014658504,0.4000508130081301,0.10120234997985356,0.17978443412470302,130422.1408420138,-3.0490451388937174,130419.09179687491,724,1,344.7560975609756,39,2,19,36.61066353932967,0.6191239316239316,44.635416666666664,1021.4583333333326,26.191239316239297,0
728,4,0,0,41,0.0,0.0,1.0,41,1000,800,200,0.8,12,8,4,316.1826609765874,0.4000508130081301,0.10234405880905184,0.18151363878533078,130555.17713758699,55.85666232640796,130611.03379991339,725,2,345.7560975609756,39,2,17,36.42690602385078,0.6204594017094017,44.50520833333334,1021.9791666666681,26.204594017094053,0
729,4,0,0,41,0.0,0.0,1.0,41,700,500,200,0.7142857142857143,9,5,4,319.3663398640013,0.4005335365853659,0.10724350976951746,0.18371988625001817,130635.03146701396,144.08637152778235,130779.11783854174,726,3,346.7560975609756,39,2,17,36.26494463691325,0.6212606837606838,44.427083333333336,1022.2916666666673,26.212606837606852,0
730,4,2,1,42,0.046511627906976744,0.023255813953488372,0.9767441860465116,43,1050,700,350,0.6666666666666666,14,7,7,310.5939852949571,0.40702288667404946,0.1202383687147821,0.18119737243817632,131175.6395266437,-451.5270691610239,130724.11245748268,727,0,331.5813953488372,41,2,18,35.94446058493124,0.6234756097560976,43.89880952380951,1024.4047619047597,24.985481997677066,0
731,4,0,0,42,0.0,0.0,1.0,42,1600,1400,200,0.875,18,14,4,320.1588435761687,0.40280197444831595,0.1234655402148952,0.1865064061017702,131119.87428944398,-4.1625355278092115,131115.71175391617,728,1,340.4761904761905,40,2,18,35.75568895944962,0.6244791666666667,43.95325203252032,1024.1869918699176,25.60467479674794,0
732,4,0,1,41,0.0,0.023809523809523808,0.9761904761904762,42,900,700,200,0.7777777777777778,11,7,4,319.77243063927995,0.40243902439024387,0.12367633028216307,0.18678711736414935,131223.97898902764,-7.637856104170851,131216.34113292347,729,2,341.4761904761905,40,2,18,35.6607072009522,0.6255208333333333,43.85162601626016,1024.593495934959,25.614837398373975,0
733,4,1,0,42,0.023809523809523808,0.0,1.0,42,1400,1000,400,0.7142857142857143,18,10,8,319.07207733067185,0.4035157762291908,0.12168371665578381,0.18753818515346096,131461.62245008716,-10.812095729292821,131450.81035435788,730,0,342.1904761904762,39,3,20,35.439415100727956,0.6295405982905982,43.619791666666686,1025.5208333333362,26.295405982906058,0
734,4,0,0,42,0.0,0.0,1.0,42,1100,700,400,0.6363636363636364,15,7,8,318.37833218857253,0.4030923344947735,0.11605480856166195,0.18765458969032042,131568.4692382815,-22.290039062470157,131546.17919921904,731,1,343.1904761904762,39,3,15,35.34971824550716,0.6306089743589742,43.515625000000014,1025.937500000002,26.306089743589798,0
735,4,0,1,41,0.0,0.023809523809523808,0.9761904761904762,42,500,200,300,0.4,8,2,6,324.0177636212063,0.4030923344947735,0.14489019573592654,0.18639568183930388,130635.03146701418,65.61414930558873,130700.64561631977,732,2,344.1904761904762,39,3,18,36.146066843285105,0.6212606837606836,44.42708333333335,1022.291666666669,26.2126068376069,5
736,4,0,0,41,0.0,0.0,1.0,41,1450,1200,250,0.8275862068965517,17,12,5,329.6828516523644,0.3984502032520325,0.14666938276634722,0.19017780478983082,130741.54188368091,420.64887152781534,131162.19075520872,733,6,353.5365853658537,39,2,18,35.8936816731174,0.6223290598290596,44.322916666666686,1022.7083333333362,26.22329059829067,0
737,4,0,1,40,0.0,0.024390243902439025,0.975609756097561,41,1450,900,550,0.6206896551724138,20,9,11,359.074258900149,0.398145325203252,0.16978978022600844,0.20042952919583976,129459.11864144553,1101.0262188920378,130560.14486033756,734,7,354.5365853658537,36,5,16,36.444386042565746,0.6148726851851851,45.57995495495496,1017.6801801801804,28.2688938938939,4
738,4,1,1,40,0.024390243902439025,0.024390243902439025,0.975609756097561,41,950,700,250,0.7368421052631579,12,7,5,352.1999363785459,0.39728150406504065,0.18274481252275177,0.1977435396985691,129688.42734203805,935.2511717798952,130623.67851381794,735,0,354.8780487804878,36,5,16,36.386124930901055,0.6171875,45.35472972972973,1018.5810810810816,28.293918918918934,0
739,4,0,0,40,0.0,0.0,1.0,40,950,600,350,0.631578947368421,13,6,7,359.3410622588588,0.3948450854700855,0.18700545702592053,0.20106641117232316,129554.6392746913,1310.8603395061643,130865.49961419747,736,9,364.75,35,5,16,36.340381991814446,0.6178571428571429,45.48611111111111,1018.0555555555552,29.087301587301578,0
740,4,2,2,40,0.047619047619047616,0.047619047619047616,0.9523809523809523,42,1000,600,400,0.6,14,6,8,346.16916299455573,0.40230594270228415,0.18270180881728004,0.19596587857652856,130010.85820877584,601.1499932671657,130612.00820204301,737,0,348.3333333333333,37,5,17,36.21239203669856,0.6185247747747746,45.03837719298246,1019.8464912280707,27.56341868183975,0
741,4,3,1,42,0.06976744186046512,0.023255813953488372,0.9767441860465116,43,1050,800,250,0.7619047619047619,13,8,5,342.5854764447401,0.4053156146179402,0.1950666536927117,0.19588021260835622,130398.9517130543,334.5574001022748,130733.50911315657,738,0,340.93023255813955,38,5,19,35.91047768479777,0.6206140350877192,44.65811965811966,1021.3675213675215,26.878092667566353,0
742,4,0,0,42,0.0,0.0,1.0,42,700,400,300,0.5714285714285714,10,4,6,349.5545045523787,0.40066056910569103,0.2015832106038289,0.19945168789165155,130318.55955678684,710.687903970467,131029.24746075731,739,1,350.04761904761904,37,5,19,35.81400343642613,0.6216216216216215,44.736842105263165,1021.0526315789485,27.59601706970131,0
743,4,0,0,42,0.0,0.0,1.0,42,1250,800,450,0.64,17,8,9,346.7222288593845,0.39980158730158727,0.19704592165403856,0.1981209104046814,130374.54433094799,640.7505193905856,131015.29485033857,740,2,351.04761904761904,37,5,19,35.829575549352235,0.6221846846846846,44.68201754385965,1021.2719298245614,27.601944049312472,0
744,4,0,0,42,0.0,0.0,1.0,42,1450,1200,250,0.8275862068965517,17,12,5,346.85001069450794,0.40041860240030974,0.1999146831782812,0.19919833331383308,130570.58572108731,657.6818107494664,131228.26753183678,741,3,352.04761904761904,37,5,15,35.627771519507924,0.6241554054054053,44.49013157894737,1022.039473684211,27.622688477951648,0
745,4,0,0,42,0.0,0.0,1.0,42,1000,700,300,0.7,13,7,6,347.41547787177,0.4001766356949284,0.20339567155263438,0.20039234150340143,130738.73842191837,684.1322570406313,131422.870678959,742,4,353.04761904761904,37,5,16,35.443135520531754,0.6258445945945945,44.32565789473684,1022.6973684210534,27.640469416785226,0
746,4,2,3,41,0.045454545454545456,0.06818181818181818,0.9318181818181819,44,1300,1000,300,0.7692307692307693,16,10,6,333.45058746387025,0.40487359055673006,0.20678698525673567,0.19462828057609313,131194.6953667537,-50.61035156247837,131144.08501519123,743,0,337.95454545454544,39,5,17,35.3398788340959,0.626869658119658,43.88020833333334,1024.4791666666686,26.26869658119663,0
747,4,0,0,41,0.0,0.0,1.0,41,900,600,300,0.6666666666666666,12,6,6,355.1128793346447,0.39418191056910573,0.21975666171465136,0.204443235984733,130665.25298524872,1080.1828433162893,131745.435828565,744,1,363.4146341463415,36,5,17,35.32074934831298,0.627025462962963,44.39752252252252,1022.4099099099096,28.400275275275266,0
748,4,2,1,42,0.046511627906976744,0.023255813953488372,0.9767441860465116,43,1150,1000,150,0.8695652173913043,13,10,3,332.1101232404334,0.40051679586563305,0.2054384614267255,0.1962023274199012,131656.85609796143,144.91494082836323,131801.7710387898,745,0,347.4651162790698,38,5,18,34.908520716219044,0.6332236842105265,43.42948717948716,1026.2820512820479,27.007422402159154,1
749,4,1,1,42,0.023255813953488372,0.023255813953488372,0.9767441860465116,43,1150,800,350,0.6956521739130435,15,8,7,329.2773114781278,0.3987172388335179,0.19465977605512474,0.19489657084786444,131728.820800781,75.06239149302601,131803.88319227402,746,0,348.4418604651163,39,4,19,34.908781498393346,0.6322115384615385,43.359374999999986,1026.562499999998,26.322115384615334,0
750,4,0,1,41,0.0,0.023809523809523808,0.9761904761904762,42,1150,800,350,0.6956521739130435,15,8,7,329.78599643205683,0.39750290360046453,0.18491196790728748,0.196097239065815,131903.67408366222,299.99691814596895,132203.6710018082,747,2,357.73809523809524,38,4,18,34.71983879355174,0.6356907894736842,43.18910256410257,1027.2435897435907,27.032726045883965,1
751,4,0,0,41,0.0,0.0,1.0,41,1100,600,500,0.5454545454545454,16,6,10,365.7197618522778,0.39446138211382115,0.21904223805173761,0.19803746541567052,128255.57503270218,1190.3909156845507,129445.96594838673,748,5,367.4146341463415,37,4,18,37.50405932019917,0.6007882882882885,46.76535087719297,1012.9385964912266,27.376718824087206,8
752,4,1,1,41,0.023809523809523808,0.023809523809523808,0.9761904761904762,42,450,200,250,0.4444444444444444,7,2,5,360.4263212138377,0.3990151955090979,0.2182301311292778,0.19621832254722324,128469.25593770537,860.740261341215,129329.99619904658,749,0,359.64285714285717,38,4,16,37.41964379808199,0.6011513157894737,46.554487179487175,1013.7820512820506,26.678475033738174,0
753,4,2,1,42,0.046511627906976744,0.023255813953488372,0.9767441860465116,43,600,300,300,0.5,9,3,6,353.320876507559,0.40222406792174237,0.22709741474777534,0.19384902143522836,128778.125,500.00000000000034,129278.125,750,0,352.2325581395349,39,4,17,37.28448275862067,0.6025641025641025,46.25,1015.0,26.025641025641026,0
754,4,1,0,43,0.023255813953488372,0.0,1.0,43,900,800,100,0.8888888888888888,10,8,2,353.546238243483,0.4014627168696936,0.2305205418005778,0.1943606984861381,128857.43408203125,511.41221788194434,129368.84629991319,751,0,353.2093023255814,39,4,18,37.19787712458533,0.6033653846153847,46.171875,1015.3125,26.033653846153847,0
755,4,0,0,43,0.0,0.0,1.0,43,1300,900,400,0.6923076923076923,17,9,8,361.1642723428217,0.40187799926172024,0.2388865441521868,0.19934550923370348,129016.12548828125,719.2030164930547,129735.32850477431,752,1,354.2093023255814,39,4,18,36.84261680166787,0.6049679487179487,46.015625,1015.9375,26.049679487179485,0
756,4,1,0,44,0.022727272727272728,0.0,1.0,44,1050,800,250,0.7619047619047619,13,8,5,354.4512369024742,0.40572145877378435,0.2461059413027924,0.19778254431728542,129445.89548405632,376.7173952683072,129822.61287932463,753,0,347.1363636363636,38,6,17,36.575459317585306,0.6110197368421053,45.59294871794871,1017.6282051282034,26.779689608636932,0
757,4,1,1,44,0.022222222222222223,0.022222222222222223,0.9777777777777777,45,1150,800,350,0.6956521739130435,15,8,7,344.98917539135033,0.40989057239057236,0.24950135168904364,0.19417054739230052,129784.51063368034,-45.14973958335412,129739.36089409699,754,0,340.4,39,6,17,36.47217678729639,0.6127136752136754,45.26041666666666,1018.9583333333317,26.12713675213671,0
758,4,0,0,44,0.0,0.0,1.0,44,700,300,400,0.42857142857142855,11,3,8,351.95291049534904,0.40515988372093026,0.2555250989178628,0.1977531527149764,129717.84056770017,330.91430619473454,130048.75487389491,755,2,349.1363636363636,38,6,17,36.36252403425974,0.6137609649122808,45.32585470085469,1018.6965811965797,26.807804768331046,0
759,4,0,0,44,0.0,0.0,1.0,44,1700,1200,500,0.7058823529411765,22,12,10,372.68452101675916,0.4053030303030303,0.28747401198944655,0.20542943835129543,128963.21750217004,813.6604161387475,129776.87791830879,756,3,350.1363636363636,39,5,21,36.60404488428537,0.6044337606837608,46.06770833333333,1015.7291666666658,26.044337606837587,2
760,4,0,0,44,0.0,0.0,1.0,44,1200,800,400,0.6666666666666666,16,8,8,379.57498120800875,0.40546819943622264,0.29727254547272564,0.21007910277040917,129123.91067031852,1002.4411932381458,130126.35186355667,757,4,351.1363636363636,40,4,21,36.26491517514915,0.6044270833333334,45.90955284552845,1016.3617886178856,25.40904471544714,0
761,4,0,0,44,0.0,0.0,1.0,44,1550,1300,250,0.8387096774193549,18,13,5,374.3788562716532,0.40487359055673006,0.29534888401392734,0.2085165590356419,129373.18019032526,887.0095970007096,130260.18978732597,758,5,352.1363636363636,36,8,21,36.14262785034314,0.6140046296296298,45.6644144144144,1017.3423423423408,28.259509509509467,0
762,4,1,1,44,0.022222222222222223,0.022222222222222223,0.9777777777777777,45,1350,900,450,0.6666666666666666,18,9,9,362.1338349905935,0.4089646464646464,0.304918032786885,0.2008196721311476,129201.38888888908,357.638888888908,129559.02777777798,759,0,345.2888888888889,38,7,17,36.629098360655725,0.6085526315789472,45.83333333333334,1016.6666666666682,26.75438596491232,3
763,4,4,2,46,0.08333333333333333,0.041666666666666664,0.9583333333333334,48,1100,700,400,0.6363636363636364,15,7,8,340.5690268116166,0.4193354757683215,0.30270291587791776,0.19301475562440437,130055.18297846874,-741.4465802432171,129313.73639822552,760,0,314.0,40,8,19,36.31023546212348,0.6138020833333333,44.994918699187004,1020.020325203254,25.50050813008135,0
764,4,1,0,47,0.02127659574468085,0.0,1.0,47,1650,1100,550,0.6666666666666666,22,11,11,350.9867999487374,0.418458988590811,0.31699346405228757,0.19889251997095153,130050.00000000025,-270.83333333330313,129779.16666666695,761,0,321.6595744680851,39,8,20,36.049836601307206,0.6153846153846152,45.000000000000014,1020.0000000000019,26.153846153846203,0
765,4,0,0,47,0.0,0.0,1.0,47,1650,1300,350,0.7878787878787878,20,13,7,352.53478862349016,0.4184011717545482,0.31679899645495935,0.20032834253358614,130158.86423631784,-222.89446179521923,129935.96977452261,762,1,322.6595744680851,40,7,20,35.899893768880894,0.6148437499999999,44.893292682926834,1020.426829268294,25.51067073170735,0
766,4,2,2,47,0.04081632653061224,0.04081632653061224,0.9591836734693877,49,800,500,300,0.625,11,5,6,340.3754609740583,0.4246208900226757,0.307405347893287,0.19562145790383306,130598.60365689447,-909.281458599622,129689.32219829485,763,0,310.44897959183675,37,12,16,35.76485732675392,0.6244369369369369,44.46271929824562,1022.1491228070179,27.62565196775724,0
767,4,1,1,47,0.020833333333333332,0.020833333333333332,0.9791666666666666,48,1450,1000,450,0.6896551724137931,19,10,9,350.2516885506665,0.42055444739952713,0.3130739842774224,0.2008965753418932,130521.37230135548,-456.9337918999993,130064.43850945549,764,0,317.8958333333333,36,12,16,35.59069869958122,0.6255787037037037,44.53828828828829,1021.8468468468475,28.38463463463465,0
768,4,1,2,46,0.020833333333333332,0.041666666666666664,0.9583333333333334,48,1350,800,550,0.5925925925925926,19,8,11,346.70256778137,0.4193077718676123,0.3073406478578893,0.19963559408349651,130671.89554569364,-539.1436554898091,130132.75189020383,765,0,318.875,38,10,16,35.528996865203766,0.6233552631578947,44.39102564102564,1022.4358974358976,26.906207827260463,0
769,4,1,2,45,0.02127659574468085,0.0425531914893617,0.9574468085106383,47,1200,700,500,0.5833333333333334,17,7,10,324.79073892824584,0.4184011717545482,0.23213715681550973,0.17956359708598715,129081.07284672021,-1013.4889382027814,128067.58390851744,766,0,325.468085106383,43,4,19,37.70045118504024,0.599563953488372,45.951704545454554,1016.1931818181832,23.632399577167053,7
770,4,3,2,46,0.0625,0.041666666666666664,0.9583333333333334,48,1300,1100,200,0.8461538461538461,15,11,4,320.146599213791,0.4255226802600473,0.24676710459507545,0.17887339777349273,129497.1005348237,-1308.2766371950815,128188.82389762861,767,0,319.2083333333333,42,6,15,37.396269675044444,0.6051587301587301,45.54263565891473,1017.8294573643416,24.23403469915099,0
771,4,1,1,46,0.02127659574468085,0.02127659574468085,0.9787234042553191,47,1100,600,500,0.5454545454545454,16,6,10,324.18960864102246,0.42084875115633674,0.2569617129121704,0.1810485136117719,129478.90216561165,-1004.8570759322231,128474.04508967944,768,0,326.97872340425533,41,6,15,37.3118521948208,0.6064532520325203,45.56051587301587,1017.7579365079368,24.82336430507163,0
772,4,1,1,46,0.02127659574468085,0.02127659574468085,0.9787234042553191,47,1250,700,550,0.56,18,7,11,324.2483030865682,0.41859389454209067,0.26921885972989856,0.18219253930246346,129719.10609526167,-987.7599941409828,128731.34610112068,769,0,327.9574468085106,42,5,16,37.066806176479915,0.607390873015873,45.32461240310077,1018.7015503875966,24.2547988187523,0
773,4,1,0,47,0.02127659574468085,0.0,1.0,47,1600,1000,600,0.625,22,10,12,326.71044548060433,0.41807354301572613,0.28490132197610896,0.18450459457334584,129916.60399202254,-910.9776868878234,129005.62630513472,770,0,328.8723404255319,42,5,17,36.803971422234895,0.609375,45.130813953488364,1019.4767441860452,24.273255813953455,0
774,4,0,0,47,0.0,0.0,1.0,47,900,300,600,0.3333333333333333,15,3,12,325.5780321708861,0.41824699352451433,0.287518067418002,0.1843307578589873,130015.40927716167,-933.9677791298761,129081.4414980318,771,1,329.8723404255319,42,5,17,36.73277909738717,0.6103670634920635,45.03391472868216,1019.8643410852701,24.28248431155405,0
775,4,0,1,46,0.0,0.02127659574468085,0.9787234042553191,47,1350,800,550,0.5925925925925926,19,8,11,325.1316402630845,0.41790009250693805,0.2916067902394852,0.18431129655624612,130064.82600392101,-942.3619561624978,129122.46404775852,772,2,330.8723404255319,42,5,17,36.69413571451187,0.6108630952380953,44.985465116279066,1020.0581395348836,24.287098560354373,0
776,4,1,0,47,0.02127659574468085,0.0,1.0,47,1250,900,350,0.72,16,9,7,329.80085356117604,0.41608849830403943,0.29669477848704506,0.18803515180905622,130288.52390276936,-805.8462588156303,129482.67764395374,773,0,331.5744680851064,40,7,18,36.34862963700313,0.6161458333333334,44.76626016260162,1020.9349593495922,25.523373983739805,0
777,4,0,0,47,0.0,0.0,1.0,47,1350,1000,350,0.7407407407407407,17,10,7,331.3175182689966,0.4159921369102683,0.30180664724217365,0.189152183157209,130340.40584308289,-763.1880411791866,129577.2178019037,774,1,332.5744680851064,40,7,18,36.25742270435245,0.6166666666666667,44.71544715447155,1021.1382113821144,25.52845528455286,0
778,4,1,1,47,0.020833333333333332,0.020833333333333332,0.9791666666666666,48,1300,1000,300,0.7692307692307693,16,10,6,348.88614017696716,0.418218085106383,0.28608237182543483,0.19287132061338177,129078.27546609272,-573.4333619908011,128504.84210410192,775,0,326.625,42,6,18,37.09116048440926,0.6009424603174605,45.95445736434108,1016.182170542635,24.194813584348452,7
779,4,1,1,47,0.020833333333333332,0.020833333333333332,0.9791666666666666,48,1450,1300,150,0.896551724137931,16,13,3,344.8177821750264,0.4180980348699764,0.2849299224965005,0.1916025046883768,129280.82817925338,-684.1582575251922,128596.66992172819,776,0,327.5625,39,9,19,36.988395814128175,0.6076388888888891,45.75520833333333,1016.9791666666658,26.076388888888868,0
780,4,1,1,47,0.020833333333333332,0.020833333333333332,0.9791666666666666,48,1000,700,300,0.7,13,7,6,333.41124166458104,0.4169806442080379,0.2470751822017645,0.1777511466297674,127629.96890210922,-1048.4992797110713,126581.46962239814,777,0,328.5416666666667,42,6,18,38.9612102032988,0.5863095238095237,47.383720930232556,1010.4651162790695,24.05869324473975,5
781,4,2,0,49,0.04081632653061224,0.0,1.0,49,1750,1200,550,0.6857142857142857,23,12,11,337.5403158094184,0.4237528344671202,0.2630775375817056,0.18216514378381932,128121.09482167344,-1150.7930384087856,126970.30178326466,778,0,311.9795918367347,44,5,22,38.35494024754588,0.5885416666666667,46.898148148148145,1012.4074074074067,23.00925925925924,0
782,4,3,2,50,0.057692307692307696,0.038461538461538464,0.9615384615384616,52,1550,1100,450,0.7096774193548387,20,11,9,326.2229802346298,0.43193815987933637,0.29252786184540724,0.17980820585799825,128960.81285152693,-1985.9952862306827,126974.81756529625,779,0,294.9230769230769,43,9,16,37.78629809186401,0.5983527131782944,46.07007575757577,1015.7196969696995,23.621388301620918,0
783,4,4,1,53,0.07407407407407407,0.018518518518518517,0.9814814814814815,54,1650,1000,650,0.6060606060606061,23,10,13,322.91796910605564,0.43329256929885857,0.31456723609771586,0.18132251004761862,129692.62390318252,-2422.8633167210464,127269.76058646147,780,0,284.9074074074074,40,14,15,37.127523362931925,0.6101562500000001,45.350609756097555,1018.5975609756089,25.464939024390222,0
784,4,0,0,53,0.0,0.0,1.0,53,1450,900,550,0.6206896551724138,20,9,11,328.88918644819296,0.43155841799709727,0.3203467022484925,0.18450144197142868,129655.65653344653,-2071.5313208616967,127584.12521258483,781,1,291.2830188679245,41,12,17,37.01295538671342,0.6082317073170732,45.38690476190475,1018.4523809523795,24.84030197444828,0
785,4,0,0,53,0.0,0.0,1.0,53,1300,600,700,0.46153846153846156,20,6,14,331.56345710630524,0.43118045476536043,0.325102918456986,0.18660209687336193,129781.98346757663,-1993.8073782754077,127788.17608930123,782,2,292.2830188679245,41,12,17,36.816745367215134,0.6095020325203253,45.262896825396815,1018.948412698411,24.85240030971734,0
786,4,1,1,53,0.018518518518518517,0.018518518518518517,0.9814814814814815,54,1350,900,450,0.6666666666666666,18,9,9,324.44694052837986,0.4326811087817377,0.32429068504077807,0.18394433912482652,130069.31889921933,-2359.881485307632,127709.4374139117,783,0,287.85185185185185,43,11,19,36.707049139745024,0.6094961240310077,44.9810606060606,1020.0757575757565,23.7226920366455,0
787,4,0,2,51,0.0,0.03773584905660377,0.9622641509433962,53,1800,1000,800,0.5555555555555556,26,10,16,328.10970392077365,0.43004656507015,0.32099802726125426,0.1868301372721617,130238.42047068704,-2053.502084050725,128184.91838663632,784,4,294.2830188679245,43,10,20,36.44248461514673,0.6111918604651163,44.815340909090914,1020.7386363636368,23.738107822410157,0
788,4,1,1,51,0.019230769230769232,0.019230769230769232,0.9807692307692307,52,1100,600,500,0.5454545454545454,16,6,10,331.87440661486403,0.4320245726495726,0.31894049346879494,0.1897392744524049,130395.54172092023,-1745.00466759211,128650.53705332812,785,0,297.38461538461536,39,13,21,36.18742563318034,0.6188568376068376,44.661458333333336,1021.3541666666674,26.188568376068396,0
789,4,0,0,51,0.0,0.0,1.0,51,1700,1100,600,0.6470588235294118,23,11,12,340.34340516874084,0.42879084967320263,0.3278369001676218,0.1941887715341884,130317.12420784937,-1329.485239060561,128987.6389687888,786,6,304.2156862745098,38,13,21,36.05058247009174,0.6197916666666666,44.738247863247864,1021.0470085470085,26.86965811965812,0
790,4,1,1,51,0.019230769230769232,0.019230769230769232,0.9807692307692307,52,1450,1000,450,0.6896551724137931,19,10,9,334.3918361535716,0.4305319884364002,0.316821139890034,0.1923183236059905,130625.94112507421,-1663.950339579627,128961.99078549459,787,0,299.34615384615387,40,12,16,35.89012327269113,0.6195312500000001,44.43597560975609,1022.2560975609745,25.55640243902436,0
791,4,0,0,51,0.0,0.0,1.0,51,1750,1200,550,0.6857142857142857,23,12,11,335.9785675683048,0.42880718954248365,0.3229160423085069,0.1932762990688948,130635.03146701393,-1421.8858506944412,129213.1456163195,788,8,306.2156862745098,39,12,16,35.840381088241294,0.6212606837606838,44.427083333333336,1022.2916666666671,26.21260683760685,0
792,4,1,0,52,0.019230769230769232,0.0,1.0,52,1250,800,450,0.64,17,8,9,335.5277727706272,0.4296207264957265,0.3295840067560669,0.1950047550657016,131030.32889399705,-1607.1371161588593,129423.19177783819,789,0,301.3076923076923,42,10,18,35.45255221149597,0.6205357142857142,44.04069767441862,1023.837209302328,24.37707641196019,0
793,4,0,2,50,0.0,0.038461538461538464,0.9615384615384616,52,1250,800,450,0.64,17,8,9,313.49230194809326,0.42978569632981395,0.27149042411984015,0.17108526074925104,128566.7534722223,-2331.961721050411,126234.7917511719,790,1,302.3076923076923,44,8,14,38.509997261024374,0.5930397727272728,46.458333333333336,1014.1666666666674,23.04924242424244,8
794,4,1,1,50,0.0196078431372549,0.0196078431372549,0.9803921568627451,51,1500,1100,400,0.7333333333333333,19,11,8,319.7404055515364,0.42830065359477126,0.3035958691053886,0.17517066390031977,128720.46100206574,-1968.5735192837788,126751.88748278197,791,0,308.96078431372547,43,8,14,38.19522209779769,0.5959302325581397,46.306818181818166,1014.7727272727242,23.59936575052847,0
795,4,0,1,49,0.0,0.02,0.98,50,1150,800,350,0.6956521739130435,15,8,7,328.9881825315211,0.4261904761904762,0.30951580555820857,0.1800750266224545,128684.70687045538,-1532.8504334174743,127151.8564370379,792,12,316.14,42,8,14,37.997007608315016,0.5969742063492064,46.342054263565885,1014.6317829457355,24.157899593946084,0
796,4,0,0,49,0.0,0.0,1.0,49,900,400,500,0.4444444444444444,14,4,10,333.59783111816466,0.42306193310657597,0.3086375395228522,0.18219573853376675,128596.93877551008,-1220.0680272108932,127376.87074829919,793,13,323.3469387755102,41,8,14,37.96948356807512,0.5975609756097562,46.42857142857142,1014.2857142857132,24.738675958188125,0
797,4,1,0,50,0.02,0.0,1.0,50,1300,900,400,0.6923076923076923,17,9,8,335.26628143271375,0.42638605442176875,0.3231878765747669,0.1830761139987014,128590.2306241428,-1376.1890764536147,127214.04154768918,794,0,317.86,44,6,18,37.93401192867141,0.5932765151515151,46.43518518518519,1014.2592592592604,23.051346801346828,4
798,4,1,0,51,0.0196078431372549,0.0,1.0,51,1550,1100,450,0.7096774193548387,20,11,9,327.87019495120546,0.43001633986928106,0.323512290001575,0.18017127987433829,128841.12029072997,-1751.3673545093197,127089.75293622066,795,0,312.6078431372549,46,5,19,37.86620241005937,0.5932971014492754,46.18794326241135,1015.2482269503556,22.070613629355556,0
799,4,1,0,52,0.019230769230769232,0.0,1.0,52,1300,900,400,0.6923076923076923,17,9,8,326.9123805446304,0.4316396430367018,0.3339985021383942,0.18098425833555926,129135.20812988284,-1956.820339626734,127178.3877902561,796,0,307.5769230769231,47,5,20,37.59154283030147,0.5950797872340425,45.8984375,1016.4062500000002,21.625664893617024,0
800,4,1,1,52,0.018867924528301886,0.018867924528301886,0.9811320754716981,53,1650,1300,350,0.7878787878787878,20,13,7,320.02254602628057,0.4336145379777456,0.3247805209293302,0.17869201493429152,129472.4449871552,-2313.0779777321927,127159.36700942302,797,0,302.75471698113205,42,11,13,37.424426354374944,0.6049107142857143,45.56686046511628,1017.7325581395348,24.231727574750828,0
801,4,1,1,52,0.018867924528301886,0.018867924528301886,0.9811320754716981,53,1900,1400,500,0.7368421052631579,24,14,10,323.31964261422627,0.43170960328979197,0.3347192099645959,0.18200167094473454,129790.40745027442,-2207.2423696844903,127583.16508058993,798,0,303.7358490566038,44,9,15,37.01821141905195,0.6053503787878787,45.25462962962963,1018.981481481482,23.158670033670045,0
802,4,0,0,52,0.0,0.0,1.0,52,1450,900,550,0.6206896551724138,20,9,11,327.29964881201374,0.42985639768728,0.33069511837008636,0.18390963923543294,129719.65449245548,-1908.5605281207102,127811.09396433477,799,1,310.53846153846155,44,8,15,36.98853996243107,0.6046401515151515,45.324074074074076,1018.7037037037042,23.152356902356914,0
803,4,1,1,52,0.018867924528301886,0.018867924528301886,0.9811320754716981,53,1200,900,300,0.75,15,9,6,324.45811032686476,0.4313014029995162,0.33700237566302405,0.18399029398293815,130077.71886814754,-2159.0458280823327,127918.6730400652,800,0,305.66037735849056,45,8,18,36.69826259397381,0.6069444444444445,44.97282608695652,1020.1086956521747,22.669082125603882,0
804,4,0,2,50,0.0,0.038461538461538464,0.9615384615384616,52,950,600,350,0.631578947368421,13,6,7,329.73028773333266,0.4276803670186023,0.3367523307378051,0.18673414495540658,130026.38996056237,-1825.272205075451,128201.11775548692,801,1,312.4423076923077,44,8,18,36.615789075503095,0.607717803030303,45.023148148148145,1019.9074074074072,23.1797138047138,0
805,4,0,0,50,0.0,0.0,1.0,50,750,400,350,0.5333333333333333,11,4,7,335.42938713714364,0.4243197278911565,0.33044310264746857,0.18934962519828785,129900.32717982371,-1285.522573031461,128614.80460679226,802,2,314.56,43,7,19,36.59825437374206,0.6078003875968994,45.1467803030303,1019.4128787878781,23.707276250880884,0
806,4,1,0,51,0.0196078431372549,0.0,1.0,51,1600,1200,400,0.75,20,12,8,333.4652634512737,0.42573529411764705,0.34241313487369873,0.1901244061652381,130288.5239027695,-1508.6429193013778,128779.88098346813,803,0,309.37254901960785,40,11,20,36.25510153294842,0.6161458333333334,44.766260162601625,1020.9349593495933,25.523373983739834,0
807,4,2,2,51,0.03773584905660377,0.03773584905660377,0.9622641509433962,53,1700,1500,200,0.8823529411764706,19,15,4,323.82441700960277,0.4287312530237059,0.3285674353598893,0.18682177904400118,130746.38429752036,-2132.2256657484163,128614.15863177195,804,0,298.66037735849056,43,10,17,36.038580246913575,0.6162790697674421,44.318181818181806,1022.7272727272704,23.78435517970396,0
808,4,0,0,51,0.0,0.0,1.0,51,1450,1000,450,0.6896551724137931,19,10,9,340.1480389956709,0.4251797385620915,0.34228680798925426,0.19584165865303843,130667.99433893945,-1310.7075932224532,129357.28674571699,805,2,311.37254901960785,41,10,17,35.70048191991721,0.6183943089430893,44.39484126984128,1022.4206349206362,24.93708865660088,0
809,4,1,2,50,0.019230769230769232,0.038461538461538464,0.9615384615384616,52,1350,800,550,0.5925925925925926,19,8,11,335.6340496775094,0.42675339366515835,0.34828704000227795,0.19473260563414907,130964.38573411664,-1608.7785705062045,129355.60716361045,806,0,306.36538461538464,43,9,17,35.51640993616432,0.6184593023255814,44.10511363636363,1023.5795454545447,23.804175475687085,0
810,4,0,0,50,0.0,0.0,1.0,50,950,500,450,0.5263157894736842,14,5,9,340.33173388767557,0.4243452380952381,0.34969730630380447,0.19671501986027598,130819.03126614145,-1095.6264527376134,129723.40481340383,807,4,317.82,43,7,17,35.5430783115801,0.6170058139534884,44.247159090909086,1023.0113636363631,23.7909619450317,0
811,4,0,1,49,0.0,0.02,0.98,50,1350,900,450,0.6666666666666666,18,9,9,342.1667964365606,0.42392857142857143,0.35563014566181206,0.19832037760950705,130925.07823216716,-1040.3570816186698,129884.72115054849,808,5,318.82,44,6,17,35.38895925691368,0.6167140151515152,44.14351851851851,1023.4259259259244,23.2596801346801,0
812,4,0,0,49,0.0,0.0,1.0,49,1600,1300,300,0.8125,19,13,6,341.42114550606345,0.42384141156462585,0.3460140681035011,0.19837591202630264,131019.8570387515,-853.4100651577692,130166.44697359373,809,6,324.0,44,5,17,35.312283319767275,0.617660984848485,44.05092592592592,1023.7962962962947,23.268097643097608,0
813,4,1,1,49,0.02,0.02,0.98,50,600,400,200,0.6666666666666666,8,4,4,336.72471995401634,0.4255442176870748,0.3420864645035806,0.19662846192048902,131212.0953860138,-1163.5287853129812,130048.56660070081,810,0,318.5,45,5,17,35.238466242300994,0.618287037037037,43.86322463768115,1024.547101449274,22.76771336553942,0
814,4,0,0,49,0.0,0.0,1.0,49,1550,1000,550,0.6451612903225806,21,10,11,337.68603014006885,0.4234162414965987,0.3404969414821639,0.19707063988050427,131188.89561672948,-939.8685281453623,130249.02708858412,811,8,326.0,45,4,17,35.23725316828766,0.6180555555555556,43.885869565217384,1024.456521739129,22.765700483091752,0
815,4,2,1,50,0.0392156862745098,0.0196078431372549,0.9803921568627451,51,1300,1100,200,0.8461538461538461,15,11,4,327.5776571533703,0.42772875816993466,0.3458255268181438,0.1934226517970594,131636.7551868999,-1575.5265016556796,130061.22868524423,812,0,314.1764705882353,44,7,15,35.045038948539805,0.6238162878787878,43.449074074074076,1026.2037037037042,23.322811447811457,0
816,4,0,0,50,0.0,0.0,1.0,50,1650,1300,350,0.7878787878787878,20,13,7,334.02158068284973,0.4257738095238095,0.34805124503789275,0.19735049042050665,131660.51097393685,-1204.509602194789,130456.00137174207,813,1,321.46,44,6,15,34.855798147479845,0.6240530303030303,43.425925925925924,1026.2962962962958,23.324915824915816,0
817,4,0,1,49,0.0,0.02,0.98,50,1350,900,450,0.6666666666666666,18,9,9,333.1580788143731,0.42556122448979594,0.34411579042294127,0.1974553680370168,131779.32205932788,-1219.3308470507584,130559.99121227712,814,2,322.46,44,6,15,34.75835662969307,0.6252367424242424,43.31018518518518,1026.7592592592594,23.335437710437713,0
818,4,0,0,49,0.0,0.0,1.0,49,1450,800,650,0.5517241379310345,21,8,13,341.0063496782692,0.42396541950113376,0.34257124047775855,0.20306909407295368,131959.80131571373,-800.173969811771,131159.62734590197,815,3,316.6734693877551,43,6,15,34.375192012288785,0.6283914728682172,43.13446969696969,1027.4621212121194,23.89446793516557,0
819,4,0,1,48,0.0,0.02040816326530612,0.9795918367346939,49,1250,800,450,0.64,17,8,9,338.76426575895874,0.4240717120181406,0.3423125239775233,0.20199284681407784,132008.45457415044,-856.0505624426253,131152.4040117078,816,4,317.6734693877551,43,6,15,34.383830937461596,0.6288759689922481,43.087121212121204,1027.6515151515139,23.898872445384043,0
820,4,0,0,48,0.0,0.0,1.0,48,1150,900,250,0.782608695652174,14,9,5,341.07176391106316,0.4230200945626477,0.3414694512540075,0.20345371923738645,132024.29710504157,-594.0480214530571,131430.2490835885,817,5,324.125,42,6,15,34.30860676346721,0.6304563492063493,43.07170542635658,1027.7131782945721,24.469361387966003,0
821,4,0,0,48,0.0,0.0,1.0,48,1300,900,400,0.6923076923076923,17,9,8,338.6007723050384,0.4234818262411348,0.33961278667923356,0.2025115103808598,132123.900494261,-652.5490505378447,131471.35144372316,818,6,325.125,42,6,16,34.27191328934965,0.6314484126984128,42.97480620155038,1028.1007751937973,24.478589885566603,0
822,4,0,0,48,0.0,0.0,1.0,48,1050,700,350,0.6666666666666666,14,7,7,340.34098809899297,0.4230200945626477,0.3414901780233275,0.20397920147654872,132203.1572830579,-601.1693640954994,131601.9879189624,819,7,326.125,43,5,16,34.14748311847759,0.6308139534883721,42.89772727272727,1028.4090909090912,23.916490486257935,0
823,4,1,1,48,0.02040816326530612,0.02040816326530612,0.9795918367346939,49,1200,800,400,0.6666666666666666,16,8,8,339.1478256055363,0.4237528344671202,0.34558463385354155,0.2048576263251179,132497.7477033382,-812.448433242148,131685.29927009603,820,0,320.44897959183675,42,7,16,33.882156862745106,0.6351686507936507,42.611434108527135,1029.554263565892,24.513196751568856,0
824,4,0,0,48,0.0,0.0,1.0,48,1700,1300,400,0.7647058823529411,21,13,8,348.11327043112203,0.42145020685579193,0.3574317269076308,0.2098591040513011,132423.52966939093,-380.32240095111956,132043.20726843982,821,9,328.125,41,7,17,33.72600401606426,0.6359247967479674,42.68353174603175,1029.2658730158732,25.10404568331398,0
825,4,0,0,48,0.0,0.0,1.0,48,1300,800,500,0.6153846153846154,18,8,10,346.71463451470214,0.42135786052009455,0.35215500626385277,0.20929946261541957,132474.58944515302,-413.82422760771243,132060.7652175453,822,10,329.125,41,7,18,33.71067023224439,0.6364329268292683,42.63392857142857,1029.4642857142853,25.108885017421592,0
826,4,0,0,48,0.0,0.0,1.0,48,1250,800,450,0.64,17,8,9,350.5251925155408,0.42080378250591016,0.3585143880271058,0.21188706890616169,132525.65906281487,-309.28356875158295,132216.37549406328,823,11,330.125,41,7,18,33.56125750714583,0.6369410569105691,42.58432539682539,1029.6626984126979,25.113724351529218,0
827,4,0,0,48,0.0,0.0,1.0,48,1500,1200,300,0.8,18,12,6,348.0806751636551,0.42070220153664306,0.3555995729377388,0.21069536378273496,132576.73852237655,-370.5198688271606,132206.21865354938,824,12,331.125,41,7,18,33.57285345021352,0.6374491869918699,42.53472222222222,1029.861111111111,25.118563685636857,0
828,4,0,0,48,0.0,0.0,1.0,48,1400,1100,300,0.7857142857142857,17,11,6,346.4090843566388,0.42125627955082745,0.3505856083586112,0.21018318063111402,132666.15125868065,-408.6480034722128,132257.50325520843,825,13,332.125,43,5,14,33.526078530502204,0.6354166666666666,42.44791666666667,1030.2083333333342,23.958333333333353,0
829,4,0,0,48,0.0,0.0,1.0,48,1050,600,450,0.5714285714285714,15,6,9,347.8991742371089,0.4211269946808511,0.34798347575729727,0.21163704377990253,132763.72680103593,-362.32181545569557,132401.40498558024,826,14,333.125,43,5,15,33.389709485742294,0.6363856589147288,42.353219696969695,1030.5871212121212,23.96714235377026,0
830,4,0,1,47,0.0,0.020833333333333332,0.9791666666666666,48,1200,600,600,0.5,18,6,12,346.80002257900605,0.42044363179669025,0.34888228181345116,0.2117950334191137,132910.1573709395,-381.35088455578284,132528.80648638372,827,15,334.125,43,5,15,33.271057183089965,0.6378391472868217,42.21117424242424,1031.155303030303,23.980355884425652,0
831,4,0,0,47,0.0,0.0,1.0,47,500,300,200,0.6,7,3,4,353.5840945993008,0.41774591427690405,0.3541046290944798,0.21557485286200337,132847.14828022648,-5.472271047423277,132841.67600917906,828,16,341.21276595744683,42,5,15,33.159444809975874,0.638640873015873,42.27228682170542,1030.9108527131775,24.545496493170894,0
832,4,1,2,46,0.020833333333333332,0.041666666666666664,0.9583333333333334,48,1150,900,250,0.782608695652174,14,9,5,348.70870987426736,0.41884604018912525,0.35043441018110655,0.21393750578772602,133081.09504132217,-318.692607897165,132762.402433425,829,0,335.0833333333333,43,5,15,33.05035487028879,0.6395348837209303,42.04545454545454,1031.8181818181808,23.99577167019025,0
833,4,0,0,46,0.0,0.0,1.0,46,950,700,250,0.7368421052631579,12,7,5,356.6409229341458,0.4145028180354267,0.3573903002309471,0.2175007318739225,132857.8514739227,276.50935374147866,133134.36082766418,830,27,350.2826086956522,41,5,15,33.069909545804464,0.6402439024390245,42.26190476190475,1030.9523809523794,25.145180023228765,0
834,4,0,0,46,0.0,0.0,1.0,46,1550,1300,250,0.8387096774193549,18,13,5,355.88539173840934,0.4141807568438003,0.35541261689278447,0.21763438426544138,132960.14817964222,263.7148841017847,133223.863063744,831,28,351.2826086956522,41,5,15,32.98664550468128,0.641260162601626,42.16269841269841,1031.3492063492063,25.154858691444055,0
835,4,0,0,46,0.0,0.0,1.0,46,1350,900,450,0.6666666666666666,18,9,9,353.8287524111068,0.4142411433172302,0.35064853608971647,0.21667322541641262,133011.3112953514,212.64526643989944,133223.9565617913,832,29,352.2826086956522,41,5,15,32.98831506058858,0.6417682926829269,42.113095238095234,1031.5476190476184,25.159698025551666,0
836,4,0,0,46,0.0,0.0,1.0,46,850,500,350,0.5882352941176471,12,5,7,354.2744151062443,0.4137278582930757,0.34850954966704695,0.2173928136589998,133088.07442247728,229.93994472788887,133318.01436720518,833,30,353.2826086956522,41,5,15,32.89978127103163,0.6425304878048781,42.038690476190474,1031.8452380952378,25.166957026713117,0
837,4,0,0,46,0.0,0.0,1.0,46,1350,800,550,0.5925925925925926,19,8,11,355.19102490416395,0.41321457326892114,0.3514510164427642,0.21855485595078783,133190.45970529402,261.6111780360132,133452.07088333005,834,31,354.2826086956522,41,5,15,32.77340621496075,0.6435467479674797,41.93948412698412,1032.2420634920622,25.176635694928347,0
838,4,0,0,46,0.0,0.0,1.0,46,1300,800,500,0.6153846153846154,18,8,10,356.4816583477982,0.41290257648953305,0.35332665079563985,0.22010522321474346,133318.49666950098,305.11975623581327,133623.61642573678,835,32,355.2826086956522,41,5,15,32.61167146974063,0.6448170731707317,41.81547619047618,1032.738095238094,25.188734030197416,0
839,4,0,0,46,0.0,0.0,1.0,46,950,600,350,0.631578947368421,13,6,7,353.8492218614357,0.4131239935587762,0.35062419285406765,0.21880880453880608,133374.38662190078,238.88458448116938,133613.27120638193,836,33,356.2826086956522,43,3,15,32.62360958318054,0.6424418604651163,41.76136363636363,1032.954545454545,24.022198731501046,0
840,4,0,0,46,0.0,0.0,1.0,46,1250,900,350,0.72,16,9,7,354.65205275056906,0.4128220611916264,0.35132905591200725,0.21959443220821268,133423.29993830345,263.76944157483257,133687.0693798783,837,34,357.2826086956522,43,3,15,32.55384967919339,0.6429263565891473,41.71401515151515,1033.143939393939,24.026603241719513,0
841,4,0,1,45,0.0,0.021739130434782608,0.9782608695652174,46,1250,1000,250,0.8,15,10,5,355.13408537408145,0.4122483896940419,0.35017922403442503,0.22050315363464562,133526.04709201393,283.9659915920613,133810.013083606,838,35,358.2826086956522,39,7,16,32.43843647114157,0.6501068376068376,41.614583333333336,1033.541666666667,26.501068376068385,0
842,4,0,0,45,0.0,0.0,1.0,45,1250,1000,250,0.8,15,10,5,359.32622268470357,0.4110900673400673,0.34928315412186395,0.22278225806451618,133472.22222222216,592.0138888888853,134064.23611111104,839,36,365.7111111111111,40,5,16,32.38407258064515,0.6479166666666667,41.666666666666664,1033.333333333333,25.833333333333325,0
843,4,0,0,45,0.0,0.0,1.0,45,1450,1100,350,0.7586206896551724,18,11,7,355.70761863190313,0.41043771043771043,0.34053604554468153,0.22145667869663632,133626.03635204077,506.35983560089886,134132.39618764166,840,37,366.7111111111111,41,4,17,32.32345039339857,0.6478658536585367,41.51785714285714,1033.9285714285709,25.21777003484319,0
844,4,0,1,44,0.0,0.022222222222222223,0.9777777777777777,45,900,500,400,0.5555555555555556,13,5,8,356.8209085945474,0.41024831649831645,0.3382194934765925,0.2224582028223423,133677.32741244647,539.7730851599918,134217.10049760644,841,38,367.7111111111111,41,4,17,32.24330071629573,0.6483739837398375,41.46825396825397,1034.126984126984,25.22260936895083,0
845,4,0,0,44,0.0,0.0,1.0,44,1450,1200,250,0.8275862068965517,17,12,5,358.9753528925983,0.4101039464411558,0.33417088712419085,0.22458032125476327,133805.5981217717,806.5823609536253,134612.18048272532,842,39,358.8181818181818,41,3,17,32.05914197590052,0.6496443089430894,41.344246031746025,1034.6230158730148,25.234707704219872,0
846,4,0,0,44,0.0,0.0,1.0,44,950,700,250,0.7368421052631579,12,7,5,359.3282467349166,0.41002686751233264,0.33095719464584494,0.22527117006842853,133882.59007306633,821.5592718568976,134704.14934492324,843,40,359.8181818181818,41,3,17,31.972935838445807,0.6504065040650406,41.26984126984127,1034.9206349206354,25.24196670538135,0
847,4,0,0,44,0.0,0.0,1.0,44,1050,600,450,0.5714285714285714,15,6,9,358.63759706251926,0.4101039464411558,0.33231911835170114,0.2253090502918356,133959.604168635,808.5901084970988,134768.1942771321,844,41,360.8181818181818,41,3,17,31.913731831975717,0.6511686991869918,41.195436507936506,1035.2182539682537,25.249225706542774,0
848,4,0,0,44,0.0,0.0,1.0,44,1150,700,450,0.6086956521739131,16,7,9,357.22901578425785,0.409564393939394,0.3294736017000821,0.22489484117949843,134036.64040847824,776.3554264298327,134812.99583490807,845,42,361.8181818181818,41,3,17,31.87312384237082,0.651930894308943,41.12103174603175,1035.5158730158732,25.256484707704224,0
849,4,0,0,44,0.0,0.0,1.0,44,1150,800,350,0.6956521739130435,15,8,7,351.8400081028045,0.40931113460183227,0.3227794943209017,0.22259048362409434,134216.47775140157,644.545323916615,134861.0230753182,846,43,362.8181818181818,41,3,17,31.832914472634428,0.6537093495934958,40.94742063492064,1036.2103174603183,25.273422377080934,0
850,4,0,0,44,0.0,0.0,1.0,44,800,300,500,0.375,13,3,10,343.3255741084297,0.40931113460183227,0.28662895677488276,0.20508091799648823,132076.58420138896,307.09030139834056,132383.6745027873,847,44,363.8181818181818,39,5,13,34.1980813403594,0.6356837606837606,43.020833333333336,1027.9166666666672,26.35683760683762,8
851,4,0,0,44,0.0,0.0,1.0,44,1400,1100,300,0.7857142857142857,17,11,6,345.78093929690664,0.40917899929527835,0.2844776779136591,0.20713285392834105,132183.68055555545,341.31944444443855,132524.99999999988,848,45,364.8181818181818,39,5,13,34.027215018908706,0.6367521367521367,42.916666666666664,1028.3333333333326,26.36752136752135,0
852,4,0,0,44,0.0,0.0,1.0,44,1150,900,250,0.782608695652174,14,9,5,344.08588367248814,0.4093221458773784,0.2854430379746833,0.20655611557846948,132264.03130425356,302.0372178819533,132566.06852213552,849,46,365.8181818181818,39,5,13,33.98997890295357,0.6375534188034189,42.83854166666667,1028.6458333333342,26.37553418803421,0
853,4,0,0,44,0.0,0.0,1.0,44,800,600,200,0.75,10,6,4,344.22700624997367,0.40900281888653983,0.2854726775704801,0.20693427515100374,132317.6120334202,309.45909288194855,132627.07112630215,850,47,366.8181818181818,39,5,15,33.932473591846374,0.6380876068376069,42.786458333333336,1028.8541666666672,26.380876068376082,0
854,4,0,0,44,0.0,0.0,1.0,44,1350,1000,350,0.7407407407407407,17,10,7,344.65214366946753,0.40845225510923183,0.28576449497570433,0.20793509106169802,132452.98603121104,330.0655282782759,132783.0515594893,851,48,367.8181818181818,38,6,18,33.785460992907794,0.6411732456140352,42.65491452991452,1029.3803418803407,27.08895636527212,0
855,4,0,0,44,0.0,0.0,1.0,44,1200,900,300,0.75,15,9,6,345.4380813388363,0.4082320295983087,0.2863121297965494,0.20869865500935536,132505.23003472204,354.47048611109176,132859.70052083314,852,49,368.8181818181818,39,5,18,33.712734385538916,0.6399572649572651,42.60416666666666,1029.583333333332,26.39957264957261,0
856,4,0,0,44,0.0,0.0,1.0,44,1250,1000,250,0.8,15,10,5,345.12526732898414,0.40791270260747003,0.28736342501125733,0.2098539809272056,132746.64849175327,362.84450954859085,133109.49300130186,853,50,369.8181818181818,39,5,14,33.47832221436034,0.6423611111111112,42.36979166666666,1030.5208333333317,26.423611111111068,0
857,4,0,0,44,0.0,0.0,1.0,44,750,500,250,0.6666666666666666,10,5,5,345.312039337921,0.40801180408738547,0.2854157864766067,0.21072124324085933,132880.86480034704,377.07248263886515,133257.93728298592,854,51,370.8181818181818,39,5,15,33.33880581935744,0.6436965811965814,42.23958333333332,1031.0416666666652,26.436965811965774,0
858,4,0,0,44,0.0,0.0,1.0,44,1200,900,300,0.75,15,9,6,343.1078461381494,0.40787966878083154,0.2821395775941231,0.2096770170844244,132934.57031249985,322.1788194444292,133256.7491319443,855,52,371.8181818181818,39,5,15,33.341750841750844,0.6442307692307694,42.18749999999999,1031.2499999999989,26.44230769230766,0
859,4,0,0,44,0.0,0.0,1.0,44,950,600,350,0.631578947368421,13,6,7,346.8810864630441,0.4080888830162086,0.28793461005533216,0.21305337406009808,133122.62505425367,435.54416232640904,133558.16921658008,856,53,372.8181818181818,39,5,15,33.055856969819324,0.6461004273504274,42.00520833333334,1031.9791666666683,26.461004273504315,0
860,4,0,0,44,0.0,0.0,1.0,44,1050,800,250,0.7619047619047619,13,8,5,347.0336097208043,0.4078025898520084,0.2834064079397547,0.2137632135452388,133230.14458550353,447.06759982639767,133677.21218532993,857,54,373.8181818181818,39,5,17,32.94414034910706,0.6471688034188035,41.90104166666667,1032.395833333334,26.47168803418805,0
861,4,0,0,44,0.0,0.0,1.0,44,1300,1000,300,0.7692307692307693,16,10,6,349.0053757493409,0.40804483791402396,0.2926351258423876,0.21560051716851827,133337.70751953148,507.11534288197333,133844.82286241345,858,55,374.8181818181818,39,5,18,32.78544713397211,0.6482371794871793,41.796875000000014,1032.8125000000018,26.482371794871842,0
862,4,0,0,44,0.0,0.0,1.0,44,1100,700,400,0.6363636363636364,15,7,8,352.67875163400174,0.40696573291050037,0.29458299081896433,0.21917659182454305,133559.51126379755,620.9237907935343,134180.4350545911,859,56,375.8181818181818,36,8,18,32.46836075098958,0.6559606481481481,41.582207207207205,1033.671171171171,28.71308808808808,0
863,4,0,0,44,0.0,0.0,1.0,44,1250,1000,250,0.8,15,10,5,354.963378956268,0.4068335976039465,0.2977096845696441,0.2215995733748825,133727.27816491603,693.6573032086638,134420.9354681247,860,57,376.8181818181818,37,7,15,32.24131153044276,0.655686936936937,41.41995614035087,1034.3201754385957,27.954599336178262,0
864,4,0,0,44,0.0,0.0,1.0,44,1300,600,700,0.46153846153846156,20,6,14,346.949677981117,0.40737315010570824,0.24586054046532846,0.21030806524143644,132629.89921932062,408.2358070829076,133038.13502640353,861,58,377.8181818181818,36,8,16,33.54856783644911,0.646701388888889,42.483108108108105,1030.0675675675673,28.612987987987978,6
865,4,0,0,44,0.0,0.0,1.0,44,1100,700,400,0.6363636363636364,15,7,8,351.76093868935834,0.40616190979563077,0.24532448192165224,0.21431656413601158,132821.5187004656,544.28441924439,133365.80311970998,862,59,378.8181818181818,37,7,17,33.23216945005851,0.6466779279279279,42.29714912280702,1030.8114035087724,27.859767662399253,0
866,4,0,0,44,0.0,0.0,1.0,44,1600,1200,400,0.75,20,12,8,354.92942390529964,0.40605179704016914,0.24283415638257777,0.217229739146204,132991.1141529125,640.4919061634397,133631.60605907592,863,60,379.8181818181818,37,7,17,32.980205343538486,0.648367117117117,42.13267543859649,1031.4692982456145,27.877548601232824,0
867,4,0,0,44,0.0,0.0,1.0,44,1250,1000,250,0.8,15,10,5,355.4739010827747,0.40561134601832277,0.24048603330371288,0.2183890572448482,133132.52635426284,665.0277008310252,133797.55405509387,864,61,380.8181818181818,37,7,19,32.8242314775464,0.6497747747747746,41.99561403508772,1032.017543859649,27.892366050260787,0
868,4,0,0,44,0.0,0.0,1.0,44,800,600,200,0.75,10,6,4,359.73570681042287,0.4053250528541226,0.2422262780771387,0.22134326430806017,133189.11227493064,782.5758887349848,133971.68816366562,865,62,381.8181818181818,37,7,19,32.657478223921814,0.6503378378378378,41.940789473684205,1032.2368421052624,27.898293029871958,0
869,4,0,0,44,0.0,0.0,1.0,44,1050,600,450,0.5714285714285714,15,6,9,362.626070094793,0.40403673361522197,0.24131624478128422,0.22416041212765098,133361.84619037193,872.0964369201666,134233.9426272921,866,63,382.8181818181818,38,6,20,32.40953833953938,0.650219298245614,41.77350427350428,1032.9059829059836,27.181736392262724,0
870,4,0,0,44,0.0,0.0,1.0,44,1150,800,350,0.6956521739130435,15,8,7,363.72906103445763,0.4039926885130374,0.24666656760478278,0.22568908675545768,133501.3153990139,911.7529335835427,134413.06833259744,867,64,383.8181818181818,36,8,21,32.241155424793874,0.6553819444444444,41.638513513513516,1033.4459459459463,28.706831831831842,0
871,4,0,0,44,0.0,0.0,1.0,44,850,500,350,0.5882352941176471,12,5,7,360.5415151862614,0.4039926885130374,0.24467736336637547,0.22422067316464858,133585.55036164972,832.6273468759643,134418.17770852568,868,65,384.8181818181818,37,7,21,32.239075095460336,0.6542792792792793,41.55701754385965,1033.7719298245613,27.939781887150307,0
872,4,0,0,44,0.0,0.0,1.0,44,1650,1100,550,0.6666666666666666,22,11,11,362.18711522811304,0.40415785764622975,0.22456415333003354,0.22423044998953973,133418.408203125,864.485677083333,134282.89388020834,869,66,385.8181818181818,39,5,18,32.364135914498895,0.6490384615384615,41.71875,1033.125,26.490384615384617,1
873,4,1,1,44,0.022222222222222223,0.022222222222222223,0.9777777777777777,45,950,500,450,0.5263157894736842,14,5,9,358.0104110322301,0.4062289562289562,0.21431365618003984,0.22298799049101287,133642.2324657589,569.0946673495912,134211.32713310848,870,0,378.22222222222223,37,8,18,32.24770236832804,0.6548423423423422,41.50219298245615,1033.9912280701772,27.945708866761546,0
874,4,0,1,43,0.0,0.022727272727272728,0.9772727272727273,44,1300,900,400,0.6923076923076923,17,9,8,360.33230691217307,0.40332100070472165,0.2180752577220173,0.22391909408444707,133557.21381819432,824.9957919744828,134382.2096101688,871,68,387.8181818181818,37,7,18,32.272881970227374,0.6539977477477475,41.58442982456142,1033.6622807017563,27.936818397344766,0
875,4,0,0,43,0.0,0.0,1.0,43,1100,800,300,0.7272727272727273,14,8,6,364.36293715980764,0.4037006275378368,0.22115092976403816,0.22711876142459697,133670.5780264122,1140.9208843105803,134811.4989107228,872,69,392.4651162790698,37,6,19,32.05507987841515,0.6551238738738737,41.4747807017544,1034.1008771929844,27.948672356567148,0
876,4,0,0,43,0.0,0.0,1.0,43,1350,1100,250,0.8148148148148148,16,11,5,374.92018866199606,0.4038851974898487,0.19427184443228995,0.23027491066797212,133122.62505425327,1382.0719401041422,134504.6969943574,873,70,393.4651162790698,39,4,17,32.33246273678542,0.6461004273504274,42.00520833333332,1031.979166666665,26.46100427350423,2
877,4,0,0,43,0.0,0.0,1.0,43,1350,1000,350,0.7407407407407407,17,10,7,378.1819071836067,0.4037006275378368,0.1961143401314447,0.23298665828248963,133236.04630386984,1477.4924193601455,134713.53872322998,874,71,394.4651162790698,40,3,17,32.13427338648817,0.6455729166666668,41.89532520325202,1032.4186991869901,25.810467479674752,0
878,4,0,0,43,0.0,0.0,1.0,43,1600,1300,300,0.8125,19,13,6,375.8794572629499,0.4042543373938723,0.1939586136203475,0.23238678854140027,133367.22932778104,1426.0003552779378,134793.22968305898,875,72,395.4651162790698,40,3,17,32.06189328348419,0.6468750000000001,41.76829268292683,1032.9268292682923,25.823170731707307,0
879,4,0,0,43,0.0,0.0,1.0,43,1050,1000,50,0.9523809523809523,11,10,1,374.1220547102246,0.4046004060538944,0.19403483568118074,0.2316275766251001,133419.72061107805,1383.0520027761268,134802.77261385418,876,73,396.4651162790698,40,3,17,32.05456095481671,0.6473958333333334,41.71747967479675,1033.1300813008131,25.82825203252033,0
880,4,0,0,43,0.0,0.0,1.0,43,1050,800,250,0.7619047619047619,13,8,5,376.79313862758465,0.4045081210778885,0.20100425636913188,0.23379034440849164,133500.5497484804,1460.449213189138,134960.99896166954,877,74,397.4651162790698,37,6,18,31.90439876215739,0.6534346846846846,41.63925438596492,1033.4429824561412,27.930891417733545,0
881,4,0,0,43,0.0,0.0,1.0,43,900,500,400,0.5555555555555556,13,5,8,372.8806156068307,0.4031930601698044,0.19727677037556712,0.23239610292714227,133665.49014035013,1368.254049784522,135033.74419013466,878,75,398.4651162790698,38,5,18,31.83998002548473,0.6532346491228069,41.479700854700866,1034.0811965811984,27.21266306792627,0
882,4,0,0,43,0.0,0.0,1.0,43,800,400,400,0.5,12,4,8,376.1388651580493,0.4029854189737911,0.19831093902374541,0.23495332209420883,133748.36205164742,1461.5914237709217,135209.95347541833,879,76,399.4651162790698,38,5,15,31.672605522275017,0.6540570175438596,41.399572649572654,1034.4017094017101,27.221097615834477,0
883,4,0,0,43,0.0,0.0,1.0,43,1350,800,550,0.5925925925925926,19,8,11,381.2621053105715,0.40261627906976744,0.2055252068050566,0.23868930122384532,133831.25964506183,1604.9575617284067,135436.21720679023,880,77,400.4651162790698,38,5,15,31.456935123042502,0.6548793859649122,41.31944444444445,1034.722222222223,27.229532163742714,0
884,4,0,0,43,0.0,0.0,1.0,43,1100,700,400,0.6363636363636364,15,7,8,382.9621768548045,0.40222406792174237,0.21373177590724546,0.24101749468030934,134024.78723792822,1665.2848546277994,135690.07209255602,881,78,401.4651162790698,38,5,16,31.218831682487274,0.6567982456140351,41.13247863247863,1035.4700854700852,27.24921277552856,0
885,4,0,0,43,0.0,0.0,1.0,43,1050,900,150,0.8571428571428571,12,9,3,378.60326605010897,0.40194721299372466,0.21207709888697313,0.23917367237054743,134163.10683988954,1558.9180866023705,135722.02492649193,882,79,402.4651162790698,38,5,16,31.19306658416692,0.6581688596491229,40.99893162393162,1036.0042735042725,27.263270355375592,0
886,4,0,0,43,0.0,0.0,1.0,43,1350,1000,350,0.7407407407407407,17,10,7,377.9187505665108,0.40132428940568476,0.2122937970114045,0.2396449488886463,134301.49778106506,1551.0108481262282,135852.5086291913,883,80,403.4651162790698,38,5,16,31.072201607915883,0.6595394736842106,40.86538461538461,1036.5384615384614,27.27732793522267,0
887,4,0,0,43,0.0,0.0,1.0,43,600,300,300,0.5,9,3,6,372.8204601429976,0.4013012181616833,0.2110779626900543,0.23694974235021535,134384.5665885929,1420.2631903352888,135804.8297789282,884,81,404.4651162790698,38,5,16,31.121200412158675,0.6603618421052633,40.7852564102564,1036.8589743589732,27.285762483130874,0
888,4,0,0,43,0.0,0.0,1.0,43,1500,900,600,0.6,21,9,12,371.76819728714065,0.40097822074566264,0.20995610348370208,0.2373596951910204,134550.78124999988,1404.3402777777637,135955.12152777764,885,82,405.4651162790698,38,5,16,30.98226238286478,0.6620065789473685,40.62499999999999,1037.499999999999,27.302631578947345,0
889,4,0,0,43,0.0,0.0,1.0,43,1150,800,350,0.6956521739130435,15,8,7,372.7546130611638,0.4006782945736434,0.2060662345495805,0.23889734963735246,134689.3719409743,1441.2169442617949,136130.5888852361,886,83,406.4651162790698,38,5,17,30.818152188829426,0.6633771929824562,40.49145299145298,1038.0341880341864,27.31668915879438,0
890,4,0,0,43,0.0,0.0,1.0,43,850,500,350,0.5882352941176471,12,5,7,372.1488107412066,0.4004937246216316,0.20186783500073036,0.2390558024847182,134772.56059838185,1431.089629446996,136203.65022782885,887,84,407.4651162790698,38,5,17,30.750763110059335,0.6641995614035088,40.41132478632478,1038.3547008547002,27.325123706702637,0
891,4,0,1,42,0.0,0.023255813953488372,0.9767441860465116,43,1300,1000,300,0.7692307692307693,16,10,6,370.74950464868164,0.40005537098560356,0.20389032443295996,0.23833896727415235,134800.2958579881,1395.4285831689579,136195.72444115704,888,85,408.4651162790698,38,5,15,30.7593878600823,0.6644736842105263,40.38461538461538,1038.4615384615379,27.32793522267205,0
892,4,0,1,41,0.0,0.023809523809523808,0.9761904761904762,42,1600,1100,500,0.6875,21,11,10,378.4268855003656,0.39792634533488197,0.20519626769626775,0.24350947414806098,134835.33394890715,1805.063096337312,136640.39704524446,889,86,408.1190476190476,37,5,15,30.525056306306304,0.6666666666666667,40.350877192982445,1038.5964912280685,28.070175438596447,0
893,4,1,0,42,0.023809523809523808,0.0,1.0,42,750,500,250,0.6666666666666666,10,5,5,377.3880426183028,0.3994628339140534,0.19987594236091266,0.24456705619030267,135091.6883680555,1796.3975694444396,136888.08593749994,890,0,402.42857142857144,37,5,16,30.296008684034728,0.6692004504504505,40.104166666666664,1039.583333333333,28.096846846846837,0
894,4,0,0,42,0.0,0.0,1.0,42,1250,1000,250,0.8,15,10,5,378.86252825996263,0.3983376887340302,0.20040059034366453,0.24649450912716064,135234.21269044303,1847.0351454293398,137081.24783587237,891,1,403.42857142857144,37,5,17,30.11543327008222,0.6706081081081081,39.96710526315788,1040.131578947367,28.11166429587478,0
895,4,0,0,42,0.0,0.0,1.0,42,900,500,400,0.5555555555555556,13,5,8,377.5889240650391,0.39815621370499416,0.19659605859416174,0.24625026119952959,135319.7633526662,1819.048769813786,137138.81212247998,892,2,404.42857142857144,37,5,17,30.063209154459546,0.6714527027027027,39.88486842105263,1040.4605263157894,28.120554765291605,0
896,4,0,0,42,0.0,0.0,1.0,42,850,700,150,0.8235294117647058,10,7,3,375.2378753547513,0.39768437862950057,0.19305202329536053,0.2454950482937734,135433.87298255228,1763.983749807624,137197.8567323599,893,3,405.42857142857144,37,5,17,30.010599915727383,0.6725788288288288,39.77521929824561,1040.899122807017,28.132408724513972,0
897,4,0,0,42,0.0,0.0,1.0,42,650,400,250,0.6153846153846154,9,4,5,376.2745070407841,0.39674070847851334,0.1950365278258297,0.24695777424784565,135548.03070415897,1800.6536867112952,137348.68439087027,894,4,406.42857142857144,37,5,18,29.869849250640552,0.673704954954955,39.665570175438596,1041.3377192982455,28.144262683736365,0
898,4,0,0,42,0.0,0.0,1.0,42,1350,1100,250,0.8148148148148148,16,11,5,375.5303630223423,0.395603464963221,0.1928830630230316,0.24747615870623185,135693.9688893176,1791.4951825751684,137485.46407189275,895,5,407.42857142857144,35,7,18,29.74385321780344,0.6791666666666667,39.52546296296296,1041.8981481481483,29.768518518518523,0
899,4,0,0,42,0.0,0.0,1.0,42,1100,600,500,0.5454545454545454,16,6,10,375.5303630223423,0.3950711382113821,0.1928830630230316,0.24747615870623185,135693.9688893176,1791.441079389573,137485.40996870716,896,6,408.42857142857144,35,7,18,29.74385321780344,0.6791666666666667,39.52546296296296,1041.8981481481483,29.768518518518523,0
900,4,0,0,42,0.0,0.0,1.0,42,1000,600,400,0.6,14,6,8,374.80231921778983,0.39475658149438636,0.19065067732622687,0.2478318419144946,135814.58574459876,1780.7243441358014,137595.31008873458,897,7,409.42857142857144,35,7,18,29.6427381745503,0.6803571428571429,39.40972222222222,1042.361111111111,29.78174603174603,0
901,4,0,0,42,0.0,0.0,1.0,42,1000,800,200,0.8,12,8,4,374.5605044306345,0.39411536972512584,0.18959611816754696,0.24830136750666557,135905.08355034713,1780.935329861107,137686.01888020823,898,8,410.42857142857144,35,7,14,29.558982683982684,0.68125,39.322916666666664,1042.7083333333328,29.79166666666665,0
902,4,0,0,42,0.0,0.0,1.0,42,1150,600,550,0.5217391304347826,17,6,11,373.2897957084499,0.39314750290360045,0.18971785806765284,0.24787872874936207,135965.43216574503,1750.9016793124179,137716.33384505747,899,9,411.42857142857144,35,7,15,29.532076536085523,0.681845238095238,39.2650462962963,1042.939814814815,29.798280423280428,0
903,4,0,0,42,0.0,0.0,1.0,42,850,600,250,0.7058823529411765,11,6,5,374.2369251118349,0.393062814556717,0.18949337391414622,0.2487185227955645,135995.61149691354,1778.915895061721,137774.52739197525,900,10,412.42857142857144,35,7,15,29.47736351531292,0.6821428571428572,39.23611111111111,1043.0555555555552,29.80158730158729,0
904,4,0,0,42,0.0,0.0,1.0,42,1000,500,500,0.5,15,5,10,375.78356651431324,0.3925425861401471,0.18790347290458276,0.2501708322422466,136055.98020618994,1825.5202974965705,137881.50050368652,901,11,413.42857142857144,35,7,16,29.376987648842544,0.6827380952380953,39.17824074074074,1043.2870370370367,29.80820105820105,0
905,4,0,0,42,0.0,0.0,1.0,42,650,300,350,0.46153846153846156,10,3,7,376.5980513512306,0.3927240611691831,0.18932228541854834,0.2513534144362728,136146.55838745285,1854.505717378254,138001.0641048311,902,12,414.42857142857144,35,7,16,29.265669476174637,0.6836309523809524,39.09143518518518,1043.6342592592591,29.81812169312169,0
906,4,0,0,42,0.0,0.0,1.0,42,1600,1100,500,0.6875,21,11,10,379.76742870076987,0.392518389469609,0.19022289766970668,0.2549867021276595,136358.02469135786,1956.8672839505962,138314.89197530845,903,13,415.42857142857144,35,7,16,28.97273936170213,0.6857142857142857,38.88888888888888,1044.444444444443,29.8412698412698,0
907,4,0,0,42,0.0,0.0,1.0,42,1200,1000,200,0.8333333333333334,14,10,4,381.72560948455833,0.39221593108788233,0.18977451383832933,0.25674033913618644,136418.47377614872,2014.8850094307138,138433.35878557945,904,14,416.42857142857144,35,7,16,28.861529655070534,0.6863095238095238,38.83101851851851,1044.6759259259252,29.847883597883577,0
908,4,0,1,41,0.0,0.023809523809523808,0.9761904761904762,42,1150,900,250,0.782608695652174,14,9,5,380.6115465302093,0.3907883275261324,0.17572292737508333,0.2571488216210125,136577.61432604262,1996.6034020083093,138574.21772805092,905,15,417.42857142857144,37,5,17,28.732538725130258,0.6838400900900901,38.67872807017544,1045.2850877192982,28.250948316737787,0
909,4,0,0,41,0.0,0.0,1.0,41,1050,900,150,0.8571428571428571,12,9,3,391.86245357370836,0.3884908536585366,0.19155976262312202,0.2643199607226481,136520.31304103197,2499.4369661819114,139019.75000721388,906,103,428.2439024390244,37,4,18,28.49550152135138,0.683277027027027,38.73355263157895,1045.065789473685,28.245021337126623,0
910,4,0,0,41,0.0,0.0,1.0,41,1350,900,450,0.6666666666666666,18,9,9,391.08723118638284,0.3875,0.19687158858099885,0.2646735577033156,136637.13223208426,2487.407544378707,139124.53977646297,907,104,429.2439024390244,38,3,18,28.39962701818925,0.6825657894736841,38.621794871794876,1045.5128205128212,27.51349527665319,0
911,4,0,1,40,0.0,0.024390243902439025,0.975609756097561,41,850,600,250,0.7058823529411765,11,6,5,386.8192568371927,0.38727134146341463,0.1918180934797391,0.2624098201787446,136720.920138889,2377.2826265614826,139098.20276545046,908,105,430.2439024390244,37,4,18,28.427954847277555,0.6852477477477477,38.54166666666667,1045.8333333333342,28.26576576576579,0
912,4,0,0,40,0.0,0.0,1.0,40,1450,1200,250,0.8275862068965517,17,12,5,388.6654387375598,0.3867120726495727,0.20253954305799637,0.2639029053003239,136752.96347858995,2630.2301098135267,139383.1935884035,909,106,438.8,33,7,18,28.347856863893767,0.6941287878787878,38.5110294117647,1045.955882352941,31.695632798573968,0
913,4,0,1,39,0.0,0.025,0.975,40,950,800,150,0.8421052631578947,11,8,3,387.9626856298127,0.38669871794871796,0.2005974695407684,0.26366636023376455,136785.01057285667,2613.4960111495657,139398.50658400625,910,107,439.8,33,7,18,28.33440721649485,0.6944444444444444,38.48039215686275,1046.0784313725496,31.699346405228777,0
914,4,0,0,39,0.0,0.0,1.0,39,1100,900,200,0.8181818181818182,13,9,4,388.0521484104521,0.38630229419703105,0.1865464834748114,0.26441692903316844,136876.59438775503,2823.051303854867,139699.64569160988,911,108,432.56410256410254,34,5,18,28.241135760333723,0.6930147058823529,38.39285714285714,1046.4285714285706,30.777310924369726,0
915,4,0,0,39,0.0,0.0,1.0,39,950,700,250,0.7368421052631579,12,7,5,390.0728118347499,0.386555330634278,0.19634999147194265,0.26101311296360874,136237.1667095337,2831.6717144676863,139068.83842400138,912,109,433.56410256410254,35,4,17,28.823909830007395,0.6845238095238095,39.00462962962963,1043.981481481482,29.828042328042343,2
916,4,0,0,39,0.0,0.0,1.0,39,600,300,300,0.5,9,3,6,388.36153236758696,0.3861054880791723,0.19578559738134205,0.26075702887538,136358.0246913581,2791.2422839506253,139149.2669753087,913,110,434.56410256410254,35,4,17,28.74833776595745,0.6857142857142857,38.88888888888889,1044.444444444445,29.84126984126986,0
917,4,0,0,39,0.0,0.0,1.0,39,1150,600,550,0.5217391304347826,17,6,11,387.6207866927633,0.3865834457939721,0.19592504537669053,0.26092862352539686,136448.70334201382,2778.070746527767,139226.7740885416,914,111,435.56410256410254,35,4,17,28.677509139248905,0.6866071428571429,38.80208333333333,1044.791666666666,29.85119047619046,0
918,4,0,1,38,0.0,0.02564102564102564,0.9743589743589743,39,1250,800,450,0.64,17,8,9,384.7065928169438,0.3861336032388664,0.19515685289132279,0.25985678681599256,136569.65509527182,2707.849338777441,139277.50443404928,915,112,436.56410256410254,35,4,17,28.63343391281881,0.6877976190476189,38.686342592592595,1045.25462962963,29.864417989418,0
919,4,0,0,38,0.0,0.0,1.0,38,600,200,400,0.3333333333333333,10,2,8,391.00377793983085,0.38550557136083446,0.19522364973831063,0.26384490134771516,136534.22796201814,3077.079790249433,139611.30775226757,916,113,444.0,34,4,17,28.504100694839956,0.6896446078431373,38.720238095238095,1045.1190476190475,30.73879551820728,0
920,4,0,0,38,0.0,0.0,1.0,38,800,200,600,0.25,14,2,12,388.5859097197426,0.3849128733997155,0.19378862256426843,0.2626768955542001,136596.44451530612,3015.890731292515,139612.33524659864,917,114,445.0,34,4,17,28.505437877234936,0.6902573529411764,38.660714285714285,1045.357142857143,30.745798319327733,0
921,4,0,0,38,0.0,0.0,1.0,38,850,600,250,0.7058823529411765,11,6,5,389.9736148851529,0.38469061166429586,0.18796735691688227,0.26431545008882595,136689.79591836734,3061.0827664399058,139750.87868480725,918,115,446.0,34,4,17,28.376404068002426,0.6911764705882353,38.57142857142857,1045.7142857142856,30.756302521008397,0
922,4,0,0,38,0.0,0.0,1.0,38,1000,700,300,0.7,13,7,6,389.9736148851529,0.3850017780938833,0.18796735691688227,0.26431545008882595,136689.79591836734,3061.0827664399058,139750.87868480725,919,116,447.0,34,4,17,28.376404068002426,0.6911764705882353,38.57142857142857,1045.7142857142856,30.756302521008397,0
923,4,0,0,38,0.0,0.0,1.0,38,850,500,350,0.5882352941176471,12,5,7,389.0414437866065,0.38482396870554764,0.18483958901237152,0.26391730375794126,136720.92013888896,3038.0243764172446,139758.9445153062,920,117,448.0,33,5,17,28.369853917662695,0.6938131313131313,38.54166666666667,1045.833333333334,31.69191919191921,0
924,4,0,0,38,0.0,0.0,1.0,38,1100,1000,100,0.9090909090909091,12,10,2,385.66448531565453,0.38409791370317686,0.18798974125016188,0.26234404072826656,136817.06142168885,2953.0963151191922,139770.15773680803,921,118,449.0,33,5,17,28.362690835968912,0.694760101010101,38.44975490196079,1046.2009803921574,31.703060011883558,0
925,4,0,0,38,0.0,0.0,1.0,38,850,600,250,0.7058823529411765,11,6,5,384.6266939356998,0.38386083451872927,0.19253569469863607,0.2625976493129346,136945.302362673,2934.563779555942,139879.86614222894,922,119,450.0,33,5,18,28.262571712914184,0.6960227272727273,38.32720588235294,1046.6911764705883,31.717914438502675,0
926,4,0,0,38,0.0,0.0,1.0,38,500,400,100,0.8,6,4,2,391.64596053557074,0.38386083451872927,0.23525509887793694,0.25538204339070647,135314.73021193786,3004.567654267606,138319.29786620545,923,120,451.0,33,5,19,29.702591283863377,0.6799242424242424,39.88970588235295,1040.4411764705892,31.528520499108765,3
927,4,0,0,38,0.0,0.0,1.0,38,1300,900,400,0.6923076923076923,17,9,8,388.8896868376683,0.38307550972024657,0.2351449118264648,0.25516568873047635,135537.95602953195,2941.8626549884743,138479.81868452043,924,121,452.0,33,5,19,29.551483857047593,0.6821338383838383,39.67524509803922,1041.2990196078435,31.55451574569223,0
928,4,1,1,38,0.02564102564102564,0.02564102564102564,0.9743589743589743,39,1050,700,350,0.6666666666666666,14,7,7,382.1265090768997,0.38585245164192533,0.22461658983398114,0.2536580805182854,135953.00635572866,2590.2833345348026,138543.28969026345,925,0,441.38461538461536,33,6,18,29.314042303172744,0.6862373737373737,39.27696078431373,1042.8921568627457,31.602792632204412,0
929,4,0,0,38,0.0,0.0,1.0,38,650,400,250,0.6153846153846154,9,4,5,392.19969465538685,0.38191974869606443,0.23397372564267638,0.2596946975757442,135863.944447633,3057.159505407626,138921.1039530406,926,123,454.0,32,6,18,29.140173993783062,0.6878255208333333,39.362373737373744,1042.5505050505058,32.579703282828305,0
930,4,0,0,38,0.0,0.0,1.0,38,400,100,300,0.25,7,1,6,394.24139437272436,0.3816826695116169,0.23647882117500063,0.261287755596305,135896.85523160917,3115.233139475583,139012.08837108474,927,124,455.0,32,6,18,29.05414951158473,0.6881510416666666,39.33080808080809,1042.6767676767688,32.583648989899025,0
931,4,0,0,38,0.0,0.0,1.0,38,900,700,200,0.7777777777777778,11,7,4,393.27944453999197,0.38114924134660977,0.23957530310463215,0.2613742149110921,135995.61149691363,3096.85570987655,139092.46720679017,928,125,456.0,32,6,19,28.98080337328008,0.6891276041666666,39.236111111111114,1043.0555555555559,32.59548611111112,0
932,4,0,0,38,0.0,0.0,1.0,38,900,600,300,0.6666666666666666,12,6,6,390.741135287737,0.3807491702228544,0.23493812049503626,0.26031064364943624,136080.84180363335,3034.476523452537,139115.31832708587,929,126,457.0,33,5,19,28.96210163652025,0.6875,39.15441176470589,1043.3823529411775,31.61764705882356,0
933,4,0,0,38,0.0,0.0,1.0,38,1000,700,300,0.7,13,7,6,391.6325440680639,0.3802305595068753,0.23509986964123541,0.26208308271137754,136240.7205912389,3071.2600021626276,139311.98059340153,930,127,458.0,33,5,19,28.779664084203944,0.6890782828282829,39.00122549019608,1043.9950980392155,31.636215092097437,0
934,4,0,1,37,0.0,0.02631578947368421,0.9736842105263158,38,550,200,350,0.36363636363636365,9,2,7,391.85958278202673,0.3797415836889521,0.2380525945231533,0.26294703657231777,136336.69291858922,3084.9679209919505,139421.66083958116,931,128,459.0,33,5,19,28.678224986309946,0.6900252525252524,38.90931372549021,1044.362745098041,31.647355912061848,0
935,4,0,0,37,0.0,0.0,1.0,37,1350,1100,250,0.8148148148148148,16,11,5,395.5188447984019,0.37850350350350354,0.22027519771366655,0.2661866090453049,136440.92970521544,3392.991780045353,139833.9214852608,932,129,447.6216216216216,34,3,19,28.478948268003638,0.6887254901960784,38.80952380952381,1044.7619047619048,30.72829131652661,0
936,4,0,0,37,0.0,0.0,1.0,37,600,400,200,0.6666666666666666,8,4,4,395.5188447984019,0.37850350350350354,0.22027519771366655,0.2661866090453049,136440.92970521544,3392.991780045353,139833.9214852608,933,130,448.6216216216216,34,3,19,28.478948268003638,0.6887254901960784,38.80952380952381,1044.7619047619048,30.72829131652661,0
937,4,0,0,37,0.0,0.0,1.0,37,1050,700,350,0.6666666666666666,14,7,7,392.19950703204245,0.37828453453453453,0.2164748480537948,0.26441837732160317,136503.12500000017,3307.291666666683,139810.41666666686,934,131,449.6216216216216,34,3,19,28.50378787878786,0.6893382352941175,38.75000000000001,1045.0000000000014,30.7352941176471,0
938,4,0,0,37,0.0,0.0,1.0,37,650,500,150,0.7692307692307693,8,5,3,392.9774129441004,0.3778778778778779,0.21483100412485356,0.2654108988960925,136565.3344671202,3333.418367346939,139898.75283446716,935,132,450.6216216216216,34,3,19,28.421602126044025,0.6899509803921569,38.69047619047619,1045.2380952380954,30.74229691876751,0
939,4,0,0,37,0.0,0.0,1.0,37,650,500,150,0.7692307692307693,8,5,3,394.03489913142414,0.37772147147147145,0.21771190457138934,0.26659587705486676,136627.5581065761,3367.2052154195135,139994.76332199562,936,133,451.6216216216216,34,3,20,28.332099749487586,0.690563725490196,38.63095238095239,1045.4761904761915,30.749299719887986,0
940,4,0,0,37,0.0,0.0,1.0,37,1100,700,400,0.6363636363636364,15,7,8,396.22769131709384,0.3768455955955956,0.2235356283147738,0.2695519417285254,136819.97532139576,3442.436365041882,140262.41168643764,937,134,452.6216216216216,32,5,21,28.083514361573744,0.697265625,38.446969696969695,1046.212121212121,32.69412878787878,0
941,4,0,0,37,0.0,0.0,1.0,37,1100,700,400,0.6363636363636364,15,7,8,394.62174227799204,0.37650150150150147,0.2207359386413439,0.2689658717105265,136886.03203754735,3403.640891235612,140289.67292878297,938,135,453.6216216216216,32,5,21,28.05989583333334,0.6979166666666666,38.383838383838395,1046.4646464646478,32.70202020202024,0
942,4,0,0,37,0.0,0.0,1.0,37,850,400,450,0.47058823529411764,13,4,9,392.0238636054818,0.3756569069069069,0.21772188201707077,0.2684602725747532,137051.24357527297,3345.4716036628984,140396.71517893588,939,136,454.6216216216216,32,5,16,27.963845009847663,0.6995442708333333,38.226010101010104,1047.0959595959598,32.721748737373744,0
943,4,0,0,37,0.0,0.0,1.0,37,600,400,200,0.6666666666666666,8,4,4,389.1636095703116,0.37521896896896895,0.2024256602844301,0.2628351147713334,136565.33446712006,3229.2517006802573,139794.58616780033,940,137,455.6216216216216,34,3,17,28.521260440394833,0.6899509803921569,38.69047619047618,1045.2380952380943,30.74229691876748,1
944,4,0,0,37,0.0,0.0,1.0,37,1500,1200,300,0.8,18,12,6,386.81925683719305,0.3744682182182182,0.20372563798858634,0.2624098201787446,136720.92013888896,3177.345521541961,139898.26566043092,941,138,456.6216216216216,33,4,18,28.427954847277558,0.6938131313131313,38.54166666666667,1045.833333333334,31.69191919191921,0
945,4,0,0,37,0.0,0.0,1.0,37,850,600,250,0.7058823529411765,11,6,5,382.8093954903001,0.3738738738738739,0.19667013857010396,0.2604018971554336,136817.06142168882,3074.9713151191913,139892.032736808,942,139,457.6216216216216,33,4,18,28.437365780328772,0.694760101010101,38.44975490196079,1046.2009803921571,31.70306001188355,0
946,4,0,0,37,0.0,0.0,1.0,37,500,400,100,0.8,6,4,2,384.6263800415279,0.3738738738738739,0.19812222623185383,0.2618771955976528,136849.11602508655,3127.1560217224196,139976.27204680897,943,140,458.6216216216216,33,4,18,28.358026860310765,0.6950757575757576,38.419117647058826,1046.323529411765,31.706773618538335,0
947,4,0,0,37,0.0,0.0,1.0,37,700,300,400,0.42857142857142855,11,3,8,386.9019966595165,0.37256006006006004,0.19956911142677258,0.2646360094045035,137009.44536055846,3201.8455942425985,140211.29095480105,944,141,459.6216216216216,33,4,15,28.139387997971042,0.6966540404040404,38.26593137254902,1046.936274509804,31.725341651812244,0
948,4,0,0,37,0.0,0.0,1.0,37,1300,900,400,0.6923076923076923,17,9,8,389.45341856916235,0.37346721721721726,0.205051159995572,0.2668708469665994,137073.6033767062,3276.7566861303467,140350.36006283652,945,142,460.6216216216216,33,4,15,28.008947727716013,0.6972853535353536,38.204656862745104,1047.1813725490204,31.73276886512183,0
949,4,0,0,37,0.0,0.0,1.0,37,1000,800,200,0.8,12,8,4,389.5653579149721,0.37334209209209207,0.19864928100772716,0.2676852636219601,137169.86856016924,3287.325788158409,140457.19434832764,946,143,461.6216216216216,33,4,15,27.910524879114025,0.6982323232323232,38.11274509803922,1047.5490196078438,31.743909685086177,0
950,4,0,0,37,0.0,0.0,1.0,37,850,500,350,0.5882352941176471,12,5,7,390.402774515815,0.37237237237237236,0.19644126764435432,0.26950080148779404,137330.38562391882,3322.832714580948,140653.21833849978,947,144,462.6216216216216,33,4,16,27.729427296465182,0.699810606060606,37.95955882352942,1048.1617647058833,31.762477718360103,0
951,4,0,0,37,0.0,0.0,1.0,37,1100,600,500,0.5454545454545454,16,6,10,391.97310064620774,0.37149649649649646,0.20341477123811535,0.2720922764339734,137523.13000108127,3381.073535419066,140904.20353650034,948,145,463.6216216216216,33,4,16,27.49724948397398,0.7017045454545454,37.775735294117645,1048.897058823529,31.78475935828876,0
952,4,0,0,37,0.0,0.0,1.0,37,1200,800,400,0.6666666666666666,16,8,8,390.7366390896875,0.3715903403403404,0.20373346129683,0.2717381289396279,137587.4081633268,3352.0882893598855,140939.49645268667,949,146,464.6216216216216,33,4,17,27.466003776817356,0.7023358585858586,37.71446078431374,1049.1421568627466,31.792186571598382,0
953,4,0,0,37,0.0,0.0,1.0,37,950,600,350,0.631578947368421,13,6,7,390.72433839010563,0.3714652152152152,0.20448125341270296,0.2722353547302258,137651.7013438341,3356.7739871684034,141008.47533100253,950,147,465.6216216216216,33,4,17,27.402657752345373,0.7029671717171716,37.65318627450981,1049.387254901961,31.799613784907905,0
954,4,0,0,37,0.0,0.0,1.0,37,800,700,100,0.875,9,7,2,387.3771730914585,0.3705267767767768,0.20763620763620727,0.27116402116402116,137812.50000000015,3277.083333333349,141089.5833333335,951,148,466.6216216216216,33,4,18,27.331349206349202,0.7045454545454545,37.50000000000001,1050.0000000000011,31.818181818181852,0
955,4,0,0,37,0.0,0.0,1.0,37,850,600,250,0.7058823529411765,11,6,5,385.51145697407577,0.3702452452452452,0.20448002703352564,0.2703781027917677,137878.79584991347,3230.771094786273,141109.56694469973,952,149,467.6216216216216,32,5,19,27.314759156848613,0.7076822916666666,37.4368686868687,1050.2525252525268,32.82039141414146,0
956,4,0,0,37,0.0,0.0,1.0,37,650,400,250,0.6153846153846154,9,4,5,399.3600000000001,0.3699637137137137,0.22529729729729753,0.26273684210526305,135633.68055555547,3474.6636185083053,139108.3441740638,953,150,468.6216216216216,31,6,20,29.183333333333344,0.6881720430107527,39.58333333333333,1041.666666666666,33.60215053763439,7
957,4,0,0,37,0.0,0.0,1.0,37,950,700,250,0.7368421052631579,12,7,5,399.5795602461544,0.3697447447447448,0.22656498037652728,0.26338020107823107,135701.50587293826,3444.7096082899106,139146.21548122817,954,151,469.6216216216216,31,6,21,29.10991002249437,0.6888440860215055,39.51822916666666,1041.9270833333323,33.61055107526879,0
958,4,0,0,37,0.0,0.0,1.0,37,850,700,150,0.8235294117647058,10,7,3,398.3947416694877,0.3702452452452452,0.22622597606978512,0.26284856698935755,135735.42488945846,3415.2559068467785,139150.68079630524,955,152,470.6216216216216,31,6,21,29.106923445374655,0.6891801075268817,39.48567708333333,1042.0572916666658,33.614751344085995,0
959,4,0,0,37,0.0,0.0,1.0,37,1100,800,300,0.7272727272727273,14,8,6,397.20020049945015,0.3701514014014014,0.2239420830125476,0.26230943933973594,135769.34814453128,3385.5224609375,139154.87060546878,956,153,471.6216216216216,31,6,21,29.104197901049474,0.6895161290322581,39.453125,1042.1875000000002,33.61895161290323,0
960,4,0,0,37,0.0,0.0,1.0,37,850,500,350,0.5882352941176471,12,5,7,397.20020049945015,0.3701514014014014,0.2239420830125476,0.26230943933973594,135769.34814453128,3385.5224609375,139154.87060546878,957,154,472.6216216216216,31,6,21,29.104197901049474,0.6895161290322581,39.453125,1042.1875000000002,33.61895161290323,0
961,4,0,0,37,0.0,0.0,1.0,37,1200,900,300,0.75,15,9,6,398.9888078604381,0.37012012012012013,0.23351189330957012,0.26424345612394773,135871.14334106448,3442.2131008572046,139313.3564419217,958,155,473.6216216216216,31,6,18,28.956043670121968,0.690524193548387,39.35546875,1042.5781250000002,33.63155241935485,0
962,4,1,1,37,0.02631578947368421,0.02631578947368421,0.9736842105263158,38,950,700,250,0.7368421052631579,12,7,5,389.81603592417116,0.3738738738738739,0.22947610346781433,0.2605181219874794,136193.2316377155,3018.061135343328,139211.29277305884,959,0,462.13157894736844,32,6,19,28.874339744365148,0.6910807291666667,39.04671717171717,1043.813131313131,32.61916035353534,0
963,4,0,0,37,0.0,0.0,1.0,37,750,500,250,0.6666666666666666,10,5,5,398.1336082017848,0.36965090090090086,0.2342814547981149,0.2651907400266752,136074.84817504886,3435.1940578884546,139510.04223293733,960,157,475.6216216216216,31,6,19,28.77524543450226,0.6925403225806452,39.16015625,1043.3593750000002,33.65675403225807,0
964,4,0,0,37,0.0,0.0,1.0,37,800,500,300,0.625,11,5,6,398.11475413409613,0.3697447447447448,0.2348053069290903,0.26543191677459615,136108.81381564666,3437.3853895399257,139546.1992051866,961,158,476.6216216216216,31,6,19,28.74188919391066,0.6928763440860215,39.127604166666664,1043.489583333333,33.66095430107526,0
965,4,0,0,37,0.0,0.0,1.0,37,950,500,450,0.5263157894736842,14,5,9,396.5925421450031,0.36986986986986986,0.236775496034755,0.2656871842490209,136278.70559692386,3409.4236585828994,139688.12925550676,962,159,477.6216216216216,31,6,20,28.612384129359427,0.6945564516129032,38.96484375,1044.1406250000002,33.681955645161295,0
966,4,0,0,37,0.0,0.0,1.0,37,850,700,150,0.8235294117647058,10,7,3,400.983374965738,0.3695883383383383,0.23865171415962871,0.26966384051551706,136414.69531589095,3540.0049845377716,139954.70030042873,963,160,478.6216216216216,31,6,21,28.362338485188417,0.6959005376344086,38.83463541666667,1044.6614583333342,33.69875672043013,0
967,4,0,0,37,0.0,0.0,1.0,37,550,300,250,0.5454545454545454,8,3,5,399.95047245219524,0.3685247747747748,0.2350469083586446,0.2697481085631362,136516.73210991765,3519.9863009982746,140036.71841091593,964,161,479.6216216216216,31,6,21,28.28775230500871,0.6969086021505376,38.73697916666667,1045.0520833333342,33.71135752688175,0
968,4,0,0,37,0.0,0.0,1.0,37,900,700,200,0.7777777777777778,11,7,4,403.90993906275185,0.3683058058058058,0.24092394798584826,0.27320917445112347,136618.80705091698,3636.338806152354,140255.14585706932,965,162,480.6216216216216,31,6,21,28.08270540125379,0.6979166666666666,38.63932291666667,1045.4427083333342,33.72395833333336,0
969,4,0,0,37,0.0,0.0,1.0,37,650,400,250,0.6153846153846154,9,4,5,403.90993906275185,0.3683058058058058,0.24092394798584826,0.27320917445112347,136618.80705091698,3636.338806152354,140255.14585706932,966,163,481.6216216216216,31,6,21,28.08270540125379,0.6979166666666666,38.63932291666667,1045.4427083333342,33.72395833333336,0
970,4,0,0,37,0.0,0.0,1.0,37,1050,600,450,0.5714285714285714,15,6,9,403.35229247229125,0.3673986486486487,0.2357851170800811,0.2744487976052723,136826.36721008207,3637.883923941085,140464.25113402316,967,164,482.6216216216216,30,7,21,27.8908123501199,0.7027777777777778,38.44086021505376,1046.2365591397847,34.874551971326156,0
971,4,0,0,37,0.0,0.0,1.0,37,1450,1200,250,0.8275862068965517,17,12,5,399.9854881896216,0.36608483483483484,0.23908058344485306,0.2729272796322729,136925.26075575073,3553.623453776022,140478.88420952676,968,165,483.6216216216216,31,6,21,27.880588040142644,0.7009408602150538,38.34635416666666,1046.6145833333321,33.76176075268813,0
972,4,0,0,37,0.0,0.0,1.0,37,900,600,300,0.6666666666666666,12,6,6,397.863789763818,0.36586586586586584,0.23694780466326315,0.27227427519071135,137027.4882846407,3503.655158148851,140531.14344278956,969,166,484.6216216216216,31,6,18,27.834561414417774,0.7019489247311829,38.24869791666666,1047.0052083333321,33.77436155913975,0
973,4,0,0,37,0.0,0.0,1.0,37,950,700,250,0.7368421052631579,12,7,5,396.1408354504053,0.36567817817817816,0.2364025668016989,0.27127959937161084,137051.24357527273,3458.318825885089,140509.56240115783,970,167,485.6216216216216,32,5,18,27.85607339523292,0.6995442708333334,38.22601010101009,1047.095959595958,32.72174873737369,0
974,4,1,0,38,0.02631578947368421,0.0,1.0,38,600,300,300,0.5,9,3,6,385.805328125742,0.36959163110478904,0.227798455812237,0.2668200955631141,137394.61873137724,3001.515192474033,140396.13392385127,971,0,473.8157894736842,33,5,19,27.78626047145919,0.7004419191919192,37.89828431372548,1048.406862745097,31.769904931669604,0
975,4,0,0,38,0.0,0.0,1.0,38,550,300,250,0.5454545454545454,8,3,5,386.8100183571821,0.36931009957325744,0.22946039713589728,0.26776266319288416,137426.740916955,3031.6080353710095,140458.348952326,972,1,474.8157894736842,33,5,19,27.72810503350476,0.7007575757575758,37.86764705882353,1048.5294117647056,31.773618538324413,0
976,4,0,0,38,0.0,0.0,1.0,38,350,300,50,0.8571428571428571,4,3,1,386.8100183571821,0.36931009957325744,0.22946039713589728,0.26776266319288416,137426.740916955,3031.6080353710095,140458.348952326,973,2,475.8157894736842,33,5,19,27.72810503350476,0.7007575757575758,37.86764705882353,1048.5294117647056,31.773618538324413,0
977,4,0,0,38,0.0,0.0,1.0,38,1050,700,350,0.6666666666666666,14,7,7,387.5546519904498,0.36936936936936937,0.23256221521205744,0.26902516353497646,137523.13000108127,3059.5457576412873,140582.67575872256,974,3,476.8157894736842,33,5,19,27.613111928963654,0.7017045454545455,37.775735294117645,1048.897058823529,31.78475935828876,0
978,4,0,0,38,0.0,0.0,1.0,38,800,500,300,0.625,11,5,6,387.5731504934932,0.3692063774300616,0.23589522872602098,0.2692878383298943,137555.267204921,3062.545655517088,140617.81286043808,975,4,477.8157894736842,33,5,19,27.58080218068535,0.7020202020202021,37.74509803921568,1049.0196078431359,31.788472964943512,0
979,4,0,0,38,0.0,0.0,1.0,38,750,600,150,0.8,9,6,3,391.32685513561216,0.3685840445708867,0.24287249604442218,0.27269140142453907,137656.29428854867,3173.7209467120074,140830.01523526068,976,5,478.8157894736842,34,4,19,27.38230289279637,0.7006740196078431,37.64880952380952,1049.4047619047612,30.864845938375332,0
980,4,0,0,38,0.0,0.0,1.0,38,1100,700,400,0.6363636363636364,15,7,8,396.50125057922105,0.3680506164058796,0.24644457839234724,0.277299328220313,137781.25177154178,3326.087726757355,141107.33949829914,977,6,479.8157894736842,34,4,19,27.122784140303143,0.7018995098039216,37.5297619047619,1049.8809523809512,30.87885154061621,0
981,4,0,0,38,0.0,0.0,1.0,38,850,600,250,0.7058823529411765,11,6,5,399.205316368081,0.36707266477003314,0.2507928014929457,0.27999913754999506,137880.86785210512,3408.565723652748,141289.43357575787,978,7,480.8157894736842,31,7,19,26.953157285726082,0.7103494623655914,37.434895833333336,1050.2604166666672,33.87936827956991,0
982,4,0,0,38,0.0,0.0,1.0,38,650,500,150,0.7692307692307693,8,5,3,398.64827372601513,0.36714675201517305,0.24857933230249296,0.27988647729745547,137915.0581359863,3395.919969346787,141310.97810533308,979,8,481.8157894736842,31,7,20,26.933933515144005,0.7106854838709677,37.40234375,1050.3906249999998,33.88356854838709,0
983,4,0,0,38,0.0,0.0,1.0,38,1250,900,350,0.72,16,9,7,396.972343065041,0.36652441915599815,0.25504668509728234,0.28010146444239614,138086.07313368068,3363.270399305576,141449.34353298624,980,9,482.8157894736842,31,7,18,26.808721506442023,0.7123655913978494,37.23958333333334,1051.0416666666677,33.90456989247315,0
984,4,0,0,38,0.0,0.0,1.0,38,850,600,250,0.7058823529411765,11,6,5,394.7614060678139,0.36557610241820765,0.2534996480800811,0.2796572908248829,138222.96142578125,3313.018120659722,141535.97954644097,981,10,483.8157894736842,31,7,18,26.731467723295363,0.7137096774193548,37.109375,1051.5625,33.921370967741936,0
985,4,0,0,38,0.0,0.0,1.0,38,800,600,200,0.75,10,6,4,394.33330727245215,0.365383475580844,0.2508289848274605,0.2801951441912173,138325.6721496582,3309.2839558919277,141634.95610555014,982,11,484.8157894736842,31,7,18,26.64121487807898,0.7147177419354838,37.01171875,1051.953125,33.93397177419355,0
986,4,0,0,38,0.0,0.0,1.0,38,400,100,300,0.25,7,1,6,394.2750710714634,0.36557610241820765,0.25362167795726864,0.2804350857620973,138359.91753472234,3310.3732638888996,141670.29079861124,983,12,485.8157894736842,31,7,18,26.6089108910891,0.7150537634408602,36.97916666666667,1052.0833333333342,33.93817204301078,0
987,4,0,0,38,0.0,0.0,1.0,38,1000,900,100,0.9,11,9,2,396.636651995835,0.36584281650071127,0.2500358170854007,0.28268231229544444,138428.42102050793,3381.1570909288353,141809.57811143677,984,13,486.8157894736842,31,7,18,26.47910995628146,0.7157258064516128,36.91406250000001,1052.343750000001,33.94657258064519,0
988,4,0,0,38,0.0,0.0,1.0,38,700,500,200,0.7142857142857143,9,5,4,394.34048362981923,0.3649834044570887,0.24807659762812895,0.28218027881687785,138565.4788547093,3328.3955891927194,141893.87444390202,985,14,487.8157894736842,31,7,19,26.404175941957288,0.7170698924731183,36.78385416666667,1052.8645833333342,33.963373655914005,0
989,4,0,0,38,0.0,0.0,1.0,38,1150,800,350,0.6956521739130435,15,8,7,395.0119408563173,0.36510194404931245,0.24553594669165468,0.28323196610335977,138634.0332031252,3352.419704861142,141986.45290798636,986,15,488.8157894736842,31,7,20,26.318826244642278,0.7177419354838708,36.718750000000014,1053.1250000000016,33.97177419354844,0
990,4,0,0,38,0.0,0.0,1.0,38,1000,800,200,0.8,12,8,4,396.72428388849164,0.3644203413940256,0.24682720891959198,0.2853241049726034,138736.8965148927,3408.0591837565257,142144.95569864922,987,16,489.8157894736842,31,7,20,26.17221295266345,0.71875,36.62109375000001,1053.515625000001,33.98437500000003,0
991,4,0,0,38,0.0,0.0,1.0,38,650,400,250,0.6153846153846154,9,4,5,397.482827855343,0.3638276434329066,0.2502406535369561,0.28615934546311717,138771.1927625869,3431.8332248263987,142203.0259874133,988,17,490.8157894736842,31,7,20,26.11838853188334,0.7190860215053763,36.58854166666667,1053.6458333333342,33.98857526881723,0
992,4,0,0,38,0.0,0.0,1.0,38,1050,800,250,0.7619047619047619,13,8,5,395.72560108734694,0.3630423186344239,0.24453921364676479,0.2860530773574253,138908.42013888902,3393.9236111111322,142302.34375000015,989,18,491.8157894736842,32,6,20,26.029314888010546,0.7177734375,36.45833333333334,1054.1666666666679,32.94270833333337,0
993,4,0,0,38,0.0,0.0,1.0,38,800,500,300,0.625,11,5,6,382.9789201183433,0.36252370791844474,0.23005440283400835,0.2691203222453222,137945.10764207726,2970.353949852048,140915.4615919293,990,19,492.8157894736842,32,6,19,27.315705128205135,0.7083333333333334,37.37373737373737,1050.50505050505,32.82828282828281,2
994,4,0,0,38,0.0,0.0,1.0,38,1200,800,400,0.6666666666666666,16,8,8,381.4690567138285,0.361768018018018,0.228463294485161,0.26883716841906824,138044.60522204367,2931.949067697168,140976.55428974083,991,20,493.8157894736842,32,6,16,27.25704874043813,0.7093098958333334,37.2790404040404,1050.8838383838383,32.84011994949495,0
995,4,0,0,38,0.0,0.0,1.0,38,950,600,350,0.631578947368421,13,6,7,379.83122679213506,0.3603751778093884,0.22222256305176025,0.26863743566774323,138166.58744533343,2895.996882208753,141062.58432754216,992,21,494.8157894736842,33,5,16,27.179619808058437,0.7080176767676768,37.162990196078425,1051.3480392156855,31.85903149138441,0
996,4,0,0,38,0.0,0.0,1.0,38,1250,900,350,0.72,16,9,7,379.4730726679509,0.36030109056424847,0.22276179487504555,0.262095295281974,137348.8754336292,2826.026122834233,140174.90155646345,993,22,495.8157894736842,32,6,18,27.997520677748327,0.7024739583333334,37.94191919191919,1048.232323232323,32.7572601010101,2
997,4,0,0,38,0.0,0.0,1.0,38,1000,800,200,0.8,12,8,4,378.8079470198677,0.3600788288288288,0.22122690833042857,0.2623853211009174,137448.15779320986,2813.2908950617266,140261.44868827157,994,23,496.8157894736842,32,6,19,27.91666666666667,0.7034505208333334,37.84722222222222,1048.611111111111,32.76909722222222,0
998,4,0,0,38,0.0,0.0,1.0,38,550,200,350,0.36363636363636365,9,2,7,379.09288287881395,0.35976766239924135,0.224549152800132,0.26283351295420937,137481.25988419537,2823.633430262208,140304.8933144576,995,24,497.8157894736842,32,6,19,27.876434705835145,0.7037760416666667,37.81565656565656,1048.737373737373,32.773042929292906,0
999,4,0,0,38,0.0,0.0,1.0,38,850,500,350,0.5882352941176471,12,5,7,379.09288287881395,0.35976766239924135,0.224549152800132,0.26283351295420937,137481.25988419537,2823.633430262208,140304.8933144576,996,25,498.8157894736842,32,6,19,27.876434705835145,0.7037760416666667,37.81565656565656,1048.737373737373,32.773042929292906,0
1000,4,0,0,38,0.0,0.0,1.0,38,650,400,250,0.6153846153846154,9,4,5,377.10837382812736,0.35929350403034616,0.22471048830550133,0.2619578904485019,137547.47602285483,2774.061001428427,140321.53702428326,997,26,499.8157894736842,32,6,20,27.862953378269953,0.7044270833333334,37.75252525252525,1048.989898989899,32.780934343434346,0
1001,4,0,0,38,0.0,0.0,1.0,38,950,700,250,0.7368421052631579,12,7,5,378.40969257273485,0.3583303698435278,0.22491949162958802,0.2639007009114739,137683.8535659361,2820.180940023059,140504.03450595916,998,27,500.8157894736842,33,5,20,27.693931963257047,0.7032828282828283,37.62254901960784,1049.509803921568,31.803327391562664,0
1002,4,0,0,38,0.0,0.0,1.0,38,600,300,300,0.5,9,3,6,376.4915728049197,0.3586711711711712,0.22393154515009073,0.2628076871291067,137716.00954260386,2769.7834066224564,140485.7929492263,999,28,501.8157894736842,33,5,20,27.712468379062067,0.7035984848484849,37.591911764705884,1049.6323529411768,31.807040998217477,0
1003,4,0,0,38,0.0,0.0,1.0,38,700,300,400,0.42857142857142855,11,3,8,376.4915728049197,0.3586711711711712,0.22393154515009073,0.2628076871291067,137716.00954260386,2769.7834066224564,140485.7929492263,1000,29,502.8157894736842,33,5,20,27.712468379062067,0.7035984848484849,37.591911764705884,1049.6323529411768,31.807040998217477,0
1004,4,0,0,38,0.0,0.0,1.0,38,900,500,400,0.5555555555555556,13,5,8,375.9010319839725,0.3576635846372689,0.22574878340494697,0.2633840676504379,137845.64593217528,2763.297903170356,140608.94383534562,1001,30,503.8157894736842,32,6,20,27.599845697567225,0.7073567708333334,37.46843434343434,1050.1262626262626,32.816445707070706,0
1005,4,0,0,38,0.0,0.0,1.0,38,1350,800,550,0.5925925925925926,19,8,11,375.4381974831768,0.3576635846372689,0.224263170549601,0.26331323159064624,137878.79584991324,2752.9933170084655,140631.7891669217,1002,31,504.8157894736842,32,6,21,27.579245812294626,0.7076822916666667,37.436868686868685,1050.252525252525,32.820391414141405,0
1006,4,0,0,38,0.0,0.0,1.0,38,1150,900,250,0.782608695652174,14,9,5,377.89360364991853,0.35707088667614983,0.23022046825788323,0.2660601158692574,138011.4353764922,2830.7277318641,140842.16310835633,1003,32,505.8157894736842,32,6,21,27.383741888969002,0.708984375,37.31060606060606,1050.757575757576,32.83617424242425,0
1007,4,0,0,38,0.0,0.0,1.0,38,1450,1000,450,0.6896551724137931,19,10,9,371.93351980800435,0.35707088667614983,0.22385633414932693,0.24604832848837221,135831.0376492195,2504.0231864095585,138335.06083562906,1004,33,506.8157894736842,32,6,22,29.701126453488367,0.6875,39.3939393939394,1042.4242424242427,32.575757575757585,4
1008,4,0,0,38,0.0,0.0,1.0,38,750,400,350,0.5333333333333333,11,4,7,372.2041539850591,0.35704125177809387,0.22696332742731062,0.24668233576313184,135896.85523160922,2516.274806142251,138413.13003775149,1005,34,507.8157894736842,32,6,17,29.628592475982867,0.6881510416666666,39.33080808080809,1042.6767676767693,32.58364898989904,0
1009,4,0,0,38,0.0,0.0,1.0,38,750,500,250,0.6666666666666666,10,5,5,372.9630087521997,0.3567597202465624,0.22735962681859023,0.2474137742397123,135929.77000114793,2539.3551997245286,138469.12520087246,1006,35,508.8157894736842,32,6,17,29.576068531299192,0.6884765625,39.29924242424243,1042.803030303031,32.58759469696972,0
1010,4,0,0,38,0.0,0.0,1.0,38,1300,1000,300,0.7692307692307693,16,10,6,374.008179721787,0.3556039592223803,0.2293674689484193,0.24893914260919264,136048.87730980874,2576.6785911668644,138625.5559009756,1007,36,509.8157894736842,33,5,18,29.43035651356748,0.6871843434343434,39.185049019607845,1043.2598039215688,31.61393345216875,0
1011,4,0,0,38,0.0,0.0,1.0,38,1050,500,550,0.47619047619047616,16,5,11,371.92317491250583,0.3557965860597439,0.22669164101232675,0.24777417145579608,136080.84180363326,2522.3237456747433,138603.165549308,1008,37,510.8157894736842,33,5,18,29.452959830866817,0.6875,39.154411764705884,1043.3823529411766,31.617647058823533,0
1012,4,0,0,38,0.0,0.0,1.0,38,1000,800,200,0.8,12,8,4,370.2775048807086,0.3560929350403035,0.22575461669674435,0.24712251031066723,136144.78205497886,2482.2700403690897,138627.05209534796,1009,38,511.8157894736842,33,5,19,29.43234304055112,0.6881313131313131,39.09313725490196,1043.6274509803923,31.625074272133098,0
1013,4,0,0,38,0.0,0.0,1.0,38,700,400,300,0.5714285714285714,10,4,6,374.8374440697392,0.35544096728307256,0.23102297998517374,0.25107036348067435,136272.70761245672,2616.0226835832336,138888.73029603995,1010,39,512.8157894736842,33,5,19,29.186228482003134,0.6893939393939394,38.970588235294116,1044.1176470588234,31.639928698752225,0
1014,4,0,0,38,0.0,0.0,1.0,38,800,500,300,0.625,11,5,6,376.9569608040601,0.3547741820768136,0.2320315925328984,0.2531760580719467,136368.69120350343,2681.0254769800003,139049.71668048343,1011,40,513.8157894736842,33,5,19,29.035526418710155,0.6903409090909092,38.87867647058823,1044.4852941176468,31.65106951871657,0
1015,4,0,0,38,0.0,0.0,1.0,38,1100,800,300,0.7272727272727273,14,8,6,374.82071877606825,0.3543296586059744,0.23319339404229034,0.2521978395868967,136432.69903702897,2627.560463523635,139060.2595005526,1012,41,514.8157894736842,33,5,19,29.02773704789834,0.6909722222222223,38.81740196078431,1044.7303921568623,31.65849673202613,0
1016,4,0,0,38,0.0,0.0,1.0,38,800,400,400,0.5,12,4,8,372.3299532583873,0.3541370317686107,0.22847857887947276,0.2509768783742503,136496.7218888167,2564.363616157236,139061.08550497395,1013,42,515.8157894736842,33,5,19,29.029235565458734,0.6916035353535354,38.75612745098039,1044.9754901960778,31.66592394533569,0
1017,4,0,0,38,0.0,0.0,1.0,38,700,400,300,0.5714285714285714,10,4,6,373.6100020752905,0.35418148411569467,0.22759918553711356,0.2525272042553271,136592.78432574007,2606.486087081891,139199.27041282196,1014,43,516.8157894736842,33,5,19,28.900449394294654,0.6925505050505051,38.66421568627451,1045.3431372549019,31.677064765300056,0
1018,4,0,0,38,0.0,0.0,1.0,38,550,300,250,0.5454545454545454,8,3,5,365.5134880089075,0.35392958748221903,0.19106285431058523,0.23940147113613483,135474.15845167718,2303.526438148786,137777.68488982596,1015,44,517.8157894736842,33,5,22,30.223538355895627,0.6815025252525253,39.736519607843135,1041.0539215686272,31.54708853238264,2
1019,4,0,0,38,0.0,0.0,1.0,38,1000,800,200,0.8,12,8,4,366.7543869595006,0.3534850640113798,0.19678166471597258,0.2410708070200152,135601.76862564884,2346.508704584782,137948.27733023363,1016,45,518.8157894736842,33,5,22,30.064198729262262,0.6827651515151516,39.6139705882353,1041.5441176470592,31.561942959001794,0
1020,4,0,0,38,0.0,0.0,1.0,38,1400,1200,200,0.8571428571428571,16,12,4,364.0005909184477,0.353366524419156,0.18586938356121996,0.24011613844682392,135729.43887266915,2281.11919093618,138010.55806360533,1017,46,519.8157894736842,33,5,22,30.008893919793017,0.6840277777777778,39.49142156862745,1042.0343137254902,31.576797385620914,0
1021,4,0,0,38,0.0,0.0,1.0,38,1150,700,450,0.6086956521739131,16,7,9,367.2530178653584,0.3534850640113798,0.19296905443771584,0.2435663233839701,135921.05688016638,2383.483666138033,138304.5405463044,1018,47,520.8157894736842,33,5,19,29.733590903748965,0.6859217171717171,39.30759803921569,1042.769607843138,31.599079025549635,0
1022,4,0,0,38,0.0,0.0,1.0,38,1000,700,300,0.7,13,7,6,369.37158706501685,0.35243302513039354,0.1909610177664034,0.24607431081937034,136080.84180363326,2452.8793012302995,138533.72110486357,1019,48,521.8157894736842,33,5,19,29.519516874168044,0.6875,39.154411764705884,1043.3823529411766,31.617647058823533,0
1023,4,0,0,38,0.0,0.0,1.0,38,650,300,350,0.46153846153846156,10,3,7,370.2775048807086,0.35216631104789003,0.1873006847791152,0.2471225103106673,136144.78205497886,2482.2700403690906,138627.05209534796,1020,49,522.8157894736842,33,5,19,29.43234304055112,0.6881313131313131,39.09313725490196,1043.6274509803923,31.625074272133098,0
1024,4,0,0,38,0.0,0.0,1.0,38,850,500,350,0.5882352941176471,12,5,7,372.68811057533367,0.3513661688003793,0.19516797509558437,0.249856442975013,136304.69838824004,2559.8281009707753,138864.5264892108,1021,50,523.8157894736842,33,5,21,29.210553338809998,0.689709595959596,38.939950980392155,1044.240196078431,31.643642305407,0
1025,4,0,0,38,0.0,0.0,1.0,38,850,600,250,0.7058823529411765,11,6,5,375.7343111155936,0.35084755808440016,0.19241028427474105,0.2525835384818075,136400.69324298337,2650.08410226835,139050.77734525173,1022,51,524.8157894736842,33,5,21,29.035664007508213,0.6906565656565657,38.84803921568627,1044.6078431372543,31.654783125371345,0
1026,4,0,0,38,0.0,0.0,1.0,38,1100,800,300,0.7272727272727273,14,8,6,379.1803919995735,0.35084755808440016,0.18542159574003203,0.234891247975636,133440.56560277307,2519.6091947808654,135960.17479755395,1023,52,525.8157894736842,33,5,21,31.90297216621199,0.661300505050505,41.69730392156863,1033.2107843137262,31.30941770647655,7
1027,4,0,0,38,0.0,0.0,1.0,38,950,700,250,0.7368421052631579,12,7,5,374.7216335756812,0.35065493124703656,0.18183805470186587,0.23273682036802174,133537.46588358335,2407.879226456182,135945.34511003955,1024,53,526.8157894736842,32,6,21,31.920860819284954,0.6647135416666666,41.60353535353536,1033.585858585859,32.29955808080809,0
1028,4,0,0,38,0.0,0.0,1.0,38,600,400,200,0.6666666666666666,8,4,4,375.94981941544324,0.3502252252252252,0.1779633783445056,0.23411810427323676,133635.36126734508,2448.0379871951777,136083.39925454027,1025,54,527.8157894736842,32,6,21,31.790867830829978,0.6656901041666667,41.50883838383838,1033.964646464646,32.311395202020186,0
1029,4,0,0,38,0.0,0.0,1.0,38,700,400,300,0.5714285714285714,10,4,6,377.0849108695984,0.3501363205310574,0.18363229851973673,0.23544813946979784,133733.29252117118,2485.761338128744,136219.05385929992,1026,55,528.8157894736842,32,6,18,31.6632588704427,0.6666666666666667,41.414141414141405,1034.3434343434333,32.32323232323229,0
1030,4,0,0,38,0.0,0.0,1.0,38,900,700,200,0.7777777777777778,11,7,4,376.1705007077293,0.3489509246088194,0.18250227558947074,0.2352319531092332,133788.99491781997,2465.494641484029,136254.489559304,1027,56,529.8157894736842,33,5,18,31.63103135118059,0.6647727272727273,41.36029411764705,1034.558823529411,31.35026737967912,0
1031,4,0,0,38,0.0,0.0,1.0,38,900,700,200,0.7777777777777778,11,7,4,372.67987940484414,0.34844713134186817,0.17736991626794296,0.23425592419733046,133979.23875432517,2386.2733083429375,136365.5120626681,1028,57,530.8157894736842,33,5,18,31.53063841540405,0.6666666666666667,41.17647058823529,1035.294117647058,31.37254901960782,0
1032,4,0,0,38,0.0,0.0,1.0,38,950,700,250,0.7368421052631579,12,7,5,369.8346615928635,0.34778034613560926,0.17353598764394107,0.23307030015818694,134074.4113592127,2317.0729106593503,136391.48426987207,1029,58,531.8157894736842,33,5,18,31.508968366662717,0.6676136363636365,41.084558823529406,1035.6617647058815,31.383689839572167,0
1033,4,0,0,38,0.0,0.0,1.0,38,950,900,50,0.9473684210526315,10,9,1,370.3717491540514,0.34712837837837834,0.17789697833842877,0.23381272558619845,134137.87853529892,2336.176140186467,136474.0546754854,1030,59,532.8157894736842,33,5,19,31.431518395835806,0.6682449494949495,41.02328431372549,1035.906862745098,31.391117052881754,0
1034,4,0,0,38,0.0,0.0,1.0,38,1000,800,200,0.8,12,8,4,375.850527374241,0.34712837837837834,0.1453250487892368,0.22865340938009873,132765.8180980726,2380.020549886631,135145.83864795923,1031,60,533.8157894736842,34,4,16,32.66744638250356,0.652267156862745,42.35119047619048,1030.5952380952385,30.311624649859958,7
1035,4,0,0,38,0.0,0.0,1.0,38,1150,700,450,0.6086956521739131,16,7,9,376.7502075563022,0.346743124703651,0.14616777455066887,0.2301417699472982,132919.2247732426,2415.4691043083835,135334.69387755098,1032,61,534.8157894736842,34,4,16,32.48985030400985,0.6537990196078431,42.20238095238095,1031.190476190476,30.329131652661058,0
1036,4,1,1,38,0.02564102564102564,0.02564102564102564,0.9743589743589743,39,1250,900,350,0.72,16,9,7,370.49633022170616,0.35250787224471436,0.1514665563085198,0.22860084773430583,133292.88435570992,2076.9048996913602,135369.78925540127,1033,0,522.0769230769231,35,4,16,32.275554808338946,0.6553571428571427,41.84027777777778,1032.6388888888891,29.50396825396826,0
1037,4,0,0,38,0.0,0.0,1.0,38,1000,700,300,0.7,13,7,6,378.59556347675505,0.3463282361308677,0.1590629115160782,0.23337308614313435,133257.03125000012,2490.104166666681,135747.1354166668,1034,63,536.8157894736842,34,4,17,32.102502017756244,0.6571691176470588,41.87500000000001,1032.500000000001,30.367647058823557,0
1038,4,0,0,38,0.0,0.0,1.0,38,850,500,350,0.5882352941176471,12,5,7,378.59556347675505,0.3463282361308677,0.1590629115160782,0.23337308614313435,133257.03125000012,2490.104166666681,135747.1354166668,1035,64,537.8157894736842,34,4,17,32.102502017756244,0.6571691176470588,41.87500000000001,1032.500000000001,30.367647058823557,0
1039,4,0,0,38,0.0,0.0,1.0,38,1450,1100,350,0.7586206896551724,18,11,7,374.387831376237,0.34517247510668564,0.16953515174798284,0.22788268205094933,132785.41512613586,2387.093165937911,135172.50829207376,1036,65,538.8157894736842,35,3,17,32.68540613887328,0.6502976190476191,42.33217592592592,1030.6712962962954,29.447751322751298,7
1040,4,0,0,38,0.0,0.0,1.0,38,600,200,400,0.3333333333333333,10,2,8,372.0696058032933,0.34468349928876246,0.1619005979249879,0.22701342797915985,132874.8981910149,2287.7421982167143,135162.64038923162,1037,66,539.8157894736842,35,3,18,32.65510402634335,0.6511904761904763,42.24537037037036,1031.0185185185169,29.45767195767191,0
1041,4,0,0,38,0.0,0.0,1.0,38,850,600,250,0.7058823529411765,11,6,5,370.6968676665647,0.3446538643907065,0.15773524720893128,0.22653697468512274,132934.5703124999,2255.685763888875,135190.2560763888,1038,67,540.8157894736842,35,3,18,32.63047138047137,0.6517857142857144,42.18749999999999,1031.2499999999993,29.464285714285694,0
1042,4,0,0,38,0.0,0.0,1.0,38,900,500,400,0.5555555555555556,13,5,8,370.7790580235474,0.34391299193930774,0.1632263854610725,0.22731255317894752,133053.9547432268,2266.724001200246,135320.67874442704,1039,68,541.8157894736842,35,3,20,32.50832024530701,0.6529761904761906,42.071759259259245,1031.712962962961,29.47751322751317,0
1043,4,0,0,38,0.0,0.0,1.0,38,750,300,450,0.4,12,3,9,368.75660782366356,0.3442389758179232,0.15978919040143547,0.22679802955665015,133173.39275763018,2221.7137131344175,135395.1064707646,1040,69,542.8157894736842,35,3,20,32.4404761904762,0.6541666666666668,41.95601851851851,1032.175925925925,29.490740740740712,0
1044,4,0,0,38,0.0,0.0,1.0,38,1150,800,350,0.6956521739130435,15,8,7,366.75679527420823,0.34417970602181125,0.16032783404212614,0.22647549371846087,133322.7656276791,2179.4060517403886,135502.1716794195,1041,70,543.8157894736842,35,3,20,32.34209813590347,0.6556547619047619,41.81134259259259,1032.754629629629,29.50727513227512,0
1045,4,0,0,38,0.0,0.0,1.0,38,1150,700,450,0.6086956521739131,16,7,9,367.50103281245845,0.34468349928876246,0.16068061525776223,0.22803977597176187,133502.97796201805,2212.580181410264,135715.55814342832,1042,71,544.8157894736842,34,4,20,32.14203432784243,0.6596200980392157,41.63690476190476,1033.4523809523803,30.395658263305304,0
1046,4,0,0,38,0.0,0.0,1.0,38,1150,1000,150,0.8695652173913043,13,10,3,367.5715757807546,0.3453354670459934,0.15850969082658284,0.22922428419292268,133687.58680555547,2227.9513888888787,135915.53819444435,1043,72,545.8157894736842,34,4,20,31.95507655116843,0.6614583333333334,41.45833333333333,1034.166666666666,30.41666666666665,0
1047,4,0,0,38,0.0,0.0,1.0,38,700,500,200,0.7142857142857143,9,5,4,364.8804471177398,0.3448909435751541,0.1586102719033231,0.22787816603013533,133741.45507812488,2159.928385416652,135901.38346354154,1044,73,546.8157894736842,35,3,18,31.970669687814695,0.6598214285714286,41.40624999999999,1034.374999999999,29.553571428571402,0
1048,4,0,0,38,0.0,0.0,1.0,38,750,400,350,0.5333333333333333,11,4,7,363.6309094814376,0.34438715030820294,0.15233954110020553,0.2274665290311106,133801.32144043632,2130.8592410408028,135932.18068147713,1045,74,547.8157894736842,35,3,18,31.943007234217102,0.6604166666666667,41.348379629629626,1034.606481481481,29.560185185185173,0
1049,4,0,0,38,0.0,0.0,1.0,38,1250,900,350,0.72,16,9,7,361.97000777647287,0.34502430061640593,0.15266924018453998,0.22734970151353742,133951.04595336074,2097.25222908093,136048.29818244168,1046,75,548.8157894736842,35,3,18,31.836053965414425,0.6619047619047619,41.2037037037037,1035.185185185185,29.576719576719572,0
1050,4,1,1,38,0.02564102564102564,0.02564102564102564,0.9743589743589743,39,950,700,250,0.7368421052631579,12,7,5,353.79722600365767,0.3497244714349978,0.1551054979284905,0.22408780942268802,134258.85080604232,1700.081796323328,135958.93260236565,1047,0,535.7179487179487,36,3,18,31.739876489550507,0.6629050925925927,40.90653153153152,1036.3738738738723,28.78816316316312,0
1051,4,0,0,38,0.0,0.0,1.0,38,950,700,250,0.7368421052631579,12,7,5,363.1448374802819,0.34438715030820294,0.16324844621888768,0.2293937501966126,134160.80092860496,2143.960449888527,136304.76137849348,1048,77,550.8157894736842,35,3,18,31.595748147320585,0.6639880952380952,41.0011574074074,1035.995370370369,29.59986772486769,0
1052,4,0,0,38,0.0,0.0,1.0,38,950,600,350,0.631578947368421,13,6,7,359.6422268682526,0.34377963489805596,0.15997508286124007,0.22811301585212942,134310.72638031538,2060.761745541823,136371.4881258572,1049,78,551.8157894736842,35,3,18,31.536586273634054,0.6654761904761906,40.856481481481474,1036.574074074073,29.616402116402085,0
1053,4,0,0,38,0.0,0.0,1.0,38,800,600,200,0.75,10,6,4,359.9876000931345,0.3439574442863917,0.16090880248175754,0.2287070157187442,134370.72000385777,2074.3586033950396,136445.0786072528,1050,79,552.8157894736842,35,3,19,31.46768251841931,0.6660714285714286,40.7986111111111,1036.8055555555536,29.623015873015817,0
1054,4,1,1,38,0.02564102564102564,0.02564102564102564,0.9743589743589743,39,800,500,300,0.625,11,5,6,351.6469310860783,0.35017431399010346,0.15305684723485302,0.22488347960897132,134610.82845721874,1667.2175068587046,136278.04596407744,1051,0,539.6153846153846,35,4,19,31.44425236077032,0.668452380952381,40.567129629629626,1037.731481481481,29.649470899470888,0
1055,4,0,0,38,0.0,0.0,1.0,38,500,300,200,0.6,7,3,4,361.7270643494873,0.3435573731626363,0.1630486494106036,0.2303792625185326,134460.73555652,2127.6174286265323,136588.35298514654,1052,81,554.8157894736842,35,3,19,31.33264981586876,0.6669642857142857,40.71180555555555,1037.1527777777771,29.63293650793649,0
1056,4,0,0,38,0.0,0.0,1.0,38,950,700,250,0.7368421052631579,12,7,5,361.80500547488947,0.3433795637743006,0.1688063090263514,0.23119445951020065,134581.66099773246,2138.4938596387633,136720.1548573712,1053,82,555.8157894736842,34,4,19,31.20984396512161,0.6703431372549019,40.595238095238095,1037.6190476190477,30.518207282913167,0
1057,4,0,0,38,0.0,0.0,1.0,38,1250,900,350,0.72,16,9,7,363.7916389928298,0.3436907302038881,0.17226444365300186,0.2330565246420636,134674.3214994332,2198.6784297052286,136872.99992913843,1054,83,556.8157894736842,34,4,19,31.065775891730702,0.6712622549019608,40.50595238095239,1037.9761904761913,30.52871148459386,0
1058,4,0,0,38,0.0,0.0,1.0,38,1400,1100,300,0.7857142857142857,17,11,6,359.5032943635384,0.3430683973447131,0.1679577209874754,0.23129105752415258,134828.82653061225,2094.2814625850287,136923.10799319728,1055,84,557.8157894736842,34,4,17,31.02289660706097,0.6727941176470589,40.357142857142854,1038.5714285714284,30.546218487394952,0
1059,4,0,0,38,0.0,0.0,1.0,38,750,700,50,0.9333333333333333,8,7,1,358.1105654307951,0.3436907302038881,0.16674306669722672,0.23078824179830998,134890.65334467115,2061.1536281179074,136951.80697278905,1056,85,558.8157894736842,34,4,18,30.99740239896095,0.6734068627450981,40.297619047619044,1038.8095238095234,30.553221288515395,0
1060,4,0,0,38,0.0,0.0,1.0,38,700,500,200,0.7142857142857143,9,5,4,357.5606314818756,0.34499466571834997,0.16808762081627449,0.23102492614398912,134983.42013888896,2052.9513888888946,137036.37152777787,1057,86,559.8157894736842,34,4,18,30.919206094627093,0.6743259803921569,40.208333333333336,1039.1666666666672,30.563725490196095,0
1061,4,0,0,38,0.0,0.0,1.0,38,950,700,250,0.7368421052631579,12,7,5,358.6469963063668,0.3457799905168326,0.1710933214378294,0.23212356743890936,135045.28238378675,2086.7169784580396,137131.9993622448,1058,87,560.8157894736842,34,4,18,30.82932462871759,0.6749387254901962,40.14880952380952,1039.404761904761,30.5707282913165,0
1062,4,1,0,39,0.02564102564102564,0.0,1.0,39,950,500,450,0.5263157894736842,14,5,9,350.5439859638878,0.3491621682411156,0.16496962436895757,0.2286930648632329,135332.4398255314,1687.9945773319446,137020.43440286332,1059,0,547.4102564102565,35,4,19,30.75407860585835,0.6755952380952381,39.872685185185176,1040.509259259258,29.728835978835942,0
1063,4,0,0,39,0.0,0.0,1.0,39,800,400,400,0.5,12,4,8,348.1931515509999,0.3485436347278452,0.16080883422148862,0.2277309826835012,135422.7768802512,1630.6566947445074,137053.4335749957,1060,1,548.4102564102565,35,4,19,30.725402164646567,0.6764880952380953,39.785879629629626,1040.8564814814813,29.738756613756607,0
1064,4,0,0,39,0.0,0.0,1.0,39,950,700,250,0.7368421052631579,12,7,5,348.0050715687878,0.3480094466936572,0.15459862502992783,0.22818175100822272,135513.1440757888,1631.8522805212672,137144.99635631006,1061,2,549.4102564102565,35,4,19,30.640469838446712,0.6773809523809524,39.699074074074076,1041.203703703704,29.748677248677254,0
1065,4,0,0,39,0.0,0.0,1.0,39,950,800,150,0.8421052631578947,11,8,3,347.7349244556206,0.34784075573549256,0.1588552574217652,0.228580466411697,135603.54141214423,1630.8174457733212,137234.35885791754,1062,3,550.4102564102565,35,4,19,30.557677704930178,0.6782738095238094,39.61226851851852,1041.550925925926,29.75859788359789,0
1066,4,0,1,38,0.0,0.02564102564102564,0.9743589743589743,39,600,400,200,0.6666666666666666,8,4,4,347.14075648004007,0.34831871345029236,0.1587163253274546,0.2289603099333189,135724.1180796683,1623.0746045524713,137347.19268422076,1063,4,551.4102564102565,35,4,19,30.453390536487838,0.6794642857142856,39.49652777777778,1042.0138888888894,29.77182539682541,0
1067,4,0,0,38,0.0,0.0,1.0,38,900,700,200,0.7777777777777778,11,7,4,352.98889588679947,0.3476173541963015,0.14926715142329594,0.23243083731417477,135664.68431122453,1977.6254251700732,137642.30973639459,1064,5,539.0,34,4,19,30.360101702662533,0.6810661764705882,39.55357142857143,1041.7857142857147,30.64075630252102,0
1068,4,0,0,38,0.0,0.0,1.0,38,950,700,250,0.7368421052631579,12,7,5,352.3796608739819,0.3469950213371266,0.15033127713045435,0.23263435530096827,135757.7168367347,1967.6516439909321,137725.36848072565,1065,6,540.0,34,4,19,30.283537049729652,0.6819852941176471,39.464285714285715,1042.1428571428573,30.651260504201687,0
1069,4,0,0,38,0.0,0.0,1.0,38,650,500,150,0.7692307692307693,8,5,3,348.455887341654,0.34637268847795166,0.1448780663693945,0.23084543580470543,135881.80980725624,1869.7633219954648,137751.57312925172,1066,7,541.0,34,4,17,30.262569460302963,0.6832107843137255,39.345238095238095,1042.6190476190475,30.665266106442573,0
1070,4,0,0,38,0.0,0.0,1.0,38,950,700,250,0.7368421052631579,12,7,5,347.7174162340234,0.3460763394973921,0.14341504446046627,0.23075792168257914,135943.8775510204,1854.010770975055,137797.88832199547,1067,8,542.0,34,4,17,30.220224505327238,0.6838235294117647,39.285714285714285,1042.857142857143,30.672268907563026,0
1071,4,0,0,38,0.0,0.0,1.0,38,400,300,100,0.75,5,3,2,347.9727430825106,0.34570590327169276,0.14341970094738077,0.23112882503001322,135974.91673752829,1863.1129535147375,137838.02969104302,1068,9,543.0,34,4,17,30.182770231708723,0.6841299019607843,39.25595238095238,1042.9761904761901,30.67577030812324,0
1072,4,0,0,38,0.0,0.0,1.0,38,750,500,250,0.6666666666666666,10,5,5,348.261264447973,0.3463282361308677,0.14280781817635968,0.2321300367214052,136099.10891439888,1879.6095521541745,137978.71846655305,1069,10,544.0,34,4,17,30.052053622361676,0.6853553921568629,39.13690476190475,1043.4523809523794,30.689775910364098,0
1073,4,0,0,38,0.0,0.0,1.0,38,800,600,200,0.75,10,6,4,348.8569083328894,0.34561699857752487,0.14009076066077597,0.23313851922734544,136192.29024943305,1902.324263038541,138094.6145124716,1070,11,545.0,34,4,17,29.94411496350365,0.6862745098039216,39.047619047619044,1043.8095238095234,30.700280112044805,0
1074,4,0,0,38,0.0,0.0,1.0,38,1350,1100,250,0.8148148148148148,16,11,5,352.07396022737765,0.34509838786154573,0.14615896242101756,0.23578761657098526,136267.37618151994,1995.2389564043021,138262.61513792424,1071,12,546.0,35,3,17,29.785708347189892,0.6848214285714287,38.975694444444436,1044.0972222222213,29.831349206349177,0
1075,4,0,1,37,0.0,0.02631578947368421,0.9736842105263158,38,950,800,150,0.8421052631578947,11,8,3,352.58796356688487,0.34447605500237083,0.14584924916168518,0.23694016166724763,136388.24755926352,2017.7708922753745,138406.0184515389,1072,13,547.0,35,3,17,29.65246999076638,0.6860119047619048,38.8599537037037,1044.560185185185,29.844576719576715,0
1076,4,0,0,37,0.0,0.0,1.0,37,950,600,350,0.631578947368421,13,6,7,363.0616130226007,0.34024649649649646,0.15547550743081495,0.24327069578466226,136285.50347222213,2496.0069444444334,138781.51041666657,1073,102,562.4324324324324,34,3,17,29.48091247672253,0.6871936274509804,38.95833333333333,1044.1666666666658,30.710784313725465,0
1077,4,0,0,37,0.0,0.0,1.0,37,950,500,450,0.5263157894736842,14,5,9,364.62180361288733,0.34065315315315314,0.15661689273908586,0.24474575999203216,136347.66333616775,2543.066184807244,138890.729520975,1074,103,563.4324324324324,34,3,18,29.378490824119453,0.6878063725490196,38.89880952380952,1044.4047619047615,30.717787114845926,0
1078,4,0,1,36,0.0,0.02702702702702703,0.972972972972973,37,800,600,200,0.75,10,6,4,364.11431520351346,0.34024649649649646,0.15880457617407773,0.24462013794759752,136378.7485827663,2531.4909297052027,138910.2395124715,1075,104,564.4324324324324,34,3,18,29.360895828584464,0.6881127450980393,38.86904761904761,1044.5238095238083,30.721288515406126,0
1079,4,0,0,36,0.0,0.0,1.0,36,800,500,300,0.625,11,5,6,370.3784522471294,0.33908730158730155,0.15474700052164891,0.2480836802787372,136272.7076124565,2894.4949058054244,139167.2025182619,1076,105,567.5277777777778,33,3,18,29.302621283255082,0.6893939393939394,38.9705882352941,1044.1176470588214,31.63992869875216,0
1080,4,0,0,36,0.0,0.0,1.0,36,1050,800,250,0.7619047619047619,13,8,5,368.3635293524731,0.3380787037037037,0.14987224112532194,0.24740444134524217,136368.69120350323,2846.6504769799844,139215.34168048322,1077,106,568.5277777777778,33,3,18,29.25991923813994,0.6903409090909092,38.878676470588225,1044.4852941176453,31.651069518716522,0
1081,4,0,0,36,0.0,0.0,1.0,36,1300,1000,300,0.7692307692307693,16,10,6,368.8322095107799,0.33840939153439153,0.14249182335848287,0.2486191502370288,136496.72188881654,2868.8775050461086,139365.59939386265,1078,107,569.5277777777778,33,3,18,29.12061197763966,0.6916035353535355,38.75612745098038,1044.9754901960764,31.66592394533565,0
1082,4,0,0,36,0.0,0.0,1.0,36,850,600,250,0.7058823529411765,11,6,5,367.89044665472795,0.33895502645502645,0.1362967304936824,0.2486612923902399,136592.78432574,2850.2360870818757,139443.02041282188,1079,108,570.5277777777778,33,3,18,29.04992184447049,0.6925505050505052,38.6642156862745,1045.3431372549012,31.677064765300035,0
1083,4,0,0,36,0.0,0.0,1.0,36,850,500,350,0.5882352941176471,12,5,7,364.2538822863894,0.33816137566137566,0.1353660696215344,0.246883186882997,136689.7959183672,2757.95776643989,139447.75368480707,1080,109,571.5277777777778,34,2,18,29.048791363084387,0.6911764705882353,38.57142857142856,1045.7142857142844,30.756302521008365,0
1084,4,0,0,36,0.0,0.0,1.0,36,1100,1000,100,0.9090909090909091,12,10,2,366.56893054233956,0.33870701058201064,0.14029671640990604,0.2496102487596031,136853.00168669026,2833.218780127618,139686.22046681787,1081,110,572.5277777777778,32,4,18,28.826525481678136,0.6975911458333333,38.41540404040405,1046.3383838383847,32.69807449494952,0
1085,4,0,0,36,0.0,0.0,1.0,36,900,700,200,0.7777777777777778,11,7,4,365.5918542018131,0.33864087301587303,0.1379036474041908,0.24941488719990354,136919.0663739669,2811.299070247933,139730.36544421484,1082,111,573.5277777777778,32,4,20,28.786644951140072,0.6982421875,38.35227272727273,1046.5909090909088,32.7059659090909,0
1086,4,0,0,36,0.0,0.0,1.0,36,500,300,200,0.6,7,3,4,363.7089750807147,0.33875661375661376,0.1403784360405369,0.24831641536086208,136945.30236267298,2761.647112889275,139706.94947556226,1083,112,574.5277777777778,33,3,20,28.809931506849324,0.6960227272727273,38.32720588235294,1046.691176470588,31.717914438502667,0
1087,4,0,0,36,0.0,0.0,1.0,36,450,200,250,0.4444444444444444,7,2,5,363.7765634498596,0.33859126984126986,0.14045612392212004,0.24881850933163727,137009.4453605584,2768.1650386870424,139777.61039924543,1084,113,575.5277777777778,33,3,16,28.744659370244662,0.6966540404040404,38.26593137254902,1046.9362745098035,31.72534165181223,0
1088,4,0,0,36,0.0,0.0,1.0,36,1150,900,250,0.782608695652174,14,9,5,366.804705143851,0.33821097883597884,0.1441427382438616,0.25112014429079027,137041.52249134946,2853.495049980774,139895.01754133022,1085,114,576.5277777777778,33,3,16,28.633641541822723,0.696969696969697,38.23529411764706,1047.0588235294117,31.72905525846702,0
1089,4,0,0,36,0.0,0.0,1.0,36,650,300,350,0.46153846153846156,10,3,7,365.705532374128,0.3382275132275132,0.14141798322605825,0.2505977364985503,137073.60337670604,2825.7150194636647,139899.31839616972,1086,115,577.5277777777778,33,3,16,28.630656329237375,0.6972853535353536,38.2046568627451,1047.1813725490192,31.732768865121795,0
1090,4,0,0,36,0.0,0.0,1.0,36,650,400,250,0.6153846153846154,9,4,5,362.16445691366073,0.3382440476190476,0.13549281016046177,0.24921105436255855,137219.38952664382,2739.197137188192,139958.58666383201,1087,116,578.5277777777778,34,2,16,28.579138734234746,0.6963848039215688,38.06547619047618,1047.738095238094,30.81582633053218,0
1091,4,0,0,36,0.0,0.0,1.0,36,450,400,50,0.8888888888888888,5,4,1,365.51126732109026,0.33809523809523806,0.13922972051806415,0.25173945030987765,137250.5739795918,2833.3262471655307,140083.90022675734,1088,117,579.5277777777778,34,2,16,28.460624479285006,0.6966911764705882,38.035714285714285,1047.8571428571427,30.819327731092432,0
1092,4,0,0,36,0.0,0.0,1.0,36,1450,1200,250,0.8275862068965517,17,12,5,364.4262832698241,0.3373346560846561,0.14292699854880464,0.25166850385810197,137344.14859693873,2810.3635204081593,140154.5121173469,1089,118,580.5277777777778,34,2,17,28.396507666098813,0.6976102941176471,37.94642857142857,1048.2142857142853,30.829831932773097,0
1093,4,0,0,36,0.0,0.0,1.0,36,1450,1400,50,0.9655172413793104,15,14,1,369.67370455300795,0.3364583333333333,0.1399228325011348,0.256905732217753,137562.61337868485,2970.656179138328,140533.26955782317,1090,119,581.5277777777778,34,2,17,28.042962248449076,0.6997549019607843,37.73809523809524,1049.0476190476195,30.854341736694693,0
1094,4,0,0,36,0.0,0.0,1.0,36,900,700,200,0.7777777777777778,11,7,4,368.9406850142318,0.33543320105820107,0.1400863427238923,0.2570918686482572,137656.2942885488,2957.401502267578,140613.69579081636,1091,120,582.5277777777778,34,2,17,27.96960673095103,0.7006740196078431,37.648809523809526,1049.4047619047622,30.864845938375357,0
1095,4,0,0,36,0.0,0.0,1.0,36,650,400,250,0.6153846153846154,9,4,5,368.44032451611787,0.3344246031746032,0.14091126735717374,0.2574411078908974,137750.00708616778,2950.531462585036,140700.5385487528,1092,121,583.5277777777778,34,2,19,27.890158388145473,0.7015931372549019,37.55952380952381,1049.7619047619046,30.875350140056018,0
1096,4,0,0,36,0.0,0.0,1.0,36,750,700,50,0.9333333333333333,8,7,1,368.15015092106796,0.33457341269841273,0.13846682037519997,0.2574715448828628,137781.25177154195,2944.837726757371,140726.08949829932,1093,122,584.5277777777778,34,2,20,27.866916128056843,0.7018995098039216,37.529761904761905,1049.8809523809525,30.87885154061625,0
1097,4,0,0,36,0.0,0.0,1.0,36,900,500,400,0.5555555555555556,13,5,8,367.71454038613547,0.3340112433862434,0.13163467062108403,0.2576480060986929,137845.6459321751,2937.5767538037317,140783.22268597884,1094,123,585.5277777777778,32,4,21,27.814766943208685,0.7073567708333334,37.46843434343433,1050.1262626262612,32.81644570707066,0
1098,4,0,0,36,0.0,0.0,1.0,36,650,200,450,0.3076923076923077,11,2,9,368.190932414941,0.33336640211640217,0.13544337606837642,0.25872876331860706,137945.10764207726,2958.02756096316,140903.1352030404,1095,124,586.5277777777778,32,4,21,27.704076522435905,0.7083333333333334,37.37373737373737,1050.50505050505,32.82828282828281,0
1099,4,0,0,36,0.0,0.0,1.0,36,650,400,250,0.6153846153846154,9,4,5,368.190932414941,0.33336640211640217,0.13544337606837642,0.25872876331860706,137945.10764207726,2958.02756096316,140903.1352030404,1096,125,587.5277777777778,32,4,21,27.704076522435905,0.7083333333333334,37.37373737373737,1050.50505050505,32.82828282828281,0
1100,4,0,0,36,0.0,0.0,1.0,36,600,500,100,0.8333333333333334,7,5,2,366.757101676206,0.3329365079365079,0.13502316762141287,0.25797006281045726,137978.26951650344,2920.9020444342395,140899.17156093768,1097,126,588.5277777777778,32,4,21,27.709009333814034,0.7086588541666667,37.342171717171716,1050.6313131313132,32.832228535353536,0
1101,4,0,0,36,0.0,0.0,1.0,36,850,800,50,0.9411764705882353,9,8,1,366.5871276682087,0.3330191798941799,0.13950950950950958,0.2588496893840406,138110.95686983474,2925.9397956841194,141036.89666551887,1098,127,589.5277777777778,32,4,17,27.58258258258258,0.7099609375,37.21590909090909,1051.136363636364,32.848011363636374,0
1102,4,0,0,36,0.0,0.0,1.0,36,1000,800,200,0.8,12,8,4,369.5844508933792,0.3324239417989418,0.1402098928519011,0.2614723638563438,138177.32445987643,3013.6381172839374,141190.96257716036,1099,128,590.5277777777778,32,4,17,27.43835314839278,0.7106119791666667,37.15277777777777,1051.388888888888,32.85590277777775,0
1103,4,0,0,36,0.0,0.0,1.0,36,550,200,350,0.36363636363636365,9,2,7,368.71205640774355,0.3322751322751323,0.13758805635606808,0.261108333823443,138210.51423324156,2991.976584022046,141202.4908172636,1100,129,591.5277777777778,32,4,17,27.428554274735834,0.7109375,37.121212121212125,1051.515151515152,32.8598484848485,0
1104,4,0,0,36,0.0,0.0,1.0,36,950,600,350,0.631578947368421,13,6,7,367.01100212519844,0.3323743386243386,0.13172774310556412,0.26091601277364773,138343.31318232822,2954.7036016732836,141298.0167840015,1101,130,592.5277777777778,32,4,17,27.342374779964796,0.7122395833333334,36.99494949494949,1052.0202020202012,32.87563131313129,0
1105,4,0,0,36,0.0,0.0,1.0,36,1000,600,400,0.6,14,6,8,364.8560928228077,0.3317625661375661,0.13629513201640342,0.2604945121575305,138488.87935229222,2905.7022839772917,141394.58163626952,1102,131,593.5277777777778,33,3,17,27.25567101331159,0.7111742424242425,36.85661764705881,1052.5735294117633,31.89616755793222,0
1106,4,0,0,36,0.0,0.0,1.0,36,1250,1100,150,0.88,14,11,3,365.0072876158987,0.3308366402116402,0.13293442983306836,0.26159362989853346,138617.90124291123,2919.3088295367024,141537.21007244792,1103,132,594.5277777777778,33,3,20,27.124670274254246,0.7124368686868687,36.734068627450974,1053.063725490195,31.91102198455137,0
1107,4,0,0,36,0.0,0.0,1.0,36,800,600,200,0.75,10,6,4,364.0869710293978,0.33004298941798943,0.1279587615538751,0.261430870175244,138682.43471561404,2898.4935181180144,141580.92823373206,1104,133,595.5277777777778,33,3,21,27.085393639713015,0.7130681818181819,36.67279411764705,1053.3088235294108,31.918449197860934,0
1108,4,0,0,36,0.0,0.0,1.0,36,800,500,300,0.625,11,5,6,352.27932040517345,0.33004298941798943,0.10748735442889057,0.2319695199662572,135665.59624002792,2358.4368091599436,138024.03304918786,1105,134,596.5277777777778,33,3,22,30.37767615574639,0.6833964646464646,39.552696078431374,1041.789215686275,31.569370172311363,4
1109,4,0,0,36,0.0,0.0,1.0,36,500,400,100,0.8,6,4,2,352.27932040517345,0.33004298941798943,0.10748735442889057,0.2319695199662572,135665.59624002792,2358.4368091599436,138024.03304918786,1106,135,597.5277777777778,33,3,22,30.37767615574639,0.6833964646464646,39.552696078431374,1041.789215686275,31.569370172311363,0
1110,4,0,0,36,0.0,0.0,1.0,36,1150,700,450,0.6086956521739131,16,7,9,356.08507271308855,0.3300595238095238,0.11136583326802008,0.2355256320760134,135825.23098087285,2473.067450019237,138298.2984308921,1107,136,598.5277777777778,33,3,22,30.119915353867874,0.6849747474747474,39.399509803921575,1042.4019607843145,31.58793820558529,0
1111,4,0,0,36,0.0,0.0,1.0,36,1050,700,350,0.6666666666666666,14,7,7,355.9854710817051,0.33004298941798943,0.11396170473988754,0.2356706928009391,135857.16919273845,2472.635674980789,138329.80486771924,1108,137,599.5277777777778,33,3,22,30.090783080600293,0.685290404040404,39.36887254901961,1042.5245098039222,31.591651812240066,0
1112,4,0,0,36,0.0,0.0,1.0,36,900,600,300,0.6666666666666666,12,6,6,356.5150330594021,0.32979497354497356,0.1147808598443294,0.23623285835431423,135889.1111591696,2489.3021914648325,138378.41335063445,1109,138,600.5277777777778,33,3,18,30.04525152797368,0.6856060606060606,39.33823529411765,1042.64705882353,31.595365418894847,0
1113,4,0,0,36,0.0,0.0,1.0,36,750,500,250,0.6666666666666666,10,5,5,357.72501229031445,0.3295138888888889,0.11834684525907635,0.23767350348187874,135984.95958585633,2529.044267829673,138514.003853686,1110,139,601.5277777777778,33,3,19,29.918512317393166,0.6865530303030303,39.24632352941176,1043.0147058823525,31.606506238859165,0
1114,4,0,0,36,0.0,0.0,1.0,36,800,700,100,0.875,9,7,2,358.69505568483385,0.32921626984126984,0.11887374864586242,0.23874675598475303,136048.8773098087,2560.0119245001974,138608.8892343089,1111,140,602.5277777777778,33,3,19,29.829745683072954,0.6871843434343434,39.185049019607845,1043.2598039215686,31.613933452168745,0
1115,4,0,0,36,0.0,0.0,1.0,36,900,700,200,0.7777777777777778,11,7,4,360.5821511484173,0.3291501322751323,0.12361518888236467,0.24043516186599634,136112.81005202327,2615.9699694828937,138728.78002150616,1112,141,603.5277777777778,33,3,19,29.717043452730486,0.6878156565656566,39.12377450980392,1043.5049019607843,31.621360665478313,0
1116,4,0,0,36,0.0,0.0,1.0,36,850,400,450,0.47058823529411764,13,4,9,360.4122730377613,0.3283564814814815,0.11646189563198606,0.24119027132825505,136240.7205912389,2620.5655577181833,138861.2861489571,1113,142,604.5277777777778,33,3,19,29.594509332081245,0.6890782828282829,39.00122549019608,1043.9950980392155,31.636215092097437,0
1117,4,0,0,36,0.0,0.0,1.0,36,700,600,100,0.8571428571428571,8,6,2,360.4122730377613,0.3283564814814815,0.11646189563198606,0.24119027132825505,136240.7205912389,2620.5655577181833,138861.2861489571,1114,143,605.5277777777778,33,3,19,29.594509332081245,0.6890782828282829,39.00122549019608,1043.9950980392155,31.636215092097437,0
1118,4,0,0,36,0.0,0.0,1.0,36,450,300,150,0.6666666666666666,6,3,3,360.1864709383058,0.3274966931216931,0.1152842983828899,0.24125697581716715,136272.70761245684,2616.717128027693,138889.42474048454,1115,144,606.5277777777778,33,3,20,29.568661971830995,0.6893939393939393,38.97058823529412,1044.1176470588243,31.639928698752254,0
1119,4,0,0,36,0.0,0.0,1.0,36,950,800,150,0.8421052631578947,11,8,3,360.02458895267307,0.3271494708994709,0.11558971550757491,0.24158500370509317,136336.69291858922,2616.9123654363943,138953.60528402563,1116,145,607.5277777777778,33,3,20,29.509407024955024,0.6900252525252524,38.90931372549021,1044.362745098041,31.647355912061848,0
1120,4,0,0,36,0.0,0.0,1.0,36,850,700,150,0.8235294117647058,10,7,3,358.23327999161444,0.32706679894179896,0.1212133062203451,0.2408186497356879,136400.6932429835,2572.6535467128097,138973.3467896963,1117,146,608.5277777777778,33,3,20,29.49270686688567,0.6906565656565655,38.84803921568628,1044.6078431372553,31.65478312537137,0
1121,4,0,0,36,0.0,0.0,1.0,36,650,500,150,0.7692307692307693,8,5,3,358.23327999161444,0.32706679894179896,0.1212133062203451,0.2408186497356879,136400.6932429835,2572.6535467128097,138973.3467896963,1118,147,609.5277777777778,33,3,20,29.49270686688567,0.6906565656565655,38.84803921568628,1044.6078431372553,31.65478312537137,0
1122,4,0,0,36,0.0,0.0,1.0,36,650,500,150,0.7692307692307693,8,5,3,357.67729887946325,0.3275132275132275,0.12085255558161956,0.24088125199417923,136464.70858564042,2562.0656718570126,139026.77425749743,1119,148,610.5277777777778,33,3,20,29.44376026272579,0.6912878787878787,38.78676470588237,1044.8529411764728,31.662210338680993,0
1123,4,0,0,36,0.0,0.0,1.0,36,750,500,250,0.6666666666666666,10,5,5,358.97493167661236,0.3273313492063492,0.12211211445995063,0.241974643668496,136496.72188881683,2599.7802828239173,139096.50217164075,1120,149,611.5277777777778,33,3,20,29.378127321058606,0.6916035353535352,38.756127450980394,1044.9754901960787,31.665923945335717,0
1124,4,0,0,36,0.0,0.0,1.0,36,1100,800,300,0.7272727272727273,14,8,6,358.2611742876918,0.3277612433862434,0.11970168710685836,0.24175056487868168,136534.22796201828,2582.982568027225,139117.2105300455,1121,150,612.5277777777778,34,2,21,29.359598663477236,0.6896446078431371,38.7202380952381,1045.1190476190486,30.73879551820731,0
1125,4,0,0,36,0.0,0.0,1.0,36,1150,600,550,0.5217391304347826,17,6,11,356.17596413849225,0.32739748677248676,0.12447645800908513,0.240768371139346,136596.44451530624,2530.4740646258633,139126.9185799321,1122,151,613.5277777777778,34,2,21,29.35243708005922,0.6902573529411764,38.66071428571429,1045.3571428571438,30.745798319327758,0
1126,4,0,0,36,0.0,0.0,1.0,36,750,700,50,0.9333333333333333,8,7,1,356.9136805937496,0.3279265873015873,0.12769934342859313,0.24169412927177347,136658.67524092968,2555.0701530612205,139213.7453939909,1123,152,614.5277777777778,34,2,21,29.271509355193746,0.6908700980392157,38.601190476190474,1045.5952380952378,30.752801120448172,0
1127,4,0,0,36,0.0,0.0,1.0,36,750,400,350,0.5333333333333333,11,4,7,354.38580297077283,0.3283068783068783,0.12870718462823727,0.235666558975564,136016.9165705498,2440.507011628187,138457.423582178,1124,153,615.5277777777778,33,3,16,29.97386043233083,0.6868686868686869,39.21568627450981,1043.1372549019611,31.610219845513974,1
1128,4,0,0,36,0.0,0.0,1.0,36,450,100,350,0.2222222222222222,8,1,7,354.6568534181025,0.32858796296296294,0.11395944392181456,0.2341616367599025,135761.36582083817,2460.1517445213385,138221.5175653595,1125,154,616.5277777777778,33,3,23,30.220582470994042,0.6843434343434343,39.46078431372549,1042.1568627450981,31.580510992275702,3
1129,4,0,0,36,0.0,0.0,1.0,36,800,600,200,0.75,10,6,4,355.8554102939758,0.3289351851851852,0.11195048664184482,0.23516319071874636,135793.2965235728,2464.5558499135095,138257.8523734863,1126,155,617.5277777777778,33,3,23,30.157627865961196,0.6846590909090908,39.430147058823536,1042.2794117647068,31.584224598930508,0
1130,4,0,0,36,0.0,0.0,1.0,36,900,600,300,0.6666666666666666,12,6,6,352.1871937615979,0.3287367724867725,0.10391298833079654,0.23372422858724237,135943.87755102053,2375.538548752848,138319.41609977337,1127,156,618.5277777777778,34,2,18,30.103691019786908,0.6838235294117647,39.28571428571429,1042.8571428571438,30.67226890756305,0
1131,4,0,0,36,0.0,0.0,1.0,36,950,700,250,0.7368421052631579,12,7,5,350.05014769533835,0.32883597883597887,0.10291059632038735,0.23291491604056577,136037.00573979603,2323.954790249445,138360.96053004547,1128,157,619.5277777777778,34,2,19,30.06699570162425,0.6847426470588235,39.19642857142858,1043.2142857142865,30.68277310924372,0
1132,4,0,0,36,0.0,0.0,1.0,36,1000,1000,0,1.0,10,10,0,347.5791697802057,0.32883597883597887,0.11976875352509886,0.20500927079850445,131595.18771701382,1947.9492187499905,133543.13693576382,1129,158,620.5277777777778,35,1,14,34.57381556683587,0.6383928571428572,43.48958333333333,1026.041666666666,29.315476190476172,8
1133,4,0,0,36,0.0,0.0,1.0,36,1000,900,100,0.9,11,9,2,349.04859969203096,0.3284060846560847,0.12348567419601397,0.20651848103192938,131713.96933138277,1994.915310999648,133708.8846423824,1130,159,621.5277777777778,35,1,15,34.416342503852384,0.6395833333333334,43.37384259259259,1026.5046296296289,29.32870370370368,0
1134,4,1,1,36,0.02702702702702703,0.02702702702702703,0.972972972972973,37,850,700,150,0.8235294117647058,10,7,3,339.4012894916525,0.3361486486486487,0.11920082677176969,0.2025974865395889,132050.5402995902,1563.624731150076,133614.1650307403,1131,0,605.7027027027027,36,1,15,34.32512508673897,0.6409143518518519,43.046171171171174,1027.815315315316,28.550425425425445,0
1135,4,0,0,36,0.0,0.0,1.0,36,1100,900,200,0.8181818181818182,13,9,4,346.3842220598977,0.3297453703703704,0.1198948948948948,0.20671316477768092,132040.89506172843,1947.3765432098803,133988.27160493832,1132,161,623.5277777777778,35,1,15,34.1554054054054,0.6428571428571428,43.05555555555556,1027.777777777778,29.365079365079374,0
1136,4,0,0,36,0.0,0.0,1.0,36,600,400,200,0.6666666666666666,8,4,4,345.9668107737024,0.3300595238095238,0.11907755633124384,0.2066261766295395,132070.63567654756,1938.4113243741494,134009.0470009217,1133,162,624.5277777777778,35,1,15,34.13619430995006,0.6431547619047618,43.026620370370374,1027.8935185185192,29.36838624338626,0
1137,4,0,0,36,0.0,0.0,1.0,36,1000,800,200,0.8,12,8,4,346.77742294449916,0.32976190476190476,0.09211484211484211,0.19334028923070015,129413.28124999988,1782.9187296381892,131196.19997963807,1134,163,625.5277777777778,34,2,20,36.803849303849304,0.6185661764705883,45.62499999999999,1017.4999999999991,29.92647058823527,6
1138,4,1,1,36,0.02702702702702703,0.02702702702702703,0.972972972972973,37,650,400,250,0.6153846153846154,9,4,5,336.8710854570951,0.3343656156156156,0.08435563575957139,0.1892755179530983,129717.10519641264,1339.588405973544,131056.69360238618,1135,0,609.5945945945946,36,1,15,36.74736531800429,0.6174768518518519,45.32657657657658,1018.6936936936937,28.297047047047048,0
1139,4,2,0,38,0.05263157894736842,0.0,1.0,38,400,200,200,0.5,6,2,4,329.8110207561904,0.34290540540540543,0.09264142508728557,0.18670555715479778,130010.85820877583,975.802771044943,130986.66097982076,1136,0,594.5,37,1,18,36.629461885818735,0.6185247747747746,45.03837719298246,1019.8464912280706,27.563418681839746,0
1140,4,0,0,38,0.0,0.0,1.0,38,850,800,50,0.9411764705882353,9,8,1,328.8329991571205,0.34256460407776196,0.09099910602134198,0.18628529586842474,130038.81602993225,952.2107763927297,130991.02680632498,1137,1,595.5,37,1,18,36.62608399627319,0.6188063063063063,45.0109649122807,1019.9561403508769,27.566382171645323,0
1141,4,1,0,39,0.02564102564102564,0.0,1.0,39,1000,700,300,0.7,13,7,6,325.0831844429058,0.3494995501574449,0.103312906405026,0.1857561214663326,130374.54433094787,676.7067751615766,131051.25110610946,1138,0,581.2051282051282,37,2,19,36.38205926562165,0.6221846846846848,44.682017543859644,1021.2719298245605,27.601944049312447,0
1142,4,0,0,39,0.0,0.0,1.0,39,500,300,200,0.6,7,3,4,325.9889667102592,0.349527665317139,0.106742640075973,0.18640805554978893,130402.54122662726,701.9579341720296,131104.49916079929,1139,1,582.2051282051282,37,2,19,36.330627124709224,0.6224662162162162,44.65460526315788,1021.3815789473671,27.604907539118027,0
1143,4,0,0,39,0.0,0.0,1.0,39,600,400,200,0.6666666666666666,8,4,4,327.9847892874876,0.34913405308142154,0.10803462831795052,0.18795585895330927,130486.54994806083,759.5207179131864,131246.07066597402,1140,2,583.2051282051282,37,2,19,36.19473062889031,0.6233108108108109,44.57236842105262,1021.7105263157886,27.613798008534825,0
1144,4,2,1,40,0.04878048780487805,0.024390243902439025,0.975609756097561,41,600,400,200,0.6666666666666666,8,4,4,315.3884303759006,0.35978150406504067,0.11161031211370531,0.18294018399489964,130954.6929253473,60.31901041667106,131015.01193576398,1141,0,555.7073170731708,39,2,16,36.044253341475,0.624465811965812,44.114583333333336,1023.5416666666673,26.244658119658137,0
1145,4,1,0,41,0.024390243902439025,0.0,1.0,41,1200,1000,200,0.8333333333333334,14,10,4,316.7047115900941,0.3582825203252033,0.12303517523124019,0.18459735797660892,131141.34250217004,106.61621093749528,131247.95871310754,1142,0,556.609756097561,39,2,18,35.82250669514221,0.6263354700854702,43.932291666666664,1024.2708333333326,26.26335470085468,0
1146,4,0,1,40,0.0,0.024390243902439025,0.975609756097561,41,1150,1000,150,0.8695652173913043,13,10,3,316.3514043205909,0.35807926829268294,0.12240374214437622,0.18441329115947,131145.89659139735,97.63771151431396,131243.53430291166,1143,1,557.609756097561,40,1,18,35.82696696100803,0.6247395833333333,43.927845528455286,1024.2886178861793,25.60721544715448,0
1147,4,0,0,40,0.0,0.0,1.0,40,1050,800,250,0.7619047619047619,13,8,5,328.17567849389695,0.35423344017094016,0.1234540276647682,0.19115066771042608,131114.6701388888,605.729166666657,131720.39930555545,1144,2,572.375,39,1,18,35.555668565229176,0.6260683760683762,43.95833333333333,1024.1666666666658,26.26068376068374,0
1148,4,1,0,41,0.024390243902439025,0.0,1.0,41,1250,800,450,0.64,17,8,9,324.41317717652623,0.3566819105691057,0.13335738732947333,0.19069455527969814,131465.0463533674,330.1458972532471,131795.19225062063,1145,0,559.390243902439,38,3,19,35.29903288537001,0.6313048245614037,43.61645299145298,1025.534188034186,26.987741790373313,0
1149,4,0,0,41,0.0,0.0,1.0,41,1100,700,400,0.6363636363636364,15,7,8,324.8135613665718,0.3572916666666666,0.13110232320692483,0.19147849170062525,131574.63480029564,347.4451429980031,131922.07994329365,1146,1,560.390243902439,38,3,17,35.17845985629491,0.6324013157894738,43.50961538461537,1025.9615384615365,26.99898785425096,0
1150,4,1,2,40,0.023809523809523808,0.047619047619047616,0.9523809523809523,42,950,700,250,0.7368421052631579,12,7,5,321.6546119022514,0.36261130468447544,0.12882355498239484,0.19092069950296756,131835.77609591992,81.11707899303065,131916.89317491296,1147,0,548.0238095238095,39,3,17,34.99689370118671,0.6332799145299146,43.25520833333332,1026.979166666665,26.332799145299102,0
1151,4,3,2,41,0.06976744186046512,0.046511627906976744,0.9534883720930233,43,1100,600,500,0.5454545454545454,16,6,10,315.7813664851245,0.37027039497969727,0.12944165354240167,0.18866677625499306,132084.41904826814,-258.04033230882067,131826.37871595932,1148,0,536.1627906976744,40,3,18,34.898047454275826,0.6341145833333335,43.013211382113816,1027.947154471544,25.6986788617886,0
1152,4,0,1,40,0.0,0.024390243902439025,0.975609756097561,41,850,700,150,0.8235294117647058,10,7,3,328.9813945398696,0.3619664634146342,0.133468975630052,0.1954775727506985,131876.2384487542,476.9657663086865,132353.20421506287,1149,1,563.3170731707318,38,3,18,34.76808993828443,0.6354166666666667,43.21581196581195,1027.13675213675,27.02991452991447,0
1153,4,0,0,40,0.0,0.0,1.0,40,750,400,350,0.5333333333333333,11,4,7,338.11566747335576,0.35699786324786326,0.13622503471109737,0.20023889908621287,131749.9269606992,909.3428987765191,132659.26985947572,1150,2,578.2,37,3,18,34.66069902808929,0.6359797297297298,43.33881578947367,1026.6447368421032,27.74715504978657,0
1154,4,0,0,40,0.0,0.0,1.0,40,1100,600,500,0.5454545454545454,16,6,10,335.20500154333484,0.3568509615384616,0.1339754535752402,0.19954706889841442,131946.99931709733,845.8588219451849,132792.8581390425,1151,3,579.2,37,3,18,34.537086446104574,0.6379504504504505,43.14692982456139,1027.4122807017525,27.767899478425743,0
1155,4,1,1,40,0.024390243902439025,0.024390243902439025,0.975609756097561,41,1150,900,250,0.782608695652174,14,9,5,326.59683282090424,0.361890243902439,0.12946818779499703,0.19589705355556633,132233.1242809005,437.3839168310034,132670.50819773148,1152,0,566.0487804878048,38,3,18,34.470759322738125,0.6389802631578949,42.86858974358973,1028.525641025639,27.06646423751682,0
1156,4,0,0,40,0.0,0.0,1.0,40,1250,900,350,0.72,16,9,7,332.8533238777323,0.35715811965811967,0.13395808894102634,0.1991809583919266,132144.21895438954,796.92850203906,132941.1474564286,1153,5,581.2,37,3,18,34.39921705591697,0.6399211711711712,42.95504385964911,1028.1798245614013,27.788643907064902,0
1157,4,0,0,40,0.0,0.0,1.0,40,1050,700,350,0.6666666666666666,14,7,7,333.4963925423146,0.3570646367521368,0.13785714285714334,0.20001254233036483,132228.78674207427,819.5646737457455,133048.35141582,1154,6,582.2,37,3,19,34.297707889125796,0.6407657657657658,42.87280701754385,1028.5087719298228,27.7975343764817,0
1158,4,0,0,40,0.0,0.0,1.0,40,850,600,250,0.7058823529411765,11,6,5,321.7697504954535,0.3572516025641026,0.09395374107420107,0.1981683300852497,133223.94035585143,573.4868096646999,133797.42716551613,1155,7,583.2,38,2,19,33.602400910690264,0.6488486842105262,41.907051282051285,1032.371794871795,27.167678812415655,2
1159,4,0,0,40,0.0,0.0,1.0,40,650,200,450,0.3076923076923077,11,2,9,319.64821650867316,0.35730502136752135,0.08902193027826621,0.19744660121337676,133334.2593163308,524.0116379940272,133858.27095432483,1156,8,584.2,38,2,21,33.54690355504984,0.6499451754385963,41.80021367521368,1032.7991452991466,27.178924876293333,0
1160,4,0,0,40,0.0,0.0,1.0,40,800,500,300,0.625,11,5,6,318.36470189693773,0.3575854700854701,0.08496586677699636,0.19679986815470568,133361.84619037196,491.5408813646126,133853.38707173656,1157,9,585.2,38,2,21,33.55248414011861,0.650219298245614,41.77350427350428,1032.9059829059838,27.18173639226273,0
1161,4,0,0,40,0.0,0.0,1.0,40,1300,1000,300,0.7692307692307693,16,10,6,319.35084174798953,0.35733173076923075,0.08292739683524686,0.19755619250552217,133389.43591798164,519.6057281393905,133909.04164612104,1158,10,586.2,38,2,21,33.499457027614056,0.6504934210526315,41.746794871794876,1033.0128205128208,27.184547908232126,0
1162,4,0,1,39,0.0,0.025,0.975,40,1100,800,300,0.7272727272727273,14,8,6,319.5732327674153,0.3575721153846154,0.07771087533156495,0.1982868807658257,133500.54974848044,532.6661339868463,134033.21588246728,1159,11,587.2,37,3,21,33.38273651635719,0.6534346846846846,41.63925438596492,1033.4429824561414,27.93089141773355,0
1163,4,0,0,39,0.0,0.0,1.0,39,1300,1100,200,0.8461538461538461,15,11,4,328.95465857616193,0.3523672964462438,0.07894529134312589,0.20348534723874095,133387.25767784324,975.6719615650997,134362.92963940834,1160,12,602.7948717948718,37,2,21,33.253613381452766,0.6523085585585585,41.74890350877193,1033.004385964913,27.91903745851116,0
1164,4,1,1,39,0.025,0.025,0.975,40,800,700,100,0.875,9,7,2,321.36012534882076,0.3569845085470085,0.08760602205258672,0.20046750676521669,133698.92659279777,593.1278133656472,134292.05440616343,1161,0,588.7,37,3,22,33.13851781170484,0.6554054054054055,41.44736842105263,1034.2105263157891,27.951635846372678,0
1165,4,0,0,39,0.0,0.0,1.0,39,1250,900,350,0.72,16,9,7,327.0285913423577,0.356865721997301,0.08220088028512973,0.20452087601512878,133792.42153893766,950.7894296323482,134743.21096857,1162,1,590.0769230769231,36,3,18,32.89861579768514,0.6582754629629629,41.35698198198199,1034.5720720720728,28.738113113113133,0
1166,4,0,0,39,0.0,0.0,1.0,39,850,600,250,0.7058823529411765,11,6,5,329.30189228761395,0.3558816914080072,0.08752315279730483,0.20675840122320702,133938.0934989044,1021.2135277169223,134959.30702662133,1163,2,591.0769230769231,36,3,19,32.694417246881365,0.6597222222222221,41.216216216216225,1035.135135135136,28.753753753753774,0
1167,4,0,0,39,0.0,0.0,1.0,39,1050,900,150,0.8571428571428571,12,9,3,331.66912985522015,0.35461650922177235,0.0907765352693044,0.2090720347689143,134083.84471887434,1094.2944211103065,135178.13913998465,1164,3,592.0769230769231,36,3,19,32.487722445725055,0.6611689814814814,41.075450450450454,1035.6981981981987,28.76939439439441,0
1168,4,0,0,39,0.0,0.0,1.0,39,750,500,250,0.6666666666666666,10,5,5,335.52839540343837,0.35478520017993703,0.08993173728471038,0.21184116055705082,134142.16739966325,1201.7012367096934,135343.86863637294,1165,4,593.0769230769231,36,3,19,32.32960104359169,0.6617476851851851,41.01914414414415,1035.923423423424,28.775650650650668,0
1169,4,0,0,39,0.0,0.0,1.0,39,950,500,450,0.5263157894736842,14,5,9,336.2781728028231,0.35405420602789023,0.09153210978504345,0.21316145333864922,134288.0295836378,1231.6266435354428,135519.65622717325,1166,5,594.0769230769231,36,3,20,32.16468383311604,0.6631944444444444,40.878378378378386,1036.4864864864874,28.791291291291316,0
1170,4,0,0,39,0.0,0.0,1.0,39,950,600,350,0.631578947368421,13,6,7,334.3561300137041,0.3530420602789024,0.09512421947655114,0.21264330339876247,134408.61761551638,1188.0690452831677,135596.68666079955,1167,6,595.0769230769231,37,2,21,32.09428201332347,0.6624436936936937,40.762061403508774,1036.9517543859654,28.025723091512578,0
1171,4,0,0,39,0.0,0.0,1.0,39,750,500,250,0.6666666666666666,10,5,5,332.7485412828936,0.3518331084120558,0.10233593500006921,0.2127881893075549,134609.20538359313,1158.2784902413405,135767.48387383448,1168,7,596.0769230769231,36,3,22,31.93615482003979,0.6663773148148149,40.568693693693696,1037.7252252252258,28.825700700700718,0
1172,4,0,0,39,0.0,0.0,1.0,39,900,600,300,0.6666666666666666,12,6,6,335.5644556655344,0.35174876293297347,0.11217079554209408,0.21527966017957983,134726.0916955807,1241.857524754484,135967.94922033517,1169,8,597.0769230769231,36,3,22,31.746709693748425,0.6675347222222222,40.45608108108108,1038.1756756756756,28.838213213213212,0
1173,4,0,0,39,0.0,0.0,1.0,39,1200,700,500,0.5833333333333334,17,7,10,336.21100024782083,0.3525641025641026,0.11048829721568865,0.21621602819284566,134813.78971877292,1265.1758177096153,136078.96553648254,1170,9,598.0769230769231,36,3,16,31.642629942890206,0.6684027777777777,40.37162162162163,1038.5135135135142,28.847597597597616,0
1174,4,0,0,39,0.0,0.0,1.0,39,650,400,250,0.6153846153846154,9,4,5,336.5351898726731,0.35287336932073776,0.10997980978981614,0.21689349584038822,134892.2805574793,1279.1998499538417,136171.48040743315,1171,10,599.0769230769231,37,2,16,31.556100907747513,0.6672297297297296,40.29605263157895,1038.8157894736848,28.0761024182077,0
1175,4,0,0,39,0.0,0.0,1.0,39,900,600,300,0.6666666666666666,12,6,6,337.6253855097083,0.35250787224471436,0.11335633583654703,0.2177672244863502,134920.75837036394,1310.5346116112619,136231.2929819752,1172,11,600.0769230769231,37,2,16,31.49945030782761,0.6675112612612613,40.26864035087719,1038.9254385964912,28.079065908013273,0
1176,4,0,0,39,0.0,0.0,1.0,39,600,300,300,0.5,9,3,6,340.51958309424015,0.35163630229419707,0.11484625664832504,0.22015311108916852,135006.2098434135,1394.4516582025417,136400.66150161604,1173,12,601.0769230769231,37,2,16,31.33924175283112,0.6683558558558558,40.18640350877194,1039.2543859649134,28.08795637743009,0
1177,4,0,0,39,0.0,0.0,1.0,39,850,800,50,0.9411764705882353,9,8,1,345.0994113640479,0.3520580296896086,0.11761779623441337,0.2241727957107284,135177.19394429075,1529.9140120037089,136707.10795629447,1174,13,602.0769230769231,37,2,17,31.050101926050893,0.670045045045045,40.02192982456141,1039.912280701756,28.105737316263674,0
1178,4,0,0,39,0.0,0.0,1.0,39,1000,500,500,0.5,15,5,10,346.1548305270312,0.3521704903283851,0.11590348942794138,0.2255712247280544,135291.24345952595,1566.3434903047032,136857.58694983067,1175,14,603.0769230769231,37,2,18,30.909218662169756,0.6711711711711712,39.91228070175438,1040.3508771929821,28.117591275486003,0
1179,4,0,0,39,0.0,0.0,1.0,39,750,500,250,0.6666666666666666,10,5,5,344.5298248546741,0.3518612235717499,0.11390007807666658,0.2250469764415493,135376.81215614424,1528.2698763080966,136905.08203245234,1176,15,604.0769230769231,37,2,19,30.86641291750079,0.6720157657657657,39.83004385964912,1040.6798245614036,28.1264817449028,0
1180,4,0,0,39,0.0,0.0,1.0,39,950,700,250,0.7368421052631579,12,7,5,343.3609965868664,0.3509615384615385,0.10427062406843413,0.22517652096608282,135519.48676515833,1506.421206525067,137025.9079716834,1177,16,605.0769230769231,37,2,21,30.75505475989891,0.6734234234234235,39.69298245614034,1041.228070175437,28.14129919393073,0
1181,4,0,0,39,0.0,0.0,1.0,39,1050,600,450,0.5714285714285714,15,6,9,345.05358086407585,0.3515519568151147,0.10452922169945045,0.22682795602960917,135605.12759935728,1558.2069723376167,137163.3345716949,1178,17,606.0769230769231,37,2,21,30.62592114959469,0.6742680180180181,39.610745614035075,1041.557017543858,28.15018966334751,0
1182,4,1,0,40,0.025,0.0,1.0,40,1000,600,400,0.6,14,6,8,336.8737244760254,0.3559561965811966,0.09869583508624347,0.22304981701379156,135862.21241151105,1153.6849078562418,137015.8973193673,1179,0,591.9,37,3,23,30.583894264479028,0.6768018018018018,39.36403508771929,1042.5438596491213,28.176861071597873,0
1183,4,0,1,39,0.0,0.025,0.975,40,600,400,200,0.6666666666666666,8,4,4,336.0655464846746,0.35610309829059833,0.09478651803554539,0.22269319035001856,135890.79241930178,1133.6426833256041,137024.43510262738,1180,1,592.9,37,3,14,30.5766247765275,0.6770833333333335,39.33662280701753,1042.6535087719274,28.179824561403443,0
1184,4,0,0,39,0.0,0.0,1.0,39,1000,700,300,0.7,13,7,6,345.564032434328,0.35239541160593796,0.09695227173892018,0.22865520001748185,135839.041638767,1588.2173981413703,137427.25903690836,1181,20,609.0769230769231,36,3,24,30.380387814626776,0.6785300925925927,39.386261261261254,1042.4549549549538,28.95708208208205,0
1185,4,0,0,39,0.0,0.0,1.0,39,1250,1000,250,0.8,15,10,5,336.1715647279021,0.3519174538911381,0.13079879296977426,0.21140638619072044,133996.38447569197,1212.0082075318628,135208.39268322382,1182,21,610.0769230769231,36,3,18,32.458442099920255,0.6603009259259258,41.15990990990991,1035.3603603603608,28.76001001001002,4
1186,4,0,0,39,0.0,0.0,1.0,39,1200,800,400,0.6666666666666666,16,8,8,336.8483104336144,0.3515800719748088,0.12648494631749996,0.212336799935432,134083.84471887437,1233.183309999195,135317.02802887358,1183,22,611.0769230769231,36,3,18,32.3536207458954,0.6611689814814814,41.075450450450454,1035.698198198199,28.769394394394414,0
1187,4,0,0,39,0.0,0.0,1.0,39,1000,800,200,0.8,12,8,4,335.5023629489601,0.3521142600089968,0.12588628762541787,0.21199325131390345,134171.3334956579,1202.9598855612435,135374.29338121915,1184,23,612.0769230769231,36,3,19,32.30117753623186,0.662037037037037,40.990990990990994,1036.0360360360366,28.778778778778797,0
1188,4,0,0,39,0.0,0.0,1.0,39,300,100,200,0.3333333333333333,5,1,4,334.77668807622945,0.35174876293297347,0.12397527850690238,0.21187173890491487,134229.67519884746,1187.3932209236227,135417.0684197711,1185,24,613.0769230769231,36,3,20,32.26178185901617,0.6626157407407407,40.93468468468468,1036.2612612612609,28.785035035035023,0
1189,4,0,0,39,0.0,0.0,1.0,39,900,500,400,0.5555555555555556,13,5,8,335.95496620047487,0.3518612235717499,0.1309296961187445,0.21295657774856536,134288.02958363757,1222.9460879798587,135510.97567161743,1186,25,614.0769230769231,36,3,20,32.17305881500798,0.6631944444444444,40.87837837837837,1036.4864864864855,28.791291291291266,0
1190,4,0,0,39,0.0,0.0,1.0,39,1000,700,300,0.7,13,7,6,336.0381830830334,0.3508209626630679,0.1247657161635658,0.21351991384716962,134375.58493882394,1231.0654827124438,135606.65042153638,1187,26,615.0769230769231,36,3,20,32.08360486586294,0.6640625,40.79391891891892,1036.8243243243242,28.80067567567567,0
1191,4,0,0,39,0.0,0.0,1.0,39,1050,1000,50,0.9523809523809523,11,10,1,334.2192370343679,0.3511864597390913,0.1240926518372496,0.21270386688662715,134433.9710276155,1186.0838456700005,135620.05487328552,1188,27,616.0769230769231,36,3,20,32.07256488218047,0.6646412037037037,40.737612612612615,1037.04954954955,28.806931931931942,0
1192,4,0,0,39,0.0,0.0,1.0,39,1250,900,350,0.72,16,9,7,331.7688424380252,0.3508771929824561,0.12212954381629104,0.21182164555658542,134550.78125000012,1128.002115290982,135678.7833652911,1189,28,617.0769230769231,35,4,22,32.01974564926371,0.6678571428571427,40.62500000000001,1037.500000000001,29.642857142857167,0
1193,4,0,0,39,0.0,0.0,1.0,39,500,100,400,0.2,9,1,8,331.8783557174846,0.35101776878092666,0.12253349922061574,0.2120662479691554,134580.80317911954,1132.891134044929,135713.69431316448,1190,29,618.0769230769231,35,4,22,31.98700966722438,0.6681547619047619,40.59606481481482,1037.615740740741,29.646164021164033,0
1194,4,0,0,39,0.0,0.0,1.0,39,650,400,250,0.6153846153846154,9,4,5,330.53990757901414,0.35141138101664415,0.11962762185777387,0.2117344207977571,134670.88906035668,1102.8206447187943,135773.70970507548,1191,30,619.0769230769231,35,4,22,31.932054713053823,0.669047619047619,40.50925925925926,1037.962962962963,29.65608465608466,0
1195,4,0,0,39,0.0,0.0,1.0,39,1100,800,300,0.7272727272727273,14,8,6,332.01907070207443,0.35062415654520923,0.12310321863326013,0.21320995585313587,134761.00508241166,1148.644734867968,135909.64981727963,1192,31,620.0769230769231,35,4,22,31.803984134061594,0.6699404761904761,40.4224537037037,1038.310185185185,29.666005291005284,0
1196,4,0,0,39,0.0,0.0,1.0,39,1200,700,500,0.5833333333333334,17,7,10,334.996966828268,0.35079284750337386,0.12740786461949938,0.21547869414695703,134821.0991753473,1232.9318576388941,136054.0310329862,1193,32,621.0769230769231,35,4,17,31.66687562688064,0.6705357142857142,40.364583333333336,1038.5416666666672,29.67261904761906,0
1197,4,0,0,39,0.0,0.0,1.0,39,850,600,250,0.7058823529411765,11,6,5,331.82853675209145,0.3510739991003149,0.12943048188675887,0.21414987594705448,134941.32754897556,1155.4766535922558,136096.80420256782,1194,33,622.0769230769231,35,4,17,31.62955794437635,0.6717261904761904,40.248842592592595,1039.0046296296302,29.685846560846578,0
1198,4,0,0,39,0.0,0.0,1.0,39,1000,800,200,0.8,12,8,4,330.805898780264,0.35014619883040937,0.13618868140026308,0.2140228365307472,135031.53399348422,1133.8455932784664,136165.3795867627,1195,34,623.0769230769231,35,4,17,31.566443949517442,0.6726190476190477,40.16203703703704,1039.351851851852,29.6957671957672,0
1199,4,0,0,39,0.0,0.0,1.0,39,1000,700,300,0.7,13,7,6,327.39290884843314,0.3498931623931624,0.1295271741545574,0.21225360495005166,135106.32253875505,1046.57038795553,136152.89292671057,1196,35,624.0769230769231,36,3,17,31.58082394569614,0.6712962962962963,40.090090090090094,1039.63963963964,28.878878878878893,0
1200,4,0,0,39,0.0,0.0,1.0,39,1500,1200,300,0.8,18,12,6,327.0289718747945,0.34930274403958617,0.12612852716793865,0.21270701297433814,135223.42443795144,1044.395493466442,136267.81993141788,1197,36,625.0769230769231,36,3,18,31.473987656994368,0.6724537037037037,39.97747747747748,1040.09009009009,28.891391391391387,0
1201,4,0,0,39,0.0,0.0,1.0,39,900,700,200,0.7777777777777778,11,7,4,326.27014939096546,0.3492183985605038,0.12385190949844782,0.21278195515951015,135319.76335266628,1030.1598809249117,136349.9232335912,1198,37,626.0769230769231,37,2,18,31.398088137141247,0.6714527027027026,39.88486842105264,1040.4605263157903,28.12055476529163,0
1202,4,0,0,39,0.0,0.0,1.0,39,1100,600,500,0.5454545454545454,16,6,10,324.5658595414601,0.3497244714349978,0.12055117132007798,0.21251229451631876,135462.40790435515,993.2945714065796,136455.70247576173,1199,38,627.0769230769231,37,2,20,31.30090934625378,0.6728603603603605,39.747807017543856,1041.0087719298242,28.135372214319574,0
1203,4,0,0,39,0.0,0.0,1.0,39,750,600,150,0.8,9,6,3,328.15404303345275,0.3497244714349978,0.11007183225468187,0.19727191010598963,132317.61203342,884.1118706597122,133201.72390407973,1200,39,628.0769230769231,39,0,21,34.34589197124634,0.6380876068376069,42.78645833333333,1028.8541666666656,26.38087606837604,7
1204,4,0,0,39,0.0,0.0,1.0,39,1000,700,300,0.7,13,7,6,328.15404303345275,0.3497244714349978,0.11007183225468187,0.19727191010598963,132317.61203342,884.1118706597122,133201.72390407973,1201,40,629.0769230769231,39,0,21,34.34589197124634,0.6380876068376069,42.78645833333333,1028.8541666666656,26.38087606837604,0
1205,4,0,0,39,0.0,0.0,1.0,39,700,500,200,0.7142857142857143,9,5,4,330.89101685409133,0.34944331983805665,0.1154482053358461,0.1992000216637154,132371.20361328125,960.0884331597222,133331.29204644097,1202,41,630.0769230769231,39,0,21,34.22168657421466,0.6386217948717949,42.734375,1029.0625,26.38621794871795,0
1206,4,0,0,39,0.0,0.0,1.0,39,900,500,400,0.5555555555555556,13,5,8,328.9563126992405,0.3494995501574449,0.10958383041997322,0.19911927009509114,132576.73852237643,922.401861496897,133499.14038387334,1203,42,631.0769230769231,35,4,22,34.06523937963587,0.6482142857142857,42.534722222222214,1029.8611111111102,29.42460317460315,0
1207,4,0,0,39,0.0,0.0,1.0,39,950,600,350,0.631578947368421,13,6,7,325.7999101019449,0.34882478632478636,0.1092013947282855,0.1976404229186068,132658.9004545085,844.0515684603411,133502.95202296882,1204,43,632.0769230769231,36,3,17,34.06413970266723,0.6469907407407408,42.45495495495495,1030.1801801801796,28.6161161161161,0
1208,4,0,0,39,0.0,0.0,1.0,39,750,300,450,0.4,12,3,9,326.63356627839966,0.34857174988753936,0.07906395783951004,0.1903845795622703,131141.34250217,767.0328776041617,131908.37537977417,1205,44,633.0769230769231,39,0,16,35.56826078850132,0.6263354700854702,43.932291666666664,1024.2708333333323,26.263354700854677,5
1209,4,1,1,39,0.025,0.025,0.975,40,700,500,200,0.7142857142857143,9,5,4,319.33899237292894,0.3545405982905983,0.06884271489534699,0.18730240541921106,131381.5158420137,391.1810980902581,131772.69694010395,1206,0,618.225,39,1,16,35.51319176319177,0.6287393162393163,43.69791666666666,1025.2083333333317,26.28739316239312,0
1210,4,0,0,39,0.0,0.0,1.0,39,700,400,300,0.5714285714285714,10,4,6,322.7727279095572,0.3485436347278452,0.07735572687798786,0.18878942313758748,131274.74500868045,674.3815104166563,131949.1265190971,1207,46,635.0769230769231,39,0,16,35.532713288608804,0.6276709401709402,43.80208333333333,1024.7916666666658,26.27670940170938,0
1211,4,0,0,39,0.0,0.0,1.0,39,750,300,450,0.4,12,3,9,321.898340934629,0.34893724696356276,0.07942464040025055,0.18854045683313955,131328.12499999974,654.8719618055261,131982.99696180527,1208,47,636.0769230769231,38,1,16,35.50135501355013,0.6299342105263159,43.749999999999986,1024.999999999998,26.97368421052626,0
1212,4,1,0,40,0.025,0.0,1.0,40,1000,800,200,0.8,12,8,4,316.6160845144766,0.35349893162393164,0.08458181079983795,0.18700849308373013,131648.63281249974,336.41493055552564,131985.04774305527,1209,0,621.15,39,1,15,35.31431858167546,0.6314102564102566,43.437499999999986,1026.249999999998,26.314102564102512,0
1213,4,0,0,40,0.0,0.0,1.0,40,850,700,150,0.8235294117647058,10,7,3,313.71226176421004,0.353792735042735,0.08262987012987022,0.18581418581418563,131755.55555555533,266.6666666666414,132022.22222222196,1210,1,622.15,39,1,15,35.281385281385276,0.6324786324786327,43.33333333333332,1026.666666666665,26.32478632478628,0
1214,4,0,0,40,0.0,0.0,1.0,40,900,700,200,0.7777777777777778,11,7,4,313.71226176421004,0.353792735042735,0.08262987012987022,0.18581418581418563,131755.55555555533,266.6666666666414,132022.22222222196,1211,2,623.15,39,1,15,35.281385281385276,0.6324786324786327,43.33333333333332,1026.666666666665,26.32478632478628,0
1215,4,0,0,40,0.0,0.0,1.0,40,950,700,250,0.7368421052631579,12,7,5,312.4364936208103,0.3536191239316239,0.08588345674003439,0.18544921075301402,131835.77609591992,238.061523437475,132073.8376193574,1212,3,624.15,39,1,15,35.23356408695945,0.6332799145299146,43.25520833333332,1026.979166666665,26.332799145299102,0
1216,4,0,0,40,0.0,0.0,1.0,40,1000,600,400,0.6,14,6,8,313.9092971046953,0.3534855769230769,0.08535181993308338,0.18684896785417046,131942.77479383664,283.61273871525805,132226.3875325519,1213,4,625.15,39,1,17,35.08831406941769,0.6343482905982908,43.15104166666666,1027.395833333332,26.34348290598287,0
1217,4,0,0,40,0.0,0.0,1.0,40,1050,800,250,0.7619047619047619,13,8,5,313.27893619103736,0.3536458333333334,0.08123416117587445,0.186736961058887,131996.29041883658,270.33148871525407,132266.62190755183,1214,5,626.15,39,1,18,35.05078982936307,0.6348824786324787,43.09895833333332,1027.604166666665,26.34882478632474,0
1218,4,0,0,40,0.0,0.0,1.0,40,950,600,350,0.631578947368421,13,6,7,314.39385394952996,0.3535389957264958,0.0844284584198558,0.18757905870156877,132032.19112507408,302.02188264257484,132334.21300771667,1215,6,627.15,40,0,18,34.986115231220545,0.6335937500000002,43.06402439024389,1027.7439024390221,25.693597560975554,0
1219,4,1,2,39,0.024390243902439025,0.04878048780487805,0.9512195121951219,41,1000,800,200,0.8,12,8,4,308.5044418183178,0.3586890243902439,0.08751419883305012,0.18547823571581268,132321.43964356548,-35.64962443313607,132285.79001913234,1216,0,612.829268292683,41,0,18,34.8474713142416,0.634908536585366,42.78273809523808,1028.8690476190454,25.09436701509867,0
1220,4,0,0,39,0.0,0.0,1.0,39,750,500,250,0.6666666666666666,10,5,5,321.57664635191634,0.35287336932073776,0.08645727794663971,0.19236130299960083,132130.126953125,697.9926215277785,132828.11957465278,1217,8,621.2307692307693,39,0,18,34.7032252617359,0.6362179487179487,42.96875,1028.125,26.362179487179485,0
1221,4,0,0,39,0.0,0.0,1.0,39,1200,900,300,0.75,15,9,6,324.66116659007963,0.352929599640126,0.08347154414570168,0.19544958347004232,132371.2036132811,795.1578776041522,133166.36149088526,1218,9,622.2307692307693,39,0,18,34.381959206397404,0.6386217948717949,42.73437499999999,1029.0624999999989,26.38621794871792,0
1222,4,0,0,39,0.0,0.0,1.0,39,900,700,200,0.7777777777777778,11,7,4,323.3186106273331,0.3535200179937022,0.08107417696458796,0.19520664987499875,132480.48159105846,766.6837613258047,133247.16535238427,1219,10,623.2307692307693,38,1,18,34.30689601494395,0.6414473684210527,42.628205128205124,1029.487179487179,27.09176788124155,0
1223,4,0,0,39,0.0,0.0,1.0,39,950,600,350,0.631578947368421,13,6,7,325.4813077284149,0.3539417453891138,0.10051427724147599,0.19292058029338505,131782.29302300382,778.5346137153167,132560.82763671913,1220,11,624.2307692307693,39,0,12,34.95242382739846,0.6327457264957264,43.307291666666686,1026.7708333333362,26.32745726495734,3
1224,4,0,0,39,0.0,0.0,1.0,39,1050,800,250,0.7619047619047619,13,8,5,324.5760877517979,0.3544478182636077,0.09131137908262232,0.1930620854890373,131916.0210503475,763.357204861145,132679.37825520866,1221,12,625.2307692307693,39,0,12,34.841225579666066,0.6340811965811964,43.17708333333335,1027.291666666669,26.340811965812026,0
1225,4,0,0,39,0.0,0.0,1.0,39,700,500,200,0.7142857142857143,9,5,4,324.94479668010433,0.35472896986054886,0.0937883419635237,0.19355407454423657,131969.53125000047,776.5625000000432,132746.0937500005,1222,13,626.2307692307693,39,0,12,34.777980535279795,0.6346153846153845,43.12500000000002,1027.5000000000036,26.34615384615394,0
1226,4,0,0,39,0.0,0.0,1.0,39,900,600,300,0.6666666666666666,12,6,6,326.56604265892264,0.3551506972559604,0.09541330173677176,0.19506983710401035,132076.58420138902,826.3454861111306,132902.92968750015,1223,14,627.2307692307693,39,0,13,34.62876638292124,0.6356837606837606,43.02083333333334,1027.9166666666679,26.356837606837637,0
1227,4,1,1,39,0.025,0.025,0.975,40,850,500,350,0.5882352941176471,12,5,7,321.3314333024277,0.35998931623931624,0.0884702745407866,0.19344840033414898,132371.85723610298,507.0477229162691,132878.90495901924,1224,0,612.525,40,0,15,34.46696622555797,0.6369791666666667,42.73373983739838,1029.0650406504076,25.72662601626019,0
1228,4,0,0,39,0.0,0.0,1.0,39,1400,900,500,0.6428571428571429,19,9,10,330.05296457769316,0.3554318488529015,0.09762075375684143,0.19827269331930059,132290.82031250015,932.5954861111262,133223.41579861127,1225,16,629.2307692307693,39,0,17,34.32395031726745,0.6378205128205128,42.81250000000001,1028.7500000000011,26.378205128205156,0
1229,4,1,2,38,0.025,0.05,0.95,40,750,500,250,0.6666666666666666,10,5,5,324.1500830619396,0.36252670940170945,0.0947521497218009,0.19597697682368662,132532.04345703137,592.0979817708472,133124.1414388022,1226,0,614.475,39,1,17,34.23379278367898,0.6402243589743589,42.57812500000001,1029.687500000001,26.402243589743613,0
1230,4,0,0,38,0.0,0.0,1.0,38,800,500,300,0.625,11,5,6,334.5513139341729,0.3519736842105263,0.10825756251092855,0.20139989098837202,132370.51647308053,1256.9460424428316,133627.46251552337,1227,18,645.4473684210526,38,0,17,34.12820978682171,0.6403508771929824,42.73504273504273,1029.0598290598286,27.080521817363913,0
1231,4,1,0,39,0.02564102564102564,0.0,1.0,39,850,600,250,0.7058823529411765,11,6,5,325.56857073061025,0.356612685560054,0.10541930852972858,0.19786445272191128,132728.0700402694,842.4204653371128,133570.49050560652,1228,0,629.8717948717949,38,1,12,34.00077760497666,0.6439144736842106,42.387820512820504,1030.4487179487166,27.117071524966228,0
1232,4,0,1,38,0.0,0.02564102564102564,0.9743589743589743,39,550,500,50,0.9090909090909091,6,5,1,344.6738750023029,0.356359649122807,0.046550016507098446,0.1978054504323557,130542.57079101236,1201.0029969394043,131743.57378795175,1229,1,630.8717948717949,37,2,11,35.71173104434908,0.623873873873874,44.51754385964911,1021.9298245614013,27.619724988145983,8
1233,4,0,0,38,0.0,0.0,1.0,38,1000,600,400,0.6,14,6,8,353.70346591383407,0.35114390706495974,0.04559373640713327,0.20302713176268458,130550.14209733375,1635.207547074091,132185.34964440783,1230,21,648.4473684210526,36,2,11,35.473370064279145,0.6258680555555556,44.51013513513513,1021.9594594594589,28.387762762762748,0
1234,4,1,0,39,0.02564102564102564,0.0,1.0,39,1400,1000,400,0.7142857142857143,18,10,8,346.8653303390388,0.35756860098965365,0.05386894708946821,0.20153587986158078,131019.23338190587,1289.2059335564716,132308.43931546234,1231,0,632.7948717948718,37,2,14,35.173570204562495,0.6286599099099099,44.051535087719294,1023.7938596491219,27.670104314841133,0
1235,4,0,0,39,0.0,0.0,1.0,39,1000,800,200,0.8,12,8,4,346.90111078094094,0.35793409806567705,0.05270365582899039,0.20244204110095748,131187.6746330601,1301.8300101954358,132489.50464325552,1232,1,633.7948717948718,37,2,15,35.002475115059404,0.6303490990990992,43.88706140350877,1024.4517543859643,27.68788525367471,0
1236,4,0,0,39,0.0,0.0,1.0,39,350,100,250,0.2857142857142857,6,1,5,345.88344729311314,0.35793409806567705,0.049624604847207765,0.20199593321917797,131215.75869498303,1277.071791320399,132492.83048630343,1233,2,634.7948717948718,37,2,15,35.000178367579906,0.6306306306306306,43.859649122807014,1024.5614035087715,27.69084874348031,0
1237,4,1,1,39,0.025,0.025,0.975,40,750,500,250,0.6666666666666666,10,5,5,339.7479146558406,0.3658253205128205,0.045177502138580294,0.19958055891089313,131440.53939673727,931.3779239765884,132371.91732071387,1234,0,619.9,37,3,15,34.930585258055316,0.632882882882883,43.64035087719297,1025.4385964912267,27.714556661925045,0
1238,4,1,0,40,0.025,0.0,1.0,40,800,500,300,0.625,11,5,6,339.7390363650545,0.3636351495726496,0.049179583110636305,0.20001627974795982,131524.881754482,936.8273170590813,132461.70907154106,1235,0,620.875,37,3,16,34.84578211295207,0.6337274774774776,43.55811403508771,1025.767543859648,27.723447131341835,0
1239,4,0,1,39,0.0,0.025,0.975,40,750,500,250,0.6666666666666666,10,5,5,340.15196170934774,0.3645699786324786,0.04598514798589637,0.2008506125954436,131637.3803117303,955.342629462891,132592.72294119318,1236,1,621.875,37,3,14,34.72181411831749,0.6348536036036037,43.44846491228069,1026.2061403508753,27.7353010905642,0
1240,4,2,1,40,0.04878048780487805,0.024390243902439025,0.975609756097561,41,1300,1200,100,0.9230769230769231,14,12,2,332.2569738624936,0.3671747967479675,0.05147840021907846,0.1981388612264924,132013.44515897785,572.4775595368345,132585.9227185147,1237,0,607.6341463414634,38,3,17,34.545994039574445,0.6367872807017545,43.08226495726495,1027.6709401709388,27.043972109761548,0
1241,4,0,0,40,0.0,0.0,1.0,40,850,500,350,0.5882352941176471,12,5,7,340.39412149452534,0.3621661324786325,0.04896200234816961,0.20248587455760042,131918.8371061287,980.8793330640053,132899.7164391927,1238,1,623.825,37,3,17,34.43214768562992,0.637668918918919,43.17434210526315,1027.3026315789464,27.764935988620174,0
1242,4,0,0,40,0.0,0.0,1.0,40,1050,900,150,0.8571428571428571,12,9,3,341.7100810725809,0.36212606837606837,0.06253199658703079,0.20432868113115543,132116.03570329322,1029.0762542320572,133145.11195752528,1239,2,624.825,37,3,17,34.199907565415245,0.6396396396396395,42.98245614035087,1028.0701754385957,27.785680417259343,0
1243,4,0,0,40,0.0,0.0,1.0,40,550,200,350,0.36363636363636365,9,2,7,341.7100810725809,0.3621661324786325,0.06253199658703079,0.20432868113115543,132116.03570329322,1029.0762542320572,133145.11195752528,1240,3,625.825,37,3,17,34.199907565415245,0.6396396396396395,42.98245614035087,1028.0701754385957,27.785680417259343,0
1244,4,0,0,40,0.0,0.0,1.0,40,1050,600,450,0.5714285714285714,15,6,9,380.32764676387035,0.3618856837606838,0.02161458333333366,0.2102988164459046,129086.92476260026,1848.2208701598395,130935.1456327601,1241,4,626.825,36,4,19,36.28356789302602,0.6111111111111112,45.94594594594594,1016.2162162162148,28.22822822822819,6
1245,4,1,1,40,0.024390243902439025,0.024390243902439025,0.975609756097561,41,850,600,250,0.7058823529411765,11,6,5,372.4094717867227,0.36780995934959354,0.018416839838970578,0.20759997885079762,129407.39300679433,1438.6092277955702,130846.0022345899,1242,0,612.5121951219512,35,6,20,36.157836613202896,0.6163690476190476,45.63078703703703,1017.4768518518512,29.070767195767175,0
1246,4,1,2,39,0.024390243902439025,0.04878048780487805,0.9512195121951219,41,800,500,300,0.625,11,5,6,370.9494535463139,0.36857215447154473,0.0192132858171854,0.20766278696670099,129573.74762854056,1413.0621753510104,130986.80980389156,1243,0,613.3658536585366,36,5,17,36.02546731556244,0.6160300925925927,45.467342342342334,1018.1306306306294,28.281406406406372,0
1247,4,2,1,40,0.04878048780487805,0.024390243902439025,0.975609756097561,41,1350,1000,350,0.7407407407407407,17,10,7,369.4164573497784,0.3728912601626016,0.02479459144724072,0.2078656782400993,129774.47041636237,1388.1650231312458,131162.6354394936,1244,0,614.2926829268292,36,5,19,35.86013483642795,0.6180555555555556,45.270270270270274,1018.9189189189193,28.303303303303313,0
1248,4,1,1,40,0.024390243902439025,0.024390243902439025,0.975609756097561,41,900,500,400,0.5555555555555556,13,5,8,372.82331461410985,0.3719512195121952,0.026101414477850193,0.21024447480201328,129860.542024288,1483.007543016009,131343.54956730403,1245,0,615.2682926829268,36,5,19,35.68574374838877,0.618923611111111,45.18581081081082,1019.2567567567585,28.312687687687735,0
1249,4,1,1,40,0.024390243902439025,0.024390243902439025,0.975609756097561,41,700,400,300,0.5714285714285714,10,4,6,370.404575300603,0.37515243902439027,0.022364905627855425,0.20964898962014145,130004.05811216628,1430.81958647838,131434.87769864468,1246,0,616.2439024390244,36,5,19,35.60139686395761,0.6203703703703705,45.04504504504505,1019.8198198198203,28.32832832832834,0
1250,4,1,0,41,0.024390243902439025,0.0,1.0,41,850,400,450,0.47058823529411764,13,4,9,373.4085316795308,0.3725609756097561,0.057786881847056826,0.2132416488678641,130351.21588059417,1535.1080273333628,131886.32390792752,1247,0,617.219512195122,35,6,21,35.17192281536892,0.625892857142857,44.704861111111114,1021.1805555555559,29.17658730158731,0
1251,4,0,0,41,0.0,0.0,1.0,41,1100,800,300,0.7272727272727273,14,8,6,370.47764648997503,0.37217987804878044,0.06003752345215796,0.21221325019902731,130469.43486636234,1467.2018336334081,131936.63669999575,1248,1,618.219512195122,35,6,21,35.126718213058425,0.6270833333333332,44.589120370370374,1021.6435185185188,29.189814814814824,0
1252,4,1,1,41,0.023809523809523808,0.023809523809523808,0.9761904761904762,42,950,500,450,0.5263157894736842,14,5,9,361.2996583381504,0.3774075687185443,0.05984102515703449,0.20847036194581245,130751.61944038658,1048.1030861943282,131799.7225265809,1249,0,604.4761904761905,36,6,16,35.0751027673787,0.6278935185185184,44.313063063063076,1022.7477477477498,28.409659659659717,0
1253,4,0,0,41,0.0,0.0,1.0,41,650,400,250,0.6153846153846154,9,4,5,369.0619208096636,0.37220528455284557,0.06248498222724308,0.21204852457190249,130587.70743580679,1438.9900280778534,132026.69746388466,1250,3,620.219512195122,35,6,16,35.04286509644058,0.6282738095238094,44.47337962962963,1022.1064814814818,29.203042328042336,0
1254,4,1,1,41,0.023809523809523808,0.023809523809523808,0.9761904761904762,42,800,400,400,0.5,12,4,8,360.3965125340257,0.3752903600464576,0.06235977438091056,0.20825966411317404,130809.21292914564,1028.6368293969958,131837.84975854264,1251,0,606.4285714285714,36,6,16,35.03985945985615,0.6284722222222221,44.25675675675677,1022.9729729729752,28.415915915915978,0
1255,4,0,0,41,0.0,0.0,1.0,41,550,400,150,0.7272727272727273,7,4,3,367.8289870028047,0.3720782520325203,0.06711665079299345,0.21198754730396477,130706.03358892752,1415.4935860339579,132121.52717496146,1252,5,622.219512195122,35,6,17,34.954371816638364,0.6294642857142856,44.35763888888889,1022.5694444444448,29.216269841269852,0
1256,4,0,1,40,0.0,0.024390243902439025,0.975609756097561,41,1400,1100,300,0.7857142857142857,17,11,6,365.4143035564382,0.3718241869918699,0.059044255600926965,0.2114046101727038,130854.01663237311,1363.1858710562387,132217.20250342935,1253,6,623.219512195122,35,6,17,34.86613876319759,0.6309523809523809,44.21296296296296,1023.1481481481482,29.232804232804234,0
1257,4,0,0,40,0.0,0.0,1.0,40,800,500,300,0.625,11,5,6,412.7080898914462,0.364957264957265,0.06903292181069975,0.22286236854138078,128144.53124999988,2714.8598251028657,130859.39107510274,1254,7,639.575,33,7,20,36.428326474622764,0.6079545454545455,46.87499999999999,1012.4999999999991,30.681818181818155,7
1258,4,1,0,41,0.024390243902439025,0.0,1.0,41,1000,700,300,0.7,13,7,6,400.2250720419629,0.3693343495934959,0.06814836873421548,0.2182533395424737,128536.57171201808,2088.7117346938694,130625.28344671195,1255,0,624.9512195121952,34,7,18,36.341913203412375,0.6096813725490196,46.488095238095234,1014.0476190476186,29.82492997198878,0
1259,4,0,0,41,0.0,0.0,1.0,41,850,400,450,0.47058823529411764,13,4,9,402.2879254097197,0.3702997967479675,0.056089262054183076,0.22021194529653443,128687.51594387757,2153.8867630385516,130841.40270691612,1256,1,625.9512195121952,34,7,19,36.13482146349095,0.6112132352941178,46.339285714285715,1014.6428571428573,29.842436974789923,0
1260,4,0,0,41,0.0,0.0,1.0,41,900,600,300,0.6666666666666666,12,6,6,406.3160481173932,0.37151930894308943,0.05845193872269383,0.22343453090865556,128868.76594387753,2272.2895408163254,131141.05548469385,1257,2,626.9512195121952,34,7,21,35.846816742877245,0.6130514705882353,46.160714285714285,1015.3571428571427,29.863445378151255,0
1261,4,1,1,41,0.023809523809523808,0.023809523809523808,0.9761904761904762,42,850,500,350,0.5882352941176471,12,5,7,407.8204783660308,0.3769962253193961,0.0614754098360657,0.22615499254843513,129201.38888888882,2139.909297052146,131341.29818594098,1258,0,613.0,31,11,21,35.46789617486339,0.6236559139784946,45.83333333333333,1016.6666666666661,32.79569892473116,0
1262,4,0,0,41,0.0,0.0,1.0,41,950,600,350,0.631578947368421,13,6,7,413.1096191388271,0.37184959349593494,0.06178252437167764,0.22891259168244274,129171.13272392283,2472.3674886621243,131643.50021258494,1259,4,628.9512195121952,34,7,21,35.36445524456416,0.6161151960784315,45.863095238095234,1016.5476190476185,29.898459383753483,0
1263,4,1,1,41,0.023809523809523808,0.023809523809523808,0.9761904761904762,42,900,400,500,0.4444444444444444,14,4,10,402.96423009458175,0.37843592721641506,0.05796889599706523,0.22541574810745396,129544.24267409173,2040.3462886380103,131584.58896272973,1260,0,614.952380952381,33,9,18,35.24073572489067,0.6221590909090908,45.49632352941177,1018.0147058823533,30.848930481283432,0
1264,4,1,1,41,0.023809523809523808,0.023809523809523808,0.9761904761904762,42,950,600,350,0.631578947368421,13,6,7,390.5297152101581,0.37846012388695316,0.07452775585372295,0.22006811473548793,129831.84831791272,1740.6389497605978,131572.4872676733,1261,0,615.9285714285714,36,6,18,35.26381215469614,0.6186342592592592,45.21396396396398,1019.1441441441459,28.30955955955961,3
1265,4,2,1,42,0.046511627906976744,0.023255813953488372,0.9767441860465116,43,950,700,250,0.7368421052631579,12,7,5,381.01065967961324,0.38505906238464377,0.08828154285797751,0.21693538990339842,130235.32238476147,1324.209219081014,131559.53160384248,1262,0,602.5581395348837,38,5,19,35.09568418114579,0.6189692982456141,44.81837606837607,1020.7264957264956,26.861223571749886,0
1266,4,1,0,43,0.023255813953488372,0.0,1.0,43,800,400,400,0.5,12,4,8,382.5058121949576,0.38441306755260246,0.06755247672174591,0.21613173185538057,129937.87140185625,1340.4067677958813,131278.27816965213,1263,0,603.5348837209302,35,8,18,35.360261285806196,0.6217261904761904,45.10995370370371,1019.560185185186,29.130291005291028,1
1267,4,0,0,43,0.0,0.0,1.0,43,600,200,400,0.3333333333333333,10,2,8,372.19485495347567,0.3844822812846069,-0.010081338068507195,0.2042042042042041,128778.125,986.1111111111113,129764.23611111111,1264,1,604.5348837209302,39,4,15,36.80555555555554,0.6025641025641025,46.25,1015.0,26.025641025641026,8
1268,4,1,1,43,0.022727272727272728,0.022727272727272728,0.9772727272727273,44,1050,800,250,0.7619047619047619,13,8,5,363.8341677555783,0.38910544397463004,-0.010696390735402295,0.20084208586706345,129020.64252635674,588.4236193733982,129609.06614573013,1265,0,591.7727272727273,40,4,16,36.770197725984474,0.6033854166666666,46.01117886178862,1015.955284552846,25.398882113821152,0
1269,4,2,1,44,0.044444444444444446,0.022222222222222223,0.9777777777777777,45,1450,1200,250,0.8275862068965517,17,12,5,360.88022508659475,0.3946759259259259,0.0036354492222583357,0.20111757408879935,129396.54659366322,339.8370365416962,129736.38363020492,1266,0,579.5777777777778,37,8,18,36.462150195782584,0.6123310810810811,45.64144736842104,1017.4342105263141,27.498221906116598,0
1270,4,0,0,44,0.0,0.0,1.0,44,1100,900,200,0.8181818181818182,13,9,4,367.98866308238945,0.3890283650458069,0.005797568242209561,0.20465970473892495,129315.90374157943,717.3573066309557,130033.26104821039,1267,1,593.6590909090909,36,8,18,36.36353151756716,0.6134259259259259,45.72072072072072,1017.1171171171172,28.253253253253256,0
1271,4,0,0,44,0.0,0.0,1.0,44,950,800,150,0.8421052631578947,11,8,3,347.99070963273624,0.38903937632135305,0.012111720055645536,0.1900384486648318,128593.16541883674,149.84537760416214,128743.0107964409,1268,2,594.6590909090909,39,5,16,37.60837099038034,0.6006944444444444,46.432291666666664,1014.2708333333328,26.006944444444432,5
1272,4,1,0,45,0.022222222222222223,0.0,1.0,45,1000,700,300,0.7,13,7,6,338.9404337556147,0.39198232323232324,0.0297289186756029,0.18710035981528853,129020.64252635646,-253.93749173774245,128766.70503461872,1269,0,582.4222222222222,40,5,18,37.402470741222366,0.6033854166666668,46.01117886178861,1015.9552845528439,25.398882113821095,0
1273,4,2,2,45,0.0425531914893617,0.0425531914893617,0.9574468085106383,47,850,500,350,0.5882352941176471,12,5,7,328.1304519265692,0.39993832870798646,0.027976089238083146,0.18313178323518708,129453.6613835346,-904.3358012064002,128549.32558232821,1270,0,558.5957446808511,41,6,15,37.23719698446741,0.60619918699187,45.58531746031745,1017.6587301587278,24.820944638017753,0
1274,4,1,1,45,0.021739130434782608,0.021739130434782608,0.9782608695652174,46,1400,1000,400,0.7142857142857143,18,10,8,334.3348072434964,0.39670893719806766,0.035428660744522444,0.1866236766854161,129459.8174449728,-543.4153777513845,128916.40206722141,1271,0,571.7173913043479,40,6,16,37.07309766327143,0.6078125000000002,45.579268292682904,1017.6829268292648,25.44207317073162,0
1275,4,0,0,45,0.0,0.0,1.0,45,1150,800,350,0.6956521739130435,15,8,7,339.8164733595696,0.39212962962962966,0.03128044062087465,0.18895034429856666,129307.31336805524,-211.84895833336856,129095.46440972187,1272,3,585.4222222222222,39,6,19,37.088624880513436,0.6079059829059832,45.72916666666665,1017.0833333333309,26.079059829059766,0
1276,4,1,0,46,0.021739130434782608,0.0,1.0,46,1150,700,450,0.6086956521739131,16,7,9,333.0574792413832,0.3953804347826087,0.03986122020335281,0.18652335855334867,129589.12854658232,-567.8743018375726,129021.25424474475,1273,0,573.6739130434783,40,6,17,36.97433210233889,0.6091145833333336,45.4522357723577,1018.1910569105659,25.454776422764148,0
1277,4,2,0,48,0.041666666666666664,0.0,1.0,48,1250,1000,250,0.8,15,10,5,325.69762598917157,0.40286088947990545,0.06369047619047663,0.18557190317987657,130262.58680555534,-1111.2661320973168,129151.32067345803,1274,0,550.7291666666666,40,8,20,36.4795918367347,0.6158854166666667,44.79166666666666,1020.8333333333317,25.520833333333293,0
1278,4,2,2,48,0.04,0.04,0.96,50,1800,1500,300,0.8333333333333334,21,15,6,314.15647508114483,0.4080867346938775,0.066496730787454,0.18106462487882674,130708.09789262945,-1787.4409402980782,128920.65695233137,1275,0,529.66,42,8,15,36.324386430398924,0.6173115079365081,44.35562015503875,1022.5775193798434,24.347083794758174,0
1279,4,1,1,48,0.02040816326530612,0.02040816326530612,0.9795918367346939,49,900,700,200,0.7777777777777778,11,7,4,317.5267867169245,0.404921343537415,0.0660309538662629,0.18269757326174768,130642.63791454061,-1503.4925949546694,129139.14531958594,1276,0,541.4489795918367,41,8,15,36.30428190198933,0.6181402439024392,44.41964285714285,1022.3214285714268,24.934668989546996,0
1280,4,0,1,47,0.0,0.020833333333333332,0.9791666666666666,48,1500,1100,400,0.7333333333333333,19,11,8,327.1937701106477,0.4024822695035461,0.06384226017206851,0.18838318406482313,130667.99433893918,-1049.2492598891492,129618.74507905003,1277,3,553.7291666666666,41,7,16,36.03159971537614,0.6183943089430894,44.394841269841265,1022.4206349206341,24.93708865660083,0
1281,4,1,0,48,0.020833333333333332,0.0,1.0,48,1250,1000,250,0.8,15,10,5,325.69310860606373,0.4005614657210402,0.08222272196446045,0.1886804673608688,130906.34694617207,-1072.9409853674665,129833.4059608046,1278,0,554.4166666666666,42,6,17,35.829348546539144,0.6192956349206349,44.161821705426355,1023.3527131782943,24.365540789959386,0
1282,4,1,0,49,0.02040816326530612,0.0,1.0,49,1200,1000,200,0.8333333333333334,14,10,4,330.19987279876074,0.4040355725623583,0.07115547442735881,0.18889236889586508,130418.24811826645,-1119.5663649876071,129298.68175327884,1279,0,544.0816326530612,40,9,17,36.207218187245054,0.6174479166666667,44.63922764227643,1021.443089430896,25.5360772357724,6
1283,4,0,0,49,0.0,0.0,1.0,49,1250,900,350,0.72,16,9,7,331.0551998703834,0.40421272675736963,0.07175328365236244,0.1900166147201245,130548.0368828081,-1156.2787114151402,129391.75817139295,1280,1,545.0816326530612,40,9,14,36.054138491116404,0.6187499999999999,44.51219512195123,1021.9512195121971,25.548780487804926,0
1284,4,3,4,48,0.057692307692307696,0.07692307692307693,0.9230769230769231,52,1200,700,500,0.5833333333333334,17,7,10,320.5962069738273,0.411371920563097,0.10997568380413392,0.18718458517268433,131206.82253106358,-1987.1180734905754,129219.704457573,1281,0,514.5769230769231,43,9,15,35.656888344578974,0.6208817829457364,43.86837121212122,1024.5265151515162,23.826198026779444,0
1285,4,0,1,47,0.0,0.020833333333333332,0.9791666666666666,48,1250,800,450,0.64,17,8,9,339.18304981594383,0.4034888445626477,0.09713313649630084,0.19619881715501775,130848.09570312501,-723.7087673611104,130124.3869357639,1282,1,547.7708333333334,39,9,15,35.54308355392655,0.6233974358974359,44.21875,1023.1250000000001,26.23397435897436,0
1286,4,1,2,46,0.020833333333333332,0.041666666666666664,0.9583333333333334,48,1000,800,200,0.8,12,8,4,332.46706784969285,0.40417220744680854,0.11419282185411239,0.19357346539268933,131099.4300063777,-882.7513818027074,130216.67862457498,1283,0,548.0208333333334,41,7,15,35.46116681197327,0.6227134146341463,43.97321428571429,1024.1071428571438,24.9782229965157,0
1287,4,0,0,46,0.0,0.0,1.0,46,1200,800,400,0.6666666666666666,16,8,8,344.814025617595,0.3975644122383253,0.1257684992702024,0.20056342436810395,131061.33355034716,-161.64279513889437,130899.69075520827,1284,3,572.5434782608696,39,7,17,35.18353679213293,0.625534188034188,44.010416666666664,1023.9583333333328,26.255341880341867,0
1288,4,0,0,46,0.0,0.0,1.0,46,1200,1000,200,0.8333333333333334,14,10,4,344.451774452795,0.3973228663446055,0.12864013296320542,0.2011892905889364,131221.37586805547,-160.11284722222666,131061.26302083324,1285,4,573.5434782608696,39,7,17,35.03117798563102,0.6271367521367521,43.854166666666664,1024.5833333333328,26.27136752136751,0
1289,4,0,1,45,0.0,0.021739130434782608,0.9782608695652174,46,1300,900,400,0.6923076923076923,17,9,8,341.39731641218884,0.3978260869565218,0.12919759632378924,0.19996128532713872,131328.12499999974,-232.89930555558465,131095.22569444415,1286,5,574.5434782608696,37,9,17,35.00169376693767,0.6317567567567569,43.749999999999986,1024.999999999998,27.70270270270265,0
1290,4,0,0,45,0.0,0.0,1.0,45,950,700,250,0.7368421052631579,12,7,5,345.6933199823875,0.3945496632996633,0.12444166434992132,0.20218843446774742,131273.37643363266,76.06586492802472,131349.4422985607,1287,6,587.8666666666667,38,7,17,34.94687413122047,0.6293859649122808,43.80341880341879,1024.7863247863233,26.968061178587458,0
1291,4,0,0,45,0.0,0.0,1.0,45,850,700,150,0.8235294117647058,10,7,3,347.35066090107176,0.39421296296296293,0.12789418210037495,0.20330292190506255,131300.74929003185,121.4804085396799,131422.22969857152,1288,7,588.8666666666667,38,7,17,34.87677646895307,0.6296600877192984,43.77670940170939,1024.89316239316,26.970872694556846,0
1292,4,2,3,44,0.0425531914893617,0.06382978723404255,0.9361702127659575,47,1350,1000,350,0.7407407407407407,17,10,7,330.831206233517,0.39760638297872336,0.13309978062326566,0.196438317872851,131849.4747256924,-676.0158470487124,131173.45887864367,1289,0,564.7659574468086,40,7,16,34.74750973019327,0.6317708333333333,43.24186991869919,1027.0325203252034,25.675813008130085,0
1293,4,1,1,44,0.022222222222222223,0.022222222222222223,0.9777777777777777,45,1100,800,300,0.7272727272727273,14,8,6,345.1799143413275,0.3998316498316498,0.13429559464742158,0.20407036535859266,131684.26890432084,90.95293209875268,131775.2218364196,1290,0,564.7333333333333,38,7,16,34.54555705908886,0.6334978070175439,43.40277777777777,1026.3888888888878,27.010233918128627,0
1294,4,0,0,44,0.0,0.0,1.0,44,1350,800,550,0.5925925925925926,19,8,11,350.35387355214306,0.39482029598308666,0.13241666423776066,0.2065697035177947,131581.12502164117,419.99136753615466,132001.11638917733,1291,10,578.5681818181819,37,7,16,34.516827865056484,0.6342905405405406,43.503289473684205,1025.9868421052624,27.72937411095304,0
1295,4,0,0,44,0.0,0.0,1.0,44,1450,1100,350,0.7586206896551724,18,11,7,350.3269028515651,0.394985465116279,0.12629626826129803,0.2072623696180933,131711.68456424863,428.4293045510975,132140.11386879973,1292,11,579.5681818181819,38,6,17,34.385841659728,0.6337719298245614,43.376068376068375,1026.495726495726,27.013045434098057,0
1296,4,1,1,44,0.022222222222222223,0.022222222222222223,0.9777777777777777,45,900,700,200,0.7777777777777778,11,7,4,346.16075252091764,0.39819023569023565,0.12184490623416111,0.20633690777153202,131996.29041883687,138.38704427083894,132134.6774631077,1293,0,567.6666666666666,39,6,18,34.206052542659236,0.6348824786324787,43.098958333333336,1027.6041666666672,26.3488247863248,0
1297,4,0,0,44,0.0,0.0,1.0,44,1100,800,300,0.7272727272727273,14,8,6,354.7937237302288,0.39414860817477093,0.12191887675507074,0.21096732552047912,131903.67408366187,559.7191403681608,132463.39322403003,1294,13,581.5681818181819,38,6,19,34.07761310452419,0.6356907894736843,43.189102564102555,1027.2435897435882,27.0327260458839,0
1298,4,0,0,44,0.0,0.0,1.0,44,1100,900,200,0.8181818181818182,13,9,4,361.4129620498689,0.3933998414376321,0.12336244541484764,0.215369880359085,131985.99810979585,740.2901051939206,132726.28821498976,1295,14,582.5681818181819,38,6,19,33.824599708879184,0.636513157894737,43.10897435897434,1027.5641025641,27.041160593792107,0
1299,4,0,0,44,0.0,0.0,1.0,44,900,800,100,0.8888888888888888,10,8,2,365.723755159755,0.3930254580690627,0.12528580336728323,0.21857105417063125,132095.80342793482,862.1146541018289,132957.91808203666,1296,15,583.5681818181819,38,6,19,33.60311439063257,0.637609649122807,43.00213675213675,1027.9914529914527,27.052406657669806,0
1300,4,1,0,45,0.022222222222222223,0.0,1.0,45,1550,1200,350,0.7741935483870968,19,12,7,349.5134680562091,0.3971590909090909,0.15246540373505346,0.2039463770947614,131183.87972009153,171.14239619435182,131355.0221162859,1297,0,571.5777777777778,36,9,16,34.939403099923055,0.6322337962962964,43.89076576576576,1024.4369369369356,28.456581581581545,4
1301,4,1,1,45,0.021739130434782608,0.021739130434782608,0.9782608695652174,46,800,600,200,0.75,10,6,4,340.83395080541055,0.3993055555555556,0.14837985242220086,0.20007145473831697,131412.43128895407,-242.0363717682598,131170.39491718583,1298,0,560.1304347826087,37,9,16,34.93109025772644,0.6326013513513514,43.667763157894726,1025.3289473684194,27.711593172119443,0
1302,4,1,1,45,0.021739130434782608,0.021739130434782608,0.9782608695652174,46,750,500,250,0.6666666666666666,10,5,5,369.6638614960162,0.39959742351046695,0.1265647995058048,0.21315798085782323,130726.51855504414,468.6559521506736,131195.1745071948,1299,0,561.1086956521739,38,8,14,34.88669208803454,0.6239035087719298,44.337606837606835,1022.6495726495722,26.911830859199267,4
1303,4,0,0,45,0.0,0.0,1.0,45,1450,900,550,0.6206896551724138,20,9,11,357.43805330020325,0.3961489898989899,-0.05328535937633827,0.20578186974714943,130665.25298524887,445.85247312856114,131111.10545837742,1300,3,574.5777777777778,36,9,15,35.26131732569665,0.6270254629629629,44.39752252252253,1022.4099099099108,28.4002752752753,8
1304,4,0,1,44,0.0,0.022222222222222223,0.9777777777777777,45,1500,1100,400,0.7333333333333333,19,11,8,355.7048969027749,0.3953493265993266,-0.0483029653447663,0.2056212322244667,130822.85534972313,306.8660549399899,131129.7214046631,1301,4,575.5777777777778,37,8,16,35.14603429796353,0.6266891891891891,44.24342105263158,1023.0263157894748,27.64935988620202,0
1305,4,1,0,45,0.022222222222222223,0.0,1.0,45,1300,1100,200,0.8461538461538461,15,11,4,358.1285197682041,0.39463383838383836,-0.026722835076695706,0.20808002421130814,131019.233381906,384.3448224453752,131403.5782043514,1302,0,576.4666666666667,37,8,17,34.88529060012139,0.6286599099099099,44.0515350877193,1023.793859649123,27.67010431484116,0
1306,4,1,0,46,0.021739130434782608,0.0,1.0,46,1150,800,350,0.6956521739130435,15,8,7,350.8920426496536,0.39670893719806766,-0.00787670415204289,0.20598788190361672,131414.71021274655,23.202607425592362,131437.91282017215,1303,0,564.9130434782609,36,10,18,34.67096833241807,0.6345486111111112,43.66554054054054,1025.337837837838,28.481606606606608,0
1307,4,1,1,46,0.02127659574468085,0.02127659574468085,0.9787234042553191,47,950,700,250,0.7368421052631579,12,7,5,339.65592811746694,0.39841581868640147,-0.008446990361883788,0.20070577570577566,131665.51246537376,-455.80563250232746,131209.70683287142,1304,0,553.8723404255319,37,10,16,34.706196581196586,0.6351351351351353,43.42105263157894,1026.3157894736826,27.738264580369798,0
1308,4,0,0,46,0.0,0.0,1.0,46,1350,1000,350,0.7407407407407407,17,10,7,348.2417780484565,0.3959440418679549,-0.014445848935104921,0.20598467273923968,131703.53366457685,-27.065452276593504,131676.46821230027,1305,2,566.9130434782609,36,10,16,34.44756811117206,0.6374421296296295,43.38400900900901,1026.4639639639647,28.51288788788791,0
1309,4,0,0,46,0.0,0.0,1.0,46,900,500,400,0.5555555555555556,13,5,8,348.2417780484565,0.3959339774557166,-0.014445848935104921,0.20598467273923968,131703.53366457685,-27.065452276593504,131676.46821230027,1306,3,567.9130434782609,36,10,16,34.44756811117206,0.6374421296296295,43.38400900900901,1026.4639639639647,28.51288788788791,0
1310,4,0,0,46,0.0,0.0,1.0,46,1400,900,500,0.6428571428571429,19,9,10,344.619140288171,0.39570249597423507,-0.006803779103507157,0.20439254267249646,131806.21831957897,-115.41087161435217,131690.80744796462,1307,4,568.9130434782609,37,9,16,34.43706620395089,0.6365427927927929,43.28399122807017,1026.8640350877183,27.753082029397792,0
1311,4,1,0,47,0.02127659574468085,0.0,1.0,47,500,200,300,0.4,8,2,6,339.0258816634061,0.3985699969164354,0.0033835559182373576,0.20246852932859277,132068.34781804733,-445.0823882314294,131623.2654298159,1308,0,557.7872340425532,38,9,17,34.316858954370645,0.6373355263157894,43.02884615384615,1027.8846153846152,27.0495951417004,0
1312,4,0,0,47,0.0,0.0,1.0,47,750,400,350,0.5333333333333333,11,4,7,337.338289762186,0.39882053654024047,-0.0050444874274659934,0.2020461131898592,132178.1873790085,-482.2472651399128,131695.9401138686,1309,1,558.7872340425532,38,9,17,34.249783549783544,0.6384320175438598,42.92200854700854,1028.3119658119645,27.06084120557801,0
1313,4,0,1,46,0.0,0.02127659574468085,0.9787234042553191,47,1550,1100,450,0.7096774193548387,20,11,9,337.01057378541327,0.39855072463768115,-0.007940217871306388,0.20259607043691572,132317.61203342004,-481.5131293402894,131836.09890407976,1310,2,559.7872340425532,39,8,17,34.11809000708718,0.6380876068376069,42.78645833333333,1028.8541666666658,26.380876068376047,0
1314,4,0,0,46,0.0,0.0,1.0,46,1150,900,250,0.782608695652174,14,9,5,334.2611093739919,0.39814814814814814,-0.01857612381862883,0.20168190104208983,132455.95838659612,-344.9516391127113,132111.0067474834,1311,3,557.3260869565217,36,10,18,34.04988513291764,0.6449652777777778,42.65202702702703,1029.3918918918923,28.59421921921923,0
1315,4,0,0,46,0.0,0.0,1.0,46,1100,800,300,0.7272727272727273,14,8,6,335.09051695648526,0.39823872785829306,-0.01743505844977311,0.20233801228640624,132484.94059938332,-321.1105531206706,132163.83004626265,1312,4,558.3260869565217,36,10,18,33.999443958287756,0.6452546296296295,42.62387387387388,1029.5045045045058,28.597347347347384,0
1316,4,0,0,46,0.0,0.0,1.0,46,1100,700,400,0.6363636363636364,15,7,8,337.1945997313795,0.3975845410628019,-0.012781990633988993,0.2040797230008913,132571.9062601453,-259.49382659686364,132312.41243354845,1313,5,559.3260869565217,36,10,19,33.8579825041006,0.6461226851851851,42.539414414414416,1029.8423423423426,28.606731731731738,0
1317,4,0,0,46,0.0,0.0,1.0,46,1450,1100,350,0.7586206896551724,18,11,7,337.9951577774218,0.3977053140096618,-0.05414377562563544,0.1990173168839387,131530.20154867688,-305.6390004869934,131224.5625481899,1314,6,560.3260869565217,36,10,19,34.88514106927215,0.6357060185185187,43.55292792792792,1025.7882882882868,28.494119119119077,4
1318,4,0,1,45,0.0,0.021739130434782608,0.9782608695652174,46,1250,900,350,0.72,16,9,7,336.94255922706293,0.3977053140096618,-0.049116452639666575,0.19869797133448341,131587.96623904296,-332.4827783865103,131255.48346065645,1315,7,561.3260869565217,36,10,17,34.85393114550176,0.6362847222222223,43.496621621621614,1026.0135135135124,28.500375375375345,0
1319,4,0,0,45,0.0,0.0,1.0,45,1250,900,350,0.72,16,9,7,345.85653939637916,0.39425505050505055,-0.04958113870077763,0.20320218428726222,131446.78605109718,92.34610768172757,131539.1321587789,1316,13,574.6444444444444,35,10,19,34.767682468021064,0.636904761904762,43.634259259259245,1025.4629629629612,29.29894179894175,0
1320,4,0,0,45,0.0,0.0,1.0,45,1350,900,450,0.6666666666666666,18,9,9,344.08661616517253,0.3938341750841751,-0.057145571348841684,0.20287450960664888,131581.12502164117,55.060811980599794,131636.18583362177,1317,14,575.6444444444444,37,8,18,34.67758095543444,0.6342905405405406,43.503289473684205,1025.9868421052624,27.72937411095304,0
1321,4,1,1,45,0.021739130434782608,0.021739130434782608,0.9782608695652174,46,1000,900,100,0.9,11,9,2,336.5510970172177,0.39587359098228664,-0.039543781261023425,0.1999754169792043,131876.23844875421,-323.38145591353515,131552.85699284068,1318,0,564.1086956521739,38,8,19,34.57371194785381,0.6354166666666669,43.21581196581195,1027.1367521367501,27.02991452991448,0
1322,4,0,0,45,0.0,0.0,1.0,45,1350,1000,350,0.7407407407407407,17,10,7,344.55213819988387,0.39358164983164984,-0.03548980796610768,0.20253251528356933,131465.0463533677,59.312563919941795,131524.35891728764,1319,1,576.7555555555556,38,7,22,34.78270305934646,0.6313048245614035,43.616452991452995,1025.5341880341884,26.98774179037338,1
1323,4,1,2,44,0.021739130434782608,0.043478260869565216,0.9565217391304348,46,900,700,200,0.7777777777777778,11,7,4,338.64611782443774,0.3973329307568438,-0.028746486393462445,0.20016077977949526,131675.35942925353,-281.7301432291638,131393.62928602437,1320,0,565.195652173913,39,7,15,34.72218698196828,0.6316773504273505,43.411458333333336,1026.354166666667,26.316773504273513,0
1324,4,0,0,44,0.0,0.0,1.0,44,950,600,350,0.631578947368421,13,6,7,348.39482890918737,0.39349894291754756,-0.023431504919912194,0.20571780465369618,131637.3803117305,372.35651835179226,132009.7368300823,1321,3,588.2727272727273,37,7,16,34.510342094953145,0.6348536036036037,43.4484649122807,1026.206140350877,27.735301090564242,0
1325,4,0,0,44,0.0,0.0,1.0,44,850,400,450,0.47058823529411764,13,4,9,347.99865840451383,0.3938953488372093,-0.023217597312438776,0.20609180510066163,131749.9269606993,369.7595654431983,132119.6865261425,1322,4,589.2727272727273,37,7,16,34.40704101249601,0.6359797297297298,43.33881578947368,1026.644736842104,27.747155049786596,0
1326,4,0,0,44,0.0,0.0,1.0,44,1400,1100,300,0.7857142857142857,17,11,6,350.4231656990978,0.393388830162086,-0.023003872395353064,0.20814291649356043,131862.52170138882,441.53645833332797,132304.05815972213,1323,5,590.2727272727273,37,7,18,34.231321839080465,0.6371058558558559,43.229166666666664,1027.0833333333328,27.759009009008995,0
1327,4,0,1,43,0.0,0.022727272727272728,0.9772727272727273,44,1100,600,500,0.5454545454545454,16,6,10,348.8091861610824,0.39326770613107825,-0.03250494703759743,0.20795417892504234,132003.33275623273,408.7950138504208,132412.12777008314,1324,6,591.2727272727273,37,7,19,34.1309218950064,0.6385135135135135,43.0921052631579,1027.6315789473688,27.773826458036993,0
1328,4,0,0,43,0.0,0.0,1.0,43,850,700,150,0.8235294117647058,10,7,3,355.828468049235,0.39061923218899963,-0.032651458555901125,0.21143397114508633,131876.9799148812,785.1167468143897,132662.0966616956,1325,22,605.8837209302326,36,7,20,34.07795197894968,0.6391782407407407,43.215090090090094,1027.1396396396403,28.531656656656676,0
1329,4,1,1,43,0.022727272727272728,0.022727272727272728,0.9772727272727273,44,1050,900,150,0.8571428571428571,12,9,3,350.5902494510208,0.39326770613107825,-0.02702165610035112,0.2099511723723931,132172.40521121898,467.6713027085441,132640.07651392752,1326,0,593.0909090909091,37,7,20,33.914925001777206,0.6402027027027026,42.92763157894738,1028.2894736842118,27.79160739687059,0
1330,4,0,0,43,0.0,0.0,1.0,43,1550,1200,350,0.7741935483870968,19,12,7,355.83644684271223,0.3898809523809524,-0.02888126041749317,0.21277567127533614,132116.0357032934,802.3401431209741,132918.37584641436,1327,24,607.8837209302326,37,6,20,33.836835182025034,0.6396396396396395,42.982456140350884,1028.0701754385973,27.785680417259385,0
1331,4,0,2,41,0.0,0.046511627906976744,0.9534883720930233,43,1250,800,450,0.64,17,8,9,353.5488635170017,0.38971945367294203,-0.037254337791010284,0.19928663956279763,129843.17440222,581.4819223222615,130424.65632454226,1328,25,608.8837209302326,37,6,20,36.194526627218934,0.6168355855855854,45.202850877192986,1019.1885964912287,27.545637743006182,5
1332,4,0,0,41,0.0,0.0,1.0,41,950,700,250,0.7368421052631579,12,7,5,356.923031937458,0.38772865853658534,-0.02640360910251549,0.20137227048515008,129878.87577428416,1071.352425197192,130950.22819948135,1329,26,611.7560975609756,35,6,20,36.07227678740396,0.6211309523809523,45.167824074074076,1019.3287037037039,29.123677248677254,0
1333,4,0,2,39,0.0,0.04878048780487805,0.9512195121951219,41,900,500,400,0.5555555555555556,13,5,8,355.52272271677737,0.3877032520325203,-0.026915664252009974,0.20073359882624195,129908.37191358028,1037.0756172839583,130945.44753086424,1330,27,612.7560975609756,35,6,20,36.077997275204375,0.6214285714285714,45.13888888888889,1019.4444444444447,29.126984126984134,0
1334,4,0,0,39,0.0,0.0,1.0,39,950,700,250,0.7368421052631579,12,7,5,360.6168767821906,0.3827597840755736,-0.01749561300123159,0.20407163142760973,129996.88042534735,1575.8138020833399,131572.69422743068,1331,28,629.8974358974359,35,4,20,35.858231188287355,0.6223214285714285,45.052083333333336,1019.7916666666677,29.13690476190479,0
1335,4,0,0,39,0.0,0.0,1.0,39,900,500,400,0.5555555555555556,13,5,8,368.97557489965953,0.38236617183985605,-0.03669272547481417,0.20321049899735275,128929.21095521539,1727.9093147675678,130657.12026998296,1332,29,630.8974358974359,34,5,19,36.7329445551518,0.6136642156862745,46.101190476190474,1015.5952380952378,29.8704481792717,3
1336,4,1,0,40,0.025,0.0,1.0,40,1150,1000,150,0.8695652173913043,13,10,3,360.99696800754344,0.3858306623931624,-0.02354730568661534,0.20051514347122432,129265.58036169766,1333.7574850494075,130599.33784674708,1333,0,616.1,32,8,20,36.592583395414295,0.6217447916666667,45.770202020202014,1016.919191919191,31.77872474747472,0
1337,4,1,0,41,0.024390243902439025,0.0,1.0,41,1300,1000,300,0.7692307692307693,16,10,6,349.60009772993476,0.3881859756097561,-0.01638150709865327,0.19571951562940007,129575.43372741247,859.9168589004128,130435.35058631288,1334,0,602.0487804878048,33,8,17,36.56716417910447,0.6224747474747474,45.4656862745098,1018.1372549019603,30.85264408793819,0
1338,4,0,1,40,0.0,0.024390243902439025,0.975609756097561,41,700,400,300,0.5714285714285714,10,4,6,348.73473498678106,0.388135162601626,-0.01884156321104946,0.19548341566690197,129625.34722222215,840.9722222222172,130466.31944444437,1335,1,603.0487804878048,34,7,17,36.538461538461554,0.6207107843137255,45.416666666666664,1018.3333333333327,29.950980392156843,0
1339,4,1,1,40,0.024390243902439025,0.024390243902439025,0.975609756097561,41,1200,700,500,0.5833333333333334,17,7,10,351.7448510801386,0.386864837398374,-0.02130976094198389,0.19793452862556893,129776.9292091835,929.673327664375,130706.60253684787,1336,0,603.9756097560976,34,7,17,36.30778517739609,0.6222426470588236,45.26785714285713,1018.92857142857,29.96848739495794,0
1340,4,2,0,42,0.047619047619047616,0.0,1.0,42,1350,1000,350,0.7407407407407407,17,10,7,314.1274822677175,0.3938129113433992,0.06038165625519332,0.17211641913678893,128725.26584201407,-286.566618835015,128438.69922317905,1337,0,590.547619047619,39,3,16,38.33273455142682,0.6020299145299145,46.30208333333334,1014.7916666666681,26.020299145299184,6
1341,4,4,3,43,0.08695652173913043,0.06521739130434782,0.9347826086956522,46,1200,800,400,0.6666666666666666,16,8,8,299.9045415846099,0.40731682769726246,0.051064643631263396,0.16441712006487452,128747.9184382086,-1459.3320401077085,127288.58639810089,1338,0,540.1086956521739,41,5,14,38.67057673509286,0.5990853658536586,46.279761904761905,1014.8809523809522,24.75319396051103,2
1342,4,1,1,43,0.022727272727272728,0.022727272727272728,0.9772727272727273,44,1300,800,500,0.6153846153846154,18,8,10,314.64010603008984,0.40231897463002114,0.04524912228281175,0.17171166324601791,128566.7534722224,-709.5486111110902,127857.2048611113,1339,0,565.6363636363636,39,5,15,38.480895645028774,0.6004273504273503,46.45833333333334,1014.1666666666681,26.00427350427354,0
1343,4,2,1,44,0.044444444444444446,0.022222222222222223,0.9777777777777777,45,1100,800,300,0.7272727272727273,14,8,6,307.42120916531815,0.40683922558922564,0.05232264593689928,0.16903936713102366,128865.81776926789,-1076.7828962588105,127789.03487300908,1340,0,554.0222222222222,40,5,16,38.36014913422082,0.6018229166666664,46.163617886178876,1015.3455284552866,25.383638211382166,0
1344,4,2,0,46,0.043478260869565216,0.0,1.0,46,1300,900,400,0.6923076923076923,17,9,8,303.009943563558,0.40979267310789047,0.06842480399144657,0.168032786885246,129201.38888888911,-1370.1388888888687,127831.25000000023,1341,0,542.9347826086956,41,5,19,38.1318306010929,0.6036585365853657,45.83333333333334,1016.6666666666684,24.796747967479718,0
1345,4,0,2,44,0.0,0.043478260869565216,0.9565217391304348,46,1300,1100,200,0.8461538461538461,15,11,4,304.9372898530942,0.4094907407407407,0.05989386055329948,0.17026881208543607,129472.44498715532,-1286.4435918814852,128186.00139527384,1342,1,543.9347826086956,42,4,14,37.80824526325812,0.6049107142857142,45.566860465116285,1017.7325581395357,24.231727574750852,4
1346,4,1,1,44,0.022222222222222223,0.022222222222222223,0.9777777777777777,45,750,300,450,0.4,12,3,9,313.15573825089547,0.4065025252525252,0.10403272939801278,0.17567523545812538,129655.65653344679,-879.5174319727806,128776.13910147401,1343,0,556.9555555555555,41,4,18,37.41354958114162,0.6082317073170731,45.386904761904766,1018.4523809523815,24.84030197444833,0
1347,4,1,0,45,0.022222222222222223,0.0,1.0,45,800,600,200,0.75,10,6,4,316.4228691380029,0.4074705387205387,0.11660069647221638,0.17842637527573252,129857.80915375426,-782.0038895187565,129075.8052642355,1344,0,557.8,41,4,19,37.12567322042695,0.6102642276422763,45.18849206349207,1019.2460317460332,24.859659310878857,0
1348,4,2,1,46,0.0425531914893617,0.02127659574468085,0.9787234042553191,47,750,400,350,0.5333333333333333,11,4,7,312.28716919531354,0.4111740672217083,0.13728611221647458,0.17876484195622422,130444.2007072513,-1250.900319890627,129193.30038736066,1345,0,535.0212765957447,40,7,20,36.63843845337579,0.6177083333333332,44.6138211382114,1021.544715447157,25.538617886178926,0
1349,4,2,2,46,0.041666666666666664,0.041666666666666664,0.9583333333333334,48,1550,1000,550,0.6451612903225806,21,10,11,305.3326100683563,0.4148751477541371,0.13871576615902015,0.17614291422466075,130744.07837498432,-1615.9138597568528,129128.16451522747,1346,0,524.8333333333334,41,7,12,36.51370566171954,0.6191565040650406,44.32043650793651,1022.7182539682545,24.944347657762307,0
1350,4,0,0,46,0.0,0.0,1.0,46,1150,700,450,0.6086956521739131,16,7,9,317.77217281204787,0.4077294685990338,0.14196255258072443,0.18251483392180287,130574.00238160166,-901.4431100865784,129672.55927151509,1347,2,548.6521739130435,40,6,14,36.367289781578336,0.6190104166666666,44.486788617886184,1022.0528455284561,25.551321138211403,0
1351,4,0,0,46,0.0,0.0,1.0,46,1200,800,400,0.6666666666666666,16,8,8,315.95556834035875,0.40757850241545895,0.15113218926476213,0.18227117817687513,130744.07837498422,-938.1360819790913,129805.94229300514,1348,3,549.6521739130435,41,5,14,36.24209832832154,0.6191565040650406,44.320436507936506,1022.7182539682537,24.944347657762286,0
1352,4,0,0,46,0.0,0.0,1.0,46,1200,800,400,0.6666666666666666,16,8,8,316.9474160137045,0.4077999194847021,0.15562737979279118,0.18308374266203425,130794.81336805566,-908.9843749999945,129885.82899305566,1349,4,550.6521739130435,41,5,15,36.16556347589952,0.6196646341463414,44.270833333333336,1022.9166666666675,24.94918699186994,0
1353,4,0,0,46,0.0,0.0,1.0,46,1200,1000,200,0.8333333333333334,14,10,4,316.54901705978483,0.4080716586151369,0.15262918279080284,0.18321473411642117,130870.93431122466,-914.5868764172219,129956.34743480744,1350,5,551.6521739130435,41,5,15,36.098991661818864,0.6204268292682926,44.19642857142858,1023.214285714287,24.95644599303139,0
1354,4,0,0,46,0.0,0.0,1.0,46,1400,1000,400,0.7142857142857143,18,10,8,321.2410144378426,0.4072463768115942,0.1515485041618494,0.18682189320664183,131055.13232565642,-779.9432688840889,130275.18905677233,1351,6,552.6521739130435,42,4,16,35.79323207469796,0.6207837301587302,44.01647286821705,1023.9341085271311,24.379383536360265,0
1355,4,2,1,47,0.041666666666666664,0.020833333333333332,0.9791666666666666,48,850,700,150,0.8235294117647058,10,7,3,330.0824661972104,0.41412714243498816,0.18547639696629648,0.18819885114594856,130289.17236328109,-912.1737881611274,129376.99857511996,1352,0,530.5833333333334,39,9,18,36.34078580416964,0.6177884615384617,44.76562499999999,1020.9374999999987,26.177884615384585,5
1356,4,0,0,47,0.0,0.0,1.0,47,1450,1100,350,0.7586206896551724,18,11,7,331.7925073567435,0.4109235275979031,0.1873608078247173,0.1893032687491729,130315.76063368015,-752.4414062500399,129563.31922743011,1353,1,542.5531914893617,39,8,18,36.27023396585732,0.6180555555555558,44.739583333333314,1021.0416666666634,26.180555555555472,0
1357,4,0,0,47,0.0,0.0,1.0,47,1300,900,400,0.6923076923076923,17,9,8,335.2124838010788,0.41086571076164047,0.1858783810172675,0.1917790907907453,130422.1408420137,-656.1740451389076,129765.9667968748,1354,2,543.5531914893617,39,8,18,36.07527704126724,0.6191239316239316,44.63541666666666,1021.4583333333318,26.191239316239276,0
1358,4,1,0,48,0.020833333333333332,0.0,1.0,48,1100,600,500,0.5454545454545454,16,6,10,327.2223838640492,0.41394244976359335,0.19328738201689055,0.1889554385307891,130781.8193225758,-1041.0522630378778,129740.76705953792,1355,0,533.2083333333334,40,8,16,35.91592151018382,0.62109375,44.28353658536585,1022.8658536585363,25.571646341463406,0
1359,4,1,1,48,0.02040816326530612,0.02040816326530612,0.9795918367346939,49,1100,700,400,0.6363636363636364,15,7,8,325.40195909037,0.41609977324263037,0.20609002996781856,0.1895852046077297,131124.8307193244,-1266.34463970777,129858.48607961665,1356,0,523.3061224489796,41,8,18,35.61644388479917,0.6229674796747968,43.94841269841268,1024.2063492063462,24.98064266356942,0
1360,4,0,1,47,0.0,0.020833333333333332,0.9791666666666666,48,850,500,350,0.5882352941176471,12,5,7,331.06674382716045,0.41438571217494086,0.2082051917989418,0.1931222672325103,131171.9214753124,-914.6678151232666,130257.25366018915,1357,1,533.5,40,8,19,35.423900462962976,0.625,43.90243902439025,1024.3902439024396,25.60975609756099,0
1361,4,0,0,47,0.0,0.0,1.0,47,1350,900,450,0.6666666666666666,18,9,9,328.9060560661294,0.41612704286154795,0.20013324911527763,0.19210926172603626,131221.37586805565,-768.098958333324,130453.27690972232,1358,2,532.1702127659574,39,8,19,35.42937508472279,0.6271367521367521,43.85416666666667,1024.5833333333342,26.271367521367544,0
1362,4,0,0,47,0.0,0.0,1.0,47,1500,1200,300,0.8,18,12,6,327.46333770224635,0.41610777058279375,0.19870986715913452,0.1916663759460086,131301.43364800356,-800.7188585069332,130500.71478949662,1359,3,533.1702127659574,39,8,19,35.3856464071552,0.6279380341880341,43.77604166666667,1024.8958333333342,26.279380341880362,0
1363,4,1,2,46,0.020833333333333332,0.041666666666666664,0.9583333333333334,48,1600,1100,500,0.6875,21,11,10,319.1417286645266,0.4188183362884161,0.20351262967974715,0.18867658998646827,131684.268904321,-1194.8055314428987,130489.46337287812,1360,0,523.0416666666666,38,10,16,35.21368967072621,0.6334978070175439,43.40277777777778,1026.3888888888891,27.010233918128662,0
1364,4,0,0,46,0.0,0.0,1.0,46,800,500,300,0.625,11,5,6,326.6336595016097,0.4135366344605475,0.21410918111838417,0.19286841761990922,131637.38031173032,-600.5601483148869,131036.82016341542,1361,5,545.5217391304348,37,9,16,35.06862823663498,0.6348536036036037,43.44846491228069,1026.2061403508756,27.735301090564203,0
1365,4,0,0,46,0.0,0.0,1.0,46,1450,1300,150,0.896551724137931,16,13,3,332.4353237865542,0.41334541062801927,0.21854499872327593,0.19716635891457113,131806.218319579,-436.5914271699062,131369.62689240908,1362,6,546.5217391304348,37,9,16,34.74984427834135,0.6365427927927929,43.28399122807017,1026.8640350877185,27.7530820293978,0
1366,4,0,0,46,0.0,0.0,1.0,46,1300,1000,300,0.7692307692307693,16,10,6,330.8012814099775,0.41334541062801927,0.2155120556854624,0.19641709192057516,131848.80566741532,-476.8492265687896,131371.95644084652,1363,7,547.5217391304348,38,8,16,34.74895107319949,0.6351425438596492,43.24252136752136,1027.0299145299136,27.027103013945094,0
1367,4,1,2,45,0.02127659574468085,0.0425531914893617,0.9574468085106383,47,1400,800,600,0.5714285714285714,20,8,12,326.00261112888916,0.4143539932161579,0.12206613170406411,0.1978015842984484,132666.15125868036,-740.1643840971972,131925.98687458315,1364,0,536.8510638297872,39,8,11,34.05165149983147,0.6415598290598292,42.44791666666666,1030.2083333333317,26.415598290598247,3
1368,4,0,0,45,0.0,0.0,1.0,45,900,500,400,0.5555555555555556,13,5,8,334.4015805897211,0.40963804713804713,0.13124149599498347,0.20221282957617961,132539.10007165655,-135.74308921977433,132403.35698243676,1365,10,561.5333333333333,37,8,18,33.96281457423775,0.6438626126126127,42.571271929824555,1029.714912280701,27.83013276434327,0
1369,4,0,1,44,0.0,0.022222222222222223,0.9777777777777777,45,1150,900,250,0.782608695652174,14,9,5,336.3210086537047,0.4082281144781145,0.13076068194178458,0.2044466260884551,132736.76155163112,-71.56769390583085,132665.1938577253,1366,11,562.5333333333333,37,8,15,33.715063488685544,0.6458333333333334,42.379385964912274,1030.4824561403498,27.850877192982427,0
1370,4,0,0,44,0.0,0.0,1.0,44,1150,700,450,0.6086956521739131,16,7,9,339.9970316411058,0.4047414552501762,0.14809594723965525,0.20714919601153844,132821.5187004656,231.78441924438872,133053.30311970998,1367,12,575.8181818181819,37,7,16,33.535328688437396,0.6466779279279279,42.29714912280702,1030.8114035087724,27.859767662399253,0
1371,4,0,0,44,0.0,0.0,1.0,44,1100,800,300,0.7272727272727273,14,8,6,338.263568247835,0.40490662438336855,0.14431806096700273,0.20640443427867577,132878.0384950178,189.5598886195856,133067.59838363738,1368,13,576.8181818181819,37,7,17,33.52332145769081,0.6472409909909909,42.242324561403514,1031.0307017543867,27.86569464201045,0
1372,4,1,1,44,0.022222222222222223,0.022222222222222223,0.9777777777777777,45,1350,800,550,0.5925925925925926,19,8,11,330.9837657758394,0.4062079124579125,0.1407461056503998,0.20414537946544273,133279.09412895388,-177.35670520126044,133101.7374237526,1369,0,564.9777777777778,38,7,19,33.30940679427487,0.6493969298245614,41.85363247863248,1032.5854700854698,27.173301844354466,0
1373,4,0,0,44,0.0,0.0,1.0,44,1000,700,300,0.7,13,7,6,337.57963543897966,0.4015812191684285,0.14406652826727195,0.2078686898402872,133217.40974386342,194.2969230917124,133411.70666695514,1370,1,578.1590909090909,37,7,19,33.200898389095414,0.6506193693693694,41.91337719298245,1032.3464912280697,27.90125651967756,0
1374,4,0,0,44,0.0,0.0,1.0,44,1100,700,400,0.6363636363636364,15,7,8,335.60585534787924,0.4019556025369979,0.13625985886259828,0.206967933189979,133274.01369892657,145.50787261464643,133419.52157154123,1371,2,579.1590909090909,37,7,19,33.195174507097086,0.6511824324324325,41.858552631578945,1032.5657894736842,27.90718349928876,0
1375,4,0,1,43,0.0,0.022727272727272728,0.9772727272727273,44,900,600,300,0.6666666666666666,12,6,6,334.01822122931003,0.40246212121212116,0.01769714435420533,0.2062354497625813,133318.49666950124,106.16142290250946,133424.65809240376,1372,3,580.1590909090909,41,3,18,33.19164265129684,0.6448170731707317,41.8154761904762,1032.738095238096,25.188734030197466,7
1376,4,0,0,43,0.0,0.0,1.0,43,1150,700,450,0.6086956521739131,16,7,9,337.4276645757267,0.3987864525655223,0.023596835140287986,0.20817258650600867,133288.51176754935,395.0462480997054,133683.55801564906,1373,4,594.2558139534884,40,3,18,33.13363186038121,0.6460937499999999,41.844512195121965,1032.6219512195144,25.81554878048786,0
1377,4,0,1,42,0.0,0.023255813953488372,0.9767441860465116,43,1150,800,350,0.6956521739130435,15,8,7,339.5388775804243,0.39867109634551495,0.014477401937793788,0.21006772310438343,133393.47367844897,458.45406586690757,133851.92774431588,1374,5,595.2558139534884,40,3,18,32.974053123462866,0.6471354166666665,41.7428861788618,1033.028455284555,25.825711382113877,0
1378,4,0,1,41,0.0,0.023809523809523808,0.9761904761904762,42,1000,600,400,0.6,14,6,8,350.1505244802092,0.39601480836236935,0.017039725751159418,0.21677858313325332,133418.40820312515,943.3051215277936,134361.71332465293,1375,23,610.3095238095239,39,3,19,32.67501848490961,0.6490384615384615,41.71875000000001,1033.1250000000011,26.490384615384645,0
1379,4,0,0,41,0.0,0.0,1.0,41,1000,800,200,0.8,12,8,4,348.4126344200386,0.3914634146341463,0.03016047983522463,0.21634634334935993,133528.8802804709,1104.6406406298095,134633.52092110072,1376,24,625.6341463414634,37,4,20,32.60927222575853,0.6537162162162162,41.61184210526316,1033.5526315789475,27.93385490753912,0
1380,4,0,0,41,0.0,0.0,1.0,41,550,400,150,0.7272727272727273,7,4,3,342.9739184767907,0.39148882113821143,0.04578887392520481,0.20967240247349317,132948.3427044524,919.5628104682487,133867.90551492065,1377,25,626.6341463414634,38,3,19,33.33139093200733,0.6461074561403508,42.174145299145295,1031.303418803418,27.139563652721527,1
1381,4,0,1,40,0.0,0.024390243902439025,0.975609756097561,41,750,600,150,0.8,9,6,3,344.5381455126784,0.3909298780487805,0.040919023379772934,0.21093949238585347,133003.43940618375,964.9516719628853,133968.39107814664,1378,26,627.6341463414634,38,3,20,33.235801829794575,0.6466557017543859,42.120726495726494,1031.5170940170938,27.145186684660363,0
1382,4,0,0,40,0.0,0.0,1.0,40,800,600,200,0.75,10,6,4,350.12025073812225,0.38795405982905984,0.04708634623564434,0.21380070376242213,132906.30290089257,1306.6376192674643,134212.94052016002,1379,27,643.325,37,3,20,33.189334325818805,0.6475225225225225,42.21491228070175,1031.1403508771928,27.86865813181602,0
1383,4,0,0,40,0.0,0.0,1.0,40,1500,1100,400,0.7333333333333333,19,11,8,353.1301066877776,0.38735309829059833,0.04830499468650351,0.2166202284179913,133075.95245652506,1398.6250577100598,134474.57751423513,1380,28,644.325,37,3,20,32.94146298264258,0.6492117117117117,42.050438596491226,1031.7982456140348,27.88643907064959,0
1384,4,0,0,40,0.0,0.0,1.0,40,1050,700,350,0.6666666666666666,14,7,7,353.86132288505354,0.3870192307692308,0.043766599383831206,0.21756346390052322,133160.81781173064,1424.092629462927,134584.91044119356,1381,29,645.325,37,3,21,32.83745440702575,0.6500563063063062,41.96820175438597,1032.127192982457,27.895329540066406,0
1385,4,0,1,39,0.0,0.025,0.975,40,1000,800,200,0.8,12,8,4,354.46778242266464,0.3865518162393162,0.04232851985559538,0.2187665514322842,133302.32018505703,1450.2755655586443,134752.59575061567,1382,30,646.325,37,3,22,32.67988603383592,0.6514639639639639,41.8311403508772,1032.675438596492,27.91014698909438,0
1386,4,1,0,40,0.025,0.0,1.0,40,950,700,250,0.7368421052631579,12,7,5,351.053903752818,0.38627136752136754,0.06502614663906758,0.21816680992194443,133559.5112637978,1377.4257688661412,134936.93703266393,1383,0,646.55,36,4,23,32.510349711297536,0.6559606481481481,41.58220720720722,1033.6711711711728,28.71308808808813,0
1387,4,0,0,40,0.0,0.0,1.0,40,1200,1000,200,0.8333333333333334,14,10,4,350.69715410446923,0.3863648504273504,0.06375394837163739,0.21828817436156858,133617.71981018202,1371.8708150718564,134989.59062525388,1384,1,647.55,36,4,23,32.461287804523856,0.6565393518518517,41.525900900900915,1033.8963963963981,28.719344344344393,0
1388,4,0,0,40,0.0,0.0,1.0,40,1050,800,250,0.7619047619047619,13,8,5,348.35097986319334,0.3868322649572649,0.06863161332462453,0.21768381639614265,133763.2966581448,1319.3150921191632,135082.61175026395,1385,2,648.55,36,4,19,32.376260976848826,0.657986111111111,41.385135135135144,1034.4594594594607,28.73498498498502,0
1389,4,0,1,39,0.0,0.025,0.975,40,1100,700,400,0.6363636363636364,15,7,8,347.7295113538487,0.3858306623931624,0.06404362963768873,0.21815576374424778,133908.952766111,1312.8189422530993,135221.7717083641,1386,3,649.55,36,4,19,32.246672469444746,0.6594328703703702,41.24436936936939,1035.022522522525,28.75062562562569,0
1390,4,0,0,39,0.0,0.0,1.0,39,1050,400,650,0.38095238095238093,17,4,13,355.4998930750964,0.38121345029239767,0.06737008795634836,0.22219986323812693,133771.38658479095,1711.1427254801251,135482.5293102711,1387,42,667.1282051282051,35,4,19,32.183281121802025,0.6601190476190475,41.377314814814824,1034.490740740742,29.556878306878342,0
1391,4,0,0,39,0.0,0.0,1.0,39,700,400,300,0.5714285714285714,10,4,6,352.94254806212547,0.3805386864597391,0.06347594917106192,0.221139405902135,133861.20119866694,1649.0626875428802,135510.2638862098,1388,43,668.1282051282051,35,4,19,32.15955057227007,0.6610119047619047,41.29050925925927,1034.8379629629637,29.566798941798965,0
1392,4,0,0,39,0.0,0.0,1.0,39,1200,700,500,0.5833333333333334,17,7,10,356.10762974962665,0.3803418803418803,0.07565285744982364,0.22129377888264512,133557.21381819385,1712.148569752205,135269.36238794605,1389,44,669.1282051282051,37,2,19,32.38205420600402,0.6539977477477479,41.58442982456139,1033.6622807017527,27.936818397344666,1
1393,4,0,0,39,0.0,0.0,1.0,39,800,400,400,0.5,12,4,8,356.7448729929552,0.38039811066126855,0.07711880994323761,0.2225408493432241,133698.92659279765,1739.2813173283917,135438.20791012605,1390,45,670.1282051282051,37,2,19,32.22363584959004,0.6554054054054055,41.44736842105262,1034.2105263157882,27.951635846372653,0
1394,4,0,0,39,0.0,0.0,1.0,39,950,800,150,0.8421052631578947,11,8,3,359.1625292177058,0.38000449842555106,0.07874118462353774,0.22456583586276016,133783.99032635018,1810.039266889787,135594.02959323997,1391,46,671.1282051282051,37,2,16,32.07593623034799,0.6562500000000002,41.365131578947356,1034.5394736842086,27.960526315789423,0
1395,4,0,0,39,0.0,0.0,1.0,39,1200,700,500,0.5833333333333334,17,7,10,360.84979447402173,0.3796108861898336,0.07974310072212165,0.226142122194277,133869.0811114956,1861.3260811018438,135730.40719259743,1392,47,672.1282051282051,37,2,17,31.94709331072967,0.6570945945945947,41.28289473684209,1034.8684210526294,27.9694167852062,0
1396,4,0,0,39,0.0,0.0,1.0,39,1000,600,400,0.6,14,6,8,372.41369892525523,0.3796108861898336,0.11259741413918523,0.21866564343211334,131422.3514543687,1995.6220130715199,133417.97346744023,1393,48,673.1282051282051,33,6,22,34.11156428030755,0.6410984848484846,43.65808823529413,1025.3676470588252,31.071746880570462,5
1397,4,0,0,39,0.0,0.0,1.0,39,1150,600,550,0.5217391304347826,17,6,11,369.07644584903727,0.37887989203778677,0.11077731536348523,0.21777851170500317,131610.9057363757,1914.897064830866,133525.80280120656,1394,49,674.1282051282051,33,6,17,34.00650404076596,0.6429924242424241,43.47426470588237,1026.1029411764728,31.094028520499176,0
1398,4,0,0,39,0.0,0.0,1.0,39,800,600,200,0.75,10,6,4,366.66221677473635,0.3795546558704453,0.10580566112925172,0.21682864424086284,131694.45153061242,1857.475907029498,133551.92743764192,1395,50,675.1282051282051,34,5,17,33.984042758833986,0.6415441176470587,43.39285714285715,1026.428571428573,30.189075630252145,0
1399,4,0,0,39,0.0,0.0,1.0,39,600,300,300,0.5,9,3,6,352.3113357565445,0.37938596491228066,0.10360112832912072,0.20588830083807283,131241.56832085442,1447.5784483807847,132689.1467692352,1396,51,676.1282051282051,36,3,19,34.80945708319595,0.6328125000000002,43.834459459459445,1024.6621621621603,28.462837837837785,5
1400,4,0,0,39,0.0,0.0,1.0,39,1150,900,250,0.782608695652174,14,9,5,353.19961357324013,0.3793016194331984,0.10707805015497351,0.20656275601005658,131270.41737683603,1472.9321382192666,132743.3495150553,1397,52,677.1282051282051,36,3,19,34.757554945054935,0.6331018518518521,43.80630630630629,1024.7747747747726,28.465965965965907,0
1401,4,0,0,39,0.0,0.0,1.0,39,1300,1000,300,0.7692307692307693,16,10,6,353.01570736872804,0.3799763832658569,0.08077846437957281,0.19533824396093016,129115.53603857236,1320.7846359873422,130436.3206745597,1398,53,678.1282051282051,36,3,15,36.948291782086805,0.611400462962963,45.917792792792795,1016.3288288288289,28.231356356356358,8
1402,4,3,2,40,0.07142857142857142,0.047619047619047616,0.9523809523809523,42,1150,800,350,0.6956521739130435,15,8,7,331.8198299814551,0.3894091173054588,0.07229012426804537,0.18688505450250878,129811.04736328137,214.7759331597359,130025.8232964411,1399,0,630.6190476190476,39,3,14,36.78074636273809,0.6129807692307692,45.23437500000001,1019.0625000000009,26.129807692307715,0
1403,4,0,0,40,0.0,0.0,1.0,40,1250,700,550,0.56,18,7,11,344.0835924360555,0.3825186965811966,0.07835917312661533,0.19298601488804842,129647.68005540158,921.927900892575,130569.60795629416,1400,1,663.15,37,3,15,36.6341874820557,0.6148648648648649,45.39473684210526,1018.4210526315783,27.52489331436698,0
1404,4,0,0,40,0.0,0.0,1.0,40,650,300,350,0.46153846153846156,10,3,7,344.221482999448,0.3823183760683761,0.07427333405102843,0.19320080698379885,129675.59880203517,927.4253856955931,130603.02418773076,1401,2,664.15,37,3,16,36.60232084544444,0.6151463963963963,45.36732456140351,1018.5307017543854,27.52785680417258,0
1405,4,2,1,41,0.047619047619047616,0.023809523809523808,0.9761904761904762,42,1050,900,150,0.8571428571428571,12,9,3,334.56344803112256,0.38948170731707316,0.08971218616044085,0.1903631047508096,130209.42382812513,312.66276041667925,130522.08658854182,1402,0,633.4761904761905,39,3,19,36.30715452133089,0.6169871794871794,44.84375000000001,1020.625000000001,26.16987179487182,0
1406,4,0,0,41,0.0,0.0,1.0,41,900,700,200,0.7777777777777778,11,7,4,336.3467444344031,0.3876524390243902,0.08939431447259927,0.19190840815281118,130317.12420784925,566.3480942727579,130883.47230212201,1403,1,634.7560975609756,38,3,19,36.152601932266045,0.6197916666666667,44.73824786324786,1021.0470085470076,26.869658119658094,0
1407,4,2,1,42,0.046511627906976744,0.023255813953488372,0.9767441860465116,43,1500,1400,100,0.9333333333333333,16,14,2,323.4430438541161,0.397171465485419,0.09580000046202053,0.1870247629224232,130833.79937743739,-136.5435380725744,130697.25583936482,1404,0,606.1860465116279,40,3,13,35.960108936790185,0.6216145833333333,44.232723577235774,1023.0691056910571,25.576727642276428,0
1408,4,0,2,40,0.0,0.047619047619047616,0.9523809523809523,42,1350,1100,250,0.8148148148148148,16,11,5,333.0634979076172,0.39186507936507936,0.09260573207131317,0.1925876067453175,130833.79937743722,315.1925730385234,131148.99195047573,1405,1,621.6190476190476,40,2,13,35.71404920366877,0.6216145833333333,44.23272357723577,1023.0691056910556,25.57672764227639,0
1409,4,0,0,40,0.0,0.0,1.0,40,500,300,200,0.6,7,3,4,346.6673960853831,0.3843883547008547,0.09388331242158099,0.1987726004892448,130508.0950032873,1048.5802925706757,131556.67529585797,1406,2,653.55,38,2,14,35.69570786281891,0.6217105263157894,44.55128205128205,1021.7948717948716,26.88933873144399,0
1410,4,0,0,40,0.0,0.0,1.0,40,1050,600,450,0.5714285714285714,15,6,9,361.35757700130796,0.38426816239316236,0.10266118563392523,0.1964934965764756,128422.23087873169,1294.855076596144,129717.08595532783,1407,3,654.55,37,3,17,37.4441078898024,0.6024774774774776,46.600877192982445,1013.5964912280683,27.394499762920766,4
1411,4,1,1,40,0.024390243902439025,0.024390243902439025,0.975609756097561,41,750,700,50,0.9333333333333333,8,7,1,356.68061763612207,0.39024390243902435,0.10153739452086463,0.19497308373373487,128631.77237426018,976.092003616022,129607.8643778762,1408,0,639.560975609756,38,3,17,37.348604528699305,0.602796052631579,46.39423076923076,1014.4230769230755,26.69534412955462,0
1412,4,2,2,40,0.047619047619047616,0.047619047619047616,0.9523809523809523,42,1450,1100,350,0.7586206896551724,18,11,7,351.8183215349034,0.3913448509485095,0.11163445995770904,0.1939276683599119,128963.21750217004,674.3245442708227,129637.54204644087,1409,0,625.2857142857143,39,3,18,37.133905069565515,0.6044337606837608,46.06770833333333,1015.7291666666658,26.044337606837587,0
1413,4,2,0,42,0.047619047619047616,0.0,1.0,42,850,800,50,0.9411764705882353,9,8,1,351.82836869528904,0.3923127177700348,0.1332731795347022,0.1955418011211574,129289.65627411232,698.4326774690933,129988.08895158142,1410,0,626.0,35,7,21,36.80116934107202,0.6151785714285716,45.74652777777776,1017.0138888888862,29.057539682539606,0
1414,4,1,0,43,0.023255813953488372,0.0,1.0,43,1100,900,200,0.8181818181818182,13,9,4,344.4107756242675,0.39571797711332596,0.14556471087564216,0.19338117401659344,129690.63321827706,333.3703155818082,130024.00353385886,1411,0,612.4186046511628,38,5,16,36.582232011747415,0.6134868421052634,45.35256410256408,1018.5897435897405,26.80499325236159,0
1415,4,1,0,44,0.022727272727272728,0.0,1.0,44,1650,1300,350,0.7878787878787878,20,13,7,335.96853774189435,0.39964323467230445,0.15663992869875232,0.19038217138707308,130049.99999999974,-61.45833333336435,129988.54166666638,1412,0,599.4772727272727,39,5,17,36.43280228758167,0.6153846153846155,44.999999999999986,1019.999999999998,26.1538461538461,0
1416,4,0,1,43,0.0,0.022727272727272728,0.9772727272727273,44,1000,700,300,0.7,13,7,6,336.2301007395732,0.39979739252995067,0.1603342054964838,0.19131141272046076,130209.42382812485,-43.934461805569754,130165.48936631928,1413,1,600.4772727272727,39,5,17,36.264628835816836,0.6169871794871796,44.84374999999999,1020.6249999999989,26.169871794871767,0
1417,4,0,0,43,0.0,0.0,1.0,43,1100,700,400,0.6363636363636364,15,7,8,338.23075719464805,0.40162421557770395,0.1653680172620473,0.19299049086988754,130318.5595567868,215.55986577602187,130534.11942256283,1414,2,600.2558139534884,37,6,17,36.10305698739978,0.6216216216216215,44.736842105263165,1021.0526315789482,27.596017069701304,0
1418,4,0,0,43,0.0,0.0,1.0,43,900,600,300,0.6666666666666666,12,6,6,338.41859449009627,0.4017395717977113,0.17033629449543342,0.19379508573228188,130458.54403518388,229.91942232224824,130688.46345750612,1415,3,601.2558139534884,37,6,17,35.9565623770169,0.6230292792792793,44.59978070175438,1021.6008771929822,27.61083451872925,0
1419,4,0,0,43,0.0,0.0,1.0,43,1650,1300,350,0.7878787878787878,20,13,7,346.6926831981332,0.4016472868217054,0.17110671639922925,0.19472642242507,129703.52055440134,393.4523122499211,130096.97286665127,1416,4,602.2558139534884,37,6,17,36.5110333692142,0.6154279279279279,45.33991228070175,1018.6403508771929,27.530820293978184,3
1420,4,2,2,43,0.044444444444444446,0.044444444444444446,0.9555555555555556,45,1150,800,350,0.6956521739130435,15,8,7,334.3987037483818,0.40852272727272726,0.1707545029717341,0.19000984349879063,130156.27170138898,-295.18229166666197,129861.08940972232,1417,0,576.4444444444445,39,6,17,36.36518306791886,0.6164529914529915,44.895833333333336,1020.4166666666674,26.164529914529933,0
1421,4,1,0,44,0.022727272727272728,0.0,1.0,44,1450,700,750,0.4827586206896552,22,7,15,342.40190369449346,0.40250616631430586,0.18518690374549895,0.19455736940784596,130156.2717013891,113.15104166668658,130269.42274305578,1418,0,590.5227272727273,39,5,20,36.16101810262692,0.6164529914529913,44.89583333333334,1020.4166666666683,26.164529914529957,0
1422,4,0,0,44,0.0,0.0,1.0,44,1250,900,350,0.72,16,9,7,345.0229071220322,0.4030897639182523,0.18747680890538,0.19658281917418144,130262.5868055558,188.71527777780287,130451.3020833336,1419,1,591.5227272727273,40,4,20,35.98639455782313,0.6158854166666665,44.79166666666668,1020.8333333333353,25.520833333333382,0
1423,4,0,0,44,0.0,0.0,1.0,44,1700,1200,500,0.7058823529411765,22,12,10,345.5588442959077,0.40306774136715995,0.18907112832770157,0.19748777474527776,130380.7656035665,210.84533607681476,130591.61093964332,1420,2,592.5227272727273,35,9,21,35.85297673012995,0.6261904761904762,44.675925925925924,1021.2962962962961,29.179894179894173,0
1424,4,1,1,44,0.022222222222222223,0.022222222222222223,0.9777777777777777,45,1400,1000,400,0.7142857142857143,18,10,8,338.4117409709229,0.406986531986532,0.19164279944187412,0.19468325630760716,130636.47050766999,-158.2169162405459,130478.25359142944,1421,0,580.3333333333334,36,9,17,35.776740471469495,0.626736111111111,44.425675675675684,1022.2972972972985,28.39714714714718,0
1425,4,2,2,44,0.043478260869565216,0.043478260869565216,0.9565217391304348,46,1250,900,350,0.72,16,9,7,335.33546540255026,0.40845410628019324,0.2120530935559839,0.19554955791452072,131159.5935768697,-403.50732917822046,130756.08624769148,1422,0,568.6739130434783,37,9,19,35.32701776921431,0.6300675675675675,43.91447368421052,1024.342105263157,27.68492176386911,0
1426,4,0,0,44,0.0,0.0,1.0,44,1000,700,300,0.7,13,7,6,351.5135696750615,0.4031998766737139,0.22066738697639976,0.20358214197815713,130895.62694028502,402.317816126955,131297.94475641198,1423,1,595.4318181818181,36,8,19,35.179606397417565,0.6293402777777777,44.172297297297305,1023.3108108108119,28.42530030030033,0
1427,4,0,0,44,0.0,0.0,1.0,44,1150,700,450,0.6086956521739131,16,7,9,360.0260799578398,0.4034641472868217,0.23133929196284875,0.2094508730042634,131068.54056336742,637.618572964858,131706.15913633228,1424,2,596.4318181818181,36,8,20,34.78683236189009,0.6310763888888888,44.00337837837838,1023.9864864864866,28.444069069069073,0
1428,4,1,1,44,0.022222222222222223,0.022222222222222223,0.9777777777777777,45,1600,1200,400,0.75,20,12,8,360.63983995221577,0.4061658249158249,0.23362374014691167,0.21187008920031453,131443.5782911289,481.01500994237017,131924.5933010713,1425,0,584.1555555555556,36,9,20,34.391930229152955,0.634837962962963,43.637387387387385,1025.45045045045,28.484734734734722,0
1429,4,0,0,44,0.0,0.0,1.0,44,900,500,400,0.5555555555555556,13,5,8,366.84513186595274,0.40278144820295986,0.23928307464892828,0.21486643437862962,131328.12500000012,835.416666666681,132163.5416666668,1426,4,598.4318181818181,37,7,20,34.349593495934954,0.6317567567567567,43.75000000000001,1025.000000000001,27.702702702702727,0
1430,4,1,1,44,0.022222222222222223,0.022222222222222223,0.9777777777777777,45,1350,1000,350,0.7407407407407407,17,10,7,359.2625018319495,0.4056818181818182,0.22973286026067719,0.21218141148376907,131645.7436110097,459.0758410437502,132104.81945205346,1427,0,586.1111111111111,36,9,16,34.22308789641171,0.6368634259259259,43.44031531531532,1026.2387387387391,28.50663163163164,0
1431,4,1,1,44,0.022222222222222223,0.022222222222222223,0.9777777777777777,45,1200,1000,200,0.8333333333333334,14,10,4,359.35907346579535,0.40606060606060607,0.223738814522225,0.21239939011460826,131674.6370525931,463.69511403294973,132138.33216662606,1428,0,587.0888888888888,36,9,16,34.19144539536246,0.6371527777777778,43.41216216216216,1026.3513513513512,28.509759759759756,0
1432,4,0,0,44,0.0,0.0,1.0,44,1050,700,350,0.6666666666666666,14,7,7,369.62067797051975,0.40280347075405215,0.22911880538234342,0.21784027191028502,131565.50068587105,925.8659122085058,132491.36659807956,1429,7,601.4318181818181,35,9,16,34.038432611311684,0.638095238095238,43.51851851851852,1025.9259259259259,29.31216931216931,0
1433,4,0,0,44,0.0,0.0,1.0,44,1300,900,400,0.6923076923076923,17,9,8,369.67713674663116,0.40264931289640593,0.22955699123211826,0.21804310161403082,131595.1877170138,929.5464409722126,132524.734157986,1430,8,602.4318181818181,35,9,17,34.00697969543148,0.6383928571428572,43.48958333333333,1026.0416666666658,29.315476190476165,0
1434,4,1,0,45,0.022222222222222223,0.0,1.0,45,900,700,200,0.7777777777777778,11,7,4,362.23854472576255,0.40319865319865317,0.23541184979665397,0.21580021631437507,131975.1645337988,561.29830813326,132536.46284193205,1431,0,590.0222222222222,37,8,18,33.81431633052323,0.6382319819819819,43.119517543859644,1027.5219298245606,27.77086296823137,0
1435,4,0,0,45,0.0,0.0,1.0,45,1500,1200,300,0.8,18,12,6,358.32724616508415,0.403030303030303,0.23369369369369397,0.21384045335658222,132040.89506172817,462.7700617283682,132503.66512345654,1432,1,591.0222222222222,38,7,18,33.84853603603602,0.637061403508772,43.05555555555554,1027.777777777776,27.04678362573095,0
1436,4,0,0,45,0.0,0.0,1.0,45,1550,1100,450,0.7096774193548387,20,11,9,357.6431427665257,0.4031355218855219,0.23169853144915575,0.21405208992444255,132150.72320841518,452.5599934253491,132603.28320184053,1433,2,592.0222222222222,38,7,20,33.755455112219444,0.6381578947368423,42.948717948717935,1028.2051282051257,27.05802968960857,0
1437,4,1,0,46,0.021739130434782608,0.0,1.0,46,1450,1100,350,0.7586206896551724,18,11,7,332.1335342442395,0.40569645732689213,0.20453814260144565,0.19467448143393262,131355.50356353633,-422.377456351819,130933.12610718451,1434,0,580.1304347826087,38,8,20,35.21148167448323,0.6302083333333334,43.723290598290596,1025.106837606837,26.97649572649571,6
1438,4,0,2,44,0.0,0.043478260869565216,0.9565217391304348,46,1200,800,400,0.6666666666666666,16,8,8,333.2110678633459,0.4055756843800322,0.2104830565656659,0.196147116036541,131519.83486969463,-435.22707557162653,131084.607794123,1435,1,581.1304347826087,38,8,21,35.01827066625004,0.6318530701754386,43.56303418803419,1025.747863247863,26.993364822312184,0
1439,4,2,2,44,0.043478260869565216,0.043478260869565216,0.9565217391304348,46,950,500,450,0.5263157894736842,14,5,9,323.39413436076296,0.41001409017713364,0.20501546979319296,0.19188051972071946,131821.3757396451,-673.9480604865139,131147.42767915857,1436,0,575.2173913043479,38,8,18,34.96670828131501,0.6348684210526315,43.269230769230774,1026.9230769230778,27.02429149797573,0
1440,4,1,1,44,0.022222222222222223,0.022222222222222223,0.9777777777777777,45,1350,1000,350,0.7407407407407407,17,10,7,331.22973226908005,0.4075968013468014,0.20980852729731692,0.1965968106737769,131834.36850761753,-266.50748307173535,131567.8610245458,1437,0,588.9777777777778,37,8,18,34.75247348565734,0.6368243243243243,43.25657894736841,1026.9736842105249,27.756045519203376,0
1441,4,0,0,44,0.0,0.0,1.0,44,1450,900,550,0.6206896551724138,20,9,11,336.0017481023094,0.4043560606060606,0.21208075197607434,0.19883997254954597,131721.78578985823,51.75005771004925,131773.53584756827,1438,4,603.3636363636364,37,7,18,34.74328847112442,0.6356981981981983,43.36622807017543,1026.5350877192968,27.744191559980994,0
1442,4,0,0,44,0.0,0.0,1.0,44,1350,1100,250,0.8148148148148148,16,11,5,334.0931411699559,0.4045652748414376,0.20605382862222554,0.1983716717768241,131848.8056674152,9.956328986753647,131858.76199640197,1439,5,604.3636363636364,38,6,18,34.66443011200111,0.6351425438596492,43.242521367521356,1027.0299145299127,27.027103013945073,0
1443,4,0,0,44,0.0,0.0,1.0,44,800,500,300,0.625,11,5,6,332.27256953002086,0.40424594785059903,0.20598748037899273,0.1974331571978749,131876.23844875421,-36.22867813575937,131840.00977061846,1440,6,605.3636363636364,38,6,18,34.68357776853198,0.6354166666666667,43.21581196581195,1027.1367521367501,27.02991452991448,0
1444,4,2,0,46,0.043478260869565216,0.0,1.0,46,650,400,250,0.6153846153846154,9,4,5,323.96398763953476,0.41152375201288244,0.18307077918061854,0.19001511122457143,131381.51584201425,-685.3637686394718,130696.15207337479,1441,0,580.0,39,7,18,35.394652170967966,0.6287393162393161,43.697916666666686,1025.2083333333362,26.287393162393236,3
1445,4,1,2,45,0.02127659574468085,0.0425531914893617,0.9574468085106383,47,1300,900,400,0.6923076923076923,17,9,8,330.1728376223703,0.41302420598211537,0.21549869258203458,0.19604739700421134,131849.4747256925,-693.3769581598117,131156.0977675327,1442,0,568.6382978723404,40,7,13,34.76441387954351,0.6317708333333333,43.241869918699194,1027.0325203252044,25.67581300813011,0
1446,4,0,0,45,0.0,0.0,1.0,45,900,600,300,0.6666666666666666,12,6,6,342.32976656922335,0.4061658249158249,0.21161773891317925,0.20223983626469622,131656.85609796192,14.012163050631898,131670.86826101254,1443,1,594.8666666666667,38,7,14,34.64631480324796,0.6332236842105262,43.42948717948718,1026.2820512820517,27.007422402159257,0
1447,4,0,1,44,0.0,0.022222222222222223,0.9777777777777777,45,650,400,250,0.6153846153846154,9,4,5,340.4410424008305,0.4062710437710438,0.20889073919881596,0.20141364134157494,131711.68456424863,-31.987362115569567,131679.69720213307,1444,2,595.8666666666667,38,7,14,34.63953649736331,0.6337719298245614,43.376068376068375,1026.495726495726,27.013045434098057,0
1448,4,0,0,44,0.0,0.0,1.0,44,1000,800,200,0.8,12,8,4,343.10608324904473,0.4026933579985906,0.20639063425624715,0.2028942542826473,131693.6476247499,236.9783250615552,131930.62594981145,1445,3,609.6363636363636,37,7,14,34.589320051276566,0.6354166666666666,43.39364035087719,1026.425438596491,27.74122807017543,0
1449,4,0,1,43,0.0,0.022727272727272728,0.9772727272727273,44,1300,1000,300,0.7692307692307693,16,10,6,340.9694211302025,0.40174638830162085,0.20325479388246293,0.20267776250937436,131890.67790089277,194.13761926749385,132084.81552016025,1446,4,610.6363636363636,37,7,14,34.445719470538016,0.6373873873873872,43.201754385964925,1027.1929824561419,27.761972498814647,0
1450,4,1,2,42,0.022727272727272728,0.045454545454545456,0.9545454545454546,44,1100,700,400,0.6363636363636364,15,7,8,337.71670016468056,0.4007994186046511,0.19625366099656705,0.20164053167794407,132059.67821829824,119.75175053866701,132179.42996883692,1447,0,611.3409090909091,37,7,14,34.35922053907973,0.6390765765765763,43.037280701754405,1027.8508771929849,27.77975343764824,0
1451,4,0,0,42,0.0,0.0,1.0,42,850,600,250,0.7058823529411765,11,6,5,354.64478916324396,0.39699477351916374,0.20576333768038957,0.21048583372879356,131832.80452942822,950.7634334276478,132783.56796285586,1448,6,641.0714285714286,35,7,14,34.15288421803974,0.6407738095238094,43.258101851851855,1026.967592592593,29.34193121693123,0
1452,4,0,0,42,0.0,0.0,1.0,42,950,400,550,0.42105263157894735,15,4,11,354.64478916324396,0.39699477351916374,0.20576333768038957,0.21048583372879356,131832.80452942822,950.7634334276478,132783.56796285586,1449,7,642.0714285714286,35,7,14,34.15288421803974,0.6407738095238094,43.258101851851855,1026.967592592593,29.34193121693123,0
1453,4,0,0,42,0.0,0.0,1.0,42,1100,900,200,0.8181818181818182,13,9,4,355.5288110527276,0.39706736353077815,0.20486491126418982,0.21150628196407592,131921.96609224982,980.4119513031739,132902.37804355298,1450,8,643.0714285714286,35,7,14,34.040295929097184,0.6416666666666666,43.171296296296305,1027.3148148148161,29.35185185185189,0
1454,4,0,0,42,0.0,0.0,1.0,42,800,200,600,0.25,14,2,12,353.76852075195575,0.3967044134727062,0.2016273506474,0.2107890555191856,131981.42387902958,938.1746184842352,132919.59849751383,1451,9,644.0714285714286,35,7,14,34.02558759480364,0.6422619047619047,43.11342592592593,1027.546296296297,29.35846560846563,0
1455,4,0,0,42,0.0,0.0,1.0,42,1050,600,450,0.5714285714285714,15,6,9,354.52215915952155,0.3969826751838947,0.22152799581370952,0.20733622418712383,131270.41737683633,907.6543604415185,132178.07173727785,1452,10,645.0714285714286,36,6,15,34.72367216117215,0.6331018518518519,43.806306306306304,1024.7747747747749,28.465965965965967,1
1456,4,0,0,42,0.0,0.0,1.0,42,1300,900,400,0.6923076923076923,17,9,8,357.829308205513,0.39652293844367015,0.22463358902361907,0.21037776047950962,131472.4495399114,1008.9391333901364,132481.38867330155,1453,11,646.0714285714286,36,6,16,34.43482119980968,0.6351273148148149,43.60923423423423,1025.5630630630621,28.487862862862837,0
1457,4,1,1,42,0.023255813953488372,0.023255813953488372,0.9767441860465116,43,1400,1000,400,0.7142857142857143,18,10,8,350.09401396426244,0.3982788851974899,0.2101042502004815,0.20794740829443537,131862.52170138882,632.855902777773,132495.3776041666,1454,0,632.0232558139535,37,6,15,34.23977349560514,0.6371058558558559,43.229166666666664,1027.0833333333328,27.759009009008995,0
1458,4,0,0,42,0.0,0.0,1.0,42,900,700,200,0.7777777777777778,11,7,4,360.3625953824395,0.39513162988772743,0.21506900819325425,0.2138026354777141,131819.1518165125,1100.5383339420537,132919.69015045455,1455,13,648.0714285714286,36,6,15,34.01985780604598,0.638599537037037,43.2713963963964,1026.9144144144148,28.52540040040041,0
1459,4,0,0,42,0.0,0.0,1.0,42,1300,1100,200,0.8461538461538461,15,11,4,362.108862134854,0.39513162988772743,0.21577492134648746,0.21540304313279024,131918.83710612875,1153.7959997306848,133072.63310585942,1456,14,649.0714285714286,37,5,15,33.87445743053333,0.637668918918919,43.17434210526316,1027.302631578947,27.76493598862019,0
1460,4,0,0,42,0.0,0.0,1.0,42,900,700,200,0.7777777777777778,11,7,4,360.3601870571966,0.39530100658149436,0.21257360300356165,0.21500038404119032,132031.503984399,1115.7794946521944,133147.2834790512,1457,15,650.0714285714286,37,5,15,33.805767452612116,0.638795045045045,43.06469298245614,1027.7412280701749,27.776789947842566,0
1461,4,0,0,42,0.0,0.0,1.0,42,1200,800,400,0.6666666666666666,16,8,8,358.1331260918112,0.3947444831591173,0.20671561086317491,0.2146281526910605,132200.59447378034,1069.0824340181493,133269.67690779848,1458,16,651.0714285714286,37,5,15,33.69262448022178,0.6404842342342343,42.90021929824561,1028.399122807017,27.794570886676134,0
1462,4,0,0,42,0.0,0.0,1.0,42,950,800,150,0.8421052631578947,11,8,3,358.8715599116584,0.3944541231126597,0.21320496232590047,0.21603653558504876,132369.79316953282,1100.750831986752,133470.54400151956,1459,17,652.0714285714286,37,5,17,33.50326318593501,0.6421734234234234,42.73574561403508,1029.0570175438586,27.81235182550969,0
1463,4,1,0,43,0.023255813953488372,0.0,1.0,43,950,800,150,0.8421052631578947,11,8,3,351.19219751997326,0.3963639719453673,0.2215668496136891,0.21328070232258325,132700.54879830522,720.6794689166491,133421.22826722186,1460,0,637.8837209302326,38,5,16,33.36832918567677,0.643640350877193,42.414529914529915,1030.3418803418804,27.11426000899685,0
1464,4,0,0,43,0.0,0.0,1.0,43,1050,800,250,0.7619047619047619,13,8,5,326.58756159138204,0.3963639719453673,0.12102821185406776,0.1834405378978823,129704.91672092034,-68.00122539365304,129636.91549552669,1461,1,638.8837209302326,39,4,17,37.02161519582781,0.6119123931623931,45.33854166666668,1018.6458333333351,26.119123931623978,8
1465,4,0,0,43,0.0,0.0,1.0,43,750,400,350,0.5333333333333333,11,4,7,327.0477354482341,0.3962486157253599,0.12075618843367364,0.1839478953662554,129757.97661675367,-112.58951822914725,129645.38709852453,1462,2,639.8837209302326,39,4,17,36.95610963432505,0.6124465811965811,45.28645833333334,1018.8541666666683,26.124465811965855,0
1466,4,1,2,42,0.022727272727272728,0.045454545454545456,0.9545454545454546,44,1400,1100,300,0.7857142857142857,17,11,6,321.3864223700486,0.4021207716701903,0.11740386531181524,0.18226423207630219,130081.0994199881,-438.7401678894855,129642.35925209861,1463,0,626.3181818181819,40,4,18,36.77317858803213,0.6140625,44.96951219512195,1020.1219512195121,25.503048780487802,0
1467,4,1,1,42,0.023255813953488372,0.023255813953488372,0.9767441860465116,43,1300,800,500,0.6153846153846154,18,8,10,324.63094248844544,0.3997785160575858,0.11781046333558898,0.1843339177782218,130129.69970703138,-151.17458767359668,129978.52511935779,1464,0,607.9767441860465,39,4,19,36.641249787306435,0.6161858974358974,44.92187500000001,1020.312500000001,26.161858974359,0
1468,4,1,0,43,0.023255813953488372,0.0,1.0,43,1000,700,300,0.7,13,7,6,327.7505806004752,0.39980158730158727,0.12846339837178467,0.18686931009105656,130289.1723632815,-59.5296223958058,130229.6427408857,1465,0,608.953488372093,39,4,20,36.40030354045509,0.6177884615384615,44.765625000000014,1020.9375000000019,26.177884615384666,0
1469,4,0,0,43,0.0,0.0,1.0,43,1550,1000,550,0.6451612903225806,21,10,11,305.0950125196743,0.39980158730158727,0.03602878469926485,0.16345818882676583,127828.32031249996,-800.04340277778,127028.27690972218,1466,1,609.953488372093,39,4,18,39.47431671473701,0.5929487179487181,47.1875,1011.2499999999997,25.92948717948717,7
1470,4,2,1,44,0.044444444444444446,0.022222222222222223,0.9777777777777777,45,950,600,350,0.631578947368421,13,6,7,295.37176617593855,0.4067760942760943,0.06663992512368,0.160427410256343,128376.15258774528,-1415.8711900571868,126960.2813976881,1467,0,583.8,40,5,13,39.16298970450594,0.596875,46.64634146341463,1013.4146341463405,25.335365853658512,0
1471,4,2,0,46,0.043478260869565216,0.0,1.0,46,1200,1000,200,0.8333333333333334,14,10,4,294.38899919717176,0.4142109500805153,0.1024504847439478,0.1618032770023554,128848.62075617288,-1613.6766975308622,127234.94405864202,1468,0,555.6739130434783,41,5,17,38.70839033287733,0.6001016260162602,46.18055555555556,1015.277777777778,24.762872628726296,0
1472,4,2,1,47,0.041666666666666664,0.020833333333333332,0.9791666666666666,48,1150,800,350,0.6956521739130435,15,8,7,284.62796260028097,0.4207114361702127,0.10471856934121071,0.1580362878056798,129250.65068956194,-2241.8478728074588,127008.80281675448,1469,0,533.4791666666666,42,6,20,38.549210660059714,0.6026785714285714,45.78488372093023,1016.8604651162791,24.210963455149503,0
1473,4,0,0,47,0.0,0.0,1.0,47,1550,1000,550,0.6451612903225806,21,10,11,291.7405261389515,0.41516342892383595,0.0983692301944592,0.16209388257183718,129277.04480229605,-1856.9293863378564,127420.1154159582,1470,1,545.8297872340426,41,6,20,38.34168617695834,0.604420731707317,45.75892857142858,1016.9642857142868,24.80400696864114,0
1474,4,1,0,48,0.020833333333333332,0.0,1.0,48,950,600,350,0.631578947368421,13,6,7,287.60918653530155,0.417756353427896,0.11231168046126694,0.16116006163700386,129610.88266363948,-2144.5438941976317,127466.33876944185,1471,0,535.4375,43,5,13,38.10922920735301,0.6048934108527131,45.430871212121225,1018.2765151515172,23.680849189570168,0
1475,4,3,2,49,0.058823529411764705,0.0392156862745098,0.9607843137254902,51,1050,600,450,0.5714285714285714,15,6,9,274.6413207520565,0.42549019607843136,0.13383748824638841,0.1565789571141154,130286.75538230322,-3038.6716956496684,127248.08368665355,1472,0,504.88235294117646,43,8,15,37.75826685836195,0.6116763565891472,44.76799242424243,1020.9280303030309,23.742512332628625,0
1476,4,0,1,48,0.0,0.02040816326530612,0.9795918367346939,49,1100,800,300,0.7272727272727273,14,8,6,288.09735622637146,0.42129039115646255,0.13488132591936774,0.16345296966540485,130097.22650891643,-2303.866598079551,127793.35991083688,1473,1,526.4285714285714,44,5,17,37.60588733587463,0.6084280303030303,44.95370370370371,1020.185185185186,23.186026936026956,0
1477,4,0,0,48,0.0,0.0,1.0,48,1750,1300,450,0.7428571428571429,22,13,9,294.4148773711438,0.41876292848699764,0.12844256714940006,0.1669177399495769,130069.3188992195,-1941.131485307615,128128.18741391189,1474,2,538.2708333333334,43,5,19,37.47292362916203,0.6094961240310077,44.98106060606061,1020.075757575758,23.722692036645533,0
1478,4,0,0,48,0.0,0.0,1.0,48,1700,1200,500,0.7058823529411765,22,12,10,294.784071115248,0.4180149231678487,0.1342637690571178,0.16785406775231165,130238.42047068704,-1921.5576396062806,128316.86283108075,1475,3,539.2708333333334,43,5,19,37.29290363979344,0.6111918604651163,44.815340909090914,1020.7386363636367,23.738107822410157,0
1479,4,1,1,48,0.02040816326530612,0.02040816326530612,0.9795918367346939,49,1150,600,550,0.5217391304347826,17,6,11,289.13834353715254,0.4189519557823129,0.1353153320486331,0.1661128130517365,130584.26852352613,-2248.6116976613557,128335.65682586477,1476,0,529.2448979591836,42,7,16,37.08858709391987,0.6160714285714286,44.47674418604651,1022.0930232558133,24.33554817275746,0
1480,4,0,1,47,0.0,0.020833333333333332,0.9791666666666666,48,1200,700,500,0.5833333333333334,17,7,10,294.88673719442954,0.4173592641843971,0.13187160062160053,0.16867521367521365,130414.54081632645,-1908.4963151927523,128506.0445011337,1477,5,541.2708333333334,41,7,19,37.11271367521368,0.6158536585365854,44.64285714285714,1021.4285714285708,24.9128919860627,0
1481,4,2,3,46,0.04081632653061224,0.061224489795918366,0.9387755102040817,49,1150,800,350,0.6956521739130435,15,8,7,288.2427064338023,0.41974914965986393,0.10272656688334836,0.16660706033196188,130819.03126614148,-2258.473674959835,128560.55759118164,1478,0,529.6938775510204,43,6,13,36.87526998673205,0.6170058139534884,44.247159090909086,1023.0113636363633,23.790961945031704,1
1482,4,1,0,47,0.02127659574468085,0.0,1.0,47,1150,600,550,0.5217391304347826,17,6,11,301.6809681623554,0.41732192414431085,0.11986634277423325,0.1740363234910867,130744.07837498409,-1511.399970867995,129232.6784041161,1479,0,552.8297872340426,41,6,15,36.60707068257509,0.6191565040650406,44.3204365079365,1022.7182539682527,24.94434765776226,0
1483,4,1,1,47,0.020833333333333332,0.020833333333333332,0.9791666666666666,48,1050,700,350,0.6666666666666666,14,7,7,299.1223958059202,0.42075760933806144,0.13755915759583637,0.1737343656783695,131005.5278097017,-1762.6625315486008,129242.8652781531,1480,0,542.2916666666666,42,6,16,36.409331124783115,0.6202876984126985,44.06492248062015,1023.7403100775174,24.37476928755994,0
1484,4,1,0,48,0.020833333333333332,0.0,1.0,48,1300,900,400,0.6923076923076923,17,9,8,298.76396324938867,0.42379580378250586,0.15718157181571835,0.1749903213317846,131328.12499999985,-1751.9843684273937,129576.14063157246,1481,0,539.125,41,7,18,36.09417344173441,0.625,43.74999999999999,1024.9999999999989,24.99999999999997,0
1485,4,1,1,48,0.02040816326530612,0.02040816326530612,0.9795918367346939,49,1250,1000,250,0.8,15,10,5,292.79034979688487,0.4254180839002268,0.1535276747646548,0.17260936657290715,131576.5466318128,-2095.131377321095,129481.41525449169,1482,0,529.1020408163265,42,7,13,35.99790643495781,0.6259920634920635,43.50775193798449,1025.9689922480604,24.427833148763344,0
1486,4,0,2,46,0.0,0.041666666666666664,0.9583333333333334,48,1500,1300,200,0.8666666666666667,17,13,4,298.4215586874136,0.4238881501182033,0.15382817537072935,0.1757220339879186,131531.5767510705,-1749.628369866492,129781.94838120401,1483,2,541.125,41,7,21,35.898613797549984,0.6270325203252034,43.55158730158729,1025.7936507936483,25.019357336430446,0
1487,4,0,0,46,0.0,0.0,1.0,46,1450,1000,450,0.6896551724137931,19,10,9,303.26317569991534,0.42151771336553945,0.14090049496207002,0.17847435757080146,131510.4799247306,-1223.5428440412509,130286.93708068936,1484,3,550.6304347826087,40,6,21,35.79564219426005,0.6283854166666667,43.572154471544714,1025.7113821138207,25.64278455284552,0
1488,4,0,0,46,0.0,0.0,1.0,46,1250,900,350,0.72,16,9,7,307.6830201874791,0.421628421900161,0.14252164441593407,0.18181924054261875,131666.88484243845,-1097.667042600301,130569.21779983815,1485,4,551.6304347826087,40,6,16,35.52517575997622,0.6299479166666667,43.41971544715447,1026.3211382113827,25.65802845528457,0
1489,4,1,0,47,0.02127659574468085,0.0,1.0,47,1450,1100,350,0.7586206896551724,18,11,7,301.0834094152982,0.42213999383287076,0.15116608557454225,0.1799207778755085,132091.8810232425,-1445.8652210884532,130646.01580215404,1486,0,540.8723404255319,41,6,18,35.26828797529434,0.6326219512195121,43.00595238095237,1027.9761904761892,25.07259001161437,0
1490,4,0,0,47,0.0,0.0,1.0,47,1500,1000,500,0.6666666666666666,20,10,10,305.38019972679194,0.4214654640764724,0.1588707195469754,0.18347582104095178,132295.92328829662,-1319.8889046359423,130976.03438366068,1487,1,541.8723404255319,41,6,18,34.953391192542604,0.6346544715447155,42.80753968253968,1028.7698412698398,25.091947348044876,0
1491,4,0,1,46,0.0,0.02127659574468085,0.9787234042553191,47,1150,800,350,0.6956521739130435,15,8,7,306.37232847818217,0.4206945729263028,0.15954574919381992,0.18432098555543522,132346.9584593096,-1290.5108339632188,131056.44762534638,1488,2,542.8723404255319,41,6,18,34.876751510476936,0.6351626016260162,42.757936507936506,1028.9682539682535,25.096786682152526,0
1492,4,1,1,46,0.02127659574468085,0.02127659574468085,0.9787234042553191,47,1300,900,400,0.6923076923076923,17,9,8,305.28694591241793,0.42005858772741284,0.15480456197097303,0.18430016460624518,132476.45767235113,-1311.32352448272,131165.1341478684,1489,0,543.6595744680851,40,7,18,34.77500822639024,0.6380208333333334,42.63211382113821,1029.4715447154472,25.73678861788618,0
1493,4,0,0,46,0.0,0.0,1.0,46,1400,700,700,0.5,21,7,14,314.3068549402284,0.41760265700483096,0.16788820504247481,0.1897553236025827,132478.41932508687,-872.2249348958283,131606.19439019106,1490,4,556.4782608695652,39,7,19,34.54089935579614,0.639690170940171,42.630208333333336,1029.4791666666672,26.396901709401725,0
1494,4,0,1,45,0.0,0.021739130434782608,0.9782608695652174,46,1650,1200,450,0.7272727272727273,21,12,9,312.9528953505459,0.41727053140096615,0.1667531336970809,0.1897480798357786,132639.32427300356,-898.0278862847164,131741.29638671884,1491,5,557.4782608695652,39,7,14,34.414606296558475,0.6412927350427351,42.473958333333336,1030.1041666666672,26.412927350427363,0
1495,4,0,0,45,0.0,0.0,1.0,45,1050,700,350,0.6666666666666666,14,7,7,317.27142563634027,0.41449915824915823,0.15799702597088205,0.1919760999189378,132562.98539201167,-588.3105276134334,131974.67486439823,1492,6,570.3555555555556,38,7,20,34.37986305633363,0.6422697368421053,42.54807692307691,1029.807692307691,27.100202429149764,0
1496,4,1,0,46,0.021739130434782608,0.0,1.0,46,1250,800,450,0.64,17,8,9,327.1919819401555,0.41514694041867956,0.08403193431485612,0.18893462214083523,130781.15297866901,-603.6247169259984,130177.528261743,1493,0,558.9347826086956,38,8,19,35.917371701135025,0.6244517543859649,44.284188034188034,1022.8632478632479,26.917453891138102,7
1497,4,0,0,46,0.0,0.0,1.0,46,1650,1200,450,0.7272727272727273,21,12,9,326.47531640185576,0.41525764895330114,0.08139577110588592,0.18905565782932113,130890.45606874114,-653.4993881949193,130236.95668054622,1494,1,559.9347826086956,38,8,19,35.82537238115126,0.6255482456140351,44.17735042735042,1023.2905982905968,26.928699955015706,0
1498,4,1,1,46,0.02127659574468085,0.02127659574468085,0.9787234042553191,47,950,700,250,0.7368421052631579,12,7,5,320.5620080493045,0.4179579093432007,0.08482938905527693,0.1867159753045475,131114.670138889,-993.923611111107,130120.74652777788,1495,0,549.0,39,8,20,35.750610252237585,0.6260683760683761,43.958333333333336,1024.1666666666674,26.26068376068378,0
1499,4,2,0,48,0.041666666666666664,0.0,1.0,48,1200,1000,200,0.8333333333333334,14,10,4,307.5686823324376,0.4230293291962175,0.07979293613179883,0.18098762701394835,131506.13667052472,-1510.5661651234489,129995.57050540127,1496,0,508.3125,41,7,22,35.68960167005193,0.6267784552845528,43.57638888888889,1025.6944444444448,25.016937669376702,0
1500,4,0,2,46,0.0,0.041666666666666664,0.9583333333333334,48,1450,1000,450,0.6896551724137931,19,10,9,307.5596660382768,0.4231770833333333,0.08400810532082925,0.1814654663909811,131607.9117555588,-1504.5429224930615,130103.36883306575,1497,1,509.3125,41,7,16,35.58757533275325,0.6277947154471544,43.477182539682545,1026.0912698412706,25.026616337591964,0
1501,4,0,0,46,0.0,0.0,1.0,46,1300,800,500,0.6153846153846154,18,8,10,319.69884104137077,0.4189110305958132,0.07557566842911956,0.187644346593334,131408.21533203125,-797.7891710069439,130610.42616102431,1498,3,532.4130434782609,39,7,20,35.47709455111924,0.6290064102564104,43.671875,1025.3125,26.290064102564102,0
1502,4,0,0,46,0.0,0.0,1.0,46,1350,1000,350,0.7407407407407407,17,10,7,319.40203340004257,0.41838768115942027,0.07565976836909005,0.18799472940168688,131515.04041883687,-798.7657335069384,130716.27468532993,1499,4,533.4130434782609,39,7,20,35.3772087945567,0.6300747863247864,43.567708333333336,1025.7291666666672,26.300747863247878,0
1503,4,0,0,46,0.0,0.0,1.0,46,1200,1000,200,0.8333333333333334,14,10,4,321.6084309546939,0.41836755233494366,0.07574380001147585,0.18982412542448693,131621.90890842004,-733.8568793402826,130888.05202907976,1500,5,534.4130434782609,39,7,17,35.21311288194092,0.6311431623931625,43.463541666666664,1026.1458333333326,26.311431623931604,0
1504,4,0,0,46,0.0,0.0,1.0,46,1400,1100,300,0.7857142857142857,17,11,6,321.6084309546939,0.41836755233494366,0.07574380001147585,0.18982412542448693,131621.90890842004,-733.8568793402826,130888.05202907976,1501,6,535.4130434782609,39,7,17,35.21311288194092,0.6311431623931625,43.463541666666664,1026.1458333333326,26.311431623931604,0
1505,4,0,0,46,0.0,0.0,1.0,46,950,700,250,0.7368421052631579,12,7,5,324.1988741535505,0.41784420289855073,0.07377888400501309,0.19148724869069422,131648.6328125,-663.9322916666667,130984.70052083333,1502,7,536.4130434782609,39,7,17,35.11977263499797,0.6314102564102565,43.4375,1026.25,26.314102564102566,0
1506,4,1,1,46,0.02127659574468085,0.02127659574468085,0.9787234042553191,47,700,500,200,0.7142857142857143,9,5,4,316.5347292376487,0.42032839962997226,0.0725820710791536,0.18820782606671477,131901.66650142102,-1049.7083415956183,130851.9581598254,1503,0,525.9787234042553,40,7,17,35.062161983907146,0.6322916666666667,43.1910569105691,1027.235772357723,25.680894308943074,0
1507,4,1,2,45,0.02127659574468085,0.0425531914893617,0.9574468085106383,47,1100,800,300,0.7272727272727273,14,8,6,319.7700391689036,0.4187673450508788,0.07882776730406715,0.19065534410825163,132006.08103641987,-957.6820592901267,131048.39897712975,1504,0,526.9574468085107,40,7,18,34.87420061972575,0.6333333333333334,43.08943089430893,1027.6422764227623,25.691056910569056,0
1508,4,0,0,45,0.0,0.0,1.0,45,1150,700,450,0.6086956521739131,16,7,9,337.38123112908636,0.4145412457912458,0.07868299055480432,0.20003522593347597,131793.94866544288,-107.03906877786642,131686.909596665,1505,12,551.1777777777778,38,7,18,34.63522699684389,0.6345942982456141,43.29594017094016,1026.816239316238,27.02147998200626,0
1509,4,0,0,45,0.0,0.0,1.0,45,1150,900,250,0.782608695652174,14,9,5,334.0636339962182,0.4145412457912458,0.07521580863234534,0.19864080648569155,131903.67408366175,-187.15585963185418,131716.5182240299,1506,13,552.1777777777778,38,7,18,34.609984399375975,0.6356907894736843,43.18910256410255,1027.2435897435873,27.032726045883877,0
1510,4,0,0,45,0.0,0.0,1.0,45,1050,700,350,0.6666666666666666,14,7,7,335.21595277202505,0.4139941077441078,0.07895946679604005,0.19990342527675778,132013.44515897773,-149.39744046318157,131864.04771851454,1507,14,553.1777777777778,38,7,19,34.46997262362683,0.6367872807017545,43.08226495726494,1027.670940170938,27.043972109761523,0
1511,4,1,1,45,0.021739130434782608,0.021739130434782608,0.9782608695652174,46,550,300,250,0.5454545454545454,8,3,5,331.20211156418594,0.41622383252818035,0.08349111852823854,0.19868102366857643,132237.24500868042,-440.5490451388986,131796.6959635415,1508,0,542.1304347826087,39,7,19,34.348204037539666,0.6372863247863249,42.86458333333333,1028.5416666666656,26.372863247863222,0
1512,4,0,0,45,0.0,0.0,1.0,45,1150,900,250,0.782608695652174,14,9,5,334.7612940902275,0.41327861952861955,0.08473809358912221,0.20064833231086723,132205.65440317037,-148.53280918986871,132057.1215939805,1509,16,555.1777777777778,38,7,20,34.288428907819096,0.6387061403508772,42.89529914529914,1028.4188034188028,27.06365272154744,0
1513,4,0,0,45,0.0,0.0,1.0,45,1300,800,500,0.6153846153846154,18,8,10,332.2560940276598,0.4119107744107744,0.08773071244001507,0.2000181686046511,132370.51647308053,-203.81784644605665,132166.69862663446,1510,17,556.1777777777778,38,7,20,34.18725775193798,0.6403508771929824,42.73504273504273,1029.0598290598286,27.080521817363913,0
1514,4,0,0,45,0.0,0.0,1.0,45,750,600,150,0.8,9,6,3,332.2560940276598,0.4119107744107744,0.08773071244001507,0.2000181686046511,132370.51647308053,-203.81784644605665,132166.69862663446,1511,18,557.1777777777778,38,7,20,34.18725775193798,0.6403508771929824,42.73504273504273,1029.0598290598286,27.080521817363913,0
1515,4,0,1,44,0.0,0.022222222222222223,0.9777777777777777,45,1150,900,250,0.782608695652174,14,9,5,333.63201370484967,0.41172138047138046,0.08887942154530704,0.20144507888584132,132482.65241468523,-159.906325217225,132322.746089468,1512,19,558.1777777777778,37,8,20,34.03927912095715,0.6432995495495495,42.62609649122807,1029.4956140350873,27.82420578473209,0
1516,4,0,0,44,0.0,0.0,1.0,44,1150,500,650,0.43478260869565216,18,5,13,331.4053081981621,0.40943225863284005,0.07611863451786505,0.19554166923823452,131609.25116381957,-76.79911126501338,131532.45205255455,1513,20,570.7954545454545,37,7,17,34.974531595070175,0.6345720720720721,43.47587719298245,1026.0964912280697,27.73233760075864,3
1517,4,1,1,44,0.022222222222222223,0.022222222222222223,0.9777777777777777,45,900,500,400,0.5555555555555556,13,5,8,323.205015564117,0.41304713804713805,0.07547928583809993,0.19218405841985067,131903.67408366204,-473.6141929651591,131430.0598906969,1514,0,559.0888888888888,38,7,17,34.88884555382215,0.6356907894736842,43.18910256410256,1027.2435897435896,27.032726045883937,0
1518,4,0,0,44,0.0,0.0,1.0,44,1000,700,300,0.7,13,7,6,330.5387077594679,0.4092560782241015,0.07556096045362337,0.19575167114180236,131749.9269606993,-90.30987900124455,131659.61708169803,1515,22,572.7954545454545,37,7,18,34.855170173377495,0.6359797297297298,43.33881578947368,1026.644736842104,27.747155049786596,0
1519,4,0,0,44,0.0,0.0,1.0,44,1100,800,300,0.7272727272727273,14,8,6,330.1302774213834,0.4094102360817477,0.06928845313789256,0.19579924306847699,131806.2183195789,-97.35531605881107,131708.8630035201,1516,23,573.7954545454545,37,7,19,34.80901850863143,0.6365427927927929,43.283991228070164,1026.8640350877176,27.753082029397774,0
1520,4,1,1,44,0.022222222222222223,0.022222222222222223,0.9777777777777777,45,900,500,400,0.5555555555555556,13,5,8,321.27938873968924,0.41245791245791247,0.07304853965284308,0.19187020478364636,132068.34781804704,-513.8323882314565,131554.5154298156,1517,0,562.0222222222222,38,7,20,34.77289263070366,0.6373355263157896,43.02884615384614,1027.884615384613,27.04959514170034,0
1521,4,0,0,44,0.0,0.0,1.0,44,1350,1100,250,0.8148148148148148,16,11,5,320.6026985335044,0.41242732558139533,0.0633200740311044,0.19218642638866365,132210.46142578128,-322.59385850694366,131887.86756727434,1518,1,558.2045454545455,39,5,21,34.64762905567371,0.6370192307692308,42.890625,1028.4375000000002,26.370192307692314,0
1522,4,0,0,44,0.0,0.0,1.0,44,1150,800,350,0.6956521739130435,15,8,7,324.2178071436922,0.4116895701198027,0.06623054479184898,0.194905616625578,132317.61203342004,-220.05479600695352,132097.55723741307,1519,2,559.2045454545455,39,5,22,34.44713728865041,0.6380876068376069,42.78645833333333,1028.8541666666658,26.380876068376047,0
1523,4,0,0,44,0.0,0.0,1.0,44,1300,1000,300,0.7692307692307693,16,10,6,323.6493345475997,0.41183271670190275,0.06633690694093364,0.19512500342956413,132426.21678064374,-228.01978433271591,132198.19699631102,1520,3,560.2045454545455,37,7,24,34.35280618585987,0.6427364864864866,42.68092105263156,1029.2763157894713,27.818278805120844,0
1524,4,0,0,44,0.0,0.0,1.0,44,1050,1000,50,0.9523809523809523,11,10,1,323.14846085038585,0.4116675475687104,0.0707428422041263,0.19511517034882753,132482.65241468503,-237.68695656358926,132244.96545812144,1521,4,561.2045454545455,37,7,24,34.3090984130365,0.6432995495495497,42.626096491228054,1029.4956140350857,27.824205784732047,0
1525,4,2,2,44,0.043478260869565216,0.043478260869565216,0.9565217391304348,46,1000,600,400,0.6,14,6,8,310.1390620246167,0.41432165861513687,0.07295359595134165,0.18912176813663786,132854.0161132813,-959.3560112847209,131894.6601019966,1522,0,537.7608695652174,39,7,11,34.2722752685999,0.6434294871794872,42.265625,1030.9375000000005,26.434294871794883,0
1526,4,0,0,44,0.0,0.0,1.0,44,1000,700,300,0.7,13,7,6,324.66047317685474,0.4111059725158563,0.07660685423381053,0.19661739681174703,132595.5597515581,-190.2925659818495,132405.26718557623,1523,6,563.2045454545455,37,7,24,34.15697416515844,0.6444256756756757,42.51644736842105,1029.9342105263152,27.836059743954465,0
1527,4,0,0,44,0.0,0.0,1.0,44,600,400,200,0.6666666666666666,8,4,4,321.9521469736673,0.41123810782241016,0.0764411382021839,0.1952366415798804,132645.51487508212,-258.89833990795904,132386.61653517417,1524,7,564.2045454545455,38,6,12,34.17664903546983,0.6430921052631579,42.467948717948715,1030.1282051282046,27.108636977058016,0
1528,4,0,0,44,0.0,0.0,1.0,44,1550,1200,350,0.7741935483870968,19,12,7,322.5056487529151,0.41101788231148695,0.06989708404802708,0.19614687817595325,132755.59413580247,-237.11419753087034,132518.4799382716,1525,8,565.2045454545455,38,6,13,34.05211141060198,0.6441885964912281,42.36111111111111,1030.5555555555554,27.11988304093567,0
1529,4,0,0,44,0.0,0.0,1.0,44,1150,700,450,0.6086956521739131,16,7,9,323.31385869899356,0.41011495771670187,0.06404916933758242,0.19743885794332758,132907.7162000869,-205.81868489582206,132701.89751519109,1526,9,566.2045454545455,39,5,15,33.87894821025694,0.6439636752136751,42.21354166666667,1031.1458333333342,26.439636752136774,0
1530,4,0,0,44,0.0,0.0,1.0,44,800,600,200,0.75,10,6,4,322.9218549419127,0.4101039464411558,0.07038522979746986,0.19762498193045872,132988.2866753473,-211.03515624998894,132777.2515190973,1527,10,567.2045454545455,39,5,16,33.808405709284315,0.6447649572649572,42.13541666666667,1031.4583333333342,26.447649572649595,0
1531,4,0,0,44,0.0,0.0,1.0,44,850,300,550,0.35294117647058826,14,3,11,321.143058994064,0.41002686751233264,0.0682736177283283,0.19667778065666147,133015.14892578128,-256.6216362847206,132758.52728949656,1528,11,568.2045454545455,39,5,16,33.82739658016088,0.6450320512820513,42.109375,1031.5625000000002,26.450320512820518,0
1532,4,0,1,43,0.0,0.022727272727272728,0.9772727272727273,44,1000,700,300,0.7,13,7,6,321.143058994064,0.41002686751233264,0.0682736177283283,0.19667778065666147,133015.14892578128,-256.6216362847206,132758.52728949656,1529,12,569.2045454545455,39,5,16,33.82739658016088,0.6450320512820513,42.109375,1031.5625000000002,26.450320512820518,0
1533,4,0,0,43,0.0,0.0,1.0,43,900,500,400,0.5555555555555556,13,5,8,332.2009191878292,0.4068383167220377,0.06924834935630164,0.20315758498324285,132961.427137587,233.9816623264091,133195.4087999134,1530,37,583.1627906976744,39,4,17,33.59603827896173,0.6444978632478633,42.16145833333334,1031.3541666666683,26.444978632478676,0
1534,4,0,0,43,0.0,0.0,1.0,43,1150,900,250,0.782608695652174,14,9,5,331.080990393393,0.4065845330380214,0.0713128191157062,0.20261829214310134,132988.2866753473,205.97873263889946,133194.2654079862,1531,38,584.1627906976744,39,4,17,33.5980105029287,0.6447649572649572,42.13541666666667,1031.4583333333342,26.447649572649595,0
1535,4,0,0,43,0.0,0.0,1.0,43,1050,700,350,0.6666666666666666,14,7,7,332.2400767921196,0.4061461794019934,0.07111747649178835,0.20376705638550757,133068.88156467024,242.16308593751052,133311.04465060774,1532,39,585.1627906976744,39,4,17,33.48740114420326,0.6455662393162394,42.05729166666667,1031.7708333333342,26.455662393162413,0
1536,4,0,0,43,0.0,0.0,1.0,43,1150,700,450,0.6086956521739131,16,7,9,356.88302578103685,0.4057770394979698,0.07110289616310994,0.20888590664245213,131301.43364800338,772.4609374999945,132073.89458550338,1533,40,586.1627906976744,39,4,18,34.63184351390724,0.6279380341880343,43.776041666666664,1024.8958333333328,26.27938034188033,4
1537,4,0,0,43,0.0,0.0,1.0,43,950,600,350,0.631578947368421,13,6,7,357.76830907375165,0.4056616832779623,0.06714587737843591,0.2098578224491574,131384.3261869033,801.0350690837163,132185.361255987,1534,41,587.1627906976744,37,6,18,34.5254010695187,0.6323198198198199,43.69517543859647,1025.219298245611,27.708629682313813,0
1538,4,0,0,43,0.0,0.0,1.0,43,1400,1000,400,0.7142857142857143,18,10,8,362.37317263400456,0.4048541897379107,0.06401065850045251,0.21349895485917778,131553.00188519532,934.2557325330745,132487.2576177284,1535,42,588.1627906976744,37,6,19,34.23694242553798,0.6340090090090091,43.53070175438596,1025.8771929824552,27.726410621147437,0
1539,4,0,0,43,0.0,0.0,1.0,43,1250,800,450,0.64,17,8,9,359.1993814598263,0.4038851974898487,0.06891549865999025,0.21272509858370345,131749.92696069932,864.8984543320903,132614.8254150314,1536,43,589.1627906976744,37,6,17,34.11956192815694,0.6359797297297298,43.33881578947368,1026.6447368421043,27.747155049786603,0
1540,4,0,0,43,0.0,0.0,1.0,43,1200,900,300,0.75,15,9,6,354.04138389127854,0.4034237726098191,0.0694962851531089,0.21073688408688454,131942.77479383667,742.6405164930372,132685.4153103297,1537,44,590.1627906976744,39,4,19,34.05752560072999,0.6343482905982908,43.15104166666666,1027.3958333333321,26.343482905982874,0
1541,4,0,1,42,0.0,0.023255813953488372,0.9767441860465116,43,1300,1100,200,0.8461538461538461,15,11,4,352.07947946029685,0.4033545588778147,0.06664387840497876,0.20986489817980783,131996.29041883646,694.6370442707962,132690.92746310725,1538,45,591.1627906976744,39,4,19,34.05399983105253,0.6348824786324789,43.098958333333314,1027.604166666664,26.34882478632472,0
1542,4,0,0,42,0.0,0.0,1.0,42,1050,600,450,0.5714285714285714,15,6,9,356.4803049802526,0.4031165311653116,0.06352672073196142,0.2124304568339567,131985.99810979585,1010.0817718605882,132996.07988165645,1539,46,599.9285714285714,38,4,19,33.95131524225411,0.636513157894737,43.10897435897434,1027.5641025641,27.041160593792107,0
1543,4,0,0,42,0.0,0.0,1.0,42,800,300,500,0.375,13,3,10,356.44373582927716,0.4028866627951994,0.060321914858865844,0.21287058860418806,132068.34781804716,1014.9870562130035,133083.33487426015,1540,47,600.9285714285714,38,4,19,33.86927034611787,0.6373355263157896,43.028846153846146,1027.8846153846139,27.049595141700365,0
1544,4,0,0,42,0.0,0.0,1.0,42,1150,700,450,0.6086956521739131,16,7,9,356.44373582927716,0.40292295780100656,0.060321914858865844,0.21287058860418806,132068.34781804716,1014.9870562130035,133083.33487426015,1541,48,601.9285714285714,38,4,19,33.86927034611787,0.6373355263157896,43.028846153846146,1027.8846153846139,27.049595141700365,0
1545,4,0,1,41,0.0,0.023809523809523808,0.9761904761904762,42,1150,700,450,0.6086956521739131,16,7,9,363.6075425872834,0.40256000774293454,0.0680148423005571,0.21777987538286217,132178.18737900836,1212.1971793045193,133390.3845583129,1542,49,602.9285714285714,38,4,19,33.574458874458884,0.6384320175438598,42.92200854700853,1028.3119658119633,27.060841205577983,0
1546,4,0,0,41,0.0,0.0,1.0,41,400,100,300,0.25,7,1,6,369.2913777777784,0.3997713414634146,0.07462504065040698,0.22065689398767782,132087.85545792908,1555.7812259541088,133643.63668388317,1543,50,616.9268292682926,37,4,19,33.51944444444444,0.6393581081081082,43.009868421052616,1027.960526315787,27.782716927453706,0
1547,4,0,0,41,0.0,0.0,1.0,41,1300,700,600,0.5384615384615384,19,7,12,371.9004732657152,0.39997459349593495,0.07424203026678455,0.22304516874887523,132228.78674207444,1635.1896737457614,133863.97641582022,1544,51,617.9268292682926,37,4,19,33.31023454157781,0.6407657657657657,42.872807017543856,1028.5087719298242,27.797534376481735,0
1548,4,0,0,41,0.0,0.0,1.0,41,850,600,250,0.7058823529411765,11,6,5,374.0785127204079,0.4000254065040651,0.06990327603371904,0.22485449614705882,132313.381581352,1699.1185989919964,134012.500180344,1545,52,618.9268292682926,37,4,19,33.168918078794974,0.6416103603603605,42.790570175438596,1028.837719298246,27.80642484589854,0
1549,4,0,0,41,0.0,0.0,1.0,41,650,300,350,0.46153846153846156,10,3,7,370.94694388031064,0.3996951219512195,0.07113989952191879,0.22331006021594682,132370.5164730805,1620.487709109499,133991.00418219,1546,53,619.9268292682926,38,3,19,33.19187776854928,0.6403508771929824,42.73504273504273,1029.0598290598284,27.080521817363906,0
1550,4,0,1,40,0.0,0.024390243902439025,0.975609756097561,41,750,500,250,0.6666666666666666,10,5,5,370.39468537379105,0.39974593495934957,0.06945446267686539,0.22331660590027952,132427.7842747985,1610.1180589481257,134037.90233374664,1547,54,620.9268292682926,35,6,19,33.14837981183702,0.6467261904761905,42.679398148148145,1029.2824074074072,29.408068783068774,0
1551,4,0,1,39,0.0,0.025,0.975,40,950,800,150,0.8421052631578947,11,8,3,375.8995788226976,0.3990651709401709,0.07525445292620914,0.22664070840314093,132428.6352040815,1955.9736394557722,134384.60884353728,1548,55,634.825,34,6,19,33.005869766365954,0.6488970588235294,42.67857142857142,1029.2857142857133,30.27310924369745,0
1552,4,0,0,39,0.0,0.0,1.0,39,1250,900,350,0.72,16,9,7,378.29441832527107,0.3964799820062978,0.08246988684033396,0.22864209811986513,132520.5516581633,2226.357001133789,134746.9086592971,1549,56,648.5641025641025,34,5,19,32.851582071145025,0.6498161764705883,42.589285714285715,1029.6428571428576,30.283613445378165,0
1553,4,0,0,39,0.0,0.0,1.0,39,900,600,300,0.6666666666666666,12,6,6,376.6717985777275,0.39558029689608637,0.08571902746660065,0.22821879560885847,132612.5,2190.2777777777783,134802.77777777778,1550,57,649.5641025641025,34,5,19,32.800701186623506,0.650735294117647,42.5,1030.0,30.294117647058822,0
1554,4,1,0,40,0.025,0.0,1.0,40,1000,600,400,0.6,14,6,8,369.0640935186152,0.3973557692307692,0.10629556926528361,0.22644228449541984,133083.809223358,1823.2910826045704,134907.10030596258,1551,0,634.3,35,5,17,32.52255094410169,0.6532738095238096,42.04282407407406,1031.828703703702,29.48082010582006,0
1555,4,0,0,40,0.0,0.0,1.0,40,1100,900,200,0.8181818181818182,13,9,4,368.6448123264422,0.39736912393162394,0.10689771197846554,0.2263661946764845,133113.66705246898,1814.3325617283745,134927.99961419735,1552,1,635.3,35,5,17,32.50336473755046,0.6535714285714287,42.01388888888888,1031.9444444444432,29.48412698412695,0
1556,4,0,0,40,0.0,0.0,1.0,40,1050,600,450,0.5714285714285714,15,6,9,367.12704891256897,0.39668803418803417,0.10083538910069545,0.22579579463464028,133173.3927576301,1778.3109353566251,134951.70369298672,1553,2,636.3,35,5,17,32.48252597742393,0.6541666666666668,41.956018518518505,1032.175925925924,29.490740740740687,0
1557,4,0,1,39,0.0,0.025,0.975,40,950,700,250,0.7368421052631579,12,7,5,363.0646834306854,0.397142094017094,0.12854776661679934,0.21422189833192584,131609.25116381916,1563.6206632548328,133172.871827074,1554,3,637.3,37,3,17,34.16239224905607,0.6345720720720722,43.47587719298243,1026.0964912280663,27.732337600758548,6
1558,4,0,0,39,0.0,0.0,1.0,39,1050,900,150,0.8571428571428571,12,9,3,360.0938709913075,0.39465249662618085,0.11955950032873153,0.21278274194940844,131665.51246537355,1682.3888119420874,133347.90127731563,1555,4,634.1025641025641,37,2,17,34.18180199430197,0.6351351351351353,43.421052631578924,1026.3157894736808,27.73826458036975,0
1559,4,0,0,39,0.0,0.0,1.0,39,1050,800,250,0.7619047619047619,13,8,5,363.3469608916307,0.3939496176338282,0.11963257351814183,0.21597933563659838,131890.6779008923,1784.415397045212,133675.0932979375,1556,5,635.1025641025641,37,2,18,33.8710681753487,0.6373873873873874,43.2017543859649,1027.192982456138,27.76197249881454,0
1560,4,0,1,38,0.0,0.02564102564102564,0.9743589743589743,39,700,500,200,0.7142857142857143,9,5,4,366.2356190714566,0.3932186234817814,0.11426288891077663,0.21834352556855502,132003.33275623247,1868.8644582948361,133872.19721452732,1557,6,636.1025641025641,37,2,19,33.683223075828714,0.6385135135135136,43.09210526315788,1027.6315789473665,27.773826458036933,0
1561,4,0,0,38,0.0,0.0,1.0,38,1000,700,300,0.7,13,7,6,374.94923563716895,0.3913140113798008,0.12912157640923883,0.22330527584553078,131963.74584043506,2295.9411269377556,134259.6869673728,1558,65,653.6842105263158,36,2,19,33.49933326026596,0.6400462962962963,43.130630630630634,1027.4774774774778,28.54104104104105,0
1562,4,0,0,38,0.0,0.0,1.0,38,1100,700,400,0.6363636363636364,15,7,8,370.4967435209323,0.3902027027027027,0.13176918199112242,0.22166679346960108,132137.36329234645,2191.2925594513495,134328.65585179778,1559,66,654.6842105263158,36,2,19,33.438526834611174,0.6417824074074074,42.961711711711715,1028.1531531531534,28.559809809809817,0
1563,4,0,0,38,0.0,0.0,1.0,38,950,700,250,0.7368421052631579,12,7,5,370.4967435209323,0.3902027027027027,0.13176918199112242,0.22166679346960108,132137.36329234645,2191.2925594513495,134328.65585179778,1560,67,655.6842105263158,36,2,19,33.438526834611174,0.6417824074074074,42.961711711711715,1028.1531531531534,28.559809809809817,0
1564,4,2,2,38,0.05,0.05,0.95,40,1200,1100,100,0.9166666666666666,13,11,2,352.68760145572503,0.3944310897435897,0.12501064282673502,0.214073172046382,132680.2718144045,1359.1941677537118,134039.4659821582,1561,0,623.85,37,3,15,33.35018447566341,0.6452702702702702,42.434210526315795,1030.2631578947373,27.84495021337128,0
1565,4,0,0,38,0.0,0.0,1.0,38,850,500,350,0.5882352941176471,12,5,7,363.40214247729983,0.3891654812707444,0.1326617555693621,0.21944752595625133,132487.35592689045,2029.2377989969157,134516.59372588736,1562,69,657.6842105263158,35,3,21,33.2683389544688,0.6473214285714286,42.62152777777778,1029.513888888889,29.41468253968254,0
1566,4,1,1,38,0.02564102564102564,0.02564102564102564,0.9743589743589743,39,750,600,150,0.8,9,6,3,356.5945500085578,0.3902946468735942,0.13658777120315602,0.2169915772392502,132774.93709926153,1669.3637894651547,134444.3008887267,1563,0,641.7948717948718,36,3,15,33.1544106934732,0.6481481481481481,42.34234234234235,1030.6306306306315,28.62862862862865,0
1567,4,0,0,38,0.0,0.0,1.0,38,1050,800,250,0.7619047619047619,13,8,5,363.830241861692,0.3884690611664296,0.1384439359267733,0.22075344122773824,132666.1512586805,2053.5915798611068,134719.7428385416,1564,71,659.6842105263158,35,3,15,33.07739298955174,0.6491071428571429,42.447916666666664,1030.208333333333,29.4345238095238,0
1568,4,0,0,38,0.0,0.0,1.0,38,800,300,500,0.375,13,3,10,361.2979451121344,0.38737256993835945,0.13594287225601698,0.22019449997047127,132832.97444403864,1998.456141952767,134831.43058599142,1565,72,660.6842105263158,36,2,17,32.97488347534777,0.6487268518518519,42.28603603603604,1030.855855855856,28.634884884884887,0
1569,4,0,0,38,0.0,0.0,1.0,38,1100,500,600,0.45454545454545453,17,5,12,366.35528498693765,0.38675023707918443,0.13985290737761402,0.22431914508558487,133007.1625679734,2145.5753895787702,135152.73795755216,1566,73,661.6842105263158,36,2,17,32.669441411935956,0.650462962962963,42.11711711711712,1031.5315315315318,28.65365365365366,0
1570,4,1,0,39,0.02564102564102564,0.0,1.0,39,1300,900,400,0.6923076923076923,17,9,8,364.1518024170462,0.3902665317139002,0.13520605367739114,0.22508595661211134,133358.94217451528,1912.5798322560806,135271.52200677135,1567,0,645.6923076923077,37,2,19,32.37305378627034,0.652027027027027,41.776315789473685,1032.8947368421057,27.916073968705557,0
1571,4,0,0,39,0.0,0.0,1.0,39,1050,800,250,0.7619047619047619,13,8,5,364.85431841831394,0.3901540710751237,0.14102564102564052,0.22620967741935485,133472.22222222234,1939.6314250538726,135411.8536472762,1568,1,646.6923076923077,36,3,19,32.2412634408602,0.6550925925925926,41.66666666666667,1033.3333333333344,28.703703703703734,0
1572,4,0,0,39,0.0,0.0,1.0,39,1250,900,350,0.72,16,9,7,362.8885163591566,0.389704228520018,0.1398241216850553,0.22553634931131716,133561.93636670534,1893.6185860339567,135455.5549527393,1569,2,647.6923076923077,35,4,19,32.202091031239505,0.6580357142857143,41.579861111111114,1033.680555555556,29.533730158730176,0
1573,4,0,0,39,0.0,0.0,1.0,39,1150,900,250,0.782608695652174,14,9,5,365.444644824948,0.3890856950067476,0.13615714634181342,0.22786098405519267,133681.60211173276,1970.645120670446,135652.2472324032,1570,3,648.6923076923077,35,4,20,32.01606509979481,0.6592261904761905,41.464120370370374,1034.1435185185192,29.54695767195769,0
1574,4,0,0,39,0.0,0.0,1.0,39,1200,500,700,0.4166666666666667,19,5,14,363.1804558060016,0.3884109311740891,0.13016120165973266,0.2274891075938208,133850.68081172404,1922.3902534291224,135773.07106515317,1571,4,649.6923076923077,36,3,15,31.905221823194413,0.6588541666666665,41.300675675675684,1034.7972972972984,28.7443693693694,0
1575,4,0,0,39,0.0,0.0,1.0,39,650,400,250,0.6153846153846154,9,4,5,362.9142240761763,0.3880454340980657,0.13221729304427865,0.22750216366030468,133879.81520371747,1917.3778508238236,135797.1930545413,1572,5,650.6923076923077,36,3,15,31.882934348929997,0.6591435185185184,41.272522522522536,1034.909909909912,28.74749749749755,0
1576,4,0,0,39,0.0,0.0,1.0,39,1000,900,100,0.9,11,9,2,362.3861954755866,0.38790485829959515,0.13239728109737903,0.2277112983600186,133967.23740209828,1909.5754961042383,135876.8128982025,1573,6,651.6923076923077,36,3,15,31.80907574603866,0.660011574074074,41.188063063063076,1035.2477477477496,28.756881881881935,0
1577,4,0,1,38,0.0,0.02564102564102564,0.9743589743589743,39,900,600,300,0.6666666666666666,12,6,6,364.0442797055509,0.38776428250112466,0.12886316235598483,0.2292980271350856,134054.68813408026,1960.3684765847192,136015.056610665,1574,7,652.6923076923077,36,3,16,31.67862838915472,0.6608796296296295,41.10360360360362,1035.5855855855875,28.76626626626632,0
1578,4,0,0,38,0.0,0.0,1.0,38,450,200,250,0.4444444444444444,7,2,5,373.3395481007352,0.3833422238027501,0.13126114514733622,0.23430004060806167,133921.09435281658,2399.6081693673063,136320.70252218388,1575,82,670.6842105263158,35,3,16,31.571829922844678,0.6616071428571427,41.2326388888889,1035.0694444444462,29.57341269841275,0
1579,4,0,0,38,0.0,0.0,1.0,38,1250,700,550,0.56,18,7,11,375.111514775941,0.382823613086771,0.13634384945262412,0.23618034642507726,134040.9208488728,2456.058572316552,136496.97942118935,1576,83,671.6842105263158,35,3,16,31.405894899593903,0.6627976190476189,41.11689814814816,1035.532407407409,29.58664021164026,0
1580,4,0,0,38,0.0,0.0,1.0,38,1000,400,600,0.4,16,4,12,375.54607903175645,0.3823494547178758,0.1255474495464619,0.23761583360928046,134220.7610623501,2481.2161083247756,136701.97717067486,1577,84,672.6842105263158,35,3,17,31.214513757027458,0.6645833333333332,40.943287037037045,1036.2268518518529,29.60648148148151,0
1581,4,0,1,37,0.0,0.02631578947368421,0.9736842105263158,38,950,500,450,0.5263157894736842,14,5,9,379.35449792654117,0.38144559032716924,0.13538703838649746,0.24061606823159376,134310.7263803156,2590.2756344307395,136901.00201474634,1578,85,673.6842105263158,35,3,17,31.025755545630496,0.6654761904761903,40.85648148148149,1036.5740740740748,29.61640211640214,0
1582,4,0,0,37,0.0,0.0,1.0,37,1150,800,350,0.6956521739130435,15,8,7,375.54364592964134,0.38206956956956956,0.13024340764499165,0.2393644321130188,134489.03238378695,2701.3003117913977,137190.33269557834,1579,86,684.6756756756756,34,3,18,30.946095872068568,0.669424019607843,40.68452380952382,1037.2619047619055,30.507703081232513,0
1583,4,0,0,37,0.0,0.0,1.0,37,950,700,250,0.7368421052631579,12,7,5,374.9939517104559,0.3818818818818819,0.1276457180071633,0.23941921532282978,134550.78125000015,2691.145833333347,137241.9270833335,1580,87,685.6756756756756,34,3,18,30.898594377510037,0.6700367647058822,40.62500000000001,1037.5000000000011,30.514705882352974,0
1584,4,0,0,37,0.0,0.0,1.0,37,900,500,400,0.5555555555555556,13,5,8,374.9506233275463,0.38100600600600604,0.1311410560702344,0.24065012733567964,134741.56574394458,2704.2868127643133,137445.85255670888,1581,88,686.6756756756756,33,4,19,30.70900220333648,0.6742424242424242,40.44117647058823,1038.2352941176466,31.461675579322623,0
1585,4,0,0,37,0.0,0.0,1.0,37,600,500,100,0.8333333333333334,7,5,2,373.0976041470747,0.38075575575575576,0.1281072404667909,0.23962866740580188,134767.01388888905,2656.2500000000236,137423.26388888908,1582,89,687.6756756756756,34,3,19,30.73167469234886,0.6721813725490196,40.41666666666668,1038.3333333333346,30.53921568627455,0
1586,4,0,0,37,0.0,0.0,1.0,37,1050,800,250,0.7619047619047619,13,8,5,374.2596530406155,0.38078703703703703,0.12573375667931574,0.24099007179183546,134859.7381660998,2694.511763038555,137554.24992913834,1583,90,688.6756756756756,34,3,15,30.60888252148998,0.6731004901960784,40.327380952380956,1038.6904761904764,30.549719887955188,0
1587,4,0,0,37,0.0,0.0,1.0,37,1250,800,450,0.64,17,8,9,372.7620305625308,0.3809434434434435,0.12617980033195408,0.2406410504992434,134952.49433106586,2661.033163265311,137613.52749433118,1584,91,689.6756756756756,34,3,16,30.555157729911397,0.6740196078431373,40.23809523809524,1039.0476190476197,30.560224089635874,0
1588,4,0,0,37,0.0,0.0,1.0,37,800,600,200,0.75,10,6,4,375.6808917643719,0.3802865365365365,0.13225939259612396,0.24314824803519147,135045.28238378698,2746.786422902512,137792.0688066895,1585,92,690.6756756756756,34,3,16,30.386696827396637,0.674938725490196,40.14880952380953,1039.4047619047628,30.570728291316556,0
1589,4,0,0,37,0.0,0.0,1.0,37,1000,800,200,0.8,12,8,4,371.76606466604335,0.38022397397397395,0.12837064222454697,0.24123364106933304,135138.10232426313,2647.952097505685,137786.05442176881,1586,93,691.6756756756756,34,3,16,30.395819021448755,0.6758578431372548,40.05952380952382,1039.7619047619055,30.58123249299722,0
1590,4,0,0,37,0.0,0.0,1.0,37,900,700,200,0.7777777777777778,11,7,4,372.7331302371141,0.3797547547547548,0.13120078192177065,0.24269315141668432,135261.91184807263,2683.319160997745,137945.23100907038,1587,94,692.6756756756756,34,3,16,30.247196154726485,0.6770833333333333,39.9404761904762,1040.2380952380959,30.595238095238113,0
1591,4,0,0,37,0.0,0.0,1.0,37,900,600,300,0.6666666666666666,12,6,6,375.0416808013071,0.3796296296296296,0.1372716956746245,0.24482743329979276,135354.8061933106,2752.7388038548706,138107.54499716547,1588,95,693.6756756756756,34,3,16,30.094525797963627,0.6780024509803921,39.851190476190474,1040.5952380952376,30.605742296918752,0
1592,4,0,0,37,0.0,0.0,1.0,37,900,700,200,0.7777777777777778,11,7,4,363.20462638949186,0.37941066066066065,0.06607779654654666,0.2324509608892747,134638.42220598977,2380.259566999432,137018.6817729892,1589,96,694.6756756756756,36,1,20,31.116852936921294,0.6666666666666666,40.54054054054054,1037.8378378378377,28.828828828828826,3
1593,4,1,0,38,0.02631578947368421,0.0,1.0,38,750,500,250,0.6666666666666666,10,5,5,353.06654785193643,0.38191974869606443,0.0649881960838774,0.22772672164037422,134920.75837036394,1927.2012782779304,136847.95964864187,1590,0,677.3684210526316,37,1,17,31.09839489885664,0.6675112612612613,40.26864035087719,1038.9254385964912,28.079065908013273,0
1594,4,0,0,38,0.0,0.0,1.0,38,900,600,300,0.6666666666666666,12,6,6,353.057586607535,0.381015884305358,0.06811896802567663,0.22825919548882767,135006.2098434133,1932.99332486918,136939.20316828246,1591,1,678.3684210526316,37,1,17,31.01348737427024,0.6683558558558559,40.186403508771924,1039.2543859649118,28.087956377430046,0
1595,4,0,0,38,0.0,0.0,1.0,38,1100,800,300,0.7272727272727273,14,8,6,357.84940224222186,0.3805269084874348,0.07981327501415403,0.23208810068814945,135120.18722106787,2070.53564558324,137190.7228666511,1592,2,679.3684210526316,37,1,18,30.77541657878084,0.6694819819819819,40.076754385964904,1039.6929824561394,28.099810336652414,0
1596,4,0,0,38,0.0,0.0,1.0,38,900,600,300,0.6666666666666666,12,6,6,356.4128947504062,0.3793711474632527,0.07897510721042078,0.2320720063484626,135262.72657211818,2041.87598588025,137304.6025579984,1593,3,680.3684210526316,37,1,20,30.670808299075922,0.6708896396396398,39.93969298245613,1040.241228070174,28.114627785680376,0
1597,4,0,0,38,0.0,0.0,1.0,38,700,500,200,0.7142857142857143,9,5,4,353.8539907782803,0.37969713134186817,0.07965178516953131,0.2307711696560205,135319.76335266605,1976.6876587026607,137296.4510113687,1594,4,681.3684210526316,37,1,20,30.680590683949834,0.6714527027027027,39.88486842105262,1040.4605263157882,28.120554765291573,0
1598,4,0,0,38,0.0,0.0,1.0,38,1050,700,350,0.6666666666666666,14,7,7,359.2503386088299,0.3791488857278331,0.0810876749395617,0.23484877507403645,135405.34106648175,2128.8829255155183,137534.22399199728,1595,5,682.3684210526316,37,1,20,30.455032307908418,0.6722972972972974,39.802631578947356,1040.7894736842086,28.12944523470834,0
1599,4,0,0,38,0.0,0.0,1.0,38,1150,900,250,0.782608695652174,14,9,5,356.81232163376217,0.377993124703651,0.08938943821221135,0.2339979147951798,135519.48676515836,2071.0045398584016,137590.49130501677,1596,6,683.3684210526316,37,1,21,30.404907329401837,0.6734234234234235,39.69298245614034,1041.2280701754373,28.141299193930738,0
1600,4,0,0,38,0.0,0.0,1.0,38,1000,800,200,0.8,12,8,4,359.13654554270124,0.3769707207207207,0.09018954903840282,0.23608567793149585,135605.12759935728,2140.1514167820624,137745.27901613933,1597,7,684.3684210526316,37,1,21,30.25921588237357,0.6742680180180181,39.610745614035075,1041.557017543858,28.15018966334751,0
1601,4,0,0,38,0.0,0.0,1.0,38,1050,800,250,0.7619047619047619,13,8,5,361.0792911570743,0.37679291133238507,0.08862275108499662,0.23813732580729907,135721.67342595966,2201.2601327920156,137922.93355875168,1598,8,685.3684210526316,36,2,21,30.092717677149736,0.6773726851851853,39.49887387387387,1042.004504504504,28.944569569569556,0
1602,4,0,0,38,0.0,0.0,1.0,38,1100,900,200,0.8181818181818182,13,9,4,361.00777508383203,0.37720779990516834,0.09065085728908961,0.23848158161319513,135780.35119156315,2203.5524967535066,137983.90368831667,1599,9,686.3684210526316,36,2,21,30.03624167116874,0.677951388888889,39.442567567567565,1042.2297297297293,28.950825825825817,0
1603,4,0,0,38,0.0,0.0,1.0,38,950,700,250,0.7368421052631579,12,7,5,364.79999999999995,0.3775782361308677,0.052000000000000046,0.24000000000000007,135633.6805555557,2310.9276083516147,137944.6081639073,1600,10,687.3684210526316,36,2,16,30.083333333333343,0.6765046296296295,39.58333333333334,1041.6666666666679,28.93518518518522,6
1604,4,0,0,38,0.0,0.0,1.0,38,800,400,400,0.5,12,4,8,363.5007043966046,0.3772226173541963,0.04810908594443286,0.2395376436664808,135692.33929875845,2264.85218326437,137957.1914820228,1601,11,688.3684210526316,36,2,16,30.058816111831675,0.6770833333333333,39.52702702702704,1041.8918918918937,28.94144144144149,0
1605,4,0,0,38,0.0,0.0,1.0,38,650,300,350,0.46153846153846156,10,3,7,362.9980463572796,0.37700035561877665,0.04942635958750219,0.239402774265425,135721.67342595992,2253.340460392845,137975.01388635277,1602,12,689.3684210526316,36,2,16,30.04273388810836,0.6773726851851851,39.49887387387388,1042.0045045045058,28.944569569569605,0
1606,4,0,0,38,0.0,0.0,1.0,38,700,500,200,0.7142857142857143,9,5,4,364.95353711092304,0.37627430061640593,0.05316608288222735,0.24128642424990746,135809.69482996513,2312.845700430164,138122.5405303953,1603,13,690.3684210526316,36,2,17,29.904251296456344,0.6782407407407407,39.414414414414416,1042.3423423423426,28.95395395395396,0
1607,4,0,0,38,0.0,0.0,1.0,38,1000,800,200,0.8,12,8,4,364.5076935907224,0.3758890469416785,0.05285329331104838,0.24138857133497188,135868.39161796926,2305.0148121094016,138173.40643007867,1604,14,691.3684210526316,36,2,14,29.857510621444508,0.6788194444444444,39.358108108108105,1042.5675675675673,28.960210210210203,0
1608,4,0,0,38,0.0,0.0,1.0,38,1050,800,250,0.7619047619047619,13,8,5,366.1115360436163,0.37557788051209107,0.044293368636965536,0.24345234446317435,136015.18906998212,2359.345959134809,138374.53502911693,1605,15,692.3684210526316,36,2,14,29.669788405484184,0.6802662037037037,39.21734234234234,1043.1306306306305,28.975850850850847,0
1609,4,0,1,37,0.0,0.02631578947368421,0.9736842105263158,38,800,500,300,0.625,11,5,6,365.89359498761075,0.374985182550972,0.044092507085129906,0.24411345894529812,136132.6840987948,2362.015436044159,138494.69953483896,1606,16,693.3684210526316,36,2,15,29.558738894284385,0.6814236111111112,39.10472972972973,1043.5810810810815,28.988363363363376,0
1610,4,0,0,37,0.0,0.0,1.0,37,1100,800,300,0.7272727272727273,14,8,6,372.7076784554646,0.3722472472472473,0.06635377892862948,0.24896872920825003,136176.75781249985,2750.824652777762,138927.5824652776,1607,114,712.6756756756756,35,2,15,29.33715901530273,0.6839285714285714,39.06249999999999,1043.7499999999989,29.821428571428537,0
1611,4,0,0,37,0.0,0.0,1.0,37,850,700,150,0.8235294117647058,10,7,3,373.94981336048903,0.3720908408408408,0.07219589352154232,0.25065194770715643,136297.58900248603,2793.691593792838,139091.28059627887,1608,115,713.6756756756756,35,2,16,29.184678194044185,0.6851190476190476,38.946759259259245,1044.212962962961,29.83465608465603,0
1612,4,0,0,37,0.0,0.0,1.0,37,950,700,250,0.7368421052631579,12,7,5,372.24744001159826,0.37180930930930933,0.07257728747255521,0.24972406328807797,136327.80517243216,2749.5352955675476,139077.3404679997,1609,116,714.6756756756756,35,2,16,29.19910691196572,0.6854166666666668,38.91782407407407,1044.3287037037028,29.837962962962937,0
1613,4,0,1,36,0.0,0.02702702702702703,0.972972972972973,37,1250,1000,250,0.8,15,10,5,370.7620905975991,0.3711836836836837,0.07065290614642539,0.24958011870428962,136448.7033420137,2718.0013020833085,139166.70464409702,1610,117,715.6756756756756,35,2,16,29.117854769026245,0.686607142857143,38.80208333333332,1044.7916666666652,29.851190476190432,0
1614,4,0,0,36,0.0,0.0,1.0,36,750,500,250,0.6666666666666666,10,5,5,373.9083960751551,0.3676256613756614,0.08943938243482652,0.2525319782722971,136565.3344671202,3012.5850340136035,139577.91950113382,1611,118,732.6944444444445,34,2,16,28.919893697798006,0.6899509803921569,38.69047619047619,1045.2380952380954,30.74229691876751,0
1615,4,0,0,36,0.0,0.0,1.0,36,750,400,350,0.5333333333333333,11,4,7,374.6623559104095,0.36769179894179893,0.0858675327231575,0.25328970049272587,136599.9014060356,3035.7681755829844,139635.6695816186,1612,119,733.6944444444445,35,1,16,28.865884263359895,0.6880952380952381,38.657407407407405,1045.37037037037,29.867724867724856,0
1616,4,0,0,36,0.0,0.0,1.0,36,950,500,450,0.5263157894736842,14,5,9,375.6193784915024,0.36737764550264546,0.08939002644038618,0.25459272953268763,136690.660432206,3068.7321834276468,139759.39261563364,1613,120,734.6944444444445,35,1,16,28.750807046670356,0.6889880952380952,38.570601851851855,1045.717592592593,29.877645502645517,0
1617,4,0,0,36,0.0,0.0,1.0,36,850,600,250,0.7058823529411765,11,6,5,374.44003465217577,0.36630291005291005,0.08601977218998513,0.25491506309511774,136845.452451814,3048.086540589736,139893.53899240374,1614,121,735.6944444444445,34,2,17,28.62811468881557,0.6927083333333334,38.422619047619044,1046.3095238095232,30.773809523809504,0
1618,4,0,0,36,0.0,0.0,1.0,36,600,400,200,0.6666666666666666,8,4,4,375.0188870762274,0.36660052910052915,0.09034808326697785,0.2557634628616843,136907.73986677983,3068.597647392266,139976.3375141721,1615,122,736.6944444444445,34,2,17,28.5512171539074,0.6933210784313726,38.36309523809523,1046.5476190476174,30.780812324929926,0
1619,4,0,0,36,0.0,0.0,1.0,36,950,700,250,0.7368421052631579,12,7,5,373.8460628535584,0.3659722222222222,0.09059756174594202,0.25587362823323284,137032.35721371858,3045.8014455782036,140078.15865929678,1616,123,737.6944444444445,34,2,15,28.458404396437377,0.6945465686274511,38.244047619047606,1047.0238095238076,30.79481792717081,0
1620,4,0,0,36,0.0,0.0,1.0,36,800,600,200,0.75,10,6,4,373.8460628535584,0.36582341269841273,0.09059756174594202,0.25587362823323284,137032.35721371858,3045.8014455782036,140078.15865929678,1617,124,738.6944444444445,34,2,15,28.458404396437377,0.6945465686274511,38.244047619047606,1047.0238095238076,30.79481792717081,0
1621,4,0,0,36,0.0,0.0,1.0,36,750,400,350,0.5333333333333333,11,4,7,375.4813460931962,0.3656415343915344,0.09343663964032234,0.2576821281535051,137125.8574263036,3097.640306122419,140223.49773242604,1618,125,739.6944444444445,34,2,15,28.32296165795257,0.6954656862745099,38.15476190476189,1047.3809523809505,30.805322128851486,0
1622,4,0,0,36,0.0,0.0,1.0,36,1100,900,200,0.8181818181818182,13,9,4,374.8165399545489,0.36582341269841273,0.08743640242901662,0.25791715153557326,137219.38952664385,3086.4193594104127,140305.80888605426,1619,126,740.6944444444445,34,2,16,28.247736999583374,0.6963848039215688,38.06547619047618,1047.7380952380943,30.815826330532186,0
1623,4,0,0,36,0.0,0.0,1.0,36,900,500,400,0.5555555555555556,13,5,8,389.4506899406236,0.36582341269841273,0.11977610936196603,0.2581126643282238,135896.85523160893,3406.9671247363253,139303.82235634525,1620,127,741.6944444444445,32,4,14,29.179028416888666,0.6881510416666667,39.330808080808076,1042.676767676767,32.58364898989897,3
1624,4,0,0,36,0.0,0.0,1.0,36,650,400,250,0.6153846153846154,9,4,5,387.5537316297547,0.36582341269841273,0.11896461679070391,0.25726070640945486,135953.00635572855,3337.8189878892663,139290.82534361782,1621,128,742.6944444444445,33,3,15,29.17254210732472,0.6862373737373737,39.27696078431372,1042.8921568627447,31.602792632204388,0
1625,4,0,0,36,0.0,0.0,1.0,36,900,700,200,0.7777777777777778,11,7,4,388.36565578027324,0.36560846560846566,0.12059230538257659,0.258031233126144,135984.95958585633,3362.377601163007,139347.33718701932,1622,129,743.6944444444445,33,3,15,29.119546273450048,0.6865530303030303,39.24632352941176,1043.0147058823525,31.606506238859165,0
1626,4,0,0,36,0.0,0.0,1.0,36,1200,900,300,0.75,15,9,6,391.9558156050745,0.36582341269841273,0.11852199780804762,0.2615905741138567,136144.78205497877,3472.547818146854,139617.32987312562,1623,130,744.6944444444445,33,3,16,28.866741036480352,0.6881313131313131,39.093137254901954,1043.6274509803914,31.625074272133073,0
1627,4,0,0,36,0.0,0.0,1.0,36,650,500,150,0.7692307692307693,8,5,3,392.90684084481103,0.36574074074074076,0.12340063387721578,0.2629358505229335,136240.7205912389,3505.9822243848507,139746.70281562375,1624,131,745.6944444444445,33,3,16,28.746405094494666,0.6890782828282829,39.00122549019608,1043.9950980392155,31.636215092097437,0
1628,4,0,0,36,0.0,0.0,1.0,36,1300,1100,200,0.8461538461538461,15,11,4,393.4513324734943,0.3652943121693122,0.12029648752249056,0.2640151382156788,136336.69291858913,3528.3706987697133,139865.06361735886,1625,132,746.6944444444445,33,3,16,28.63666588437768,0.6900252525252525,38.9093137254902,1044.3627450980403,31.647355912061826,0
1629,4,0,0,36,0.0,0.0,1.0,36,850,500,350,0.5882352941176471,12,5,7,395.4989035182013,0.3646494708994709,0.12915933528836732,0.2661111406860827,136432.69903702912,3591.7965746347622,140024.49561166388,1626,133,747.6944444444445,33,3,16,28.487658846529804,0.6909722222222222,38.817401960784316,1044.7303921568634,31.658496732026165,0
1630,4,0,0,36,0.0,0.0,1.0,36,1000,700,300,0.7,13,7,6,392.0525345930323,0.3640046296296296,0.12561236189284974,0.26451139359251447,136528.73894655914,3505.287629757803,140034.02657631694,1627,134,748.6944444444445,33,3,17,28.482156816760487,0.6919191919191918,38.72549019607844,1045.0980392156873,31.669637551990526,0
1631,4,0,1,35,0.0,0.027777777777777776,0.9722222222222222,36,1200,800,400,0.6666666666666666,16,8,8,389.44749849934783,0.3631117724867725,0.12147731416367136,0.26371159184098714,136656.8447231835,3444.133266051532,140100.97798923502,1628,135,749.6944444444445,33,3,18,28.422898109079547,0.6931818181818181,38.602941176470594,1045.5882352941185,31.68449197860965,0
1632,4,0,0,35,0.0,0.0,1.0,35,1100,900,200,0.8181818181818182,13,9,4,403.8692554146149,0.36134453781512604,0.13316752163324508,0.27091667571243105,136325.05810950394,4011.4999426078693,140336.5580521118,1629,136,758.4,32,3,16,28.37625438278322,0.6923828125000001,38.92045454545453,1044.3181818181802,32.63494318181813,4
1633,4,0,0,35,0.0,0.0,1.0,35,900,600,300,0.6666666666666666,12,6,6,403.53383884110474,0.3610294117647059,0.131534954407295,0.27094414893617,136358.0246913579,4005.015432098743,140363.04012345662,1630,137,759.4,32,3,17,28.352171985815595,0.6927083333333335,38.88888888888888,1044.4444444444432,32.63888888888885,0
1634,4,0,0,35,0.0,0.0,1.0,35,1150,900,250,0.782608695652174,14,9,5,402.17954781950635,0.36067927170868347,0.1272492668621703,0.27060620719505046,136432.69903702894,3974.088241301412,140406.78727833036,1631,138,760.4,33,2,17,28.313172043010756,0.6909722222222223,38.81740196078431,1044.730392156862,31.658496732026123,0
1635,4,0,0,35,0.0,0.0,1.0,35,1400,900,500,0.6428571428571429,19,9,10,408.2450876775849,0.36032913165266106,0.13684809914587137,0.27593744832724254,136592.7843257401,4152.666642637447,140745.45096837755,1632,139,761.4,33,2,18,27.99531066822978,0.6925505050505051,38.66421568627451,1045.343137254902,31.677064765300063,0
1636,4,0,1,34,0.0,0.02857142857142857,0.9714285714285714,35,950,500,450,0.5263157894736842,14,5,9,408.58638329640553,0.35962885154061625,0.13815272125267297,0.2774368523956907,136753.9345474953,4175.219176711734,140929.15372420705,1633,140,762.4,32,3,18,27.825979800418477,0.6966145833333333,38.51010101010102,1045.9595959595972,32.68623737373741,0
1637,4,0,0,34,0.0,0.0,1.0,34,900,500,400,0.5555555555555556,13,5,8,411.99884287844213,0.3574346405228758,0.1454990809967711,0.2797621897584551,136754.96631198452,4468.577575683585,141223.54388766811,1634,141,777.0294117647059,31,3,18,27.735720361840738,0.699260752688172,38.50911458333333,1045.963541666666,33.74075940860213,0
1638,4,0,0,34,0.0,0.0,1.0,34,1050,900,150,0.8571428571428571,12,9,3,412.2985131801996,0.3558749257278669,0.13973241405558112,0.28105539867932694,136891.19338989258,4488.007100423177,141379.20049031576,1635,142,778.0294117647059,31,3,18,27.59230745302974,0.7006048387096775,38.37890625,1046.484375,33.75756048387097,0
1639,4,0,0,34,0.0,0.0,1.0,34,800,600,200,0.75,10,6,4,417.18523743528635,0.35546642899584074,0.13888746644037542,0.2854967229120966,137027.48828464074,4633.16904703774,141660.6573316785,1636,143,779.0294117647059,31,3,16,27.328820005803582,0.7019489247311829,38.24869791666666,1047.0052083333323,33.774361559139756,0
1640,4,0,0,34,0.0,0.0,1.0,34,1100,900,200,0.8181818181818182,13,9,4,417.80896268929644,0.3555592691622103,0.1393658408166849,0.2867623972587628,137129.7539605034,4658.808051215274,141788.5620117187,1637,144,780.0294117647059,31,3,16,27.21075750041439,0.7029569892473118,38.151041666666664,1047.395833333333,33.786962365591386,0
1641,4,0,0,34,0.0,0.0,1.0,34,1050,700,350,0.6666666666666666,14,7,7,439.9949349552421,0.3555592691622103,0.17748887292547622,0.27453886632753266,133707.78613620347,4966.149732801669,138673.93586900513,1638,145,781.0294117647059,31,3,17,30.062240337404003,0.669018817204301,41.43880208333334,1034.2447916666679,33.3627352150538,5
1642,4,0,0,34,0.0,0.0,1.0,34,750,400,350,0.5333333333333333,11,4,7,437.49725238928227,0.35529931669637554,0.17290563802613534,0.27347880961706145,133775.12825859926,4905.250210232216,138680.37846883148,1639,146,782.0294117647059,31,3,17,30.058868260960764,0.6696908602150538,41.37369791666667,1034.5052083333342,33.3711357526882,0
1643,4,0,0,34,0.0,0.0,1.0,34,950,500,450,0.5263157894736842,14,5,9,437.89394526855466,0.35472370766488415,0.17463905929713675,0.2747292005477302,133909.8633660211,4927.663675944016,138837.52704196514,1640,147,783.0294117647059,31,3,18,29.91269866230553,0.6710349462365591,41.243489583333336,1035.026041666667,33.387936827957,0
1644,4,0,0,34,0.0,0.0,1.0,34,700,500,200,0.7142857142857143,9,5,4,438.51520382491134,0.35442661913250145,0.17692558094801214,0.2756232715898713,133977.2563510472,4950.212775336383,138927.46912638357,1641,148,784.0294117647059,31,3,18,29.828664109336355,0.6717069892473118,41.17838541666667,1035.2864583333342,33.39633736559143,0
1645,4,0,0,34,0.0,0.0,1.0,34,700,500,200,0.7142857142857143,9,5,4,440.70802058656716,0.35496509209744503,0.2068847200697026,0.258826904469201,131431.47193678463,4785.805709685378,136217.27764647,1642,149,785.0294117647059,30,4,19,32.351607899681035,0.6489583333333333,43.649193548387096,1025.4032258064517,34.18010752688172,4
1646,4,0,0,34,0.0,0.0,1.0,34,1050,900,150,0.8571428571428571,12,9,3,444.40179878169374,0.3549093879976233,0.20501911456406474,0.2617032815047753,131534.85952133202,4890.865634755475,136425.7251560875,1643,150,786.0294117647059,30,4,19,32.15163128930819,0.6499999999999999,43.5483870967742,1025.8064516129039,34.1935483870968,0
1647,4,1,1,34,0.02857142857142857,0.02857142857142857,0.9714285714285714,35,900,600,300,0.6666666666666666,12,6,6,439.0555650162448,0.35721288515406163,0.19564201488887667,0.26055916036742843,131829.0901184082,4576.059129503039,136405.14924791123,1644,0,764.5428571428571,31,4,17,31.98948163644816,0.6502016129032258,43.26171875,1026.953125,33.12752016129032,0
1648,4,0,0,34,0.0,0.0,1.0,34,950,600,350,0.631578947368421,13,6,7,450.2626855612945,0.3546865715983363,0.21248420793147016,0.2661150051815825,131672.772863915,5057.46726500175,136730.24012891675,1645,152,788.0294117647059,30,4,17,31.860867382573783,0.6513888888888888,43.41397849462366,1026.3440860215062,34.21146953405021,0
1649,4,1,0,35,0.02857142857142857,0.0,1.0,35,900,700,200,0.7777777777777778,11,7,4,439.1754732854861,0.3627450980392157,0.19710050496823572,0.2620114898444702,132029.74319458008,4596.844991048178,136626.58818562826,1646,0,766.4857142857143,31,4,18,31.78251298619029,0.6522177419354838,43.06640625,1027.734375,33.15272177419355,0
1650,4,0,0,35,0.0,0.0,1.0,35,750,700,50,0.9333333333333333,8,7,1,436.95763824826975,0.3620798319327731,0.18221302273365114,0.26166051513925803,132170.69686766653,4550.599109784712,136721.29597745123,1647,1,767.4857142857143,32,3,18,31.696392026850027,0.6510416666666667,42.92929292929293,1028.2828282828282,32.13383838383838,0
1651,4,1,1,35,0.027777777777777776,0.027777777777777776,0.9722222222222222,36,850,500,350,0.5882352941176471,12,5,7,427.951232375015,0.3658730158730159,0.17161311421797087,0.2584825443545091,132495.48037190083,4140.516114427106,136635.99648632793,1648,0,747.1388888888889,32,4,18,31.598755212165823,0.654296875,42.61363636363637,1029.5454545454547,32.17329545454546,0
1652,4,0,0,35,0.0,0.0,1.0,35,850,600,250,0.7058823529411765,11,6,5,437.49852591013496,0.36228991596638654,0.17876452474523252,0.26334588688655236,132366.4745080018,4582.027495434454,136948.50200343624,1649,3,769.4857142857143,33,2,18,31.4838384740582,0.6505681818181817,42.7389705882353,1029.0441176470592,31.183155080213915,0
1653,4,1,1,35,0.027777777777777776,0.027777777777777776,0.9722222222222222,36,650,400,250,0.6153846153846154,9,4,5,430.7867984154115,0.3687169312169312,0.16992562625148122,0.26087066924086955,132592.9931416438,4223.869710692176,136816.86285233597,1650,0,749.0833333333334,32,4,18,31.426995218830452,0.6552734375,42.5189393939394,1029.924242424243,32.18513257575759,0
1654,4,0,0,35,0.0,0.0,1.0,35,800,500,300,0.625,11,5,6,438.8895983835697,0.36239495798319327,0.17908920467487888,0.26486061403562133,132462.98408644527,4627.32517727783,137090.3092637231,1651,5,771.4857142857143,32,3,18,31.350167627458198,0.6539713541666666,42.64520202020202,1029.419191919192,32.16934974747475,0
1655,4,0,0,35,0.0,0.0,1.0,35,800,500,300,0.625,11,5,6,450.2847265079689,0.3621848739495798,0.2078609815927943,0.2644512839514469,131431.47193678463,4847.8072563763935,136279.27919316103,1652,6,772.4857142857143,30,5,20,32.106108271070916,0.6489583333333333,43.649193548387096,1025.4032258064517,34.18010752688172,2
1656,4,2,2,35,0.05405405405405406,0.05405405405405406,0.9459459459459459,37,1400,1100,300,0.7857142857142857,17,11,6,433.6675512801087,0.37227852852852855,0.18946816071416728,0.2583591897743428,131976.01807213546,4046.7433170084614,136022.7613891439,1653,0,731.6756756756756,32,5,18,31.978577865159338,0.6490885416666667,43.118686868686865,1027.525252525252,32.110164141414124,0
1657,4,0,0,35,0.0,0.0,1.0,35,650,600,50,0.9230769230769231,7,6,1,449.9691001827402,0.3615546218487395,0.20848348769763358,0.2657010115928243,131638.2877536419,4846.632378020562,136484.92013166245,1654,8,774.4857142857143,30,5,18,31.903514516481113,0.6510416666666667,43.44758064516128,1026.2096774193537,34.20698924731179,0
1658,4,1,1,35,0.027777777777777776,0.027777777777777776,0.9722222222222222,36,700,500,200,0.7142857142857143,9,5,4,440.0347255080254,0.36483134920634924,0.19951543835925212,0.26137002370536927,131862.52170138882,4404.8177083333285,136267.33940972213,1655,0,753.9444444444445,31,5,18,31.930358350236656,0.6505376344086022,43.229166666666664,1027.0833333333328,33.13172043010751,0
1659,4,0,0,35,0.0,0.0,1.0,35,900,600,300,0.6666666666666666,12,6,6,447.2862047813087,0.3612394957983193,0.20652874895837092,0.2652104519477746,131795.66277398012,4790.076361762158,136585.73913574227,1656,10,776.4857142857143,31,4,21,31.812177698875637,0.6498655913978495,43.294270833333336,1026.8229166666672,33.123319892473134,0
1660,4,0,0,35,0.0,0.0,1.0,35,950,800,150,0.8421052631578947,11,8,3,450.5457512503027,0.3619047619047619,0.20928236423229407,0.2678489398352403,131895.95752292217,4885.032653808599,136780.99017673076,1657,11,777.4857142857143,31,4,21,31.62644716271602,0.6508736559139785,43.196614583333336,1027.2135416666672,33.13592069892475,0
1661,4,1,1,35,0.027777777777777776,0.027777777777777776,0.9722222222222222,36,900,800,100,0.8888888888888888,10,8,2,442.4106549731116,0.36883267195767194,0.19946847240425214,0.2654147696346908,132240.39619677523,4500.912059063818,136741.30825583905,1658,0,756.8611111111111,33,3,21,31.485439254934676,0.6493055555555556,42.861519607843135,1028.5539215686272,31.168300653594763,0
1662,4,0,0,35,0.0,0.0,1.0,35,700,300,400,0.42857142857142855,11,3,8,450.80547476992444,0.3613095238095238,0.20971098671626898,0.26925952825399513,132073.33953486884,4907.87690669319,136981.21644156202,1659,13,779.4857142857143,32,3,21,31.43937067518323,0.6500651041666667,43.023989898989896,1027.90404040404,32.12200126262625,0
1663,4,0,0,35,0.0,0.0,1.0,35,550,400,150,0.7272727272727273,7,4,3,447.1375506115849,0.3609593837535014,0.20340303115352265,0.26775648618976083,132170.6968676665,4819.6963320069335,136990.39319967345,1660,14,780.4857142857143,32,3,21,31.43469629993452,0.6510416666666667,42.92929292929293,1028.282828282828,32.13383838383837,0
1664,4,0,0,35,0.0,0.0,1.0,35,750,600,150,0.8,9,6,3,443.71084296470923,0.3602941176470588,0.2008031001771029,0.2663899954040888,132268.0900705285,4737.757148505253,137005.84721903375,1661,15,781.4857142857143,32,3,21,31.423888138783198,0.6520182291666667,42.83459595959596,1028.661616161616,32.1456755050505,0
1665,4,0,0,35,0.0,0.0,1.0,35,1050,900,150,0.8571428571428571,12,9,3,442.90848681435625,0.3602941176470588,0.19860806759812744,0.2663661445793498,132333.03880025004,4722.285194112854,137055.3239943629,1662,16,782.4857142857143,32,3,21,31.378594510573897,0.6526692708333333,42.77146464646465,1028.914141414142,32.15356691919194,0
1666,4,0,0,35,0.0,0.0,1.0,35,550,400,150,0.7272727272727273,7,4,3,438.7877198446128,0.36004901960784313,0.19572006940427955,0.26434284585760837,132398.0034722223,4618.923611111116,137016.92708333343,1663,17,783.4857142857143,32,3,21,31.418690958164635,0.6533203125,42.708333333333336,1029.1666666666672,32.16145833333335,0
1667,4,0,0,35,0.0,0.0,1.0,35,850,500,350,0.5882352941176471,12,5,7,437.3689641656414,0.3600140056022409,0.19531753820271947,0.26371536951762664,132430.4917865525,4584.197403326202,137014.6891898787,1664,18,784.4857142857143,32,3,21,31.422248119070982,0.6536458333333333,42.67676767676768,1029.2929292929302,32.16540404040407,0
1668,4,0,0,35,0.0,0.0,1.0,35,1100,800,300,0.7272727272727273,14,8,6,439.74408746421625,0.36015406162464986,0.19335645958162462,0.26560542882838684,132495.48037190092,4652.82082185492,137148.30119375585,1665,19,785.4857142857143,32,3,21,31.29522320333578,0.654296875,42.61363636363637,1029.5454545454554,32.17329545454548,0
1669,4,0,0,35,0.0,0.0,1.0,35,950,800,150,0.8421052631578947,11,8,3,435.52861146800285,0.36074929971988795,0.1922109760795716,0.2639704615420483,132625.5053693502,4552.440439751061,137177.94580910125,1666,20,786.4857142857143,32,3,16,31.271962082209694,0.6555989583333333,42.487373737373744,1030.050505050506,32.18907828282831,0
1670,4,2,3,34,0.05405405405405406,0.08108108108108109,0.9189189189189189,37,1000,700,300,0.7,13,7,6,415.4013755435874,0.36858733733733734,0.17051222888786355,0.25500702005749387,133103.4297052153,3658.2695578231173,136761.6992630384,1667,0,744.918918918919,34,3,16,31.307443085679125,0.6556372549019608,42.02380952380952,1031.904761904761,30.350140056022383,0
1671,4,0,0,34,0.0,0.0,1.0,34,850,500,350,0.5882352941176471,12,5,7,436.47184691740085,0.360256981580511,0.1778789342647984,0.2655399437625851,132766.7766147192,4789.7920396593145,137556.5686543785,1668,22,777.0882352941177,31,3,17,31.10457464729416,0.6596102150537633,42.35026041666668,1030.598958333335,33.2451276881721,0
1672,4,0,0,34,0.0,0.0,1.0,34,1050,700,350,0.6666666666666666,14,7,7,443.36248243736804,0.35947712418300654,0.17979468590062675,0.27070065523681724,132901.00309583885,4984.663730197502,137885.66682603635,1669,23,778.0882352941177,31,3,17,30.79105632024247,0.6609543010752688,42.22005208333334,1031.1197916666677,33.26192876344089,0
1673,4,0,0,34,0.0,0.0,1.0,34,1050,700,350,0.6666666666666666,14,7,7,437.6126457275461,0.35994132501485443,0.17975175936098808,0.26839339046014554,133068.88156467033,4846.5250651041915,137915.40662977452,1670,24,779.0882352941177,31,3,17,30.76939256267878,0.6626344086021504,42.05729166666668,1031.7708333333348,33.28293010752693,0
1674,4,0,0,34,0.0,0.0,1.0,34,900,700,200,0.7777777777777778,11,7,4,435.41236451982184,0.3597742127153892,0.17697148242417948,0.26776678150105754,133169.65950859935,4796.743265787785,137966.40277438713,1671,25,780.0882352941177,31,3,17,30.724238888188047,0.6636424731182795,41.95963541666668,1032.1614583333348,33.295530913978546,0
1675,4,1,0,35,0.02857142857142857,0.0,1.0,35,700,500,200,0.7142857142857143,9,5,4,422.0152643049136,0.3650560224089636,0.16954252600511088,0.26212497402601004,133539.50500488302,4271.485222710534,137810.99022759355,1672,0,758.7714285714286,31,4,19,30.696754010246085,0.6673387096774193,41.601562500000014,1033.5937500000016,33.34173387096779,0
1676,4,0,1,34,0.0,0.02857142857142857,0.9714285714285714,35,1300,1100,200,0.8461538461538461,15,11,4,409.86445187348147,0.36474089635854345,0.1020456627200872,0.2519619280057271,133155.82498317957,3918.9825413640565,137074.80752454363,1673,1,759.7714285714286,33,2,18,31.397431330641968,0.6584595959595959,41.97303921568628,1032.1078431372553,31.27599524658349,4
1677,4,0,0,34,0.0,0.0,1.0,34,900,600,300,0.6666666666666666,12,6,6,416.7620088005176,0.3574532085561497,0.12386324392770809,0.2565848030085116,133211.4069992859,4303.49071523315,137514.89771451903,1674,28,783.0882352941177,32,2,18,31.163364318330075,0.6614583333333333,41.919191919191924,1032.323232323233,32.26010101010103,0
1678,4,0,0,34,0.0,0.0,1.0,34,750,500,250,0.6666666666666666,10,5,5,413.7095347690305,0.35654337492572785,0.12259876441100959,0.2553758705566718,133309.1828161668,4230.256000663209,137539.43881683002,1675,29,784.0882352941177,32,2,18,31.143528141174556,0.6624348958333333,41.824494949494955,1032.702020202021,32.271938131313156,0
1679,4,0,0,34,0.0,0.0,1.0,34,300,100,200,0.3333333333333333,5,1,4,413.7095347690305,0.35654337492572785,0.12259876441100959,0.2553758705566718,133309.1828161668,4230.256000663209,137539.43881683002,1676,30,785.0882352941177,32,2,18,31.143528141174556,0.6624348958333333,41.824494949494955,1032.702020202021,32.271938131313156,0
1680,4,0,0,34,0.0,0.0,1.0,34,600,400,200,0.6666666666666666,8,4,4,411.95159731105724,0.356060606060606,0.12389180094480068,0.25473741629642943,133374.3866219009,4188.758321854921,137563.14494375582,1677,31,786.0882352941177,32,2,19,31.123181762620703,0.6630859375,41.76136363636364,1032.954545454546,32.27982954545456,0
1681,4,0,0,34,0.0,0.0,1.0,34,550,300,250,0.5454545454545454,8,3,5,410.80523164590903,0.3565805109922757,0.12043979268354055,0.2544753376652897,133439.60636988585,4163.537681103989,137603.14405098982,1678,32,787.0882352941177,32,2,19,31.08706057273209,0.6637369791666665,41.69823232323233,1033.2070707070718,32.287720959595994,0
1682,4,0,1,33,0.0,0.029411764705882353,0.9705882352941176,34,750,500,250,0.6666666666666666,10,5,5,392.9369993492685,0.35652480689245397,0.0928186714542194,0.2284612825026537,131045.648383434,3498.5367707131563,134544.18515414716,1679,33,788.0882352941177,33,1,18,33.96755934570116,0.6373106060606062,44.02573529411763,1023.8970588235273,31.02718360071295,8
1683,4,0,0,33,0.0,0.0,1.0,33,1100,1000,100,0.9090909090909091,12,10,2,400.48465894989147,0.3499842171717172,0.09891662741403717,0.23221234945978655,130940.15438475648,3887.904614325049,134828.05899908152,1680,187,811.969696969697,32,1,19,33.881538366642,0.6386718750000002,44.12878787878787,1023.484848484847,31.98390151515147,0
1684,4,1,0,34,0.029411764705882353,0.0,1.0,34,850,600,250,0.7058823529411765,11,6,5,390.3108401744941,0.35793597742127153,0.09536051656104338,0.22842334194396707,131296.723691008,3449.3069071991285,134746.03059820711,1681,0,789.0588235294117,33,1,21,33.78011778070072,0.6398358585858587,43.78063725490195,1024.87745098039,31.05689245395121,0
1685,4,0,0,34,0.0,0.0,1.0,34,550,300,250,0.5454545454545454,8,3,5,388.3270540022477,0.35832590612002374,0.09564801530368294,0.227448703058459,131328.12499999977,3399.656532343301,134727.78153234307,1682,1,790.0588235294117,32,2,21,33.799119241192415,0.6425781250000002,43.749999999999986,1024.9999999999982,32.03124999999994,0
1686,4,1,1,34,0.02857142857142857,0.02857142857142857,0.9714285714285714,35,600,400,200,0.6666666666666666,8,4,4,376.74897030097617,0.36418067226890755,0.08773462562282464,0.2221227027718147,131579.47063629355,2914.4860149942115,134493.95665128776,1683,0,768.4571428571429,33,2,19,33.84147555343207,0.6426767676767678,43.5049019607843,1025.9803921568614,31.090314913844285,0
1687,4,0,0,34,0.0,0.0,1.0,34,750,500,250,0.6666666666666666,10,5,5,389.11567834256545,0.3577131610219846,0.09402857535972675,0.22887665859353074,131489.94880943268,3432.9601252423217,134922.908934675,1684,3,792.0588235294117,32,2,22,33.61494111371004,0.6442057291666667,43.592171717171716,1025.631313131313,32.05097853535353,0
1688,4,0,0,34,0.0,0.0,1.0,34,1150,900,250,0.782608695652174,14,9,5,386.97462407967424,0.3577688651218063,0.08815097945532746,0.22815151780246684,131579.47063629355,3383.5832372164323,134963.05387350998,1685,4,793.0588235294117,33,1,19,33.57919254658384,0.6426767676767678,43.5049019607843,1025.9803921568614,31.090314913844285,0
1689,4,1,1,34,0.02857142857142857,0.02857142857142857,0.9714285714285714,35,850,600,250,0.7058823529411765,11,6,5,374.44072183394906,0.36474089635854345,0.07681303397576023,0.22249824710628854,131877.80612244885,2876.084183673459,134753.8903061223,1686,0,771.3714285714286,34,1,20,33.59918289290681,0.6433823529411765,43.21428571428571,1027.1428571428562,30.210084033613416,0
1690,4,0,1,33,0.0,0.029411764705882353,0.9705882352941176,34,800,700,100,0.875,9,7,2,382.5154598455458,0.35604203802733214,0.08143419639661165,0.2272049659082578,131862.52170138882,3287.890624999997,135150.41232638882,1687,6,795.0588235294117,33,1,21,33.40728532792427,0.6455176767676768,43.229166666666664,1027.0833333333328,31.123737373737356,0
1691,4,0,0,33,0.0,0.0,1.0,33,900,800,100,0.8888888888888888,10,8,2,390.90302619721746,0.3467881944444444,0.07656796664542886,0.23189017593449823,131813.89534550055,3705.290117079899,135519.18546258044,1688,195,819.969696969697,32,1,21,33.24111643919834,0.6474609375,43.276515151515156,1026.89393939394,32.09043560606062,0
1692,4,0,0,33,0.0,0.0,1.0,33,550,400,150,0.7272727272727273,7,4,3,386.66504476543446,0.3467881944444444,0.08090037303520448,0.22288969377617474,130714.10323245086,3508.5149155698523,134222.6181480207,1689,196,820.969696969697,32,1,18,34.464645841050334,0.6363932291666666,44.34974747474748,1022.6010101010108,31.95628156565659,2
1693,4,1,0,34,0.029411764705882353,0.0,1.0,34,1000,800,200,0.8,12,8,4,376.9259359846899,0.358288770053476,0.08219669777458716,0.21968946812831508,131139.77346453292,3085.9963715878575,134225.76983612077,1690,0,797.7941176470588,33,1,20,34.28202520539203,0.6382575757575757,43.93382352941177,1024.2647058823534,31.038324420677377,0
1694,4,0,0,34,0.0,0.0,1.0,34,950,900,50,0.9473684210526315,10,9,1,374.1129027749578,0.35756461675579326,0.08675116584957587,0.21894375128810165,131296.72369100823,3023.9596849769323,134320.68337598516,1691,1,798.7941176470588,33,1,22,34.195140300530134,0.6398358585858586,43.78063725490196,1024.877450980392,31.056892453951274,0
1695,4,0,0,34,0.0,0.0,1.0,34,1100,800,300,0.7272727272727273,14,8,6,376.0464946428192,0.35788027332144984,0.08384128122385559,0.22079866811764687,131422.35145436844,3084.1829164263704,134506.5343707948,1692,2,799.7941176470588,33,1,22,34.01844050037846,0.6410984848484849,43.658088235294116,1025.3676470588232,31.0717468805704,0
1696,4,0,0,34,0.0,0.0,1.0,34,650,500,150,0.7692307692307693,8,5,3,381.99616471954533,0.3579916815210933,0.10619522151518801,0.21747409815099752,130231.31315179268,3149.572430074982,133380.88558186765,1693,3,800.7941176470588,33,1,20,35.074613799175566,0.6291035353535352,44.82230392156863,1020.7107843137262,30.930629827688673,6
1697,4,0,0,34,0.0,0.0,1.0,34,650,400,250,0.6153846153846154,9,4,5,381.8482351160446,0.356729055258467,0.10256475534445264,0.21792566530581894,130327.04132550258,3153.033898173353,133480.07522367593,1694,4,801.7941176470588,32,2,20,34.98103952846131,0.6324869791666666,44.72853535353536,1021.0858585858592,31.9089330808081,0
1698,4,0,0,34,0.0,0.0,1.0,34,650,400,250,0.6153846153846154,9,4,5,386.3959034393121,0.3564505347593583,0.10337193831926528,0.22125472432607746,130455.99819214875,3281.532656106518,133737.53084825526,1695,5,802.7941176470588,32,2,20,34.73380917068347,0.6337890625,44.60227272727273,1021.590909090909,31.924715909090907,0
1699,4,2,1,35,0.05555555555555555,0.027777777777777776,0.9722222222222222,36,850,600,250,0.7058823529411765,11,6,5,370.27205462726636,0.36818783068783073,0.09291120927949592,0.21549933788252662,131084.1907596371,2507.362528344663,133591.55328798178,1696,0,759.1388888888889,34,2,18,34.5086898395722,0.6354166666666667,43.988095238095234,1024.0476190476184,30.1190476190476,0
1700,4,0,0,35,0.0,0.0,1.0,35,1150,900,250,0.782608695652174,14,9,5,378.0566014885279,0.36127450980392156,0.09593596059113318,0.21927282886334606,130951.55709342546,2901.4201268742645,133852.97722029974,1697,1,781.8285714285714,33,2,18,34.44384578544062,0.6363636363636365,44.11764705882352,1023.5294117647048,31.01604278074863,0
1701,4,0,0,35,0.0,0.0,1.0,35,450,300,150,0.6666666666666666,6,3,3,375.84964036531886,0.36144957983193277,0.09554822048536926,0.2181703993030929,130982.91710219614,2845.9764573721486,133828.8935595683,1698,2,782.8285714285714,33,2,18,34.46852927092063,0.636679292929293,44.08700980392156,1023.6519607843126,31.01975638740341,0
1702,4,0,0,35,0.0,0.0,1.0,35,1150,900,250,0.782608695652174,14,9,5,377.94037127402146,0.36151960784313725,0.0963234036731766,0.21956285546753648,131014.28086553245,2903.11719050365,133917.3980560361,1699,3,783.8285714285714,33,2,18,34.383229590615265,0.6369949494949496,44.056372549019606,1023.7745098039213,31.02346999405822,0
1703,4,1,1,35,0.027777777777777776,0.027777777777777776,0.9722222222222222,36,550,200,350,0.36363636363636365,9,2,7,370.32152592556776,0.36514550264550266,0.0831848926063612,0.21655758798690802,131267.1201814058,2522.2080498866076,133789.3282312924,1700,0,763.0277777777778,34,2,19,34.322239002478305,0.6372549019607843,43.8095238095238,1024.761904761904,30.140056022408938,0
1704,4,0,0,35,0.0,0.0,1.0,35,950,700,250,0.7368421052631579,12,7,5,377.6976392987213,0.3611344537815126,0.08680692781587807,0.21999544961996617,131114.67013888893,2904.3402777777833,134019.01041666672,1701,5,785.8285714285714,34,1,19,34.28770002712232,0.6357230392156863,43.958333333333336,1024.166666666667,30.122549019607852,0
1705,4,0,0,35,0.0,0.0,1.0,35,700,600,100,0.8571428571428571,8,6,2,376.9581149021842,0.3619047619047619,0.08988129824852664,0.21991353076157916,131175.6395266439,2889.54435941042,134065.18388605432,1702,6,786.8285714285714,34,1,20,34.244867325198506,0.6363357843137255,43.89880952380952,1024.4047619047612,30.12955182072827,0
1706,4,0,1,34,0.0,0.02857142857142857,0.9714285714285714,35,550,200,350,0.36363636363636365,9,2,7,374.6199070459228,0.36116946778711484,0.08961099309612353,0.21907120651163733,131267.1201814059,2835.0552721088443,134102.17545351473,1703,7,787.8285714285714,34,1,20,34.21211857187114,0.6372549019607843,43.80952380952381,1024.7619047619046,30.14005602240896,0
1707,4,1,1,34,0.02857142857142857,0.02857142857142857,0.9714285714285714,35,1100,700,400,0.6363636363636364,15,7,8,376.7522505929947,0.36074929971988795,0.08486380326189069,0.22085021557185705,131359.5300635573,2898.0138899922695,134257.54395354955,1704,0,788.4285714285714,33,2,20,34.063932058178914,0.6404671717171717,43.71936274509804,1025.1225490196077,31.06431966726084,0
1708,4,0,0,34,0.0,0.0,1.0,34,550,400,150,0.7272727272727273,7,4,3,386.31370688209995,0.3521984551396316,0.09963274868612682,0.2257141092411767,131233.9323367215,3339.4933739427174,134573.42571066422,1705,9,812.6176470588235,33,1,20,33.946173703305035,0.6392045454545454,43.841911764705884,1024.6323529411768,31.049465240641723,0
1709,4,0,0,34,0.0,0.0,1.0,34,800,500,300,0.625,11,5,6,387.0050895630908,0.3522541592394533,0.09899569583931123,0.22667440960123889,131328.125,3364.96434664552,134693.08934664552,1706,10,813.6176470588235,32,2,21,33.83299457994579,0.642578125,43.75,1025.0,32.03125,0
1710,4,0,0,34,0.0,0.0,1.0,34,750,400,350,0.5333333333333333,11,4,7,386.1449189534494,0.35264408793820556,0.09952495093814995,0.2271292669557474,131489.9488094328,3354.8351252423354,134844.78393467513,1707,11,814.6176470588235,32,2,21,33.691113710041456,0.6442057291666666,43.59217171717172,1025.6313131313138,32.05097853535356,0
1711,4,0,0,34,0.0,0.0,1.0,34,450,200,250,0.4444444444444444,7,2,5,384.15459433688903,0.35214275103980985,0.09772296015180282,0.22611631185652328,131516.61169982693,3304.5421232218305,134821.15382304875,1708,12,815.6176470588235,33,1,21,33.71515332536838,0.6420454545454546,43.56617647058823,1025.7352941176466,31.082887700534744,0
1712,4,1,1,34,0.02857142857142857,0.02857142857142857,0.9714285714285714,35,950,600,350,0.631578947368421,13,6,7,374.63292192348047,0.3573529411764706,0.08451525288993422,0.2222547169540536,131816.67375283435,2876.5731292516894,134693.24688208604,1709,0,793.2857142857143,34,1,16,33.6560012365716,0.6427696078431373,43.27380952380952,1026.904761904761,30.20308123249297,0
1713,4,0,0,34,0.0,0.0,1.0,34,950,800,150,0.8421052631578947,11,8,3,374.8471864770813,0.35184566250742716,0.11954880668950763,0.21698297137216202,130875.54841342726,3012.945273571637,133888.4936869989,1710,14,817.6176470588235,32,2,19,34.60302525501812,0.6380208333333333,44.1919191919192,1023.2323232323237,31.976010101010115,4
1714,4,1,0,35,0.02857142857142857,0.0,1.0,35,1000,800,200,0.8,12,8,4,366.2587142256655,0.357703081232493,0.12664774519079192,0.21401145643858158,131236.62308673482,2613.3113662131686,133849.934452948,1711,0,795.2285714285714,34,1,21,34.45717632934433,0.6369485294117647,43.83928571428572,1024.6428571428582,30.136554621848774,0
1715,4,0,0,35,0.0,0.0,1.0,35,400,0,400,0.0,8,0,8,365.77796029922786,0.357703081232493,0.12460050113668442,0.2140708674518052,131297.6208191611,2605.1551870748453,133902.77600623594,1712,1,796.2285714285714,34,1,23,34.407790296976046,0.6375612745098038,43.77976190476191,1024.8809523809532,30.143557422969213,0
1716,4,1,0,36,0.027777777777777776,0.0,1.0,36,650,500,150,0.7692307692307693,8,5,3,357.5023820931197,0.3604662698412699,0.12361433359113194,0.21107332422210223,131633.36167800458,2211.851615646266,133845.21329365086,1713,0,775.0833333333334,34,2,17,34.28074245939676,0.6409313725490196,43.452380952380956,1026.1904761904766,30.182072829131666,0
1717,4,0,0,36,0.0,0.0,1.0,36,750,500,250,0.6666666666666666,10,5,5,354.7976318826634,0.36033399470899474,0.12115002963993993,0.20981242675530337,131694.45153061225,2144.975907029485,133839.42743764175,1714,1,776.0833333333334,34,2,17,34.2884964818681,0.6415441176470588,43.392857142857146,1026.4285714285716,30.189075630252105,0
1718,4,0,0,36,0.0,0.0,1.0,36,650,600,50,0.9230769230769231,7,6,1,356.7266122742886,0.3603174603174603,0.12183501488267834,0.2111224143885514,131725.00177154213,2197.962726757389,133922.96449829952,1715,2,777.0833333333334,34,2,17,34.20817387606787,0.6418504901960783,43.36309523809525,1026.5476190476204,30.192577030812366,0
1719,4,2,1,37,0.05263157894736842,0.02631578947368421,0.9736842105263158,38,950,600,350,0.631578947368421,13,6,7,343.63932898945876,0.3692508297771456,0.1256113085603352,0.20670392027496318,132340.0612394492,1495.4499685496605,133835.51120799885,1716,0,737.1315789473684,36,2,18,33.92502097698005,0.6438078703703702,42.764639639639654,1028.9414414414437,28.58170670670677,0
1720,4,1,1,37,0.02631578947368421,0.02631578947368421,0.9736842105263158,38,1050,900,150,0.8571428571428571,12,9,3,343.39195856349033,0.3694730915125652,0.12412103132324748,0.20687271650044448,132398.0034722224,1492.8819444444634,133890.88541666686,1717,0,738.1052631578947,36,2,18,33.87314439946019,0.644386574074074,42.70833333333334,1029.166666666668,28.587962962963005,0
1721,4,0,0,37,0.0,0.0,1.0,37,1200,700,500,0.5833333333333334,17,7,10,351.83842935470045,0.36292542542542544,0.12886126796600705,0.21163579519512177,132340.06123944905,1912.4638574385342,134252.52509688758,1718,2,759.0540540540541,36,1,18,33.71411112327169,0.6438078703703702,42.76463963963965,1028.9414414414425,28.581706706706736,0
1722,4,0,0,37,0.0,0.0,1.0,37,1300,900,400,0.6923076923076923,17,9,8,354.0779845634672,0.36173673673673673,0.13613497890954585,0.21418003961356546,132551.19756235802,1986.717540071759,134537.91510242978,1719,3,760.0540540540541,34,3,20,33.444123314065514,0.6501225490196079,42.559523809523796,1029.7619047619028,30.287114845938316,0
1723,4,0,0,37,0.0,0.0,1.0,37,1050,800,250,0.7619047619047619,13,8,5,357.9867231243577,0.3620808308308308,0.1343543682346553,0.2172522511864087,132673.81660997713,2099.092970521526,134772.90958049867,1720,4,761.0540540540541,34,3,17,33.22018719667206,0.6513480392156863,42.44047619047618,1030.2380952380938,30.30112044817923,0
1724,4,0,0,37,0.0,0.0,1.0,37,1050,700,350,0.6666666666666666,14,7,7,353.29357928648517,0.362205955955956,0.12925019278259442,0.21493060547316217,132765.8180980724,1981.0622165532702,134746.88031462568,1721,5,762.0540540540541,34,3,17,33.248623464633624,0.6522671568627452,42.35119047619047,1030.595238095237,30.31162464985991,0
1725,4,1,0,38,0.02631578947368421,0.0,1.0,38,1150,1000,150,0.8695652173913043,13,10,3,343.98731237502665,0.36722083926031296,0.12394211588626192,0.2115640587421023,133173.39275763015,1561.9914909121949,134735.38424854234,1722,0,742.9736842105264,35,3,19,33.07963295208194,0.6541666666666668,41.95601851851851,1032.1759259259247,29.490740740740705,0
1726,4,0,0,38,0.0,0.0,1.0,38,1000,800,200,0.8,12,8,4,344.19767819558706,0.36726529160739685,0.12175367783737845,0.21186329136138274,133203.26063368033,1569.6506076388641,134772.9112413192,1723,1,743.9736842105264,35,3,19,33.044273461150354,0.6544642857142857,41.92708333333332,1032.291666666665,29.49404761904757,0
1727,4,0,0,38,0.0,0.0,1.0,38,1100,700,400,0.6363636363636364,15,7,8,343.203320241445,0.36576872925557136,0.11375017926287123,0.2126192075094707,133443.13221583082,1559.6252079782628,135002.7574238091,1724,2,744.9736842105264,36,2,22,32.82970027247959,0.6548032407407407,41.69481981981983,1033.2207207207216,28.7005755755756,0
1728,4,0,0,38,0.0,0.0,1.0,38,1400,1000,400,0.7142857142857143,18,10,8,340.91629694578853,0.366005808440019,0.11057601968759223,0.2118952187816953,133564.50007086174,1506.869294315006,135071.36936517674,1725,3,745.9736842105264,34,4,23,32.76733271910628,0.6602328431372548,41.577380952380956,1033.6904761904768,30.40266106442579,0
1729,4,0,0,38,0.0,0.0,1.0,38,1200,800,400,0.6666666666666666,16,8,8,346.14413138010275,0.36619843527738266,0.10931337206836589,0.21586174223251664,133687.5868055558,1655.034722222256,135342.62152777804,1726,4,746.9736842105264,34,4,23,32.50906526994359,0.6614583333333331,41.45833333333335,1034.1666666666686,30.41666666666672,0
1730,4,0,0,38,0.0,0.0,1.0,38,950,700,250,0.7368421052631579,12,7,5,345.14111949506093,0.3653390232337601,0.12090425751143719,0.2159003825868685,133801.32144043644,1636.0675743741501,135437.3890148106,1727,5,747.9736842105264,35,3,15,32.42124864824552,0.6604166666666667,41.34837962962963,1034.606481481482,29.5601851851852,0
1731,4,0,0,38,0.0,0.0,1.0,38,650,500,150,0.7692307692307693,8,5,3,333.24902226701874,0.3653390232337601,0.06188215747938042,0.19732435430630532,131743.6731074244,1180.6900505829708,132924.36315800739,1728,6,748.9736842105264,35,3,18,34.79190154077414,0.6398809523809523,43.3449074074074,1026.620370370369,29.332010582010543,5
1732,4,0,0,38,0.0,0.0,1.0,38,1050,700,350,0.6666666666666666,14,7,7,331.87916683197795,0.36584281650071127,0.06052779836916233,0.19728249200494313,131892.24222232925,1154.4574920696002,133046.69971439886,1729,7,749.9736842105264,35,3,18,34.67758215962442,0.6413690476190477,43.200231481481474,1027.199074074073,29.348544973544943,0
1733,4,0,1,37,0.0,0.02631578947368421,0.9736842105263158,38,850,600,250,0.7058823529411765,11,6,5,330.6062819576333,0.3654427453769559,0.05597439544807936,0.1972972972972973,132040.89506172843,1130.7098765432136,133171.60493827163,1730,8,750.9736842105264,35,3,18,34.560810810810814,0.6428571428571428,43.05555555555556,1027.777777777778,29.365079365079374,0
1734,4,0,0,37,0.0,0.0,1.0,37,850,700,150,0.8235294117647058,10,7,3,333.537073426223,0.36605355355355357,0.06460943222583237,0.19915346417441293,132061.28826530624,1409.4671201814185,133470.75538548766,1731,9,763.9459459459459,34,3,18,34.46500270249402,0.645220588235294,43.03571428571429,1027.8571428571438,30.23109243697482,0
1735,4,0,1,36,0.0,0.02702702702702703,0.972972972972973,37,550,300,250,0.5454545454545454,8,3,5,332.55262877307763,0.36608483483483484,0.06362430053953916,0.19888673837148882,132122.47732426313,1387.5354308390135,133510.01275510216,1732,10,764.9459459459459,34,3,18,34.42879612474913,0.6458333333333333,42.97619047619048,1028.0952380952388,30.23809523809526,0
1736,4,0,0,36,0.0,0.0,1.0,36,950,600,350,0.631578947368421,13,6,7,344.25499197368276,0.36112764550264553,0.07755788692841636,0.20567029007658483,132082.88278546714,1894.0383506343733,133976.9211361015,1733,17,786.9166666666666,33,3,18,34.16785884597046,0.6477272727272727,43.01470588235294,1027.9411764705883,31.149732620320858,0
1737,4,0,0,36,0.0,0.0,1.0,36,800,600,200,0.75,10,6,4,345.5883539767335,0.36107804232804236,0.07774666719620882,0.2073283098589511,132240.39619677534,1940.1481701749428,134180.5443669503,1734,18,787.9166666666666,33,3,18,33.97511318956274,0.6493055555555556,42.86151960784314,1028.553921568628,31.16830065359479,0
1738,4,0,0,36,0.0,0.0,1.0,36,600,300,300,0.5,9,3,6,346.9891173023931,0.36030092592592594,0.08636387697845538,0.20869058946066554,132334.9492983467,1983.7574490580466,134318.70674740477,1735,19,788.9166666666666,33,3,18,33.84399317135144,0.6502525252525253,42.76960784313725,1028.9215686274504,31.179441473559102,0
1739,4,0,1,35,0.0,0.027777777777777776,0.9722222222222222,36,1250,1100,150,0.88,14,11,3,347.32580438951635,0.35982142857142857,0.07950967161493483,0.20924261874197675,132398.00347222204,1997.0486111110872,134395.05208333314,1736,20,789.9166666666666,33,3,19,33.771929824561404,0.6508838383838385,42.70833333333332,1029.1666666666652,31.186868686868642,0
1740,4,0,0,35,0.0,0.0,1.0,35,650,400,250,0.6153846153846154,9,4,5,356.050221130008,0.35910364145658263,0.07801388596675785,0.2139452213692702,132300.5624426078,2421.1289026629825,134721.69134527078,1737,21,783.4857142857143,32,3,19,33.645526509572896,0.65234375,42.8030303030303,1028.787878787878,32.14962121212119,0
1741,4,0,0,35,0.0,0.0,1.0,35,950,700,250,0.7368421052631579,12,7,5,354.9426775565511,0.3588235294117647,0.07165644171779184,0.21364718036084857,132365.51914345476,2396.434356188144,134761.9534996429,1738,22,784.4857142857143,32,3,19,33.6086400817996,0.6529947916666667,42.73989898989899,1029.040404040404,32.15751262626262,0
1742,4,0,0,35,0.0,0.0,1.0,35,900,700,200,0.7777777777777778,11,7,4,354.53785507056347,0.3584033613445378,0.07333718912666298,0.21358743951811987,132398.00347222216,2388.020833333325,134786.02430555547,1739,23,785.4857142857143,32,3,20,33.586369770580305,0.6533203125,42.70833333333333,1029.166666666666,32.161458333333314,0
1743,4,0,0,35,0.0,0.0,1.0,35,950,700,250,0.7368421052631579,12,7,5,354.1229880552137,0.3587535014005602,0.07455488574232438,0.2135214939812206,132430.4917865524,2379.3362922150773,134809.82807876746,1740,24,786.4857142857143,32,3,21,33.56436048413476,0.6536458333333334,42.676767676767675,1029.2929292929293,32.16540404040404,0
1744,4,0,0,35,0.0,0.0,1.0,35,650,300,350,0.46153846153846156,10,3,7,354.0257436095572,0.3582983193277311,0.07345937516426915,0.21364706792366522,132462.98408644515,2379.0612883889276,134842.0453748341,1741,25,787.4857142857143,32,3,21,33.534179647573495,0.6539713541666667,42.645202020202014,1029.419191919191,32.16934974747472,0
1745,4,0,0,35,0.0,0.0,1.0,35,600,500,100,0.8333333333333334,7,5,2,353.20759841692643,0.35714285714285715,0.07855829349025356,0.21389119378521684,132592.99314164382,2366.570534894407,134959.56367653824,1742,26,788.4857142857143,32,3,21,33.42451268848841,0.6552734375,42.5189393939394,1029.9242424242432,32.1851325757576,0
1746,4,0,0,35,0.0,0.0,1.0,35,950,600,350,0.631578947368421,13,6,7,360.48106480392215,0.3572478991596639,0.1019185032503569,0.20954415444408644,131037.09323347117,2447.2781795225087,133484.37141299367,1743,27,789.4857142857143,32,3,20,34.807004562831416,0.6396484375,44.034090909090914,1023.863636363637,31.995738636363658,4
1747,4,0,0,35,0.0,0.0,1.0,35,1200,800,400,0.6666666666666666,16,8,8,360.4987882271688,0.35696778711484595,0.10528911354950066,0.2099070833675928,131101.73906042756,2452.4036131517255,133554.14267357928,1744,28,790.4857142857143,32,3,20,34.74114371429746,0.6402994791666666,43.9709595959596,1024.116161616162,32.00363005050506,0
1748,4,1,0,36,0.027777777777777776,0.0,1.0,36,850,700,150,0.8235294117647058,10,7,3,351.81288352753245,0.3646825396825397,0.11614894464356817,0.20707973524088935,131516.61169982696,2053.8476787773875,133570.45937860434,1745,0,769.5,33,3,21,34.544504181600935,0.6420454545454546,43.56617647058823,1025.7352941176468,31.08288770053475,0
1749,4,0,0,36,0.0,0.0,1.0,36,1200,900,300,0.75,15,9,6,349.4273112051683,0.3634259259259259,0.11402653399668372,0.20652461053939908,131673.78720023547,2002.0834835159583,133675.87068375142,1746,1,770.5,33,3,18,34.4471393034826,0.6436237373737373,43.41299019607843,1026.3480392156862,31.101455733808674,0
1750,4,0,0,36,0.0,0.0,1.0,36,350,200,150,0.5714285714285714,5,2,3,351.5017621380097,0.36326058201058203,0.11435080179857571,0.20809401140848816,131736.68368235772,2061.135290513265,133797.81897287097,1747,2,771.5,33,3,18,34.33048326767738,0.6442550505050505,43.35171568627451,1026.5931372549019,31.10888294711824,0
1751,4,1,1,36,0.02702702702702703,0.02702702702702703,0.972972972972973,37,1200,900,300,0.75,15,9,6,346.3546701312679,0.36821196196196193,0.11507616024641765,0.2068067926634416,132061.2882653061,1748.008786848071,133809.29705215417,1748,0,751.6216216216217,34,3,18,34.13563624430547,0.6452205882352942,43.035714285714285,1027.8571428571427,30.231092436974784,0
1752,4,0,0,36,0.0,0.0,1.0,36,850,700,150,0.8235294117647058,10,7,3,357.14494588513946,0.362417328042328,0.12456095007091084,0.21248730172853958,131925.4632382977,2223.3024858227536,134148.76572412046,1749,4,773.5,33,3,18,33.99526323114238,0.6461489898989898,43.16789215686274,1027.3284313725485,31.131164587046925,0
1753,4,0,0,36,0.0,0.0,1.0,36,750,500,250,0.6666666666666666,10,5,5,358.7234637199276,0.36297949735449736,0.12353077585635752,0.21378082752605493,131988.41979346887,2269.468623846603,134257.88841731547,1750,5,774.5,33,3,18,33.89124925462136,0.646780303030303,43.106617647058826,1027.5735294117649,31.13859180035651,0
1754,4,0,0,36,0.0,0.0,1.0,36,950,800,150,0.8421052631578947,11,8,3,359.6032678677729,0.3634755291005291,0.12002371394883626,0.21466139555921776,132051.39136690204,2297.2223724048326,134348.61373930686,1751,6,775.5,33,3,18,33.80516970708635,0.6474116161616161,43.045343137254896,1027.8186274509796,31.14601901366605,0
1755,4,0,0,36,0.0,0.0,1.0,36,1000,700,300,0.7,13,7,6,358.21917516312203,0.3636904761904762,0.1200569460998544,0.21436939226951446,132145.87688629364,2267.437403883107,134413.31429017676,1752,7,776.5,33,3,18,33.745530393325396,0.6483585858585859,42.95343137254901,1028.186274509803,31.157159833630395,0
1756,4,0,0,36,0.0,0.0,1.0,36,950,700,250,0.7368421052631579,12,7,5,359.4522312741771,0.36461640211640217,0.12552273569424632,0.21618631330787888,132334.9492983467,2313.618560169158,134648.56785851586,1753,8,777.5,33,3,18,33.523404001905675,0.6502525252525253,42.76960784313725,1028.9215686274504,31.179441473559102,0
1757,4,0,0,36,0.0,0.0,1.0,36,1100,1000,100,0.9090909090909091,12,10,2,361.4220852661085,0.36443452380952385,0.12944219523166933,0.2177347684408018,132398.00347222213,2370.3124999999905,134768.31597222213,1754,9,778.5,33,3,18,33.409244264507436,0.6508838383838385,42.70833333333333,1029.1666666666658,31.18686868686866,0
1758,4,0,0,36,0.0,0.0,1.0,36,950,800,150,0.8421052631578947,11,8,3,363.6437134632952,0.3643518518518518,0.131720430107527,0.21962407166104533,132492.6128922769,2436.02115172048,134928.6340439974,1755,10,779.5,33,3,19,33.25682954410188,0.6518308080808082,42.616421568627445,1029.5343137254895,31.198009506833014,0
1759,4,0,0,36,0.0,0.0,1.0,36,550,300,250,0.5454545454545454,8,3,5,362.4993515247719,0.36463293650793654,0.12860278174414264,0.21948447768113705,132587.2561034218,2412.558871587849,134999.81497500965,1756,11,780.5,33,3,19,33.191039980961435,0.6527777777777778,42.52450980392157,1029.9019607843138,31.20915032679739,0
1760,4,1,0,37,0.02702702702702703,0.0,1.0,37,650,400,250,0.6153846153846154,9,4,5,388.19269139547504,0.36977602602602605,0.11405841587703547,0.21646500447660372,129419.51600646383,2774.846363177621,132194.36236964146,1757,0,760.3783783783783,33,4,20,35.74398309847845,0.6208964646464646,45.618872549019606,1017.5245098039214,30.834076054664287,7
1761,4,0,0,37,0.0,0.0,1.0,37,650,400,250,0.6153846153846154,9,4,5,387.350171672846,0.3695257757757758,0.11310831355270623,0.21662729352351254,129534.44054705223,2635.037556689353,132169.4781037416,1758,1,761.3783783783783,34,3,19,35.648121077456835,0.6197916666666666,45.50595238095239,1017.976190476191,29.940476190476208,0
1762,4,0,0,37,0.0,0.0,1.0,37,1400,1200,200,0.8571428571428571,16,12,4,397.62698670460264,0.3709021521521521,0.07316942423697737,0.2258489664045827,130141.08737244921,2951.562500000027,133092.64987244923,1759,2,762.3783783783783,34,3,18,34.76767588379419,0.6259191176470587,44.9107142857143,1020.3571428571447,30.010504201680728,8
1763,4,1,2,36,0.02631578947368421,0.05263157894736842,0.9473684210526316,38,750,500,250,0.6666666666666666,10,5,5,391.9381193924932,0.3760964912280702,0.0746529751304108,0.22403376454163515,130387.7189662631,2620.8968513876334,133008.61581765075,1760,0,743.2894736842105,33,5,18,34.66172706183505,0.6306818181818181,44.66911764705883,1021.3235294117658,30.9491978609626,0
1764,4,0,0,36,0.0,0.0,1.0,36,1000,800,200,0.8,12,8,4,402.3259101576374,0.36575727513227513,0.09895478982404171,0.22904801816151515,130231.3131517928,3279.086318963885,133510.39947075667,1761,16,785.5,33,3,19,34.55584403890023,0.6291035353535352,44.82230392156864,1020.7107843137272,30.930629827688705,0
1765,4,1,0,37,0.02702702702702703,0.0,1.0,37,950,600,350,0.631578947368421,13,6,7,389.2589201323248,0.3721221221221221,0.09554935370152773,0.22382387907608706,130617.2839506175,2768.796089378043,133386.08003999555,1762,0,765.2432432432432,32,5,18,34.496716485507235,0.6354166666666665,44.44444444444446,1022.2222222222239,31.944444444444496,0
1766,4,0,0,37,0.0,0.0,1.0,37,1000,700,300,0.7,13,7,6,389.53237594844154,0.3724974974974975,0.09307492902110859,0.22491815948384364,130778.66934815331,2788.5051589123645,133567.17450706568,1763,1,766.2432432432432,32,5,19,34.325751964778014,0.6370442708333333,44.286616161616166,1022.8535353535359,31.964172979797997,0
1767,4,0,1,36,0.0,0.02702702702702703,0.972972972972973,37,900,700,200,0.7777777777777778,11,7,4,391.0285397608712,0.3716529029029029,0.09221809740136311,0.22616018969895374,130843.25140610666,2832.689106978899,133675.94051308557,1764,2,767.2432432432432,32,5,19,34.22189312600271,0.6376953125,44.22348484848486,1023.1060606060618,31.97206439393943,0
1768,4,1,2,35,0.02702702702702703,0.05405405405405406,0.9459459459459459,37,500,300,200,0.6,7,3,4,390.93689313653937,0.3704642142142142,0.0992079894398592,0.22705704366411608,131004.77629833683,2842.9200464238234,133847.69634476065,1765,0,767.7027027027027,32,5,19,34.060238858740334,0.6393229166666667,44.06565656565656,1023.7373737373731,31.99179292929291,0
1769,4,0,0,35,0.0,0.0,1.0,35,1200,1000,200,0.8333333333333334,14,10,4,402.0874204429941,0.3658963585434174,0.08476917484551105,0.2330683720266914,130928.03955078135,3528.9035373264037,134456.94308810774,1766,4,770.0857142857143,31,4,20,33.852841391009335,0.6411290322580644,44.14062500000001,1023.4375000000008,33.01411290322583,0
1770,4,0,0,35,0.0,0.0,1.0,35,1200,900,300,0.75,15,9,6,413.9399790102217,0.365546218487395,0.10455723661231331,0.22261090497497787,127979.78931003131,3603.3960978189907,131583.1854078503,1767,5,771.0857142857143,31,4,20,36.56664200231631,0.61122311827957,47.03776041666666,1011.848958333332,32.64028897849458,6
1771,4,3,3,35,0.07894736842105263,0.07894736842105263,0.9210526315789473,38,500,400,100,0.8,6,4,2,386.5018050695289,0.38117887624466573,0.08889725870369758,0.2114051738416381,128656.40503838884,2345.3984838446067,131001.80352223344,1768,0,711.1315789473684,32,6,19,36.567102260941695,0.6155598958333335,46.36994949494949,1014.5202020202012,31.703756313131287,0
1772,4,1,1,35,0.027777777777777776,0.027777777777777776,0.9722222222222222,36,1100,900,200,0.8181818181818182,13,9,4,405.72008127241907,0.37161044973544977,0.11754002911208161,0.22090465404105258,128474.33302137571,3224.923366970467,131699.25638834617,1769,0,751.6111111111111,31,5,19,36.26648257556297,0.6162634408602152,46.54947916666666,1013.8020833333321,32.70329301075265,0
1773,4,0,0,35,0.0,0.0,1.0,35,1300,1000,300,0.7692307692307693,16,10,6,412.1760021166671,0.3637254901960784,0.1206147082788549,0.22371453419420836,128348.74561004162,3580.454568447217,131929.20017848883,1770,8,774.0857142857143,30,5,21,36.23187204315337,0.6177083333333333,46.67338709677419,1013.3064516129032,33.776881720430104,0
1774,4,1,0,36,0.027777777777777776,0.0,1.0,36,400,100,300,0.25,7,1,6,403.3832414860289,0.37073412698412694,0.12268993839835729,0.2207276838243776,128672.41753472229,3180.859375000011,131853.2769097223,1771,0,753.5555555555555,31,5,20,36.12251882272416,0.618279569892473,46.35416666666667,1014.5833333333339,32.72849462365593,0
1775,4,0,0,36,0.0,0.0,1.0,36,1000,700,300,0.7,13,7,6,403.3832414860289,0.3706845238095238,0.12268993839835729,0.2207276838243776,128672.41753472229,3180.859375000011,131853.2769097223,1772,1,754.5555555555555,31,5,20,36.12251882272416,0.618279569892473,46.35416666666667,1014.5833333333339,32.72849462365593,0
1776,4,0,0,36,0.0,0.0,1.0,36,850,700,150,0.8235294117647058,10,7,3,407.4526384845366,0.37098214285714287,0.12725899321589407,0.22369723729756683,128804.55864800354,3296.3514539930616,132100.9101019966,1773,2,755.5555555555555,31,5,20,35.88378655720883,0.6196236559139785,46.223958333333336,1015.1041666666672,32.74529569892475,0
1777,4,2,0,38,0.05263157894736842,0.0,1.0,38,800,800,0,1.0,8,8,0,389.97752257519954,0.38301623992413464,0.13723680842751818,0.21735266486466553,129400.03289116762,2493.841552734381,131893.874443902,1774,0,716.7368421052631,31,7,22,35.718475386059204,0.6256720430107526,45.638020833333336,1017.4479166666673,32.82090053763443,0
1778,4,0,0,38,0.0,0.0,1.0,38,800,500,300,0.625,11,5,6,387.98995145015715,0.3825865339023234,0.13704521260963554,0.21638830579493532,129426.12879106724,2443.207485205591,131869.33627627284,1775,1,717.7368421052631,32,6,17,35.74238946105803,0.6233723958333334,45.61237373737374,1017.5505050505051,31.798453282828284,0
1779,4,2,3,37,0.05,0.075,0.925,40,500,300,200,0.6,7,3,4,373.06180265821797,0.39389690170940167,0.1320243104254324,0.20944335850024345,129685.96938775496,1676.1763038548538,131362.14569160983,1776,0,682.8,34,6,18,35.85739052516752,0.6213235294117647,45.35714285714285,1018.5714285714273,29.957983193277272,2
1780,4,1,1,37,0.02631578947368421,0.02631578947368421,0.9736842105263158,38,750,500,250,0.6666666666666666,10,5,5,392.544440271167,0.3802009246088194,0.13874885725479924,0.21910721527601176,129458.25043362938,2563.623290990734,132021.87372462012,1777,0,719.6578947368421,32,6,18,35.5937241521919,0.6236979166666665,45.58080808080809,1017.6767676767689,31.80239898989903,0
1781,4,0,0,37,0.0,0.0,1.0,37,500,400,100,0.8,6,4,2,399.2372979105911,0.3763763763763764,0.144748357726727,0.2223265152227693,129366.91496107333,2929.6195136176457,132296.53447469097,1778,4,740.1081081081081,31,6,22,35.51679359187679,0.6253360215053763,45.67057291666668,1017.317708333335,32.81670026881726,0
1782,4,0,0,37,0.0,0.0,1.0,37,1100,700,400,0.6363636363636364,15,7,8,394.5715635669526,0.3763763763763764,0.14750062242385642,0.2202836672028075,129466.28146701408,2816.742621527802,132283.0240885419,1779,5,741.1081081081081,31,6,18,35.53394745820539,0.6263440860215053,45.57291666666668,1017.708333333335,32.82930107526887,0
1783,4,0,0,37,0.0,0.0,1.0,37,600,400,200,0.6666666666666666,8,4,4,393.42142988077217,0.3766891891891892,0.14903929255425785,0.22001207001486986,129532.54699707044,2792.175971137168,132324.7229682076,1780,6,742.1081081081081,31,6,18,35.49554447002643,0.627016129032258,45.50781250000001,1017.968750000001,32.83770161290326,0
1784,4,0,0,37,0.0,0.0,1.0,37,700,500,200,0.7142857142857143,9,5,4,393.8355517394846,0.37634509509509506,0.1451626841062832,0.22042950458489835,129565.68611992736,2805.514695909299,132371.20081583667,1781,7,743.1081081081081,31,6,18,35.45117129215159,0.6273521505376343,45.47526041666667,1018.0989583333338,32.841901881720446,0
1785,4,1,1,37,0.02631578947368421,0.02631578947368421,0.9736842105263158,38,850,500,350,0.5882352941176471,12,5,7,387.7104326669486,0.383431128496918,0.14108549371446455,0.2185473891401965,129844.02101826367,2468.376313641493,132312.39733190517,1782,0,724.5263157894736,32,6,18,35.32323670300627,0.6276041666666665,45.202020202020215,1019.191919191921,31.84974747474753,0
1786,4,2,2,37,0.05128205128205128,0.05128205128205128,0.9487179487179487,39,1100,700,400,0.6363636363636364,15,7,8,375.67955109533614,0.3855994152046784,0.1396821879356982,0.21422219987510271,130293.86421388431,1989.7480836697662,132283.6122975541,1783,0,706.8974358974359,33,6,19,35.17222322250229,0.6297348484848484,44.76102941176472,1020.955882352943,30.938057040998274,0
1787,4,0,0,37,0.0,0.0,1.0,37,850,600,250,0.7058823529411765,11,6,5,393.6570383745261,0.3756569069069069,0.15030202616409483,0.22239066453625844,129930.49621582044,2829.610866970501,132760.10708279096,1784,1,745.7837837837837,31,6,19,35.08354618986802,0.631048387096774,45.11718750000001,1019.531250000001,32.88810483870971,0
1788,4,0,0,37,0.0,0.0,1.0,37,800,400,400,0.5,12,4,8,392.526111472006,0.3754066566566567,0.15446380530607162,0.2228865659054088,130129.69970703137,2815.8610026041806,132945.56070963555,1785,2,746.7837837837837,31,6,19,34.90939254721796,0.6330645161290323,44.92187500000001,1020.3125000000009,32.91330645161293,0
1789,4,0,1,36,0.0,0.02702702702702703,0.972972972972973,37,850,600,250,0.7058823529411765,11,6,5,392.619464805329,0.3754692192192192,0.15643814265911749,0.22332012809464225,130196.1347791884,2823.5073513454904,133019.6421305339,1786,3,747.7837837837837,31,6,19,34.83935102492132,0.6337365591397849,44.856770833333336,1020.572916666667,32.92170698924732,0
1790,4,0,0,36,0.0,0.0,1.0,36,1150,800,350,0.6956521739130435,15,8,7,382.51461124191275,0.3757440476190476,0.1745431241213926,0.21385803022415384,129522.50567544119,2708.850181103956,132231.35585654515,1787,4,761.2222222222222,32,4,16,35.783356073761674,0.6243489583333335,45.51767676767676,1017.9292929292922,31.81029040404038,2
1791,4,2,2,36,0.05263157894736842,0.05263157894736842,0.9473684210526316,38,500,200,300,0.4,8,2,6,363.3265770627193,0.3832385016595543,0.15188663589371632,0.2050867158462796,129898.25857426286,1839.0979308389767,131737.35650510184,1788,0,722.1052631578947,34,4,16,35.88938845420218,0.623468137254902,45.14880952380951,1019.4047619047604,29.982492997198836,0
1792,4,1,1,36,0.02702702702702703,0.02702702702702703,0.972972972972973,37,1350,1000,350,0.7407407407407407,17,10,7,372.56830426623645,0.38391516516516516,0.15762515762515839,0.20991043484268404,129825.09731833881,2273.7432718184996,132098.8405901573,1789,0,742.5945945945946,33,4,16,35.728314894981565,0.6250000000000002,45.2205882352941,1019.1176470588211,30.8823529411764,0
1793,4,0,0,36,0.0,0.0,1.0,36,900,500,400,0.5555555555555556,13,5,8,382.2906360983703,0.37817460317460316,0.1649423863213979,0.2153152633600796,129811.8515489488,2725.171060350948,132537.02260929975,1790,7,764.2222222222222,32,4,16,35.49410440672366,0.6272786458333335,45.23358585858584,1019.0656565656543,31.845801767676697,0
1794,4,1,0,37,0.02702702702702703,0.0,1.0,37,950,600,350,0.631578947368421,13,6,7,372.9741501419699,0.38163163163163166,0.16466754939377415,0.21216726245780895,130200.04325259503,2312.250096116862,132512.2933487119,1791,0,744.5405405405405,33,4,18,35.336615433877675,0.6287878787878789,44.85294117647058,1020.5882352941167,30.92691622103384,0
1795,4,0,1,36,0.0,0.02702702702702703,0.972972972972973,37,700,500,200,0.7142857142857143,9,5,4,372.01166180758025,0.38181931931931934,0.16172090457804766,0.21196013289036544,130262.5868055555,2291.8552960399807,132554.4421015955,1792,1,745.5405405405405,32,5,18,35.29761904761904,0.6318359375,44.791666666666664,1020.8333333333329,31.901041666666654,0
1796,4,2,1,37,0.05263157894736842,0.02631578947368421,0.9736842105263158,38,1000,700,300,0.7,13,7,6,356.7255202352925,0.3899211711711712,0.16210465080677272,0.20646840716648732,130870.93431122435,1737.0004251700493,132607.9347363944,1793,0,700.1052631578947,34,4,17,35.07126236183828,0.6332720588235294,44.19642857142856,1023.2142857142845,30.094537815126017,0
1797,4,0,1,36,0.0,0.02702702702702703,0.972972972972973,37,800,600,200,0.75,10,6,4,355.06743396035455,0.38522897897897895,0.1159938398825282,0.19768040035579487,129357.17520004313,1786.10405252786,131143.279252571,1794,1,720.027027027027,33,4,20,36.650077299923716,0.6202651515151516,45.68014705882352,1017.279411764705,30.826648841354697,7
1798,4,0,0,36,0.0,0.0,1.0,36,450,300,150,0.6666666666666666,6,3,3,361.9237851502762,0.3800760582010582,0.1217152907097041,0.2011936569624206,129297.68207644622,2159.181301652886,131456.8633780991,1795,2,740.9444444444445,32,4,20,36.53631284916203,0.6220703125,45.73863636363636,1017.045454545454,31.78267045454544,0
1799,4,0,0,36,0.0,0.0,1.0,36,900,600,300,0.6666666666666666,12,6,6,359.3181460946902,0.380869708994709,0.09124520597080821,0.1995826447342506,129265.58036169769,2089.493737883876,131355.07409958157,1796,3,741.9444444444445,32,4,23,36.63526405098914,0.6217447916666667,45.770202020202014,1016.9191919191912,31.778724747474726,8
1800,4,0,0,36,0.0,0.0,1.0,36,900,600,300,0.6666666666666666,12,6,6,362.62598765059033,0.38057208994708996,0.09022089848597648,0.20207746946669836,129394.01113406805,2184.326216712588,131578.33735078064,1797,4,742.9444444444445,32,4,23,36.42032762472076,0.623046875,45.6439393939394,1017.4242424242432,31.7945075757576,0
1801,4,1,0,37,0.02702702702702703,0.0,1.0,37,750,500,250,0.6666666666666666,10,5,5,372.6761828269596,0.3846346346346346,0.11019709534173905,0.1959230689870682,127063.62771132632,2070.7175503206045,129134.34526164693,1798,0,723.8378378378378,36,1,21,38.55132357868871,0.5905671296296295,47.94481981981983,1008.2207207207218,28.006131131131163,6
1802,4,3,3,37,0.075,0.075,0.925,40,1050,800,250,0.7619047619047619,13,8,5,347.5424283137436,0.40357905982905984,0.0914472931212087,0.1861727894651855,127822.4682382758,884.75888251786,128707.22712079366,1799,0,670.475,35,5,20,38.40718114532066,0.600297619047619,47.19328703703703,1011.2268518518512,28.892195767195748,0
1803,4,1,1,37,0.02631578947368421,0.02631578947368421,0.9736842105263158,38,900,600,300,0.6666666666666666,12,6,6,363.94941013922806,0.38978781412991936,0.11627780792186604,0.19397303727200632,127617.73003472229,1689.2795138888941,129307.00954861118,1800,0,706.7368421052631,33,5,20,38.20231958762886,0.6025883838383839,47.395833333333336,1010.4166666666673,30.61868686868689,0
1804,4,4,3,38,0.0975609756097561,0.07317073170731707,0.926829268292683,41,750,500,250,0.6666666666666666,10,5,5,338.6194646975482,0.4030487804878049,0.105739339714092,0.18393002685432577,128379.01341735241,495.41162980108527,128874.4250471535,1801,0,655.9268292682926,35,6,19,38.06437490482717,0.605952380952381,46.64351851851851,1013.4259259259248,28.955026455026424,0
1805,4,3,2,39,0.07317073170731707,0.04878048780487805,0.9512195121951219,41,1000,700,300,0.7,13,7,6,339.11053465821294,0.3984247967479675,0.12328645184262044,0.1858325729927007,128731.13854595338,530.8170438957501,129261.95558984912,1802,0,656.8536585365854,35,6,20,37.69293643552311,0.6095238095238095,46.2962962962963,1014.814814814815,28.994708994709,0
1806,4,4,2,41,0.09302325581395349,0.046511627906976744,0.9534883720930233,43,1250,900,350,0.72,16,9,7,321.9709778558128,0.40840716131413807,0.14199605510818403,0.1794335557672123,129396.54659366334,-267.6134724145994,129128.93312124875,1803,0,627.2093023255813,37,6,22,37.45184017674319,0.612331081081081,45.64144736842105,1017.434210526315,27.498221906116623,0
1807,4,2,1,42,0.046511627906976744,0.023255813953488372,0.9767441860465116,43,800,600,200,0.75,10,6,4,319.4958661125626,0.40785345145810264,0.14480970808130111,0.17881368998524064,129563.94184989601,-320.9712363419628,129242.97061355405,1804,0,628.1627906976744,37,6,19,37.345068210375146,0.6140202702702702,45.47697368421052,1018.092105263157,27.51600284495019,0
1808,4,1,1,42,0.023255813953488372,0.023255813953488372,0.9767441860465116,43,1150,900,250,0.782608695652174,14,9,5,319.9222284920416,0.4075535252860834,0.13713169950184012,0.17969029641421194,129703.52055440132,-300.9921321945237,129402.52842220679,1805,0,629.1395348837209,37,6,21,37.19277000358809,0.6154279279279279,45.33991228070175,1018.6403508771926,27.53082029397818,0
1809,4,0,0,42,0.0,0.0,1.0,42,900,300,600,0.3333333333333333,15,3,12,325.60380397776305,0.4033826945412311,0.13823102185171132,0.18321288671584604,129774.47041636256,51.01224535348288,129825.48266171604,1806,2,645.1190476190476,36,6,22,36.9761733716475,0.6180555555555556,45.27027027027028,1018.9189189189209,28.30330330330336,0
1810,4,0,0,42,0.0,0.0,1.0,42,1050,700,350,0.6666666666666666,14,7,7,323.0368398309058,0.40368515292295776,0.14205753003808685,0.18230233629360124,129889.23890106347,-8.198147471765964,129881.0407535917,1807,3,646.1190476190476,36,6,22,36.92531116512005,0.6192129629629628,45.15765765765767,1019.3693693693713,28.315815815815867,0
1811,4,1,0,43,0.023255813953488372,0.0,1.0,43,1000,800,200,0.8,12,8,4,318.08044362609604,0.4053156146179402,0.15223077441935406,0.18110158102234447,130234.60493853896,-314.98381713602,129919.62112140295,1808,0,632.0697674418604,37,6,23,36.702272890034735,0.6207770270270269,44.81907894736843,1020.7236842105278,27.587126600284535,0
1812,4,3,1,45,0.06521739130434782,0.021739130434782608,0.9782608695652174,46,1050,600,450,0.5714285714285714,15,6,9,297.49570224815295,0.41151368760064416,0.14904734760152638,0.17213716840427618,130859.79327781094,-1413.954780553897,129445.83849725703,1809,0,591.7826086956521,40,6,19,36.59759468944508,0.621875,44.207317073170735,1023.1707317073179,25.579268292682947,0
1813,4,2,0,47,0.0425531914893617,0.0,1.0,47,1350,700,650,0.5185185185185185,20,7,13,291.92687640527265,0.4133903792784459,0.17021698457462575,0.17110205707728018,131354.16795764776,-1730.0010534403964,129624.16690420736,1810,0,580.1489361702128,40,7,22,36.24322560391262,0.6268229166666666,43.72459349593497,1025.101626016262,25.627540650406548,0
1814,4,0,1,46,0.0,0.02127659574468085,0.9787234042553191,47,1650,1400,250,0.8484848484848485,19,14,5,293.0321575188454,0.41290857230958994,0.1664393481051749,0.17245326914505626,131510.47992473101,-1692.640066263427,129817.83985846759,1811,1,581.1489361702128,40,7,23,36.05799398923346,0.6283854166666665,43.572154471544735,1025.7113821138241,25.642784552845605,0
1815,4,0,0,46,0.0,0.0,1.0,46,1100,900,200,0.8181818181818182,13,9,4,300.5913245578493,0.408786231884058,0.17291948175820626,0.17679941347649877,131488.3300781253,-1295.1497395833053,130193.18033854199,1812,2,594.6304347826087,39,7,25,35.88640056875889,0.6298076923076922,43.593750000000014,1025.6250000000023,26.29807692307698,0
1816,4,0,0,46,0.0,0.0,1.0,46,1350,1000,350,0.7407407407407407,17,10,7,297.92531454839093,0.40824275362318846,0.1755132942209976,0.17559942686936617,131568.46923828154,-1360.4844835069166,130207.98475477462,1813,3,595.6304347826087,39,7,14,35.874306190137744,0.6306089743589742,43.515625000000014,1025.9375000000023,26.3060897435898,0
1817,4,0,0,46,0.0,0.0,1.0,46,950,600,350,0.631578947368421,13,6,7,301.21076723585765,0.4079911433172303,0.17546829352122395,0.180583706423393,132215.03404058397,-1235.0816313041532,130979.95240927981,1814,4,596.6304347826087,40,6,24,35.14163372859023,0.6354166666666669,42.8861788617886,1028.4552845528428,25.71138211382107,1
1818,4,1,1,46,0.02127659574468085,0.02127659574468085,0.9787234042553191,47,1350,1000,350,0.7407407407407407,17,10,7,296.3135235788194,0.41051880974406413,0.17559379674770526,0.1791473504939833,132532.04345703102,-1545.539610973265,130986.50384605775,1815,0,584.9148936170212,39,8,25,34.95036671724834,0.6402243589743591,42.578124999999986,1029.6874999999982,26.40224358974354,0
1819,4,0,0,46,0.0,0.0,1.0,46,1150,700,450,0.6086956521739131,16,7,9,303.03622436902305,0.4081320450885668,0.17442070350398198,0.18282742778932576,132452.98603121092,-1172.3894413397952,131280.59658987113,1816,6,598.6304347826087,38,8,25,34.85642622383669,0.6411732456140353,42.654914529914514,1029.3803418803398,27.0889563652721,0
1820,4,0,0,46,0.0,0.0,1.0,46,1500,1200,300,0.8,18,12,6,300.95603188613114,0.4080112721417069,0.17557765006270465,0.1819707801329063,132535.48127145856,-1222.5294944846523,131312.9517769739,1817,7,599.6304347826087,38,8,25,34.82741924327316,0.6419956140350879,42.57478632478631,1029.7008547008525,27.097390913180327,0
1821,4,0,0,46,0.0,0.0,1.0,46,1150,600,550,0.5217391304347826,17,6,11,308.17263544536263,0.4069343800322061,0.1639437856829158,0.188327721661055,132934.57031250003,-1006.6406249999995,131927.92968750003,1818,8,600.6304347826087,39,7,18,34.24242424242424,0.6442307692307693,42.1875,1031.2500000000002,26.442307692307697,1
1822,4,0,2,44,0.0,0.043478260869565216,0.9565217391304348,46,1450,1100,350,0.7586206896551724,18,11,7,303.4309909109807,0.4069343800322061,0.1715658490786447,0.1733472443243004,130366.35068618212,-1286.3916670797857,129079.95901910233,1819,9,601.6304347826087,40,6,19,36.94314525491757,0.6169270833333333,44.6900406504065,1021.2398373983737,25.530995934959343,7
1823,4,0,0,44,0.0,0.0,1.0,44,1000,600,400,0.6,14,6,8,315.32847838718874,0.40216481677237487,0.18336169904582578,0.17930512910329272,130184.79100568444,-589.8055886046678,129594.98541707978,1820,10,629.5227272727273,40,4,20,36.822844054969124,0.6151041666666668,44.86788617886179,1020.5284552845528,25.51321138211382,0
1824,4,1,1,44,0.022222222222222223,0.022222222222222223,0.9777777777777777,45,900,700,200,0.7777777777777778,11,7,4,307.2065711294191,0.4044402356902357,0.17666338237126178,0.1763606594119793,130555.17713758658,-978.471862361321,129576.70527522526,1821,0,616.5111111111111,39,6,14,36.65624044439914,0.6204594017094018,44.50520833333332,1021.9791666666648,26.20459401709397,0
1825,4,2,2,44,0.043478260869565216,0.043478260869565216,0.9565217391304348,46,1100,800,300,0.7272727272727273,14,8,6,298.43517194156226,0.40890700483091785,0.16650968463894844,0.17210046620332,130729.84959556125,-1397.1229716108387,129332.72662395041,1822,0,604.0652173913044,40,6,14,36.70438735963431,0.6205729166666668,44.33434959349592,1022.6626016260142,25.566565040650353,0
1826,4,0,0,44,0.0,0.0,1.0,44,1350,1200,150,0.8888888888888888,15,12,3,307.83833696126004,0.40266032417195213,0.16645999030759184,0.17688224442692918,130589.98243343183,-759.8793967784488,129830.10303665338,1823,13,632.5227272727273,38,6,15,36.604996341590876,0.6225328947368423,44.47115384615384,1022.1153846153836,26.8977732793522,0
1827,4,0,0,44,0.0,0.0,1.0,44,1100,700,400,0.6363636363636364,15,7,8,309.0926464778085,0.40219785059901336,0.17041537278140262,0.17835707683737556,130753.83434007231,-716.9902613412174,130036.8440787311,1824,14,633.5227272727273,38,6,16,36.40773529719003,0.6241776315789473,44.31089743589744,1022.7564102564102,26.91464237516869,0
1828,4,0,0,44,0.0,0.0,1.0,44,1550,1200,350,0.7741935483870968,19,12,7,310.8180316508381,0.4022749295278365,0.1774909850066424,0.18024435491616406,130945.12473518889,-659.9788151070179,130285.14592008186,1825,15,634.5227272727273,38,6,17,36.17084203201112,0.6260964912280702,44.123931623931625,1023.504273504274,26.93432298695458,0
1829,4,1,1,44,0.022222222222222223,0.022222222222222223,0.9777777777777777,45,1350,1100,250,0.8148148148148148,16,11,5,302.5291720325436,0.40683922558922564,0.17957597731919206,0.17682587434843325,131248.05908203122,-1058.7266710069453,130189.33241102428,1826,0,621.4,39,6,19,36.07817847582258,0.6274038461538461,43.828125,1024.6874999999998,26.274038461538456,0
1830,4,0,0,44,0.0,0.0,1.0,44,1150,900,250,0.782608695652174,14,9,5,309.0056990524457,0.40204369274136714,0.18165471034750724,0.1808597724838386,131300.74929003228,-685.4640359047239,130615.28525412756,1827,17,636.5227272727273,38,6,21,35.85926369922513,0.6296600877192982,43.77670940170941,1024.8931623931635,26.970872694556935,0
1831,4,0,0,44,0.0,0.0,1.0,44,1300,800,500,0.6153846153846154,18,8,10,309.127158489051,0.40163627554615927,0.17876308805086438,0.1814593885141948,131412.43128895463,-675.3668515329758,130737.06443742165,1828,18,637.5227272727273,37,7,22,35.74383755748048,0.6326013513513511,43.667763157894754,1025.3289473684238,27.71159317211956,0
1832,4,0,0,44,0.0,0.0,1.0,44,1000,600,400,0.6,14,6,8,311.6181986778355,0.40126189217758984,0.17810235287260334,0.18386652605467776,131609.25116381978,-597.6324445983195,131011.61871922146,1829,19,638.5227272727273,37,7,12,35.482118686329,0.634572072072072,43.475877192982466,1026.0964912280713,27.732337600758683,0
1833,4,0,1,43,0.0,0.022727272727272728,0.9772727272727273,44,1200,1000,200,0.8333333333333334,14,10,4,312.78529232575374,0.4013169485553207,0.178557555039768,0.18496418960589903,131693.64762474995,-561.6327860495563,131132.0148387004,1830,20,639.5227272727273,37,7,13,35.367370829327335,0.6354166666666666,43.39364035087719,1026.4254385964914,27.741228070175442,0
1834,4,0,0,43,0.0,0.0,1.0,43,1650,1200,450,0.7272727272727273,21,12,9,325.14764532713394,0.39908637873754155,0.21771060042328783,0.1848594462467705,130178.6502217027,-134.54368170976704,130044.10653999294,1831,21,654.0930232558139,37,6,18,36.578538555209356,0.620213963963964,44.873903508771924,1020.5043859649112,27.581199620673274,3
1835,4,0,0,43,0.0,0.0,1.0,43,1450,1200,250,0.8275862068965517,17,12,5,328.69637650978746,0.3991325212255445,0.2154722354057903,0.18728049359278606,130262.58680555565,-36.60489285163669,130225.98191270401,1832,22,655.0930232558139,36,7,18,36.40306122448979,0.622974537037037,44.79166666666667,1020.8333333333342,28.356481481481506,0
1836,4,1,0,44,0.022727272727272728,0.0,1.0,44,900,800,100,0.8888888888888888,10,8,2,322.89199563438746,0.4027043692741367,0.17760713401040418,0.18230978830433864,129908.37191358018,-410.72530864198256,129497.6466049382,1833,0,641.1818181818181,38,6,16,36.90962761126248,0.6156798245614036,45.138888888888886,1019.4444444444439,26.827485380116944,8
1837,4,0,0,44,0.0,0.0,1.0,44,1200,700,500,0.5833333333333334,17,7,10,323.1155036295784,0.40274841437632136,0.1745677343184675,0.18320111809116466,130071.79578493665,-394.3572393893097,129677.43854554734,1834,1,642.1818181818181,38,6,17,36.738496718335426,0.6173245614035088,44.97863247863247,1020.0854700854688,26.84435447593339,0
1838,4,1,1,44,0.022222222222222223,0.022222222222222223,0.9777777777777777,45,1050,700,350,0.6666666666666666,14,7,7,314.01702914784516,0.4065025252525252,0.17172351258980267,0.17929359406183387,130344.39718934883,-813.78810084743,129530.6090885014,1835,0,628.8888888888889,38,7,17,36.695046034735284,0.6200657894736843,44.711538461538446,1021.1538461538439,26.87246963562747,0
1839,4,3,3,44,0.06382978723404255,0.06382978723404255,0.9361702127659575,47,1200,800,400,0.6666666666666666,16,8,8,304.0394416908263,0.4127736663583102,0.1730372424990705,0.17545028332433873,130755.83316808735,-1449.0138971512047,129306.81927093615,1836,0,603.063829787234,40,7,13,36.53492647058825,0.6208333333333336,44.308943089430876,1022.764227642273,25.569105691056826,0
1840,4,0,0,44,0.0,0.0,1.0,44,1000,700,300,0.7,13,7,6,324.90106054276646,0.40204369274136714,0.1877727700601881,0.18589940394071724,130426.23325525942,-324.87569855361426,130101.3575567058,1837,4,645.1818181818181,38,6,17,36.334457692709954,0.620888157894737,44.63141025641024,1021.4743589743567,26.880904183535705,0
1841,4,0,0,44,0.0,0.0,1.0,44,1100,800,300,0.7272727272727273,14,8,6,334.79451146880626,0.4022198731501057,0.1995497718021466,0.194286263742134,130972.4633487654,-30.22762345679145,130942.23572530861,1838,5,646.1818181818181,38,6,16,35.529737675260066,0.6263706140350876,44.09722222222222,1023.611111111111,26.93713450292397,3
1842,4,0,1,43,0.0,0.022727272727272728,0.9772727272727273,44,1150,900,250,0.782608695652174,14,9,5,332.3412558516389,0.4021538054968288,0.20007731494217995,0.1931368256413739,131027.14913662434,-90.85454105485564,130936.29459556949,1839,6,647.1818181818181,38,6,16,35.53732303732305,0.6269188596491228,44.04380341880342,1023.8247863247866,26.942757534862807,0
1843,4,0,1,42,0.0,0.023255813953488372,0.9767441860465116,43,1200,800,400,0.6666666666666666,16,8,8,336.957702955578,0.3984403839055002,0.20880921665413155,0.1959222310211199,131047.29940943363,231.4793975069204,131278.77880694057,1840,30,663.0930232558139,37,6,17,35.3988184479189,0.6289414414414414,44.02412280701754,1023.9035087719295,27.673067804646745,0
1844,4,1,1,42,0.023255813953488372,0.023255813953488372,0.9767441860465116,43,900,700,200,0.7777777777777778,11,7,4,336.9203996036827,0.40155500184569953,0.2177411126457376,0.19690563691659882,131243.84576263846,243.74579197444777,131487.5915546129,1841,0,663.2093023255813,37,6,18,35.20142232923133,0.6309121621621622,43.83223684210526,1024.6710526315785,27.693812233285904,0
1845,4,0,0,42,0.0,0.0,1.0,42,1000,600,400,0.6,14,6,8,346.69469285918774,0.3994386372435153,0.2048751439895351,0.19174339135681612,129095.50781249999,551.3454861111105,129646.8532986111,1842,1,679.047619047619,39,3,17,37.129287959546254,0.6057692307692308,45.9375,1016.2499999999999,26.057692307692303,5
1846,4,0,0,42,0.0,0.0,1.0,42,600,300,300,0.5,9,3,6,346.6809997312552,0.3993418505613628,0.21018735362997698,0.19225037257824137,129201.38888888879,558.3767361111018,129759.76562499988,1843,2,680.047619047619,38,4,18,37.021857923497265,0.6085526315789473,45.83333333333333,1016.6666666666658,26.75438596491226,0
1847,4,1,1,42,0.023255813953488372,0.023255813953488372,0.9767441860465116,43,950,800,150,0.8421052631578947,11,8,3,339.85974234104435,0.40141657438169065,0.20447780386628467,0.18922863419057245,129360.29188368063,192.87109375000483,129553.16297743063,1844,0,665.2093023255813,39,4,18,37.033671240357705,0.608440170940171,45.677083333333336,1017.2916666666673,26.084401709401725,0
1848,4,3,1,44,0.06666666666666667,0.022222222222222223,0.9777777777777777,45,1100,800,300,0.7272727272727273,14,8,6,329.45795993742684,0.4124368686868687,0.21819912183937906,0.18577667839720738,129857.80915375393,-443.46222285211763,129414.34693090181,1845,0,636.5777777777778,41,4,16,36.793524106157946,0.6102642276422765,45.188492063492056,1019.2460317460304,24.85965931087879,0
1849,4,0,0,44,0.0,0.0,1.0,44,950,600,350,0.631578947368421,13,6,7,338.81546916775574,0.4089037174066244,0.22817946067497186,0.19062648113781822,129770.27253123144,-6.364845660652861,129763.9076855708,1846,1,652.0454545454545,40,4,16,36.643892546046914,0.6109375,45.27439024390244,1018.9024390243906,25.472560975609763,0
1850,4,0,0,44,0.0,0.0,1.0,44,850,600,250,0.7058823529411765,11,6,5,338.92640043090194,0.4093661909795631,0.22864560678555934,0.1914476153785364,129925.63950029736,7.04586390375249,129932.68536420111,1847,2,653.0454545454545,40,4,16,36.48346125730994,0.6125,45.12195121951219,1019.5121951219505,25.487804878048763,0
1851,4,0,0,44,0.0,0.0,1.0,44,850,300,550,0.35294117647058826,14,3,11,337.4683339656697,0.4092010218463707,0.23033308264545194,0.19075041096775006,129951.54303200802,-29.093855344047142,129922.44917666397,1848,3,654.0454545454545,40,4,16,36.494360277750104,0.6127604166666667,45.09654471544715,1019.613821138211,25.490345528455276,0
1852,4,1,0,45,0.022222222222222223,0.0,1.0,45,1500,1100,400,0.7333333333333333,19,11,8,327.7958048028788,0.411763468013468,0.23375728309415322,0.18702296150627606,130315.76063368074,-455.86446791962226,129859.8961657611,1849,0,640.4888888888889,39,6,17,36.372253961776515,0.6180555555555556,44.73958333333334,1021.0416666666681,26.180555555555593,0
1853,4,0,0,45,0.0,0.0,1.0,45,800,500,300,0.625,11,5,6,329.5551067831991,0.4117424242424242,0.23342624696897585,0.18854243740467047,130422.14084201399,-403.74348958332325,130018.39735243066,1850,1,641.4888888888889,39,6,17,36.21974641376028,0.6191239316239316,44.63541666666667,1021.4583333333342,26.191239316239336,0
1854,4,1,0,46,0.021739130434782608,0.0,1.0,46,1050,700,350,0.6666666666666666,14,7,7,322.6279474321417,0.41391908212560385,0.23046847998894027,0.18617704489432782,130755.83316808798,-762.902786040034,129992.93038204794,1851,0,628.5217391304348,40,6,18,36.059635002649706,0.6208333333333333,44.308943089430905,1022.764227642278,25.56910569105695,0
1855,4,0,0,46,0.0,0.0,1.0,46,1300,1100,200,0.8461538461538461,15,11,4,323.51947489716974,0.4140801127214171,0.2341220154570185,0.18744770496055818,130911.78882444321,-729.4973643333852,130182.29146010983,1852,1,629.5217391304348,40,6,18,35.87946871896723,0.6223958333333333,44.15650406504066,1023.3739837398381,25.58434959349595,0
1856,4,0,0,46,0.0,0.0,1.0,46,1050,700,350,0.6666666666666666,14,7,7,320.50432666306125,0.41464371980676323,0.22603640040444883,0.18623900062853563,131023.24263038553,-801.2967687074753,130221.94586167806,1853,2,630.5217391304348,41,5,18,35.844234496124045,0.621951219512195,44.04761904761905,1023.8095238095241,24.970963995354246,0
1857,4,0,0,46,0.0,0.0,1.0,46,1250,800,450,0.64,17,8,9,317.50783214587625,0.41435185185185186,0.21698625292480012,0.18536776970062674,131204.00221027885,-868.3403378703163,130335.66187240853,1854,3,631.5217391304348,42,4,18,35.73883161512027,0.6222718253968254,43.87112403100775,1024.5155038759692,24.393226282761173,0
1858,4,1,1,46,0.02127659574468085,0.02127659574468085,0.9787234042553191,47,1000,700,300,0.7,13,7,6,309.7608911339503,0.41566450817144623,0.21298829632832073,0.18179323167912412,131404.40095308947,-1259.093764122522,130145.30718896695,1855,0,619.063829787234,41,6,18,35.735667634252536,0.6257621951219512,43.675595238095234,1025.2976190476184,25.007259001161422,0
1859,4,0,0,46,0.0,0.0,1.0,46,1400,800,600,0.5714285714285714,20,8,12,317.45952823715953,0.41321457326892114,0.22102454918456704,0.18619370470095714,131380.21349725686,-858.4198806927177,130521.79361656414,1856,5,633.5217391304348,40,6,18,35.562673473433776,0.6270833333333334,43.699186991869915,1025.2032520325197,25.630081300812993,0
1860,4,0,0,46,0.0,0.0,1.0,46,1500,1100,400,0.7333333333333333,19,11,8,319.4347850828966,0.41330515297906606,0.22851179681139344,0.18799156185665725,131510.47992473046,-798.1956218190405,130712.28430291142,1857,6,634.5217391304348,40,6,18,35.3809570989795,0.6283854166666667,43.57215447154471,1025.7113821138196,25.64278455284549,0
1861,4,0,0,46,0.0,0.0,1.0,46,1050,600,450,0.5714285714285714,15,6,9,321.51750588271574,0.41337560386473426,0.23309937587996687,0.18995423177365464,131658.81406092524,-733.8772951310261,130924.93676579422,1858,7,635.5217391304348,41,5,15,35.17832688899628,0.6283028455284554,43.42757936507936,1026.289682539682,25.03145567169956,0
1862,4,2,2,46,0.041666666666666664,0.041666666666666664,0.9583333333333334,48,900,600,300,0.6666666666666666,12,6,6,311.51458344771333,0.4166851359338062,0.2294814507708378,0.18598345922670398,132057.11680010322,-1372.4564537419662,130684.66034636126,1859,0,610.0,43,5,15,35.0350869111234,0.6293604651162792,43.03977272727273,1027.8409090909086,23.903276955602525,0
1863,4,0,0,46,0.0,0.0,1.0,46,1400,1200,200,0.8571428571428571,16,12,4,321.89996387150757,0.4126811594202899,0.2376985282955395,0.19088829978435146,131800.326800147,-714.6959129559718,131085.63088719104,1860,9,637.5217391304348,42,4,15,35.02622597590512,0.6282242063492064,43.289728682170534,1026.8410852713162,24.448597268364672,0
1864,4,1,1,46,0.02127659574468085,0.02127659574468085,0.9787234042553191,47,1150,700,450,0.6086956521739131,16,7,9,316.11591735241063,0.41396854764107305,0.23904904163187268,0.1887305922410926,132057.11680010322,-1050.9286759641884,131006.18812413904,1861,0,624.936170212766,43,4,16,34.916850930532526,0.6293604651162792,43.03977272727273,1027.8409090909086,23.903276955602525,0
1865,4,0,0,46,0.0,0.0,1.0,46,1650,1100,550,0.6666666666666666,22,11,11,327.1552356840281,0.4115942028985507,0.24590483059912205,0.19553745889418891,132098.9961259089,-556.6243577609525,131542.37176814795,1862,1,639.2608695652174,42,4,17,34.5911097495837,0.6312003968253969,42.99903100775194,1028.0038759689921,24.47628276116648,0
1866,4,0,2,44,0.0,0.043478260869565216,0.9565217391304348,46,1400,1000,400,0.7142857142857143,18,10,8,324.5527535765859,0.41084943639291466,0.24719789017613247,0.19500716382131375,132298.2967989454,-612.4446960819616,131685.85210286346,1863,2,640.2608695652174,42,4,17,34.457905560265,0.6331845238095237,42.80523255813954,1028.7790697674423,24.49473975636767,0
1867,4,1,1,44,0.022222222222222223,0.022222222222222223,0.9777777777777777,45,1400,1200,200,0.8571428571428571,16,12,4,328.64003671589404,0.41287878787878785,0.2369770580296897,0.19798558309469746,132398.0034722224,-297.7054977164649,132100.29797450593,1864,0,608.5555555555555,40,5,17,34.252699055330645,0.6372395833333333,42.70833333333334,1029.166666666668,25.729166666666703,0
1868,4,0,0,44,0.0,0.0,1.0,44,1250,900,350,0.72,16,9,7,334.0166925773512,0.4114142882311487,0.2459506172839505,0.20094587120295174,132345.71358194525,41.135505486147764,132386.8490874314,1865,4,623.3863636363636,40,4,17,34.16687242798354,0.63671875,42.75914634146341,1028.9634146341461,25.724085365853654,0
1869,4,0,0,44,0.0,0.0,1.0,44,1150,700,450,0.6086956521739131,16,7,9,336.1446250447246,0.4105113636363636,0.24264184635816322,0.20306983877925475,132502.61423631755,108.00831598253893,132610.62255230008,1866,5,624.3863636363636,40,4,17,33.95457013128023,0.6382812500000001,42.606707317073166,1029.5731707317063,25.739329268292657,0
1870,4,0,0,44,0.0,0.0,1.0,44,950,600,350,0.631578947368421,13,6,7,338.94344725466914,0.41014799154334036,0.2481613690177229,0.20547432902950488,132633.43578557714,191.04678927884748,132824.482574856,1867,6,625.3863636363636,40,4,16,33.75119212049459,0.6395833333333334,42.47967479674796,1030.0813008130065,25.752032520325162,0
1871,4,0,0,44,0.0,0.0,1.0,44,1500,1000,500,0.6666666666666666,20,10,10,338.88726835006804,0.41011495771670187,0.24320108997687373,0.20630220141695008,132790.50684942814,200.2024258047329,132990.7092752329,1868,7,626.3863636363636,40,4,16,33.59503385262603,0.6411458333333334,42.32723577235772,1030.6910569105682,25.767276422764205,0
1872,4,1,0,45,0.022222222222222223,0.0,1.0,45,1050,800,250,0.7619047619047619,13,8,5,331.60313406071054,0.4115951178451178,0.23774338598908473,0.20376062632212424,133139.2621429355,-170.12068137444066,132969.14146156106,1869,0,613.4444444444445,41,4,18,33.4333645743215,0.643038617886179,41.98908730158728,1032.0436507936479,25.17179636082068,0
1873,4,0,0,45,0.0,0.0,1.0,45,1450,1000,450,0.6896551724137931,19,10,9,333.0415500502457,0.41077441077441074,0.24732628882484864,0.20563241613422623,133318.49666950095,-119.88024376418696,133198.61642573675,1870,1,614.4444444444445,41,4,20,33.21685878962535,0.6448170731707317,41.81547619047618,1032.7380952380938,25.18873403019741,0
1874,4,0,1,44,0.0,0.022222222222222223,0.9777777777777777,45,1000,500,500,0.5,15,5,10,336.5634755463057,0.41007996632996635,0.25519713261648724,0.20866935483870977,133472.2222222223,-15.447845804979295,133456.77437641734,1871,2,615.4444444444445,39,6,20,32.97211021505376,0.6495726495726495,41.66666666666667,1033.3333333333342,26.49572649572652,0
1875,4,0,1,43,0.0,0.022727272727272728,0.9772727272727273,44,1350,900,450,0.6666666666666666,18,9,9,334.82891653145856,0.4105774312896406,0.24319238900634232,0.20805843079266928,133555.03420857986,143.61748027613277,133698.65168885599,1872,3,616.4318181818181,38,6,20,32.93410852713178,0.6521381578947368,41.58653846153846,1033.653846153846,27.20141700404858,0
1876,4,0,0,43,0.0,0.0,1.0,43,1250,900,350,0.72,16,9,7,340.2991526534541,0.4090762273901809,0.24341213455492827,0.21161533425930765,133582.64391116975,491.61210643584633,134074.2560176056,1873,4,629.9302325581396,38,5,20,32.76513194157364,0.6524122807017543,41.55982905982907,1033.7606837606854,27.204228520018038,0
1877,4,0,0,43,0.0,0.0,1.0,43,850,700,150,0.8235294117647058,10,7,3,341.3835594854355,0.4091685123661868,0.24845445786490483,0.21276570973982822,133665.49014034998,526.2401608956196,134191.7303012456,1874,5,630.9302325581396,38,5,20,32.65424286255468,0.6532346491228069,41.47970085470086,1034.0811965811972,27.212663067926243,0
1878,4,0,0,43,0.0,0.0,1.0,43,1400,1000,400,0.7142857142857143,18,10,8,340.2058966693231,0.4087993724621632,0.2457998328578428,0.2128264795442975,133803.62426035505,504.15639381985727,134307.78065417492,1875,6,631.9302325581396,38,5,16,32.54659748038,0.6546052631578947,41.34615384615385,1034.6153846153848,27.226720647773284,0
1879,4,0,0,43,0.0,0.0,1.0,43,1150,900,250,0.782608695652174,14,9,5,341.7321404302771,0.4081764488741233,0.24447053231254512,0.21426273426201273,133886.53897518083,550.666707758055,134437.2056829389,1876,7,632.9302325581396,38,5,17,32.42425415505316,0.6554276315789473,41.26602564102564,1034.9358974358977,27.235155195681518,0
1880,4,0,0,43,0.0,0.0,1.0,43,1100,600,500,0.5454545454545454,16,6,10,341.55987309377076,0.4080841638981174,0.245388436892505,0.21463781908421772,133969.4793721235,551.7196745562039,134521.19904667969,1877,8,633.9302325581396,38,5,17,32.34584623323013,0.65625,41.18589743589743,1035.2564102564095,27.243589743589723,0
1881,4,0,1,42,0.0,0.023255813953488372,0.9767441860465116,43,800,500,300,0.625,11,5,6,341.1866333249815,0.40776116648209676,0.2427559531236505,0.2147260292328391,134024.7872379282,545.4931879611336,134570.28042588933,1878,9,634.9302325581396,38,5,18,32.300264823221895,0.6567982456140351,41.13247863247863,1035.470085470085,27.24921277552855,0
1882,4,0,0,42,0.0,0.0,1.0,42,950,500,450,0.5263157894736842,14,5,9,344.22936892224203,0.4065040650406504,0.2386196325205221,0.21672681067344332,134039.34383656492,828.0557479224158,134867.39958448734,1879,10,648.7857142857143,37,5,18,32.20695679796695,0.6587837837837839,41.11842105263157,1035.5263157894722,27.98719772403979,0
1883,4,0,0,42,0.0,0.0,1.0,42,1200,900,300,0.75,15,9,6,347.76680996224064,0.40667344173441733,0.23589673610900497,0.21528639181762366,133415.57618690372,880.4757232994821,134296.0519102032,1880,11,649.7857142857143,37,5,19,32.73942192032831,0.6525900900900901,41.72149122807018,1033.11403508772,27.922000948316754,4
1884,4,1,0,43,0.023255813953488372,0.0,1.0,43,1150,900,250,0.782608695652174,14,9,5,342.35613107820404,0.40663067552602433,0.2438165048445391,0.2142757583342329,133821.54959013077,562.9496403737052,134384.49923050447,1881,0,635.6511627906976,36,7,18,32.47306269046582,0.6585648148148149,41.32882882882883,1034.6846846846854,28.741241241241262,0
1885,4,0,0,43,0.0,0.0,1.0,43,500,200,300,0.4,8,2,6,342.7519082377888,0.4063076781100037,0.24693832615842504,0.2146930664483327,133850.6808117239,575.5152534291074,134426.196065153,1882,1,636.6511627906976,36,7,18,32.4337069684768,0.6588541666666666,41.30067567567568,1034.7972972972973,28.74436936936937,0
1886,4,0,0,43,0.0,0.0,1.0,43,1050,800,250,0.7619047619047619,13,8,5,340.8691616117722,0.4064922480620155,0.24331806564263458,0.21368264633098136,133879.8152037172,527.1000730460172,134406.91527676323,1883,2,637.6511627906976,36,7,18,32.45330068915487,0.6591435185185186,41.27252252252252,1034.9099099099099,28.747497497497495,0
1887,4,0,0,43,0.0,0.0,1.0,43,1750,1400,350,0.8,21,14,7,338.6993722925523,0.4063538205980066,0.2422581820389822,0.21265878620991407,133938.09349890435,472.9496388280187,134411.04313773237,1884,3,638.6511627906976,36,7,18,32.4512257035103,0.6597222222222222,41.21621621621622,1035.1351351351354,28.753753753753763,0
1888,4,0,0,43,0.0,0.0,1.0,43,1150,800,350,0.6956521739130435,15,8,7,346.71283729657983,0.40616925064599485,0.18927754583870748,0.20919485450350106,132455.9583865963,675.3860279198366,133131.34441451612,1885,4,639.6511627906976,36,7,20,33.72944243882873,0.6449652777777777,42.65202702702704,1029.3918918918937,28.59421921921927,8
1889,4,0,0,43,0.0,0.0,1.0,43,1700,1100,600,0.6470588235294118,23,11,12,350.0109170117824,0.4053156146179402,0.19051057036231045,0.21232757750820877,132658.9004545087,686.4126795714831,133345.31313408018,1886,5,640.6511627906976,36,7,16,33.44059721614924,0.6469907407407407,42.454954954954964,1030.1801801801814,28.61611611611615,0
1890,4,1,0,44,0.022727272727272728,0.0,1.0,44,1450,1100,350,0.7586206896551724,18,11,7,343.6256304849014,0.4065583157152925,0.20676769823863062,0.21063019916823697,133047.67001625494,343.71789877654214,133391.3879150315,1887,0,627.0681818181819,37,7,17,33.214984766358455,0.6489301801801801,42.07785087719298,1031.6885964912276,27.88347558084399,0
1891,4,0,0,44,0.0,0.0,1.0,44,1200,800,400,0.6666666666666666,16,8,8,340.8236205065227,0.40632707892882314,0.20238210212182395,0.20954753362690384,133160.81781173055,276.87040724069243,133437.68821897125,1888,1,628.0681818181819,37,7,19,33.17386858599809,0.6500563063063063,41.968201754385966,1032.1271929824563,27.89532954006639,0
1892,4,0,0,44,0.0,0.0,1.0,44,850,600,250,0.7058823529411765,11,6,5,343.43737119485684,0.4065803382663848,0.2068915578898589,0.21163653711850616,133245.71021852887,352.3112880886516,133598.02150661752,1889,2,629.0681818181819,37,7,21,33.02136434437835,0.6509009009009008,41.885964912280706,1032.4561403508778,27.904220009483186,0
1893,4,0,0,44,0.0,0.0,1.0,44,850,400,450,0.47058823529411764,13,4,9,348.0794033975241,0.40616190979563077,0.11952998379254431,0.2085097008701672,132183.6805555555,402.0833333333288,132585.76388888885,1890,3,630.0681818181819,39,5,17,33.968125337655316,0.6367521367521367,42.916666666666664,1028.333333333333,26.36752136752136,8
1894,4,0,0,44,0.0,0.0,1.0,44,1050,700,350,0.6666666666666666,14,7,7,349.7381298863297,0.4054351656095842,0.11925144519312192,0.2100981612382842,132290.8203125,453.4288194444455,132744.24913194444,1891,4,631.0681818181819,39,5,18,33.81767247198597,0.6378205128205128,42.8125,1028.75,26.378205128205128,0
1895,4,0,0,44,0.0,0.0,1.0,44,950,600,350,0.631578947368421,13,6,7,347.2364876190885,0.40572145877378435,0.11386644333597151,0.2088917189221288,132344.40646701385,390.9613715277741,132735.36783854163,1892,5,632.0681818181819,39,5,18,33.828119727340216,0.6383547008547009,42.760416666666664,1028.958333333333,26.383547008547,0
1896,4,1,1,44,0.022222222222222223,0.022222222222222223,0.9777777777777777,45,1500,1200,300,0.8,18,12,6,343.66951658211053,0.40726010101010096,0.1163187243651782,0.20871214218626433,132700.54879830536,121.04839252777506,132821.59719083313,1893,0,619.0,38,7,16,33.56210251624499,0.6436403508771928,42.41452991452992,1030.3418803418815,27.114260008996883,0
1897,4,0,1,43,0.0,0.022727272727272728,0.9772727272727273,44,1550,1100,450,0.7096774193548387,20,11,9,343.3817052326439,0.40462033121916846,0.12039508035040902,0.20936931210099366,132849.77709487555,323.636599723015,133173.41369459857,1894,7,634.0681818181819,37,7,17,33.419751116783665,0.6469594594594594,42.269736842105274,1030.9210526315806,27.86273115220488,0
1898,4,0,0,43,0.0,0.0,1.0,43,1050,900,150,0.8571428571428571,12,9,3,353.43641758911065,0.4032392026578073,0.13454895117347498,0.21341583418755952,132484.94059938332,766.455332536457,133251.39593191977,1895,8,646.7441860465116,36,7,21,33.52726427477577,0.6452546296296295,42.62387387387388,1029.5045045045058,28.597347347347384,2
1899,4,0,0,43,0.0,0.0,1.0,43,1550,1300,250,0.8387096774193549,18,13,5,348.8093745736846,0.4031238464377999,0.13020103861903798,0.21176224074151584,132687.90486009675,656.55702154859,133344.46188164534,1896,9,647.7441860465116,36,7,16,33.44240718475606,0.6472800925925926,42.42680180180181,1030.292792792794,28.61924424424428,0
1900,4,0,1,42,0.0,0.023255813953488372,0.9767441860465116,43,700,400,300,0.5714285714285714,10,4,6,349.6502260588598,0.4028008490217792,0.1276973160894852,0.21260127698768277,132745.92318247305,682.9284098287521,133428.8515923018,1897,10,648.7441860465116,36,7,16,33.36247404655228,0.6478587962962963,42.3704954954955,1030.5180180180184,28.62550050050051,0
1901,4,0,0,42,0.0,0.0,1.0,42,650,400,250,0.6153846153846154,9,4,5,355.9287968690825,0.40128968253968256,0.13833065810593914,0.21578789455959327,132636.3436642659,1041.818844307248,133678.16250857315,1898,11,664.3333333333334,35,7,16,33.31086142322097,0.648809523809524,42.47685185185184,1030.092592592591,29.431216931216888,0
1902,4,0,0,42,0.0,0.0,1.0,42,1050,800,250,0.7619047619047619,13,8,5,353.7291481808885,0.40130178087495155,0.1365503739127647,0.2147951485065667,132695.96220207462,987.6859353566383,133683.64813743124,1899,12,665.3333333333334,35,7,16,33.30759005466937,0.649404761904762,42.418981481481474,1030.324074074073,29.437830687830658,0
1903,4,0,0,42,0.0,0.0,1.0,42,1050,600,450,0.5714285714285714,15,6,9,352.4916198119652,0.4016889276035618,0.13530204356613496,0.21472574323155683,132815.23946544912,963.2517789780379,133778.49124442716,1900,13,666.3333333333334,35,7,16,33.2196459315817,0.6505952380952382,42.30324074074073,1030.7870370370363,29.451058201058178,0
1904,4,0,0,42,0.0,0.0,1.0,42,1150,1100,50,0.9565217391304348,12,11,1,351.1070298949087,0.40153164924506385,0.13290043290043263,0.21456540715799968,132934.5703124999,934.8524305555418,133869.42274305545,1901,14,667.3333333333334,35,7,17,33.135521885521875,0.6517857142857144,42.18749999999999,1031.2499999999993,29.464285714285694,0
1905,4,0,1,41,0.0,0.023809523809523808,0.9761904761904762,42,950,600,350,0.631578947368421,13,6,7,352.9762018268149,0.4002492257065428,0.1356051154086091,0.2161271396212315,133007.1625679734,989.6726118009926,133996.83517977438,1902,15,668.3333333333334,36,6,17,33.01446506550218,0.650462962962963,42.11711711711712,1031.5315315315318,28.65365365365366,0
1906,4,0,0,41,0.0,0.0,1.0,41,1050,700,350,0.6666666666666666,14,7,7,356.2016117351464,0.40127032520325207,0.11537386573254516,0.21861187999525442,133094.2994303426,1281.6807939696478,134375.98022431225,1903,16,650.5121951219512,36,5,18,32.84381934592018,0.6513310185185186,42.03265765765766,1031.86936936937,28.663038038038053,0
1907,4,0,1,40,0.0,0.024390243902439025,0.975609756097561,41,900,600,300,0.6666666666666666,12,6,6,353.86132288505314,0.4011686991869919,0.11253248620874579,0.21756346390052303,133160.81781173058,1224.0926294629141,134384.9104411935,1904,17,651.5121951219512,37,4,19,32.83745440702573,0.6500563063063063,41.968201754385966,1032.1271929824566,27.895329540066392,0
1908,4,0,0,40,0.0,0.0,1.0,40,1150,900,250,0.782608695652174,14,9,5,352.47914446160206,0.3992254273504274,0.0841676398768445,0.21770498765139876,133330.62967691984,1399.2532558094788,134729.88293272932,1905,18,631.825,37,3,20,32.70284796687547,0.6517454954954955,41.80372807017544,1032.7850877192984,27.913110478899956,0
1909,4,0,0,40,0.0,0.0,1.0,40,1150,700,450,0.6086956521739131,16,7,9,352.8225806451609,0.399332264957265,0.0856854838709673,0.21874999999999994,133472.22222222234,1418.402777777787,134890.62500000012,1906,19,632.825,38,2,20,32.55208333333332,0.6513157894736842,41.66666666666667,1033.3333333333344,27.192982456140378,0
1910,4,0,0,40,0.0,0.0,1.0,40,950,500,450,0.5263157894736842,14,5,9,349.3978420719202,0.3986778846153846,0.0879724430889881,0.21747942969913914,133617.71981018197,1337.1485928496204,134954.86840303158,1907,20,633.825,36,4,20,32.49487165522999,0.6565393518518519,41.52590090090091,1033.8963963963977,28.71934434434438,0
1911,4,0,0,40,0.0,0.0,1.0,40,1000,800,200,0.8,12,8,4,352.25275117583556,0.39838408119658114,0.0864287269955355,0.21960196972489465,133675.94103816655,1417.5435993425895,135093.48463750913,1908,21,634.825,36,4,20,32.36278993792879,0.6571180555555556,41.4695945945946,1034.1216216216217,28.7256006006006,0
1912,4,0,0,40,0.0,0.0,1.0,40,1050,700,350,0.6666666666666666,14,7,7,350.622301309621,0.3982371794871795,0.08924994556934496,0.21910316053266513,133763.2966581446,1380.0789810080387,135143.37563915263,1909,22,635.825,36,4,14,32.3175212279556,0.6579861111111112,41.38513513513514,1034.4594594594594,28.734984984984983,0
1913,4,0,1,39,0.0,0.025,0.975,40,700,600,100,0.8571428571428571,8,6,2,350.622301309621,0.3982371794871795,0.08924994556934496,0.21910316053266513,133763.2966581446,1380.0789810080387,135143.37563915263,1910,23,636.825,36,4,14,32.3175212279556,0.6579861111111112,41.38513513513514,1034.4594594594594,28.734984984984983,0
1914,4,1,1,39,0.025,0.025,0.975,40,550,300,250,0.5454545454545454,8,3,5,344.9171365176588,0.4009615384615384,0.07252556014792244,0.216906166425674,133996.38447569186,1243.5298474149754,135239.91432310684,1911,0,595.85,36,4,14,32.232071640925255,0.6603009259259259,41.159909909909906,1035.36036036036,28.760010010009996,0
1915,4,0,0,39,0.0,0.0,1.0,39,450,200,250,0.4444444444444444,7,2,5,353.91198594657897,0.39701417004048584,0.07640681466184818,0.2215667475043709,133831.2596450617,1672.8973765432072,135504.15702160491,1912,25,612.1282051282051,35,4,14,32.16442953020134,0.6607142857142857,41.31944444444444,1034.7222222222222,29.563492063492063,0
1916,4,0,0,39,0.0,0.0,1.0,39,1100,1000,100,0.9090909090909091,12,10,2,353.5454955661306,0.3973515519568151,0.07382688867483189,0.22205835058591797,133951.0459533607,1671.5577846364854,135622.60373799718,1913,26,613.1282051282051,35,4,17,32.0540772212284,0.6619047619047618,41.2037037037037,1035.1851851851848,29.576719576719565,0
1917,4,0,1,38,0.0,0.02564102564102564,0.9743589743589743,39,1150,800,350,0.6956521739130435,15,8,7,372.0334191944712,0.3976889338731444,0.030262926473428875,0.2243046235184024,132427.78427479864,2065.3542684756612,134493.1385432743,1914,27,614.1282051282051,35,4,19,33.106211814535776,0.6467261904761905,42.67939814814815,1029.2824074074083,29.40806878306881,5
1918,4,0,0,38,0.0,0.0,1.0,38,850,600,250,0.7058823529411765,11,6,5,378.01182774709054,0.39578888098624937,0.03833859195283207,0.2275492999661057,132368.2260186257,2407.351010588136,134775.57702921383,1915,28,630.1052631578947,35,3,19,33.012432984666134,0.6461309523809524,42.73726851851852,1029.050925925926,29.401455026455032,0
1919,4,1,1,38,0.02564102564102564,0.02564102564102564,0.9743589743589743,39,1250,900,350,0.72,16,9,7,366.6968812334271,0.3981950067476383,0.042206226946060355,0.2224498056713125,132658.90045450864,1929.121012904801,134588.02146741343,1916,0,614.9230769230769,36,3,16,33.010858475440884,0.6469907407407407,42.45495495495496,1030.1801801801807,28.61611611611613,0
1920,4,1,1,38,0.02564102564102564,0.02564102564102564,0.9743589743589743,39,1200,900,300,0.75,15,9,6,367.22123682403173,0.4006410256410256,0.03537620849096301,0.22311250444488012,132716.91243608488,1947.2937464491754,134664.20618253405,1917,0,615.8974358974359,36,3,16,32.93897996357014,0.6475694444444444,42.39864864864866,1030.4054054054066,28.622372372372404,0
1921,4,0,0,38,0.0,0.0,1.0,38,900,600,300,0.6666666666666666,12,6,6,375.04322601793154,0.39509246088193456,0.03886289287341094,0.22683613744945846,132546.9409749013,2342.166468407059,134889.10744330837,1918,31,633.1052631578947,35,3,19,32.9086817653891,0.6479166666666667,42.563657407407405,1029.7453703703695,29.421296296296273,0
1922,4,2,3,37,0.05,0.075,0.925,40,900,700,200,0.7777777777777778,11,7,4,362.0149426528947,0.40037393162393164,0.062031332979288756,0.2229150219147812,133217.40974386354,1645.338589758393,134862.74833362192,1919,0,602.4,37,3,17,32.57025579748629,0.6506193693693694,41.91337719298246,1032.3464912280706,27.901256519677585,0
1923,4,0,0,37,0.0,0.0,1.0,37,850,600,250,0.7058823529411765,11,6,5,371.02088051010827,0.39101601601601604,0.10790195692046489,0.22764288711270586,133083.80922335826,2475.374415937932,135559.18363929618,1920,1,648.4054054054054,35,2,17,32.47207421948028,0.6532738095238095,42.042824074074076,1031.8287037037042,29.48082010582012,0
1924,4,0,1,36,0.0,0.02702702702702703,0.972972972972973,37,800,500,300,0.625,11,5,6,371.02088051010827,0.39101601601601604,0.10790195692046489,0.22764288711270586,133083.80922335826,2475.374415937932,135559.18363929618,1921,2,649.4054054054054,35,2,17,32.47207421948028,0.6532738095238095,42.042824074074076,1031.8287037037042,29.48082010582012,0
1925,4,0,0,36,0.0,0.0,1.0,36,950,500,450,0.5263157894736842,14,5,9,368.75660782366316,0.3890542328042328,0.10419002765941565,0.2267980295566504,133173.3927576304,2621.7137131344457,135795.10647076485,1922,3,662.6111111111111,35,1,17,32.44047619047619,0.6541666666666666,41.956018518518526,1032.1759259259268,29.490740740740765,0
1926,4,0,0,36,0.0,0.0,1.0,36,1100,900,200,0.8181818181818182,13,9,4,371.2970008723207,0.38852513227513225,0.10597653476815005,0.2289108876836196,133263.00643272043,2696.030923139587,135959.03735586003,1923,4,663.6111111111111,35,1,17,32.2848942569966,0.6550595238095237,41.86921296296297,1032.523148148149,29.500661375661398,0
1927,4,0,0,36,0.0,0.0,1.0,36,950,700,250,0.7368421052631579,12,7,5,369.686714993177,0.388260582010582,0.10597145952407616,0.22828474449025052,133322.76562767936,2657.5310517404173,135980.2966794198,1924,5,664.6111111111111,35,1,18,32.26645093204826,0.6556547619047619,41.8113425925926,1032.754629629631,29.50727513227517,0
1928,4,0,0,36,0.0,0.0,1.0,36,900,600,300,0.6666666666666666,12,6,6,370.7075962539021,0.3865244708994709,0.11155913978494625,0.2298387096774194,133472.22222222228,2695.8333333333435,136168.05555555562,1925,6,665.6111111111111,35,1,18,32.09005376344087,0.657142857142857,41.66666666666667,1033.333333333334,29.52380952380954,0
1929,4,0,0,36,0.0,0.0,1.0,36,400,300,100,0.75,5,3,2,373.28735398214206,0.38637566137566143,0.11378904937856893,0.23199925945821234,133561.93636670534,2771.396363811735,136333.33273051708,1926,7,666.6111111111111,35,1,19,31.93336412495801,0.6580357142857143,41.579861111111114,1033.680555555556,29.533730158730176,0
1930,4,0,0,36,0.0,0.0,1.0,36,650,500,150,0.7692307692307693,8,5,3,374.41749053669383,0.3862433862433863,0.12027501026157639,0.23307814933549056,133621.76254125958,2806.065002357696,136427.82754361728,1927,8,667.6111111111111,35,1,19,31.84412198216351,0.6586309523809523,41.52199074074075,1033.9120370370383,29.540343915343954,0
1931,4,0,0,36,0.0,0.0,1.0,36,700,600,100,0.8571428571428571,8,6,2,371.6591233873183,0.3858465608465609,0.11802447030737095,0.23192359822549433,133711.52692043904,2739.021776406047,136450.54869684507,1928,9,668.6111111111111,35,1,16,31.825387943897336,0.6595238095238094,41.43518518518519,1034.25925925926,29.550264550264572,0
1932,4,0,0,36,0.0,0.0,1.0,36,800,600,200,0.75,10,6,4,373.3449108978333,0.3855489417989418,0.12450585515029489,0.23335362332900936,133771.3865847908,2788.573281035669,136559.95986582647,1929,10,669.6111111111111,35,1,16,31.721768479152686,0.6601190476190476,41.37731481481482,1034.4907407407409,29.55687830687831,0
1933,4,0,0,36,0.0,0.0,1.0,36,850,500,350,0.5882352941176471,12,5,7,374.63591677178107,0.38467261904761907,0.11777367773677727,0.23511361429403763,133921.0943528163,2834.3303915895,136755.42474440578,1930,11,670.6111111111111,35,1,16,31.538284132841326,0.6616071428571428,41.232638888888886,1035.0694444444441,29.57341269841269,0
1934,4,0,0,36,0.0,0.0,1.0,36,950,500,450,0.5263157894736842,14,5,9,376.91178607482857,0.38361441798941803,0.12244384847469014,0.2377014498649501,134100.85419077933,2908.8384934413607,137009.69268422067,1931,12,671.6111111111111,35,1,16,31.299237344954747,0.6633928571428571,41.05902777777778,1035.763888888889,29.59325396825397,0
1935,4,0,0,36,0.0,0.0,1.0,36,1300,1000,300,0.7692307692307693,16,10,6,379.95055661106375,0.38449074074074074,0.1302397438761076,0.2405995250279679,134250.7461526921,3001.729145233202,137252.4752979253,1932,13,672.6111111111111,35,1,17,31.070378229469135,0.6648809523809524,40.914351851851855,1036.342592592593,29.60978835978837,0
1936,4,0,0,36,0.0,0.0,1.0,36,950,700,250,0.7368421052631579,12,7,5,382.59813938589934,0.38386243386243385,0.13289796829649458,0.24307192429921187,134370.72000385812,3081.9974922839565,137452.71749614208,1933,14,673.6111111111111,35,1,17,30.881614199598122,0.6660714285714285,40.798611111111114,1036.805555555556,29.623015873015888,0
1937,4,0,0,36,0.0,0.0,1.0,36,850,300,550,0.35294117647058826,14,3,11,383.2190688775511,0.3841269841269841,0.13087797619047614,0.24386668019480517,134430.7270233196,3103.283607681755,137534.01063100135,1934,15,674.6111111111111,35,1,17,30.80543154761905,0.6666666666666666,40.74074074074074,1037.037037037037,29.629629629629626,0
1938,4,0,0,36,0.0,0.0,1.0,36,1250,1100,150,0.88,14,11,3,391.35468793126876,0.38508597883597884,0.14170996693434113,0.2503014726134429,134614.36106305267,3336.499420332158,137950.86048338484,1935,16,675.6111111111111,33,3,17,30.410565265312542,0.6729797979797979,40.56372549019608,1037.7450980392157,31.446821152703507,0
1939,4,0,1,35,0.0,0.027777777777777776,0.9722222222222222,36,650,400,250,0.6153846153846154,9,4,5,390.58054749801016,0.3851190476190476,0.1394004984914079,0.250243361369754,134677.95589436762,3320.517949827,137998.4738441946,1936,17,676.6111111111111,33,3,17,30.36698150334514,0.673611111111111,40.50245098039216,1037.9901960784318,31.454248366013086,0
1940,4,0,0,35,0.0,0.0,1.0,35,950,500,450,0.5263157894736842,14,5,9,396.4902974618218,0.38252801120448177,0.1409866842818901,0.25337148246821556,134583.53261146822,3672.2129757167686,138255.745587185,1937,18,693.1428571428571,32,3,17,30.308215705362205,0.6751302083333333,40.593434343434346,1037.6262626262628,32.42582070707071,0
1941,4,0,0,35,0.0,0.0,1.0,35,950,900,50,0.9473684210526315,10,9,1,396.62299761777916,0.38172268907563023,0.14650319577718918,0.25433712436186307,134709.75894187353,3685.797679978878,138395.55662185242,1938,19,694.1428571428571,33,2,18,30.178329004840034,0.6739267676767676,40.47181372549021,1038.112745098041,31.457961972667906,0
1942,4,0,1,34,0.0,0.02857142857142857,0.9714285714285714,35,600,200,400,0.3333333333333333,10,2,8,398.6867345122723,0.381687675070028,0.1450253747196979,0.25610862028222015,134773.37630058153,3746.471459294509,138519.84775987602,1939,20,695.1428571428571,33,2,18,30.06105177229631,0.6745580808080808,40.41053921568628,1038.3578431372553,31.465389185977433,0
1943,4,0,0,34,0.0,0.0,1.0,34,500,300,200,0.6,7,3,4,402.0233794228526,0.38103461081402257,0.14883268482490242,0.2583000212791829,134780.12447709424,4036.952224262839,138817.0767013571,1940,21,703.1176470588235,32,2,16,29.967675907911794,0.6770833333333333,40.40404040404041,1038.383838383839,32.44949494949497,0
1944,4,0,0,34,0.0,0.0,1.0,34,400,300,100,0.75,5,3,2,400.35038605776305,0.3812574272133096,0.1447204702449909,0.2576903189132364,134845.6869834712,3997.104568411407,138842.79155188263,1941,22,704.1176470588235,32,2,16,29.945447362022854,0.677734375,40.3409090909091,1038.6363636363649,32.4573863636364,0
1945,4,0,0,34,0.0,0.0,1.0,34,1300,1100,200,0.8461538461538461,15,11,4,400.4257901256256,0.38107174688057044,0.1435780144378529,0.25867380319732347,134976.85982297736,4009.6431486583133,138986.50297163567,1942,23,705.1176470588235,32,2,16,29.81217091940057,0.6790364583333333,40.21464646464647,1039.141414141415,32.47316919191922,0
1946,4,0,0,34,0.0,0.0,1.0,34,850,600,250,0.7058823529411765,11,6,5,402.2678528201902,0.3804032976827094,0.14762319793110334,0.26080893701743696,135108.09643148675,4069.928770023488,139178.02520151023,1943,24,706.1176470588235,32,2,16,29.63297506274796,0.6803385416666665,40.08838383838385,1039.6464646464658,32.488952020202056,0
1947,4,0,0,34,0.0,0.0,1.0,34,800,600,200,0.75,10,6,4,399.44880458012017,0.3801990493166964,0.14747302344514313,0.25968901368006747,135206.56573627712,4001.6202109478836,139208.185947225,1944,25,707.1176470588235,32,2,17,29.6077657723281,0.6813151041666666,39.99368686868688,1040.0252525252542,32.500789141414195,0
1948,4,0,0,34,0.0,0.0,1.0,34,750,600,150,0.8,9,6,3,403.92149354321776,0.37973484848484845,0.14826527698458025,0.263315910347794,135305.0709111316,4130.525265279061,139435.59617641065,1945,26,708.1176470588235,32,2,17,29.39295105177993,0.6822916666666666,39.8989898989899,1040.404040404041,32.512626262626284,0
1949,4,0,0,34,0.0,0.0,1.0,34,1350,900,450,0.6666666666666666,18,9,9,403.16879692597087,0.37973484848484845,0.14246312379130943,0.2635464229231387,135403.6119560505,4118.102266350383,139521.7142224009,1946,27,709.1176470588235,32,2,17,29.31401391079299,0.6832682291666666,39.804292929292934,1040.782828282829,32.52446338383841,0
1950,4,0,0,34,0.0,0.0,1.0,34,950,700,250,0.7368421052631579,12,7,5,401.04584181930704,0.3791221033868093,0.14019631621748863,0.2628794921813998,135502.1888710337,4068.5178808285,139570.7067518622,1947,28,710.1176470588235,32,2,19,29.27075753900881,0.6842447916666666,39.709595959595966,1041.161616161617,32.536300505050534,0
1951,4,0,0,34,0.0,0.0,1.0,34,750,500,250,0.6666666666666666,10,5,5,404.70469989021194,0.3790478312537136,0.14480515775660385,0.2657646787177127,135567.92674216928,4172.995421385582,139740.92216355487,1948,29,711.1176470588235,32,2,19,29.10983470740381,0.6848958333333333,39.64646464646465,1041.4141414141423,32.544191919191945,0
1952,4,0,0,34,0.0,0.0,1.0,34,1050,700,350,0.6666666666666666,14,7,7,406.74905278556093,0.3783236779560309,0.14654276108585584,0.26785997520313387,135668.68505390815,4236.653712169544,139905.3387660777,1949,30,712.1176470588235,30,4,19,28.955941168881438,0.6913194444444444,39.54973118279571,1041.8010752688187,34.72670250896063,0
1953,4,0,0,34,0.0,0.0,1.0,34,1000,500,500,0.5,15,5,10,403.2741250564123,0.37767379679144386,0.14711761766175746,0.266320635062007,135769.34814453137,4150.453016493071,139919.80116102443,1950,31,713.1176470588235,31,3,19,28.94594369481927,0.689516129032258,39.45312500000001,1042.187500000001,33.61895161290325,0
1954,4,0,0,34,0.0,0.0,1.0,34,900,700,200,0.7777777777777778,11,7,4,405.13028785929583,0.37592840166369573,0.1548882507179421,0.2688225746035712,135939.02799818266,4214.603508843336,140153.631507026,1951,32,714.1176470588235,31,3,17,28.72822761892871,0.6911962365591398,39.29036458333334,1042.8385416666679,33.63995295698928,0
1955,4,0,0,34,0.0,0.0,1.0,34,1100,900,200,0.8181818181818182,13,9,4,404.19326029728734,0.37568701723113485,0.152728207387824,0.2684567176601389,135972.97668457055,4191.872151692738,140164.8488362633,1952,33,715.1176470588235,31,3,17,28.718789013732835,0.691532258064516,39.257812500000014,1042.9687500000018,33.64415322580651,0
1956,4,0,0,34,0.0,0.0,1.0,34,1100,800,300,0.7272727272727273,14,8,6,405.94259241731436,0.3747214795008913,0.1510591651956037,0.2705410954626364,136094.40363228263,4249.303004795453,140343.70663707808,1953,34,716.1176470588235,32,2,17,28.552053081639244,0.6901041666666666,39.14141414141415,1043.434343434345,32.60732323232328,0
1957,4,0,0,34,0.0,0.0,1.0,34,800,600,200,0.75,10,6,4,403.80550190323686,0.3746472073677956,0.15095856876503344,0.2696168238071209,136160.28498367517,4196.454443424145,140356.73942709932,1954,35,717.1176470588235,32,2,17,28.542120332284867,0.6907552083333333,39.07828282828283,1043.686868686869,32.61521464646466,0
1958,4,0,0,34,0.0,0.0,1.0,34,700,600,100,0.8571428571428571,8,6,2,401.32539372781173,0.3740344622697564,0.15245103967333717,0.2687092858894961,136259.1369024845,4136.850353280284,140395.98725576478,1955,36,718.1176470588235,32,2,17,28.508334341113393,0.6917317708333333,38.98358585858586,1044.065656565657,32.62705176767678,0
1959,4,0,0,34,0.0,0.0,1.0,34,850,700,150,0.8235294117647058,10,7,3,410.47725036692935,0.37429441473559116,0.16454051500118116,0.26207393677273194,134550.78125000003,4246.788114733191,138797.5693647332,1956,37,719.1176470588235,31,3,16,29.978246318607766,0.6774193548387097,40.625,1037.5000000000002,33.46774193548388,4
1960,4,0,0,34,0.0,0.0,1.0,34,1100,1000,100,0.9090909090909091,12,10,2,417.03858575745204,0.37429441473559116,0.15556108430867766,0.2525451925778425,132592.9931416439,4259.278868227756,136852.27200987167,1957,38,720.1176470588235,32,2,18,31.780985656491367,0.6552734375,42.518939393939405,1029.9242424242439,32.18513257575762,3
1961,4,1,0,35,0.02857142857142857,0.0,1.0,35,550,300,250,0.5454545454545454,8,3,5,405.39300215802194,0.3777310924369748,0.14908805305873107,0.25156495243846927,133504.8420601214,3827.291220283644,137332.13328040502,1958,0,700.5142857142857,32,3,18,31.161168804724095,0.6643880208333334,41.63510101010101,1033.4595959595958,32.29561237373737,1
1962,4,1,0,36,0.027777777777777776,0.0,1.0,36,700,600,100,0.8571428571428571,8,6,2,393.8835071405469,0.3801256613756614,0.1466796952110232,0.24652027062917967,133820.69283749023,3341.952764561688,137162.64560205193,1959,0,682.0277777777778,33,3,15,31.141058667930043,0.6650883838383839,41.32965686274509,1034.6813725490183,31.353980986333887,0
1963,4,0,0,36,0.0,0.0,1.0,36,1200,800,400,0.6666666666666666,16,8,8,392.7713017082928,0.3798776455026455,0.14523132796463023,0.24603567296920045,133852.39451172607,3314.6758458285085,137167.0703575546,1960,1,683.0277777777778,33,3,15,31.137987525659245,0.6654040404040404,41.29901960784313,1034.803921568626,31.35769459298867,0
1964,4,0,0,36,0.0,0.0,1.0,36,1050,700,350,0.6666666666666666,14,7,7,391.97397852786895,0.3796296296296296,0.14378330373001802,0.24574760569174822,133884.09994052752,3295.816663062263,137179.91660358978,1961,2,684.0277777777778,33,3,15,31.126776198934273,0.665719696969697,41.26838235294117,1034.926470588234,31.361408199643453,0
1965,4,0,0,36,0.0,0.0,1.0,36,950,500,450,0.5263157894736842,14,5,9,391.49131401514524,0.3794146825396825,0.14144105033283338,0.2456564367141097,133915.80912389458,3285.3752162629694,137201.18434015755,1962,3,685.0277777777778,33,3,15,31.107427579130164,0.6660353535353536,41.23774509803921,1035.0490196078426,31.365121806298262,0
1966,4,0,0,36,0.0,0.0,1.0,36,900,600,300,0.6666666666666666,12,6,6,396.6688419672472,0.3789847883597883,0.10412016726955553,0.24230927426800378,132919.2247732426,3344.9829931972727,136264.20776643988,1963,4,686.0277777777778,34,2,16,31.976352651427682,0.6537990196078431,42.20238095238095,1031.190476190476,30.329131652661058,3
1967,4,0,1,35,0.0,0.027777777777777776,0.9722222222222222,36,750,600,150,0.8,9,6,3,396.1031265533227,0.37888558201058203,0.10267902944495755,0.24236140455211774,132980.6122448979,3334.807256235819,136315.41950113373,1964,5,687.0277777777778,34,2,16,31.929055093875036,0.6544117647058822,42.14285714285714,1031.4285714285709,30.336134453781497,0
1968,4,0,1,34,0.0,0.02857142857142857,0.9714285714285714,35,800,600,200,0.75,10,6,4,407.69261323151625,0.37496498599439776,0.1072905701382052,0.24893509780333625,132902.9775206649,3836.7124423298465,136739.68996299474,1965,6,707.4857142857143,33,2,16,31.70856112827827,0.6559343434343435,42.21813725490195,1031.1274509803902,31.24628639334516,0
1969,4,0,0,34,0.0,0.0,1.0,34,1000,700,300,0.7,13,7,6,416.7521597006627,0.373236036838978,0.1197255142105833,0.2541285574276257,132853.20255904994,4273.371817926722,137126.57437697667,1966,7,724.5,32,2,16,31.525311288017953,0.6578776041666667,42.26641414141413,1030.9343434343423,32.216698232323196,0
1970,4,0,0,34,0.0,0.0,1.0,34,1050,800,250,0.7619047619047619,13,8,5,417.38425651958323,0.37407159833630427,0.11782705738354093,0.255624390986881,133015.9629757166,4303.753762371163,137319.71673808777,1967,8,725.5,32,2,16,31.344604243166057,0.6595052083333335,42.10858585858585,1031.5656565656552,32.236426767676726,0
1971,4,0,0,34,0.0,0.0,1.0,34,950,500,450,0.5263157894736842,14,5,9,416.1187436882904,0.37407159833630427,0.09988901220865665,0.2530820555874685,132755.59413580256,4248.41820987655,137004.0123456791,1968,9,726.5,32,2,17,31.64027403414196,0.6569010416666666,42.361111111111114,1030.555555555556,32.20486111111113,3
1972,4,0,0,34,0.0,0.0,1.0,34,600,400,200,0.6666666666666666,8,4,4,417.967374362079,0.37355169340463457,0.10003746721618612,0.25464818240985193,132820.662432405,4302.940707580877,137123.60313998588,1969,10,727.5,32,2,17,31.52687612281563,0.6575520833333333,42.29797979797981,1030.8080808080817,32.212752525252554,0
1973,4,0,0,34,0.0,0.0,1.0,34,550,500,50,0.9090909090909091,6,5,1,419.03904054803536,0.37327317290552586,0.0976153596772451,0.2555230594529283,132853.20255905014,4334.135706815639,137187.33826586578,1970,11,728.5,32,2,17,31.4663706878955,0.6578776041666666,42.266414141414145,1030.9343434343439,32.216698232323246,0
1974,4,0,0,34,0.0,0.0,1.0,34,700,500,200,0.7142857142857143,9,5,4,421.8632037688462,0.3736631016042781,0.09391743964970911,0.2579175635017918,132950.84685236207,4417.414039383746,137368.26089174583,1971,12,729.5,32,2,17,31.29489063010121,0.6588541666666666,42.17171717171718,1031.3131313131319,32.22853535353537,0
1975,4,0,0,34,0.0,0.0,1.0,34,700,500,200,0.7142857142857143,9,5,4,422.2787191998667,0.3737373737373737,0.09525523795809598,0.2586219742026172,133015.96297571683,4433.962095704526,137449.92507142137,1972,13,730.5,32,2,17,31.21838025295797,0.6595052083333333,42.10858585858586,1031.565656565657,32.23642676767678,0
1976,4,1,0,35,0.02857142857142857,0.0,1.0,35,900,600,300,0.6666666666666666,12,6,6,413.0264814394756,0.3744747899159664,0.09257576784866761,0.25520433911817475,133345.61827181865,4015.0543060361547,137360.6725778548,1973,0,710.6,33,2,18,31.124426514791963,0.6603535353535352,41.78921568627452,1032.843137254903,31.298276886512213,0
1977,4,0,0,35,0.0,0.0,1.0,35,800,600,200,0.75,10,6,4,413.9568158168574,0.3744747899159664,0.09470046082949346,0.25665322580645183,133472.22222222236,4050.347222222246,137522.5694444446,1974,1,711.6,33,2,18,30.97278225806452,0.6616161616161615,41.66666666666668,1033.3333333333346,31.31313131313135,0
1978,4,0,0,35,0.0,0.0,1.0,35,600,500,100,0.8333333333333334,7,5,2,439.8285216605073,0.3737745098039216,0.08536838464199237,0.271118178277298,133257.03125000012,4722.048611111126,137979.07986111124,1975,2,712.6,34,1,17,30.521926284638145,0.6571691176470588,41.87500000000001,1032.500000000001,30.367647058823557,3
1979,4,0,0,35,0.0,0.0,1.0,35,850,400,450,0.47058823529411764,13,4,9,439.560191493872,0.3733893557422969,0.08627399334935637,0.27207584463508,133410.72137188204,4728.408446712016,138139.12981859405,1976,3,713.6,34,1,18,30.373501958976714,0.6587009803921569,41.726190476190474,1033.0952380952378,30.385154061624643,0
1980,4,0,0,35,0.0,0.0,1.0,35,800,500,300,0.625,11,5,6,436.6028564402379,0.37366946778711485,0.08186403700148381,0.2709320985567361,133504.8420601215,4657.747423081582,138162.58948320308,1977,4,714.6,32,3,18,30.35481571981267,0.6643880208333333,41.63510101010102,1033.4595959595968,32.2956123737374,0
1981,4,0,0,35,0.0,0.0,1.0,35,650,500,150,0.7692307692307693,8,5,3,442.8555555726215,0.37419467787114846,0.08581546674109886,0.2757828246832089,133635.36126734523,4836.232431639636,138471.59369898486,1978,5,715.6,32,3,18,30.061413685024633,0.6656901041666666,41.50883838383839,1033.9646464646469,32.311395202020215,0
1982,4,0,0,35,0.0,0.0,1.0,35,1000,600,400,0.6,14,6,8,444.06673262396384,0.3738095238095238,0.09206465449599821,0.2775163036146556,133765.9442435721,4880.201159320477,138646.14540289258,1979,6,716.6,32,3,15,29.89823629927988,0.6669921875,41.38257575757576,1034.469696969697,32.32717803030303,0
1983,4,0,0,35,0.0,0.0,1.0,35,1050,600,450,0.5714285714285714,15,6,9,443.49265090706075,0.37349439775910365,0.09669739800275368,0.2781414888665017,133896.5909888022,4876.430817008476,138773.02180581068,1980,7,717.6,32,3,15,29.781220771827098,0.6682942708333333,41.256313131313135,1034.9747474747478,32.34296085858587,0
1984,4,0,0,35,0.0,0.0,1.0,35,900,500,400,0.5555555555555556,13,5,8,441.4179060083281,0.3731792717086835,0.09643205574912872,0.27757874457578935,133994.61789613313,4829.524729619436,138824.14262575257,1981,8,718.6,32,3,15,29.736026422764212,0.6692708333333333,41.161616161616166,1035.353535353536,32.354797979798,0
1985,4,0,0,35,0.0,0.0,1.0,35,800,700,100,0.875,9,7,2,440.81469658181663,0.37307422969187676,0.09327782326197132,0.2774459959069438,134027.3015030354,4816.240849148045,138843.54235218346,1982,9,719.6,32,3,15,29.718682680973863,0.6695963541666666,41.130050505050505,1035.4797979797981,32.35874368686869,0
1986,4,0,0,35,0.0,0.0,1.0,35,1150,900,250,0.782608695652174,14,9,5,442.8329361750478,0.37230392156862746,0.08181770697310031,0.2797108730805444,134158.07578627198,4881.922922405901,139039.9987086779,1983,10,720.6,32,3,16,29.534582571602687,0.6708984375,41.00378787878789,1035.9848484848499,32.37452651515156,0
1987,4,0,0,35,0.0,0.0,1.0,35,1000,700,300,0.7,13,7,6,433.52965753870205,0.37230392156862746,0.09248262792166817,0.2637499799707014,132766.7766147189,4512.814881716216,137279.5914964351,1984,11,721.6,31,4,15,31.180380080016842,0.6596102150537635,42.350260416666664,1030.5989583333328,33.245127688172026,2
1988,4,0,0,35,0.0,0.0,1.0,35,1000,800,200,0.8,12,8,4,433.52965753870205,0.37230392156862746,0.09248262792166817,0.2637499799707014,132766.7766147189,4511.667039659284,137278.44365437818,1985,12,722.6,31,4,15,31.180380080016842,0.6596102150537635,42.350260416666664,1030.5989583333328,33.245127688172026,0
1989,4,0,0,35,0.0,0.0,1.0,35,1100,800,300,0.7272727272727273,14,8,6,432.9187253460116,0.3732843137254902,0.09332804099159242,0.2640870930115346,132867.44011772997,4504.1605631510365,137371.600680881,1986,13,723.6,31,4,15,31.094236760124605,0.6606182795698925,42.252604166666664,1030.989583333333,33.25772849462365,0
1990,4,0,0,35,0.0,0.0,1.0,35,700,400,300,0.5714285714285714,10,4,6,431.9321908155154,0.37314425770308124,0.09237818627893168,0.2637217439528191,132901.00309583865,4480.844285753027,137381.84738159168,1987,14,724.6,31,4,15,31.08570631813782,0.6609543010752689,42.22005208333333,1031.1197916666658,33.261928763440835,0
1991,4,1,0,36,0.027777777777777776,0.0,1.0,36,900,600,300,0.6666666666666666,12,6,6,419.01159303629646,0.3747023809523809,0.0847804818393052,0.25819576460119026,133243.9949526833,3966.15571752881,137210.1506702121,1988,0,705.4444444444445,32,4,16,31.07241857241856,0.6617838541666667,41.887626262626256,1032.4494949494942,32.264046717171695,0
1992,4,0,1,35,0.0,0.027777777777777776,0.9722222222222222,36,750,400,350,0.5333333333333333,11,4,7,416.26880682066314,0.3735284391534392,0.08117756417863231,0.25698880843060257,133313.97667063138,3898.8900002402775,137212.86667087165,1989,1,706.4444444444445,33,3,17,31.07261876508049,0.6600378787878789,41.819852941176464,1032.7205882352932,31.29456327985737,0
1993,4,0,0,35,0.0,0.0,1.0,35,800,500,300,0.625,11,5,6,424.90747823805816,0.3711134453781513,0.08025580095051721,0.26159966431282855,133211.40699928577,4320.504604122021,137531.9116034078,1990,2,727.1714285714286,32,3,17,30.953145384866264,0.6614583333333334,41.91919191919192,1032.323232323232,32.260101010101,0
1994,4,0,0,35,0.0,0.0,1.0,35,850,500,350,0.5882352941176471,12,5,7,424.96842276820263,0.37125350140056024,0.08168054900728139,0.2627865961199295,133374.3866219009,4335.980544077142,137710.36716597804,1991,3,728.1714285714286,32,3,17,30.78703703703703,0.6630859375,41.76136363636364,1032.954545454546,32.27982954545456,0
1995,4,0,0,35,0.0,0.0,1.0,35,1200,1000,200,0.8333333333333334,14,10,4,427.06831086148634,0.37135854341736696,0.08621357867355672,0.2645495827236596,133439.60636988573,4397.565458881751,137837.1718287675,1992,4,729.1714285714286,32,3,17,30.666982361807,0.6637369791666666,41.698232323232325,1033.207070707071,32.287720959595966,0
1996,4,0,0,35,0.0,0.0,1.0,35,600,100,500,0.16666666666666666,11,1,10,428.3993934356544,0.3699229691876751,0.09091039942425372,0.26657454419115145,133606.80474175338,4447.418807611299,138054.2235493647,1993,5,730.1714285714286,31,4,18,30.463895885810242,0.668010752688172,41.53645833333333,1033.8541666666658,33.35013440860212,0
1997,4,0,0,35,0.0,0.0,1.0,35,850,500,350,0.5882352941176471,12,5,7,430.761394943926,0.3696778711484594,0.0927267166783603,0.26828833233331106,133640.46096801758,4513.430277506511,138153.89124552408,1994,6,731.1714285714286,31,4,18,30.36889245686941,0.6683467741935484,41.50390625,1033.984375,33.35433467741935,0
1998,4,0,0,35,0.0,0.0,1.0,35,750,500,250,0.6666666666666666,10,5,5,429.7105533202821,0.368452380952381,0.08824957295693614,0.26861135689454296,133775.1282585991,4496.916876898867,138272.045135498,1995,7,732.1714285714286,31,4,17,30.260252779525906,0.6696908602150538,41.373697916666664,1034.505208333333,33.37113575268816,0
1999,4,0,0,35,0.0,0.0,1.0,35,850,500,350,0.5882352941176471,12,5,7,402.2209740340653,0.368452380952381,0.06939230429013721,0.22728721940693344,129940.55333958278,3465.784807519503,133406.33814710227,1996,8,733.1714285714286,32,3,17,34.85500515995872,0.6285807291666666,45.10732323232324,1019.5707070707077,31.861584595959616,8
2000,4,0,0,35,0.0,0.0,1.0,35,1100,900,200,0.8181818181818182,13,9,4,403.26518107280475,0.3686274509803922,0.07857673398648912,0.22844152403268697,130037.12153096621,3487.8886720742776,133525.0102030405,1997,9,734.1714285714286,32,3,17,34.72987331847818,0.6295572916666666,45.01262626262626,1019.9494949494948,31.873421717171713,0
2001,4,3,1,37,0.07894736842105263,0.02631578947368421,0.9736842105263158,38,800,400,400,0.5,12,4,8,373.1869834162696,0.38068990042674256,0.07663295045431173,0.2161667998279148,130901.38888888895,2170.334181461086,133071.72307035004,1998,0,677.1315789473684,34,4,18,34.61929967426711,0.633578431372549,44.16666666666667,1023.3333333333338,30.09803921568629,0
2002,4,0,0,37,0.0,0.0,1.0,37,1100,600,500,0.5454545454545454,16,6,10,382.4789307977344,0.37600100100100103,0.08293991652539301,0.22102497998284681,130810.03578514738,2606.416524943308,133416.45231009068,1999,1,696.4324324324324,34,3,18,34.47428139183055,0.6326593137254901,44.25595238095238,1022.9761904761904,30.0875350140056,0
2003,4,0,0,37,0.0,0.0,1.0,37,650,400,250,0.6153846153846154,9,4,5,380.3492779826989,0.3752815315315315,0.08151806569859388,0.22048973316367237,130931.84700963715,2559.966695011332,133491.8137046485,2000,2,697.4324324324324,34,3,18,34.405170408281954,0.6338848039215685,44.13690476190476,1023.4523809523806,30.10154061624649,0
2004,4,0,0,37,0.0,0.0,1.0,37,1000,700,300,0.7,13,7,6,379.72361241404633,0.37640765765765766,0.0811973466315985,0.22082507034301638,131053.71492346934,2552.8380102040733,133606.5529336734,2001,3,698.4324324324324,34,3,18,34.29761074293686,0.635110294117647,44.01785714285714,1023.928571428571,30.11554621848738,0
2005,4,0,0,37,0.0,0.0,1.0,37,1000,500,500,0.5,15,5,10,381.92124425315205,0.37672047047047047,0.08637341583303271,0.22280896995243216,131175.639526644,2619.752692743768,133795.39221938775,2002,4,699.4324324324324,34,3,19,34.11776099167151,0.6363357843137254,43.898809523809526,1024.404761904762,30.12955182072829,0
2006,4,1,1,37,0.02631578947368421,0.02631578947368421,0.9736842105263158,38,1350,1100,250,0.8148148148148148,16,11,5,372.91962621694495,0.3802305595068753,0.08084742542276224,0.21978454566402952,131565.50068587123,2212.6714677640757,133778.1721536353,2003,0,682.0,35,3,16,33.953820697954264,0.638095238095238,43.518518518518526,1025.9259259259272,29.31216931216935,0
2007,4,0,0,37,0.0,0.0,1.0,37,1100,700,400,0.6363636363636364,15,7,8,379.6203695251401,0.3763763763763764,0.08962996658875966,0.22323750740335044,131480.6990504536,2582.5503117913945,134063.249362245,2004,6,701.4324324324324,34,3,20,33.86776939446701,0.6393995098039215,43.60119047619048,1025.5952380952388,30.164565826330552,0
2008,4,1,1,37,0.02631578947368421,0.02631578947368421,0.9736842105263158,38,1300,900,400,0.6923076923076923,17,9,8,372.12396522994686,0.3794304172593646,0.08344508396131278,0.22034309556673087,131743.67310742452,2204.99560613854,133948.66871356306,2005,0,683.9473684210526,35,3,17,33.79415633220594,0.6398809523809523,43.344907407407405,1026.62037037037,29.33201058201057,0
2009,4,1,1,37,0.02631578947368421,0.02631578947368421,0.9736842105263158,38,850,600,250,0.7058823529411765,11,6,5,368.8015041865358,0.37971194879089615,0.08933369714153505,0.21888800980917272,131832.8045294282,2124.027322316535,133956.83185174473,2006,0,684.921052631579,35,3,17,33.78942202937751,0.6407738095238094,43.258101851851855,1026.9675925925928,29.341931216931226,0
2010,4,1,1,37,0.02631578947368421,0.02631578947368421,0.9736842105263158,38,700,400,300,0.5714285714285714,10,4,6,371.0393969450504,0.3802157420578473,0.09311489992587085,0.22056092752091927,131892.2422223295,2187.4436031807395,134079.68582551024,2007,0,685.8947368421053,35,3,17,33.67194835680751,0.6413690476190474,43.20023148148149,1027.199074074075,29.348544973545,0
2011,4,0,0,37,0.0,0.0,1.0,37,1500,1000,500,0.6666666666666666,20,10,10,380.6578880725966,0.37578203203203203,0.09666600907476819,0.22673969854759027,131969.53125000012,2647.048611111124,134616.57986111124,2008,10,705.4324324324324,34,3,18,33.346850500135176,0.6443014705882353,43.12500000000001,1027.500000000001,30.220588235294144,0
2012,4,1,0,38,0.02631578947368421,0.0,1.0,38,1700,1300,400,0.7647058823529411,21,13,8,375.27110046738244,0.37980085348506404,0.09292245013975053,0.22536550952392545,132278.91375171472,2328.0907064471917,134607.00445816191,2009,0,687.8421052631579,35,3,19,33.17300480048006,0.6452380952380952,42.824074074074076,1028.703703703704,29.391534391534396,0
2013,4,0,0,38,0.0,0.0,1.0,38,1250,1000,250,0.8,15,10,5,380.16907054222276,0.37959340919867235,0.09179444674678794,0.2286673232151799,132338.45191400888,2462.1972522290785,134800.64916623797,2010,1,688.8421052631579,35,3,19,32.986970378702665,0.6458333333333333,42.7662037037037,1028.935185185185,29.39814814814814,0
2014,4,0,0,38,0.0,0.0,1.0,38,600,300,300,0.5,9,3,6,390.92806544105247,0.37959340919867235,0.13615003417634974,0.23154970029970035,131755.55555555547,2706.2248156721453,134461.78037122762,2011,2,689.8421052631579,34,4,17,33.29951298701298,0.6421568627450981,43.33333333333333,1026.666666666666,30.19607843137253,2
2015,4,0,0,38,0.0,0.0,1.0,38,850,500,350,0.5882352941176471,12,5,7,386.2489303020674,0.37836356092935036,0.13704272847569032,0.2300700150060141,131969.53125000003,2594.6180555555557,134564.1493055556,2012,3,690.8421052631579,34,4,17,33.20323060286563,0.6443014705882353,43.125,1027.5000000000002,30.220588235294123,0
2016,4,1,0,39,0.02564102564102564,0.0,1.0,39,1000,700,300,0.7,13,7,6,378.88037228565315,0.381831983805668,0.1407371506381403,0.2275330235726275,132278.91375171478,2223.5768175583044,134502.49056927307,2013,0,674.1025641025641,35,4,18,33.080183018301824,0.6452380952380952,42.824074074074076,1028.7037037037044,29.39153439153441,0
2017,4,0,0,39,0.0,0.0,1.0,39,1000,800,200,0.8,12,8,4,379.78003245422855,0.38222559604138556,0.14138897539707296,0.22879431223462038,132398.0034722221,2256.423611111102,134654.4270833332,2014,1,675.1025641025641,35,4,18,32.93690958164643,0.6464285714285715,42.70833333333333,1029.1666666666656,29.404761904761873,0
2018,4,0,0,39,0.0,0.0,1.0,39,1050,800,250,0.7619047619047619,13,8,5,380.2007854148336,0.38186009896536216,0.14162516140933445,0.2297735181420081,132517.14677640595,2276.6246570644635,134793.77143347042,2015,2,676.1025641025641,35,4,18,32.805942745803364,0.6476190476190476,42.59259259259259,1029.629629629629,29.417989417989403,0
2019,4,1,1,39,0.025,0.025,0.975,40,1150,1000,150,0.8695652173913043,13,10,3,368.4427364082835,0.3860977564102564,0.107857308048104,0.22250647936165052,132489.9092970522,1769.8476561406492,134259.75695319285,2016,0,660.175,34,6,19,33.1360333795868,0.6495098039215685,42.61904761904762,1029.5238095238096,30.28011204481793,1
2020,4,0,1,38,0.0,0.02564102564102564,0.9743589743589743,39,850,600,250,0.7058823529411765,11,6,5,376.55300637036413,0.3821974808816914,0.1119156675198707,0.22632817540787178,132311.09487866264,2164.4281105429964,134475.52298920564,2017,1,678.025641025641,36,3,19,33.10757807939287,0.6435185185185185,42.7927927927928,1028.8288288288304,28.57857857857862,0
2021,4,0,0,38,0.0,0.0,1.0,38,1000,600,400,0.6,14,6,8,365.9386179152893,0.37940078236130864,0.044470053357748895,0.20934100070857456,130419.01139285341,1963.9249253680832,132382.9363182215,2018,2,696.6578947368421,33,5,22,35.29381623675264,0.6309974747474749,44.63848039215684,1021.4460784313702,30.95291146761728,8
2022,4,0,1,37,0.0,0.02631578947368421,0.9736842105263158,38,700,500,200,0.7142857142857143,9,5,4,365.89327883407475,0.3789858937885254,0.04788362460854634,0.20948395414566223,130450.30757400977,1946.178152633576,132396.48572664335,2019,3,697.6578947368421,33,5,22,35.263215770953295,0.6313131313131315,44.60784313725489,1021.5686274509786,30.95662507427208,0
2023,4,0,0,37,0.0,0.0,1.0,37,1050,700,350,0.6666666666666666,14,7,7,375.416786445726,0.37681431431431434,0.053733377426369744,0.21496795606032343,130455.99819214885,2395.0743227732,132851.07251492204,2020,4,712.7027027027027,32,5,22,35.014213323445816,0.6337890625,44.602272727272734,1021.5909090909099,31.924715909090935,0
2024,4,1,1,37,0.02631578947368421,0.02631578947368421,0.9736842105263158,38,900,600,300,0.6666666666666666,12,6,6,366.6933877951334,0.37969713134186817,0.04769007599886432,0.2114759033276012,130732.14215986647,1987.7224204632896,132719.86458032977,2021,0,694.921052631579,33,5,16,34.95693529059316,0.6341540404040404,44.33210784313726,1022.6715686274516,30.9900475341652,0
2025,4,0,0,37,0.0,0.0,1.0,37,900,700,200,0.7777777777777778,11,7,4,378.2401077050634,0.37650150150150147,0.057471647987825225,0.21785123699826506,130681.82615294371,2485.8215998367723,133167.6477527805,2022,6,714.7027027027027,32,5,19,34.71278916604925,0.6360677083333333,44.38131313131314,1022.4747474747486,31.952335858585894,0
2026,4,0,1,36,0.0,0.02702702702702703,0.972972972972973,37,800,700,100,0.875,9,7,2,377.67751467481287,0.3763763763763764,0.059825068218057886,0.21825557945045204,130810.95838434873,2480.871530966256,133291.829915315,2023,7,715.7027027027027,32,5,19,34.59613881346169,0.6373697916666665,44.25505050505052,1022.9797979797996,31.96811868686874,0
2027,4,1,0,37,0.02702702702702703,0.0,1.0,37,950,700,250,0.7368421052631579,12,7,5,378.015926579728,0.3743430930930931,0.06214082854438052,0.2195525166696588,131004.77629833705,2504.378379757185,133509.15467809423,2024,0,716.4864864864865,32,5,20,34.3909307679658,0.6393229166666665,44.065656565656575,1023.7373737373749,31.991792929292966,0
2028,4,0,0,37,0.0,0.0,1.0,37,950,600,350,0.631578947368421,13,6,7,378.7071872528862,0.3739364364364364,0.06659624733844938,0.22050926028773604,131101.7390604277,2529.8341687072943,133631.57322913499,2025,1,717.4864864864865,32,5,21,34.27495582131263,0.6402994791666665,43.970959595959606,1024.116161616163,32.003630050505095,0
2029,4,1,2,36,0.02631578947368421,0.05263157894736842,0.9473684210526316,38,700,300,400,0.42857142857142855,11,3,8,375.17932946837254,0.3808380749170223,0.04078288937752239,0.21680672347826024,130810.0357851476,2215.4443027211155,133025.48008786872,2026,0,699.578947368421,34,4,15,34.660964350828195,0.6326593137254901,44.255952380952394,1022.9761904761922,30.087535014005653,4
2030,4,0,0,36,0.0,0.0,1.0,36,850,600,250,0.7058823529411765,11,6,5,392.42816834797134,0.36944444444444446,0.04363510303829132,0.22508300258257508,130520.50053884827,3043.98419166414,133564.4847305124,2027,29,739.3888888888889,32,4,15,34.51413773219655,0.6344401041666665,44.539141414141426,1021.8434343434359,31.93260732323237,0
2031,4,1,0,37,0.02702702702702703,0.0,1.0,37,1000,400,600,0.4,16,4,12,389.4354874991128,0.3738113113113113,0.0612759293472811,0.2260566106379495,130982.91710219649,2801.8792351499706,133784.79633734646,2028,0,720.3783783783783,33,4,17,34.12084979448501,0.6366792929292928,44.08700980392158,1023.6519607843154,31.019756387403497,0
2032,4,1,0,38,0.02631578947368421,0.0,1.0,38,1250,1100,150,0.88,14,11,3,383.6286264832563,0.3782005689900427,0.062483569825947605,0.2245179364646063,131297.6208191612,2473.90518707486,133771.52600623606,2029,0,702.3947368421053,34,4,18,33.950420102993,0.6375612745098038,43.77976190476192,1024.880952380954,30.143557422969238,0
2033,4,0,0,38,0.0,0.0,1.0,38,1150,700,450,0.6086956521739131,16,7,9,384.66262216252824,0.37774122807017546,0.0590296563785746,0.22567233499380893,131390.93888168037,2508.2401588086473,133899.17904048902,2030,1,703.3947368421053,33,5,19,33.82938879591999,0.6407828282828281,43.68872549019609,1025.2450980392175,31.06803327391568,0
2034,4,0,1,37,0.0,0.02631578947368421,0.9736842105263158,38,1150,1000,150,0.8695652173913043,13,10,3,376.09888294004884,0.37774122807017546,0.05348737697903294,0.22028648857917155,131328.12500000012,2278.4722222222367,133606.59722222236,2031,2,704.3947368421053,34,4,16,34.11246612466124,0.6378676470588235,43.75000000000001,1025.000000000001,30.147058823529438,1
2035,4,1,0,38,0.02631578947368421,0.0,1.0,38,1050,800,250,0.7619047619047619,13,8,5,373.03745672305286,0.3787339971550498,0.058329978866860976,0.21921189872601896,131453.76778162265,2207.4358419838763,133661.20362360653,2032,0,705.3157894736842,33,5,18,34.063794614404074,0.6414141414141413,43.62745098039217,1025.490196078433,31.075460487225243,0
2036,4,0,0,38,0.0,0.0,1.0,38,800,500,300,0.625,11,5,6,375.5741404486922,0.3787488146040778,0.054335659938376635,0.2210657915299268,131516.61169982728,2278.847678777429,133795.45937860472,2033,1,706.3157894736842,33,5,19,33.93518518518519,0.6420454545454544,43.56617647058825,1025.7352941176493,31.08288770053483,0
2037,4,0,0,38,0.0,0.0,1.0,38,950,500,450,0.5263157894736842,14,5,9,372.7040369888772,0.37864509246088196,0.054973065052455805,0.21991902055728493,131610.90573637566,2210.3831759419772,133821.28891231763,2034,2,707.3157894736842,33,5,14,33.91344699231659,0.6429924242424241,43.47426470588237,1026.1029411764725,31.09402852049917,0
2038,4,0,1,37,0.0,0.02631578947368421,0.9736842105263158,38,1050,1000,50,0.9523809523809523,11,10,1,372.451214605019,0.37765232337600757,0.05268811800329187,0.22067866166625538,131768.1375552673,2215.4405757401128,133983.57813100744,2035,3,708.3157894736842,33,5,15,33.76104082119838,0.644570707070707,43.321078431372555,1026.7156862745105,31.112596553773045,0
2039,4,0,0,37,0.0,0.0,1.0,37,1150,900,250,0.782608695652174,14,9,5,381.90922864749126,0.3714339339339339,0.0568275917113128,0.22540132906449994,131619.47959710757,2653.338785583124,134272.8183826907,2036,8,728.3783783783783,32,5,15,33.66863541282147,0.6455078125,43.4659090909091,1026.1363636363646,32.066761363636395,0
2040,4,1,1,37,0.02631578947368421,0.02631578947368421,0.9736842105263158,38,800,700,100,0.875,9,7,2,374.9106595121322,0.37763750592697964,0.05104629042485698,0.22305720785594085,131925.46323829785,2292.0524858227673,134217.5157241206,2037,0,710.1842105263158,33,5,15,33.53898266332657,0.6461489898989898,43.16789215686275,1027.3284313725496,31.131164587046957,0
2041,4,0,0,37,0.0,0.0,1.0,37,1200,900,300,0.75,15,9,6,381.3275450705005,0.37171546546546547,0.06160713989152011,0.22698333827642023,131943.58555568318,2662.7447135496536,134606.33026923283,2038,10,730.3783783783783,32,5,15,33.35586415960017,0.6487630208333333,43.15025252525253,1027.3989898989907,32.10621843434346,0
2042,4,0,0,37,0.0,0.0,1.0,37,900,700,200,0.7777777777777778,11,7,4,380.3908264424427,0.3716841841841842,0.06274202440336651,0.22661936644133218,131976.0180721355,2640.493317008475,134616.511389144,2039,11,731.3783783783783,32,5,15,33.347157368722876,0.6490885416666666,43.11868686868687,1027.5252525252527,32.110164141414145,0
2043,4,1,1,37,0.02631578947368421,0.02631578947368421,0.9736842105263158,38,950,800,150,0.8421052631578947,11,8,3,371.22230505025635,0.3739035087719298,0.061767177056292866,0.22289270590785756,132271.91014273342,2220.456675317166,134492.3668180506,2040,0,713.1052631578947,33,5,15,33.284191088872994,0.6496212121212122,42.83088235294117,1028.6764705882342,31.172014260249522,0
2044,4,0,0,37,0.0,0.0,1.0,37,650,400,250,0.6153846153846154,9,4,5,379.490391036008,0.3713713713713714,0.07042160038230749,0.2272477753380329,132170.69686766653,2631.50188756249,134802.198755229,2041,13,733.3783783783783,32,5,16,33.17370661427635,0.6510416666666667,42.92929292929293,1028.2828282828282,32.13383838383838,0
2045,4,0,0,37,0.0,0.0,1.0,37,1100,700,400,0.6363636363636364,15,7,8,382.0200586049192,0.37162162162162166,0.07228659861530873,0.2293527942118113,132268.09007052862,2705.8127040608224,134973.90277458943,2042,14,734.3783783783783,32,5,16,33.010361687328675,0.6520182291666666,42.834595959595966,1028.6616161616168,32.14567550505053,0
2046,4,0,0,37,0.0,0.0,1.0,37,900,600,300,0.6666666666666666,12,6,6,380.65486583622715,0.3716529029029029,0.0718863193089998,0.22872978221486573,132300.56244260792,2672.1705693296635,134972.73301193758,2043,15,735.3783783783783,32,5,16,33.012702503681886,0.65234375,42.803030303030305,1028.787878787879,32.14962121212122,0
2047,4,0,0,37,0.0,0.0,1.0,37,600,300,300,0.5,9,3,6,388.5840198429216,0.3716529029029029,0.07039972177586828,0.2331226360644491,132240.39619677534,2877.300947952721,135117.69714472807,2044,16,736.3783783783783,33,4,17,32.86952917113467,0.6493055555555556,42.86151960784314,1028.553921568628,31.16830065359479,3
2048,4,0,0,37,0.0,0.0,1.0,37,900,700,200,0.7777777777777778,11,7,4,387.6477241062793,0.37071446446446443,0.06346427399058974,0.23353411671768542,132398.00347222228,2864.756944444449,135262.76041666672,2045,17,737.3783783783783,33,4,18,32.73448043184885,0.6508838383838383,42.708333333333336,1029.166666666667,31.186868686868696,0
2049,4,1,1,37,0.02631578947368421,0.02631578947368421,0.9736842105263158,38,1200,700,500,0.5833333333333334,17,7,10,372.9753407714704,0.37461474632527264,0.013010953780389967,0.21998844949694535,131595.18771701402,2216.3519965277983,133811.53971354183,2046,0,718.9473684210526,35,3,15,33.922377326565154,0.638392857142857,43.48958333333334,1026.0416666666679,29.315476190476225,5
2050,4,0,1,36,0.0,0.02702702702702703,0.972972972972973,37,450,200,250,0.4444444444444444,7,2,5,378.9679731940928,0.37071446446446443,0.009973860555059222,0.222829144689639,131476.45968632132,2565.073490012022,134041.53317633335,2047,19,739.3783783783783,35,2,18,33.88878700673363,0.6372023809523808,43.60532407407408,1025.578703703705,29.302248677248716,0
2051,4,0,0,36,0.0,0.0,1.0,36,600,400,200,0.6666666666666666,8,4,4,384.47470331097,0.36823743386243385,0.02487485162821912,0.22555150850913322,131389.1439909298,2903.160430839017,134292.30442176881,2048,20,759.5555555555555,34,2,18,33.83602337823194,0.6384803921568627,43.6904761904762,1025.2380952380959,30.154061624649877,0
2052,4,0,0,36,0.0,0.0,1.0,36,750,400,350,0.5333333333333333,11,4,7,384.47470331097,0.36823743386243385,0.02487485162821912,0.22555150850913322,131389.1439909298,2903.160430839017,134292.30442176881,2049,21,760.5555555555555,34,2,18,33.83602337823194,0.6384803921568627,43.6904761904762,1025.2380952380959,30.154061624649877,0
2053,4,0,0,36,0.0,0.0,1.0,36,1000,800,200,0.8,12,8,4,387.227861875817,0.3682043650793651,0.026875169239101382,0.2280753578799669,131541.75347222228,2987.3263888888996,134529.07986111118,2050,22,761.5555555555555,34,2,19,33.61088545897643,0.6400122549019608,43.54166666666667,1025.833333333334,30.171568627451,0
2054,4,0,0,36,0.0,0.0,1.0,36,650,400,250,0.6153846153846154,9,4,5,386.5444528160121,0.367906746031746,0.030968403140348988,0.22803741538817318,131602.8220663266,2974.068168934249,134576.89023526086,2051,23,762.5555555555555,34,2,17,33.56658738446069,0.640625,43.48214285714286,1026.0714285714291,30.178571428571445,0
2055,4,1,0,37,0.02702702702702703,0.0,1.0,37,1000,600,400,0.6,14,6,8,378.5590503255406,0.37321696696696693,0.030181601159519067,0.22520711331699075,131921.9660922498,2588.050840192062,134510.01693244185,2052,0,742.918918918919,35,2,18,33.44881327925492,0.6416666666666666,43.171296296296305,1027.314814814816,29.351851851851883,0
2056,4,0,0,37,0.0,0.0,1.0,37,800,400,400,0.5,12,4,8,377.5155849983619,0.37378003003003,0.027407432204189508,0.2254684539590084,132070.63567654768,2571.744657707499,134642.38033425517,2053,1,743.918918918919,35,2,19,33.325474796381776,0.6431547619047618,43.02662037037038,1027.89351851852,29.368386243386286,0
2057,4,0,1,36,0.0,0.02702702702702703,0.972972972972973,37,850,600,250,0.7058823529411765,11,6,5,373.88798868643835,0.37281031031031026,0.03095756720250198,0.2238289010438222,132159.87761488356,2482.598165294944,134642.4757801785,2054,2,744.918918918919,35,2,19,33.328643253789586,0.644047619047619,42.939814814814824,1028.240740740742,29.378306878306915,0
2058,4,0,0,36,0.0,0.0,1.0,36,1400,1100,300,0.7857142857142857,17,11,6,379.66832493341707,0.37172619047619043,0.03777996475113543,0.227248463094243,132153.07716836745,2834.867488662142,134987.94465702958,2055,3,763.9722222222222,34,2,20,33.18691868318474,0.6461397058823529,42.94642857142858,1028.2142857142865,30.241596638655484,0
2059,4,0,0,36,0.0,0.0,1.0,36,300,200,100,0.6666666666666666,4,2,2,378.4847999285504,0.371875,0.037682333873581886,0.22672341898632586,132183.68055555565,2805.9027777777883,134989.58333333343,2056,4,764.9722222222222,34,2,20,33.18645326850351,0.6464460784313726,42.91666666666667,1028.3333333333342,30.245098039215712,0
2060,4,0,0,36,0.0,0.0,1.0,36,850,500,350,0.5882352941176471,12,5,7,378.0596279149519,0.37157738095238096,0.043563528806584095,0.2268357767489711,132244.89795918367,2799.2913832199492,135044.1893424036,2057,5,765.9722222222222,34,2,20,33.13560956790122,0.6470588235294117,42.857142857142854,1028.5714285714284,30.25210084033613,0
2061,4,0,0,36,0.0,0.0,1.0,36,900,500,400,0.5555555555555556,13,5,8,376.3663272448706,0.37179232804232804,0.047768264620052125,0.22636980976878326,132336.75063775506,2761.4193594104227,135098.16999716547,2058,6,766.9722222222222,34,2,20,33.08650545721008,0.6479779411764706,42.76785714285714,1028.9285714285709,30.26260504201679,0
2062,4,2,1,37,0.05263157894736842,0.02631578947368421,0.9736842105263158,38,500,200,300,0.4,8,2,6,360.8280071330634,0.38135668563300146,0.050113546078437876,0.22013386686080208,132871.38848339565,1988.78617930014,134860.1746626958,2059,0,727.5526315789474,33,5,17,32.9483884068307,0.6556186868686869,42.248774509803916,1031.0049019607832,31.2425727866904,0
2063,4,0,0,37,0.0,0.0,1.0,37,1050,700,350,0.6666666666666666,14,7,7,368.3858733952818,0.3761261261261261,0.0545639979602246,0.22405108037647478,132755.59413580256,2381.05709876544,135136.651234568,2060,1,748.2162162162163,32,5,18,32.87005840071878,0.6569010416666666,42.361111111111114,1030.555555555556,32.20486111111113,0
2064,4,0,0,37,0.0,0.0,1.0,37,650,400,250,0.6153846153846154,9,4,5,366.33656057677007,0.37575075075075076,0.05525245971105863,0.223191916458862,132820.66243240488,2331.412929803084,135152.07536220795,2061,2,749.2162162162163,32,5,19,32.857412624530475,0.6575520833333334,42.2979797979798,1030.8080808080808,32.212752525252526,0
2065,4,0,0,37,0.0,0.0,1.0,37,1050,700,350,0.6666666666666666,14,7,7,370.8634357697358,0.3756569069069069,0.05606610651302746,0.2265401406081849,132918.29476902867,2458.9070949392967,135377.20186396796,2062,3,750.2162162162163,32,5,19,32.64254520223663,0.6585286458333334,42.20328282828283,1031.1868686868688,32.22458964646465,0
2066,4,0,0,37,0.0,0.0,1.0,37,950,600,350,0.631578947368421,13,6,7,371.9194604194359,0.3756569069069069,0.09508447718029256,0.2125714224475907,130384.14292800435,2325.936558431125,132710.07948643548,2063,4,751.2162162162163,34,3,19,35.17649687220732,0.6283700980392158,44.67261904761904,1021.3095238095224,30.03851540616242,7
2067,4,2,1,38,0.05128205128205128,0.02564102564102564,0.9743589743589743,39,600,300,300,0.5,9,3,6,357.27190927250973,0.38149460188933876,0.09160766730679959,0.20697819548357088,130906.99932912023,1553.878717489967,132460.8780466102,2064,0,713.6410256410256,37,2,18,35.020781992214,0.627533783783784,44.1611842105263,1023.3552631578925,27.658250355618716,0
2068,4,0,1,37,0.0,0.02631578947368421,0.9736842105263158,38,1000,700,300,0.7,13,7,6,364.3781383054119,0.3796526789947843,0.08946904910890208,0.21056049671541716,130809.21292914521,1932.803496063619,132742.01642520883,2065,1,733.421052631579,36,2,20,34.93803207104067,0.6284722222222223,44.25675675675675,1022.9729729729718,28.415915915915882,0
2069,4,1,1,37,0.02631578947368421,0.02631578947368421,0.9736842105263158,38,850,600,250,0.7058823529411765,11,6,5,364.09816999301694,0.3792970602181129,0.0984540559319087,0.21134434005341773,130982.06948502547,1938.0663602791842,132920.13584530464,2066,0,734.0526315789474,36,2,20,34.7701228456179,0.6302083333333335,44.08783783783783,1023.6486486486478,28.43468468468466,0
2070,4,0,0,37,0.0,0.0,1.0,37,850,600,250,0.7058823529411765,11,6,5,373.8646431091157,0.3755630630630631,0.10003942651234299,0.21679246157468238,130942.84664619756,2390.9801258144516,133333.82677201202,2067,3,754.8918918918919,35,2,20,34.559939123223636,0.6318452380952382,44.1261574074074,1023.4953703703692,29.242724867724835,0
2071,4,0,0,37,0.0,0.0,1.0,37,900,700,200,0.7777777777777778,11,7,4,370.9562100849013,0.3750938438438438,0.0993822219234839,0.2156030640217498,131031.70680083998,2321.405071159098,133353.11187199908,2068,4,755.8918918918919,35,2,20,34.544332655060664,0.6327380952380953,44.03935185185184,1023.8425925925909,29.252645502645453,0
2072,4,0,0,37,0.0,0.0,1.0,37,900,500,400,0.5555555555555556,13,5,8,365.98049716006614,0.3747184684684685,0.09916527443931744,0.2132035167458472,131120.59709630028,2197.5162626457204,133318.113358946,2069,5,756.8918918918919,35,2,20,34.581708855991266,0.6336309523809525,43.95254629629628,1024.1898148148125,29.262566137566072,0
2073,4,0,0,37,0.0,0.0,1.0,37,800,400,400,0.5,12,4,8,367.5430696157822,0.3743743743743744,0.09814467731793264,0.2149422944767591,131268.8145683298,2249.3886102537645,133518.20317858356,2070,6,757.8918918918919,35,2,22,34.39170619682253,0.6351190476190476,43.80787037037037,1024.7685185185178,29.279100529100507,0
2074,4,1,0,38,0.02631578947368421,0.0,1.0,38,950,600,350,0.631578947368421,13,6,7,360.5007055076562,0.3781561166429588,0.09993770688033599,0.21250308345177696,131572.28599773237,1886.407177325656,133458.69317505803,2071,0,738.921052631579,34,4,18,34.265490833139935,0.6403186274509804,43.51190476190476,1025.9523809523805,30.17507002801119,0
2075,4,0,0,38,0.0,0.0,1.0,38,1350,700,650,0.5185185185185185,20,7,13,361.9110564854488,0.3772522522522523,0.09471904112027518,0.21429579913390712,131743.6731074244,1935.8983839163034,133679.5714913407,2072,1,739.921052631579,35,3,20,34.05627583615181,0.6398809523809523,43.3449074074074,1026.620370370369,29.332010582010543,0
2076,4,0,1,37,0.0,0.02631578947368421,0.9736842105263158,38,450,300,150,0.6666666666666666,6,3,3,358.387035207169,0.3770596254148886,0.08807810182326059,0.21263053832492987,131819.15181651237,1848.4550006087047,133667.60681712106,2073,2,740.921052631579,36,2,20,34.070576086559186,0.6385995370370372,43.27139639639639,1026.9144144144136,28.52540040040038,0
2077,4,0,0,37,0.0,0.0,1.0,37,1000,600,400,0.6,14,6,8,365.1527058329806,0.37690815815815815,0.09056521024066688,0.2168919084044088,131862.5217013888,2229.991319444439,134092.51302083323,2074,3,755.7837837837837,35,2,20,33.853110209601084,0.6410714285714285,43.229166666666664,1027.0833333333326,29.345238095238074,0
2078,4,0,0,37,0.0,0.0,1.0,37,1650,1500,150,0.9090909090909091,18,15,3,370.37983929875827,0.37662662662662666,0.09452154857560258,0.22103312990409768,132040.89506172843,2381.0570987654364,134421.95216049388,2075,4,756.7837837837837,35,2,22,33.538851351351354,0.6428571428571428,43.05555555555556,1027.777777777778,29.365079365079374,0
2079,4,3,2,38,0.075,0.05,0.95,40,850,500,350,0.5882352941176471,12,5,7,348.35878253011464,0.3873130341880342,0.11183520803756686,0.21280329363764267,132920.0542392056,1261.7381598941456,134181.79239909977,2076,0,700.95,36,4,19,33.22094208437989,0.6495949074074073,42.201576576576585,1031.1936936936952,28.644269269269312,0
2080,4,0,0,38,0.0,0.0,1.0,38,1300,1100,200,0.8461538461538461,15,11,4,363.1505482931929,0.38026019440493125,0.11691312384473229,0.22074656924339037,132735.1473922903,2040.5683106576084,134775.7157029479,2077,1,738.5263157894736,34,4,20,33.02550254158965,0.6519607843137254,42.38095238095239,1030.476190476191,30.308123249299737,0
2081,4,0,0,38,0.0,0.0,1.0,38,1300,1000,300,0.7692307692307693,16,10,6,365.2603078483486,0.3800972024656235,0.12672850274433012,0.22257487724552094,132827.170138889,2103.298611111121,134930.46875000012,2078,2,739.5263157894736,34,4,20,32.87860414982484,0.6528799019607843,42.29166666666667,1030.8333333333342,30.318627450980415,0
2082,4,0,0,38,0.0,0.0,1.0,38,750,500,250,0.6666666666666666,10,5,5,363.3622729522246,0.37968231389284024,0.12569116163764305,0.2219636113055127,132919.22477324266,2059.56632653062,134978.79109977328,2079,3,740.5263157894736,34,4,22,32.834988070499506,0.6537990196078431,42.202380952380956,1031.1904761904764,30.32913165266107,0
2083,4,0,0,38,0.0,0.0,1.0,38,850,700,150,0.8235294117647058,10,7,3,362.7610403256742,0.37946005215742057,0.12281489180761596,0.2220416477597807,132994.2558299039,2049.0269204389506,135043.28275034286,2080,4,741.5263157894736,35,3,23,32.7750972471574,0.6523809523809523,42.129629629629626,1031.4814814814808,29.470899470899454,0
2084,4,0,1,37,0.0,0.02631578947368421,0.9736842105263158,38,750,600,150,0.8,9,6,3,363.6759742245271,0.379208155523945,0.12592782865949737,0.22277965348888037,133024.10361207562,2075.534095293207,135099.63770736882,2081,5,742.5263157894736,35,3,23,32.72151632446987,0.6526785714285714,42.10069444444444,1031.5972222222222,29.474206349206348,0
2085,4,0,0,37,0.0,0.0,1.0,37,800,600,200,0.75,10,6,4,367.76968428415177,0.3785660660660661,0.122516700868881,0.22539547977414862,133042.013888889,2385.7638888888937,135427.7777777779,2082,6,733.5945945945946,34,3,23,32.59794022617123,0.6550245098039216,42.083333333333336,1031.6666666666674,30.343137254901983,0
2086,4,0,0,37,0.0,0.0,1.0,37,1000,700,300,0.7,13,7,6,352.80325450489295,0.3783470970970971,0.1072618491055104,0.2117283131831596,132253.17166828978,1931.869876633376,134185.04154492315,2083,7,734.5945945945946,36,1,22,33.7767316254288,0.6429398148148149,42.84909909909909,1028.6036036036026,28.572322322322293,3
2087,4,0,0,37,0.0,0.0,1.0,37,950,600,350,0.631578947368421,13,6,7,357.2916455596518,0.37772147147147145,0.10308009914050653,0.21508109730725272,132369.03077063544,2058.8697650353,134427.90053567075,2084,8,735.5945945945946,36,1,22,33.5446760779164,0.6440972222222223,42.736486486486484,1029.0540540540535,28.58483483483482,0
2088,4,0,0,37,0.0,0.0,1.0,37,650,400,250,0.6153846153846154,9,4,5,359.57904215729985,0.37762762762762764,0.1064973665895741,0.2167956896206692,132427.78427479859,2123.6543353092593,134551.43861010784,2085,9,736.5945945945946,35,2,22,33.42668859402528,0.6467261904761905,42.67939814814815,1029.2824074074078,29.408068783068796,0
2089,4,0,0,37,0.0,0.0,1.0,37,1000,800,200,0.8,12,8,4,358.74775893481944,0.37794044044044045,0.0977930054126952,0.21715221489809686,132576.73852237663,2112.321566358036,134689.06008873467,2086,10,737.5945945945946,35,2,22,33.298213081591385,0.6482142857142856,42.53472222222223,1029.8611111111118,29.42460317460319,0
2090,4,0,0,37,0.0,0.0,1.0,37,1150,600,550,0.5217391304347826,17,6,11,364.2446654703176,0.3773460960960961,0.10060464777445932,0.22153241129424248,132755.59413580253,2271.1033950617357,135026.69753086427,2087,11,738.5945945945946,35,2,19,32.97675202156335,0.6499999999999999,42.361111111111114,1030.5555555555559,29.444444444444454,0
2091,4,0,0,37,0.0,0.0,1.0,37,1050,700,350,0.6666666666666666,14,7,7,367.49659090611203,0.3765640640640641,0.099200233012537,0.22422326245148286,132874.89819101527,2366.2144204389783,135241.11261145424,2088,12,739.5945945945946,35,2,20,32.772975602454736,0.6511904761904761,42.24537037037038,1031.0185185185198,29.457671957671995,0
2092,4,0,0,37,0.0,0.0,1.0,37,500,300,200,0.6,7,3,4,368.7378838893989,0.37600100100100103,0.10079170079170074,0.22533981793241062,132934.57031250012,2403.6024305555707,135338.17274305568,2089,13,740.5945945945946,35,2,20,32.680976430976436,0.6517857142857142,42.18750000000001,1031.250000000001,29.46428571428574,0
2093,4,0,0,37,0.0,0.0,1.0,37,1250,800,450,0.64,17,8,9,368.6366947570988,0.3756256256256256,0.1034044198145081,0.22554064711291064,132978.12328798414,2404.123168776907,135382.24645676106,2090,14,741.5945945945946,36,1,20,32.63979874076501,0.650173611111111,42.14527027027028,1031.4189189189206,28.65052552552557,0
2094,4,0,0,37,0.0,0.0,1.0,37,700,600,100,0.8571428571428571,8,6,2,368.2675137658962,0.37575075075075076,0.10752998988293072,0.22601709501921685,133094.2994303426,2402.861349525204,135497.1607798678,2091,15,742.5945945945946,36,1,20,32.53255847793662,0.6513310185185186,42.03265765765766,1031.86936936937,28.663038038038053,0
2095,4,0,0,37,0.0,0.0,1.0,37,750,600,150,0.8,9,6,3,367.4886112757498,0.3754692192192192,0.11296742957227335,0.22606715509755193,133181.46482631282,2388.534311338368,135569.99913765118,2092,16,743.5945945945946,36,1,20,32.465088370063285,0.6521990740740742,41.9481981981982,1032.2072072072074,28.67242242242243,0
2096,4,0,0,37,0.0,0.0,1.0,37,650,500,150,0.7692307692307693,8,5,3,365.8908607438079,0.37468718718718713,0.11119691119691133,0.2257886401763606,133297.72973987513,2354.484213943685,135652.2139538188,2093,17,744.5945945945946,36,1,21,32.38958560523445,0.6533564814814814,41.83558558558559,1032.6576576576585,28.684934934934958,0
2097,4,0,0,37,0.0,0.0,1.0,37,750,600,150,0.8,9,6,3,365.36423925449327,0.3744682182182182,0.11140250586390987,0.22581676566322223,133355.88121905716,2344.6940183426973,135700.57523739987,2094,18,745.5945945945946,36,1,21,32.344817560691965,0.6539351851851851,41.779279279279294,1032.882882882885,28.69119119119125,0
2098,4,0,0,37,0.0,0.0,1.0,37,700,500,200,0.7142857142857143,9,5,4,365.12724537059785,0.3740615615615615,0.11226203312534255,0.22602411262009914,133414.0453798395,2342.6205766577596,135756.66595649725,2095,19,746.5945945945946,36,1,21,32.292575030884386,0.6545138888888888,41.72297297297298,1033.1081081081095,28.697447447447487,0
2099,4,0,0,37,0.0,0.0,1.0,37,900,700,200,0.7777777777777778,11,7,4,364.7445792771698,0.37324824824824826,0.12102539269392554,0.2265068910253915,133532.02830289796,2341.0293782740623,135873.057681172,2096,20,747.5945945945946,35,2,21,32.1841172079134,0.6577380952380951,41.608796296296305,1033.5648148148161,29.530423280423317,0
2100,4,0,0,37,0.0,0.0,1.0,37,1050,600,450,0.5714285714285714,15,6,9,362.6484545921826,0.3725913413413413,0.11955798162694697,0.22556935908199005,133591.84777949256,2289.3754286694207,135881.22320816197,2097,21,748.5945945945946,35,2,21,32.178310195551575,0.6583333333333332,41.55092592592593,1033.796296296297,29.537037037037056,0
2101,4,0,0,37,0.0,0.0,1.0,37,750,500,250,0.6666666666666666,10,5,5,362.84726256189,0.37321696696696693,0.1267230296888946,0.22624147180673324,133681.6021117327,2301.2006762260016,135982.8027879587,2098,22,749.5945945945946,35,2,22,32.08321675060624,0.6592261904761905,41.464120370370374,1034.1435185185187,29.546957671957678,0
2102,4,0,0,37,0.0,0.0,1.0,37,700,500,200,0.7142857142857143,9,5,4,363.3065272009749,0.37256006006006004,0.1279240981668548,0.22726361418121155,133801.32144043632,2322.1786854852485,136123.50012592156,2099,23,750.5945945945946,35,2,19,31.95139743446321,0.6604166666666667,41.348379629629626,1034.606481481481,29.560185185185173,0
2103,4,0,0,37,0.0,0.0,1.0,37,600,400,200,0.6666666666666666,8,4,4,364.2381456792572,0.3719657157157157,0.13361214524005227,0.2287742959940504,133951.04595336076,2358.0161179698207,136309.06207133058,2100,24,751.5945945945946,35,2,19,31.777355396541438,0.6619047619047619,41.2037037037037,1035.1851851851852,29.57671957671958,0
2104,4,1,0,38,0.02631578947368421,0.0,1.0,38,1200,800,400,0.6666666666666666,16,8,8,354.44377969478774,0.37689663347558083,0.13473581269265722,0.2244973230923009,134258.85080604246,1917.4429074344548,136176.29371347692,2101,0,732.7894736842105,36,2,20,31.723124705711903,0.6629050925925927,40.90653153153153,1036.3738738738734,28.78816316316315,0
2105,4,0,0,38,0.0,0.0,1.0,38,450,400,50,0.8888888888888888,5,4,1,350.6650986432682,0.37729670459933623,0.12972660850475082,0.22263606193861574,134346.3966500284,1822.1184867299658,136168.51513675836,2102,1,733.7894736842105,36,2,20,31.733606705771585,0.6637731481481481,40.82207207207207,1036.7117117117114,28.797547547547538,0
2106,4,0,0,38,0.0,0.0,1.0,38,750,500,250,0.6666666666666666,10,5,5,348.70669425957317,0.3771781650071124,0.12420162456882156,0.22228876871263875,134493.90677900874,1779.785126192657,136273.6919052014,2103,2,734.7894736842105,37,1,20,31.637156448202962,0.6632882882882885,40.6798245614035,1037.2807017543846,28.034613560929312,0
2107,4,0,0,38,0.0,0.0,1.0,38,600,400,200,0.6666666666666666,8,4,4,351.64693108607855,0.37700035561877665,0.12253894830764178,0.22488347960897123,134610.82845721862,1867.120989447349,136477.94944666597,2104,3,735.7894736842105,35,3,20,31.444252360770317,0.668452380952381,40.56712962962962,1037.7314814814802,29.649470899470863,0
2108,4,0,0,38,0.0,0.0,1.0,38,850,700,150,0.8235294117647058,10,7,3,349.3607454055325,0.37673364153627314,0.11756732969547579,0.2241606499490432,134730.96305941345,1813.9419367283751,136544.90499614182,2105,4,736.7894736842105,35,3,21,31.38377926421404,0.6696428571428572,40.45138888888888,1038.1944444444432,29.662698412698376,0
2109,4,0,0,38,0.0,0.0,1.0,38,950,700,250,0.7368421052631579,12,7,5,346.2793172399014,0.3759186818397345,0.11653075549113456,0.22287049147966576,134843.02873397042,1738.670384911934,136581.69911888236,2106,5,737.7894736842105,36,2,18,31.352099822906506,0.6686921296296295,40.343468468468465,1038.6261261261259,28.85072572572572,0
2110,4,0,1,37,0.0,0.02631578947368421,0.9736842105263158,38,700,500,200,0.7142857142857143,9,5,4,345.5244274503171,0.37569642010431487,0.1169406825105257,0.2229236620738897,134930.76480196402,1724.3750507263965,136655.13985269042,2107,6,738.7894736842105,36,2,19,31.284323289255013,0.6695601851851853,40.259009009009006,1038.9639639639631,28.860110110110085,0
2111,4,0,0,37,0.0,0.0,1.0,37,650,500,150,0.7692307692307693,8,5,3,353.6379788787588,0.3755005005005005,0.11504861972985014,0.22728079845990112,134791.0504543894,2133.446930726996,136924.49738511638,2108,7,753.8108108108108,35,2,19,31.212847377024808,0.6702380952380953,40.393518518518505,1038.4259259259243,29.66931216931212,0
2112,4,0,0,37,0.0,0.0,1.0,37,800,600,200,0.75,10,6,4,354.95654465905267,0.3756256256256256,0.11840928189975353,0.22831720969359678,134821.09917534702,2171.12630208331,136992.22547743033,2109,8,754.8108108108108,35,2,19,31.148654296222002,0.6705357142857145,40.36458333333332,1038.541666666665,29.672619047618998,0
2113,4,0,0,37,0.0,0.0,1.0,37,800,500,300,0.625,11,5,6,355.3147073121911,0.37543793793793795,0.1215493568434749,0.22911672505992972,134911.26543209853,2187.1913580246646,137098.4567901232,2110,9,755.8108108108108,35,2,19,31.04946524064171,0.6714285714285715,40.277777777777764,1038.888888888887,29.68253968253963,0
2114,4,0,0,37,0.0,0.0,1.0,37,1050,600,450,0.5714285714285714,15,6,9,351.755616970391,0.3751876876876877,0.11742818782248521,0.22719869993958045,134971.3930148318,2095.389124657045,137066.78213948885,2111,10,756.8108108108108,35,2,19,31.081996732754135,0.6720238095238096,40.2199074074074,1039.120370370369,29.6891534391534,0
2115,4,0,0,37,0.0,0.0,1.0,37,900,600,300,0.6666666666666666,12,6,6,352.05322051710164,0.37543793793793795,0.11731878888577874,0.22757997602757765,135001.46182966806,2105.5398823302307,137107.00171199828,2112,11,757.8108108108108,35,2,19,31.044311727363844,0.6723214285714286,40.190972222222214,1039.23611111111,29.692460317460284,0
2116,4,0,0,37,0.0,0.0,1.0,37,850,500,350,0.5882352941176471,12,5,7,351.1536091866893,0.3755317817817818,0.11807176722581891,0.22794537752407606,135151.8561385457,2091.8124142660918,137243.66855281178,2113,12,758.8108108108108,35,2,20,30.91792816859602,0.6738095238095239,40.04629629629628,1039.814814814813,29.708994708994656,0
2117,4,0,1,36,0.0,0.02702702702702703,0.972972972972973,37,750,400,350,0.5333333333333333,11,4,7,346.39689298622073,0.37506256256256254,0.11276348118453394,0.22542135244512385,135242.13291162957,1969.4909282835783,137211.62383991314,2114,13,759.8108108108108,35,2,20,30.951768294944547,0.6747023809523811,39.959490740740726,1040.1620370370351,29.718915343915288,0
2118,4,0,0,36,0.0,0.0,1.0,36,800,500,300,0.625,11,5,6,354.1015219743766,0.3690972222222222,0.12107854362262449,0.22977137391710276,135138.10232426293,2370.521541950101,137508.62386621302,2115,39,781.5555555555555,34,2,20,30.85499198534463,0.675857843137255,40.0595238095238,1039.761904761904,30.581232492997174,0
2119,4,0,0,36,0.0,0.0,1.0,36,900,700,200,0.7777777777777778,11,7,4,354.60249298085307,0.36901455026455027,0.11974495961330556,0.23029388670540887,135169.04939058944,2386.2563775510075,137555.30576814045,2116,40,782.5555555555555,34,2,20,30.811152451822174,0.6761642156862746,40.0297619047619,1039.8809523809514,30.584733893557395,0
2120,4,0,0,36,0.0,0.0,1.0,36,1150,600,550,0.5217391304347826,17,6,11,357.4054191500696,0.36792328042328043,0.12442957200422033,0.23331447115688983,135354.8061933105,2475.308248299302,137830.1144416098,2117,41,783.5555555555555,34,2,20,30.553331045265608,0.6780024509803921,39.85119047619047,1040.595238095237,30.605742296918734,0
2121,4,0,0,36,0.0,0.0,1.0,36,750,600,150,0.8,9,6,3,361.99632222908815,0.36792328042328043,0.10133624063513391,0.2271812708557706,133921.0943528162,2495.7887249228197,136416.883077739,2118,42,784.5555555555555,35,1,19,31.86535558537403,0.6616071428571428,41.23263888888888,1035.0694444444432,29.573412698412664,7
2122,4,0,0,36,0.0,0.0,1.0,36,650,300,350,0.46153846153846156,10,3,7,364.10223167717584,0.3670138888888889,0.10468127118959814,0.22924860427978125,134040.92084887257,2560.9196834276363,136601.8405323002,2119,43,785.5555555555555,35,1,19,31.690906635371263,0.662797619047619,41.116898148148145,1035.5324074074072,29.586640211640205,0
2123,4,0,0,36,0.0,0.0,1.0,36,1200,700,500,0.5833333333333334,17,7,10,361.3178612276937,0.3663525132275132,0.10489035332663188,0.2286133435739604,134220.76106234986,2499.271663880304,136720.03272623016,2120,44,786.5555555555555,35,1,19,31.58310529059161,0.6645833333333333,40.94328703703703,1036.226851851851,29.60648148148146,0
2124,4,0,0,36,0.0,0.0,1.0,36,750,500,250,0.6666666666666666,10,5,5,359.6162092238299,0.3657903439153439,0.1033026670047208,0.2277734324492021,134258.85080604246,2456.331796323343,136715.18260236582,2121,45,787.5555555555555,36,0,19,31.58911043500307,0.6629050925925927,40.90653153153153,1036.3738738738734,28.78816316316315,0
2125,4,0,0,36,0.0,0.0,1.0,36,1150,800,350,0.6956521739130435,15,8,7,361.0032165498238,0.36531084656084656,0.11007917541699874,0.2291996973488055,134346.3966500285,2499.896264507757,136846.29291453626,2122,46,788.5555555555555,36,0,19,31.46566550800202,0.6637731481481481,40.822072072072075,1036.7117117117123,28.797547547547563,0
2126,4,0,0,36,0.0,0.0,1.0,36,800,500,300,0.625,11,5,6,363.59910841350336,0.36502976190476194,0.11819053824157488,0.23140180990877357,134433.9710276155,2576.014401225556,137009.98542884106,2123,47,789.5555555555555,36,0,19,31.31085532269157,0.6646412037037037,40.737612612612615,1037.04954954955,28.806931931931942,0
2127,4,0,0,36,0.0,0.0,1.0,36,700,500,200,0.7142857142857143,9,5,4,364.1229320440767,0.3650793650793651,0.1216371094221258,0.23192062269197444,134463.16882761155,2592.2246570895372,137055.39348470108,2124,48,790.5555555555555,36,0,19,31.268096272167934,0.6649305555555556,40.70945945945947,1037.1621621621634,28.810060060060096,0
2128,4,0,0,36,0.0,0.0,1.0,36,800,500,300,0.625,11,5,6,368.5424428638249,0.36453373015873014,0.12795626952253492,0.2353001750592111,134550.78124999988,2717.591789424546,137268.37303942442,2125,49,791.5555555555555,34,2,19,31.065930388219538,0.6700367647058825,40.62499999999999,1037.499999999999,30.514705882352914,0
2129,4,0,0,36,0.0,0.0,1.0,36,1100,700,400,0.6363636363636364,15,7,8,367.6521630760172,0.3648478835978836,0.1252644592286709,0.23532977662971502,134643.431122449,2700.3897392290232,137343.82086167802,2126,50,792.5555555555555,34,2,19,30.996453697331194,0.6709558823529411,40.535714285714285,1037.857142857143,30.525210084033613,0
2130,4,0,0,36,0.0,0.0,1.0,36,850,500,350,0.5882352941176471,12,5,7,367.6442155179114,0.36453373015873014,0.12346634560256842,0.23592532770652724,134736.11288265305,2706.9905045351434,137443.1033871882,2127,51,793.5555555555555,34,2,19,30.904091656155643,0.671875,40.44642857142857,1038.2142857142856,30.53571428571428,0
2131,4,0,0,36,0.0,0.0,1.0,36,900,500,400,0.5555555555555556,13,5,8,369.20148313995014,0.36383928571428575,0.12390296406689849,0.23732826362783954,134797.91843820855,2753.51828231292,137551.43672052148,2128,52,794.5555555555555,34,2,17,30.801950781458977,0.6724877450980392,40.38690476190476,1038.4523809523805,30.54271708683472,0
2132,4,0,0,36,0.0,0.0,1.0,36,850,500,350,0.5882352941176471,12,5,7,370.1263317623067,0.3634920634920635,0.1272415813337413,0.2381255249479616,134828.82653061207,2780.7397959183468,137609.56632653042,2129,53,795.5555555555555,34,2,17,30.747077028885833,0.6727941176470589,40.35714285714285,1038.571428571427,30.546218487394913,0
2133,4,0,0,36,0.0,0.0,1.0,36,950,500,450,0.5263157894736842,14,5,9,378.70538128757755,0.3630787037037037,0.13888248405195602,0.23363374660657532,133287.76218820876,2897.7536848072705,136185.51587301603,2130,54,796.5555555555555,34,2,20,32.06877834140343,0.6574754901960783,41.8452380952381,1032.6190476190486,30.371148459383782,3
2134,4,0,0,36,0.0,0.0,1.0,36,650,300,350,0.46153846153846156,10,3,7,375.31583712061513,0.3626818783068783,0.13963167870498427,0.23192594037453435,133349.2346938778,2809.6159297052427,136158.85062358304,2131,55,797.5555555555555,34,2,20,32.0945232057784,0.6580882352941175,41.7857142857143,1032.8571428571447,30.378151260504257,0
2135,4,0,0,36,0.0,0.0,1.0,36,1000,600,400,0.6,14,6,8,375.33745860416605,0.3625,0.13555281698907096,0.23233440745497816,133412.42953746568,2814.936449759948,136227.36598722564,2132,56,798.5555555555555,35,1,20,32.03049144820375,0.6565476190476189,41.72453703703704,1033.1018518518517,29.517195767195762,0
2136,4,0,0,36,0.0,0.0,1.0,36,550,400,150,0.7272727272727273,7,4,3,376.7670884243879,0.3621362433862434,0.13890133552394102,0.23340734201002863,133442.32420535415,2855.3351926869063,136297.65939804105,2133,57,799.5555555555555,35,1,20,31.963542250102684,0.6568452380952381,41.695601851851855,1033.217592592593,29.52050264550266,0
2137,4,0,0,36,0.0,0.0,1.0,36,900,600,300,0.6666666666666666,12,6,6,376.17142893453416,0.3614252645502645,0.13674149606091723,0.23362517169616082,133535.54672481745,2846.458182965308,136382.00490778277,2134,58,800.5555555555555,33,3,20,31.885325270729588,0.6622474747474747,41.60539215686275,1033.5784313725496,31.320558526440898,0
2138,4,0,0,36,0.0,0.0,1.0,36,950,800,150,0.8421052631578947,11,8,3,374.0525349539722,0.36101190476190476,0.13307455256607836,0.23290636438425555,133630.56163795176,2796.970065599774,136427.53170355153,2135,59,801.5555555555555,33,3,20,31.844726601082545,0.6631944444444444,41.513480392156865,1033.9460784313726,31.33169934640523,0
2139,4,0,0,36,0.0,0.0,1.0,36,900,600,300,0.6666666666666666,12,6,6,378.88207379259666,0.36121031746031745,0.13751332780476244,0.23672417356649195,133757.3007527152,2935.6486988177467,136692.94945153294,2136,60,802.5555555555555,33,3,18,31.592697350234957,0.6644570707070707,41.39093137254901,1034.436274509803,31.346553773024336,0
2140,4,0,0,36,0.0,0.0,1.0,36,700,600,100,0.8571428571428571,8,6,2,376.73743769544944,0.362037037037037,0.12986974541148655,0.23619507508077725,133884.09994052764,2887.8305519511678,136771.9304924788,2137,61,803.5555555555555,33,3,18,31.52099368462601,0.665719696969697,41.268382352941174,1034.926470588235,31.36140819964348,0
2141,4,0,0,36,0.0,0.0,1.0,36,1200,900,300,0.75,15,9,6,379.59883571155444,0.362119708994709,0.1424770384015146,0.23652765329917932,133656.80980725616,2947.193877551011,136604.00368480716,2138,62,804.5555555555555,34,2,19,31.675013431575728,0.6611519607843137,41.488095238095234,1034.0476190476184,30.41316526610642,1
2142,4,0,0,36,0.0,0.0,1.0,36,1200,1000,200,0.8333333333333334,14,10,4,378.2852979810801,0.36236772486772484,0.13938132330557806,0.23590555517312595,133687.5868055556,2914.4097222222285,136601.9965277778,2139,63,805.5555555555555,34,2,19,31.678082191780817,0.6614583333333333,41.458333333333336,1034.166666666667,30.416666666666675,0
2143,4,0,0,36,0.0,0.0,1.0,36,400,200,200,0.5,6,2,4,377.6119831676554,0.36195436507936507,0.13583870472682635,0.23568196190808843,133718.3673469388,2898.731575963724,136617.0989229025,2140,64,806.5555555555555,34,2,19,31.664604435236352,0.661764705882353,41.42857142857143,1034.2857142857144,30.420168067226896,0
2144,4,0,0,36,0.0,0.0,1.0,36,700,300,400,0.42857142857142855,11,3,8,377.6119831676554,0.36195436507936507,0.13583870472682635,0.23568196190808843,133718.3673469388,2898.731575963724,136617.0989229025,2141,65,807.5555555555555,34,2,19,31.664604435236352,0.661764705882353,41.42857142857143,1034.2857142857144,30.420168067226896,0
2145,4,0,0,36,0.0,0.0,1.0,36,1200,1000,200,0.8333333333333334,14,10,4,378.6459310443995,0.3614417989417989,0.1373742602604906,0.2373157230403001,133872.32320011326,2938.0420918367217,136810.36529194997,2142,66,808.5555555555555,34,2,19,31.48342536140188,0.663296568627451,41.2797619047619,1034.8809523809516,30.43767507002799,0
2146,4,0,0,36,0.0,0.0,1.0,36,900,600,300,0.6666666666666666,12,6,6,378.88865551121404,0.3615410052910053,0.1374127750939349,0.23766652027521587,133903.12499999988,2946.8749999999864,136849.99999999988,2143,67,809.5555555555555,34,2,19,31.44625603864734,0.6636029411764707,41.24999999999999,1034.999999999999,30.441176470588207,0
2147,4,0,0,36,0.0,0.0,1.0,36,600,300,300,0.5,9,3,6,379.1154934959925,0.3618386243386243,0.1433790654301117,0.23860684243329555,134026.3676303855,2962.2945011337856,136988.6621315193,2144,68,810.5555555555555,34,2,19,31.31682570705908,0.664828431372549,41.13095238095238,1035.4761904761906,30.455182072829135,0
2148,4,1,0,37,0.02702702702702703,0.0,1.0,37,600,500,100,0.8333333333333334,7,5,2,370.00083892278764,0.3661786786786787,0.14025814159772687,0.23506861809009416,134370.7200038578,2543.4558256172622,136914.17582947508,2145,0,789.6216216216217,35,2,20,31.208137977227064,0.6660714285714286,40.7986111111111,1036.8055555555538,29.623015873015824,0
2149,4,0,0,37,0.0,0.0,1.0,37,1300,1100,200,0.8461538461538461,15,11,4,372.1925726297125,0.3662725225225225,0.13927282331191138,0.23706041451726492,134463.16882761128,2609.238545978397,137072.40737358967,2146,1,790.6216216216217,36,1,20,31.058858125226198,0.6649305555555556,40.70945945945945,1037.1621621621614,28.81006006006004,0
2150,4,0,0,37,0.0,0.0,1.0,37,800,500,300,0.625,11,5,6,372.7054503719899,0.36586586586586584,0.14321302085931342,0.23757715594300335,134492.36979800742,2625.20785143251,137117.57764943992,2147,2,791.6216216216217,36,1,20,31.016357254007893,0.6652199074074074,40.681306306306304,1037.2747747747744,28.813188188188178,0
2151,4,0,0,37,0.0,0.0,1.0,37,800,400,400,0.5,12,4,8,373.13217213454493,0.3653653653653654,0.14327610473515517,0.23883746524735386,134643.43112244885,2647.984546874491,137291.41566932335,2148,3,792.6216216216217,34,3,21,30.854267033723335,0.6709558823529412,40.53571428571428,1037.8571428571418,30.52521008403358,0
2152,4,0,0,37,0.0,0.0,1.0,37,1200,900,300,0.75,15,9,6,376.88644647061346,0.36492742742742745,0.14783077437823033,0.2424747314903854,134828.82653061196,2763.0314625849987,137591.85799319696,2149,4,793.6216216216217,34,3,19,30.571555479138002,0.672794117647059,40.35714285714284,1038.5714285714262,30.54621848739489,0
2153,4,0,0,37,0.0,0.0,1.0,37,1000,800,200,0.8,12,8,4,377.0752720339997,0.3641453953953954,0.1450109903718153,0.24384200924865307,135014.3494897958,2782.114512471646,137796.46400226746,2150,5,794.6216216216217,34,3,19,30.38134784268805,0.6746323529411765,40.17857142857142,1039.2857142857135,30.56722689075628,0
2154,4,0,0,37,0.0,0.0,1.0,37,850,600,250,0.7058823529411765,11,6,5,378.4548658070561,0.36383258258258255,0.1468163078332576,0.24515340417115786,135076.21882086145,2824.0504535147134,137900.26927437616,2151,6,795.6216216216217,34,3,19,30.283726523133296,0.6752450980392158,40.119047619047606,1039.5238095238076,30.574229691876695,0
2155,4,0,0,37,0.0,0.0,1.0,37,700,400,300,0.5714285714285714,10,4,6,381.57489050654846,0.3635197697697698,0.14421633998050742,0.24781090472674344,135169.04939058956,2915.4230442176886,138084.47243480725,2152,7,796.6216216216217,34,3,19,30.109950391146736,0.6761642156862745,40.029761904761905,1039.8809523809523,30.58473389355742,0
2156,4,0,0,37,0.0,0.0,1.0,37,1000,500,500,0.5,15,5,10,380.2888023998479,0.36283158158158163,0.14602080620164637,0.24740009430882134,135230.95415249435,2885.363520408163,138116.3176729025,2153,8,797.6216216216217,34,3,19,30.081597420930148,0.6767769607843137,39.970238095238095,1040.1190476190477,30.591736694677873,0
2157,4,0,0,37,0.0,0.0,1.0,37,450,300,150,0.6666666666666666,6,3,3,380.2888023998479,0.36283158158158163,0.14602080620164637,0.24740009430882134,135230.95415249435,2885.363520408163,138116.3176729025,2154,9,798.6216216216217,34,3,19,30.081597420930148,0.6767769607843137,39.970238095238095,1040.1190476190477,30.591736694677873,0
2158,4,0,0,37,0.0,0.0,1.0,37,950,700,250,0.7368421052631579,12,7,5,379.8597069005161,0.3626438938938939,0.14206552753665957,0.24761123316379513,135302.33417191764,2879.1810003000464,138181.51517221768,2155,10,799.6216216216217,35,2,19,30.02153094522936,0.6752976190476192,39.90162037037036,1040.3935185185169,29.725529100529055,0
2159,4,0,0,37,0.0,0.0,1.0,37,800,600,200,0.75,10,6,4,380.7219703397882,0.3628628628628629,0.1413148023468307,0.2487973806173963,135392.66117969813,2909.3921467763944,138302.05332647453,2156,11,800.6216216216217,35,2,19,29.90899317912218,0.6761904761904762,39.81481481481481,1040.74074074074,29.735449735449713,0
2160,4,0,0,37,0.0,0.0,1.0,37,1100,900,200,0.8181818181818182,13,9,4,378.0521455689449,0.3631131131131131,0.16461104804663051,0.24349316001841795,134868.8304978856,2825.407243356086,137694.23774124167,2157,12,801.6216216216217,33,4,14,30.501317445335843,0.6755050505050504,40.3186274509804,1038.7254901960796,31.476530005941807,4
2161,4,0,0,37,0.0,0.0,1.0,37,800,400,400,0.5,12,4,8,394.4529609685885,0.3631131131131131,0.17378918322661407,0.23928191141581506,132658.02158261905,3078.100240415753,135736.1218230348,2158,13,802.6216216216217,32,5,17,32.29690117252931,0.6559244791666667,42.455808080808076,1030.1767676767672,32.193023989898975,5
2162,4,0,0,37,0.0,0.0,1.0,37,700,400,300,0.5714285714285714,10,4,6,395.9099264705885,0.36267517517517517,0.17690779014308444,0.2403738839285713,132690.5417814507,3106.700528007327,135797.24230945803,2159,14,803.6216216216217,32,5,17,32.22656249999999,0.65625,42.424242424242415,1030.3030303030291,32.19696969696966,0
2163,4,0,0,37,0.0,0.0,1.0,37,1000,600,400,0.6,14,6,8,395.3938505767726,0.3628628628628629,0.17456127859264736,0.240268742707151,132723.06596584522,3095.5768225180973,135818.64278836333,2160,15,804.6216216216217,32,5,17,32.20704162071642,0.6565755208333335,42.39267676767676,1030.4292929292922,32.20091540404038,0
2164,4,0,0,37,0.0,0.0,1.0,37,450,200,250,0.4444444444444444,7,2,5,395.4124099104564,0.3633946446446446,0.14548661962455078,0.23199051795324474,131392.84256708506,3062.6919446995316,134455.5345117846,2161,16,805.6216216216217,32,5,19,33.551929392446645,0.6432291666666666,43.68686868686869,1025.2525252525259,32.03914141414143,5
2165,4,0,0,37,0.0,0.0,1.0,37,1050,800,250,0.7619047619047619,13,8,5,392.08643773168143,0.3636448948948949,0.14453453823144824,0.23062405023131421,131489.94880943277,2911.085125242335,134401.0339346751,2162,17,806.6216216216217,32,5,19,33.53876851737865,0.6442057291666666,43.59217171717172,1025.6313131313136,32.05097853535355,0
2166,4,0,0,37,0.0,0.0,1.0,37,1400,1100,300,0.7857142857142857,17,11,6,394.13980281520276,0.3634884884884885,0.15524804632651246,0.23256748195713148,131610.90573637557,2974.619287053075,134585.52502342864,2163,18,807.6216216216217,33,4,16,33.363564433297505,0.6429924242424241,43.47426470588236,1026.1029411764719,31.094028520499148,0
2167,4,0,0,37,0.0,0.0,1.0,37,1000,800,200,0.8,12,8,4,398.1752825096984,0.36402027027027023,0.1572920322920328,0.23584228271728278,131755.55555555545,3092.361111111102,134847.91666666654,2164,19,808.6216216216217,34,3,17,33.11350108225109,0.6421568627450981,43.33333333333333,1026.6666666666658,30.196078431372523,0
2168,4,0,0,37,0.0,0.0,1.0,37,500,300,200,0.6,7,3,4,396.12182314639807,0.36389514514514515,0.15586368977673337,0.23481448279296777,131786.11288265296,3040.6710600906927,134826.78394274364,2165,20,809.6216216216217,34,3,17,33.135265700483096,0.6424632352941178,43.30357142857142,1026.7857142857135,30.199579831932752,0
2169,4,1,0,38,0.02631578947368421,0.0,1.0,38,1250,1000,250,0.8,15,10,5,390.1724308830808,0.3694138217164533,0.14846725705654062,0.2337614327981235,132189.63162562155,2715.3499817815436,134904.98160740308,2166,0,789.2894736842105,35,3,19,32.87997092477958,0.6443452380952381,42.910879629629626,1028.3564814814813,29.381613756613753,0
2170,4,0,0,38,0.0,0.0,1.0,38,700,400,300,0.5714285714285714,10,4,6,389.04220509072627,0.3694582740635372,0.14973879668787116,0.23326781608881178,132219.38898533935,2687.784529320971,134907.17351466033,2167,1,790.2894736842105,35,3,19,32.87896691424712,0.6446428571428573,42.881944444444436,1028.472222222221,29.3849206349206,0
2171,4,0,0,38,0.0,0.0,1.0,38,650,400,250,0.6153846153846154,9,4,5,387.5749190266565,0.3695619962067331,0.15037044056072446,0.23257112122821702,132249.1496940371,2651.2906968021125,134900.4403908392,2168,2,791.2894736842105,35,3,19,32.886636847830154,0.6449404761904762,42.85300925925925,1028.5879629629621,29.38822751322749,0
2172,4,1,0,39,0.02564102564102564,0.0,1.0,39,1050,700,350,0.6666666666666666,14,7,7,381.26481643497397,0.3736504723346829,0.1480821827005936,0.23059912112997707,132546.94097490137,2307.180748456785,134854.12172335817,2169,0,771.974358974359,35,4,20,32.74851541718183,0.6479166666666667,42.563657407407405,1029.74537037037,29.421296296296287,0
2173,4,0,0,39,0.0,0.0,1.0,39,750,700,50,0.9333333333333333,8,7,1,383.03607699955217,0.37393162393162394,0.15096481598335765,0.2320379883743371,132606.53941883135,2358.617728695119,134965.15714752648,2170,1,772.974358974359,35,4,20,32.64282971869498,0.6485119047619048,42.50578703703703,1029.976851851851,29.42791005291003,0
2174,4,0,0,39,0.0,0.0,1.0,39,900,500,400,0.5555555555555556,13,5,8,385.48064466921903,0.37336932073774176,0.15299366102466183,0.23426171873652282,132725.7764944489,2432.6435774605798,135158.42007190947,2171,2,773.974358974359,35,4,16,32.45968119360515,0.6497023809523809,42.390046296296305,1030.4398148148161,29.441137566137606,0
2175,4,0,0,39,0.0,0.0,1.0,39,400,200,200,0.5,6,2,4,381.5788403451364,0.3735098965362123,0.15131228494507543,0.23225971109182794,132785.41512613607,2333.6209437157167,135119.03606985178,2172,3,774.974358974359,35,4,16,32.50011697548194,0.650297619047619,42.33217592592593,1030.671296296297,29.447751322751344,0
2176,4,0,0,39,0.0,0.0,1.0,39,1400,1100,300,0.7857142857142857,17,11,6,382.9712755115344,0.37384727845254156,0.15380135135513529,0.23394716276578564,132920.0542392057,2380.91254261021,135300.9667818159,2173,4,775.974358974359,36,3,17,32.328637472243464,0.6495949074074073,42.20157657657659,1031.1936936936959,28.64426926926933,0
2177,4,0,0,39,0.0,0.0,1.0,39,950,600,350,0.631578947368421,13,6,7,382.2016458704338,0.3738753936122357,0.15111245522901418,0.23081563083013354,132489.9092970522,2338.659168165687,134828.5684652179,2174,5,776.974358974359,34,5,18,32.781905257477646,0.6495098039215685,42.61904761904762,1029.5238095238096,30.28011204481793,4
2178,4,0,0,39,0.0,0.0,1.0,39,1200,800,400,0.6666666666666666,16,8,8,379.9458718968228,0.37393162393162394,0.14859937750111185,0.22982739803549068,132551.19756235825,2272.456065759639,134823.6536281179,2175,6,777.974358974359,34,5,19,32.77817919075146,0.6501225490196079,42.55952380952381,1029.7619047619046,30.28711484593837,0
2179,4,0,0,39,0.0,0.0,1.0,39,1300,800,500,0.6153846153846154,18,8,10,376.8716071203129,0.37440958164642374,0.14296744454047827,0.22848482992989005,132636.34366426617,2197.3743998628324,134833.718064129,2176,7,778.974358974359,35,4,16,32.77153558052434,0.6488095238095237,42.476851851851855,1030.092592592593,29.431216931216944,0
2180,4,0,0,39,0.0,0.0,1.0,39,750,500,250,0.6666666666666666,10,5,5,372.3508565417676,0.3746063877642825,0.1436995576621929,0.22675498269639396,132803.95418645005,2089.9332186916718,134893.88740514172,2177,8,779.974358974359,36,3,16,32.71923595178265,0.6484375,42.31418918918919,1030.7432432432438,28.631756756756772,0
2181,4,0,0,39,0.0,0.0,1.0,39,750,400,350,0.5333333333333333,11,4,7,375.4610176004718,0.3730319388214125,0.13929654488789578,0.22935934210590547,132920.05423920558,2181.259764832417,135101.314004038,2178,9,780.974358974359,36,3,16,32.52225073714099,0.6495949074074073,42.201576576576585,1031.193693693695,28.644269269269305,0
2182,4,0,0,39,0.0,0.0,1.0,39,1000,700,300,0.7,13,7,6,375.48049359474595,0.37280701754385964,0.13876616213370951,0.22954942325371736,132949.08717839475,2183.957775342922,135133.04495373767,2179,10,781.974358974359,36,3,17,32.49253839994176,0.6498842592592593,42.17342342342343,1031.3063063063073,28.647397397397427,0
2183,4,1,1,39,0.025,0.025,0.975,40,850,600,250,0.7058823529411765,11,6,5,370.7476107548065,0.37514690170940174,0.14506795497982639,0.22881395793504367,133302.3201850569,1884.3033433364092,135186.6235283933,2180,0,763.4,37,3,18,32.259591562256674,0.6514639639639639,41.83114035087719,1032.675438596491,27.91014698909435,0
2184,4,0,0,39,0.0,0.0,1.0,39,1150,900,250,0.782608695652174,14,9,5,363.7148686823566,0.37052968960863697,0.09925300318313446,0.21674161133747816,131985.99810979585,1801.0539940828085,133787.05210387867,2181,1,783.6153846153846,38,1,16,33.765465793304216,0.636513157894737,43.10897435897434,1027.5641025641,27.041160593792107,6
2185,4,0,0,39,0.0,0.0,1.0,39,800,300,500,0.375,13,3,10,364.2118208220099,0.3700236167341431,0.10128524841741826,0.2179834927606357,132150.7232084155,1826.1711045364893,133976.89431295198,2182,2,784.6153846153846,38,1,16,33.586606400665005,0.6381578947368421,42.94871794871795,1028.2051282051282,27.058029689608635,0
2186,4,0,0,39,0.0,0.0,1.0,39,1100,900,200,0.8181818181818182,13,9,4,363.71335232769536,0.36926450742240213,0.09793018226753136,0.2183187129807388,132260.59701219955,1820.9890240338932,134081.58603623344,2183,3,785.6153846153846,38,1,17,33.48869616396621,0.6392543859649124,42.84188034188034,1028.6324786324785,27.069275753486277,0
2187,4,0,0,39,0.0,0.0,1.0,39,800,600,200,0.75,10,6,4,363.4133801635021,0.3688427800269905,0.09593486844031984,0.21861550683039904,132343.03232750748,1819.0457438454227,134162.0780713529,2184,4,786.6153846153846,38,1,18,33.41337002042017,0.6400767543859649,42.761752136752136,1028.9529914529915,27.07771030139451,0
2188,4,1,1,39,0.025,0.025,0.975,40,850,300,550,0.35294117647058826,14,3,11,358.3756754014796,0.37271634615384613,0.09286969019482605,0.21703563630213407,132595.5597515582,1503.8274847888556,134099.38723634707,2185,0,767.925,37,3,18,33.2888631605096,0.6444256756756757,42.516447368421055,1029.934210526316,27.83605974395449,0
2189,4,0,0,39,0.0,0.0,1.0,39,1100,900,200,0.8181818181818182,13,9,4,367.3145223318737,0.36819613135402607,0.09335632473959454,0.2223091533239569,132571.90626014542,1939.1172845142626,134511.0235446597,2186,6,788.6153846153846,36,3,18,33.082513213049026,0.6461226851851851,42.53941441441442,1029.8423423423435,28.606731731731763,0
2190,4,0,0,39,0.0,0.0,1.0,39,750,600,150,0.8,9,6,3,368.52936785213063,0.3682242465137202,0.09177525570968226,0.22390728524880443,132716.9124360848,1982.0159686713828,134698.92840475618,2187,7,789.6153846153846,36,3,17,32.905282331511856,0.6475694444444444,42.39864864864865,1030.4054054054059,28.622372372372386,0
2191,4,0,0,39,0.0,0.0,1.0,39,1150,800,350,0.6956521739130435,15,8,7,369.016363880874,0.36799932523616735,0.09230433028509966,0.22455038312751086,132774.93709926168,1999.2249005762797,134774.16199983796,2188,8,790.6153846153846,36,3,17,32.834353146853154,0.6481481481481481,42.342342342342356,1030.6306306306326,28.628628628628682,0
2192,4,0,0,39,0.0,0.0,1.0,39,750,400,350,0.5333333333333333,11,4,7,366.6809177920807,0.36766194331983804,0.09363623720743819,0.22374436534710818,132878.0384950178,1944.76822195292,134822.80671697072,2189,9,791.6153846153846,37,2,17,32.79084246162573,0.6472409909909909,42.242324561403514,1031.0307017543867,27.86569464201045,0
2193,4,0,0,39,0.0,0.0,1.0,39,800,400,400,0.5,12,4,8,366.7751543683683,0.36754948268106163,0.09721995004853357,0.22397100984935953,132906.3029008927,1949.3459526008128,134855.64885349353,2190,10,792.6153846153846,37,2,18,32.75999574649086,0.6475225225225224,42.21491228070176,1031.140350877194,27.86865813181605,0
2194,4,0,0,39,0.0,0.0,1.0,39,700,400,300,0.5714285714285714,10,4,6,365.0465367641639,0.36729644624381463,0.09305127387406542,0.22342178082891956,132991.1141529126,1909.589128385676,134900.70328129828,2191,11,793.6153846153846,37,2,18,32.71931806101839,0.648367117117117,42.1326754385965,1031.4692982456154,27.87754860123285,0
2195,4,0,0,39,0.0,0.0,1.0,39,1100,800,300,0.7272727272727273,14,8,6,367.18686426956174,0.36690283400809715,0.09826471477730636,0.2254139321357368,133104.2379025277,1974.8255472837775,135079.06344981148,2192,12,794.6153846153846,37,2,18,32.550450713703825,0.6494932432432432,42.02302631578947,1031.907894736842,27.889402560455192,0
2196,4,0,0,39,0.0,0.0,1.0,39,1100,800,300,0.7272727272727273,14,8,6,367.5210960176096,0.3660874943769681,0.09924767809444401,0.2266500433004477,133274.01369892684,1996.2023170591197,135270.21601598596,2193,13,795.6153846153846,37,2,18,32.371309865137526,0.6511824324324322,41.85855263157896,1032.5657894736862,27.907183499288816,0
2197,4,0,0,39,0.0,0.0,1.0,39,950,700,250,0.7368421052631579,12,7,5,367.08092733083595,0.36558142150247414,0.10170395775491303,0.2268964787044931,133358.94217451525,1990.7048322560804,135349.64700677132,2194,14,796.6153846153846,37,2,18,32.297416843595194,0.652027027027027,41.776315789473685,1032.8947368421054,27.916073968705554,0
2198,4,1,0,40,0.025,0.0,1.0,40,1150,800,350,0.6956521739130435,15,8,7,361.01928755402633,0.36810897435897433,0.10154905804203418,0.2250672177602597,133675.94103816658,1652.0147827836486,135327.95582095024,2195,0,777.675,36,4,19,32.13614831754329,0.6571180555555556,41.4695945945946,1034.121621621622,28.725600600600607,0
2199,4,0,1,39,0.0,0.025,0.975,40,750,500,250,0.6666666666666666,10,5,5,361.45461670123336,0.3682959401709402,0.10075532704335832,0.2256519787784733,133727.278164916,1667.2684143197746,135394.5465792358,2196,1,778.675,37,3,16,32.073461076363124,0.6556869369369369,41.41995614035087,1034.3201754385955,27.954599336178255,0
2200,4,1,1,39,0.025,0.025,0.975,40,1350,1200,150,0.8888888888888888,15,12,3,363.32305448212605,0.3697916666666667,0.10377503443891078,0.22751689881538292,133840.71451071478,1725.4834420206146,135566.19795273538,2197,0,779.625,37,3,16,31.91151407580092,0.6568130630630631,41.310307017543856,1034.758771929824,27.966453295400648,0
2201,4,0,0,39,0.0,0.0,1.0,39,750,500,250,0.6666666666666666,10,5,5,371.6209092183326,0.36456927575348624,0.11380874614407555,0.2320420157151861,133734.1749477519,2139.6831375294296,135873.85808528133,2198,18,800.6153846153846,36,3,16,31.803665396479772,0.6576967592592593,41.41328828828829,1034.3468468468475,28.731856856856876,0
2202,4,0,0,39,0.0,0.0,1.0,39,1350,900,450,0.6666666666666666,18,9,9,368.4174509059858,0.36333220872694555,0.11915104001130072,0.2310626125648903,133897.45071800938,2066.031495267771,135963.48221327714,2199,19,801.6153846153846,37,2,17,31.72288289719956,0.6573761261261261,41.25548245614035,1034.9780701754385,27.97238027501185,0
2203,4,0,0,39,0.0,0.0,1.0,39,1150,800,350,0.6956521739130435,15,8,7,364.0404548806008,0.3639226270805218,0.11021433128368052,0.22937705779501494,134067.7314774738,1961.2155903739558,136028.94706784777,2200,20,802.6153846153846,37,2,17,31.66567407799541,0.6590653153153154,41.09100877192982,1035.6359649122803,27.990161213845415,0
2204,4,0,0,39,0.0,0.0,1.0,39,550,400,150,0.7272727272727273,7,4,3,366.4292663761034,0.36321974808816915,0.11430990685859466,0.23141869710704688,134152.9124345951,2031.5106571252559,136184.42309172038,2201,21,803.6153846153846,37,2,17,31.51857535986452,0.6599099099099099,41.008771929824555,1035.9649122807007,27.99905168326218,0
2205,4,0,0,39,0.0,0.0,1.0,39,950,600,350,0.631578947368421,13,6,7,372.61630054369664,0.3627699055330634,0.11922764922447526,0.23587385508630088,134238.12044330925,2203.862366304995,136441.98280961424,2202,22,804.6153846153846,37,2,17,31.273035481254198,0.6607545045045047,40.92653508771929,1036.293859649121,28.007942152678947,0
2206,4,0,0,39,0.0,0.0,1.0,39,950,700,250,0.7368421052631579,12,7,5,374.2151522402132,0.36234817813765186,0.12305413828739775,0.23725391241627972,134294.9408111148,2251.0403441443336,136545.98115525913,2203,23,805.6153846153846,37,2,17,31.174737296801716,0.6613175675675677,40.87171052631578,1036.5131578947355,28.01386913229015,0
2207,4,0,1,38,0.0,0.02564102564102564,0.9743589743589743,39,1000,800,200,0.8,12,8,4,374.8463542947046,0.3618983355825461,0.12428037079199883,0.23895192126872694,134493.906779009,2282.910126192685,136776.8169052017,2204,24,806.6153846153846,37,2,17,30.9593023255814,0.6632882882882882,40.679824561403514,1037.2807017543867,28.03461356092937,0
2208,4,0,0,38,0.0,0.0,1.0,38,1050,800,250,0.7619047619047619,13,8,5,376.60682892211423,0.36196064485538165,0.12819699852039745,0.2404489753887344,134550.78125,2534.548611111111,137085.32986111112,2205,25,823.421052631579,36,2,19,30.85676037483266,0.6657986111111112,40.625,1037.5,28.819444444444443,0
2209,4,1,1,38,0.02564102564102564,0.02564102564102564,0.9743589743589743,39,1050,600,450,0.5714285714285714,15,6,9,371.66709704848427,0.3649628879892038,0.12167576230076227,0.23915969723119854,134835.3339489073,2222.77142967066,137058.10537857795,2206,0,803.2820512820513,37,2,17,30.700573620495483,0.6666666666666667,40.35087719298245,1038.5964912280697,28.07017543859648,0
2210,4,0,0,38,0.0,0.0,1.0,38,700,400,300,0.5714285714285714,10,4,6,380.77366472019247,0.36224217638691325,0.13273775545153566,0.24448002706964997,134755.3211995779,2662.2554987419794,137417.5766983199,2207,27,825.421052631579,36,2,19,30.54410701373824,0.6678240740740742,40.427927927927925,1038.288288288288,28.841341341341334,0
2211,4,0,0,38,0.0,0.0,1.0,38,550,200,350,0.36363636363636365,9,2,7,380.22805057522953,0.3620199146514936,0.13438147478010687,0.244326331313881,134784.55387397538,2649.773633430733,137434.32750740612,2208,28,826.421052631579,36,2,17,30.529046018146985,0.6681134259259258,40.39977477477478,1038.4009009009012,28.844469469469477,0
2212,4,0,0,38,0.0,0.0,1.0,38,1400,1100,300,0.7857142857142857,17,11,6,378.21717206668507,0.3618569227121859,0.13297690235997628,0.24362256949323352,134872.27091956825,2602.201779482189,137474.47269905044,2209,29,827.421052631579,36,2,17,30.493594608268275,0.6689814814814814,40.31531531531532,1038.7387387387391,28.853853853853863,0
2213,4,0,0,38,0.0,0.0,1.0,38,1050,700,350,0.6666666666666666,14,7,7,379.40759716873254,0.3624792555713608,0.13211501502700318,0.24537860646602924,135018.52940355917,2645.4111628520636,137663.94056641124,2210,30,828.421052631579,36,2,18,30.31657456568066,0.6704282407407407,40.17454954954956,1039.3018018018033,28.869494494494536,0
2214,4,0,0,38,0.0,0.0,1.0,38,500,300,200,0.6,7,3,4,379.40759716873254,0.3624792555713608,0.13211501502700318,0.24537860646602924,135018.52940355917,2645.4111628520636,137663.94056641124,2211,31,829.421052631579,36,2,18,30.31657456568066,0.6704282407407407,40.17454954954956,1039.3018018018033,28.869494494494536,0
2215,4,0,0,38,0.0,0.0,1.0,38,900,700,200,0.7777777777777778,11,7,4,374.797704284035,0.3624792555713608,0.13777560551754098,0.23814785806370672,134375.58493882394,2472.732149379109,136848.31708820304,2212,32,830.421052631579,36,2,20,31.078934506353875,0.6640625,40.79391891891892,1036.8243243243242,28.80067567567567,1
2216,4,0,0,38,0.0,0.0,1.0,38,1100,700,400,0.6363636363636364,15,7,8,373.93049175561725,0.36236071597913705,0.13725988878156947,0.2379769107517262,134433.97102761536,2453.7921790033183,136887.7632066187,2213,33,831.421052631579,36,2,20,31.043001411662505,0.6646412037037037,40.73761261261261,1037.0495495495488,28.806931931931913,0
2217,4,0,0,38,0.0,0.0,1.0,38,950,600,350,0.631578947368421,13,6,7,367.2589814390039,0.36236071597913705,0.10497230873638164,0.22883870249491986,133656.80980725604,2222.712935460257,135879.5227427163,2214,34,832.421052631579,34,4,18,31.99401335482385,0.6611519607843138,41.48809523809523,1034.0476190476174,30.413165266106397,2
2218,4,0,0,38,0.0,0.0,1.0,38,1000,800,200,0.8,12,8,4,369.10009918414784,0.3618569227121859,0.10541457210344651,0.2307539469000173,133779.9390589567,2275.637755102015,136055.5768140587,2215,35,833.421052631579,34,4,16,31.82297660145761,0.6623774509803922,41.369047619047606,1034.5238095238076,30.427170868347282,0
2219,4,0,0,38,0.0,0.0,1.0,38,1100,800,300,0.7272727272727273,14,8,6,368.2712034256614,0.3607456140350877,0.10812995331997333,0.23081337933520332,133872.3232001131,2260.264314058929,136132.58751417205,2216,36,834.421052631579,34,4,17,31.751840561371225,0.6632965686274511,41.27976190476189,1034.8809523809502,30.43767507002795,0
2220,4,0,0,38,0.0,0.0,1.0,38,750,500,250,0.6666666666666666,10,5,5,367.1314739059718,0.36046408250355616,0.10337156865712305,0.23048434408753943,133933.93034297036,2234.272250566878,136168.20259353722,2217,37,835.421052631579,34,4,17,31.71961855472495,0.6639093137254903,41.22023809523809,1035.1190476190463,30.44467787114842,0
2221,4,0,0,38,0.0,0.0,1.0,38,1250,800,450,0.64,17,8,9,366.5547387818045,0.3602862731152205,0.10933006334139095,0.23116972215351397,134100.85419077906,2231.0607156635538,136331.91490644263,2218,38,836.421052631579,35,3,17,31.567423734495467,0.6633928571428573,41.059027777777764,1035.7638888888869,29.59325396825391,0
2222,4,0,0,38,0.0,0.0,1.0,38,700,500,200,0.7142857142857143,9,5,4,371.45383061762846,0.3597232100521574,0.11514039791166941,0.2348343708819922,134190.7793209876,2369.1358024691344,136559.91512345674,2219,39,837.421052631579,35,3,17,31.3505361930295,0.6642857142857144,40.97222222222222,1036.1111111111109,29.603174603174597,0
2223,4,0,0,38,0.0,0.0,1.0,38,550,300,250,0.5454545454545454,8,3,5,371.4148632610287,0.3591453295400664,0.1114255487966147,0.23538712671638443,134280.73459201385,2374.772135416662,136655.5067274305,2220,40,838.421052631579,35,3,17,31.26151591289782,0.6651785714285714,40.885416666666664,1036.458333333333,29.61309523809523,0
2224,4,0,0,38,0.0,0.0,1.0,38,900,700,200,0.7777777777777778,11,7,4,368.54272386138655,0.3589378852536747,0.11226444474477493,0.23395018976799686,134340.72151759674,2302.0590867198102,136642.78060431656,2221,41,839.421052631579,35,3,17,31.275934092516096,0.6657738095238095,40.82754629629629,1036.6898148148139,29.61970899470897,0
2225,4,0,0,38,0.0,0.0,1.0,38,650,400,250,0.6153846153846154,9,4,5,346.5586195860745,0.3593527738264581,0.060619653952244335,0.2183619854563356,134067.73147747366,1692.4655903739406,135760.1970678476,2222,42,840.421052631579,37,1,19,32.11829451208753,0.6590653153153154,41.091008771929815,1035.6359649122792,27.990161213845383,8
2226,4,0,0,38,0.0,0.0,1.0,38,700,400,300,0.5714285714285714,10,4,6,347.30471209017816,0.3597972972972973,0.06251775835269324,0.21917084937314008,134124.51577648864,1716.415267197569,135840.9310436862,2223,43,841.421052631579,37,1,19,32.042248862072604,0.6596283783783785,41.0361842105263,1035.8552631578925,27.996088193456554,0
2227,4,0,0,38,0.0,0.0,1.0,38,650,400,250,0.6153846153846154,9,4,5,348.3114669825156,0.3598713845424372,0.0642074067471814,0.2199763863670322,134152.912434595,1745.3995460141302,135898.3119806091,2224,44,842.421052631579,37,1,19,31.987810471351946,0.6599099099099102,41.00877192982455,1035.9649122806998,27.999051683262156,0
2228,4,0,0,38,0.0,0.0,1.0,38,1000,800,200,0.8,12,8,4,347.6917334461008,0.35964912280701755,0.06102845748088037,0.21975512972121747,134181.3120984339,1730.7465999153326,135912.05869834922,2225,45,843.421052631579,37,1,19,31.975495643277924,0.6601914414414416,40.981359649122794,1036.074561403507,28.002015173067758,0
2229,4,0,0,38,0.0,0.0,1.0,38,550,400,150,0.7272727272727273,7,4,3,349.0038912684416,0.3598713845424372,0.06271790587580028,0.2207554733926889,134209.71476800548,1767.9425400123016,135977.65730801778,2226,46,844.421052631579,37,1,19,31.91313932980599,0.660472972972973,40.95394736842105,1036.1842105263152,28.004978662873384,0
2230,4,0,0,38,0.0,0.0,1.0,38,1300,1200,100,0.9230769230769231,14,12,2,347.96489730219076,0.3598862019914652,0.007780108287400722,0.20743321778401316,132000.1133786848,1633.2667900955373,133633.38016878034,2227,47,845.421052631579,34,4,17,34.15585418597466,0.6446078431372548,43.095238095238095,1027.6190476190475,30.224089635854337,7
2231,4,0,0,38,0.0,0.0,1.0,38,700,300,400,0.42857142857142855,11,3,8,346.6240769033828,0.35978247984826933,0.006723401229117076,0.20701872407390354,132070.63567654754,1555.7724354852603,133626.4081120328,2228,48,846.421052631579,35,3,17,34.119304320084076,0.6431547619047618,43.026620370370374,1027.893518518519,29.368386243386254,0
2232,4,0,0,38,0.0,0.0,1.0,38,800,600,200,0.75,10,6,4,347.4037872278833,0.3599010194404931,0.005092518530367851,0.20781062908722484,132130.12695312515,1580.5013020833471,133710.6282552085,2229,49,847.421052631579,35,3,17,34.03938703140832,0.6437499999999998,42.96875000000001,1028.1250000000011,29.375000000000032,0
2233,4,1,1,38,0.02564102564102564,0.02564102564102564,0.9743589743589743,39,850,600,250,0.7058823529411765,11,6,5,336.5077283679457,0.3669871794871795,0.008927644555174918,0.20272538757776254,132398.00347222236,1110.5902777777965,133508.59375000017,2230,0,826.6666666666666,36,3,17,34.05026990553308,0.644386574074074,42.70833333333334,1029.1666666666679,28.587962962962997,0
2234,4,0,0,38,0.0,0.0,1.0,38,350,200,150,0.5714285714285714,5,2,3,346.8794252794696,0.35951576576576577,0.012706318513736603,0.20815107714102957,132249.14969403733,1574.901807913252,133824.0515019506,2231,51,849.421052631579,35,3,17,33.933109223209925,0.644940476190476,42.85300925925927,1028.587962962964,29.38822751322754,0
2235,4,0,0,38,0.0,0.0,1.0,38,700,500,200,0.7142857142857143,9,5,4,345.9052695017148,0.3594861308677098,0.012567277119562181,0.2078939784043775,132308.68115837194,1553.254002700625,133861.93516107256,2232,52,850.421052631579,35,3,17,33.898287208909885,0.6455357142857142,42.79513888888889,1028.8194444444448,29.39484126984128,0
2236,4,0,0,38,0.0,0.0,1.0,38,1150,800,350,0.6956521739130435,15,8,7,347.1800408104488,0.35896752015173067,0.04890984254839381,0.20868611934173212,132313.38158135177,1587.3130434364268,133900.6946247882,2233,53,851.421052631579,37,1,20,33.860772141106274,0.6416103603603605,42.79057017543859,1028.837719298244,27.80642484589849,1
2237,4,1,1,38,0.02564102564102564,0.02564102564102564,0.9743589743589743,39,1100,900,200,0.8181818181818182,13,9,4,338.50416158357484,0.3622638326585695,0.03773955222834391,0.20487230692798103,132571.90626014533,1175.282498810955,133747.1887589563,2234,0,830.5641025641025,36,3,21,33.82426644796791,0.6461226851851851,42.539414414414416,1029.8423423423428,28.606731731731745,0
2238,4,0,0,38,0.0,0.0,1.0,38,850,500,350,0.5882352941176471,12,5,7,346.58657959327957,0.3587156235182551,0.04470784562034691,0.20912761457955423,132457.5684263546,1581.6031164266096,134039.17154278123,2235,55,853.421052631579,35,3,21,33.73107338280487,0.6470238095238094,42.65046296296296,1029.3981481481483,29.411375661375665,0
2239,4,0,0,38,0.0,0.0,1.0,38,950,900,50,0.9473684210526315,10,9,1,346.79315899798183,0.3589230678046467,0.044348731541082875,0.20958369174225844,132517.1467764059,1591.207990397796,134108.35476680368,2236,56,854.421052631579,35,3,22,33.665879796163075,0.6476190476190476,42.59259259259259,1029.6296296296287,29.41798941798939,0
2240,4,0,0,38,0.0,0.0,1.0,38,1100,700,400,0.6363636363636364,15,7,8,347.0663350903156,0.3585229966808914,0.04029641221549696,0.21054130195001378,132658.90045450864,1608.2876795714687,134267.1881340801,2237,57,855.421052631579,36,2,15,33.51643346450953,0.6469907407407407,42.45495495495496,1030.1801801801807,28.61611611611613,0
2241,4,1,0,39,0.02564102564102564,0.0,1.0,39,700,600,100,0.8571428571428571,8,6,2,342.9180983617939,0.36209514170040485,0.046888627245770476,0.21003733524659865,133019.39058171737,1322.9512927054398,134342.3418744228,2238,0,834.4615384615385,37,2,17,33.26158588435376,0.6486486486486487,42.10526315789473,1031.5789473684204,27.880512091038387,0
2242,4,0,0,39,0.0,0.0,1.0,39,850,600,250,0.7058823529411765,11,6,5,342.9731909829924,0.3618139901034638,0.045183144343522885,0.21023027713087794,133047.67001625508,1326.3567876654452,134374.02680392054,2239,1,835.4615384615385,37,2,18,33.23181262620895,0.6489301801801801,42.077850877192986,1031.6885964912287,27.88347558084402,0
2243,4,1,0,40,0.025,0.0,1.0,40,800,600,200,0.75,10,6,4,334.27271616882865,0.3651842948717949,0.05010862818125417,0.20632695239386314,133306.6752958579,912.1568869164947,134218.83218277438,2240,0,815.55,38,2,19,33.196901510449,0.649671052631579,41.82692307692307,1032.692307692307,27.176113360323868,0
2244,4,0,0,40,0.0,0.0,1.0,40,800,200,600,0.25,14,2,12,334.6220708504977,0.3651976495726496,0.051771490638254036,0.20669594625634258,133334.25931633066,923.3171935495681,134257.57650988022,2241,1,816.55,38,2,19,33.16027895589807,0.6499451754385964,41.800213675213676,1032.7991452991455,27.1789248762933,0
2245,4,0,1,39,0.0,0.025,0.975,40,1000,900,100,0.9,11,9,2,334.28720083246594,0.3648771367521368,0.0497983870967742,0.20725806451612924,133472.22222222245,923.6111111111353,134395.83333333358,2242,2,817.55,39,1,20,33.03091397849463,0.6495726495726495,41.66666666666668,1033.333333333335,26.49572649572654,0
2246,4,0,0,39,0.0,0.0,1.0,39,1050,800,250,0.7619047619047619,13,8,5,335.84881612342383,0.36333220872694555,0.06306091400157987,0.20853667825276018,133527.4273595588,1169.005679742861,134696.43303930166,2243,3,834.025641025641,38,1,20,32.935359382537385,0.6518640350877192,41.613247863247864,1033.5470085470088,27.198605488079178,0
2247,4,0,0,39,0.0,0.0,1.0,39,900,600,300,0.6666666666666666,12,6,6,338.2871161370594,0.3641756635177688,0.05777908495692885,0.21052118474973125,133610.2564673277,1239.7256693330291,134849.98213666075,2244,4,835.025641025641,38,1,20,32.78951810133994,0.652686403508772,41.53311965811965,1033.8675213675208,27.20704003598739,0
2248,4,0,0,39,0.0,0.0,1.0,39,850,700,150,0.8235294117647058,10,7,3,337.7236869066318,0.3636695906432748,0.054153422335240675,0.21064209337990966,133693.11125721387,1230.2660895609656,134923.37734677483,2245,5,836.025641025641,38,1,20,32.72124655647383,0.6535087719298245,41.452991452991455,1034.1880341880346,27.21547458389565,0
2249,4,0,0,39,0.0,0.0,1.0,39,850,800,50,0.9411764705882353,9,8,1,336.1107683642732,0.36321974808816915,0.055487147710632234,0.2101072027160271,133775.99172921694,1192.710273759959,134968.7020029769,2246,6,837.025641025641,38,1,15,32.680126682501964,0.6543311403508771,41.37286324786325,1034.5085470085476,27.223909131803882,0
2250,4,0,0,39,0.0,0.0,1.0,39,1000,600,400,0.6,14,6,8,337.5178548461551,0.3629948268106163,0.052790814017200205,0.21162041811616214,133886.5389751808,1237.8194855358345,135124.35846071664,2247,7,838.025641025641,38,1,16,32.53329204087954,0.6554276315789473,41.26602564102564,1034.9358974358975,27.23515519568151,0
2251,4,0,0,39,0.0,0.0,1.0,39,950,500,450,0.5263157894736842,14,5,9,337.5178548461551,0.3629948268106163,0.052790814017200205,0.21162041811616214,133886.5389751808,1237.8194855358345,135124.35846071664,2248,8,839.025641025641,38,1,16,32.53329204087954,0.6554276315789473,41.26602564102564,1034.9358974358975,27.23515519568151,0
2252,4,0,0,39,0.0,0.0,1.0,39,750,600,150,0.8,9,6,3,339.6160223907064,0.36358524516419255,0.052060014289116996,0.2134162942260665,133969.4793721236,1299.6363412228839,135269.1157133465,2249,9,840.025641025641,38,1,17,32.39615583075336,0.65625,41.18589743589744,1035.2564102564104,27.243589743589748,0
2253,4,0,0,39,0.0,0.0,1.0,39,900,800,100,0.8888888888888888,10,8,2,335.4831775623049,0.36383828160143955,0.04823464990595916,0.211295545166434,134052.44545118336,1194.468071992101,135246.91352317546,2250,10,841.025641025641,38,1,17,32.4203033116682,0.6570723684210527,41.105769230769226,1035.5769230769224,27.252024291497957,0
2254,4,0,0,39,0.0,0.0,1.0,39,850,700,150,0.8235294117647058,10,7,3,337.84131495332633,0.3633040935672514,0.056062805572963725,0.2134232723845213,134163.10683988954,1265.1680866023694,135428.27492649193,2251,11,842.025641025641,38,1,17,32.24880547248291,0.6581688596491229,40.99893162393162,1036.0042735042725,27.263270355375592,0
2255,4,0,1,38,0.0,0.02564102564102564,0.9743589743589743,39,1050,800,250,0.7619047619047619,13,8,5,340.1776678725735,0.3622638326585695,0.06212082778447203,0.21603953462273873,134356.87413251487,1341.0416210095425,135697.9157535244,2252,12,843.025641025641,38,1,18,31.994967710909577,0.6600877192982457,40.8119658119658,1036.7521367521347,27.28295096716144,0
2256,4,0,0,38,0.0,0.0,1.0,38,550,400,150,0.7272727272727273,7,4,3,343.842125274165,0.35828591749644384,0.06017105819987956,0.21782813459057693,134266.52912434592,1633.2977454601364,135899.82686980607,2253,13,865.8421052631579,37,1,19,31.99014317957399,0.6610360360360361,40.89912280701754,1036.4035087719296,28.010905642484584,0
2257,4,0,0,38,0.0,0.0,1.0,38,1000,900,100,0.9,11,9,2,344.7313910576298,0.35821183025130393,0.0599452310980495,0.2190712388333969,134380.1939058172,1665.01423514928,136045.20814096648,2254,14,866.8421052631579,37,1,20,31.853673152848277,0.6621621621621622,40.78947368421053,1036.8421052631581,28.022759601706976,0
2258,4,0,0,38,0.0,0.0,1.0,38,850,700,150,0.8235294117647058,10,7,3,343.22059277071804,0.35815256045519206,0.0601424279514855,0.21879156385518833,134493.906779009,1632.2156817482412,136126.12246075724,2255,15,867.8421052631579,37,1,20,31.77942212825934,0.6632882882882882,40.679824561403514,1037.2807017543867,28.03461356092937,0
2259,4,0,0,38,0.0,0.0,1.0,38,1400,1200,200,0.8571428571428571,16,12,4,342.21776662767604,0.35853781412991936,0.054844952618231746,0.21883438806515734,134607.66774392125,1613.0270852570065,136220.69482917825,2256,16,868.8421052631579,37,1,20,31.692025922795146,0.6644144144144144,40.57017543859649,1037.7192982456145,28.046467520151744,0
2260,4,0,0,38,0.0,0.0,1.0,38,600,400,200,0.6666666666666666,8,4,4,342.75146653405693,0.3589378852536747,0.05167236633580763,0.2193470338569878,134636.1154994807,1629.3452071791385,136265.46070665983,2257,17,869.8421052631579,37,1,20,31.649828314844164,0.6646959459459458,40.54276315789474,1037.8289473684217,28.049431009957345,0
2261,4,0,0,38,0.0,0.0,1.0,38,1200,1100,100,0.9166666666666666,13,11,2,346.55412784825273,0.35976766239924135,0.04807328841749481,0.22230179420509869,134721.47680055402,1737.656779008924,136459.13357956294,2258,18,870.8421052631579,37,1,20,31.46607872130686,0.6655405405405406,40.46052631578947,1038.157894736842,28.05832147937411,0
2262,4,0,0,38,0.0,0.0,1.0,38,1150,800,350,0.6956521739130435,15,8,7,342.2687446136169,0.3597232100521574,0.041570026761819756,0.21482825459790836,133925.82333025546,1567.7246845183122,135493.54801477378,2259,19,871.8421052631579,37,1,18,32.371115819209045,0.6576576576576576,41.228070175438596,1035.0877192982455,27.975343764817445,1
2263,4,0,0,38,0.0,0.0,1.0,38,550,300,250,0.5454545454545454,8,3,5,342.2687446136169,0.3597232100521574,0.041570026761819756,0.21482825459790836,133925.82333025546,1567.7246845183122,135493.54801477378,2260,20,872.8421052631579,37,1,18,32.371115819209045,0.6576576576576576,41.228070175438596,1035.0877192982455,27.975343764817445,0
2264,4,0,0,38,0.0,0.0,1.0,38,800,500,300,0.625,11,5,6,338.97550291689794,0.35890825035561874,0.04198877475378571,0.21325420879708637,134010.9592013888,1485.2864583333226,135496.2456597221,2261,21,873.8421052631579,37,1,18,32.37131120053655,0.6585022522522523,41.14583333333333,1035.4166666666658,27.98423423423421,0
2265,4,0,0,38,0.0,0.0,1.0,38,1050,700,350,0.6666666666666666,14,7,7,335.40011451823074,0.3590712422949265,0.04197882259888286,0.2119863332496829,134181.312098434,1400.8854888042351,135582.19758723822,2262,22,874.8421052631579,37,1,19,32.29387148551876,0.6601914414414415,40.9813596491228,1036.0745614035077,28.002015173067775,0
2266,4,0,0,38,0.0,0.0,1.0,38,1100,800,300,0.7272727272727273,14,8,6,335.43372209309615,0.35930832147937414,0.03753153383935981,0.21233651088425015,134238.1204433095,1405.5984774161345,135643.71892072566,2263,23,875.8421052631579,37,1,19,32.23633742461115,0.6607545045045045,40.9265350877193,1036.293859649123,28.007942152679004,0
2267,4,1,0,39,0.02564102564102564,0.0,1.0,39,600,400,200,0.6666666666666666,8,4,4,328.5692921712143,0.36420377867746284,0.0495339195648159,0.2096194367268392,134523.07167251082,1040.0300880268874,135563.1017605377,2264,0,854.3589743589744,38,1,20,32.13032097493991,0.6617324561403508,40.651709401709404,1037.3931623931628,27.299820062977968,0
2268,4,0,0,39,0.0,0.0,1.0,39,900,600,300,0.6666666666666666,12,6,6,326.1947741337421,0.36347278452541615,0.04534800857320165,0.208425465741229,134579.22299409437,979.810703099186,135559.03369719355,2265,1,855.3589743589744,37,2,20,32.13601659093311,0.6641328828828829,40.59758771929825,1037.6096491228072,28.043504030346142,0
2269,4,0,0,39,0.0,0.0,1.0,39,650,400,250,0.6153846153846154,9,4,5,325.9881750793718,0.36347278452541615,0.03966028688691092,0.20861920737838088,134636.11549948054,977.9563182902351,135614.07181777077,2266,2,856.3589743589744,37,2,20,32.084764042965304,0.6646959459459459,40.54276315789473,1037.8289473684206,28.049431009957313,0
2270,4,0,0,39,0.0,0.0,1.0,39,750,500,250,0.6666666666666666,10,5,5,326.09643038525513,0.3633040935672514,0.04261808089362429,0.2094733117590411,134772.56059838182,989.770185002552,135762.3307833844,2267,3,857.3589743589744,38,1,20,31.94623075076311,0.6641995614035088,40.41132478632478,1038.3547008547,27.32512370670263,0
2271,4,0,0,39,0.0,0.0,1.0,39,1200,1000,200,0.8333333333333334,14,10,4,325.18087448883296,0.36333220872694555,0.041889483065953526,0.2096855983772818,134911.26543209868,974.1126543209757,135885.37808641966,2268,4,858.3589743589744,38,1,18,31.832107843137244,0.6655701754385965,40.27777777777777,1038.8888888888882,27.33918128654969,0
2272,4,0,0,39,0.0,0.0,1.0,39,1150,1000,150,0.8695652173913043,13,10,3,324.0807762198976,0.36414754835807467,0.03643572081939528,0.20945738938810243,134994.5225751515,949.8259323179091,135944.3485074694,2269,5,859.3589743589744,38,1,18,31.777954833624605,0.6663925438596492,40.19764957264957,1039.209401709401,27.34761583445792,0
2273,4,0,0,39,0.0,0.0,1.0,39,1150,900,250,0.782608695652174,14,9,5,322.83065311887555,0.36414754835807467,0.0285181320939647,0.20945252774352657,135133.34155161076,925.0369822485181,136058.37853385927,2270,6,860.3589743589744,38,1,18,31.672575010275374,0.6677631578947368,40.06410256410256,1039.7435897435896,27.36167341430499,0
2274,4,0,0,39,0.0,0.0,1.0,39,850,700,150,0.8235294117647058,10,7,3,320.79532959082667,0.3638663967611336,0.029750333222697822,0.20845271950848498,135188.88911717426,873.5928482723236,136062.48196544658,2271,7,861.3589743589744,38,1,18,31.67034792137525,0.668311403508772,40.010683760683754,1039.9572649572642,27.367296446243795,0
2275,4,0,0,39,0.0,0.0,1.0,39,900,700,200,0.7777777777777778,11,7,4,320.477850553257,0.3633040935672514,0.02954326429372678,0.20888977969796624,135300.01849112424,872.1318211702821,136172.1503122945,2272,8,862.3589743589744,38,1,18,31.568340521667682,0.6694078947368421,39.90384615384615,1040.3846153846152,27.378542510121452,0
2276,4,0,0,39,0.0,0.0,1.0,39,800,600,200,0.75,10,6,4,331.93517614293984,0.3633040935672514,0.03331441417378955,0.2124385127314816,134638.4222059899,1184.4734887614443,135822.89569475132,2273,9,863.3589743589744,36,3,21,31.928168402777786,0.6666666666666665,40.54054054054055,1037.8378378378386,28.82882882882885,3
2277,4,0,0,39,0.0,0.0,1.0,39,700,500,200,0.7142857142857143,9,5,4,332.13870629255456,0.36369770580296895,0.028994938539407267,0.21325340334382695,134755.32119957803,1151.4916098531044,135906.81280943114,2274,10,864.3589743589744,36,3,24,31.80653470715835,0.6678240740740741,40.42792792792793,1038.2882882882889,28.84134134134136,0
2278,4,0,0,39,0.0,0.0,1.0,39,550,300,250,0.5454545454545454,8,3,5,331.9217700731484,0.36321974808816915,0.029054955884223688,0.21341691000426272,134806.8651532202,1149.0666599338138,135955.931813154,2275,11,865.3589743589744,37,2,13,31.76087970295285,0.6663851351351351,40.378289473684205,1038.486842105263,28.067211948790888,0
2279,4,0,0,39,0.0,0.0,1.0,39,500,200,300,0.4,8,2,6,330.3909345399753,0.36296671165092215,0.029447218419546672,0.21255660322058906,134828.03397116295,1109.1920291840156,135937.22600034697,2276,12,866.3589743589744,38,1,13,31.779566574083603,0.6647478070175439,40.35790598290598,1038.568376068376,27.330746738641473,0
2280,4,0,0,39,0.0,0.0,1.0,39,850,600,250,0.7058823529411765,11,6,5,332.3955708262342,0.3624044084570401,0.03006352898361575,0.2141737664110984,134883.51875821818,1166.9368425377947,136050.455600756,2277,13,867.3589743589744,38,1,14,31.672323356988585,0.665296052631579,40.304487179487175,1038.7820512820506,27.33636977058028,0
2281,4,0,0,39,0.0,0.0,1.0,39,850,500,350,0.5882352941176471,12,5,7,331.44753818300194,0.36172964462438145,0.03437779200961444,0.21454777771007466,135050.0416050294,1152.4007642997822,136202.4423693292,2278,14,868.3589743589744,38,1,16,31.531375269811893,0.6669407894736843,40.14423076923076,1039.4230769230755,27.353238866396726,0
2282,4,0,0,39,0.0,0.0,1.0,39,650,500,150,0.7692307692307693,8,5,3,331.44753818300194,0.3613922627080522,0.03437779200961444,0.21454777771007466,135050.0416050294,1152.4007642997822,136202.4423693292,2279,15,869.3589743589744,38,1,16,31.531375269811893,0.6669407894736843,40.14423076923076,1039.4230769230755,27.353238866396726,0
2283,4,0,0,39,0.0,0.0,1.0,39,1050,800,250,0.7619047619047619,13,8,5,329.97489249827584,0.3611673414304993,0.03283527024534205,0.21375870199788405,135077.8054003212,1114.456863174787,136192.262263496,2280,16,870.3589743589744,38,1,16,31.5420520726276,0.6672149122807018,40.117521367521356,1039.5299145299127,27.356050382366124,0
2284,4,0,0,39,0.0,0.0,1.0,39,850,500,350,0.5882352941176471,12,5,7,326.3636861222314,0.3613079172289699,0.0309842233393407,0.21174475955610336,135133.34155161047,1020.5230933595981,136153.86464497008,2281,17,871.3589743589744,38,1,16,31.58073879983559,0.667763157894737,40.06410256410255,1039.7435897435873,27.36167341430493,0
2285,4,0,0,39,0.0,0.0,1.0,39,1050,600,450,0.5714285714285714,15,6,9,325.7881531764805,0.360801844354476,0.03776099277331846,0.21202362696030824,135244.44809701212,1012.207794579582,136256.6558915917,2282,18,872.3589743589744,38,1,16,31.485380717611612,0.668859649122807,39.957264957264954,1040.1709401709395,27.37291947818262,0
2286,4,0,0,39,0.0,0.0,1.0,39,1250,900,350,0.72,16,9,7,325.0785304993487,0.360295771479982,0.03796135418312008,0.21221614524555324,135355.60029951046,1000.2399280444054,136355.84022755487,2283,19,873.3589743589744,38,1,17,31.39352327173169,0.6699561403508772,39.850427350427346,1040.5982905982899,27.38416554206026,0
2287,4,0,0,39,0.0,0.0,1.0,39,1300,1000,300,0.7692307692307693,16,10,6,324.2437956940266,0.3595928924876293,0.04862481386183415,0.21265679897940667,135522.41421031478,988.4603970341083,136510.87460734887,2284,20,874.3589743589744,38,1,18,31.249786237088713,0.6716008771929824,39.69017094017094,1041.2393162393157,27.40103463787673,0
2288,4,0,0,39,0.0,0.0,1.0,39,1000,700,300,0.7,13,7,6,326.4596514984336,0.3593398560503824,0.049030438853992386,0.21444263361231314,135578.04167579793,1052.152047264211,136630.19372306214,2285,21,875.3589743589744,38,1,18,31.136942620708517,0.6721491228070176,39.63675213675213,1041.4529914529903,27.406657669815534,0
2289,4,0,0,39,0.0,0.0,1.0,39,550,400,150,0.7272727272727273,7,4,3,324.8000000000002,0.3594523166891588,0.046564102564102816,0.2136842105263158,135633.68055555545,1010.7638888888796,136644.44444444432,2286,22,876.3589743589744,38,1,18,31.125000000000007,0.6726973684210527,39.58333333333333,1041.6666666666658,27.412280701754366,0
2290,4,0,0,39,0.0,0.0,1.0,39,800,600,200,0.75,10,6,4,323.427902885742,0.3593398560503824,0.049636103573757584,0.2131127641176862,135689.33084958722,977.14314413032,136666.47399371755,2287,23,877.3589743589744,38,1,18,31.105585179108566,0.6732456140350878,39.52991452991453,1041.8803418803416,27.417903733693198,0
2291,4,0,0,39,0.0,0.0,1.0,39,950,800,150,0.8421052631578947,11,8,3,333.6289879249231,0.3592273954116059,0.05974740655922628,0.21986296846999648,135693.9688893173,1278.583584320509,136972.5524736378,2288,24,878.3589743589744,35,4,19,30.835277345775015,0.6791666666666668,39.52546296296295,1041.898148148146,29.76851851851846,4
2292,4,1,1,39,0.025,0.025,0.975,40,400,200,200,0.5,6,2,4,324.7112729862083,0.3628205128205128,0.05624079915878011,0.2153419948465024,135919.37543282562,826.9106840566437,136746.28611688226,2289,0,857.375,37,3,17,30.844286715737802,0.6773648648648647,39.309210526315795,1042.7631578947378,28.18278805120913,0
2293,4,0,0,39,0.0,0.0,1.0,39,950,500,450,0.5263157894736842,14,5,9,340.01352873944387,0.3583839406207827,0.09006636196968487,0.2123480717221812,133741.45507812512,1294.7808159722367,135036.23589409736,2290,26,880.3589743589744,39,0,16,32.61371265525345,0.6522435897435896,41.40625000000001,1034.375000000001,26.52243589743592,6
2294,4,0,0,39,0.0,0.0,1.0,39,1700,1400,300,0.8235294117647058,20,14,6,339.2395717378371,0.35841205578047686,0.08901556223344365,0.21217427119018906,133795.33420138914,1277.7343750000239,135073.06857638917,2291,27,881.3589743589744,39,0,16,32.57987649348907,0.6527777777777777,41.35416666666668,1034.5833333333353,26.52777777777783,0
2295,4,0,0,39,0.0,0.0,1.0,39,1050,700,350,0.6666666666666666,14,7,7,339.96206141996686,0.3579059829059829,0.08999385936395443,0.2135615023003557,133957.03667534713,1308.062065972218,135265.09874131935,2292,28,882.3589743589744,39,0,16,32.39962769168847,0.654380341880342,41.197916666666664,1035.2083333333328,26.543803418803407,0
2296,4,0,0,39,0.0,0.0,1.0,39,750,500,250,0.6666666666666666,10,5,5,340.35197098081466,0.35815901934322986,0.08708662229789033,0.2141201640221073,134010.9592013888,1322.1788194444352,135333.13802083323,2293,29,883.3589743589744,39,0,16,32.335680751173705,0.65491452991453,41.14583333333333,1035.4166666666658,26.549145299145277,0
2297,4,0,1,38,0.0,0.02564102564102564,0.9743589743589743,39,550,300,250,0.5454545454545454,8,3,5,341.35584458659275,0.3583839406207827,0.09346517493771556,0.21506716139923326,134064.89257812488,1352.7669270833203,135417.6595052082,2294,30,884.3589743589744,39,0,16,32.25583383625024,0.6554487179487181,41.09374999999999,1035.624999999999,26.554487179487158,0
2298,4,0,0,38,0.0,0.0,1.0,38,800,700,100,0.875,9,7,2,361.21720119158255,0.35567804646752016,0.15583139553925318,0.21904756313768767,132645.51487508198,1982.7683267586922,134628.28320184068,2295,31,904.7105263157895,38,0,14,33.16544803982576,0.643092105263158,42.46794871794871,1030.1282051282035,27.108636977057987,7
2299,4,1,1,38,0.02564102564102564,0.02564102564102564,0.9743589743589743,39,750,600,150,0.8,9,6,3,357.39732174626926,0.3611954565901934,0.15771121853158632,0.2180960968338209,132880.8648003473,1698.2530381944498,134579.11783854174,2296,0,882.4871794871794,39,0,15,33.027295076446414,0.6436965811965811,42.239583333333336,1031.0416666666672,26.436965811965827,0
2300,4,0,0,38,0.0,0.0,1.0,38,850,700,150,0.8235294117647058,10,7,3,365.37810017078783,0.35680417259364633,0.16360631055250052,0.22254847919493437,132810.65088757395,2105.2206607495045,134915.87154832346,2297,33,906.7105263157895,38,0,15,32.892179726368155,0.6447368421052632,42.30769230769231,1030.7692307692307,27.125506072874494,0
2301,4,0,1,37,0.0,0.02631578947368421,0.9736842105263158,38,1300,1000,300,0.7692307692307693,16,10,6,367.32132328530577,0.35686344238975815,0.1652398193993061,0.22439148179428936,132920.79863393964,2164.9287292716735,135085.7273632113,2298,34,907.7105263157895,38,0,15,32.73134238154441,0.6458333333333334,42.2008547008547,1031.196581196581,27.136752136752133,0
2302,4,0,0,37,0.0,0.0,1.0,37,1350,1300,50,0.9629629629629629,14,13,1,373.79201905543096,0.35594969969969975,0.1646562573630408,0.22860128291517434,132962.84072983984,2540.0897391504955,135502.93046899032,2299,35,917.4324324324324,37,0,15,32.52223757885038,0.6480855855855856,42.16008771929824,1031.359649122806,27.87458511142719,0
2303,4,0,0,37,0.0,0.0,1.0,37,1000,800,200,0.8,12,8,4,374.6560344039004,0.35607482482482483,0.16218513944337576,0.22982485552416557,133075.95245652494,2571.5417243767133,135647.49418090165,2300,36,918.4324324324324,37,0,15,32.386202621324834,0.6492117117117118,42.05043859649122,1031.798245614034,27.886439070649566,0
2304,4,0,0,37,0.0,0.0,1.0,37,700,500,200,0.7142857142857143,9,5,4,375.37291059650204,0.35623123123123124,0.16362618593101885,0.2311403501155046,133217.40974386342,2601.241367536157,135818.65111139958,2301,37,919.4324324324324,37,0,15,32.225504514073286,0.6506193693693694,41.91337719298245,1032.3464912280697,27.90125651967756,0
2305,4,0,0,37,0.0,0.0,1.0,37,650,500,150,0.7692307692307693,8,5,3,374.7079213674151,0.35670045045045046,0.16033663229924922,0.23090639971175275,133245.71021852875,2585.6446214219704,135831.3548399507,2302,38,920.4324324324324,37,0,15,32.214227555933164,0.6509009009009009,41.8859649122807,1032.456140350877,27.90422000948316,0
2306,4,0,0,37,0.0,0.0,1.0,37,950,800,150,0.8421052631578947,11,8,3,374.03441044000425,0.35660660660660665,0.16053772791587395,0.23066680046584911,133274.01369892643,2569.8134281701878,135843.82712709662,2303,39,921.4324324324324,37,0,15,32.203174223921266,0.6511824324324325,41.85855263157894,1032.565789473683,27.90718349928873,0
2307,4,0,0,37,0.0,0.0,1.0,37,650,400,250,0.6153846153846154,9,4,5,373.3129002498164,0.3564502002002002,0.15832288387761362,0.23057273491495206,133330.62967691972,2554.808811365021,135885.43848828474,2304,40,922.4324324324324,37,0,15,32.16492815939412,0.6517454954954955,41.80372807017543,1032.7850877192975,27.91311047889993,0
2308,4,0,0,37,0.0,0.0,1.0,37,650,500,150,0.7692307692307693,8,5,3,371.3118855396434,0.3566691691691692,0.1578699718827108,0.2295116772823778,133358.94217451513,2503.552054478288,135862.49422899343,2305,41,923.4324324324324,37,0,15,32.18816348195328,0.6520270270270271,41.77631578947368,1032.8947368421045,27.91607396870553,0
2309,4,0,0,37,0.0,0.0,1.0,37,850,700,150,0.8235294117647058,10,7,3,369.16419324336107,0.35604354354354356,0.15280610123017024,0.2287070475300583,133443.89770169646,2452.5417676592588,135896.4394693557,2306,42,924.4324324324324,37,0,15,32.15834925183063,0.6528716216216217,41.69407894736841,1033.2236842105247,27.924964438122288,0
2310,4,0,0,37,0.0,0.0,1.0,37,1150,800,350,0.6956521739130435,15,8,7,367.3023825646536,0.35551176176176175,0.14870606525470942,0.22826462894793187,133559.51126379753,2411.348346005233,135970.85960980275,2307,43,925.4324324324324,36,1,16,32.09046010821804,0.6559606481481481,41.582207207207205,1033.6711711711707,28.713088088088075,0
2311,4,0,0,37,0.0,0.0,1.0,37,1050,700,350,0.6666666666666666,14,7,7,367.449841229157,0.3553553553553554,0.1480716010127776,0.22853587686203652,133588.61395178954,2417.4229973216356,136006.03694911118,2308,44,926.4324324324324,36,1,16,32.057461873638346,0.65625,41.55405405405405,1033.783783783783,28.716216216216196,0
2312,4,0,0,37,0.0,0.0,1.0,37,800,700,100,0.875,9,7,2,367.449841229157,0.3553553553553554,0.1480716010127776,0.22853587686203652,133588.61395178954,2417.4229973216356,136006.03694911118,2309,45,927.4324324324324,36,1,16,32.057461873638346,0.65625,41.55405405405405,1033.783783783783,28.716216216216196,0
2313,4,1,1,37,0.02631578947368421,0.02631578947368421,0.9736842105263158,38,1000,700,300,0.7,13,7,6,356.52829646653265,0.3596194879089616,0.1388380909901874,0.22377839884601505,133925.82333025534,1949.6691289627408,135875.49245921808,2310,0,904.0,37,1,14,32.00211864406781,0.6576576576576577,41.22807017543859,1035.0877192982446,27.97534376481742,0
2314,4,0,0,37,0.0,0.0,1.0,37,1400,1100,300,0.7857142857142857,17,11,6,364.15324378544034,0.35604354354354356,0.1380146061830687,0.22809844288646294,133850.68081172393,2348.431920095775,136199.1127318197,2311,47,929.4324324324324,36,1,14,31.88005586389523,0.6588541666666666,41.30067567567568,1034.7972972972975,28.744369369369377,0
2315,4,0,0,37,0.0,0.0,1.0,37,1000,600,400,0.6,14,6,8,358.49371404513573,0.35604354354354356,0.1135875053744082,0.20838892668043082,131037.0932334713,2068.4247483886847,133105.51798185997,2312,48,930.4324324324324,32,5,18,34.85787396719693,0.6396484375,44.03409090909092,1023.8636363636382,31.995738636363694,7
2316,4,0,0,37,0.0,0.0,1.0,37,600,300,300,0.5,9,3,6,357.51481251168804,0.35594969969969975,0.11016762755357079,0.20799462908678573,131069.41415416806,1971.851405468845,133041.2655596369,2313,49,931.4324324324324,32,5,18,34.850236333744355,0.6399739583333333,44.00252525252526,1023.9898989898999,31.99968434343437,0
2317,4,1,0,38,0.02631578947368421,0.0,1.0,38,1350,1100,250,0.8148148148148148,16,11,5,347.4620364025324,0.3625681602655287,0.11964551804789725,0.20468717147963403,131548.03929077752,1541.5899233467835,133089.62921412432,2314,0,907.8947368421053,33,5,21,34.62437283478678,0.6423611111111112,43.53553921568627,1025.8578431372546,31.086601307189532,0
2318,4,0,0,38,0.0,0.0,1.0,38,850,600,250,0.7058823529411765,11,6,5,347.9704610354248,0.362419985775249,0.11874320340442668,0.2053246420190002,131610.90573637543,1559.3415092752841,133170.2472456507,2315,1,908.8947368421053,33,5,16,34.54792686810782,0.6429924242424242,43.474264705882355,1026.1029411764707,31.094028520499112,0
2319,4,0,0,38,0.0,0.0,1.0,38,400,300,100,0.75,5,3,2,346.26509390447956,0.36170874822190613,0.11867899071422938,0.2046025616552786,131663.90483276636,1518.1228741496534,133182.027706916,2316,2,909.8947368421053,34,4,17,34.5382399566949,0.6412377450980392,43.422619047619044,1026.3095238095232,30.18557422969186,0
2320,4,0,0,38,0.0,0.0,1.0,38,850,700,150,0.8235294117647058,10,7,3,346.3160270829394,0.3606418918918919,0.115971298522215,0.20545543669996108,131816.6737528344,1530.0453514739127,133346.71910430831,2317,3,910.8947368421053,34,4,18,34.38297009042428,0.6427696078431373,43.27380952380952,1026.9047619047615,30.203081232492984,0
2321,4,0,0,38,0.0,0.0,1.0,38,900,700,200,0.7777777777777778,11,7,4,347.1242941386723,0.36067152678994785,0.11663982626942859,0.2062664194096738,131877.8061224489,1555.5980725623467,133433.40419501124,2318,4,911.8947368421053,34,4,18,34.300629732653356,0.6433823529411765,43.21428571428571,1027.1428571428567,30.21008403361343,0
2322,4,1,0,39,0.02564102564102564,0.0,1.0,39,550,200,350,0.36363636363636365,9,2,7,338.8631746647656,0.3672121007647324,0.120489439638376,0.20270178993583243,132130.12695312488,1154.8068576388746,133284.93381076376,2319,0,889.4871794871794,35,4,19,34.2589074636947,0.64375,42.96874999999999,1028.124999999999,29.374999999999975,0
2323,4,0,0,39,0.0,0.0,1.0,39,900,500,400,0.5555555555555556,13,5,8,339.936834351523,0.3667622582096266,0.11779576641703815,0.20366411147763175,132189.6316256214,1187.2249817815293,133376.85660740294,2320,1,890.4871794871794,35,4,19,34.1714734571375,0.6443452380952381,42.91087962962962,1028.3564814814802,29.381613756613717,0
2324,4,0,0,39,0.0,0.0,1.0,39,750,400,350,0.5333333333333333,11,4,7,340.6438254311107,0.36712775528565,0.1161419878647294,0.20440929619218612,132249.14969403695,1209.9712523576547,133459.1209463946,2321,2,891.4871794871794,35,4,20,34.09345579685683,0.6449404761904762,42.853009259259245,1028.587962962961,29.388227513227456,0
2325,4,0,0,39,0.0,0.0,1.0,39,1000,700,300,0.7,13,7,6,340.0005171214473,0.3669871794871795,0.1142812637918953,0.2043451383835387,132308.6811583716,1197.0040027005832,133505.68516107218,2322,3,892.4871794871794,35,4,21,34.05016031049612,0.6455357142857144,42.79513888888887,1028.8194444444418,29.394841269841194,0
2326,4,1,0,40,0.025,0.0,1.0,40,900,800,100,0.8888888888888888,10,8,2,334.9859866178515,0.37138087606837605,0.11837078651685418,0.20309095918929657,132636.3436642659,886.2934295695932,133522.6370938355,2323,0,871.15,35,5,14,33.8501872659176,0.648809523809524,42.47685185185184,1030.092592592591,29.431216931216888,0
2327,4,0,0,40,0.0,0.0,1.0,40,1050,700,350,0.6666666666666666,14,7,7,336.42900723586115,0.3710870726495727,0.10954453554981503,0.20445238576251654,132725.77649444848,930.5602441272033,133656.3367385757,2324,1,872.15,35,5,14,33.723300198435,0.6497023809523811,42.39004629629628,1030.439814814813,29.441137566137513,0
2328,4,0,0,40,0.0,0.0,1.0,40,850,500,350,0.5882352941176471,12,5,7,336.78191817845004,0.3712072649572649,0.11334231805929917,0.2048296584331224,132755.59413580218,941.9367283950248,133697.5308641972,2325,2,873.15,35,5,14,33.68429919137465,0.6500000000000001,42.36111111111109,1030.5555555555532,29.444444444444375,0
2329,4,0,0,40,0.0,0.0,1.0,40,1000,900,100,0.9,11,9,2,337.45219439961613,0.369911858974359,0.11592644581695688,0.2054006692500736,132785.4151261357,961.7459437156738,133747.16106985137,2326,3,874.15,35,5,14,33.63711865992888,0.6502976190476192,42.33217592592591,1030.671296296294,29.44775132275126,0
2330,4,0,0,40,0.0,0.0,1.0,40,1000,800,200,0.8,12,8,4,333.9537144712277,0.3699786324786325,0.10561926605504635,0.2038453473132372,132891.02447041616,875.8902483564441,133766.9147187726,2327,4,875.15,36,4,15,33.621395806028836,0.6493055555555557,42.22972972972972,1031.0810810810794,28.641141141141095,0
2331,4,0,0,40,0.0,0.0,1.0,40,900,800,100,0.8888888888888888,10,8,2,339.834613524359,0.37035256410256406,0.08593609360936139,0.20408446250030407,132278.91375171457,1000.8913364690911,133279.80508818367,2328,5,876.15,35,5,20,34.084345934593465,0.6452380952380953,42.82407407407407,1028.7037037037028,29.391534391534364,3
2332,4,0,1,39,0.0,0.025,0.975,40,1100,900,200,0.8181818181818182,13,9,4,341.7528561359799,0.37013888888888885,0.09281376518218609,0.2058852572331389,132398.00347222207,1049.586334019179,133447.58980624125,2329,6,877.15,33,7,20,33.91531713900134,0.6508838383838385,42.70833333333332,1029.1666666666654,31.18686868686865,0
2333,4,1,1,39,0.025,0.025,0.975,40,1000,600,400,0.6,14,6,8,341.41589350333004,0.366786858974359,0.09185319680914406,0.20585442135925824,132429.53619100817,1042.7096849769207,133472.2458759851,2330,0,877.875,33,7,21,33.89230364725959,0.651199494949495,42.67769607843137,1029.2892156862738,31.19058229352345,0
2334,4,0,0,39,0.0,0.0,1.0,39,500,500,0,1.0,5,5,0,349.50494100509474,0.36282613585245166,0.09584152016918979,0.20972656385633173,132249.14969403698,1444.346252357653,133693.49594639463,2331,8,901.3846153846154,35,4,21,33.865594876411215,0.6449404761904762,42.853009259259245,1028.5879629629612,29.388227513227463,0
2335,4,0,0,39,0.0,0.0,1.0,39,1100,700,400,0.6363636363636364,15,7,8,349.34007827199355,0.3626855600539811,0.10319863863170986,0.2101240389606237,132338.45191400874,1446.2250300068413,133784.67694401558,2332,9,902.3846153846154,35,4,21,33.779996250468685,0.6458333333333335,42.766203703703695,1028.9351851851839,29.39814814814811,0
2336,4,0,0,39,0.0,0.0,1.0,39,1000,800,200,0.8,12,8,4,346.99798390401406,0.36237629329734594,0.10443267933146494,0.20904512688851598,132398.00347222228,1388.3948473936948,133786.39831961598,2333,10,903.3846153846154,33,6,22,33.78036437246964,0.6508838383838383,42.708333333333336,1029.166666666667,31.186868686868696,0
2337,4,0,0,39,0.0,0.0,1.0,39,1100,800,300,0.7272727272727273,14,8,6,341.7805823420514,0.3619545659019343,0.09798071518138984,0.2063909219234586,132487.35592689033,1256.3211323302337,133743.67705922056,2334,11,904.3846153846154,35,4,22,33.824831365935914,0.6473214285714286,42.62152777777777,1029.513888888888,29.414682539682513,0
2338,4,0,0,39,0.0,0.0,1.0,39,1000,800,200,0.8,12,8,4,340.74193978144746,0.36161718398560505,0.09485277590469754,0.20625318232485168,132576.73852237655,1234.8910108024677,133811.62953317902,2335,12,905.3846153846154,35,4,22,33.7618004045853,0.6482142857142856,42.53472222222222,1029.861111111111,29.424603174603174,0
2339,4,0,0,39,0.0,0.0,1.0,39,500,300,200,0.6,7,3,4,340.48643249604845,0.3611673414304993,0.09125197011476383,0.20626199882793284,132606.53941883135,1230.1455064728962,133836.68492530426,2336,13,906.3846153846154,35,4,23,33.73845844102334,0.6485119047619048,42.50578703703703,1029.976851851851,29.42791005291003,0
2340,4,0,0,39,0.0,0.0,1.0,39,300,100,200,0.3333333333333333,5,1,4,340.48643249604845,0.3611673414304993,0.09125197011476383,0.20626199882793284,132606.53941883135,1230.1455064728962,133836.68492530426,2337,14,907.3846153846154,35,4,23,33.73845844102334,0.6485119047619048,42.50578703703703,1029.976851851851,29.42791005291003,0
2341,4,0,0,39,0.0,0.0,1.0,39,650,400,250,0.6153846153846154,9,4,5,341.2563476297923,0.3610548807917229,0.08840838972284915,0.2070567655250703,132666.15125868047,1254.6332465277728,133920.78450520826,2338,15,908.3846153846154,35,4,14,33.65878833838896,0.6491071428571429,42.447916666666664,1030.2083333333328,29.434523809523796,0
2342,4,0,0,39,0.0,0.0,1.0,39,1200,1000,200,0.8333333333333334,14,10,4,340.72715659005877,0.36113922627080525,0.09218792286387201,0.2075592377969263,132815.2394654492,1250.7517789780518,134065.99124442725,2339,16,909.3846153846154,35,4,16,33.52281233625273,0.6505952380952381,42.30324074074074,1030.7870370370367,29.451058201058192,0
2343,4,0,0,39,0.0,0.0,1.0,39,850,500,350,0.5882352941176471,12,5,7,343.1799941337442,0.36001461988304095,0.09443907379275429,0.21005632607966532,132994.25582990394,1328.1935871056173,134322.44941700954,2340,17,910.3846153846154,35,4,17,33.28003441053262,0.6523809523809524,42.129629629629626,1031.481481481481,29.470899470899457,0
2344,4,0,0,39,0.0,0.0,1.0,39,1100,700,400,0.6363636363636364,15,7,8,340.89295968785393,0.36040823211875844,0.09693326392737034,0.2090536343145996,133065.2506391527,1272.2014243973772,134337.4520635501,2341,18,911.3846153846154,36,3,17,33.26784544859203,0.6510416666666666,42.060810810810814,1031.756756756757,28.65990990990992,0
2345,4,0,0,39,0.0,0.0,1.0,39,650,400,250,0.6153846153846154,9,4,5,342.83128786323493,0.36052069275753484,0.09973220057253651,0.21040610118491776,133094.29943034257,1325.7780161918695,134420.07744653444,2342,19,912.3846153846154,36,3,17,33.18873003746954,0.6513310185185186,42.03265765765766,1031.8693693693697,28.663038038038046,0
2346,4,0,0,39,0.0,0.0,1.0,39,750,400,350,0.5333333333333333,11,4,7,344.0830461011551,0.3600989653621232,0.10638860059873534,0.2115515161953087,133160.8178117307,1363.675962796261,134524.49377452696,2343,20,913.3846153846154,37,2,17,33.089765041255006,0.6500563063063062,41.96820175438597,1032.1271929824575,27.895329540066417,0
2347,4,0,0,39,0.0,0.0,1.0,39,700,300,400,0.42857142857142855,11,3,8,344.6998854233801,0.35891812865497075,0.10709443455249357,0.2127381075306286,133302.3201850569,1389.8588988919646,134692.17908394884,2344,21,914.3846153846154,37,2,19,32.93206271678346,0.6514639639639639,41.83114035087719,1032.675438596491,27.91014698909435,0
2348,4,0,0,39,0.0,0.0,1.0,39,900,800,100,0.8888888888888888,10,8,2,345.2752196392914,0.3588337831758885,0.11047961239044057,0.21341814757231778,133358.94217451522,1409.1076100338587,134768.04978454908,2345,22,915.3846153846154,37,2,20,32.86049186128803,0.652027027027027,41.776315789473685,1032.8947368421052,27.916073968705547,0
2349,4,0,0,39,0.0,0.0,1.0,39,1250,1100,150,0.88,14,11,3,346.91891830491323,0.3578778677462888,0.10959303916382424,0.21545759624327243,133535.54672481742,1465.3938518878927,135000.94057670532,2346,23,916.3846153846154,33,6,20,32.64119437198641,0.6622474747474747,41.60539215686275,1033.5784313725494,31.32055852644089,0
2350,4,0,0,39,0.0,0.0,1.0,39,700,500,200,0.7142857142857143,9,5,4,348.64851670180633,0.3572312190733244,0.11124279055068342,0.2172744596698552,133662.2407847942,1520.2283977316304,135182.46918252585,2347,24,917.3846153846154,33,6,21,32.46968080903848,0.663510101010101,41.482843137254896,1034.0686274509796,31.33541295305999,0
2351,4,0,0,39,0.0,0.0,1.0,39,900,800,100,0.8888888888888888,10,8,2,346.4256036867169,0.3575123706702654,0.1075925647222693,0.2163977045603078,133749.15143140577,1466.826105442166,135215.97753684793,2348,25,918.3846153846154,34,5,17,32.44020217132773,0.6620710784313726,41.39880952380952,1034.404761904761,30.42366946778709,0
2352,4,0,0,39,0.0,0.0,1.0,39,850,600,250,0.7058823529411765,11,6,5,347.5864948414092,0.3570062977957715,0.11546131426481177,0.2176672776052974,133841.52494331056,1504.3013038548627,135345.82624716542,2349,26,919.3846153846154,34,5,18,32.317792222733544,0.6629901960784315,41.3095238095238,1034.761904761904,30.43417366946776,0
2353,4,0,0,39,0.0,0.0,1.0,39,1050,900,150,0.8571428571428571,12,9,3,349.3005045116091,0.3574842555105713,0.11644379469980382,0.21957083716488718,133981.00090288496,1559.926242069617,135540.92714495456,2350,27,920.3846153846154,35,4,18,32.13399012483697,0.6622023809523809,41.17476851851852,1035.300925925926,29.58002645502646,0
2354,4,0,0,39,0.0,0.0,1.0,39,600,200,400,0.3333333333333333,10,2,8,349.5311216935158,0.3575123706702654,0.12170244717467282,0.22007423967571343,134040.92084887266,1570.2946834276495,135611.2155323003,2351,28,921.3846153846154,35,4,19,32.0681280503707,0.662797619047619,41.11689814814815,1035.5324074074078,29.586640211640223,0
2355,4,0,0,39,0.0,0.0,1.0,39,850,600,250,0.7058823529411765,11,6,5,350.37185238645304,0.356865721997301,0.12427688525576541,0.22096389760439525,134100.85419077936,1597.0329378858046,135697.88712866517,2352,29,922.3846153846154,35,4,19,31.986464968152855,0.6633928571428571,41.05902777777778,1035.7638888888891,29.593253968253975,0
2356,4,0,0,39,0.0,0.0,1.0,39,550,300,250,0.5454545454545454,8,3,5,350.2043131311837,0.3565283400809716,0.12623141949474248,0.22121939356649434,134160.80092860508,1596.7382276663188,135757.5391562714,2353,30,923.3846153846154,35,4,19,31.930906230216365,0.6639880952380952,41.001157407407405,1035.99537037037,29.599867724867714,0
2357,4,0,0,39,0.0,0.0,1.0,39,800,600,200,0.75,10,6,4,349.35322352882235,0.3564158794421952,0.12241133898678869,0.22104306786244154,134220.76106234998,1578.0911083247624,135798.85217067474,2354,31,924.3846153846154,35,4,19,31.893057261997846,0.6645833333333333,40.94328703703704,1036.226851851852,29.606481481481485,0
2358,4,0,0,39,0.0,0.0,1.0,39,550,200,350,0.36363636363636365,9,2,7,349.75884447362404,0.35633153396311296,0.12580852982862978,0.22166245238933519,134280.73459201402,1593.1749131944541,135873.9095052085,2355,32,925.3846153846154,35,4,20,31.82265494137353,0.6651785714285714,40.88541666666667,1036.4583333333344,29.61309523809527,0
2359,4,0,0,39,0.0,0.0,1.0,39,1200,1000,200,0.8333333333333334,14,10,4,347.7133073342039,0.35683760683760685,0.1210091538289797,0.22090892248934751,134370.7200038581,1544.497492283957,135915.21749614205,2356,33,926.3846153846154,35,4,20,31.785833891493645,0.6660714285714285,40.798611111111114,1036.8055555555559,29.623015873015884,0
2360,4,0,0,39,0.0,0.0,1.0,39,800,700,100,0.875,9,7,2,343.46262313825616,0.356612685560054,0.11337899621764835,0.21892688681117017,134490.74743870032,1438.5089806241494,135929.25641932446,2357,34,927.3846153846154,35,4,20,31.77629621364278,0.6672619047619047,40.682870370370374,1037.268518518519,29.636243386243397,0
2361,4,0,0,39,0.0,0.0,1.0,39,950,700,250,0.7368421052631579,12,7,5,340.1285923931407,0.356893837156995,0.1115714886206689,0.2176968656666163,134640.85708429795,1359.0410397376654,135999.89812403562,2358,35,928.3846153846154,35,4,21,31.713156574105064,0.66875,40.53819444444445,1037.847222222223,29.652777777777803,0
2362,4,0,0,39,0.0,0.0,1.0,39,1100,1000,100,0.9090909090909091,12,10,2,340.92367634254526,0.35683760683760685,0.10961402666163478,0.21856643696328024,134700.9243853954,1384.5468696416515,136085.47125503706,2359,36,929.3846153846154,35,4,21,31.632683874084808,0.669345238095238,40.48032407407408,1038.078703703705,29.659391534391574,0
2363,4,0,0,39,0.0,0.0,1.0,39,1300,1200,100,0.9230769230769231,14,12,2,342.446166604707,0.3556286549707602,0.10564925270807612,0.22081873501751806,134911.26543209876,1439.96913580247,136351.23456790124,2360,37,930.3846153846154,35,4,16,31.383689839572185,0.6714285714285714,40.27777777777778,1038.888888888889,29.682539682539684,0
2364,4,0,0,39,0.0,0.0,1.0,39,1250,800,450,0.64,17,8,9,341.73441599992066,0.3554880791722897,0.1050311232939296,0.2210933037232916,135031.53399348422,1428.9844821673544,136460.51847565157,2361,38,931.3846153846154,35,4,17,31.282479584261313,0.6726190476190477,40.16203703703704,1039.351851851852,29.6957671957672,0
2365,4,0,0,39,0.0,0.0,1.0,39,1150,700,450,0.6086956521739131,16,7,9,344.7922607298609,0.3552631578947369,0.101074771821406,0.22437712144672395,135242.13291162965,1526.0881505058144,136768.22106213548,2362,39,932.3846153846154,35,4,17,30.993495233856315,0.674702380952381,39.95949074074073,1040.162037037036,29.718915343915317,0
2366,4,0,0,39,0.0,0.0,1.0,39,700,400,300,0.5714285714285714,10,4,6,343.4040224527231,0.3550101214574899,0.09845606107288374,0.22366053288442556,135272.23186728384,1490.6057098765314,136762.8375771604,2363,40,933.3846153846154,35,4,17,30.999666221628832,0.675,39.93055555555555,1040.277777777777,29.722222222222197,0
2367,4,0,0,39,0.0,0.0,1.0,39,1200,900,300,0.75,15,9,6,341.45620397472385,0.3545602789023841,0.10210230754977845,0.22369982190478052,135483.01832829625,1452.3034282835783,136935.32175657983,2364,41,934.3846153846154,35,4,18,30.840860663331473,0.6770833333333335,39.728009259259245,1041.0879629629612,29.74537037037032,0
2368,4,0,0,39,0.0,0.0,1.0,39,1400,1100,300,0.7857142857142857,17,11,6,340.9514362088346,0.35450404858299595,0.10514234387085497,0.22412649847160723,135604.35593955452,1446.8999827530324,137051.25592230755,2365,42,935.3846153846154,36,3,18,30.733502721014872,0.6762152777777777,39.61148648648649,1041.5540540540549,28.93205705705708,0
2369,4,0,0,39,0.0,0.0,1.0,39,1000,900,100,0.9,11,9,2,339.58763876148646,0.35405420602789023,0.11058479583556746,0.22399477031494242,135726.7024518138,1418.2284212990983,137144.9308731129,2366,43,936.3846153846154,34,5,19,30.647587493811656,0.6816789215686276,39.494047619047606,1042.0238095238074,30.64775910364139,0
2370,4,0,0,39,0.0,0.0,1.0,39,1050,800,250,0.7619047619047619,13,8,5,339.9053033576962,0.3544478182636077,0.11155530173234363,0.22459403252050028,135788.7347647391,1431.0622165532739,137219.7969812924,2367,44,937.3846153846154,34,5,19,30.577765086617173,0.6822916666666667,39.4345238095238,1042.261904761904,30.65476190476188,0
2371,4,0,0,39,0.0,0.0,1.0,39,800,500,300,0.625,11,5,6,341.0127499426617,0.35385739991003146,0.11131600515162132,0.2263084613255844,135943.8775510203,1471.719104308372,137415.59665532867,2368,45,938.3846153846154,34,5,14,30.395024733637744,0.6838235294117647,39.28571428571428,1042.857142857142,30.672268907562998,0
2372,4,0,0,39,0.0,0.0,1.0,39,1350,1100,250,0.8148148148148148,16,11,5,342.94011370943906,0.35374493927125505,0.11325468993200682,0.2283835225341579,136068.05555555524,1532.638888888854,137600.6944444441,2369,46,939.3846153846154,34,5,14,30.22164536741214,0.6850490196078434,39.16666666666665,1043.3333333333308,30.686274509803845,0
2373,4,0,0,39,0.0,0.0,1.0,39,650,500,150,0.7692307692307693,8,5,3,342.94011370943906,0.35374493927125505,0.11325468993200682,0.2283835225341579,136068.05555555524,1532.638888888854,137600.6944444441,2370,47,940.3846153846154,34,5,14,30.22164536741214,0.6850490196078434,39.16666666666665,1043.3333333333308,30.686274509803845,0
2374,4,0,0,39,0.0,0.0,1.0,39,950,700,250,0.7368421052631579,12,7,5,342.6113841440281,0.35349190283400805,0.11552646433449465,0.22876420447758491,136161.22626133767,1530.0772392290025,137691.30350056666,2371,48,941.3846153846154,34,5,14,30.137874985741984,0.685968137254902,39.07738095238094,1043.6904761904748,30.69677871148455,0
2375,4,0,0,39,0.0,0.0,1.0,39,500,400,100,0.8,6,4,2,341.08709974621985,0.35312640575798465,0.1120938417756252,0.22804036713203496,136206.9605865267,1491.6874303411948,137698.6480168679,2372,49,942.3846153846154,35,4,14,30.13233636397235,0.6842261904761906,39.0335648148148,1043.8657407407388,29.824735449735396,0
2376,4,0,0,39,0.0,0.0,1.0,39,500,300,200,0.6,7,3,4,343.4741395451408,0.35276090868196136,0.1121144679508499,0.2300282266396966,136267.3761815199,1560.8639564043028,137828.2401379242,2373,50,943.3846153846154,35,4,14,30.010184569338215,0.6848214285714287,38.975694444444436,1044.097222222221,29.831349206349174,0
2377,4,0,0,39,0.0,0.0,1.0,39,800,500,300,0.625,11,5,6,344.63222350964156,0.3524797570850202,0.12238369202358146,0.2315938806533517,136388.24755926343,1600.7570033864713,137989.0045626499,2374,51,944.3846153846154,35,4,14,29.860226223453356,0.6860119047619049,38.859953703703695,1044.5601851851843,29.844576719576693,0
2378,4,0,0,39,0.0,0.0,1.0,39,750,300,450,0.4,12,3,9,345.13731387999985,0.3521986054880792,0.12454050123006466,0.23213184762152567,136418.47377614863,1616.6211205418092,138035.09489669045,2375,52,945.3846153846154,35,4,14,29.817102444789118,0.6863095238095239,38.831018518518505,1044.6759259259243,29.847883597883552,0
2379,4,0,1,38,0.0,0.02564102564102564,0.9743589743589743,39,1150,900,250,0.782608695652174,14,9,5,343.3916967137431,0.3514676113360324,0.12243866567861716,0.2319499187002102,136569.6550952716,1579.3771165551889,138149.0322118268,2376,53,946.3846153846154,35,4,15,29.71304857343225,0.6877976190476192,38.68634259259258,1045.2546296296282,29.864417989417948,0
2380,4,0,0,38,0.0,0.0,1.0,38,600,400,200,0.6666666666666666,8,4,4,351.1887078838646,0.3490398293029872,0.12741040635777479,0.2361441311632881,136409.83737244888,1981.118905895679,138390.95627834456,2377,54,968.7105263157895,34,4,15,29.66761633428299,0.6884191176470589,38.83928571428571,1044.6428571428564,30.724789915966365,0
2381,4,0,0,38,0.0,0.0,1.0,38,850,600,250,0.7058823529411765,11,6,5,353.63214385885817,0.34924727358937885,0.12576830591917854,0.23820639498458904,136472.02558106565,2052.1789965986254,138524.2045776643,2378,55,969.7105263157895,34,4,15,29.542174623067872,0.6890318627450981,38.7797619047619,1044.8809523809516,30.73179271708681,0
2382,4,0,0,38,0.0,0.0,1.0,38,1000,800,200,0.8,12,8,4,353.49283395000185,0.3487434803224277,0.12475644630427873,0.23853294306280295,136534.22796201817,2052.7742346938776,138587.00219671204,2379,56,970.7105263157895,34,4,15,29.484185746288485,0.6896446078431373,38.720238095238095,1045.1190476190477,30.738795518207287,0
2383,4,0,0,38,0.0,0.0,1.0,38,900,700,200,0.7777777777777778,11,7,4,351.78532622126573,0.34853603603603606,0.12071698289124089,0.2378237325172507,136599.90140603547,2010.7681755829708,138610.66958161845,2380,57,971.7105263157895,35,3,15,29.46375848833776,0.6880952380952381,38.6574074074074,1045.3703703703688,29.867724867724824,0
2384,4,0,0,38,0.0,0.0,1.0,38,900,600,300,0.6666666666666666,12,6,6,351.1699107786266,0.3475432669511617,0.11858852998572811,0.23802101604537823,136690.66043220588,2000.3294056498548,138690.98983785574,2381,58,972.7105263157895,35,3,16,29.389988009592322,0.6889880952380953,38.57060185185185,1045.7175925925922,29.87764550264549,0
2385,4,0,0,38,0.0,0.0,1.0,38,1100,900,200,0.8181818181818182,13,9,4,347.8056102903595,0.34686166429587484,0.11423472198931517,0.23657242285074925,136814.31405895698,1916.9605485262605,138731.27460748324,2382,59,973.7105263157895,34,4,18,29.355608026096196,0.6924019607843137,38.452380952380956,1046.1904761904768,30.77030812324932,0
2386,4,0,0,38,0.0,0.0,1.0,38,1050,800,250,0.7619047619047619,13,8,5,348.3084262784686,0.3464615931721195,0.11202990417018266,0.23797016256927553,136970.04145408171,1941.5639172335652,138911.6053713153,2383,60,974.7105263157895,34,4,16,29.18846430873042,0.6939338235294117,38.30357142857143,1046.785714285715,30.78781512605044,0
2387,4,0,0,38,0.0,0.0,1.0,38,750,400,350,0.5333333333333333,11,4,7,347.8011316483721,0.3459281650071124,0.10894904382374748,0.2382600275684643,137063.52040816328,1934.1695011337893,138997.68990929707,2384,61,975.7105263157895,34,4,16,29.10934894649082,0.6948529411764706,38.214285714285715,1047.1428571428573,30.798319327731097,0
2388,4,0,0,38,0.0,0.0,1.0,38,1100,1000,100,0.9090909090909091,12,10,2,345.6285216471134,0.3453058321479374,0.10775446970648539,0.23740713208219758,137157.03125000003,1881.0763888888891,139038.1076388889,2385,62,976.7105263157895,34,4,18,29.0738530893662,0.6957720588235294,38.125,1047.5000000000002,30.80882352941177,0
2389,4,0,0,38,0.0,0.0,1.0,38,1100,900,200,0.8181818181818182,13,9,4,345.2027376033058,0.34499466571834997,0.10505382775119654,0.23732688210227273,137188.20861678003,1871.549036281179,139059.7576530612,2386,63,977.7105263157895,34,4,18,29.05421401515152,0.696078431372549,38.095238095238095,1047.6190476190475,30.812324929971986,0
2390,4,0,0,38,0.0,0.0,1.0,38,650,400,250,0.6153846153846154,9,4,5,346.53745474487545,0.34472795163584635,0.10886281825900812,0.2386715709440059,137250.57397959192,1912.4929138322125,139163.06689342414,2387,64,978.7105263157895,34,4,18,28.9576706051655,0.6966911764705881,38.03571428571429,1047.8571428571436,30.819327731092457,0
2391,4,0,1,37,0.0,0.02631578947368421,0.9736842105263158,38,950,400,550,0.42105263157894735,15,4,11,344.29275555943997,0.34462422949265054,0.10472847312627831,0.237645975178833,137326.81755829908,1856.1256858710544,139182.94324417014,2388,65,979.7105263157895,35,3,18,28.94121760895169,0.6952380952380952,37.96296296296296,1048.1481481481483,29.94708994708995,0
2392,4,0,0,37,0.0,0.0,1.0,37,900,600,300,0.6666666666666666,12,6,6,342.9757495722535,0.34434434434434436,0.077424283967086,0.23021623955603515,136347.6633361678,1952.7884070294829,138300.4517431973,2389,66,988.4864864864865,34,3,18,29.94367187203162,0.6878063725490196,38.898809523809526,1044.404761904762,30.71778711484594,2
2393,4,0,0,37,0.0,0.0,1.0,37,650,200,450,0.3076923076923077,11,2,9,342.5978685237944,0.3439376876876877,0.07887887887887901,0.23036753228324125,136409.8373724491,1946.743905895709,138356.58127834482,2390,67,989.4864864864865,34,3,18,29.891975308641975,0.6884191176470588,38.83928571428572,1044.6428571428582,30.72478991596642,0
2394,4,0,0,37,0.0,0.0,1.0,37,900,700,200,0.7777777777777778,11,7,4,341.44070095869324,0.3439064064064064,0.07540220256719832,0.22979168647342732,136440.92970521544,1917.2973356009088,138358.22704081636,2391,68,990.4864864864865,34,3,18,29.891417882102694,0.6887254901960784,38.80952380952381,1044.7619047619048,30.72829131652661,0
2395,4,0,0,37,0.0,0.0,1.0,37,1100,700,400,0.6363636363636364,15,7,8,341.1732504501325,0.3441253753753754,0.07507849535184374,0.23042316453478198,136565.3344671203,1918.4878117913972,138483.82227891168,2392,69,991.4864864864865,34,3,20,29.775294229309033,0.6899509803921567,38.6904761904762,1045.238095238096,30.742296918767533,0
2396,4,0,0,37,0.0,0.0,1.0,37,1150,800,350,0.6956521739130435,15,8,7,342.37551784892275,0.34387512512512514,0.07860450091525739,0.23226014859480998,136720.920138889,1961.9791666666765,138682.89930555568,2393,70,992.4864864864865,34,3,20,29.589973439575026,0.6914828431372548,38.54166666666667,1045.8333333333342,30.75980392156865,0
2397,4,0,0,37,0.0,0.0,1.0,37,750,600,150,0.8,9,6,3,342.37551784892275,0.34387512512512514,0.07860450091525739,0.23226014859480998,136720.920138889,1961.9791666666765,138682.89930555568,2394,71,993.4864864864865,34,3,20,29.589973439575026,0.6914828431372548,38.54166666666667,1045.8333333333342,30.75980392156865,0
2398,4,0,0,37,0.0,0.0,1.0,37,800,700,100,0.875,9,7,2,340.509123108041,0.3434997497497498,0.07421668368413958,0.2316094561821567,136814.31405895695,1917.3044217687157,138731.61848072568,2395,72,994.4864864864865,34,3,21,29.546445911090892,0.6924019607843137,38.452380952380956,1046.1904761904766,30.77030812324931,0
2399,4,0,0,37,0.0,0.0,1.0,37,850,500,350,0.5882352941176471,12,5,7,340.17092025921477,0.34240490490490494,0.07136488023859999,0.23179088287430213,136876.5943877551,1912.2874149659783,138788.88180272107,2396,73,995.4864864864865,34,3,21,29.493742889647326,0.6930147058823529,38.39285714285714,1046.428571428571,30.77731092436974,0
2400,4,0,0,37,0.0,0.0,1.0,37,1000,800,200,0.8,12,8,4,339.1953909491176,0.3425613113113113,0.06897102995385307,0.23133178291960385,136907.7398667801,1887.6948696145182,138795.4347363946,2397,74,996.4864864864865,34,3,21,29.4884920183521,0.6933210784313726,38.36309523809524,1046.5476190476195,30.780812324929986,0
2401,4,0,0,37,0.0,0.0,1.0,37,900,600,300,0.6666666666666666,12,6,6,339.11896745817955,0.34253003003003,0.06612139263111594,0.23169177007457456,136970.04145408171,1889.8278061224537,138859.86926020417,2398,75,997.4864864864865,34,3,17,29.428949164107802,0.6939338235294118,38.30357142857143,1046.785714285715,30.78781512605044,0
2402,4,0,0,37,0.0,0.0,1.0,37,900,600,300,0.6666666666666666,12,6,6,339.7004149613245,0.34209209209209207,0.06760137440146519,0.23229591362129778,137001.1975623583,1907.8727324263075,138909.07029478461,2399,76,998.4864864864865,34,3,17,29.38295997270866,0.6942401960784312,38.273809523809526,1046.9047619047622,30.79131652661065,0
2403,4,0,0,37,0.0,0.0,1.0,37,850,700,150,0.8235294117647058,10,7,3,339.00534601388887,0.34202952952952953,0.0680054699383863,0.232027394411841,137032.35721371896,1890.9403344671384,138923.2975481861,2400,77,999.4864864864865,34,3,17,29.37038089823763,0.6945465686274509,38.24404761904763,1047.0238095238108,30.794817927170904,0
2404,4,0,0,37,0.0,0.0,1.0,37,1000,600,400,0.6,14,6,8,337.49920741353424,0.3413413413413413,0.07093749808003014,0.2316160707351231,137125.85742630405,1855.9736394557985,138981.83106575985,2401,78,1000.4864864864865,34,3,18,29.317505872546775,0.6954656862745097,38.15476190476191,1047.3809523809539,30.805322128851586,0
2405,4,0,0,37,0.0,0.0,1.0,37,650,400,250,0.6153846153846154,9,4,5,338.3502663524991,0.34146646646646645,0.07241609150917072,0.23240780590442187,137157.03125000023,1881.4236111111416,139038.4548611114,2402,79,1001.4864864864865,34,3,18,29.264452399893926,0.6957720588235292,38.125000000000014,1047.5000000000018,30.808823529411818,0
2406,4,0,0,37,0.0,0.0,1.0,37,1200,800,400,0.6666666666666666,16,8,8,337.0868245630367,0.3411536536536537,0.06712550806144613,0.23257934196339947,137312.95351473935,1857.277494331078,139170.2310090704,2403,80,1002.4864864864865,34,3,18,29.143713084961377,0.6973039215686274,37.97619047619048,1048.095238095239,30.82633053221291,0
2407,4,0,0,37,0.0,0.0,1.0,37,500,300,200,0.6,7,3,4,338.3496654795633,0.34118493493493496,0.06728827396553894,0.23387026328202806,137375.34722222236,1896.1805555555666,139271.52777777793,2404,81,1003.4864864864865,34,3,19,29.049085850556423,0.6979166666666666,37.91666666666667,1048.3333333333344,30.833333333333364,0
2408,4,0,0,37,0.0,0.0,1.0,37,800,500,300,0.625,11,5,6,335.90979699718605,0.3398711211211211,0.06871350860452896,0.23281112523589406,137468.96435657603,1835.434382086176,139304.39873866222,2405,82,1004.4864864864865,34,3,19,29.020745828130323,0.6988357843137254,37.827380952380956,1048.6904761904768,30.843837535014025,0
2409,4,0,0,37,0.0,0.0,1.0,37,1350,1100,250,0.8148148148148148,16,11,5,338.3494045388783,0.33933933933933935,0.07116391786073062,0.23580430829777163,137660.63214002483,1915.4785826045913,139576.1107226294,2406,83,1005.4864864864865,35,2,19,28.767899158119185,0.6985119047619048,37.644675925925924,1049.421296296296,29.983465608465604,0
2410,4,0,0,37,0.0,0.0,1.0,37,550,300,250,0.5454545454545454,8,3,5,339.8479120654976,0.3393706206206206,0.07118398583830277,0.23726564392009214,137721.36923707553,1960.86395640431,139682.23319347983,2407,84,1006.4864864864865,35,2,19,28.668747932517352,0.6991071428571429,37.58680555555555,1049.6527777777771,29.990079365079346,0
2411,4,0,0,37,0.0,0.0,1.0,37,850,500,350,0.5882352941176471,12,5,7,339.3228460740849,0.33952702702702703,0.07055037396823494,0.23710772063882507,137751.7428090706,1948.4626843278388,139700.20549339845,2408,85,1007.4864864864865,35,2,19,28.652609334803383,0.6994047619047619,37.55787037037037,1049.7685185185182,29.993386243386237,0
2412,4,0,0,37,0.0,0.0,1.0,37,650,400,250,0.6153846153846154,9,4,5,338.78900999781996,0.33952702702702703,0.06905880635348205,0.2369433392205258,137782.11973004526,1935.8135877486097,139717.93331779388,2409,86,1008.4864864864865,35,2,19,28.63670396501673,0.699702380952381,37.528935185185176,1049.8842592592578,29.996693121693077,0
2413,4,0,0,37,0.0,0.0,1.0,37,650,500,150,0.7692307692307693,8,5,3,338.88929579152887,0.33933933933933935,0.06797047586073757,0.23743784576466057,137843.75177154198,1942.7577424038022,139786.50951394578,2410,87,1009.4864864864865,34,3,19,28.573385481615833,0.7025122549019608,37.470238095238095,1050.1190476190477,30.885854341736696,0
2414,4,0,0,37,0.0,0.0,1.0,37,750,600,150,0.8,9,6,3,335.9848425913817,0.3390265265265265,0.06762574947483202,0.236475456197092,138000.06377551015,1873.1859410430798,139873.24971655323,2411,88,1010.4864864864865,34,3,19,28.49582672407283,0.7040441176470589,37.32142857142857,1050.7142857142853,30.903361344537803,0
2415,4,0,0,37,0.0,0.0,1.0,37,750,500,250,0.6666666666666666,10,5,5,336.46019824110294,0.3391516516516517,0.061333504758581237,0.2374586003413827,138093.89349489793,1892.6197562358216,139986.51325113376,2412,89,1011.4864864864865,34,3,19,28.391050326575304,0.7049632352941176,37.232142857142854,1051.0714285714282,30.913865546218478,0
2416,4,0,0,37,0.0,0.0,1.0,37,1000,600,400,0.6,14,6,8,333.1867004792759,0.3392454954954955,0.042012957267194784,0.23614152578429776,138238.1754222392,1811.8243098422295,140049.99973208143,2413,90,1012.4864864864865,35,2,18,28.335259373394962,0.7041666666666667,37.0949074074074,1051.620370370369,30.04629629629626,1
2417,4,0,0,37,0.0,0.0,1.0,37,650,600,50,0.9230769230769231,7,6,1,333.1867004792759,0.3392454954954955,0.042012957267194784,0.23614152578429776,138238.1754222392,1811.8243098422295,140049.99973208143,2414,91,1013.4864864864865,35,2,18,28.335259373394962,0.7041666666666667,37.0949074074074,1051.620370370369,30.04629629629626,0
2418,4,0,0,37,0.0,0.0,1.0,37,1150,900,250,0.782608695652174,14,9,5,333.1403781275337,0.3389326826826827,0.041383740954556325,0.23631901764597163,138268.6059268903,1812.571132330231,140081.17705922053,2415,92,1014.4864864864865,35,2,19,28.30657807857378,0.7044642857142858,37.065972222222214,1051.7361111111102,30.04960317460315,0
2419,4,0,0,37,0.0,0.0,1.0,37,900,700,200,0.7777777777777778,11,7,4,333.1403781275337,0.3389326826826827,0.041383740954556325,0.23631901764597163,138268.6059268903,1812.571132330231,140081.17705922053,2416,93,1015.4864864864865,35,2,19,28.30657807857378,0.7044642857142858,37.065972222222214,1051.7361111111102,30.04960317460315,0
2420,4,0,0,37,0.0,0.0,1.0,37,550,400,150,0.7272727272727273,7,4,3,335.28193810751856,0.3389952452452452,0.03861343738104317,0.23805017605633785,138299.039780521,1873.834019204362,140172.87379972538,2417,94,1016.4864864864865,35,2,19,28.22036384976527,0.7047619047619049,37.037037037037024,1051.85185185185,30.052910052909997,0
2421,4,0,0,37,0.0,0.0,1.0,37,600,600,0,1.0,6,6,0,335.91024070512333,0.33802552552552556,0.04637281364074175,0.23934920912938717,138420.8086848421,1899.3934327846234,140320.20211762673,2418,95,1017.4864864864865,35,2,22,28.084213227746005,0.705952380952381,36.92129629629629,1052.3148148148139,30.066137566137538,0
2422,4,0,0,37,0.0,0.0,1.0,37,800,600,200,0.75,10,6,4,338.4018368204897,0.3378065565565565,0.04448538698126403,0.2417725613418972,138512.1705273704,1974.5545856909991,140486.7251130614,2419,96,1018.4864864864865,35,2,22,27.928921568627455,0.7068452380952381,36.83449074074073,1052.662037037036,30.076058201058174,0
2423,4,0,0,37,0.0,0.0,1.0,37,700,400,300,0.5714285714285714,10,4,6,332.9781427363848,0.3373686186186186,0.04647460647460666,0.23896696363573317,138664.5072445128,1834.4500171467503,140498.95726165953,2420,97,1019.4864864864865,35,2,22,27.92216117216118,0.7083333333333335,36.6898148148148,1053.2407407407388,30.09259259259254,0
2424,4,0,0,37,0.0,0.0,1.0,37,900,700,200,0.7777777777777778,11,7,4,332.31375981026275,0.33643018018018017,0.04778278608206077,0.23891941878301817,138725.46537422825,1820.0761959876354,140545.5415702159,2421,98,1020.4864864864865,35,2,22,27.879861568885943,0.7089285714285716,36.631944444444436,1053.4722222222213,30.099206349206323,0
2425,4,0,0,37,0.0,0.0,1.0,37,1150,700,450,0.6086956521739131,16,7,9,339.1968588039136,0.3357107107107107,0.06296210515063505,0.24386807336755306,138725.46537422837,2011.0484182098735,140736.51379243826,2422,99,1021.4864864864865,35,2,20,27.698582729070523,0.7089285714285715,36.63194444444444,1053.4722222222222,30.099206349206348,1
2426,4,0,0,37,0.0,0.0,1.0,37,600,400,200,0.6666666666666666,8,4,4,340.4748011258002,0.33549174174174173,0.06363595885836415,0.24544917373320752,138816.92768614963,2052.7331693672772,140869.6608555169,2423,100,1022.4864864864865,35,2,20,27.575164744645804,0.7098214285714286,36.545138888888886,1053.8194444444441,30.109126984126974,0
2427,4,0,0,37,0.0,0.0,1.0,37,1000,800,200,0.8,12,8,4,339.093501658099,0.3357107107107107,0.06472597556379256,0.2448948865662415,138877.91930566262,2018.519992069602,140896.43929773223,2424,101,1023.4864864864865,35,2,21,27.551723033563913,0.7104166666666667,36.48726851851851,1054.0509259259252,30.11574074074072,0
2428,4,0,0,37,0.0,0.0,1.0,37,1050,800,250,0.7619047619047619,13,8,5,340.4183406695694,0.3351163663663664,0.05934533381750251,0.2465319086925899,138971.17524092962,2061.670724263203,141032.84596519283,2425,102,1024.4864864864865,34,3,21,27.42534153776673,0.7135416666666667,36.39880952380952,1054.4047619047612,31.01190476190474,0
2429,4,0,0,37,0.0,0.0,1.0,37,1000,600,400,0.6,14,6,8,334.8429723982871,0.33564814814814814,-0.0017795336354886615,0.2474674125141987,139651.36377931992,1952.2555494683984,141603.6193287883,2426,103,1025.4864864864865,36,1,20,26.906429789047532,0.7158564814814814,35.75450450450451,1056.9819819819825,29.360610610610625,4
2430,4,0,0,37,0.0,0.0,1.0,37,900,600,300,0.6666666666666666,12,6,6,336.83795992635964,0.33552302302302306,0.0024585727610866304,0.24938759998333343,139710.88487135802,2011.9858879149597,141722.87075927298,2427,104,1026.4864864864865,36,1,20,26.795510225820184,0.7164351851851851,35.698198198198206,1057.2072072072085,29.366866866866904,0
2431,4,0,0,37,0.0,0.0,1.0,37,850,300,550,0.35294117647058826,14,3,11,337.78798491629374,0.3352102102102102,-0.008033584526717208,0.2512147697797904,139859.74308345537,2048.5881574142068,141908.33124086956,2428,105,1027.4864864864865,36,1,20,26.624880229958496,0.7178819444444444,35.55743243243245,1057.7702702702725,29.38250750750757,0
2432,4,0,0,37,0.0,0.0,1.0,37,900,800,100,0.8888888888888888,10,8,2,338.5637684287634,0.33508508508508505,-0.005724114919517076,0.2524718387425924,139949.09605551517,2076.338669750853,142025.434725266,2429,106,1028.4864864864865,36,1,20,26.51704626082021,0.71875,35.47297297297298,1058.1081081081095,29.39189189189193,0
2433,4,0,0,37,0.0,0.0,1.0,37,1300,1200,100,0.9230769230769231,14,12,2,348.3250529963636,0.3354291791791792,0.02058070380778676,0.249532388359127,138603.56251071658,2255.8313330065357,140859.3938437231,2430,107,1029.4864864864865,35,2,22,27.577947534256612,0.7077380952380953,36.747685185185176,1053.009259259258,30.0859788359788,2
2434,4,0,0,37,0.0,0.0,1.0,37,500,200,300,0.4,8,2,6,348.4812463495027,0.3353353353353354,0.01796455208918113,0.24986846812719654,138634.033203125,2262.272135416667,140896.30533854166,2431,108,1030.4864864864865,35,2,22,27.5438921859545,0.7080357142857143,36.71875,1053.125,30.089285714285715,0
2435,4,0,0,37,0.0,0.0,1.0,37,550,400,150,0.7272727272727273,7,4,3,349.25443786982254,0.33480355355355357,0.020908820908820847,0.2506479009949041,138664.50724451293,2285.8389060356544,140950.34615054858,2432,109,1031.4864864864865,35,2,22,27.49358974358974,0.7083333333333334,36.68981481481481,1053.24074074074,30.09259259259257,0
2436,4,0,0,37,0.0,0.0,1.0,37,900,600,300,0.6666666666666666,12,6,6,349.52150729439006,0.33442817817817816,0.01824368864579773,0.25129105524435513,138725.46537422825,2297.50675154319,141022.97212577146,2433,110,1032.4864864864865,35,2,22,27.426664469347383,0.7089285714285716,36.631944444444436,1053.4722222222213,30.099206349206323,0
2437,4,0,0,37,0.0,0.0,1.0,37,850,800,50,0.9411764705882353,9,8,1,351.47392290249405,0.33442817817817816,0.024024024024023705,0.24603174603174605,137812.50000000015,2287.62056327162,140100.12056327178,2434,111,1033.4864864864865,35,2,22,28.27380952380952,0.7,37.50000000000001,1050.0000000000011,30.000000000000032,1
2438,4,0,0,37,0.0,0.0,1.0,37,650,300,350,0.46153846153846156,10,3,7,348.95876668463944,0.33445945945945943,0.029070212681229224,0.24493740640084125,137906.26594387757,2224.7200963718806,140130.98604024947,2435,112,1034.4864864864865,34,3,22,28.247430956968525,0.703125,37.410714285714285,1050.357142857143,30.892857142857142,0
2439,4,0,0,37,0.0,0.0,1.0,37,1000,500,500,0.5,15,5,10,351.74666356362724,0.3342404904904905,0.0260010718934236,0.24734376939832756,137968.79428854882,2306.0126133786966,140274.8069019275,2436,113,1035.4864864864865,34,3,22,28.112606232294617,0.7037377450980391,37.35119047619048,1050.5952380952385,30.899859943977603,0
2440,4,0,0,37,0.0,0.0,1.0,37,800,400,400,0.5,12,4,8,350.7669412350025,0.33461586586586584,0.02511008629295519,0.24687950744339168,138000.06377551018,2281.1720521541915,140281.23582766438,2437,114,1036.4864864864865,34,3,22,28.107532668630544,0.7040441176470589,37.32142857142857,1050.7142857142856,30.90336134453781,0
2441,4,0,0,37,0.0,0.0,1.0,37,800,400,400,0.5,12,4,8,351.7595040403735,0.33461586586586584,0.012981074636575718,0.2433578909727862,137406.54939058956,2269.7916666666615,139676.3410572562,2438,115,1037.4864864864865,34,3,22,28.666827523560798,0.6982230392156863,37.88690476190476,1048.4523809523807,30.83683473389355,2
2442,4,0,0,37,0.0,0.0,1.0,37,600,500,100,0.8333333333333334,7,5,2,350.1175493370804,0.33489739739739743,0.015095126912586077,0.242658181912694,137468.96435657592,2226.0593820861613,139695.02373866207,2439,116,1038.4864864864865,34,3,22,28.648257463957307,0.6988357843137255,37.82738095238095,1048.690476190476,30.843837535013996,0
2443,4,0,0,37,0.0,0.0,1.0,37,500,400,100,0.8,6,4,2,346.0958777500962,0.3334271771771771,0.010304188223172028,0.24073740888805023,137593.83680555545,2124.1319444444352,139717.96874999988,2440,117,1039.4864864864865,34,3,22,28.630526873179775,0.700061274509804,37.70833333333333,1049.1666666666658,30.85784313725488,0
2444,4,0,0,37,0.0,0.0,1.0,37,600,300,300,0.5,9,3,6,345.226092799844,0.3332394894894895,0.00803390183921171,0.24034935086396736,137625.06377551024,2102.352607709755,139727.41638322,2441,118,1040.4864864864865,34,3,22,28.622551244232646,0.7003676470588236,37.67857142857143,1049.2857142857147,30.86134453781514,0
2445,4,0,0,37,0.0,0.0,1.0,37,550,400,150,0.7272727272727273,7,4,3,345.2933222099573,0.3328953953953954,0.008554215020465827,0.24061348895500145,137656.29428854852,2106.3598356008806,139762.6541241494,2442,119,1041.4864864864865,34,3,22,28.58999810928341,0.7006740196078431,37.64880952380951,1049.40476190476,30.864845938375296,0
2446,4,0,0,37,0.0,0.0,1.0,37,750,500,250,0.6666666666666666,10,5,5,347.6448022948999,0.33264514514514515,0.010543544224651091,0.2429106074989243,137750.0070861677,2177.6147959183536,139927.62188208604,2443,120,1042.4864864864865,34,3,22,28.435917063582067,0.701593137254902,37.5595238095238,1049.761904761904,30.875350140055996,0
2447,4,0,0,37,0.0,0.0,1.0,37,750,400,350,0.5333333333333333,11,4,7,347.6946334089191,0.33233233233233234,0.014371514371514404,0.2433862433862433,137812.49999999988,2183.347505668919,139995.8475056688,2444,121,1043.4864864864865,33,4,23,28.373015873015863,0.7045454545454546,37.49999999999999,1049.999999999999,31.81818181818179,0
2448,4,0,0,37,0.0,0.0,1.0,37,650,600,50,0.9230769230769231,7,6,1,347.6946334089191,0.33233233233233234,0.014371514371514404,0.2433862433862433,137812.49999999988,2183.333333333318,139995.8333333332,2445,122,1044.4864864864865,33,4,23,28.373015873015863,0.7045454545454546,37.49999999999999,1049.999999999999,31.81818181818179,0
2449,4,0,0,37,0.0,0.0,1.0,37,750,600,150,0.8,9,6,3,347.6946334089191,0.33233233233233234,0.014371514371514404,0.2433862433862433,137812.49999999988,2183.333333333318,139995.8333333332,2446,123,1045.4864864864865,33,4,23,28.373015873015863,0.7045454545454546,37.49999999999999,1049.999999999999,31.81818181818179,0
2450,4,0,0,37,0.0,0.0,1.0,37,1100,600,500,0.5454545454545454,16,6,10,351.60628236379426,0.33167542542542544,0.006052238382539654,0.24751003817628658,138005.5822880622,2304.725946751242,140310.30823481345,2447,124,1046.4864864864865,33,4,23,28.080048207759894,0.706439393939394,37.31617647058823,1050.7352941176464,31.840463458110495,0
2451,4,0,0,37,0.0,0.0,1.0,37,700,500,200,0.7142857142857143,9,5,4,351.9932404210294,0.3309872372372372,0.0067819685357002335,0.24824786429693635,138069.97308727403,2319.939446366773,140389.9125336408,2448,125,1047.4864864864865,33,4,20,28.00645211442786,0.7070707070707071,37.25490196078431,1050.980392156862,31.847890671420064,0
2452,4,0,0,37,0.0,0.0,1.0,37,700,400,300,0.5714285714285714,10,4,6,351.9932404210294,0.3309872372372372,0.0067819685357002335,0.24824786429693635,138069.97308727403,2319.939446366773,140389.9125336408,2449,126,1048.4864864864865,33,4,20,28.00645211442786,0.7070707070707071,37.25490196078431,1050.980392156862,31.847890671420064,0
2453,4,0,0,37,0.0,0.0,1.0,37,1000,700,300,0.7,13,7,6,353.28436742835396,0.330518018018018,0.0025836048218887964,0.2496271255189801,138134.3789047482,2360.1433342945056,140494.5222390427,2450,127,1049.4864864864865,33,4,20,27.90908914276831,0.7077020202020202,37.193627450980394,1051.2254901960787,31.855317884729658,0
2454,4,0,0,37,0.0,0.0,1.0,37,600,300,300,0.5,9,3,6,352.7690799693405,0.3303303303303303,0.006333742323779701,0.24988045576336687,138219.0493905896,2351.881377551028,140570.93076814062,2451,128,1050.4864864864865,34,3,20,27.839258085210762,0.7061887254901961,37.11309523809524,1051.5476190476193,30.92787114845939,0
2455,4,0,0,37,0.0,0.0,1.0,37,1050,700,350,0.6666666666666666,14,7,7,352.7690799693405,0.3300487987987988,0.006333742323779701,0.24988045576336687,138219.0493905896,2351.881377551028,140570.93076814062,2452,129,1051.4864864864865,34,3,20,27.839258085210762,0.7061887254901961,37.11309523809524,1051.5476190476193,30.92787114845939,0
2456,4,0,0,37,0.0,0.0,1.0,37,800,700,100,0.875,9,7,2,350.34591350922443,0.329517017017017,0.00927864484202523,0.24874559859154918,138299.03978052118,2290.500685871044,140589.54046639224,2453,130,1052.4864864864865,35,2,21,27.824237089201883,0.7047619047619047,37.03703703703703,1051.851851851851,30.05291005291003,0
2457,4,0,0,37,0.0,0.0,1.0,37,700,500,200,0.7142857142857143,9,5,4,358.92150936714364,0.329517017017017,0.010784926986044274,0.24049660493958902,136285.50347222236,2384.4993141289638,138670.00278635134,2454,131,1053.4864864864865,34,3,19,29.588986432561864,0.6871936274509803,38.95833333333334,1044.1666666666679,30.710784313725526,7
2458,4,0,0,37,0.0,0.0,1.0,37,650,300,350,0.46153846153846156,10,3,7,361.61779105219927,0.32992367367367365,0.011523151058034697,0.2425161516139063,136316.58163265313,2458.900226757374,138775.4818594105,2455,132,1054.4864864864865,34,3,19,29.487764097887208,0.6875,38.92857142857143,1044.285714285715,30.714285714285733,0
2459,4,0,0,37,0.0,0.0,1.0,37,650,400,250,0.6153846153846154,9,4,5,361.61779105219927,0.32992367367367365,0.011523151058034697,0.2425161516139063,136316.58163265313,2458.900226757374,138775.4818594105,2456,133,1055.4864864864865,34,3,19,29.487764097887208,0.6875,38.92857142857143,1044.285714285715,30.714285714285733,0
2460,4,0,0,37,0.0,0.0,1.0,37,900,700,200,0.7777777777777778,11,7,4,375.5775185019759,0.32992367367367365,0.0016295260389751487,0.22590555747513974,132338.45191400888,2540.6694744513006,134879.1213884602,2457,134,1056.4864864864865,35,2,16,33.10508061492314,0.6458333333333334,42.7662037037037,1028.935185185185,29.39814814814814,8
2461,4,0,0,37,0.0,0.0,1.0,37,1000,400,600,0.4,16,4,12,377.277367420649,0.3303303303303303,0.003343048434693463,0.22746627989639534,132427.7842747985,2592.4011649091153,135020.18543970762,2458,135,1057.4864864864865,35,2,16,32.971274223171775,0.6467261904761905,42.679398148148145,1029.2824074074072,29.408068783068774,0
2462,4,0,0,37,0.0,0.0,1.0,37,900,500,400,0.5555555555555556,13,5,8,373.1524142575168,0.33045545545545546,0.0053944706675657095,0.22587144095669287,132576.73852237655,2494.2660108024684,135071.00453317902,2459,136,1058.4864864864865,35,2,16,32.927343223196225,0.6482142857142856,42.53472222222222,1029.861111111111,29.424603174603174,0
2463,4,1,0,38,0.02631578947368421,0.0,1.0,38,400,100,300,0.25,7,1,6,363.2584271969225,0.33644499762920815,0.008860089923300674,0.22138932373905654,132832.97444403867,2050.5394752861002,134883.51391932476,2460,0,1031.6052631578948,36,2,16,32.92435911441265,0.6487268518518519,42.28603603603604,1030.8558558558561,28.634884884884894,0
2464,4,0,0,38,0.0,0.0,1.0,38,750,400,350,0.5333333333333333,11,4,7,363.37929835224026,0.3357782124229493,0.013797325026008167,0.22197893495740284,132920.05423920558,2060.079209276862,134980.13344848243,2461,1,1032.6052631578948,36,2,17,32.83371555458484,0.6495949074074073,42.201576576576585,1031.193693693695,28.644269269269305,0
2465,4,1,0,39,0.02564102564102564,0.0,1.0,39,500,300,200,0.6,7,3,4,352.8924279596996,0.34027777777777773,0.019891880114928373,0.21729772460697022,133217.40974386357,1602.2830342028376,134819.6927780664,2462,0,1007.1025641025641,37,2,18,32.80569569835368,0.6506193693693694,41.91337719298246,1032.3464912280708,27.901256519677588,0
2466,4,0,0,39,0.0,0.0,1.0,39,1000,600,400,0.6,14,6,8,354.79337898930754,0.3404745838956365,0.01898165542251329,0.21896749956233938,133302.32018505692,1658.9561211141863,134961.27630617112,2463,1,1008.1025641025641,37,2,18,32.67148014440432,0.651463963963964,41.83114035087719,1032.6754385964912,27.910146989094358,0
2467,4,0,0,39,0.0,0.0,1.0,39,750,500,250,0.6666666666666666,10,5,5,353.73713605690557,0.34078385065227174,0.01575480428983611,0.21864854472808737,133358.94217451525,1634.802054478303,134993.74422899354,2464,2,1009.1025641025641,37,2,18,32.641985138004245,0.652027027027027,41.776315789473685,1032.8947368421054,27.916073968705554,0
2468,4,0,0,39,0.0,0.0,1.0,39,1050,800,250,0.7619047619047619,13,8,5,349.3238746522261,0.3405589293747189,0.016914423791215105,0.21641544187034348,133443.8977016966,1523.0278787703842,134966.92558046698,2465,3,1010.1025641025641,37,2,18,32.67083642859669,0.6528716216216216,41.69407894736842,1033.2236842105258,27.92496443812232,0
2469,4,0,0,39,0.0,0.0,1.0,39,350,200,150,0.5714285714285714,5,2,3,349.3238746522261,0.3405589293747189,0.016914423791215105,0.21641544187034348,133443.8977016966,1523.0278787703842,134966.92558046698,2466,4,1011.1025641025641,37,2,18,32.67083642859669,0.6528716216216216,41.69407894736842,1033.2236842105258,27.92496443812232,0
2470,4,0,0,39,0.0,0.0,1.0,39,850,600,250,0.7058823529411765,11,6,5,348.59521331945905,0.34033400809716596,0.017990074441687653,0.21612903225806457,133472.22222222213,1505.5555555555502,134977.7777777777,2467,5,1012.1025641025641,37,2,18,32.661290322580655,0.6531531531531531,41.666666666666664,1033.3333333333328,27.927927927927914,0
2471,4,0,0,39,0.0,0.0,1.0,39,550,500,50,0.9090909090909091,6,5,1,351.03528205595495,0.3406713900134953,0.005500351957045124,0.21339130535329004,132736.76155163127,1519.0573060941842,134255.81885772545,2468,6,1013.1025641025641,37,2,15,33.33599347378875,0.6458333333333333,42.37938596491228,1030.482456140351,27.850877192982455,1
2472,4,0,0,39,0.0,0.0,1.0,39,1200,900,300,0.75,15,9,6,346.75610949094295,0.3402496626180837,0.005093846208384045,0.21158648264395447,132878.0384950178,1415.254333064031,134293.29282808182,2469,7,1014.1025641025641,37,2,16,33.30441968875182,0.6472409909909909,42.242324561403514,1031.0307017543867,27.86569464201045,0
2473,4,0,0,39,0.0,0.0,1.0,39,1100,700,400,0.6363636363636364,15,7,8,348.465013131103,0.3415710751237067,0.009658991801848815,0.21343482054280044,133019.39058171737,1470.5207371498843,134489.91131886726,2470,8,1015.1025641025641,37,2,17,33.11853387188209,0.6486486486486487,42.10526315789473,1031.5789473684204,27.880512091038387,0
2474,4,0,0,39,0.0,0.0,1.0,39,750,600,150,0.8,9,6,3,348.9263220519996,0.34145861448493026,0.004609989946298798,0.21420388889963254,133104.23790252768,1488.7144361726666,134592.95233870033,2471,9,1016.1025641025641,37,2,17,33.02153065561577,0.6494932432432432,42.02302631578947,1031.9078947368419,27.889402560455185,0
2475,4,0,0,39,0.0,0.0,1.0,39,650,400,250,0.6153846153846154,9,4,5,350.2759547309577,0.3422177237966712,0.0032470097274091003,0.21535908307527774,133160.8178117304,1528.6065183517874,134689.4243300822,2472,10,1017.1025641025641,37,2,17,32.92996830624314,0.6500563063063063,41.96820175438596,1032.1271929824552,27.895329540066356,0
2476,4,1,2,38,0.025,0.05,0.95,40,1100,600,500,0.5454545454545454,16,6,10,342.6562629723704,0.3475427350427351,0.007466843501326315,0.21260930075803725,133500.54974848006,1149.3235899507224,134649.87333843077,2473,0,992.65,37,3,18,32.786361626878865,0.6534346846846848,41.6392543859649,1033.4429824561382,27.930891417733466,0
2477,4,0,0,38,0.0,0.0,1.0,38,750,400,350,0.5333333333333333,11,4,7,357.6536842178041,0.34323138928402086,0.010739322397845585,0.22018880612656866,133210.52629910305,1928.6471014933677,135139.17340059642,2474,1,1019.421052631579,36,2,18,32.68972037380458,0.652488425925926,41.920045045045036,1032.3198198198188,28.675550550550522,0
2478,4,0,0,38,0.0,0.0,1.0,38,650,300,350,0.46153846153846156,10,3,7,356.53324592421836,0.34311284969179706,0.017625178662656227,0.21984218775246517,133268.65875588416,1902.941497240471,135171.60025312463,2475,2,1020.421052631579,36,2,18,32.66032282691678,0.6530671296296298,41.86373873873873,1032.5450450450442,28.681806806806783,0
2479,4,0,0,38,0.0,0.0,1.0,38,950,700,250,0.7368421052631579,12,7,5,359.83132075493245,0.3432758416311048,0.020198774301650513,0.22239709393290027,133355.88121905687,1997.1245738982234,135353.00579295508,2476,3,1021.421052631579,36,2,19,32.48768898095655,0.6539351851851851,41.77927927927928,1032.8828828828828,28.691191191191187,0
2480,4,0,0,38,0.0,0.0,1.0,38,800,400,400,0.5,12,4,8,355.05207674659164,0.3432758416311048,0.026142240631255254,0.20733400476511504,131212.72243527317,1717.469919243575,132930.19235451674,2477,4,1022.421052631579,36,2,16,34.768401480178795,0.6325231481481481,43.862612612612615,1024.54954954955,28.45970970970972,5
2481,4,1,0,39,0.02564102564102564,0.0,1.0,39,1100,700,400,0.6363636363636364,15,7,8,351.258370294485,0.3487123256860099,0.035664914076824816,0.20734065985558617,131624.87809713645,1446.9694869262357,133071.8475840627,2478,0,997.1794871794872,35,4,16,34.44948868335965,0.6386904761904761,43.460648148148145,1026.1574074074072,29.318783068783063,0
2482,4,0,0,39,0.0,0.0,1.0,39,450,300,150,0.6666666666666666,6,3,3,352.618788975928,0.34865609536662173,0.03368872772278664,0.20830584955693218,131654.57182623877,1484.7751361025223,133139.34696234128,2479,1,998.1794871794872,35,4,16,34.38463309650013,0.6389880952380953,43.431712962962955,1026.2731481481474,29.322089947089925,0
2483,4,0,0,39,0.0,0.0,1.0,39,850,600,250,0.7058823529411765,11,6,5,349.72584727846964,0.3482343679712101,0.02953443805658873,0.20724235078205103,131773.38023244598,1416.9114101080238,133190.29164255402,2480,2,999.1794871794872,35,4,16,34.33906831247887,0.6401785714285715,43.31597222222222,1026.736111111111,29.33531746031746,0
2484,4,0,0,39,0.0,0.0,1.0,39,950,800,150,0.8421052631578947,11,8,3,345.9877119254193,0.34815002249212773,0.025698801724038267,0.20583022326072523,131921.96609224958,1328.6758401920322,133250.64193244162,2481,3,1000.1794871794872,35,4,17,34.285338741174684,0.6416666666666667,43.17129629629629,1027.3148148148143,29.351851851851837,0
2485,4,0,0,39,0.0,0.0,1.0,39,750,500,250,0.6666666666666666,10,5,5,346.8625615150806,0.3487966711650922,0.024248935715482478,0.20667421618328086,131981.42387902946,1355.8829518175544,133337.30683084702,2482,4,1001.1794871794872,35,4,17,34.20299241570924,0.6422619047619048,43.113425925925924,1027.546296296296,29.358465608465604,0
2486,4,0,0,39,0.0,0.0,1.0,39,1400,1000,400,0.7142857142857143,18,10,8,347.6099760979035,0.34944331983805665,0.020204469928599922,0.20760754524044922,132070.63567654745,1381.8141021519136,133452.44977869937,2483,5,1002.1794871794872,35,4,17,34.09396933528505,0.643154761904762,43.02662037037037,1027.8935185185182,29.368386243386237,0
2487,4,0,0,39,0.0,0.0,1.0,39,550,400,150,0.7272727272727273,7,4,3,347.2866852996075,0.3492183985605038,0.024267193110057095,0.20790396982491302,132159.8776148832,1379.4731652948994,133539.35078017812,2484,6,1003.1794871794872,35,4,18,34.01245685126819,0.6440476190476192,42.9398148148148,1028.240740740739,29.37830687830683,0
2488,4,0,0,39,0.0,0.0,1.0,39,800,600,200,0.75,10,6,4,348.3375513652339,0.34930274403958617,0.024688793088523342,0.20886150347040916,132219.38898533932,1411.3956404320809,133630.7846257714,2485,7,1004.1794871794872,35,4,18,33.92555705604322,0.6446428571428573,42.881944444444436,1028.4722222222208,29.384920634920594,0
2489,4,0,0,39,0.0,0.0,1.0,39,1000,800,200,0.8,12,8,4,348.3375513652339,0.34930274403958617,0.024688793088523342,0.20886150347040916,132219.38898533932,1411.3956404320809,133630.7846257714,2486,8,1005.1794871794872,35,4,18,33.92555705604322,0.6446428571428573,42.881944444444436,1028.4722222222208,29.384920634920594,0
2490,4,0,0,39,0.0,0.0,1.0,39,850,800,50,0.9411764705882353,9,8,1,349.84963913920797,0.3487123256860099,0.028083295436043265,0.20995575584083612,132253.17166828993,1453.7448766333905,133706.91654492333,2487,9,1006.1794871794872,36,3,18,33.852684110648845,0.6429398148148149,42.8490990990991,1028.6036036036037,28.572322322322325,0
2491,4,1,1,39,0.025,0.025,0.975,40,1050,800,250,0.7619047619047619,13,8,5,342.4611363847855,0.3532051282051282,0.025158591272011366,0.20694792927733596,132513.92598257045,1076.2531957633305,133590.17917833378,2488,0,982.0,36,4,19,33.78062452149185,0.6455439814814815,42.59572072072072,1029.6171171171172,28.600475475475477,0
2492,4,0,1,38,0.0,0.02564102564102564,0.9743589743589743,39,850,600,250,0.7058823529411765,11,6,5,350.6040092445379,0.34809379217273956,0.02159244264507465,0.21121753727658735,132398.00347222213,1483.854166666657,133881.8576388888,2489,11,1008.1794871794872,35,4,19,33.687584345479095,0.6464285714285715,42.70833333333333,1029.1666666666658,29.40476190476188,0
2493,4,0,0,38,0.0,0.0,1.0,38,850,600,250,0.7058823529411765,11,6,5,359.84966633477035,0.34195708866761493,0.02209957837889065,0.21610431313401618,132278.91375171472,1920.1045953360808,134199.0183470508,2490,12,1035.2894736842106,35,3,19,33.56960696069608,0.6452380952380952,42.824074074074076,1028.703703703704,29.391534391534396,0
2494,4,0,0,38,0.0,0.0,1.0,38,500,300,200,0.6,7,3,4,360.30553923288034,0.3418237316263632,0.028085763841614098,0.21689076163300852,132368.22601862552,1938.6010105881207,134306.82702921363,2491,13,1036.2894736842106,35,3,19,33.46794979942264,0.6461309523809524,42.73726851851851,1029.0509259259247,29.401455026454993,0
2495,4,2,2,38,0.05,0.05,0.95,40,700,400,300,0.5714285714285714,10,4,6,344.89810970401334,0.3526442307692308,0.03555937943843568,0.21003675303531844,132803.95418645005,1160.7699010047727,133964.72408745482,2492,0,985.425,36,4,16,33.426654284569715,0.6484375,42.31418918918919,1030.7432432432438,28.631756756756772,0
2496,4,0,0,38,0.0,0.0,1.0,38,1050,700,350,0.6666666666666666,14,7,7,361.9185516258421,0.3417792792792793,0.04193670092678792,0.2187444830895813,132520.55165816328,1992.3292233560107,134512.8808815193,2493,15,1038.2894736842106,34,4,20,33.27311442555978,0.6498161764705883,42.589285714285715,1029.6428571428573,30.28361344537816,0
2497,4,0,0,38,0.0,0.0,1.0,38,600,300,300,0.5,9,3,6,361.9185516258421,0.3417792792792793,0.04193670092678792,0.2187444830895813,132520.55165816328,1992.3292233560107,134512.8808815193,2494,16,1039.2894736842106,34,4,20,33.27311442555978,0.6498161764705883,42.589285714285715,1029.6428571428573,30.28361344537816,0
2498,4,1,0,39,0.02564102564102564,0.0,1.0,39,1200,900,300,0.75,15,9,6,351.2975791040088,0.34680049482681063,0.045776945198152896,0.2145985278089,132920.0542392056,1538.8986537213054,134458.9528929269,2495,0,1013.6153846153846,36,3,19,33.14518037202868,0.6495949074074073,42.201576576576585,1031.1936936936952,28.644269269269312,0
2499,4,0,0,39,0.0,0.0,1.0,39,750,500,250,0.6666666666666666,10,5,5,350.6694085311461,0.34705353126405764,0.04414803366539566,0.21438120449454198,132949.08717839472,1524.2355531206995,134473.32273151542,2496,1,1014.6153846153846,36,3,19,33.13223411225158,0.6498842592592593,42.17342342342343,1031.306306306307,28.64739739739742,0
2500,4,0,0,39,0.0,0.0,1.0,39,900,400,500,0.4444444444444444,14,4,10,350.0393299136173,0.3464068825910931,0.045034150711007026,0.21432889451930046,133007.16256797337,1511.547611800992,134518.71017977435,2497,2,1015.6153846153846,36,3,19,33.09020196506551,0.650462962962963,42.11711711711712,1031.5315315315315,28.653653653653652,0
2501,4,0,0,39,0.0,0.0,1.0,39,950,800,150,0.8421052631578947,11,8,3,350.3520825580975,0.3465755735492578,0.04840506215751761,0.21485446990611073,133065.2506391529,1523.9375355085022,134589.1881746614,2498,3,1016.6153846153846,36,3,20,33.02385760023283,0.6510416666666665,42.06081081081082,1031.7567567567585,28.659909909909956,0
2502,4,0,0,39,0.0,0.0,1.0,39,900,500,400,0.5555555555555556,13,5,8,347.6091975157552,0.3467442645074224,0.051416326781807964,0.21383798016304784,133181.46482631282,1459.0204224494782,134640.4852487623,2499,4,1017.6153846153846,36,3,20,32.978080224016296,0.6521990740740742,41.9481981981982,1032.2072072072074,28.67242242242243,0
2503,4,1,0,40,0.025,0.0,1.0,40,1000,700,300,0.7,13,7,6,343.41787976696406,0.3513488247863248,0.052778383089997716,0.21325367391753713,133530.41174620582,1171.6632172713394,134702.07496347715,2500,0,993.15,36,4,21,32.73679814048086,0.6556712962962963,41.61036036036037,1033.5585585585598,28.709959959959992,0
2504,4,0,0,40,0.0,0.0,1.0,40,700,500,200,0.7142857142857143,9,5,4,348.2671928205458,0.35084134615384616,0.06132196162046921,0.2088712447990227,132228.78674207427,1210.189673745746,133438.97641582,2501,1,994.15,37,3,19,33.9179104477612,0.6407657657657658,42.87280701754385,1028.5087719298228,27.7975343764817,2
2505,4,0,0,40,0.0,0.0,1.0,40,700,500,200,0.7142857142857143,9,5,4,349.4239164956913,0.3511351495726496,0.06673060528559227,0.21019192515356175,132341.58587257596,1248.6630501692541,133590.2489227452,2502,2,995.15,37,3,19,33.77468741119634,0.641891891891892,42.76315789473683,1028.947368421051,27.809388335704078,0
2506,4,0,1,39,0.0,0.025,0.975,40,800,400,400,0.5,12,4,8,340.41932783592495,0.3512820512820513,0.06875471494773144,0.18971477135072343,129396.54659366333,814.6262551938953,130211.17284885723,2503,3,996.15,37,3,19,36.982590616804984,0.612331081081081,45.64144736842105,1017.4342105263149,27.49822190611662,6
2507,4,2,0,41,0.04878048780487805,0.0,1.0,41,1100,900,200,0.8181818181818182,13,9,4,348.74145674822154,0.3570376016260162,0.10400040048796266,0.19136334707280908,128783.68975309728,796.7526065712709,129580.44235966855,2504,0,972.7317073170732,37,4,15,37.39501188289944,0.6061373873873873,46.24451754385966,1015.0219298245629,27.43302513039359,7
2508,4,1,0,42,0.023809523809523808,0.0,1.0,42,900,700,200,0.7777777777777778,11,7,4,342.5805507794393,0.3636517615176152,0.11266537520085285,0.1895851529706112,129119.93805473376,446.7958990795566,129566.73395381332,2505,0,950.547619047619,38,4,16,37.20895090928205,0.6077302631578947,45.91346153846154,1016.3461538461542,26.745951417004058,0
2509,4,1,1,42,0.023255813953488372,0.023255813953488372,0.9767441860465116,43,800,500,300,0.625,11,5,6,336.45991318928407,0.36930140273163525,0.11413545725636642,0.18708397450912143,129307.31336805565,101.34548611112035,129408.65885416677,2506,0,929.4186046511628,39,4,16,37.17397241567662,0.607905982905983,45.72916666666667,1017.0833333333342,26.07905982905985,0
2510,4,2,2,42,0.045454545454545456,0.045454545454545456,0.9545454545454546,44,750,300,450,0.4,12,3,9,333.0571431780506,0.37341437632135305,0.11399030738653337,0.18627768862169375,129537.39636005365,-171.32896671953594,129366.06739333412,2507,0,909.25,40,4,13,37.02684602841835,0.6085937499999999,45.50304878048781,1017.9878048780497,25.449695121951244,0
2511,4,0,0,42,0.0,0.0,1.0,42,1200,800,400,0.6666666666666666,16,8,8,347.91780570633586,0.3634702864885792,0.1144417439313472,0.19373528338805426,129364.36760355023,601.633382642991,129966.00098619322,2508,3,953.547619047619,38,4,17,36.82459042218023,0.6101973684210527,45.67307692307692,1017.3076923076917,26.77125506072873,0
2512,4,1,1,42,0.023255813953488372,0.023255813953488372,0.9767441860465116,43,800,600,200,0.75,10,6,4,342.30806967510637,0.37075489110372833,0.11310295604591647,0.1917513685429324,129598.829481337,272.5450303819642,129871.37451171897,2509,0,932.3488372093024,39,4,14,36.72900682011935,0.610844017094017,45.44270833333334,1018.2291666666682,26.10844017094021,0
2513,4,1,0,43,0.023255813953488372,0.0,1.0,43,1150,900,250,0.782608695652174,14,9,5,351.1028091908721,0.36985511258767073,0.1442022062842503,0.19814833279941627,129890.67382812515,520.9960937500143,130411.66992187516,2510,0,933.3255813953489,39,4,15,36.20861434702637,0.6137820512820513,45.15625000000001,1019.3750000000011,26.137820512820543,0
2514,4,1,2,42,0.022727272727272728,0.045454545454545456,0.9545454545454546,44,1100,600,500,0.5454545454545454,16,6,10,345.86558817641577,0.37462561663143057,0.1435953499741962,0.19653856088734548,130158.86423631781,203.4944270936715,130362.35866341148,2511,0,913.0909090909091,40,4,16,36.070029545529984,0.61484375,44.893292682926834,1020.4268292682938,25.510670731707343,0
2515,4,0,0,42,0.0,0.0,1.0,42,550,400,150,0.7272727272727273,7,4,3,359.1930724982712,0.3639421215640728,0.14411237715922742,0.2026647607750447,129881.14458917743,930.4814769157692,130811.6260660932,2512,2,957.4047619047619,38,4,16,36.012123117772425,0.6154057017543859,45.16559829059829,1019.3376068376068,26.82467386414755,0
2516,4,0,0,42,0.0,0.0,1.0,42,700,300,400,0.42857142857142855,11,3,8,358.7484673271758,0.36401471157568716,0.14322390383377526,0.20269607008308105,129935.60209155161,922.8396203155847,130858.4417118672,2513,3,958.4047619047619,38,4,17,35.96811799224563,0.615953947368421,45.11217948717949,1019.5512820512821,26.83029689608637,0
2517,4,2,1,43,0.045454545454545456,0.022727272727272728,0.9772727272727273,44,950,700,250,0.7368421052631579,12,7,5,348.47554308377363,0.3731611169837914,0.14942211766543378,0.1989793214432361,130346.55044100096,285.74973242220585,130632.30017342317,2514,0,915.7954545454545,37,7,18,35.81317781595618,0.6219031531531531,44.7094298245614,1021.1622807017534,27.59898055950685,0
2518,4,0,0,43,0.0,0.0,1.0,43,1000,700,300,0.7,13,7,6,354.5621687739428,0.36800941306755264,0.15260698033542153,0.20216733472355772,130291.32806793296,639.2751704407308,130930.60323837369,2515,1,938.0930232558139,36,7,18,35.71379329362453,0.6232638888888888,44.76351351351352,1020.9459459459472,28.359609609609645,0
2519,4,0,0,43,0.0,0.0,1.0,43,1050,800,250,0.7619047619047619,13,8,5,354.8026651165025,0.36824012550756735,0.14759197573128002,0.20275396155901457,130377.5708774653,651.6619237480766,131029.23280121338,2516,2,939.0930232558139,36,7,18,35.62019884588525,0.6241319444444444,44.679054054054056,1021.2837837837839,28.368993993993996,0
2520,4,1,1,43,0.022727272727272728,0.022727272727272728,0.9772727272727273,44,1000,700,300,0.7,13,7,6,344.34519626876863,0.37311707188160675,0.13704223525379122,0.19795309964765248,130608.41064453125,194.87575954861072,130803.28640407986,2517,0,918.7272727272727,39,5,14,35.65349111722544,0.6209935897435896,44.453125,1022.1875,26.209935897435898,0
2521,4,0,0,43,0.0,0.0,1.0,43,700,600,100,0.8571428571428571,8,6,2,350.9067871107223,0.368563122923588,0.14269076939909264,0.20134513609562457,130535.38795976709,561.1507186427162,131096.5386784098,2518,4,941.0930232558139,38,5,14,35.55976650984492,0.6219846491228069,44.524572649572654,1021.9017094017104,26.89215024741343,0
2522,4,1,1,43,0.022727272727272728,0.022727272727272728,0.9772727272727273,44,900,600,300,0.6666666666666666,12,6,6,344.9506060737478,0.37210403453136015,0.15242615545537852,0.19939728677164698,130821.4531792537,225.38791232641347,131046.84109158012,2519,0,920.6818181818181,39,5,15,35.42250025455657,0.6231303418803418,44.24479166666668,1023.0208333333352,26.231303418803467,0
2523,4,0,0,43,0.0,0.0,1.0,43,1200,800,400,0.6666666666666666,16,8,8,352.7462289610085,0.36680970837947585,0.15350197482522887,0.2036907355894268,130781.15297866902,626.5117064796553,131407.6646851487,2520,1,942.9767441860465,38,5,15,35.26390919852376,0.6244517543859649,44.284188034188034,1022.863247863248,26.917453891138106,0
2524,4,0,0,43,0.0,0.0,1.0,43,1500,1300,200,0.8666666666666667,17,13,4,352.00822376015606,0.3669481358434847,0.15846877777076318,0.20384127975663693,130890.4560687413,614.9033895828725,131505.35945832418,2521,2,943.9767441860465,38,5,16,35.1721827799819,0.6255482456140351,44.177350427350426,1023.2905982905982,26.92869995501574,0
2525,4,0,0,43,0.0,0.0,1.0,43,850,700,150,0.8235294117647058,10,7,3,351.7945553046592,0.36724806201550386,0.15737356380422596,0.2042966926623782,130999.8048159104,617.0036160420564,131616.80843195244,2522,3,944.9767441860465,38,5,17,35.0670528073471,0.6266447368421053,44.07051282051281,1023.7179487179473,26.939946018893348,0
2526,4,0,0,43,0.0,0.0,1.0,43,650,400,250,0.6153846153846154,9,4,5,350.01864656340535,0.3668327796234773,0.14784365333346283,0.20268915337269033,130890.45606874143,570.653101943178,131461.10917068462,2523,4,945.9767441860465,38,5,16,35.223080670982114,0.625548245614035,44.17735042735043,1023.2905982905992,26.92869995501577,3
2527,4,0,0,43,0.0,0.0,1.0,43,1200,1000,200,0.8333333333333334,14,10,4,351.8850214434455,0.36680970837947585,0.15391597038360083,0.20449449123666105,131027.14913662433,621.2982367229201,131648.44737334724,2524,5,946.9767441860465,38,5,16,35.03708824654771,0.6269188596491228,44.04380341880342,1023.8247863247865,26.942757534862803,0
2528,4,1,0,44,0.022727272727272728,0.0,1.0,44,750,600,150,0.8,9,6,3,343.38026307092343,0.3719168428470754,0.1542867701404287,0.2011227255129695,131328.12500000012,219.09722222223644,131547.22222222236,2525,0,926.4318181818181,39,5,18,34.95088075880759,0.6282051282051282,43.75000000000001,1025.000000000001,26.282051282051306,0
2529,4,0,0,44,0.0,0.0,1.0,44,1550,1200,350,0.7741935483870968,19,12,7,345.1543618829282,0.37185077519379844,0.15765963340874434,0.2028683398649214,131461.62245008702,274.9104817708584,131736.5329318579,2526,1,927.4318181818181,39,5,18,34.770716945996284,0.6295405982905982,43.61979166666668,1025.520833333335,26.29540598290603,0
2530,4,0,0,44,0.0,0.0,1.0,44,800,500,300,0.625,11,5,6,345.1532639825772,0.3719939217758985,0.15530533857773365,0.20300950042846222,131488.33007812512,276.7252604166822,131765.0553385418,2527,2,928.4318181818181,39,5,19,34.743804590696755,0.6298076923076923,43.59375000000001,1025.625000000001,26.298076923076945,0
2531,4,0,2,42,0.0,0.045454545454545456,0.9545454545454546,44,1300,1000,300,0.7692307692307693,16,10,6,346.9975467254293,0.37177369626497536,0.07380564655090782,0.2044092296722435,131547.23340821083,335.5851556221953,131882.81856383302,2528,3,929.4318181818181,38,6,17,34.63709817399153,0.6321271929824562,43.536324786324776,1025.8547008546996,26.99617633828157,3
2532,4,1,0,43,0.023255813953488372,0.0,1.0,43,1050,700,350,0.6666666666666666,14,7,7,352.27891120511936,0.36494093761535623,0.0860477545896361,0.20739894363271805,131524.88175448202,666.6884281701912,132191.5701826522,2529,0,951.4186046511628,37,6,19,34.52420719757704,0.6337274774774775,43.55811403508771,1025.7675438596482,27.723447131341842,0
2533,4,0,1,42,0.0,0.023255813953488372,0.9767441860465116,43,900,700,200,0.7777777777777778,11,7,4,350.53284740114447,0.3652639350313769,0.08975282931654016,0.2068276409823397,131609.25116381957,626.6731109572087,132235.92427477677,2530,1,952.4186046511628,37,6,15,34.483864073519975,0.6345720720720721,43.47587719298245,1026.0964912280697,27.73233760075864,0
2534,4,0,0,42,0.0,0.0,1.0,42,1050,600,450,0.5714285714285714,15,6,9,358.21552832953626,0.3609417344173442,0.09303121373523382,0.21101751552271183,131547.2334082108,1024.4523431221949,132571.685751333,2531,12,976.0714285714286,38,4,18,34.34939769492467,0.6321271929824562,43.536324786324776,1025.8547008546993,26.99617633828156,0
2535,4,0,0,42,0.0,0.0,1.0,42,750,600,150,0.8,9,6,3,358.130625572823,0.36100222609368954,0.09234465420032434,0.21111899308629956,131574.6348002958,1024.181254109129,132598.81605440495,2532,13,977.0714285714286,38,4,16,34.32390919504322,0.6324013157894738,43.50961538461538,1025.9615384615379,26.998987854251,0
2536,4,0,0,42,0.0,0.0,1.0,42,850,500,350,0.5882352941176471,12,5,7,361.12182846938407,0.36141356949283776,0.0568058795724502,0.21481589910664523,131918.83710612892,1130.322544766861,133049.15965089577,2533,14,978.0714285714286,37,5,16,33.89980698758317,0.6376689189189189,43.174342105263165,1027.3026315789484,27.764935988620227,1
2537,4,0,0,42,0.0,0.0,1.0,42,1200,800,400,0.6666666666666666,16,8,8,359.04526519482306,0.36117160278745647,0.0669628568380305,0.21421586700643394,132031.5039843991,1081.057272429986,133112.5612568291,2534,15,979.0714285714286,37,5,16,33.839552437853406,0.638795045045045,43.064692982456144,1027.741228070176,27.776789947842595,0
2538,4,0,0,42,0.0,0.0,1.0,42,1350,900,450,0.6666666666666666,18,9,9,358.10683978266565,0.36010694928377857,0.06633871996913432,0.21479716801169596,132233.12428090064,1070.7172501643527,133303.841531065,2535,16,980.0714285714286,38,4,17,33.660538070011434,0.6389802631578948,42.86858974358974,1028.5256410256402,27.066464237516847,0
2539,4,1,0,43,0.023255813953488372,0.0,1.0,43,950,800,150,0.8421052631578947,11,8,3,350.3401760666511,0.3641795865633075,0.07268773205656287,0.2115333706167065,132482.65241468523,683.0046114837761,133165.657026169,2536,0,958.2558139534884,37,6,18,33.60925462420563,0.6432995495495495,42.62609649122807,1029.4956140350873,27.82420578473209,0
2540,4,0,0,43,0.0,0.0,1.0,43,1050,700,350,0.6666666666666666,14,7,7,348.68741819490407,0.36413344407530457,0.0757002495939143,0.21100980874268968,132567.32840874133,644.9118959680076,133212.24030470935,2537,1,959.2558139534884,37,6,18,33.566687961385576,0.6441441441441441,42.543859649122815,1029.8245614035102,27.833096254148924,0
2541,4,0,0,43,0.0,0.0,1.0,43,1450,1100,350,0.7586206896551724,18,11,7,346.6328312809955,0.36484865263935035,0.07030942581872979,0.21055647805737018,132708.51518015168,600.2256703985969,133308.74085055027,2538,2,960.2558139534884,37,6,15,33.477772161328105,0.6455518018018017,42.40679824561404,1030.3728070175446,27.84791370317688,0
2542,4,0,1,42,0.0,0.023255813953488372,0.9767441860465116,43,950,700,250,0.7368421052631579,12,7,5,346.9754677966159,0.3647332964193429,0.06511232147539103,0.21156052841918185,132849.7770948754,619.1227108341109,133468.89980570952,2539,3,961.2558139534884,37,6,16,33.32712897964973,0.6469594594594594,42.26973684210527,1030.9210526315794,27.862731152204848,0
2543,4,0,0,42,0.0,0.0,1.0,42,1350,1100,250,0.8148148148148148,16,11,5,357.703727956689,0.359647212543554,0.059235098889894644,0.21800398972806495,132832.97444403882,1102.9700308416698,133935.9444748805,2540,21,985.0714285714286,36,6,16,33.06751147039544,0.6487268518518519,42.286036036036045,1030.8558558558573,28.634884884884926,0
2544,4,1,1,42,0.023255813953488372,0.023255813953488372,0.9767441860465116,43,900,600,300,0.6666666666666666,12,6,6,352.2137828407244,0.36422572905131045,0.06618962432915909,0.21638616998021504,133132.52635426272,778.222145275454,133910.74849953817,2541,0,963.1395348837209,37,6,17,32.90834395806771,0.6497747747747749,41.99561403508771,1032.0175438596482,27.89236605026076,0
2545,4,0,0,42,0.0,0.0,1.0,42,900,500,400,0.5555555555555556,13,5,8,358.0954415882437,0.362526616337592,0.06909212283044086,0.22066928520909043,133245.71021852872,1142.936288088636,134388.64650661737,2542,1,978.4761904761905,37,5,17,32.64301897479467,0.6509009009009009,41.8859649122807,1032.4561403508767,27.904220009483154,0
2546,4,0,0,42,0.0,0.0,1.0,42,850,500,350,0.5882352941176471,12,5,7,360.94285775056426,0.36234514130855594,0.0716257412828174,0.22293250997721725,133330.6296769197,1224.9477002539088,134555.5773771736,2543,2,979.4761904761905,37,5,17,32.48431804508617,0.6517454954954955,41.80372807017543,1032.7850877192973,27.913110478899927,0
2547,4,0,0,42,0.0,0.0,1.0,42,1100,900,200,0.8181818181818182,13,9,4,359.8666359319557,0.36236933797909404,0.06659135366278979,0.22260693218088995,133387.2576778431,1200.3247393428635,134587.58241718597,2544,3,980.4761904761905,37,5,17,32.4553081767682,0.6523085585585586,41.748903508771924,1033.0043859649118,27.919037458511127,0
2548,4,0,0,42,0.0,0.0,1.0,42,900,700,200,0.7777777777777778,11,7,4,360.62695109261176,0.36267179636082075,0.06720430107526898,0.22358870967741942,133472.22222222228,1226.7631627039184,134698.9853849262,2545,4,981.4761904761905,36,6,18,32.350470430107535,0.6550925925925926,41.66666666666667,1033.333333333334,28.70370370370372,0
2549,4,0,0,42,0.0,0.0,1.0,42,950,600,350,0.631578947368421,13,6,7,361.0240000128349,0.3620426829268293,0.06398609600580007,0.2245589392837496,133591.8477794926,1245.9726508916428,134837.82043038422,2546,5,982.4761904761905,35,7,18,32.22029407374234,0.6583333333333332,41.55092592592593,1033.7962962962972,29.537037037037063,0
2550,4,0,0,42,0.0,0.0,1.0,42,650,200,450,0.3076923076923077,11,2,9,362.3992178598767,0.3623088463027488,0.06711604377562064,0.22559666990538557,133621.76254125955,1284.8844468021405,134906.6469880617,2547,6,983.4761904761905,35,7,18,32.15476790178737,0.6586309523809523,41.52199074074075,1033.912037037038,29.540343915343946,0
2551,4,0,0,42,0.0,0.0,1.0,42,800,700,100,0.875,9,7,2,364.4706264763014,0.36165553619821916,0.06953660031444042,0.2272536669620204,133681.60211173273,1344.6034540037797,135026.2055657365,2548,7,984.4761904761905,35,7,18,32.0412469688491,0.6592261904761905,41.464120370370374,1034.143518518519,29.546957671957685,0
2552,4,0,0,42,0.0,0.0,1.0,42,700,400,300,0.5714285714285714,10,4,6,364.2313921519109,0.36112320944638016,0.07502517623363536,0.2274728128344957,133741.45507812515,1342.5672743055704,135084.0223524307,2549,8,985.4761904761905,35,7,16,31.987453843571664,0.6598214285714286,41.40625000000001,1034.3750000000011,29.553571428571463,0
2553,4,0,0,42,0.0,0.0,1.0,42,750,500,250,0.6666666666666666,10,5,5,363.96558713571426,0.36096593108788233,0.07692553531479684,0.22786080875303164,133831.25964506195,1341.9945987654585,135173.2542438274,2550,9,986.4761904761905,35,7,16,31.904362416107386,0.6607142857142856,41.31944444444446,1034.722222222224,29.563492063492113,0
2554,4,0,0,42,0.0,0.0,1.0,42,1300,900,400,0.6923076923076923,17,9,8,364.15677161560916,0.36063927603561746,0.07938104819392544,0.22909609556070612,134010.95920138893,1360.1996527777833,135371.15885416672,2551,10,987.4761904761905,35,7,16,31.71948356807512,0.6624999999999999,41.145833333333336,1035.416666666667,29.583333333333343,0
2555,4,0,0,42,0.0,0.0,1.0,42,750,500,250,0.6666666666666666,10,5,5,363.77842923309436,0.36048199767711964,0.0763730327271177,0.22904472951080204,134040.9208488727,1352.2391278720945,135393.1599767448,2552,11,988.4761904761905,35,7,16,31.699289333482366,0.662797619047619,41.11689814814815,1035.532407407408,29.58664021164023,0
2556,4,0,0,42,0.0,0.0,1.0,42,950,700,250,0.7368421052631579,12,7,5,365.5012015854684,0.359102787456446,0.08018621973929263,0.23069363569745724,134130.82588520242,1404.995606138552,135535.82149134096,2553,12,989.4761904761905,35,7,16,31.56471135940408,0.663690476190476,41.030092592592595,1035.8796296296302,29.596560846560863,0
2557,4,0,1,41,0.0,0.023809523809523808,0.9761904761904762,42,650,400,250,0.6153846153846154,9,4,5,363.6912505660213,0.3593205574912892,0.08183326950083014,0.22992684145953568,134190.77932098776,1360.802469135816,135551.58179012357,2554,13,990.4761904761905,35,7,17,31.55160857908848,0.6642857142857143,40.97222222222223,1036.111111111112,29.60317460317463,0
2558,4,0,0,41,0.0,0.0,1.0,41,950,800,150,0.8421052631578947,11,8,3,373.668912670102,0.3540142276422764,0.07984300532660549,0.23557387972680327,134088.01020408157,1820.9041950113342,135908.9143990929,2555,36,1015.3170731707318,34,7,17,31.39607279693487,0.6654411764705883,41.07142857142857,1035.714285714285,30.46218487394956,0
2559,4,0,0,41,0.0,0.0,1.0,41,1000,700,300,0.7,13,7,6,374.4940948315886,0.3544207317073171,0.08311683944140369,0.23669005862885364,134180.50063775506,1849.9610260770914,136030.46166383216,2556,37,1016.3170731707318,34,7,17,31.282077061549646,0.666360294117647,40.982142857142854,1036.0714285714282,30.472689075630242,0
2560,4,0,0,41,0.0,0.0,1.0,41,1200,900,300,0.75,15,9,6,376.25903489267944,0.3540142276422764,0.08407684720229547,0.23800571509490417,134211.33786848068,1899.64569160997,136110.98356009065,2557,38,1017.3170731707318,34,7,17,31.205480238970594,0.6666666666666667,40.95238095238095,1036.190476190476,30.476190476190467,0
2561,4,0,0,41,0.0,0.0,1.0,41,1350,1000,350,0.7407407407407407,17,10,7,377.4952557203542,0.35378556910569103,0.08678063348517706,0.23919022534944687,134273.0229591835,1937.4858276643763,136210.50878684787,2558,39,1018.3170731707318,34,7,17,31.111685427674395,0.667279411764706,40.89285714285713,1036.42857142857,30.483193277310882,0
2562,4,0,0,41,0.0,0.0,1.0,41,700,600,100,0.8571428571428571,8,6,2,380.611632464185,0.3528963414634146,0.09448272390837276,0.24184204969618694,134375.5849388239,2028.982149379095,136404.56708820298,2559,40,1019.3170731707318,36,5,17,30.92823395242749,0.6640625,40.79391891891891,1036.8243243243237,28.80067567567566,0
2563,4,1,1,41,0.023809523809523808,0.023809523809523808,0.9761904761904762,42,850,600,250,0.7058823529411765,11,6,5,370.5035885348324,0.35784456058846303,0.09192472707191701,0.237334012998598,134670.88906035645,1579.4378024170032,136250.32686277345,2560,0,996.0238095238095,35,7,17,30.89503419565862,0.6690476190476191,40.509259259259245,1037.9629629629612,29.656084656084605,0
2564,4,0,0,41,0.0,0.0,1.0,41,950,700,250,0.7368421052631579,12,7,5,377.25197980677757,0.3520579268292683,0.09109609168380861,0.24086087941509618,134550.78124999985,1951.9097222222085,136502.69097222207,2561,42,1021.3170731707318,34,7,17,30.84002677376172,0.6700367647058825,40.62499999999999,1037.4999999999989,30.514705882352906,0
2565,4,0,0,41,0.0,0.0,1.0,41,800,600,200,0.75,10,6,4,376.36054087766695,0.3516514227642276,0.09727564416371348,0.24110856399062267,134674.32149943296,1937.2200963718642,136611.54159580483,2562,43,1022.3170731707318,34,7,19,30.739620369308405,0.6712622549019609,40.50595238095237,1037.9761904761892,30.5287114845938,0
2566,4,0,0,41,0.0,0.0,1.0,41,1400,1100,300,0.7857142857142857,17,11,6,376.9860358259663,0.351219512195122,0.09762250357281688,0.24192017795719292,134736.11288265305,1958.7266156462547,136694.8394982993,2563,44,1023.3170731707318,34,7,19,30.661621373695677,0.671875,40.44642857142857,1038.2142857142856,30.53571428571428,0
2567,4,0,0,41,0.0,0.0,1.0,41,1050,800,250,0.7619047619047619,13,8,5,375.9961249996778,0.3510670731707317,0.09740437693301462,0.24149029471628794,134767.01388888888,1934.374999999995,136701.38888888888,2564,45,1024.3170731707316,34,7,19,30.65643392188335,0.6721813725490196,40.416666666666664,1038.3333333333333,30.539215686274506,0
2568,4,0,0,41,0.0,0.0,1.0,41,1350,1100,250,0.8148148148148148,16,11,5,373.6523778203553,0.3504573170731707,0.1003652015129779,0.24094136087036686,134911.26543209865,1881.9830246913455,136793.24845679,2565,46,1025.3170731707316,35,6,14,30.57319518716577,0.6714285714285715,40.27777777777777,1038.888888888888,29.68253968253966,0
2569,4,0,0,41,0.0,0.0,1.0,41,1450,1100,350,0.7586206896551724,18,11,7,373.27212655344937,0.3505589430894309,0.10292308068419831,0.24129664681954063,135001.4618296681,1878.4565489968977,136879.918378665,2566,47,1026.3170731707316,35,6,15,30.493025392582688,0.6723214285714286,40.190972222222214,1039.2361111111102,29.69246031746029,0
2570,4,0,0,41,0.0,0.0,1.0,41,1000,500,500,0.5,15,5,10,376.9864378054704,0.3504827235772358,0.09824527102986447,0.2443067954089999,135091.68836805565,1985.54687500001,137077.23524305565,2567,48,1027.3170731707316,35,6,15,30.3064462257849,0.6732142857142855,40.10416666666667,1039.5833333333342,29.702380952380977,0
2571,4,0,0,41,0.0,0.0,1.0,41,800,600,200,0.75,10,6,4,374.1918222078534,0.3507621951219512,0.0943523759110716,0.2431029300461,135181.94504726084,1916.7956693672909,137098.74071662815,2568,49,1028.3170731707316,35,6,15,30.28902337228714,0.6741071428571428,40.017361111111114,1039.9305555555559,29.712301587301596,0
2572,4,0,1,40,0.0,0.024390243902439025,0.975609756097561,41,550,200,350,0.36363636363636365,9,2,7,370.87776445868263,0.3507621951219512,0.09789200350563942,0.24175636147346644,135302.33417191808,1836.125444744535,137138.4596166626,2569,50,1029.3170731707316,35,6,15,30.255149812734082,0.675297619047619,39.90162037037038,1040.39351851852,29.725529100529144,0
2573,4,0,1,39,0.0,0.025,0.975,40,950,800,150,0.8421052631578947,11,8,3,373.32668376494627,0.35213675213675216,0.0829663730984791,0.24412828692273214,135416.7534722224,2110.937500000024,137527.69097222242,2570,51,992.2,34,6,15,30.077395249532977,0.6786151960784312,39.79166666666668,1040.8333333333346,30.612745098039255,0
2574,4,0,0,39,0.0,0.0,1.0,39,350,200,150,0.5714285714285714,5,2,3,374.30779959599425,0.35093342330184435,0.07420331503053279,0.24501632820716007,135452.8959297843,2340.2150848765846,137793.11101466088,2571,52,988.9230769230769,35,4,15,30.015843895930622,0.6767857142857141,39.756944444444464,1040.9722222222251,29.742063492063576,0
2575,4,0,0,39,0.0,0.0,1.0,39,700,300,400,0.42857142857142855,11,3,8,375.94265877770044,0.35028677462887986,0.07746107811000735,0.2465223987984837,135516.4011139519,2389.2792285528876,137905.68034250478,2572,53,989.9230769230769,36,3,16,29.91000612877641,0.6753472222222221,39.69594594594595,1041.216216216217,28.922672672672693,0
2576,4,1,1,39,0.025,0.025,0.975,40,700,400,300,0.5714285714285714,10,4,6,366.0130708276091,0.35460737179487184,0.07365507183752817,0.24218606123310826,135839.04163876743,1943.8236800990462,137782.86531886648,2573,0,966.15,36,4,17,29.84745777969824,0.6785300925925926,39.386261261261275,1042.4549549549572,28.957082082082145,0
2577,4,0,0,39,0.0,0.0,1.0,39,850,700,150,0.8235294117647058,10,7,3,371.66482774797555,0.34980881691408006,0.07724442080535421,0.24572354611680464,135809.69482996527,2295.1373670968455,138104.83219706212,2574,55,991.9230769230769,36,3,17,29.729364736387204,0.6782407407407407,39.41441441441442,1042.3423423423437,28.95395395395399,0
2578,4,0,0,39,0.0,0.0,1.0,39,1100,900,200,0.8181818181818182,13,9,4,374.4917083620664,0.34955578047683306,0.07361375349278987,0.24820463333746434,135897.7447675718,2378.5157201120232,138276.26048768382,2575,56,992.9230769230769,36,3,16,29.568077906181365,0.6791087962962963,39.329954954954964,1042.6801801801817,28.963338338338378,0
2579,4,0,0,39,0.0,0.0,1.0,39,1050,700,350,0.6666666666666666,14,7,7,374.88326203882065,0.3496401259559154,0.07629728083291809,0.24866898327216938,135927.1010875743,2391.3590110380937,138318.46009861238,2576,57,993.9230769230769,36,3,16,29.528662706983443,0.6793981481481481,39.301801801801815,1042.7927927927947,28.966466466466517,0
2580,4,0,0,39,0.0,0.0,1.0,39,650,300,350,0.46153846153846156,10,3,7,374.04340105438894,0.3495838956365272,0.08145773466438522,0.24852151940930806,135985.8232387795,2372.9199638828204,138358.74320266233,2577,58,994.9230769230769,36,3,16,29.492145324983806,0.6799768518518519,39.245495495495504,1043.0180180180193,28.97272272272276,0
2581,4,0,0,39,0.0,0.0,1.0,39,1050,700,350,0.6666666666666666,14,7,7,372.8779834861798,0.348740440845704,0.08376714129547369,0.24836193508263574,136073.93024358846,2347.7945428536977,138421.72478644215,2578,59,995.9230769230769,36,3,16,29.43492534628531,0.6808449074074072,39.16103603603605,1043.3558558558582,28.982107107107172,0
2582,4,0,0,39,0.0,0.0,1.0,39,900,500,400,0.5555555555555556,13,5,8,366.8293575462428,0.34876855600539813,0.08481305038256104,0.23859408072514776,135223.42443795147,2122.318856018182,137345.74329396966,2579,60,996.9230769230769,36,3,15,30.43908798902844,0.6724537037037037,39.97747747747748,1040.0900900900901,28.891391391391394,2
2583,4,0,0,39,0.0,0.0,1.0,39,1100,800,300,0.7272727272727273,14,8,6,365.71834487294564,0.34919028340080976,0.08256912968623742,0.23813108701507438,135262.7265721183,2093.6120969913745,137356.33866910965,2580,61,997.9230769230769,37,2,15,30.428810477495517,0.6708896396396395,39.93969298245614,1040.2412280701749,28.1146277856804,0
2584,4,0,0,39,0.0,0.0,1.0,39,750,600,150,0.8,9,6,3,365.06865970613006,0.3488529014844804,0.07910080786793161,0.2382738363556513,135348.28625153875,2082.283491074161,137430.56974261292,2581,62,998.9230769230769,37,2,15,30.360467158412376,0.6717342342342343,39.85745614035087,1040.570175438595,28.123518255097164,0
2585,4,0,0,39,0.0,0.0,1.0,39,950,900,50,0.9473684210526315,10,9,1,368.4612888900506,0.34896536212325685,0.08200590926523121,0.24125320529118216,135462.4079043552,2182.530682517705,137644.93858687292,2582,63,999.9230769230769,37,2,15,30.158521171266063,0.6728603603603602,39.74780701754386,1041.008771929825,28.13537221431959,0
2586,4,0,0,39,0.0,0.0,1.0,39,1100,800,300,0.7272727272727273,14,8,6,367.6290476127698,0.348740440845704,0.08408053285382966,0.2412835566813046,135548.03070415911,2166.278686711309,137714.30939087042,2583,64,1000.9230769230769,37,2,15,30.09492032571689,0.673704954954955,39.6655701754386,1041.3377192982466,28.144262683736393,0
2587,4,0,0,39,0.0,0.0,1.0,39,650,300,350,0.46153846153846156,10,3,7,366.8181626401331,0.34840305892937473,0.07835102750357015,0.24113534442343418,135605.1275993575,2148.4847501154227,137753.61234947294,2584,65,1001.9230769230769,37,2,16,30.059194827525708,0.6742680180180181,39.61074561403509,1041.5570175438597,28.15018966334756,0
2588,4,0,1,38,0.0,0.02564102564102564,0.9743589743589743,39,900,700,200,0.7777777777777778,11,7,4,349.3494645027333,0.34840305892937473,0.08078154502914425,0.2079672479282471,131946.9993170975,1419.1257165666373,133366.12503366414,2585,66,1002.9230769230769,37,2,15,34.173781572394184,0.6379504504504505,43.146929824561404,1027.412280701754,27.767899478425786,7
2589,4,1,0,39,0.02564102564102564,0.0,1.0,39,900,600,300,0.6666666666666666,12,6,6,342.804932774247,0.35405420602789023,0.08514951573022955,0.20636461155139874,132369.79316953284,1275.4036097645303,133645.19677929737,2586,0,973.7435897435897,37,2,16,33.91660007103534,0.6421734234234234,42.73574561403508,1029.0570175438588,27.812351825509698,0
2590,4,0,0,39,0.0,0.0,1.0,39,650,500,150,0.7692307692307693,8,5,3,341.7976815376637,0.35385739991003146,0.0818066810846596,0.2062292149792597,132455.95838659612,1254.6309022101004,133710.58928880622,2587,1,974.7435897435897,36,3,16,33.85593297596909,0.6449652777777778,42.65202702702703,1029.3918918918923,28.59421921921923,0
2591,4,0,0,39,0.0,0.0,1.0,39,650,500,150,0.7692307692307693,8,5,3,343.77127122400196,0.3536605937921728,0.08409403859474995,0.2077396386517549,132513.9259825705,1310.8961579823194,133824.82214055283,2588,2,975.7435897435897,36,3,16,33.74690109008714,0.6455439814814814,42.59572072072073,1029.617117117118,28.6004754754755,0
2592,4,0,0,39,0.0,0.0,1.0,39,700,500,200,0.7142857142857143,9,5,4,345.3793613076008,0.3539136302294197,0.08472052824157794,0.20903337254520254,132571.9062601453,1357.5200622920254,133929.42632243733,2589,3,976.7435897435897,36,3,16,33.64725715327137,0.6461226851851851,42.539414414414416,1029.8423423423426,28.606731731731738,0
2593,4,0,0,39,0.0,0.0,1.0,39,1100,800,300,0.7272727272727273,14,8,6,345.3134414298847,0.35441970310391363,0.08410211558784852,0.20931623914904945,132629.89921932074,1359.77738718449,133989.67660650524,2590,4,977.7435897435897,36,3,13,33.59070369155643,0.6467013888888888,42.48310810810811,1030.0675675675682,28.612987987988006,0
2594,4,0,0,39,0.0,0.0,1.0,39,1300,800,500,0.6153846153846154,18,8,10,346.46096500745733,0.3546727395411606,0.0932344898691051,0.2108251829619848,132774.93709926156,1400.266567242931,134175.2036665045,2591,5,978.7435897435897,36,3,14,33.41551027097902,0.6481481481481481,42.34234234234235,1030.6306306306317,28.628628628628658,0
2595,4,0,0,39,0.0,0.0,1.0,39,1450,1200,250,0.8275862068965517,17,12,5,344.7316558135752,0.3556567701304543,0.09572537554188898,0.21042420270860637,132891.02447041645,1362.348581689805,134253.37305210627,2592,6,979.7435897435897,36,3,15,33.34357252075141,0.6493055555555556,42.22972972972973,1031.0810810810817,28.64114114114116,0
2596,4,0,0,39,0.0,0.0,1.0,39,850,700,150,0.8235294117647058,10,7,3,346.3995848141853,0.3559098065677013,0.09323958412087707,0.21160647085680442,132920.05423920558,1408.690320387972,134328.74455959356,2593,7,980.7435897435897,36,3,15,33.27144989261403,0.6495949074074073,42.201576576576585,1031.193693693695,28.644269269269305,0
2597,4,0,0,39,0.0,0.0,1.0,39,1050,700,350,0.6666666666666666,14,7,7,347.42132123700605,0.3561628430049482,0.09469178417753588,0.2125605799071303,132978.123287984,1439.8870576657803,134418.0103456498,2594,8,981.7435897435897,36,3,16,33.186847181278885,0.6501736111111112,42.145270270270274,1031.4189189189194,28.650525525525538,0
2598,4,0,0,39,0.0,0.0,1.0,39,600,400,200,0.6666666666666666,8,4,4,347.10091774668143,0.355572424651372,0.10028577106407033,0.21269508411219734,133036.20501836305,1435.3977710819038,134471.60278944497,2595,9,982.7435897435897,36,3,16,33.13684823345341,0.6507523148148149,42.08896396396397,1031.644144144145,28.656781781781806,0
2599,4,0,0,39,0.0,0.0,1.0,39,800,400,400,0.5,12,4,8,349.2163016484826,0.3561628430049482,0.10346875936674049,0.21421938712595961,133075.95245652506,1494.4583910433935,134570.41084756845,2596,10,983.7435897435897,37,2,16,33.04241941197308,0.6492117117117117,42.050438596491226,1031.7982456140348,27.88643907064959,0
2600,4,0,0,39,0.0,0.0,1.0,39,1200,700,500,0.5833333333333334,17,7,10,349.5081681587432,0.3552631578947369,0.10409237561555473,0.21541115670191907,133251.51581561824,1514.498639418497,134766.01445503675,2597,11,984.7435897435897,38,1,16,32.8588489928256,0.6491228070175439,41.880341880341874,1032.4786324786314,27.17049032838504,0
2601,4,0,0,39,0.0,0.0,1.0,39,1000,700,300,0.7,13,7,6,347.32986196759305,0.3555443094916779,0.10581033915746385,0.2147049300193535,133361.8461903718,1464.110325809041,134825.95651618086,2598,12,985.7435897435897,38,1,17,32.80452696179837,0.6502192982456141,41.77350427350427,1032.9059829059827,27.181736392262703,0
2602,4,0,0,39,0.0,0.0,1.0,39,400,200,200,0.5,6,2,4,346.6830911742113,0.35571300044984255,0.10520537482994818,0.2144644151352175,133389.43591798155,1448.7723948060413,134838.20831278758,2599,13,986.7435897435897,38,1,17,32.79359292584549,0.6504934210526316,41.74679487179487,1033.01282051282,27.18454790823211,0
2603,4,0,0,39,0.0,0.0,1.0,39,800,700,100,0.875,9,7,2,348.92039542143596,0.3558535762483131,0.10545905707196024,0.21633064516129036,133472.22222222228,1514.2617932281482,134986.48401545043,2600,14,987.7435897435897,37,2,17,32.65288978494624,0.6531531531531531,41.66666666666667,1033.333333333334,27.927927927927943,0
2604,4,0,0,39,0.0,0.0,1.0,39,800,600,200,0.75,10,6,4,349.93310158898123,0.3562190733243365,0.10420151610349992,0.21745677974155087,133557.21381819402,1547.218014196677,135104.4318323907,2601,15,988.7435897435897,37,2,17,32.54161362752377,0.6539977477477477,41.584429824561404,1033.6622807017543,27.936818397344712,0
2605,4,0,0,39,0.0,0.0,1.0,39,1100,800,300,0.7272727272727273,14,8,6,350.076156550205,0.3567813765182186,0.10934479580434431,0.2182133663202235,133670.57802641188,1558.976439866107,135229.554466278,2602,16,989.7435897435897,37,2,19,32.42442918743152,0.6551238738738738,41.47478070175438,1034.100877192982,27.94867235656708,0
2606,4,0,0,39,0.0,0.0,1.0,39,800,600,200,0.75,10,6,4,356.5351061517992,0.35658457040035985,0.10168662268631179,0.21636677335568255,132673.0304099092,1660.5185961355598,134333.54900604475,2603,17,990.7435897435897,38,1,16,33.25836530816827,0.6433662280701755,42.441239316239304,1030.2350427350411,27.1114484930274,2
2607,4,0,0,39,0.0,0.0,1.0,39,1150,800,350,0.6956521739130435,15,8,7,354.4379606746064,0.3565283400809716,0.10699568797175285,0.2163618443055424,132893.2574169954,1620.4830292570666,134513.74044625246,2604,18,991.7435897435897,38,1,18,33.09113045280282,0.6455592105263158,42.2275641025641,1031.0897435897434,27.13394062078272,0
2608,4,0,0,39,0.0,0.0,1.0,39,1150,800,350,0.6956521739130435,15,8,7,357.3383113182087,0.35644399460188936,0.10723383457248614,0.21845387708389274,132948.3427044524,1701.507254912694,134649.8499593651,2605,19,992.7435897435897,38,1,18,32.961039745847586,0.6461074561403508,42.174145299145295,1031.303418803418,27.139563652721527,0
2609,4,0,0,39,0.0,0.0,1.0,39,800,500,300,0.625,11,5,6,356.285962012583,0.3569781826360774,0.1114076670783044,0.21813195708506572,133003.43940618372,1677.4516719628864,134680.8910781466,2606,20,993.7435897435897,38,1,18,32.932849991368904,0.6466557017543859,42.120726495726494,1031.5170940170935,27.145186684660356,0
2610,4,0,0,39,0.0,0.0,1.0,39,850,600,250,0.7058823529411765,11,6,5,356.10944154537077,0.3569781826360774,0.05739316675699824,0.20193281766379928,130076.56385633671,1464.2985026041579,131540.86235894088,2607,21,994.7435897435897,39,0,19,35.892240205589026,0.6156517094017095,44.97395833333333,1020.1041666666658,26.156517094017072,6
2611,4,0,0,39,0.0,0.0,1.0,39,800,600,200,0.75,10,6,4,353.8966194491454,0.3578216374269006,0.05066444748012433,0.20136347719876463,130209.423828125,1416.134982638889,131625.55881076388,2608,22,995.7435897435897,39,0,21,35.8138565693679,0.6169871794871795,44.84375,1020.625,26.169871794871796,0
2612,4,3,3,39,0.07142857142857142,0.07142857142857142,0.9285714285714286,42,850,600,250,0.7058823529411765,11,6,5,333.14092294287104,0.373741773132017,0.04636923937663018,0.19212946998574074,130732.8708085449,310.4938480259369,131043.36465657083,2609,0,925.547619047619,42,0,14,35.81402785673678,0.617559523809524,44.3313953488372,1022.6744186046491,24.34939091915831,0
2613,4,1,0,40,0.025,0.0,1.0,40,550,300,250,0.5454545454545454,8,3,5,356.3045188115839,0.36014957264957265,0.08252982107355922,0.20505855030003062,130651.91436975349,1310.3734962654576,131962.28786601895,2610,0,972.8,40,0,15,35.30380218687874,0.6197916666666667,44.41056910569106,1022.357723577236,25.5589430894309,0
2614,4,1,0,41,0.024390243902439025,0.0,1.0,41,1050,700,350,0.6666666666666666,14,7,7,354.37890626170235,0.3645325203252032,0.08596975978481569,0.20578705310717552,130997.85175933808,1084.575085821377,132082.42684515947,2611,0,950.0487804878048,41,0,16,35.002887069160444,0.6216971544715446,44.07242063492064,1023.7103174603182,24.968544328300442,0
2615,4,0,0,41,0.0,0.0,1.0,41,950,700,250,0.7368421052631579,12,7,5,353.98646389449874,0.36387195121951216,0.09228740936058033,0.20610277872436067,131099.43000637766,1081.4847293084038,132180.91473568606,2612,1,951.0487804878048,41,0,17,34.91021263198684,0.6227134146341463,43.97321428571429,1024.1071428571436,24.978222996515697,0
2616,4,0,0,41,0.0,0.0,1.0,41,1200,900,300,0.75,15,9,6,355.78117772148846,0.3634400406504065,0.09582269542071731,0.2076965642922449,131201.04762101607,1135.7726481796426,132336.8202691957,2613,2,952.0487804878048,41,0,17,34.76152722636452,0.6237296747967479,43.87400793650794,1024.5039682539689,24.98790166473095,0
2617,4,2,2,41,0.046511627906976744,0.046511627906976744,0.9534883720930233,43,1400,900,500,0.6428571428571429,19,9,10,344.30776205221537,0.37262366186784796,0.0995453423005972,0.20340838636368883,131656.8560979619,466.4030557503033,132123.2591537122,2614,0,908.7209302325581,38,5,13,34.59556527170518,0.6332236842105262,43.42948717948718,1026.2820512820515,27.00742240215925,0
2618,4,0,1,40,0.0,0.024390243902439025,0.975609756097561,41,1100,900,200,0.8181818181818182,13,9,4,354.98083068532856,0.3644308943089431,0.1329262352535845,0.1990102800100983,129630.3985280456,1003.2613103111723,130633.65983835676,2615,4,954.0487804878048,41,0,13,36.374309952914444,0.6079776422764227,45.411706349206355,1018.3531746031756,24.837882307394526,7
2619,4,1,0,41,0.024390243902439025,0.0,1.0,41,1250,1000,250,0.8,15,10,5,352.2980163288064,0.3638973577235773,0.14760953762784612,0.19827139318976283,129781.98346757694,944.3870661690677,130726.37053374601,2616,0,954.9268292682926,41,0,14,36.2885592120209,0.6095020325203251,45.26289682539683,1018.9484126984134,24.8524003097174,0
2620,4,2,2,41,0.046511627906976744,0.046511627906976744,0.9534883720930233,43,1350,1200,150,0.8888888888888888,15,12,3,342.45972409060505,0.3769610557401255,0.1348402001953808,0.1952525759485934,130288.52390276946,326.37908393288126,130614.90298670235,2617,0,911.4651162790698,40,3,14,36.02553255026877,0.6161458333333334,44.766260162601625,1020.934959349593,25.523373983739823,0
2621,4,0,0,41,0.0,0.0,1.0,41,1250,1000,250,0.8,15,10,5,353.2852519371665,0.3644817073170732,0.13766115490793163,0.20050692775506734,130110.72137188207,993.2397959183656,131103.96116780044,2618,2,956.9268292682926,41,0,14,35.92959937767405,0.6128048780487805,44.94047619047619,1020.2380952380952,24.883855981416957,0
2622,4,0,0,41,0.0,0.0,1.0,41,950,500,450,0.5263157894736842,14,5,9,358.029345820162,0.3644563008130081,0.14318362857034495,0.20372820297554325,130211.95515243118,1123.9402242378294,131335.895376669,2619,3,957.9268292682926,41,0,14,35.705838517366516,0.6138211382113821,44.841269841269835,1020.6349206349194,24.89353464963218,0
2623,4,0,0,41,0.0,0.0,1.0,41,1200,900,300,0.75,15,9,6,355.8036811881824,0.3639989837398374,0.13968844778726286,0.20314172898589097,130342.35161675328,1075.2773877924815,131417.62900454577,2620,4,958.9268292682926,39,2,16,35.63035550341732,0.6183226495726497,44.71354166666666,1021.1458333333318,26.183226495726455,0
2624,4,1,0,42,0.023809523809523808,0.0,1.0,42,800,400,400,0.5,12,4,8,353.9791074625806,0.3685878823073945,0.15773927861403014,0.20372024148018053,130651.91436975324,849.609607376538,131501.52397712978,2621,0,937.0714285714286,40,2,11,35.363237243207415,0.6197916666666667,44.410569105691046,1022.3577235772341,25.55894308943085,0
2625,4,0,0,42,0.0,0.0,1.0,42,850,600,250,0.7058823529411765,11,6,5,353.215762261896,0.3688177506775068,0.16278635075216608,0.20369112983618665,130729.8495955614,835.1686950558401,131565.01829061724,2622,1,938.0714285714286,40,2,11,35.30383583424426,0.6205729166666667,44.33434959349593,1022.6626016260154,25.566565040650385,0
2626,4,0,0,42,0.0,0.0,1.0,42,750,400,350,0.5333333333333333,11,4,7,355.7210649631721,0.36880565234223767,0.1665142931020953,0.20575161766490113,130845.55820302629,908.9042619362248,131754.4624649625,2623,2,939.0714285714286,41,1,12,35.1226405184395,0.6201727642276424,44.221230158730144,1023.115079365077,24.954026325977487,0
2627,4,1,0,43,0.023255813953488372,0.0,1.0,43,1200,900,300,0.75,15,9,6,349.6917306246174,0.3731773717238833,0.1693943633467958,0.20402544018562077,131179.1846944292,574.4552235442337,131753.63991797343,2624,0,918.2093023255813,42,1,13,34.939580968596275,0.6220238095238096,43.89534883720929,1024.4186046511609,24.390919158360973,0
2628,4,1,1,43,0.022727272727272728,0.022727272727272728,0.9772727272727273,44,1150,900,250,0.782608695652174,14,9,5,344.826171875,0.3761341613812544,0.18430397727272707,0.20283892463235279,131492.4391847468,268.8294126060526,131761.26859735284,2625,0,898.3181818181819,38,6,14,34.748046874999986,0.631578947368421,43.589743589743584,1025.641025641025,26.99055330634276,0
2629,4,2,1,44,0.044444444444444446,0.022222222222222223,0.9777777777777777,45,1150,800,350,0.6956521739130435,15,8,7,339.0528905466105,0.38272306397306394,0.20344757655647894,0.20167307639147616,131916.02105034734,-54.698350694439256,131861.3226996529,2626,0,879.1111111111111,39,6,12,34.469428107888845,0.6340811965811965,43.177083333333336,1027.2916666666674,26.340811965811984,0
2630,4,2,2,44,0.043478260869565216,0.043478260869565216,0.9565217391304348,46,1100,700,400,0.6363636363636364,15,7,8,333.06977663569876,0.3869363929146538,0.19753431250375986,0.19940828402366864,132162.7802977725,-396.11445733359534,131766.6658404389,2627,0,860.9565217391304,40,6,12,34.375,0.6348958333333334,42.9369918699187,1028.2520325203252,25.70630081300813,0
2631,4,0,0,44,0.0,0.0,1.0,44,1050,700,350,0.6666666666666666,14,7,7,347.87223975412405,0.3788539464411558,0.2036234556518537,0.20662772795034082,131862.5217013887,374.2621527777574,132236.78385416645,2628,2,901.0909090909091,39,5,12,34.296822177146716,0.6335470085470087,43.22916666666666,1027.0833333333317,26.335470085470043,0
2632,4,1,1,44,0.022222222222222223,0.022222222222222223,0.9777777777777777,45,800,400,400,0.5,12,4,8,345.9990495174732,0.3819444444444444,0.207606120063903,0.20690064340159084,132117.37769471193,142.49742142225213,132259.87511613418,2629,0,882.0444444444445,41,4,12,34.08832304030365,0.6328760162601628,42.981150793650784,1028.075396825395,25.07500967866817,0
2633,4,1,0,45,0.022222222222222223,0.0,1.0,45,1100,800,300,0.7272727272727273,14,8,6,349.3333753739973,0.38318602693602694,0.22841839139563813,0.21016738801502888,132346.9584593096,246.64194381455877,132593.60040312415,2630,0,883.0222222222222,41,4,13,33.771612675151054,0.6351626016260162,42.757936507936506,1028.9682539682535,25.096786682152526,0
2634,4,2,1,46,0.0425531914893617,0.02127659574468085,0.9787234042553191,47,1150,700,450,0.6086956521739131,16,7,9,338.8882451971277,0.3892036694418748,0.23075120550177441,0.20665292438176067,132854.0161132814,-395.4277547969267,132458.58835848447,2631,0,846.4042553191489,39,8,14,33.53130999292715,0.6434294871794872,42.26562500000001,1030.9375000000011,26.4342948717949,0
2635,4,0,0,46,0.0,0.0,1.0,46,1250,900,350,0.72,16,9,7,351.46862326579986,0.3857387278582931,0.23599812512112295,0.21391910464638322,132783.12108490412,133.8201521294651,132916.94123703358,2632,1,865.804347826087,38,8,14,33.27826439998616,0.6444627192982455,42.33440170940172,1030.6623931623947,27.122694556905124,0
2636,4,1,0,47,0.02127659574468085,0.0,1.0,47,800,700,100,0.875,9,7,2,344.0131203500333,0.3879509713228492,0.237911406200225,0.21089499986675958,133052.49851279007,-245.63896324937906,132806.8595495407,2633,0,848.3617021276596,40,7,16,33.20014939584976,0.6437499999999999,42.07317073170732,1031.7073170731712,25.79268292682928,0
2637,4,0,0,47,0.0,0.0,1.0,47,1050,700,350,0.6666666666666666,14,7,7,341.85299326566957,0.38756552574776443,0.23861798496643827,0.21016095639262383,133157.3674730652,-295.9510707911713,132861.41640227404,2634,1,849.3617021276596,40,7,16,33.150764736773006,0.6447916666666667,41.971544715447166,1032.1138211382133,25.802845528455332,0
2638,4,0,0,47,0.0,0.0,1.0,47,1000,800,200,0.8,12,8,4,321.57243609695075,0.38756552574776443,0.2421439874215101,0.18557665735392662,130757.64607182577,-990.0172403774994,129767.62883144828,2635,2,850.3617021276596,42,5,14,36.08479393652298,0.6178075396825395,44.30717054263567,1022.7713178294587,24.35169804355854,5
2639,4,1,0,48,0.020833333333333332,0.0,1.0,48,1250,700,550,0.56,18,7,11,316.458119672272,0.3906804078014185,0.24658782638182464,0.18407001872061732,131061.33355034718,-1304.9153645833374,129756.41818576383,2636,0,833.625,43,5,17,35.90941844693117,0.6194282945736433,44.010416666666664,1023.9583333333329,23.81298449612402,0
2640,4,0,1,47,0.0,0.020833333333333332,0.9791666666666666,48,1200,900,300,0.75,15,9,6,316.76583160363776,0.3904772458628842,0.23996571120357535,0.18448155459307175,131109.82090973653,-1293.7777096246593,129816.04320011188,2637,1,834.625,43,5,17,35.85269301895515,0.6199127906976745,43.96306818181818,1024.147727272727,23.817389006342488,0
2641,4,0,0,47,0.0,0.0,1.0,47,1100,800,300,0.7272727272727273,14,8,6,320.62187261387817,0.3878160653715695,0.24181134993415299,0.18634162299440238,131030.3288939967,-997.7621161588881,130032.56677783781,2638,2,853.2978723404256,42,5,18,35.83408259196165,0.6205357142857143,44.0406976744186,1023.8372093023252,24.37707641196012,0
2642,4,1,1,47,0.020833333333333332,0.020833333333333332,0.9791666666666666,48,1000,600,400,0.6,14,6,8,314.52693651592426,0.390837396572104,0.2424779749253001,0.1838733646698441,131255.33679300098,-1343.3322034263088,129912.00458957467,2639,0,836.5,43,5,18,35.76350383513538,0.6213662790697674,43.82102272727273,1024.7159090909088,23.83060253699788,0
2643,4,0,0,47,0.0,0.0,1.0,47,1000,800,200,0.8,12,8,4,320.8722124087316,0.38679463459759483,0.23636292130412562,0.18746421912864356,131231.07854109287,-978.3186983470943,130252.75984274577,2640,4,855.2978723404256,43,4,19,35.625385089340725,0.6211240310077519,43.844696969696976,1024.6212121212131,23.828400281888676,0
2644,4,0,0,47,0.0,0.0,1.0,47,1650,1300,350,0.7878787878787878,20,13,7,320.7227205910033,0.38623573851372184,0.22944871934784516,0.1879766234751466,131353.5478572215,-974.3148142617185,130379.2330429598,2641,5,856.2978723404256,41,6,19,35.50588325429853,0.6252540650406504,43.72519841269841,1025.0992063492058,25.0024196670538,0
2645,4,0,1,46,0.0,0.02127659574468085,0.9787234042553191,47,900,500,400,0.5555555555555556,13,5,8,320.12237129657143,0.386004471168671,0.23538469139055396,0.18799913805235013,131429.83119173595,-985.2741559586761,130444.55703577728,2642,6,857.2978723404256,41,6,19,35.444482069143454,0.6260162601626016,43.65079365079365,1025.3968253968255,25.00967866821526,0
2646,4,1,1,46,0.02127659574468085,0.02127659574468085,0.9787234042553191,47,750,400,350,0.5333333333333333,11,4,7,316.9524283275985,0.39049491211840887,0.22677090698720836,0.1873415246007769,131675.9810107565,-1052.9956132443988,130622.98539751211,2643,0,818.0212765957447,42,5,13,35.2781973816717,0.626984126984127,43.41085271317829,1026.3565891472865,24.437061646363965,0
2647,4,0,0,46,0.0,0.0,1.0,46,1550,1200,350,0.7741935483870968,19,12,7,320.2486086518015,0.3860607890499195,0.2268652305267307,0.1892898026138326,131675.9810107565,-766.1900576888434,130909.79095306767,2644,8,836.804347826087,42,4,14,35.193620971802616,0.626984126984127,43.41085271317829,1026.3565891472865,24.437061646363965,0
2648,4,0,0,46,0.0,0.0,1.0,46,900,700,200,0.7777777777777778,11,7,4,321.2413497567849,0.3861714975845411,0.22798700206375,0.19049773829729452,131800.32680014736,-732.0570240670547,131068.26977608031,2645,9,837.804347826087,42,4,14,35.04313327671351,0.6282242063492063,43.28972868217055,1026.841085271319,24.448597268364736,0
2649,4,1,1,46,0.02127659574468085,0.02127659574468085,0.9787234042553191,47,800,400,400,0.5,12,4,8,314.43689785484526,0.389781837804502,0.22590879377670592,0.18753009829612716,132017.10498113852,-1097.7902091906776,130919.31477194784,2646,0,820.9574468085107,44,3,14,35.000150163678406,0.6276041666666667,43.0787037037037,1027.685185185185,23.356481481481477,0
2650,4,0,0,46,0.0,0.0,1.0,46,1350,1000,350,0.7407407407407407,17,10,7,322.3465551457115,0.3862721417069243,0.2271441677115924,0.192326946838725,132032.78456618753,-687.9373457587102,131344.8472204288,2647,11,839.804347826087,43,3,15,34.781185693663815,0.6291182170542635,43.063446969696976,1027.746212121213,23.901074700493325,0
2651,4,0,2,44,0.0,0.043478260869565216,0.9565217391304348,46,950,600,350,0.631578947368421,13,6,7,321.68340947886986,0.3865237520128824,0.2215116884364965,0.19254897795598525,132154.46815455705,-697.6200212350626,131456.848133322,2648,12,840.804347826087,43,3,16,34.67604531221219,0.630329457364341,42.945075757575765,1028.219696969698,23.912085976039485,0
2652,4,1,0,45,0.022222222222222223,0.0,1.0,45,1000,700,300,0.7,13,7,6,330.112298276901,0.3833122895622896,0.23313538819241542,0.19730486605181097,132098.996125909,-278.49935776093696,131820.49676814806,2649,0,859.6666666666666,42,3,18,34.51511295440978,0.6312003968253967,42.999031007751945,1028.0038759689933,24.476282761166505,0
2653,4,0,0,45,0.0,0.0,1.0,45,1200,700,500,0.5833333333333334,17,7,10,329.0237310713758,0.3832070707070707,0.23532736693358425,0.19743283806233217,132248.45754649673,-297.4238139234301,131951.0337325733,2650,1,860.6666666666666,42,3,19,34.39295807819123,0.6326884920634919,42.85368217054264,1028.5852713178306,24.490125507567395,0
2654,4,0,0,45,0.0,0.0,1.0,45,1000,900,100,0.9,11,9,2,333.8275520672925,0.3832070707070707,0.2434462336901364,0.20084502976785168,132348.14544085402,-163.70851736673353,132184.4369234873,2651,2,861.6666666666666,42,3,19,34.16929560222243,0.6336805555555556,42.75678294573644,1028.972868217055,24.499354005167977,0
2655,4,0,0,45,0.0,0.0,1.0,45,1050,800,250,0.7619047619047619,13,8,5,332.93664499252463,0.38343855218855216,0.23856784625937544,0.20071671684997794,132424.80604383687,-182.1577040165185,132242.64833982036,2652,3,862.6666666666666,39,6,19,34.115242215700164,0.639155982905983,42.68229166666667,1029.270833333334,26.391559829059844,0
2656,4,0,0,45,0.0,0.0,1.0,45,750,500,250,0.6666666666666666,10,5,5,330.68792968390875,0.38327020202020207,0.23275433685228242,0.1996450097169256,132478.4193250869,-238.19715711804935,132240.22216796884,2653,4,863.6666666666666,39,6,19,34.11929997639042,0.639690170940171,42.630208333333336,1029.4791666666674,26.396901709401728,0
2657,4,0,0,45,0.0,0.0,1.0,45,950,700,250,0.7368421052631579,12,7,5,329.6472742195442,0.38345959595959594,0.2334210641751111,0.19928318510694631,132528.77338224594,-262.45021977659326,132266.32316246934,2654,5,864.6666666666666,40,5,19,34.095563560994876,0.6385416666666668,42.58130081300813,1029.6747967479669,25.741869918699173,0
2658,4,0,0,45,0.0,0.0,1.0,45,1250,700,550,0.56,18,7,11,327.7265805719101,0.3835016835016835,0.23165035039854476,0.19891528575331885,132678.92696719881,-303.5177902179528,132375.40917698087,2655,6,865.6666666666666,41,4,14,33.994443107045406,0.6384654471544715,42.435515873015866,1030.2579365079357,25.12824235385209,0
2659,4,0,1,44,0.0,0.022222222222222223,0.9777777777777777,45,900,500,400,0.5555555555555556,13,5,8,358.4487534626039,0.3837121212121212,0.2617283950617286,0.20030959752321995,129504.14540816336,299.59628527338083,129803.74169343674,2656,7,866.6666666666666,41,4,16,36.41447368421053,0.6067073170731707,45.53571428571429,1017.8571428571436,24.825783972125453,7
2660,4,0,0,44,0.0,0.0,1.0,44,950,600,350,0.631578947368421,13,6,7,364.43662730572294,0.38035147991543344,0.26833708640540443,0.20315921562276718,129408.11107806205,632.2111094586609,130040.32218752071,2657,26,887.2045454545455,40,4,19,36.359909774936746,0.6072916666666666,45.63008130081301,1017.4796747967483,25.436991869918707,0
2661,4,1,1,44,0.022222222222222223,0.022222222222222223,0.9777777777777777,45,1050,500,550,0.47619047619047616,16,5,11,358.3475575410047,0.3849747474747475,0.25944541853367076,0.20102710523038028,129655.65653344692,292.3575680272344,129948.01410147415,2658,0,868.4666666666667,41,4,17,36.26290668225211,0.6082317073170731,45.38690476190477,1018.4523809523826,24.840301974448355,0
2662,4,2,0,46,0.043478260869565216,0.0,1.0,46,1150,800,350,0.6956521739130435,15,8,7,350.8917541894489,0.38943236714975843,0.26744954522548725,0.19878829949397944,130040.11646685892,-73.99908358873074,129966.11738327019,2659,0,850.5434782608696,42,4,19,36.0622902020394,0.6106150793650793,45.00968992248062,1019.9612403100772,24.28479143595422,0
2663,4,0,0,46,0.0,0.0,1.0,46,1000,700,300,0.7,13,7,6,349.08538873901773,0.38967391304347826,0.268472479185939,0.1980156774054082,130089.53788834794,-117.52861907338172,129972.00926927457,2660,1,851.5434782608696,42,4,19,36.05820985309017,0.6111111111111112,44.961240310077514,1020.1550387596891,24.289405684754502,0
2664,4,0,0,46,0.0,0.0,1.0,46,800,500,300,0.625,11,5,6,348.81971113206913,0.3895632045088567,0.2653016146945044,0.19824179049820947,130163.68762581883,-119.2680164953913,130044.41960932343,2661,2,852.5434782608696,42,4,20,35.98977621625045,0.6118551587301586,44.88856589147287,1020.445736434109,24.296327057954976,0
2665,4,1,0,47,0.02127659574468085,0.0,1.0,47,1250,600,650,0.48,19,6,13,344.22930724419274,0.3925185013876041,0.2648821870951905,0.19704971505800822,130444.20070725087,-419.34395778690896,130024.85674946396,2662,0,835.3829787234042,40,7,23,35.82268039527787,0.6177083333333333,44.61382113821138,1021.5447154471537,25.538617886178844,0
2666,4,1,1,47,0.020833333333333332,0.020833333333333332,0.9791666666666666,48,1100,700,400,0.6363636363636364,15,7,8,338.8303548375256,0.3968860815602837,0.26795642617015814,0.19585306160787905,130820.18455530345,-734.8300894431957,130085.35446586026,2663,0,818.9583333333334,41,7,16,35.58031096457202,0.6199186991869918,44.24603174603174,1023.0158730158719,24.951606658923705,0
2667,4,0,1,46,0.0,0.02127659574468085,0.9787234042553191,47,1350,1200,150,0.8888888888888888,15,12,3,347.61185084991433,0.3946191797718162,0.27126285117378623,0.20032476765474444,130703.86860499704,-313.15726419459094,130390.71134080245,2664,1,837.3617021276596,40,7,16,35.47339826409594,0.6203125,44.359756097560975,1022.5609756097563,25.564024390243908,0
2668,4,0,0,46,0.0,0.0,1.0,46,1000,900,100,0.9,11,9,2,344.14783786164884,0.3942934782608696,0.2662541307587636,0.19872908709566836,130781.81932257593,-198.34392970453052,130583.4753928714,2665,2,848.9565217391304,40,6,16,35.48310978638848,0.62109375,44.28353658536586,1022.8658536585373,25.57164634146343,0
2669,4,0,1,45,0.0,0.021739130434782608,0.9782608695652174,46,1350,1100,250,0.8148148148148148,16,11,5,324.7741929994511,0.39449476650563603,0.19614372403593072,0.17904677655981874,128969.0239461465,-766.915154669837,128202.10879147665,2666,3,849.9565217391304,40,6,19,37.81474070368516,0.6028645833333333,46.0619918699187,1015.7520325203254,25.393800813008134,7
2670,4,1,0,46,0.021739130434782608,0.0,1.0,46,700,300,400,0.42857142857142855,11,3,8,324.57185158054585,0.3934983896940419,0.1946207165869378,0.17941659340202554,129075.34490937594,-821.1552618732464,128254.18964750269,2667,0,850.7826086956521,41,5,20,37.71183165739205,0.6023882113821137,45.95734126984128,1016.1706349206361,24.784649632210638,0
2671,4,1,0,47,0.02127659574468085,0.0,1.0,47,1350,1000,350,0.7407407407407407,17,10,7,317.55037086995833,0.397413660191181,0.19981099703650607,0.17659455876437274,129312.88954293648,-1187.0212341085614,128125.86830882792,2668,0,833.6595744680851,37,10,21,37.64913037228689,0.6114864864864864,45.72368421052632,1017.1052631578963,27.4893314366999,0
2672,4,1,1,47,0.020833333333333332,0.020833333333333332,0.9791666666666666,48,1100,900,200,0.8181818181818182,13,9,4,309.2004489204133,0.3985852541371158,0.19403706230104567,0.17301063286920842,129554.63927469145,-1588.3294753086348,127966.30979938281,2669,0,817.2708333333334,38,10,15,37.61653024101864,0.6121162280701754,45.486111111111114,1018.0555555555563,26.79093567251464,0
2673,4,1,0,48,0.020833333333333332,0.0,1.0,48,950,500,450,0.5263157894736842,14,5,9,310.94438202224956,0.40067228132387706,0.20687801552339047,0.1745903261601959,129690.6332182774,-1534.685239973702,128155.94797830371,2670,0,818.25,38,10,16,37.434445143696266,0.6134868421052632,45.3525641025641,1018.5897435897432,26.804993252361662,0
2674,4,0,1,47,0.0,0.020833333333333332,0.9791666666666666,48,900,700,200,0.7777777777777778,11,7,4,310.12449913328584,0.4006445774231679,0.20829183701995357,0.1747358297243009,129826.69850107757,-1547.5120306450367,128279.18647043253,2671,1,819.25,38,10,16,37.31763462277669,0.6148574561403508,45.2190170940171,1019.1239316239321,26.819050832208738,0
2675,4,3,1,49,0.06,0.02,0.98,50,1350,800,550,0.5925925925925926,19,8,11,302.2742935805951,0.4081802721088435,0.22667686346487192,0.17305335651750708,130448.74267578125,-2113.00917828925,128335.733497492,2672,0,787.34,39,11,19,36.889572924101834,0.6193910256410255,44.609375,1021.5625,26.193910256410255,0
2676,4,1,3,47,0.02,0.06,0.94,50,1200,800,400,0.6666666666666666,16,8,8,301.554959003424,0.4091751700680272,0.22375496891244584,0.1731161909176472,130555.17713758668,-2126.0877821180657,128429.08935546862,2673,0,788.06,39,11,14,36.80063619067033,0.6204594017094018,44.50520833333333,1021.9791666666656,26.20459401709399,0
2677,4,0,0,47,0.0,0.0,1.0,47,1200,800,400,0.6666666666666666,16,8,8,345.12011685615505,0.40103684859697813,0.25106178886677855,0.18365886769910258,127556.54450040571,-595.5340912505211,126961.01040915519,2674,2,826.6382978723404,42,5,15,38.7406075139888,0.5855654761904763,47.45639534883721,1010.1744186046519,24.05177187153933,7
2678,4,1,1,47,0.020833333333333332,0.020833333333333332,0.9791666666666666,48,1300,1100,200,0.8461538461538461,15,11,4,340.175903715861,0.4049571513002364,0.24795568039950133,0.1823834664500701,127857.05061983476,-901.2224517906244,126955.82816804413,2675,0,810.3958333333334,43,5,15,38.55805243445693,0.5872093023255813,47.159090909090914,1011.3636363636367,23.520084566596204,0
2679,4,3,0,50,0.06,0.0,1.0,50,750,300,450,0.4,12,3,9,334.70738742088423,0.4122448979591837,0.2781583325178587,0.18222561492029923,128471.19005298884,-1398.6574013883917,127072.53265160044,2676,0,778.92,41,9,17,38.06950696415174,0.596290650406504,46.55257936507937,1013.789682539683,24.7265776229191,0
2680,4,0,0,50,0.0,0.0,1.0,50,1200,700,500,0.5833333333333334,17,7,10,332.94816837410355,0.4121938775510204,0.27884593837535077,0.18174693594733177,128576.3575025827,-1438.1474546602321,127138.21004792248,2677,1,779.92,43,7,17,38.00692499221913,0.5944767441860466,46.44886363636364,1014.2045454545458,23.58615221987316,0
2681,4,1,0,51,0.0196078431372549,0.0,1.0,51,1250,800,450,0.64,17,8,9,330.0168832134472,0.4160457516339869,0.2942982244415955,0.18160035916717912,128895.62864369016,-1692.4532750342808,127203.17536865588,2678,0,765.6078431372549,44,7,18,37.75626120786602,0.5963541666666666,46.13425925925927,1015.4629629629643,23.078703703703734,0
2682,4,1,0,52,0.019230769230769232,0.0,1.0,52,1300,800,500,0.6153846153846154,18,8,10,328.88493206865877,0.4169730392156863,0.3056494047089824,0.18250716609314427,129228.54487407762,-1897.200179990436,127331.34469408718,2679,0,751.8653846153846,38,14,19,37.44658680956883,0.6088267543859649,45.806623931623925,1016.7735042735035,26.757197480881672,0
2683,4,1,2,51,0.018867924528301886,0.03773584905660377,0.9622641509433962,53,1300,1000,300,0.7692307692307693,16,10,6,325.60445949180956,0.4187076681180455,0.30279157012026947,0.18195543324542293,129504.14540816324,-2166.5745464852653,127337.57086167797,2680,0,738.6603773584906,41,12,14,37.25024366471736,0.6067073170731707,45.535714285714285,1017.8571428571427,24.825783972125432,0
2684,4,0,0,51,0.0,0.0,1.0,51,1700,1300,400,0.7647058823529411,21,13,8,332.53270276881517,0.41583333333333333,0.309148096098508,0.18523209488833223,129377.95380015417,-1595.5198688271773,127782.43393132699,2681,2,767.6666666666666,41,10,19,37.202076222980644,0.6054369918699187,45.659722222222214,1017.36111111111,24.81368563685634,0
2685,4,0,0,51,0.0,0.0,1.0,51,1200,900,300,0.75,15,9,6,331.5642549744444,0.41622549019607846,0.305113253021259,0.18516699465339267,129478.9021656115,-1613.8848537100157,127865.01731190148,2682,3,768.6666666666666,41,10,14,37.12421207395131,0.6064532520325203,45.560515873015866,1017.7579365079356,24.8233643050716,0
2686,4,1,0,52,0.019230769230769232,0.0,1.0,52,1450,900,550,0.6206896551724138,20,9,11,341.7962591425591,0.41940830819507285,0.32831766717355104,0.18992355594813937,129280.82817925369,-1539.8893733563805,127740.93880589731,2683,0,754.8653846153846,39,13,18,37.065216463518716,0.6076388888888888,45.75520833333334,1016.9791666666684,26.076388888888935,3
2687,4,3,3,52,0.05454545454545454,0.05454545454545454,0.9454545454545454,55,1500,1000,500,0.6666666666666666,20,10,10,327.0574607121687,0.4250561167227834,0.32526788800553086,0.1845839316894859,129891.90853915042,-2503.5764452256326,127388.3320939248,2684,0,714.6363636363636,42,13,16,36.82014416983524,0.609126984126984,45.15503875968993,1019.3798449612414,24.270948689553364,0
2688,4,0,0,52,0.0,0.0,1.0,52,1550,1000,550,0.6451612903225806,21,10,11,342.1288220380881,0.41734225741578684,0.330134764948518,0.19126332087850131,129519.29253472242,-1537.5434027777571,127981.74913194467,2685,1,756.8461538461538,39,13,16,36.81436758084322,0.610042735042735,45.52083333333334,1017.9166666666683,26.100427350427392,0
2689,4,0,0,52,0.0,0.0,1.0,52,900,600,300,0.6666666666666666,12,6,6,343.105261396699,0.4168787707390649,0.3313915099771976,0.19215045354575327,129589.12854658272,-1507.4576351708629,128081.67091141186,2686,2,757.8461538461538,40,12,16,36.718568054030676,0.6091145833333333,45.452235772357724,1018.191056910569,25.454776422764226,0
2690,4,0,0,52,0.0,0.0,1.0,52,1200,900,300,0.75,15,9,6,344.72927631631023,0.41611676721970836,0.33725995830132804,0.19394480152306057,129768.46648526231,-1453.0020919716328,128315.46439329068,2687,3,758.8461538461538,42,10,17,36.49508638453005,0.6078869047619048,45.276162790697676,1018.8953488372093,24.259413067552604,0
2691,4,1,0,53,0.018867924528301886,0.0,1.0,53,1400,900,500,0.6428571428571429,19,9,10,350.1806959814256,0.4168329704886309,0.3688155817055705,0.199273893415407,130214.25637769754,-1480.2962149908099,128733.96016270673,2688,0,745.5094339622641,43,10,18,35.90377002536029,0.6109496124031008,44.839015151515156,1020.6439393939403,23.735905567300936,0
2692,4,1,0,54,0.018518518518518517,0.0,1.0,54,1700,1300,400,0.7647058823529411,21,13,8,345.770512695032,0.41993506871651526,0.3764236665571894,0.19849938560859945,130555.17713758702,-1771.5290556487985,128783.64808193821,2689,0,732.6851851851852,39,15,15,35.670951822783955,0.6204594017094016,44.50520833333334,1021.9791666666683,26.20459401709406,0
2693,4,1,2,53,0.01818181818181818,0.03636363636363636,0.9636363636363636,55,1000,700,300,0.7,13,7,6,339.77003515324543,0.4225448933782267,0.375958672759785,0.19633324763792045,130807.80805902599,-2111.0852914931284,128696.72276753286,2690,0,720.3454545454546,40,15,15,35.568787668057475,0.6213541666666664,44.25813008130083,1022.967479674799,25.574186991869976,0
2694,4,0,0,53,0.0,0.0,1.0,53,1100,500,600,0.45454545454545453,17,5,12,353.39450585810596,0.41704462989840346,0.379714268239026,0.20248721746681078,130480.8049003764,-1377.7600856526965,129103.0448147237,2691,2,748.2641509433962,38,15,19,35.551518003415936,0.6214364035087718,44.57799145299146,1021.6880341880357,26.886527215474622,0
2695,4,0,1,52,0.0,0.018867924528301886,0.9811320754716981,53,1600,1200,400,0.75,20,12,8,349.9379725897919,0.4166515481373972,0.3728978671041834,0.20121433423913052,130617.28395061739,-1458.4104938271491,129158.87345679024,2692,3,749.2641509433962,38,15,17,35.50158514492753,0.6228070175438596,44.44444444444445,1022.2222222222231,26.90058479532166,0
2696,4,0,0,52,0.0,0.0,1.0,52,1050,800,250,0.7619047619047619,13,8,5,348.7877018642614,0.4173265460030166,0.36199924769606895,0.20092136628518745,130688.28125000016,-1283.5069444444289,129404.77430555574,2693,4,734.8653846153846,39,13,17,35.45911437109481,0.6217948717948718,44.37500000000001,1022.5000000000013,26.21794871794875,0
2697,4,0,0,52,0.0,0.0,1.0,52,1250,1000,250,0.8,15,10,5,347.1346826847548,0.4170594519859226,0.35747831403569097,0.20045384860711754,130781.81932257592,-1320.2189297045309,129461.60039287139,2694,5,735.8653846153846,40,12,17,35.40673124689519,0.62109375,44.28353658536586,1022.8658536585372,25.571646341463428,0
2698,4,0,0,52,0.0,0.0,1.0,52,1150,900,250,0.782608695652174,14,9,5,342.5144928832051,0.4167923579688286,0.3558695004469157,0.19831963363087976,130885.78976014635,-1433.9440189371144,129451.84574120924,2695,6,736.8653846153846,40,12,17,35.41977025192837,0.6221354166666666,44.1819105691057,1023.2723577235794,25.581808943089484,0
2699,4,1,0,53,0.018867924528301886,0.0,1.0,53,1150,700,450,0.6086956521739131,16,7,9,336.2117321006473,0.41941823899371067,0.3581425152116049,0.19603387865614721,131154.36952594522,-1780.872449822704,129373.49707612251,2696,0,723.9433962264151,42,11,18,35.30984927316874,0.6217757936507935,43.919573643410864,1024.3217054263587,24.38861203396092,0
2700,4,0,1,52,0.0,0.018867924528301886,0.9811320754716981,53,1400,800,600,0.5714285714285714,20,8,12,336.4839461462361,0.41869254958877605,0.35869218073955045,0.19670081428946695,131253.64428407289,-1767.0511650441258,129486.59311902875,2697,1,724.9433962264151,42,11,18,35.202718676122934,0.622767857142857,43.82267441860467,1024.7093023255848,24.397840531561542,0
2701,4,1,1,52,0.018867924528301886,0.018867924528301886,0.9811320754716981,53,1400,1000,400,0.7142857142857143,18,10,8,336.0576560940825,0.41816340106434446,0.3524325271771871,0.1970953358726592,131378.97317491836,-1769.796916673422,129609.17625824493,2698,0,725.4150943396227,41,12,18,35.08725243532675,0.6255081300813007,43.70039682539684,1025.1984126984148,25.00483933410768,0
2702,4,2,2,52,0.037037037037037035,0.037037037037037035,0.962962962962963,54,1400,1100,300,0.7857142857142857,17,11,6,329.61531038228804,0.420080654553925,0.34759086090908076,0.1941923923771445,131551.6939054896,-2127.709516405248,129423.98438908436,2699,0,712.9444444444445,42,12,18,35.07839803532635,0.6257440476190474,43.53197674418605,1025.872093023257,24.425526024363265,0
2703,4,0,0,52,0.0,0.0,1.0,52,1100,600,500,0.5454545454545454,16,6,10,342.1515653115999,0.41552758924082456,0.36058788539704567,0.20053938636246996,131354.16795764756,-1411.393164617619,129942.77479302994,2700,4,741.3653846153846,40,12,18,34.956090347311736,0.6268229166666666,43.72459349593496,1025.1016260162603,25.62754065040651,0
2704,4,1,1,52,0.018867924528301886,0.018867924528301886,0.9811320754716981,53,1500,1000,500,0.6666666666666666,20,10,10,302.65322435261953,0.417029511369134,0.2627352920509285,0.17077956672977934,129884.7747342253,-2737.9908264745895,127146.78390775071,2701,0,728.3584905660377,44,9,15,37.44928391921762,0.6062973484848484,45.16203703703705,1019.3518518518546,23.167087542087604,8
2705,4,0,1,51,0.0,0.019230769230769232,0.9807692307692307,52,1650,1100,550,0.6666666666666666,22,11,11,306.4095805893574,0.41461632730015086,0.26729197233284374,0.173003563194299,129908.3719135805,-2438.966049382691,127469.4058641978,2702,1,743.2692307692307,44,8,15,37.32970027247957,0.6065340909090908,45.1388888888889,1019.4444444444465,23.169191919191967,0
2706,4,0,0,51,0.0,0.0,1.0,51,1500,1100,400,0.7333333333333333,19,11,8,309.5536632823631,0.4140686274509804,0.2641823892651869,0.17498998665633386,129955.572702332,-2154.3552812071275,127801.21742112488,2703,2,757.4313725490196,44,7,15,37.201840416515324,0.6070075757575757,45.092592592592595,1019.62962962963,23.173400673400682,0
2707,4,2,1,52,0.03773584905660377,0.018867924528301886,0.9811320754716981,53,1050,600,450,0.5714285714285714,15,6,9,297.9975083624686,0.42032535074987903,0.2692957645626728,0.17033046302279917,130386.26359593766,-2827.594762137404,127558.66883380026,2704,0,729.811320754717,42,11,16,37.06178842504744,0.6140873015873016,44.67054263565891,1021.3178294573637,24.31709117755628,0
2708,4,1,1,52,0.018867924528301886,0.018867924528301886,0.9811320754716981,53,1300,800,500,0.6153846153846154,18,8,10,293.79288938391437,0.4203102322206096,0.24809278486349773,0.1618120836914482,128931.14028469389,-3024.189552839398,125906.9507318545,2705,0,730.7924528301887,46,7,15,38.63986848230913,0.5942028985507246,46.09929078014184,1015.6028368794323,22.078322540857222,4
2709,4,1,0,53,0.018867924528301886,0.0,1.0,53,1000,600,400,0.6,14,6,8,298.9236105299078,0.4195391872278665,0.26648742659411484,0.1656721624913705,129178.85736538665,-2877.077910442122,126301.77945494452,2706,0,731.7547169811321,46,7,17,38.25851719426762,0.5966938405797101,45.85549645390071,1016.578014184398,22.09952204748691,0
2710,4,1,0,54,0.018518518518518517,0.0,1.0,54,1050,600,450,0.5714285714285714,15,6,9,291.32198518176006,0.42182768460284187,0.27680999525786576,0.16275755288913807,129494.4774926437,-3255.0803845380024,126239.3971081057,2707,0,719.1851851851852,46,8,14,38.13238539035506,0.5998641304347826,45.545212765957444,1017.8191489361699,22.126503237742824,0
2711,4,0,0,54,0.0,0.0,1.0,54,1650,1300,350,0.7878787878787878,20,13,7,294.3698252343267,0.421470999301188,0.27597203681131965,0.16493325915324278,129607.29229540777,-3169.504803581299,126437.78749182647,2708,1,720.1851851851852,46,8,14,37.940753961344264,0.6009963768115942,45.43439716312057,1018.2624113475184,22.136139377119967,0
2712,4,1,0,55,0.01818181818181818,0.0,1.0,55,1600,800,800,0.5,24,8,16,293.0152066013254,0.4231481481481481,0.28402647161267836,0.16553456476828124,129930.49621582031,-3385.6777615017354,126544.81845431858,2709,0,708.0727272727273,47,8,15,37.64873350361855,0.6030585106382979,45.1171875,1019.53125,21.69215425531915,0
2713,4,0,0,55,0.0,0.0,1.0,55,1100,700,400,0.6363636363636364,15,7,8,295.7163533804485,0.42334455667789,0.2891418225148765,0.1674395872706931,130019.01226279148,-3310.2503647039134,126708.76189808757,2710,1,709.0727272727273,47,8,15,37.490513377025025,0.603945035460993,45.030381944444436,1019.87847222222,21.699541962174894,0
2714,4,1,2,54,0.017857142857142856,0.03571428571428571,0.9642857142857143,56,1600,1300,300,0.8125,19,13,6,295.3769262807163,0.4250067640692641,0.2866618075801748,0.16829615567157105,130262.58680555565,-3504.6874999999895,126757.89930555566,2711,0,697.3928571428571,49,7,15,37.25340136054422,0.6041666666666666,44.79166666666667,1020.8333333333342,20.83333333333335,0
2715,4,1,0,55,0.01818181818181818,0.0,1.0,55,1250,700,550,0.56,18,7,11,300.11329807069393,0.42565937149270483,0.29977827050997785,0.17121244297622637,130312.05047961352,-3178.3241504416897,127133.72632917183,2712,0,710.5636363636364,42,13,17,37.082621555787526,0.6133432539682541,44.74321705426356,1021.027131782945,24.310169804355834,0
2716,4,1,1,55,0.017857142857142856,0.017857142857142856,0.9821428571428571,56,1100,700,400,0.6363636363636364,15,7,8,293.8695410624243,0.42799648268398266,0.2965845544451924,0.16856259122478767,130522.6508916324,-3528.67369684499,126993.97719478741,2713,0,698.8571428571429,44,12,14,37.02975866859974,0.612689393939394,44.53703703703704,1021.8518518518521,23.22390572390573,0
2717,4,1,2,54,0.017857142857142856,0.03571428571428571,0.9642857142857143,56,1100,700,400,0.6363636363636364,15,7,8,292.9517293755002,0.42761093073593076,0.29734484155107843,0.1687162816934003,130679.01963873133,-3543.4710407477405,127135.5485979836,2714,0,699.8392857142857,45,11,15,36.89574474368059,0.6129629629629629,44.38405797101449,1022.4637681159419,22.721417069243152,0
2718,4,0,0,54,0.0,0.0,1.0,54,1550,1100,450,0.7096774193548387,20,11,9,302.04718072531574,0.4211361518751456,0.2911413186235883,0.17312460358646137,130493.85633270312,-2916.939718546532,127576.91661415658,2715,6,726.7222222222222,45,9,16,36.8498817966903,0.6111111111111112,44.565217391304344,1021.7391304347818,22.70531400966182,0
2719,4,1,1,54,0.01818181818181818,0.01818181818181818,0.9818181818181818,55,1150,700,450,0.6086956521739131,16,7,9,297.8063596799026,0.4220258136924804,0.29031012334003314,0.17167398095490616,130715.47681360332,-3214.419939263624,127501.0568743397,2716,0,714.4909090909091,46,9,16,36.73493714781102,0.6120923913043477,44.348404255319146,1022.6063829787224,22.230573543015705,0
2720,4,0,0,54,0.0,0.0,1.0,54,950,700,250,0.7368421052631579,12,7,5,306.48093427316843,0.4200515373864431,0.2965818024297553,0.17629683099933666,130632.71650519875,-2792.712599768931,127840.00390542982,2717,8,728.7222222222222,45,9,16,36.59659460098056,0.6124999999999999,44.42934782608697,1022.2826086956543,22.717391304347874,0
2721,4,0,1,53,0.0,0.018518518518518517,0.9814814814814815,54,1200,1000,200,0.8333333333333334,14,10,4,304.9677517042052,0.41966573491730724,0.2957287668536561,0.17584708461391632,130725.3309769483,-2826.597944234387,127898.73303271392,2718,9,729.7222222222222,45,9,16,36.54192500738117,0.6134259259259258,44.33876811594204,1022.6449275362334,22.72544283413852,0
2722,4,0,0,53,0.0,0.0,1.0,53,1550,1000,550,0.6451612903225806,21,10,11,312.0814134037211,0.4167573778422835,0.30020875221663457,0.17984109626925,130702.17428225419,-2442.0561430109265,128260.11813924326,2719,10,743.9433962264151,45,8,16,36.38340788968614,0.6131944444444444,44.36141304347826,1022.5543478260864,22.72342995169081,0
2723,4,1,1,53,0.018518518518518517,0.018518518518518517,0.9814814814814815,54,1650,1100,550,0.6666666666666666,22,11,11,310.90775945794627,0.4187485441416259,0.3123211051813395,0.1813497809458134,131169.15274791233,-2643.69852182991,128525.45422608242,2720,0,731.1481481481482,46,8,19,35.942953988172505,0.6166213768115942,43.90514184397162,1024.3794326241114,22.26911810052416,0
2724,4,0,0,53,0.0,0.0,1.0,53,1100,600,500,0.5454545454545454,16,6,10,319.1172034796678,0.4162584663763909,0.32224793410491226,0.1861215293528396,131165.69789861626,-2228.5538588269387,128937.14403978932,2721,1,745.7358490566038,45,8,19,35.73619462375099,0.6178240740740741,43.90851449275362,1024.3659420289846,22.7636876006441,0
2725,4,1,1,53,0.018518518518518517,0.018518518518518517,0.9814814814814815,54,1200,600,600,0.5,18,6,12,313.8746699806389,0.4185883997204752,0.3164399965785647,0.1839574067428487,131352.39221942436,-2554.060726059193,128798.33149336517,2722,0,732.9074074074074,43,11,19,35.682544264819086,0.6223352713178295,43.72632575757576,1025.094696969697,23.839411557434815,0
2726,4,1,0,54,0.018518518518518517,0.0,1.0,54,1500,1100,400,0.7333333333333333,19,11,8,312.02749553268495,0.41918530165385515,0.31517041413644087,0.18368922997880674,131522.32552800738,-2592.2836317722636,128930.04189623511,2723,0,733.8888888888889,43,11,20,35.55899187592319,0.624031007751938,43.56060606060606,1025.757575757576,23.854827343199442,0
2727,4,0,1,53,0.0,0.018518518518518517,0.9814814814814815,54,1150,700,450,0.6086956521739131,16,7,9,312.3599458812831,0.4189305264383881,0.31730309120489997,0.18435361511816908,131619.47959710748,-2577.4692952249766,129042.0103018825,2724,1,734.8888888888889,43,11,16,35.45281161560232,0.625,43.46590909090909,1026.136363636364,23.86363636363637,0
2728,4,0,0,53,0.0,0.0,1.0,53,1550,1100,450,0.7096774193548387,20,11,9,320.7072152813467,0.41619799225931303,0.318461053160604,0.18894420078929444,131551.69390548964,-2162.0845164052503,129389.60938908439,2725,5,749.7358490566038,42,11,19,35.30686218947765,0.6257440476190477,43.53197674418605,1025.8720930232573,24.42552602436327,0
2729,4,0,2,51,0.0,0.03773584905660377,0.9622641509433962,53,1350,900,450,0.6666666666666666,18,9,9,318.9966821676336,0.4165910740203193,0.23745643552457651,0.18211810581933996,130340.40584308287,-2253.819989379414,128086.58585370347,2726,6,750.7358490566038,40,13,19,36.571954617834386,0.6166666666666667,44.71544715447155,1021.1382113821143,25.528455284552855,5
2730,4,0,0,51,0.0,0.0,1.0,51,1400,900,500,0.6428571428571429,19,9,10,326.67047333969356,0.4140686274509804,0.25690828748322936,0.1865183025197606,130344.39718934921,-1684.0668145956472,128660.33037475357,2727,7,779.1960784313726,38,13,19,36.372018204645336,0.6200657894736842,44.71153846153847,1021.1538461538469,26.87246963562755,0
2731,4,0,0,51,0.0,0.0,1.0,51,1700,1300,400,0.7647058823529411,21,13,8,326.4508875788948,0.41367647058823526,0.2636345555685411,0.18704912150491146,130480.80490037626,-1680.8850856527085,128799.91981472354,2728,8,780.1960784313726,38,13,19,36.23971731325596,0.6214364035087719,44.577991452991455,1021.6880341880345,26.886527215474594,0
2732,4,1,1,51,0.019230769230769232,0.019230769230769232,0.9807692307692307,52,1250,900,350,0.72,16,9,7,316.6378315990891,0.4155197335344394,0.2615319031101524,0.18284622266739525,130782.42368247101,-2117.867390781805,128664.55629168921,2729,0,766.1730769230769,42,10,14,36.185976379941884,0.6180555555555556,44.28294573643411,1022.8682170542636,24.354005167958658,0
2733,4,0,0,51,0.0,0.0,1.0,51,1400,1000,400,0.7142857142857143,18,10,8,320.46559281044676,0.4126470588235294,0.26202752493018444,0.18470089573613582,130708.09789262975,-1822.5103847424912,128885.58750788726,2730,10,782.1960784313726,42,9,14,36.163097381471296,0.6173115079365079,44.355620155038764,1022.5775193798457,24.34708379475823,0
2734,4,0,0,51,0.0,0.0,1.0,51,1200,900,300,0.75,15,9,6,320.32418339415295,0.41215686274509805,0.2638561534303976,0.18509372764598084,130807.20364048118,-1819.8578623580509,128987.34577812313,2731,11,783.1960784313726,42,9,14,36.066709292412604,0.6183035714285714,44.25872093023255,1022.9651162790685,24.356312292358773,0
2735,4,0,0,51,0.0,0.0,1.0,51,1300,1000,300,0.7692307692307693,16,10,6,320.71567952249757,0.4121732026143791,0.2641488413547237,0.18567749867091987,130881.55759870214,-1804.8464635538564,129076.71113514829,2732,12,784.1960784313726,42,9,14,35.98169191919192,0.619047619047619,44.186046511627914,1023.2558139534896,24.363233665559274,0
2736,4,0,0,51,0.0,0.0,1.0,51,1700,1300,400,0.7647058823529411,21,13,8,315.94214187847706,0.41173202614379084,0.2653098714644375,0.18374026489982753,131055.13232565642,-1918.8321577729766,129136.30016788344,2733,13,785.1960784313726,42,9,14,35.92887448345478,0.6207837301587302,44.01647286821705,1023.9341085271311,24.379383536360265,0
2737,4,0,1,50,0.0,0.0196078431372549,0.9803921568627451,51,1300,1100,200,0.8461538461538461,15,11,4,314.56746575008845,0.4115359477124183,0.2634924522420625,0.18305886442989713,131079.93810468112,-1953.3032119464085,129126.63489273471,2734,14,786.1960784313726,42,9,14,35.939077088064586,0.621031746031746,43.9922480620155,1024.0310077519373,24.381690660760412,0
2738,4,0,0,50,0.0,0.0,1.0,50,1450,1300,150,0.896551724137931,16,13,3,319.25393722808053,0.4084778911564626,0.2634371155484059,0.18566628259158646,131055.13232565642,-1632.0266022174214,129423.105723439,2735,15,801.8,42,8,14,35.84409797798177,0.6207837301587302,44.01647286821705,1023.9341085271311,24.379383536360265,0
2739,4,0,0,50,0.0,0.0,1.0,50,1550,1200,350,0.7741935483870968,19,12,7,317.01785300832273,0.4081462585034014,0.2660618673730015,0.18484256614180805,131154.36952594502,-1684.3446720449392,129470.02485390007,2736,16,802.8,42,8,14,35.80136694730868,0.6217757936507936,43.91957364341086,1024.321705426357,24.388612033960882,0
2740,4,0,0,50,0.0,0.0,1.0,50,1000,700,300,0.7,13,7,6,315.6342571749702,0.40769557823129254,0.26797855624364453,0.18428748129390196,131206.82253106352,-1717.3264068239205,129489.4961242396,2737,17,803.8,43,7,14,35.78397957297344,0.6208817829457365,43.86837121212121,1024.5265151515155,23.82619802677943,0
2741,4,0,0,50,0.0,0.0,1.0,50,1650,1300,350,0.7878787878787878,20,13,7,317.9324476171592,0.40737244897959185,0.27073170731707297,0.1862175764614789,131328.12499999997,-1649.0813676538132,129679.04363234616,2738,18,804.8,39,11,14,35.6029810298103,0.6282051282051282,43.75,1024.9999999999998,26.282051282051277,0
2742,4,1,1,50,0.0196078431372549,0.0196078431372549,0.9803921568627451,51,1850,1300,550,0.7027027027027027,24,13,11,308.1286186774769,0.40913398692810454,0.2677041828423323,0.18253137233504318,131760.64819735746,-2080.154694979863,129680.49350237759,2739,0,790.0,41,10,12,35.419585628241045,0.629319105691057,43.328373015873005,1026.6865079365064,25.04113433991479,0
2743,4,0,0,50,0.0,0.0,1.0,50,1200,900,300,0.75,15,9,6,316.24468189393207,0.4059608843537415,0.27357227722772315,0.18700651563985438,131692.9613655892,-1670.5602650538742,130022.40110053532,2740,20,806.8,40,10,14,35.27929042904291,0.6302083333333334,43.39430894308943,1026.4227642276417,25.660569105691042,0
2744,4,1,1,50,0.0196078431372549,0.0196078431372549,0.9803921568627451,51,1450,1200,250,0.8275862068965517,17,12,5,308.2131664386662,0.40968954248366013,0.2723065478725526,0.18381002827508022,132015.40577168367,-2062.2227536848,129953.18301799888,2741,0,791.9607843137255,41,10,15,35.16175547832803,0.631859756097561,43.080357142857146,1027.6785714285716,25.065331010452965,0
2745,4,0,1,49,0.0,0.02,0.98,50,1200,900,300,0.75,15,9,6,315.78743478934587,0.4053826530612245,0.2772651829498298,0.1881241549722596,131974.50949462166,-1664.8216378222587,130309.6878567994,2742,22,808.8,42,8,15,35.00821230982017,0.6299603174603174,43.120155038759684,1027.5193798449607,24.46474713916573,0
2746,4,1,1,49,0.02,0.02,0.98,50,950,600,350,0.631578947368421,13,6,7,309.83825090954605,0.4089795918367347,0.26228750345335716,0.1855782441603288,132178.8115978679,-1809.1896414428354,130369.62195642506,2743,0,789.26,43,7,15,34.95612318506922,0.6305717054263567,42.921401515151516,1028.314393939394,23.9142882311487,0
2747,4,0,0,49,0.0,0.0,1.0,49,1200,800,400,0.6666666666666666,16,8,8,315.3689324087915,0.40534651360544216,0.26447117308461876,0.18836901097930508,132074.09410492145,-1469.586788654539,130604.5073162669,2744,24,806.3673469387755,42,7,15,34.919007667169424,0.630952380952381,43.02325581395348,1027.906976744185,24.47397563676631,0
2748,4,1,1,49,0.02,0.02,0.98,50,1450,1100,350,0.7586206896551724,18,11,7,307.0038846727535,0.40738945578231295,0.255789473684211,0.18495112076626824,132398.003472222,-1869.8663128718474,130528.13715935014,2745,0,791.22,41,9,15,34.80937921727394,0.6356707317073171,42.70833333333332,1029.1666666666647,25.101626016260113,0
2749,4,0,0,49,0.0,0.0,1.0,49,1300,800,500,0.6153846153846154,18,8,10,311.40445347655697,0.4035926870748299,0.2604534054585692,0.18772929720042264,132423.52966939064,-1552.5446231733729,130870.98504621728,2746,26,808.3673469387755,41,8,16,34.67058232931727,0.6359247967479676,42.68353174603173,1029.265873015871,25.104045683313927,0
2750,4,0,0,49,0.0,0.0,1.0,49,1300,900,400,0.6923076923076923,17,9,8,313.9429984296167,0.40313208616780044,0.2676654476819629,0.18990258296616663,132551.19756235817,-1477.2959183673597,131073.9016439908,2747,27,809.3673469387755,41,8,16,34.47736030828516,0.6371951219512195,42.5595238095238,1029.761904761904,25.11614401858302,0
2751,4,0,0,49,0.0,0.0,1.0,49,1150,900,250,0.782608695652174,14,9,5,351.40211895551977,0.40313208616780044,0.3024523160762944,0.19840704254873198,129908.3719135803,-663.6070168808171,129244.76489669947,2748,28,810.3673469387755,41,8,14,36.18301544050863,0.6107723577235772,45.13888888888889,1019.4444444444448,24.86449864498646,7
2752,4,0,0,49,0.0,0.0,1.0,49,1650,1300,350,0.7878787878787878,20,13,7,356.6461736553872,0.4033801020408163,0.30135240556683707,0.2020208986970268,130034.82187145698,-524.7156675170008,129510.10620393998,2749,29,811.3673469387755,41,8,14,35.920934247641284,0.6120426829268292,45.014880952380956,1019.9404761904767,24.87659698025553,0
2753,4,0,0,49,0.0,0.0,1.0,49,1100,500,600,0.45454545454545453,17,5,12,351.0730561041709,0.40361040249433106,0.27786826042005996,0.20576838564339175,131354.16795764756,-532.1760090053731,130821.99194864219,2750,30,812.3673469387755,40,9,16,34.72745447936288,0.6268229166666668,43.72459349593496,1025.1016260162603,25.62754065040651,4
2754,4,1,1,49,0.02,0.02,0.98,50,1200,800,400,0.6666666666666666,16,8,8,349.0529144039656,0.40599489795918364,0.2753780700058015,0.20580987689656835,131582.46429358766,-814.1514707735107,130768.31282281416,2751,0,797.1,41,9,13,34.54884612905305,0.6275406504065041,43.50198412698412,1025.9920634920622,25.024196670538103,0
2755,4,0,0,49,0.0,0.0,1.0,49,750,500,250,0.6666666666666666,10,5,5,352.801360887075,0.40290178571428575,0.2790261339328679,0.20776994963793088,131536.54095611075,-518.7458688611252,131017.79508724963,2752,32,814.3673469387755,40,9,16,34.49904233538076,0.6286458333333333,43.546747967479675,1025.8130081300812,25.645325203252032,0
2756,4,0,0,49,0.0,0.0,1.0,49,1400,1100,300,0.7857142857142857,17,11,6,350.8336158533872,0.4028840702947846,0.2778252863999515,0.20791012268358403,131775.45294753887,-553.748272339431,131221.70467519943,2753,33,815.3673469387755,42,7,13,34.308544104693596,0.6279761904761906,43.31395348837208,1026.744186046509,24.4462901439645,0
2757,4,0,0,49,0.0,0.0,1.0,49,1050,700,350,0.6666666666666666,14,7,7,353.90879772697593,0.4025120464852608,0.28219835910588364,0.21014450123855555,131850.08154745802,-467.4192318670868,131382.66231559092,2754,34,816.3673469387755,42,7,13,34.15436204673396,0.6287202380952381,43.24127906976744,1027.0348837209297,24.45321151716499,0
2758,4,0,0,49,0.0,0.0,1.0,49,850,700,150,0.8235294117647058,10,7,3,357.89395446289257,0.4028309240362811,0.2891287987419815,0.2130684783363305,131949.619210459,-355.20579817920384,131594.4134122798,2755,35,817.3673469387755,42,7,13,33.951672482630705,0.6297123015873016,43.144379844961236,1027.4224806201541,24.462440014765576,0
2759,4,0,0,49,0.0,0.0,1.0,49,1300,1000,300,0.7692307692307693,16,10,6,333.07002720934497,0.4032383786848073,0.21746897606304771,0.19926775765800453,132136.07681755815,-997.1261135667598,131138.95070399137,2756,36,818.3673469387755,44,5,14,34.401829670989436,0.6287878787878789,42.962962962962955,1028.148148148147,23.36700336700334,3
2760,4,0,0,49,0.0,0.0,1.0,49,1350,1100,250,0.8148148148148148,16,11,5,333.39529687259807,0.40327380952380953,0.21582950523382816,0.2003437070606508,132302.7274091219,-978.1785836762867,131324.5488254456,2757,37,819.3673469387755,44,5,14,34.22602976029759,0.6304450757575759,42.80092592592592,1028.796296296295,23.381734006733975,0
2761,4,0,0,49,0.0,0.0,1.0,49,1300,1000,300,0.7692307692307693,16,10,6,332.174158431681,0.4029903628117914,0.2158228014398702,0.2008933147267015,132544.232273014,-994.4119443948657,131549.82032861913,2758,38,820.3673469387755,43,6,14,34.01500521120717,0.6342054263565893,42.56628787878787,1029.7348484848467,23.947322057787133,0
2762,4,0,0,49,0.0,0.0,1.0,49,1300,1000,300,0.7692307692307693,16,10,6,331.35982153537225,0.4035749716553288,0.22058975258455238,0.201052063496002,132666.15125868053,-1007.9535590277824,131658.19769965275,2759,39,821.3673469387755,43,6,12,33.913675429726986,0.6354166666666667,42.447916666666664,1030.2083333333333,23.958333333333332,0
2763,4,0,0,49,0.0,0.0,1.0,49,1200,800,400,0.6666666666666666,16,8,8,335.03569809143875,0.40316751700680276,0.22703027007771404,0.20407742438306153,132812.5280234877,-900.61239167241,131911.9156318153,2760,40,822.3673469387755,43,6,13,33.67219797887,0.6368701550387597,42.30587121212121,1030.776515151515,23.97154686398872,0
2764,4,0,1,48,0.0,0.02040816326530612,0.9795918367346939,49,1500,1000,500,0.6666666666666666,20,10,10,338.5202559006641,0.40260062358276644,0.22329636894691807,0.20727943493681478,133007.8225884556,-794.8315721131751,132212.99101634242,2761,41,823.3673469387755,43,6,14,33.38659766210717,0.6388081395348837,42.11647727272727,1031.534090909091,23.98916490486258,0
2765,4,0,0,48,0.0,0.0,1.0,48,1050,800,250,0.7619047619047619,13,8,5,336.98250222344024,0.40041371158392436,0.2325311983850249,0.2070143917266658,133129.9545526286,-627.5069587924663,132502.4475938361,2762,42,837.875,43,5,14,33.30389368079771,0.6400193798449612,41.99810606060606,1032.007575757576,24.000176180408744,0
2766,4,0,0,48,0.0,0.0,1.0,48,1100,700,400,0.6363636363636364,15,7,8,339.20149362908643,0.4004321808510638,0.2362295909007519,0.20892512336408497,133227.70047778945,-561.7930010330363,132665.9074767564,2763,43,838.875,43,5,14,33.148734177215196,0.6409883720930232,41.9034090909091,1032.3863636363653,24.008985200845704,0
2767,4,1,2,47,0.02040816326530612,0.04081632653061224,0.9591836734693877,49,1400,1100,300,0.7857142857142857,17,11,6,332.66129032258027,0.4018034297052154,0.2309084924292295,0.20625,133472.22222222234,-919.7916666666578,132552.43055555568,2764,0,822.734693877551,45,4,14,33.07291666666666,0.6407407407407406,41.66666666666667,1033.3333333333344,22.962962962962987,0
2768,4,0,0,47,0.0,0.0,1.0,47,900,700,200,0.7777777777777778,11,7,4,339.5307138585749,0.3983387295713845,0.24239870795590113,0.20995470673295616,133374.38662190124,-343.0598599632327,133031.32676193802,2765,45,857.4042553191489,43,4,14,32.99336878132258,0.6424418604651161,41.761363636363654,1032.9545454545487,24.02219873150113,0
2769,4,0,0,47,0.0,0.0,1.0,47,1600,1300,300,0.8125,19,13,6,339.87132775103214,0.3987627197039778,0.24538169666445375,0.21172019488798957,133647.5058308544,-315.37307846647076,133332.13275238793,2766,46,858.4042553191489,42,5,14,32.71132040108706,0.646577380952381,41.49709302325581,1034.0116279069757,24.619324473975613,0
2770,4,0,0,47,0.0,0.0,1.0,47,1150,900,250,0.782608695652174,14,9,5,336.55940693657044,0.3979918285538082,0.23790251066619694,0.2105122898571621,133797.84047120044,-393.8156323237959,133404.02483887665,2767,47,859.4042553191489,42,5,13,32.64669382785426,0.6480654761904763,41.3517441860465,1034.5930232558123,24.633167220376485,0
2771,4,0,0,47,0.0,0.0,1.0,47,1500,1100,400,0.7333333333333333,19,11,8,346.7560583652331,0.39781837804502,0.25332331308750855,0.207213741452165,132091.88102324252,-237.1553704184205,131854.7256528241,2768,48,860.4042553191489,41,6,15,34.09452808338158,0.6326219512195121,43.00595238095237,1027.9761904761895,25.072590011614377,3
2772,4,0,0,47,0.0,0.0,1.0,47,1100,600,500,0.5454545454545454,16,6,10,352.4134877933914,0.39760638297872336,0.25882454350855566,0.21130541515061213,132219.38898533932,-80.82079475310343,132138.56819058623,2769,49,861.4042553191489,41,6,15,33.820757371145625,0.6338922764227642,42.881944444444436,1028.4722222222208,25.084688346883436,0
2773,4,0,0,47,0.0,0.0,1.0,47,1200,800,400,0.6666666666666666,16,8,8,351.58747070104414,0.39751002158495224,0.2527349470238609,0.2118100128369704,132398.00347222216,-89.9836033950719,132308.01986882708,2770,50,862.4042553191489,40,7,15,33.66228070175438,0.6372395833333333,42.70833333333333,1029.166666666666,25.72916666666665,0
2774,4,0,0,47,0.0,0.0,1.0,47,1550,1400,150,0.9032258064516129,17,14,3,356.4556868000533,0.3976256552574777,0.22070435770487684,0.2144590899790237,132348.14544085402,35.249815966602,132383.39525682063,2771,51,863.4042553191489,42,5,15,33.58720218476317,0.6336805555555556,42.75678294573644,1028.972868217055,24.499354005167977,1
2775,4,0,0,47,0.0,0.0,1.0,47,650,300,350,0.46153846153846156,10,3,7,355.00867141200337,0.3977027443724946,0.21888848819970308,0.2137297103398799,132373.07328285582,-1.2822246259025576,132371.79105822992,2772,52,864.4042553191489,42,5,15,33.599340866290014,0.6339285714285714,42.732558139534895,1029.0697674418623,24.50166112956815,0
2776,4,0,0,47,0.0,0.0,1.0,47,950,700,250,0.7368421052631579,12,7,5,356.5349427235817,0.39785692260252853,0.22138339861371548,0.21494336601901876,132424.80604383704,42.821169699018014,132467.62721353606,2773,53,865.4042553191489,39,8,16,33.50801622642783,0.6391559829059827,42.68229166666668,1029.2708333333353,26.39155982905988,0
2777,4,1,1,47,0.020833333333333332,0.020833333333333332,0.9791666666666666,48,1000,800,200,0.8,12,8,4,352.85228669307077,0.40055223108747046,0.23042356729758162,0.21510418246481433,132842.88452640636,-225.21688479079108,132617.66764161555,2774,0,848.3541666666666,40,8,15,33.1825874079916,0.6416666666666666,42.27642276422765,1030.8943089430902,25.772357723577255,0
2778,4,0,0,47,0.0,0.0,1.0,47,1200,800,400,0.6666666666666666,16,8,8,357.3973217462691,0.39951433857539315,0.22751211291341922,0.21809609683382095,132880.8648003474,98.25303819446367,132979.11783854186,2775,1,840.1489361702128,39,8,15,33.02729507644643,0.6436965811965811,42.23958333333334,1031.041666666668,26.436965811965848,0
2779,4,0,0,47,0.0,0.0,1.0,47,1750,1300,450,0.7428571428571429,22,13,9,359.1323553455783,0.398936170212766,0.2268128922509891,0.22041915192399658,133095.75195312523,159.79817708336276,133255.5501302086,2776,2,841.1489361702128,39,8,16,32.76675752069453,0.6458333333333333,42.031250000000014,1031.8750000000018,26.45833333333338,0
2780,4,0,1,46,0.0,0.02127659574468085,0.9787234042553191,47,1000,800,200,0.8,12,8,4,358.0050932662375,0.3984543632439099,0.22861068767846748,0.22036214125890788,133203.2606336807,137.48914930557538,133340.74978298627,2777,3,842.1489361702128,39,8,16,32.687941473259336,0.6469017094017093,41.92708333333334,1032.291666666668,26.46901709401713,0
2781,4,0,0,46,0.0,0.0,1.0,46,1700,1400,300,0.8235294117647058,20,14,6,335.8453329754836,0.3975946054750403,0.17591225099960384,0.20576919639665406,133030.99203740217,-250.59780121129205,132780.39423619088,2778,4,858.1521739130435,38,8,20,33.432365023474176,0.6469298245614036,42.09401709401709,1031.6239316239307,27.147998200629758,4
2782,4,0,0,46,0.0,0.0,1.0,46,1150,700,450,0.6086956521739131,16,7,9,335.60431382526235,0.39780595813204506,0.17964402941847535,0.20627590207076307,133149.50086805568,-262.8906249999898,132886.61024305568,2779,5,859.1521739130435,39,7,20,33.319876194321076,0.6463675213675213,41.97916666666667,1032.0833333333344,26.46367521367524,0
2783,4,0,0,46,0.0,0.0,1.0,46,1050,700,350,0.6666666666666666,14,7,7,336.3839071968917,0.39775563607085346,0.18252798540197168,0.2073530651825618,133257.03125000017,-234.89583333331865,133022.13541666686,2780,6,860.1521739130435,39,7,20,33.192090395480214,0.6474358974358974,41.87500000000001,1032.5000000000014,26.47435897435901,0
2784,4,0,0,46,0.0,0.0,1.0,46,1200,900,300,0.75,15,9,6,333.18298456802205,0.39795692431561996,0.17771196583819604,0.20612449519407866,133391.50526258702,-311.2440321180311,133080.26123046898,2781,7,861.1521739130435,39,7,21,33.14016755739304,0.6487713675213674,41.74479166666668,1033.020833333335,26.48771367521372,0
2785,4,0,0,46,0.0,0.0,1.0,46,1100,700,400,0.6363636363636364,15,7,8,331.65874237466943,0.3978764090177134,0.1801136287020344,0.20578159172483512,133499.82336410627,-344.6988811014946,133155.12448300477,2782,8,862.1521739130435,38,8,21,33.071220579620245,0.6515899122807017,41.63995726495727,1033.4401709401714,27.195793972109772,0
2786,4,0,0,46,0.0,0.0,1.0,46,1200,800,400,0.6666666666666666,16,8,8,330.60417042245035,0.3978864734299517,0.1781395348837207,0.20543322728562685,133555.03420858,-369.2297419460779,133185.80446663394,2783,9,863.1521739130435,38,8,22,33.043281653746774,0.6521381578947367,41.58653846153847,1033.653846153847,27.201417004048608,0
2787,4,0,0,46,0.0,0.0,1.0,46,1100,700,400,0.6363636363636364,15,7,8,330.8110055678531,0.3978462157809984,0.18133008178278387,0.20648493519680114,133720.7352276463,-352.7418228139389,133367.99340483238,2784,10,864.1521739130435,38,8,18,32.87237888647867,0.6537828947368421,41.42628205128205,1034.2948717948718,27.218286099865047,0
2788,4,0,0,46,0.0,0.0,1.0,46,1200,800,400,0.6666666666666666,16,8,8,330.6697896491149,0.3969102254428341,0.17615990662386904,0.20701596074671474,133831.2596450617,-349.2091049382747,133482.05054012343,2785,11,865.1521739130435,38,8,20,32.76565995525725,0.6548793859649124,41.31944444444444,1034.7222222222222,27.22953216374269,0
2789,4,0,0,46,0.0,0.0,1.0,46,1300,800,500,0.6153846153846154,18,8,10,332.2454314971962,0.39623590982286633,0.17370446624412939,0.20925633317104098,134052.44545118336,-292.3374835634541,133760.1079676199,2786,12,866.1521739130435,38,8,22,32.50412668936345,0.6570723684210527,41.105769230769226,1035.5769230769224,27.252024291497957,0
2790,4,0,0,46,0.0,0.0,1.0,46,900,700,200,0.7777777777777778,11,7,4,332.7820027440124,0.3962862318840579,0.17503465404982266,0.20981936926339376,134091.86333550364,-275.32823350692513,133816.5351019967,2787,13,867.1521739130435,39,7,22,32.45090767374033,0.6557158119658119,41.06770833333334,1035.729166666668,26.55715811965816,0
2791,4,0,1,45,0.0,0.021739130434782608,0.9782608695652174,46,1350,900,450,0.6666666666666666,18,9,9,334.0142687883455,0.39618558776167473,0.1793265174992673,0.21121677887079984,134199.77349175388,-235.07215711801678,133964.70133463587,2788,14,868.1521739130435,39,7,22,32.31135434469354,0.6567841880341878,40.963541666666686,1036.1458333333364,26.56784188034196,0
2792,4,0,0,45,0.0,0.0,1.0,45,1250,800,450,0.64,17,8,9,340.98602465444566,0.3923821548821549,0.19066281628162818,0.2152474280631189,134135.43721236032,147.6619000657532,134283.09911242608,2789,15,886.9333333333333,38,7,22,32.19497731023102,0.6578947368421052,41.02564102564103,1035.8974358974363,27.260458839406216,0
2793,4,0,0,45,0.0,0.0,1.0,45,1100,800,300,0.7272727272727273,14,8,6,342.2015981379771,0.3925925925925926,0.18911915317730377,0.21650445533856763,134218.45465565426,185.95393655490622,134404.40859220916,2790,16,887.9333333333333,38,7,22,32.08062686874936,0.6587171052631577,40.945512820512825,1036.2179487179494,27.26889338731446,0
2794,4,0,0,45,0.0,0.0,1.0,45,1350,800,550,0.5925925925925926,19,8,11,341.6195132320121,0.3922979797979798,0.18526918671248582,0.21629956125003363,134246.13284388915,172.21971108187972,134418.35255497103,2791,17,888.9333333333333,38,7,22,32.068084192439855,0.6589912280701755,40.918803418803414,1036.3247863247855,27.27170490328383,0
2795,4,0,1,44,0.0,0.022222222222222223,0.9777777777777777,45,1100,1000,100,0.9090909090909091,12,10,2,339.23112021002896,0.39191919191919194,0.18103383135840656,0.2156017041020518,134384.566588593,117.4854125575252,134502.05200115053,2792,18,889.9333333333333,38,7,22,31.991885625966002,0.6603618421052632,40.78525641025641,1036.8589743589741,27.2857624831309,0
2796,4,0,0,44,0.0,0.0,1.0,44,1300,800,500,0.6153846153846154,18,8,10,347.05094925026174,0.3915829809725158,0.18632324941823564,0.22020266269879016,134323.35550361648,523.4096068020907,134846.76511041858,2793,19,848.25,37,7,22,31.850275015866295,0.6615990990990992,40.844298245614034,1036.6228070175437,28.016832622095773,0
2797,4,0,0,44,0.0,0.0,1.0,44,1200,700,500,0.5833333333333334,17,7,10,347.484502001231,0.39096634954193094,0.18710175013695474,0.22133709794139014,134465.47405211214,544.933657471523,135010.40770958367,2794,20,849.25,37,7,22,31.697215174260833,0.6630067567567568,40.70723684210526,1037.1710526315785,28.031650071123742,0
2798,4,0,1,43,0.0,0.022727272727272728,0.9772727272727273,44,1050,800,250,0.7619047619047619,13,8,5,348.250447318265,0.390074436222692,0.18176200730268732,0.22217554819056176,134523.07167251065,569.543976915761,135092.6156494264,2795,21,850.25,38,6,22,31.6198935805012,0.6617324561403508,40.6517094017094,1037.3931623931614,27.299820062977933,0
2799,4,0,0,43,0.0,0.0,1.0,43,800,500,300,0.625,11,5,6,348.250447318265,0.38916574381690666,0.18104088328982382,0.22217554819056176,134523.07167251065,769.5439769157615,135292.6156494264,2796,22,860.046511627907,38,5,22,31.6198935805012,0.6617324561403508,40.6517094017094,1037.3931623931614,27.299820062977933,0
2800,4,0,0,43,0.0,0.0,1.0,43,1100,800,300,0.7272727272727273,14,8,6,349.61604728557995,0.38907345884090067,0.18182336995291748,0.22340041795546867,134580.80317911954,810.3302503061602,135391.1334294257,2797,23,861.046511627907,35,8,22,31.526886967837882,0.6681547619047619,40.59606481481482,1037.615740740741,29.646164021164033,0
2801,4,0,0,43,0.0,0.0,1.0,43,1000,500,500,0.5,15,5,10,348.56508298003496,0.3891196013289036,0.1797911516924784,0.22380014380751556,134755.32119957803,794.1999431864396,135549.52114276448,2798,24,862.046511627907,36,7,22,31.380151843817792,0.6678240740740741,40.42792792792793,1038.2882882882889,28.84134134134136,0
2802,4,0,0,43,0.0,0.0,1.0,43,1350,1200,150,0.8888888888888888,15,12,3,356.0745652677319,0.3891196013289036,0.19587313298118691,0.21400586955137713,132308.6811583719,933.904923892087,133242.586082264,2799,25,863.046511627907,35,8,20,33.636727978400295,0.6455357142857142,42.79513888888889,1028.8194444444446,29.394841269841272,7
2803,4,0,0,43,0.0,0.0,1.0,43,1150,900,250,0.782608695652174,14,9,5,357.6823853789227,0.3892349575489111,0.19716828881047688,0.21531171891699413,132368.22601862572,869.1565661436917,133237.38258476942,2800,26,864.046511627907,35,8,20,33.53543377197914,0.6461309523809524,42.73726851851852,1029.0509259259263,29.40145502645504,0
2804,4,0,0,43,0.0,0.0,1.0,43,950,600,350,0.631578947368421,13,6,7,355.84913701257204,0.3890503875968992,0.19282553431880234,0.214377406931964,132398.00347222216,822.7497535150799,133220.75322573725,2801,27,865.046511627907,33,10,20,33.55263157894737,0.6508838383838385,42.70833333333333,1029.166666666666,31.186868686868667,0
2805,4,1,1,43,0.022727272727272728,0.022727272727272728,0.9772727272727273,44,450,400,50,0.8888888888888888,5,4,1,347.81857059279577,0.3911975863284003,0.20152565516517007,0.21125401603372962,132704.4802295918,431.41652494330935,133135.89675453512,2802,0,846.3636363636364,34,10,19,33.451280569998076,0.6516544117647058,42.410714285714285,1030.3571428571427,30.30462184873949,0
2806,4,0,1,42,0.0,0.023255813953488372,0.9767441860465116,43,750,400,350,0.5333333333333333,11,4,7,358.0956683176934,0.3906653746770026,0.194436610551892,0.20419072150881223,130292.97052154175,731.4696712017931,131024.44019274354,2803,1,863.9302325581396,34,9,22,35.62193913246269,0.627450980392157,44.76190476190475,1020.9523809523794,30.028011204481746,5
2807,4,1,1,42,0.023255813953488372,0.023255813953488372,0.9767441860465116,43,800,400,400,0.5,12,4,8,354.04448741567734,0.39186507936507936,0.1883496040035879,0.20299023617159362,130505.75573979579,640.9686791383092,131146.72441893409,2804,0,856.9767441860465,34,9,20,35.50963144199776,0.6295955882352942,44.55357142857142,1021.7857142857132,30.05252100840333,0
2808,4,0,0,42,0.0,0.0,1.0,42,1150,800,350,0.6956521739130435,15,8,7,364.3095161458361,0.38948170731707316,0.19404733335618896,0.20824111848829868,130387.71896626287,1100.2973615916842,131488.01632785454,2805,3,878.3809523809524,33,9,22,35.3671706263499,0.6306818181818183,44.66911764705882,1021.3235294117638,30.949197860962542,0
2809,4,0,0,42,0.0,0.0,1.0,42,950,700,250,0.7368421052631579,12,7,5,364.5624187208267,0.3901592140921409,0.19723974042592074,0.20872200016873713,130450.30757401003,1111.4559304113814,131561.76350442143,2806,4,879.3809523809524,33,9,22,35.297204894433776,0.6313131313131313,44.6078431372549,1021.5686274509808,30.956625074272146,0
2810,4,0,0,42,0.0,0.0,1.0,42,1200,1000,200,0.8333333333333334,14,10,4,362.52498318978496,0.39037698412698413,0.19987611397514304,0.20839565022646447,130606.84479827477,1069.6488429930905,131676.49364126788,2807,5,880.3809523809524,33,9,20,35.190499740239,0.6328914141414141,44.454656862745104,1022.1813725490202,30.97519310754607,0
2811,4,0,0,42,0.0,0.0,1.0,42,1000,700,300,0.7,13,7,6,361.30874952405094,0.3900866240805265,0.20015353618374143,0.20803305019179816,130669.4859699394,1042.4057153498597,131711.89168528927,2808,6,881.3809523809524,33,9,20,35.15809161372807,0.6335227272727273,44.393382352941174,1022.4264705882349,30.982620320855602,0
2812,4,1,1,42,0.023255813953488372,0.023255813953488372,0.9767441860465116,43,1100,600,500,0.5454545454545454,16,6,10,352.89777995250193,0.3952104097452935,0.19526664016893625,0.20522473329083615,131053.71492346922,649.7130102040587,131703.4279336733,2809,0,861.8604651162791,34,9,21,34.984304150680146,0.6351102941176471,44.01785714285713,1023.9285714285701,30.115546218487356,0
2813,4,1,0,43,0.023255813953488372,0.0,1.0,43,1350,1000,350,0.7407407407407407,17,10,7,352.3035230352304,0.3947951273532669,0.20514274910190977,0.2063492063492062,131328.12499999988,653.7592120181262,131981.88421201802,2810,0,862.8372093023256,33,10,22,34.722222222222236,0.6401515151515152,43.74999999999999,1024.999999999999,31.060606060606034,0
2814,4,0,0,43,0.0,0.0,1.0,43,1250,900,350,0.72,16,9,7,351.9713433245359,0.3948643410852713,0.2047456873184228,0.20632377623754328,131359.5300635573,646.9580509900024,132006.4881145473,2811,1,863.8372093023256,33,10,23,34.69901872883043,0.6404671717171717,43.71936274509804,1025.1225490196077,31.06431966726084,0
2815,4,1,1,43,0.022727272727272728,0.022727272727272728,0.9772727272727273,44,950,600,350,0.631578947368421,13,6,7,344.0000890598042,0.39792547568710357,0.20414464871478422,0.20293886157470553,131602.8220663264,254.27650226755236,131857.09856859394,2812,0,845.1818181818181,34,10,18,34.657926286885555,0.640625,43.48214285714285,1026.0714285714273,30.17857142857139,0
2816,4,0,0,43,0.0,0.0,1.0,43,1050,500,550,0.47619047619047616,16,5,11,358.10057048187093,0.393249354005168,0.21911675673874265,0.211476317151988,131642.34459102276,828.239739523263,132470.58433054603,2813,3,865.8372093023256,33,10,18,34.25632911392405,0.6433080808080808,43.443627450980394,1026.225490196079,31.097742127153907,0
2817,4,0,0,43,0.0,0.0,1.0,43,900,700,200,0.7777777777777778,11,7,4,360.44979776489015,0.3933185677371724,0.21448416167772733,0.21374443421599537,131799.59518274217,901.4274858227581,132701.02266856492,2814,4,866.8372093023256,33,10,18,34.03735032024507,0.6448863636363636,43.29044117647059,1026.8382352941173,31.116310160427798,0
2818,4,0,0,43,0.0,0.0,1.0,43,950,700,250,0.7368421052631579,12,7,5,361.44974881608226,0.39258028792912514,0.21953865748384338,0.21469244116425137,131862.52170138896,932.335069444455,132794.85677083343,2815,5,867.8372093023256,33,10,18,33.94819134550372,0.6455176767676767,43.22916666666667,1027.083333333334,31.12373737373739,0
2819,4,0,0,43,0.0,0.0,1.0,43,1200,900,300,0.75,15,9,6,362.41355119360696,0.3915420819490587,0.20787465313103848,0.21669902216416007,132114.3779585975,976.0081759419322,133090.38613453944,2816,6,868.8372093023256,33,10,20,33.66946298724522,0.6480429292929294,42.984068627450974,1028.0637254901949,31.153446226975603,0
2820,4,0,0,43,0.0,0.0,1.0,43,600,400,200,0.6666666666666666,8,4,4,363.4743103274375,0.3911960132890366,0.21087119217229855,0.21751422707897278,132145.8768862936,1006.3262927719963,133152.2031790656,2817,7,869.8372093023256,33,10,20,33.61044894715933,0.6483585858585859,42.95343137254901,1028.1862745098028,31.157159833630388,0
2821,4,1,0,44,0.022727272727272728,0.0,1.0,44,1600,1100,500,0.6875,21,11,10,349.8339983871136,0.39326770613107825,0.20347896440129443,0.21195824608160424,132612.5,478.47222222222246,133090.97222222222,2818,0,851.0454545454545,34,10,22,33.49177454153182,0.650735294117647,42.5,1030.0,30.294117647058822,0
2822,4,0,1,43,0.0,0.022727272727272728,0.9772727272727273,44,950,600,350,0.631578947368421,13,6,7,349.4170594435581,0.39328972868217055,0.2011374138800206,0.2123984597291741,132735.14739229027,475.98497732427467,133211.13236961453,2819,1,852.0454545454545,34,10,18,33.37930337338263,0.6519607843137254,42.38095238095239,1030.4761904761908,30.30812324929973,0
2823,4,0,0,43,0.0,0.0,1.0,43,1150,700,450,0.6086956521739131,16,7,9,356.0523898239657,0.39294942783314873,0.2010037823292381,0.21554998071148543,132581.84700963713,841.2166950113385,133423.06370464846,2820,2,855.5813953488372,34,9,23,33.362472546526426,0.6504289215686274,42.529761904761905,1029.880952380952,30.29061624649859,0
2824,4,0,0,43,0.0,0.0,1.0,43,850,500,350,0.5882352941176471,12,5,7,355.3410286677741,0.3920727205610926,0.20902019265648275,0.2158229195171638,132704.4802295918,831.0693027210866,133535.5495323129,2821,3,856.5813953488372,34,9,18,33.257510109763146,0.6516544117647058,42.410714285714285,1030.3571428571427,30.30462184873949,0
2825,4,0,0,43,0.0,0.0,1.0,43,1150,900,250,0.782608695652174,14,9,5,355.6666061934293,0.3919112218530823,0.20576339737108174,0.2147908387123447,132489.9092970521,824.4472789115537,133314.35657596367,2822,4,857.5813953488372,34,9,21,33.464866635831015,0.6495098039215687,42.61904761904761,1029.523809523809,30.280112044817912,1
2826,4,0,0,43,0.0,0.0,1.0,43,1300,1100,200,0.8461538461538461,15,11,4,355.3696112397801,0.39105758582502764,0.20414810196655941,0.2156639982937624,132673.81660997708,829.6485260770675,133503.46513605415,2823,5,858.5813953488372,34,9,18,33.28759340574686,0.6513480392156864,42.440476190476176,1030.2380952380931,30.30112044817921,0
2827,4,0,0,43,0.0,0.0,1.0,43,1000,800,200,0.8,12,8,4,356.6107916981288,0.3913575119970469,0.19941000730774205,0.21677127899852544,132735.14739229018,866.9571995464821,133602.10459183666,2824,6,859.5813953488372,34,9,18,33.193979128157736,0.6519607843137255,42.38095238095238,1030.4761904761901,30.30812324929971,0
2828,4,1,0,44,0.022727272727272728,0.0,1.0,44,800,500,300,0.625,11,5,6,348.6573101374796,0.3933337737843552,0.1959816285542424,0.21426445447938705,133143.52823055984,484.29288301611473,133627.82111357595,2825,0,841.0227272727273,35,9,19,32.98907050203729,0.6538690476190476,41.9849537037037,1032.0601851851852,29.487433862433864,0
2829,4,0,0,44,0.0,0.0,1.0,44,1150,900,250,0.782608695652174,14,9,5,352.29942143481105,0.39290433403805497,0.19920136031489521,0.21723156658613202,133268.65875588427,590.094275018262,133858.75303090253,2826,1,842.0227272727273,36,8,19,32.76961318936998,0.6530671296296295,41.86373873873874,1032.545045045045,28.681806806806808,0
2830,4,0,0,44,0.0,0.0,1.0,44,750,600,150,0.8,9,6,3,352.29942143481105,0.39298141296687805,0.19920136031489521,0.21723156658613202,133268.65875588427,590.094275018262,133858.75303090253,2827,2,843.0227272727273,36,8,19,32.76961318936998,0.6530671296296295,41.86373873873874,1032.545045045045,28.681806806806808,0
2831,4,0,0,44,0.0,0.0,1.0,44,1500,1200,300,0.8,18,12,6,349.3831270556617,0.39252995066948554,0.19938320535050824,0.2164476833717552,133443.13221583067,524.5557635338039,133967.68797936448,2828,3,844.0227272727273,36,8,19,32.670072661217084,0.6548032407407407,41.69481981981982,1033.2207207207205,28.70057557557557,0
2832,4,1,1,44,0.022222222222222223,0.022222222222222223,0.9777777777777777,45,1450,1100,350,0.7586206896551724,18,11,7,338.89018381472226,0.3950757575757576,0.1922910187541229,0.21140292418918358,133698.92659279765,61.85076177283517,133760.77735457048,2829,0,826.2444444444444,37,8,20,32.68527353689566,0.6554054054054055,41.44736842105262,1034.2105263157882,27.951635846372653,0
2833,4,0,0,44,0.0,0.0,1.0,44,1200,900,300,0.75,15,9,6,343.8757659335879,0.39265107470049326,0.19480201206048053,0.21404226488381498,133617.7198101818,389.5791484051614,134007.29895858697,2830,5,846.0227272727273,36,8,21,32.63760302073123,0.6565393518518519,41.5259009009009,1033.8963963963963,28.719344344344343,0
2834,4,0,0,44,0.0,0.0,1.0,44,900,500,400,0.5555555555555556,13,5,8,347.82266007235745,0.39238680408738547,0.1974580297751034,0.21701109443644895,133705.05640775897,501.1296769742569,134206.18608473323,2831,6,847.0227272727273,36,8,16,32.44818887921022,0.6574074074074074,41.441441441441434,1034.234234234233,28.728728728728697,0
2835,4,0,0,44,0.0,0.0,1.0,44,850,600,250,0.7058823529411765,11,6,5,349.97335232492753,0.3924088266384778,0.19349108326900644,0.21869763363651573,133763.2966581445,562.7178698969128,134326.0145280414,2832,7,848.0227272727273,36,8,16,32.33430401335365,0.6579861111111112,41.38513513513513,1034.4594594594585,28.73498498498496,0
2836,4,0,0,44,0.0,0.0,1.0,44,1150,900,250,0.782608695652174,14,9,5,349.02599756724146,0.3918802854122621,0.19968397938694982,0.21896914291061556,133908.95276611077,547.5411644752935,134456.49393058606,2833,8,849.0227272727273,36,8,17,32.213125158669705,0.6594328703703705,41.24436936936937,1035.022522522523,28.75062562562564,0
2837,4,0,0,44,0.0,0.0,1.0,44,1250,900,350,0.72,16,9,7,345.8888667165205,0.39153893587033123,0.1955672671900648,0.21751725311844672,133996.38447569197,469.5715140816559,134465.95598977362,2834,9,850.0227272727273,36,8,17,32.206919367703584,0.6603009259259258,41.15990990990991,1035.3603603603608,28.76001001001002,0
2838,4,0,1,43,0.0,0.022727272727272728,0.9772727272727273,44,1350,900,450,0.6666666666666666,18,9,9,345.8888667165205,0.39153893587033123,0.1955672671900648,0.21751725311844672,133996.38447569197,469.5715140816559,134465.95598977362,2835,10,851.0227272727273,36,8,17,32.206919367703584,0.6603009259259258,41.15990990990991,1035.3603603603608,28.76001001001002,0
2839,4,0,0,43,0.0,0.0,1.0,43,1150,700,450,0.6086956521739131,16,7,9,346.88451264151956,0.39087301587301587,0.19830664495179895,0.21848972453776816,134054.68813408012,700.2990321402611,134754.98716622038,2836,11,864.1162790697674,36,7,17,32.12288857474265,0.6608796296296295,41.10360360360361,1035.5855855855864,28.76626626626629,0
2840,4,0,0,43,0.0,0.0,1.0,43,1400,900,500,0.6428571428571429,19,9,10,346.82443289224943,0.390296234772979,0.1978715874620829,0.21914730649785008,134171.33349565786,706.7793300056878,134878.11282566356,2837,12,865.1162790697674,36,7,18,32.007925724637666,0.662037037037037,40.990990990990994,1036.0360360360364,28.77877877877879,0
2841,4,0,0,43,0.0,0.0,1.0,43,800,500,300,0.625,11,5,6,346.82443289224943,0.390296234772979,0.1978715874620829,0.21914730649785008,134171.33349565786,706.7793300056878,134878.11282566356,2838,13,866.1162790697674,36,7,18,32.007925724637666,0.662037037037037,40.990990990990994,1036.0360360360364,28.77877877877879,0
2842,4,0,0,43,0.0,0.0,1.0,43,850,600,250,0.7058823529411765,11,6,5,347.71057254357396,0.39059616094499816,0.19924384486688962,0.22005726881334037,134229.6751988476,734.6154431458601,134964.29064199346,2839,14,867.1162790697674,36,7,18,31.926709773237718,0.6626157407407407,40.93468468468469,1036.261261261262,28.785035035035055,0
2843,4,0,0,43,0.0,0.0,1.0,43,1200,800,400,0.6666666666666666,16,8,8,346.94399068031737,0.3904577334809893,0.2000545768775961,0.21992234781140801,134288.02958363784,718.0849768687772,135006.11456050663,2840,15,868.1162790697674,36,7,19,31.888309430682312,0.6631944444444444,40.878378378378386,1036.4864864864876,28.791291291291323,0
2844,4,0,0,43,0.0,0.0,1.0,43,1200,1100,100,0.9166666666666666,13,11,2,353.95597858417614,0.3900424510889627,0.24692758555492533,0.20731707317073156,131328.1249999999,718.7158864945904,132046.8408864945,2841,16,869.1162790697674,35,8,18,34.67987804878048,0.6357142857142858,43.74999999999999,1024.9999999999993,29.285714285714267,8
2845,4,0,0,43,0.0,0.0,1.0,43,1350,1100,250,0.8148148148148148,16,11,5,352.8963871965807,0.3900885935769656,0.24200958796935645,0.2070169667408815,131387.4488275891,673.2312028463593,132060.68003043547,2842,17,870.1162790697674,35,8,19,34.64711748325432,0.6363095238095239,43.692129629629626,1025.231481481481,29.29232804232803,0
2846,4,0,0,43,0.0,0.0,1.0,43,950,700,250,0.7368421052631579,12,7,5,353.3435953197913,0.3903423772609819,0.24276455161877197,0.2074400868746208,131417.11576485322,687.0792341820822,132104.1949990353,2843,18,871.1162790697674,35,8,19,34.605697595665426,0.6366071428571429,43.663194444444436,1025.347222222221,29.295634920634885,0
2847,4,0,0,43,0.0,0.0,1.0,43,950,800,150,0.8421052631578947,11,8,3,352.2171269097028,0.38983480989294944,0.24583696160122148,0.2070782036647296,131472.44953991147,661.3696889456928,132133.81922885717,2844,19,872.1162790697674,36,7,19,34.578712345814566,0.6351273148148149,43.60923423423423,1025.5630630630626,28.48786286286285,0
2848,4,0,0,43,0.0,0.0,1.0,43,1200,800,400,0.6666666666666666,16,8,8,341.46732565318206,0.3903423772609819,0.2209913652899882,0.19932438389749474,131197.94894118933,359.9625512261481,131557.91149241547,2845,20,873.1162790697674,40,3,20,35.13127004596106,0.6252604166666667,43.877032520325216,1024.491869918701,25.612296747967527,3
2849,4,0,0,43,0.0,0.0,1.0,43,1650,1300,350,0.7878787878787878,20,13,7,345.9896535325182,0.3897425249169435,0.22550093546729766,0.20294111951699517,131382.8849806413,491.55286900070485,131874.437849642,2846,21,874.1162790697674,38,5,21,34.828748089481735,0.6304824561403508,43.69658119658119,1025.2136752136744,26.979307242465115,0
2850,4,0,0,43,0.0,0.0,1.0,43,1200,800,400,0.6666666666666666,16,8,8,346.007724819185,0.38907345884090067,0.2315505975014902,0.20382614562661414,131547.2334082109,503.2717875666556,132050.50519577754,2847,22,875.1162790697674,38,5,21,34.66248351037979,0.6321271929824561,43.53632478632478,1025.8547008547,26.99617633828158,0
2851,4,1,0,44,0.022727272727272728,0.0,1.0,44,1250,900,350,0.72,16,9,7,345.3042372080076,0.39349894291754756,0.24845135598532542,0.2053914588266205,131916.0210503471,310.2322048611026,132226.2532552082,2848,0,856.2045454545455,39,5,20,34.308879199621465,0.6340811965811967,43.17708333333333,1027.2916666666656,26.340811965811938,0
2852,4,0,0,44,0.0,0.0,1.0,44,1500,1300,200,0.8666666666666667,17,13,4,342.7033129810124,0.39483130725863286,0.2435130752077843,0.2044202470296654,132023.05230034707,248.94748263887172,132271.99978298595,2849,1,857.2045454545455,39,5,21,34.26794040137847,0.6351495726495727,43.07291666666666,1027.7083333333321,26.351495726495695,0
2853,4,0,0,44,0.0,0.0,1.0,44,900,600,300,0.6666666666666666,12,6,6,343.25666285829266,0.394633104298802,0.24502625034539927,0.20532989469159676,132130.12695312488,270.90928819443127,132401.03624131932,2850,2,858.2045454545455,39,5,21,34.14598108747043,0.6362179487179489,42.96874999999999,1028.124999999999,26.362179487179464,0
2854,4,0,0,44,0.0,0.0,1.0,44,1000,600,400,0.6,14,6,8,340.8556590812976,0.394016472868217,0.24016502136437312,0.20418246762442754,132183.6805555554,211.11111111109207,132394.79166666648,2851,3,859.2045454545455,39,5,21,34.15383576445163,0.6367521367521368,42.91666666666666,1028.333333333332,26.36752136752133,0
2855,4,0,0,44,0.0,0.0,1.0,44,1350,1100,250,0.8148148148148148,16,11,5,340.6774226859447,0.3932787174066244,0.24105450127924333,0.20494589411033862,132344.40646701382,217.3502604166626,132561.75672743047,2852,4,860.2045454545455,39,5,21,33.996844840386046,0.6383547008547009,42.760416666666664,1028.9583333333328,26.383547008546994,0
2856,4,0,0,44,0.0,0.0,1.0,44,1700,1300,400,0.7647058823529411,21,13,8,338.9982805216084,0.3936200669485553,0.2397601101814033,0.2048229736292625,132507.9800044743,184.0063260761259,132691.98633055043,2853,5,861.2045454545455,38,6,22,33.87573069074057,0.6417214912280702,42.60149572649572,1029.5940170940162,27.094579397210953,0
2857,4,0,0,44,0.0,0.0,1.0,44,1300,900,400,0.6923076923076923,17,9,8,342.7370826948571,0.39283826638477803,0.24675122595247045,0.20753677620467484,132590.49236613343,288.73570932866323,132879.2280754621,2854,6,862.2045454545455,38,6,22,33.69661998616875,0.6425438596491228,42.52136752136752,1029.9145299145302,27.103013945119216,0
2858,4,0,0,44,0.0,0.0,1.0,44,1200,1200,0,1.0,12,12,0,340.6864010935083,0.39292635658914726,0.18312350312451198,0.20924861597231179,133122.62505425359,270.6136067708386,133393.23866102443,2855,7,863.2045454545455,39,5,18,33.21567662595471,0.6461004273504274,42.005208333333336,1031.9791666666674,26.461004273504294,4
2859,4,0,1,43,0.0,0.022727272727272728,0.9772727272727273,44,950,600,350,0.631578947368421,13,6,7,338.2377399599038,0.39301444679351655,0.1789678135405104,0.20834519830594211,133230.14458550359,212.69259982639952,133442.83718533,2856,8,864.2045454545455,39,5,18,33.17116083139943,0.6471688034188035,41.90104166666667,1032.3958333333344,26.471688034188062,0
2860,4,0,0,43,0.0,0.0,1.0,43,1100,700,400,0.6363636363636364,15,7,8,342.9937540431345,0.39221114802510154,0.17049611119667363,0.21139615045107446,133251.51581561822,540.8875283073876,133792.4033439256,2731,9,818.8837209302326,38,5,18,33.026998827262695,0.6491228070175439,41.880341880341874,1032.4786324786312,27.170490328385032,0
2861,4,0,0,43,0.0,0.0,1.0,43,950,400,550,0.42105263157894735,15,4,11,338.8738770524339,0.391703580657069,0.16640570319433756,0.20963349438387593,133389.4359179814,440.43906147269513,133829.8749794541,2732,10,819.8837209302326,38,5,18,32.995268383493645,0.6504934210526316,41.74679487179486,1033.012820512819,27.184547908232076,0
2862,4,0,0,43,0.0,0.0,1.0,43,950,600,350,0.631578947368421,13,6,7,341.37462633944335,0.39087301587301587,0.16944483174752745,0.21196778788239856,133527.42735955853,516.5751241872763,134044.0024837458,2733,11,820.8837209302326,38,5,18,32.79257976707324,0.6518640350877194,41.61324786324785,1033.5470085470067,27.198605488079124,0
2863,4,0,0,43,0.0,0.0,1.0,43,1150,700,450,0.6086956521739131,16,7,9,348.5880536688658,0.39087301587301587,0.16615647985608417,0.2077273791937515,131985.9981097961,601.748438527283,132587.7465483234,2734,12,821.8837209302326,38,5,16,34.15406009565399,0.6365131578947368,43.10897435897436,1027.564102564102,27.04116059379216,2
2864,4,0,0,43,0.0,0.0,1.0,43,1200,900,300,0.75,15,9,6,350.74603080826626,0.3898809523809524,0.1718958417908718,0.20992411694643992,132150.7232084155,670.2683267587129,132820.99153517422,2735,13,822.8837209302326,38,5,18,33.93274625935163,0.6381578947368421,42.94871794871795,1028.2051282051282,27.058029689608635,0
2865,4,0,0,43,0.0,0.0,1.0,43,1050,800,250,0.7619047619047619,13,8,5,350.29163148649565,0.3889811738648948,0.17367239006013202,0.21056856499469126,132315.55103550298,669.8060486522074,132985.3570841552,2736,14,823.8837209302326,38,5,19,33.77855659397715,0.6398026315789473,42.78846153846154,1028.846153846154,27.074898785425106,0
2866,4,0,0,43,0.0,0.0,1.0,43,750,400,350,0.5333333333333333,11,4,7,348.9832874821111,0.3893041712809155,0.17164534098948847,0.2099349182848353,132343.0323275075,637.1012994009794,132980.13362690847,2737,15,824.8837209302326,38,5,19,33.784567196206694,0.6400767543859649,42.761752136752136,1028.9529914529917,27.077710301394518,0
2867,4,0,0,43,0.0,0.0,1.0,43,650,400,250,0.6153846153846154,9,4,5,348.9832874821111,0.3893041712809155,0.17164534098948847,0.2099349182848353,132343.0323275075,637.1012994009794,132980.13362690847,2738,16,825.8837209302326,38,5,19,33.784567196206694,0.6400767543859649,42.761752136752136,1028.9529914529917,27.077710301394518,0
2868,4,0,0,43,0.0,0.0,1.0,43,950,600,350,0.631578947368421,13,6,7,350.25379157418945,0.3891196013289036,0.16387213888795005,0.21116051489522802,132425.49332493255,676.5062276280388,133101.9995525606,2739,17,826.8837209302326,38,5,19,33.66895024565775,0.6408991228070174,42.68162393162394,1029.2735042735053,27.08614484930277,0
2869,4,0,0,43,0.0,0.0,1.0,43,1300,900,400,0.6923076923076923,17,9,8,347.4582544254752,0.3889811738648948,0.16424328119797127,0.21008799599452518,132535.48127145894,610.1093944042794,133145.59066586322,2740,18,827.8837209302326,38,5,19,33.63033478591687,0.6419956140350876,42.57478632478633,1029.7008547008554,27.097390913180405,0
2870,4,0,0,43,0.0,0.0,1.0,43,800,300,500,0.375,13,3,10,348.7030251461511,0.389281100036914,0.1618425147836906,0.21099488131724758,132562.98539201196,645.0228057199294,133208.0081977319,2741,19,828.8837209302326,38,5,19,33.57065048241518,0.6422697368421052,42.54807692307693,1029.8076923076933,27.100202429149824,0
2871,4,0,0,43,0.0,0.0,1.0,43,1400,1200,200,0.8571428571428571,16,12,4,345.73945565492363,0.38935031376891843,0.15995697565893074,0.20981532856390397,132673.03040990958,574.0602628022699,133247.09067271184,2742,20,829.8837209302326,38,5,18,33.5364167444433,0.6433662280701753,42.441239316239326,1030.235042735044,27.111448493027478,0
2872,4,0,0,43,0.0,0.0,1.0,43,850,600,250,0.7058823529411765,11,6,5,348.7112014554092,0.3899501661129568,0.16733194492652959,0.21239682270465862,132810.65088757421,662.5123274162011,133473.1632149904,2743,21,830.8837209302326,38,5,18,33.32167288557214,0.644736842105263,42.30769230769232,1030.7692307692328,27.125506072874547,0
2873,4,1,1,43,0.022727272727272728,0.022727272727272728,0.9772727272727273,44,750,400,350,0.5333333333333333,11,4,7,342.17505647371576,0.3943137773079634,0.16401905181432763,0.21001153094353373,133095.75195312523,308.40928819447544,133404.1612413197,2744,0,812.9772727272727,39,5,18,33.20420284002963,0.6458333333333333,42.031250000000014,1031.8750000000018,26.45833333333338,0
2874,4,0,0,43,0.0,0.0,1.0,43,950,600,350,0.631578947368421,13,6,7,348.56949828019253,0.3898809523809524,0.16825783703589536,0.2135651697584733,133030.99203740232,674.1092300387247,133705.10126744106,2745,23,832.8837209302326,38,5,18,33.10420118751726,0.6469298245614035,42.0940170940171,1031.6239316239319,27.147998200629786,0
2875,4,1,1,43,0.022727272727272728,0.022727272727272728,0.9772727272727273,44,700,400,300,0.5714285714285714,10,4,6,332.31085390105966,0.3933117512332629,0.19470935924864952,0.1872142271303272,129822.05119307281,-171.7446625685859,129650.30653050423,2746,0,814.9318181818181,40,4,18,36.75708017550858,0.6114583333333334,45.22357723577235,1019.1056910569098,25.477642276422745,6
2876,4,1,0,44,0.022727272727272728,0.0,1.0,44,1050,600,450,0.5714285714285714,15,6,9,320.14660443514106,0.3955910852713178,0.15912283902750457,0.17310151455215356,128195.9845846557,-574.3267276422391,127621.65785701346,2747,0,814.3181818181819,40,4,19,38.718849305903994,0.5950520833333331,46.82418699186994,1012.7032520325236,25.31758130081309,3
2877,4,1,0,45,0.022222222222222223,0.0,1.0,45,900,600,300,0.6666666666666666,12,6,6,316.34959076393744,0.3999368686868687,0.16678730966122202,0.17266641037798908,128571.78411005622,-865.2737425988689,127706.51036745735,2748,0,797.2,41,4,18,38.4324358472725,0.5973069105691056,46.45337301587303,1014.1865079365092,24.73625629113437,0
2878,4,1,2,44,0.021739130434782608,0.043478260869565216,0.9565217391304348,46,1050,800,250,0.7619047619047619,13,8,5,312.240904275501,0.40394524959742356,0.015917702317963522,0.17304124100113874,129176.17517203621,-1043.9463458994906,128132.22882613672,2749,0,780.8478260869565,41,5,19,37.92278634397059,0.6034044715447155,45.85813492063491,1016.5674603174587,24.79432830042582,7
2879,4,1,1,44,0.022222222222222223,0.022222222222222223,0.9777777777777777,45,750,600,150,0.8,9,6,3,319.80650362805727,0.4021885521885522,0.03315118397085626,0.17734724292101328,129201.38888888864,-736.1111111111354,128465.2777777775,2750,0,799.1333333333333,40,5,20,37.70491803278689,0.6052083333333336,45.83333333333332,1016.6666666666647,25.416666666666618,0
2880,4,0,0,44,0.0,0.0,1.0,44,1300,1100,200,0.8461538461538461,15,11,4,326.0545766614009,0.3987072762508809,0.0475308182190608,0.18129822816184027,129307.31336805537,-367.75173611113075,128939.56163194425,2751,1,818.2045454545455,39,5,20,37.43854977468251,0.607905982905983,45.72916666666666,1017.0833333333319,26.07905982905979,0
2881,4,4,3,45,0.08333333333333333,0.0625,0.9375,48,1100,800,300,0.7272727272727273,14,8,6,301.7560483651351,0.4105995124113475,0.06978741180839276,0.17107979752574906,130069.31889921932,-1750.1592630854084,128319.1596361339,2752,0,750.9375,43,5,18,37.285709865082325,0.609496124031008,44.9810606060606,1020.0757575757564,23.722692036645498,0
2882,4,0,0,45,0.0,0.0,1.0,45,1550,1400,150,0.9032258064516129,17,14,3,326.96165137296475,0.40345117845117845,0.0632096795638879,0.18420064269483644,129822.05119307281,-510.6335514574751,129311.41764161534,2753,1,802.0,40,5,20,36.89336524398351,0.6114583333333334,45.22357723577235,1019.1056910569098,25.477642276422745,0
2883,4,0,0,45,0.0,0.0,1.0,45,900,600,300,0.6666666666666666,12,6,6,328.9046423057065,0.4029671717171717,0.07117224880382778,0.1857866763294395,129925.63950029736,-453.3708027629148,129472.26869753444,2754,2,803.0,40,5,20,36.738893872939926,0.6125,45.12195121951219,1019.5121951219505,25.487804878048763,0
2884,4,0,0,45,0.0,0.0,1.0,45,600,200,400,0.3333333333333333,10,2,8,331.04478719177735,0.4032828282828283,0.0742261193038396,0.18749240881809678,130029.26911891061,-390.89765516558475,129638.37146374503,2755,3,804.0,40,5,21,36.57935598512024,0.6135416666666667,45.02032520325203,1019.9186991869911,25.497967479674777,0
2885,4,1,0,46,0.021739130434782608,0.0,1.0,46,850,700,150,0.8235294117647058,10,7,3,325.5501660243175,0.40643115942028984,0.07676872935281454,0.186123578884457,130395.5417209203,-709.5236709738766,129686.01804994642,2756,0,787.5,39,7,22,36.348907870134305,0.6188568376068375,44.66145833333334,1021.354166666668,26.18856837606841,0
2886,4,2,2,46,0.041666666666666664,0.041666666666666664,0.9583333333333334,48,750,500,250,0.6666666666666666,10,5,5,313.2998287723584,0.41325908687943264,0.07631074789019321,0.1807391121888214,130744.07837498405,-1407.580526423551,129336.4978485605,2757,0,755.6458333333334,41,7,16,36.310000161671056,0.6191565040650406,44.3204365079365,1022.7182539682524,24.944347657762254,0
2887,4,0,1,45,0.0,0.021739130434782608,0.9782608695652174,46,1100,600,500,0.5454545454545454,16,6,10,326.6757200538949,0.40577697262479867,0.08650906867739949,0.187924707890324,130635.03146701405,-664.9414062499812,129970.09006076407,2758,2,789.5,39,7,18,36.0781366754976,0.6212606837606838,44.42708333333334,1022.291666666668,26.21260683760687,0
2888,4,0,1,44,0.0,0.022222222222222223,0.9777777777777777,45,800,600,200,0.75,10,6,4,329.85747866696653,0.4043981481481482,0.09490174771348348,0.19001649123209796,130688.28125000029,-378.2986111110818,130309.98263888921,2759,3,806.4,39,6,19,35.94301820157566,0.6217948717948717,44.375000000000014,1022.5000000000023,26.217948717948776,0
2889,4,0,0,44,0.0,0.0,1.0,44,950,700,250,0.7368421052631579,12,7,5,325.1176030477894,0.400997621564482,0.09997334044254824,0.18433627517222625,130071.79578493668,-342.27390605597634,129729.5218788807,2760,4,825.5681818181819,38,6,20,36.68743890518083,0.6173245614035088,44.97863247863247,1020.0854700854691,26.844354475933397,1
2890,4,1,0,45,0.022222222222222223,0.0,1.0,45,1850,1300,550,0.7027027027027027,24,13,11,313.32352235762545,0.40389309764309766,0.10575803321112764,0.17399774529009696,129257.13320444764,-858.7660563741863,128398.36714807346,2761,0,808.2,37,8,20,37.81315146287111,0.6109234234234234,45.77850877192983,1016.8859649122817,27.483404457088692,5
2891,4,0,0,45,0.0,0.0,1.0,45,1350,1100,250,0.8148148148148148,16,11,5,316.0338546994723,0.40349326599326596,0.11635649445522267,0.17600012628461595,129368.65790435509,-823.0248730378692,128545.63303131722,2762,1,809.2,37,8,21,37.6311345836028,0.6120495495495495,45.6688596491228,1017.3245614035079,27.495258416311025,0
2892,4,0,0,45,0.0,0.0,1.0,45,1150,1000,150,0.8695652173913043,13,10,3,315.2307231303823,0.4033459595959596,0.12648173412157004,0.1763848244691376,129554.63927469144,-832.0794753086353,128722.5597993828,2763,2,810.2,38,7,16,37.46305138699408,0.6121162280701754,45.486111111111114,1018.0555555555562,26.79093567251464,0
2893,4,1,0,46,0.021739130434782608,0.0,1.0,46,700,600,100,0.8571428571428571,8,6,2,309.2060360972449,0.40625,0.1357817819775451,0.17403069304391552,129784.51063368065,-1173.9691840277683,128610.54144965288,2764,0,793.5652173913044,39,7,17,37.38371498671028,0.6127136752136751,45.26041666666667,1018.9583333333342,26.127136752136774,0
2894,4,2,1,47,0.041666666666666664,0.020833333333333332,0.9791666666666666,48,1000,600,400,0.6,14,6,8,299.6048757496221,0.41210475768321514,0.13739556631539007,0.17048828504974425,130213.13252095714,-1797.50212201792,128415.63039893922,2765,0,761.4583333333334,42,6,19,37.19540175322004,0.6123511904761905,44.84011627906976,1020.6395348837199,24.300941306755234,0
2895,4,3,2,48,0.06,0.04,0.96,50,1200,700,500,0.5833333333333334,17,7,10,290.09401160136747,0.4187755102040816,0.1544100085299971,0.16698210127692434,130658.55910289318,-2419.328109037949,128239.23099385524,2766,0,731.94,42,8,14,36.98938489242725,0.6168154761904763,44.40406976744185,1022.3837209302304,24.34246954595787,0
2896,4,1,2,47,0.02040816326530612,0.04081632653061224,0.9591836734693877,49,1250,1000,250,0.8,15,10,5,293.415858870753,0.41508999433106575,0.15810475455465123,0.1688942022337868,130658.55910289328,-2132.5413324019146,128526.01777049137,2767,0,747.8571428571429,42,7,15,36.90447982813636,0.6168154761904763,44.404069767441854,1022.3837209302312,24.342469545957886,0
2897,4,0,0,47,0.0,0.0,1.0,47,1300,800,500,0.6153846153846154,18,8,10,302.6516273607905,0.41030681467776753,0.15615372376585634,0.17322978359833557,130439.8750964505,-1504.43190586421,128935.44319058629,2768,2,780.6382978723404,41,6,21,36.888879447088144,0.6161077235772358,44.61805555555555,1021.5277777777768,24.915311653116508,0
2898,4,0,0,47,0.0,0.0,1.0,47,950,600,350,0.631578947368421,13,6,7,311.9416789965727,0.4106344434165896,0.10924614339769079,0.1797195575974108,130693.35322381285,-1231.671036470126,129461.68218734273,2769,3,781.6382978723404,41,6,16,36.395875780214084,0.6186483739837398,44.37003968253969,1022.5198412698427,24.9395083236547,3
2899,4,1,1,47,0.020833333333333332,0.020833333333333332,0.9791666666666666,48,1500,1000,500,0.6666666666666666,20,10,10,309.0615438335106,0.4129543439716312,0.112535494557501,0.17950715836179437,131005.52780970198,-1502.2458648819177,129503.28194482006,2770,0,766.3333333333334,42,6,17,36.154953462691275,0.6202876984126984,44.064922480620154,1023.7403100775197,24.374769287559992,0
2900,4,1,0,48,0.020833333333333332,0.0,1.0,48,950,600,350,0.631578947368421,13,6,7,308.4386333596135,0.4124095005910165,0.12076091645866116,0.17985879768468688,131158.3172366421,-1509.1415755566911,129649.1756610854,2771,0,767.2291666666666,43,5,19,36.017091152815034,0.6203972868217054,43.9157196969697,1024.337121212122,23.821793516560977,0
2901,4,1,2,47,0.02040816326530612,0.04081632653061224,0.9591836734693877,49,1550,1200,350,0.7741935483870968,19,12,7,298.8040948533638,0.41581632653061223,0.12267140161689438,0.17534698834565698,131400.9333839102,-1947.2627553948566,129453.67062851533,2772,0,752.5510204081633,43,6,19,36.020000153936145,0.6228197674418605,43.67897727272727,1025.2840909090914,23.84381606765329,0
2902,4,0,1,46,0.0,0.02127659574468085,0.9787234042553191,47,1650,1300,350,0.7878787878787878,20,13,7,306.2896153160627,0.4100177304964539,-0.07339950382242677,0.17319105975125842,129966.00193986206,-1351.4892806920584,128614.51265917001,2773,2,785.063829787234,42,5,16,37.27450188476038,0.6098710317460319,45.08236434108526,1019.6705426356563,24.27787006275372,8
2903,4,2,2,46,0.041666666666666664,0.041666666666666664,0.9583333333333334,48,750,600,150,0.8,9,6,3,298.11488989809436,0.4102855348699764,-0.05822538040555503,0.1700723657204234,130312.05047961352,-1830.069463223376,128481.98101639014,2774,0,769.6041666666666,42,6,16,37.13363227990256,0.6133432539682541,44.74321705426356,1021.027131782945,24.310169804355834,0
2904,4,3,4,45,0.061224489795918366,0.08163265306122448,0.9183673469387755,49,1400,1200,200,0.8571428571428571,16,12,4,294.5339591725501,0.41388534580498865,-0.045641380509958474,0.16928645129438255,130601.15089101225,-2106.7051911157164,128494.44569989653,2775,0,754.8367346938776,43,6,13,36.93371317398556,0.6148255813953489,44.460227272727266,1022.1590909090896,23.771141649048595,0
2905,4,2,0,47,0.0425531914893617,0.0,1.0,47,850,700,150,0.8235294117647058,10,7,3,305.41523127408465,0.41177150786308975,-0.044991177795315807,0.1749258093248339,130465.21183704925,-1430.787430713056,129034.4244063362,2776,0,787.6170212765958,41,6,20,36.79274292742929,0.6163617886178864,44.593253968253954,1021.626984126981,24.91773132017027,0
2906,4,2,2,47,0.04081632653061224,0.04081632653061224,0.9591836734693877,49,1550,1100,450,0.7096774193548387,20,11,9,292.9290883684451,0.41877480158730157,-0.02885387533575212,0.16999113238389285,130972.46334876528,-2126.8711419753276,128845.59220678995,2777,0,756.4285714285714,44,5,17,36.60108548168248,0.6171875,44.097222222222214,1023.61111111111,23.26388888888886,0
2907,4,0,0,47,0.0,0.0,1.0,47,850,600,250,0.7058823529411765,11,6,5,305.97158508105724,0.4111547949429541,-0.042347581563643266,0.17657354185514226,130757.64607182531,-1398.3751539871685,129359.27091783813,2778,1,789.5957446808511,42,5,18,36.48369651034265,0.6178075396825398,44.307170542635646,1022.7713178294549,24.35169804355845,0
2908,4,0,0,47,0.0,0.0,1.0,47,1450,1000,450,0.6896551724137931,19,10,9,309.1042023197458,0.41101988899167435,-0.0470812410239676,0.17930080665038303,130955.93268320721,-1304.1941777837812,129651.73850542343,2779,2,790.5957446808511,42,5,18,36.20380889267568,0.6197916666666666,44.11337209302326,1023.5465116279075,24.3701550387597,0
2909,4,0,0,47,0.0,0.0,1.0,47,950,500,450,0.5263157894736842,14,5,9,311.4063881519983,0.41100061671292015,-0.05120159191795526,0.1807525870570172,130980.72907277213,-1242.3528483865127,129738.37622438562,2780,3,791.5957446808511,42,5,18,36.119919853590794,0.6200396825396826,44.08914728682171,1023.6434108527137,24.37246216315985,0
2910,4,0,1,46,0.0,0.02127659574468085,0.9787234042553191,47,1650,1200,450,0.7272727272727273,21,12,9,336.7084791746915,0.410827166204132,-0.08616866274684032,0.19247161538608815,130389.20899667732,-595.8958981674516,129793.31309850987,2781,4,792.5957446808511,41,6,19,36.07040229885057,0.6155995934959348,44.66765873015873,1021.3293650793647,24.910472319008896,4
2911,4,1,1,46,0.02127659574468085,0.02127659574468085,0.9787234042553191,47,950,700,250,0.7368421052631579,12,7,5,339.70151182256353,0.4108078939253777,-0.068680677596486,0.1952004838989332,130591.93244716869,-527.5446231733431,130064.38782399535,2782,0,793.2127659574468,41,6,19,35.788827687728485,0.6176321138211381,44.46924603174603,1022.1230158730159,24.929829655439413,0
2912,4,2,1,47,0.041666666666666664,0.020833333333333332,0.9791666666666666,48,1300,800,500,0.6153846153846154,18,8,10,335.6397870040846,0.4146073433806146,-0.056751649149385686,0.19444277512617333,130906.34694617218,-812.5243187007864,130093.8226274714,2783,0,777.4166666666666,42,6,20,35.57487453839599,0.6192956349206348,44.16182170542636,1023.3527131782952,24.365540789959407,0
2913,4,1,0,48,0.020833333333333332,0.0,1.0,48,850,600,250,0.7058823529411765,11,6,5,346.2191507891255,0.413563829787234,-0.027302112898139663,0.20173850186554898,131129.55670482558,-520.0872468601527,130609.46945796542,2784,0,778.3958333333334,42,6,21,35.07864238410597,0.6215277777777777,43.94379844961241,1024.2248062015515,24.38630490956075,0
2914,4,1,1,48,0.02040816326530612,0.02040816326530612,0.9795918367346939,49,1150,800,350,0.6956521739130435,15,8,7,340.0753519730315,0.41728670634920634,-0.02206736353077765,0.1991869918699189,131328.12500000026,-867.7083333333039,130460.41666666696,2785,0,763.4897959183673,43,6,22,35.03556910569108,0.6220930232558138,43.750000000000014,1025.000000000002,23.83720930232563,0
2915,4,0,0,48,0.0,0.0,1.0,48,1400,800,600,0.5714285714285714,20,8,12,346.0652873731658,0.4169160017730496,-0.014401906987772106,0.20283671787012064,131354.81906467018,-508.53135850693934,130846.28770616325,2786,1,778.6041666666666,39,9,22,34.8551341327101,0.6284722222222222,43.723958333333336,1025.104166666667,26.28472222222223,0
2916,4,0,1,47,0.0,0.020833333333333332,0.9791666666666666,48,850,400,450,0.47058823529411764,13,4,9,346.782595042482,0.41724844858156024,-0.014411680043347141,0.20354091132994326,131408.21533203125,-485.983615451388,130922.23171657986,2787,2,779.6041666666666,39,9,22,34.782861763012626,0.6290064102564104,43.671875,1025.3125,26.290064102564102,0
2917,4,0,0,47,0.0,0.0,1.0,47,550,200,350,0.36363636363636365,9,2,7,351.2439072033391,0.41342892383595437,-0.010774643671892736,0.20617050626485914,131410.26925131495,-168.58871630506053,131241.6805350099,2788,3,796.4042553191489,38,9,22,34.66643221840157,0.6307565789473684,43.669871794871796,1025.3205128205132,26.982118758434556,0
2918,4,0,0,47,0.0,0.0,1.0,47,1550,1300,250,0.8387096774193549,18,13,5,351.86305903897403,0.41352528522972554,-0.00810916801265571,0.2074242453008757,131574.63480029578,-140.7493014464268,131433.88549884935,2789,4,797.4042553191489,38,9,18,34.48466625013018,0.6324013157894738,43.50961538461538,1025.9615384615377,26.99898785425099,0
2919,4,0,0,47,0.0,0.0,1.0,47,1300,1000,300,0.7692307692307693,16,10,6,356.25841912200576,0.4136601911810052,-0.007963222137580273,0.2107716065840043,131711.6845642485,-15.320695448918201,131696.36386879958,2790,5,798.4042553191489,38,9,18,34.23362475714681,0.6337719298245614,43.37606837606837,1026.4957264957252,27.013045434098032,0
2920,4,0,0,47,0.0,0.0,1.0,47,1400,1200,200,0.8571428571428571,16,12,4,358.40509526885563,0.41352528522972554,-0.007768331103534365,0.21288399032234423,131862.5217013888,52.03993055555054,131914.56163194435,2791,6,799.4042553191489,39,8,18,34.02636916835699,0.6335470085470085,43.229166666666664,1027.0833333333326,26.335470085470067,0
2921,4,1,1,47,0.020833333333333332,0.020833333333333332,0.9791666666666666,48,2000,1300,700,0.65,27,13,14,355.1749176145093,0.41517989066193856,-0.006464299171062393,0.21326566320111007,132273.37599903846,-203.9629153897091,132069.41308364875,2792,0,783.7291666666666,42,6,20,33.69540473499121,0.6329365079365079,42.82945736434108,1028.682170542635,24.4924326319675,0
2922,4,0,1,46,0.0,0.02127659574468085,0.9787234042553191,47,1050,800,250,0.7619047619047619,13,8,5,353.3942876286821,0.4115016959605304,-0.0293655193725173,0.20944203223765676,131778.07113727287,-85.84174857813838,131692.22938869474,2793,1,801.2553191489362,37,10,20,34.240175138829564,0.6362612612612613,43.311403508771924,1026.7543859649113,27.750118539592197,1
2923,4,0,1,45,0.0,0.021739130434782608,0.9782608695652174,46,1300,900,400,0.6923076923076923,17,9,8,359.5246273422694,0.4108997584541063,-0.03001888700230837,0.21281990278260576,131732.4334469605,272.21080878175803,132004.64425574226,2794,2,799.4347826086956,36,10,20,34.12886682755593,0.6377314814814814,43.35585585585586,1026.5765765765768,28.516016016016025,0
2924,4,0,0,45,0.0,0.0,1.0,45,1550,1100,450,0.7096774193548387,20,11,9,360.0747345337023,0.4081860269360269,-0.018971734892787584,0.21379437362938605,131848.06428049688,495.031348916497,132343.09562941338,2795,3,817.3555555555556,36,9,20,33.99808114035086,0.6388888888888888,43.24324324324325,1027.0270270270282,28.52852852852856,0
2925,4,0,0,45,0.0,0.0,1.0,45,700,500,200,0.7142857142857143,9,5,4,361.7752696870758,0.4076809764309764,-0.012141586883968047,0.21513129140061985,131905.89871966577,544.0584165246511,132449.9571361904,2796,4,818.3555555555556,36,9,20,33.89607542205657,0.6394675925925926,43.186936936936945,1027.2522522522536,28.534784784784822,0
2926,4,0,1,44,0.0,0.022222222222222223,0.9777777777777777,45,1050,700,350,0.6666666666666666,14,7,7,362.1173803715515,0.40770202020202023,-0.007038051750380525,0.2158276352639067,131992.67415642014,559.3682787517416,132552.04243517187,2797,5,819.3555555555556,36,9,20,33.79977168949771,0.6403356481481481,43.102477477477485,1027.5900900900915,28.54416916916921,0
2927,4,1,0,45,0.022222222222222223,0.0,1.0,45,1400,1000,400,0.7142857142857143,18,10,8,358.923548629028,0.40993265993266,0.025043417419443825,0.21640048257341998,132427.78427479847,507.53285064891077,132935.3171254474,2798,0,815.4888888888889,35,10,21,33.443555792945766,0.6467261904761905,42.679398148148145,1029.282407407407,29.40806878306877,0
2928,4,0,0,45,0.0,0.0,1.0,45,950,500,450,0.5263157894736842,14,5,9,358.923548629028,0.41007996632996635,0.025043417419443825,0.21640048257341998,132427.78427479847,506.29005379800594,132934.07432859647,2799,1,816.4888888888889,35,10,21,33.443555792945766,0.6467261904761905,42.679398148148145,1029.282407407407,29.40806878306877,0
2929,4,0,0,45,0.0,0.0,1.0,45,950,600,350,0.631578947368421,13,6,7,358.58408596863535,0.40968013468013464,0.027837729816147405,0.21670951282452305,132517.14677640592,503.7079903977969,133020.8547668037,2800,2,817.4888888888889,35,10,21,33.36237260191847,0.6476190476190476,42.59259259259259,1029.6296296296289,29.417989417989396,0
2930,4,0,0,45,0.0,0.0,1.0,45,1250,700,550,0.56,18,7,11,360.51003661153896,0.409196127946128,0.03641448189762775,0.21856534917184572,132636.34366426605,563.3466220850396,133199.6902863511,2801,3,818.4888888888889,35,10,17,33.19288389513109,0.648809523809524,42.47685185185185,1030.0925925925922,29.43121693121692,0
2931,4,0,0,45,0.0,0.0,1.0,45,1000,700,300,0.7,13,7,6,360.9106441713326,0.40934343434343434,0.027174414069425668,0.21989118378837966,132821.51870046556,587.3399747999451,133408.8586752655,2802,4,819.4888888888889,37,8,18,32.99637893131937,0.6466779279279279,42.29714912280702,1030.8114035087722,27.859767662399246,0
2932,4,0,0,45,0.0,0.0,1.0,45,1300,1000,300,0.7692307692307693,16,10,6,363.74110284689147,0.40885942760942756,0.02161038470170018,0.2226228077085691,132991.11415291243,674.8669061634387,133665.98105907586,2803,5,820.4888888888889,37,8,18,32.75298093618229,0.648367117117117,42.13267543859649,1031.469298245614,27.87754860123281,0
2933,4,0,0,45,0.0,0.0,1.0,45,800,500,300,0.625,11,5,6,366.534702047506,0.4085437710437711,0.009530218774720378,0.22501357344873318,133104.2379025278,757.4644361726791,133861.70233870047,2804,6,821.4888888888889,37,8,19,32.56727499734355,0.6494932432432432,42.02302631578948,1031.9078947368428,27.88940256045521,0
2934,4,0,0,45,0.0,0.0,1.0,45,1300,900,400,0.6923076923076923,17,9,8,366.25039590330664,0.4089015151515152,0.01163155720776543,0.22552305280769358,133217.40974386354,758.1858119806153,133975.59555584416,2805,7,822.4888888888889,37,8,19,32.4609444149407,0.6506193693693694,41.91337719298246,1032.3464912280706,27.901256519677585,0
2935,4,0,0,45,0.0,0.0,1.0,45,1450,900,550,0.6206896551724138,20,9,11,343.82689950763154,0.4087121212121212,0.059938007647232006,0.19888502985653475,130848.09570312512,4.702137917450358,130852.79784104257,2806,8,823.4888888888889,39,6,15,35.42430258603135,0.6233974358974359,44.21875000000001,1023.1250000000009,26.233974358974383,6
2936,4,2,1,46,0.0425531914893617,0.02127659574468085,0.9787234042553191,47,1150,800,350,0.6956521739130435,15,8,7,327.8471809108335,0.41260021584952206,0.06971112264314128,0.19202477739063092,131328.12499999988,-786.2521701389035,130541.87282986098,2807,0,789.4042553191489,38,9,16,35.34891598915989,0.6299342105263158,43.74999999999999,1024.999999999999,26.97368421052629,0
2937,4,0,0,46,0.0,0.0,1.0,46,850,500,350,0.5882352941176471,12,5,7,336.2920755249869,0.41013486312399355,0.068930028160477,0.19657956129584556,131251.87119118488,-372.2071641156375,130879.66402706924,2808,1,807.5652173913044,41,5,16,35.20942249975797,0.6242378048780487,43.824404761904766,1024.7023809523814,24.99274099883857,0
2938,4,1,0,47,0.02127659574468085,0.0,1.0,47,1650,1200,450,0.7272727272727273,21,12,9,332.04394059754907,0.4126965772432933,0.08605004349685186,0.19648364639577287,131719.04047070196,-652.6538615272646,131066.3866091747,2809,0,791.3617021276596,40,7,16,34.847622347622334,0.6304687500000001,43.36890243902439,1026.5243902439024,25.663109756097562,0
2939,4,0,0,47,0.0,0.0,1.0,47,1400,800,600,0.5714285714285714,20,8,12,331.8187591502375,0.41285075547332717,0.07594814119271942,0.19702469917581045,131849.474725692,-649.9741803820764,131199.50054530994,2810,1,792.3617021276596,40,7,17,34.72215350616797,0.6317708333333335,43.24186991869917,1027.0325203252005,25.675813008130014,0
2940,4,1,0,48,0.020833333333333332,0.0,1.0,48,1600,1400,200,0.875,18,14,4,329.3379526289682,0.4153184101654846,0.052656870039682335,0.1844292534722222,129586.77685950411,-1063.292599109097,128523.48426039501,2811,0,776.8333333333334,43,5,13,37.071397569444436,0.6046511627906976,45.45454545454545,1018.181818181818,23.678646934460883,7
2941,4,0,0,48,0.0,0.0,1.0,48,1600,900,700,0.5625,23,9,14,332.09028560668037,0.4154015218676123,0.057422855283948415,0.18677257620712337,129755.56456790907,-981.8875007174149,128773.67706719165,2812,1,777.8333333333334,43,5,13,36.830115097437805,0.6063468992248062,45.28882575757575,1018.8446969696959,23.694062720225485,0
2942,4,0,0,48,0.0,0.0,1.0,48,1000,600,400,0.6,14,6,8,332.0085451783971,0.4153091755319149,0.057053098578463635,0.18718742649319478,129852.0640083362,-977.601028036039,128874.46298030016,2813,2,778.8333333333334,43,5,14,36.73435612747376,0.6073158914728682,45.19412878787879,1019.2234848484848,23.702871740662435,0
2943,4,0,1,47,0.0,0.020833333333333332,0.9791666666666666,48,1600,1300,300,0.8125,19,13,6,332.4740408825484,0.41483820921985815,0.06431428527218164,0.18837863726175322,130045.17049938308,-952.6713333620232,129092.49916602105,2814,3,779.8333333333334,43,5,15,36.526804227400724,0.6092538759689923,45.00473484848485,1019.981060606061,23.7204897815363,0
2944,4,0,3,44,0.0,0.06382978723404255,0.9361702127659575,47,1150,800,350,0.6956521739130435,15,8,7,339.2649781935333,0.41298566142460685,0.06623338555617342,0.19207982224243858,130015.40927716167,-578.0650013520974,129437.34427580958,2815,4,796.9574468085107,42,5,15,36.38380839271575,0.6103670634920635,45.03391472868216,1019.8643410852701,24.28248431155405,0
2945,4,0,0,44,0.0,0.0,1.0,44,1250,1000,250,0.8,15,10,5,363.96696451626167,0.41186575052854124,0.09723241405575123,0.2055478754599336,129917.22140842004,700.381973493075,130617.60338191311,2816,5,838.1590909090909,39,5,20,35.853789891352484,0.6140491452991453,45.13020833333333,1019.4791666666658,26.14049145299143,5
2946,4,0,0,44,0.0,0.0,1.0,44,1250,1000,250,0.8,15,10,5,365.27591930253436,0.4114032769556026,0.10210208118574671,0.20656764725895482,129970.32470703124,695.0059678819446,130665.33067491317,2817,6,839.1590909090909,39,5,20,35.76644277590493,0.6145833333333334,45.078125,1019.6874999999999,26.145833333333332,0
2947,4,1,2,43,0.022222222222222223,0.044444444444444446,0.9555555555555556,45,950,700,250,0.7368421052631579,12,7,5,359.1938907832099,0.413699494949495,0.09613719074308102,0.20452384849299618,130237.26974875582,356.0863292075936,130593.35607796341,2818,0,821.4888888888889,41,4,20,35.65043169080246,0.6140752032520326,44.816468253968246,1020.7341269841256,24.89595431668599,0
2948,4,1,0,44,0.022727272727272728,0.0,1.0,44,850,500,350,0.5882352941176471,12,5,7,361.2696782759092,0.4098947322057787,0.11823793490460144,0.20658238509147323,130402.5412266276,622.1066649606844,131024.64789158828,2819,0,838.9545454545455,37,7,22,35.42975040257649,0.622466216216216,44.654605263157904,1021.3815789473699,27.604907539118106,0
2949,4,0,0,44,0.0,0.0,1.0,44,1000,800,200,0.8,12,8,4,361.7071760614574,0.40971855179704014,0.11907607794159225,0.20713126978270466,130458.54403518411,637.5583112111658,131096.1023463953,2820,1,839.9545454545455,37,7,22,35.36177149296984,0.6230292792792791,44.5997807017544,1021.6008771929842,27.610834518729302,0
2950,4,0,0,44,0.0,0.0,1.0,44,850,600,250,0.7058823529411765,11,6,5,357.3598528415871,0.4090909090909091,0.12150431882322765,0.20533703976789588,130589.98243343207,533.5233809993583,131123.50581443144,2821,2,840.9545454545455,38,6,16,35.33957876032194,0.622532894736842,44.471153846153854,1022.1153846153857,26.897773279352254,0
2951,4,1,0,45,0.022222222222222223,0.0,1.0,45,1400,1100,300,0.7857142857142857,17,11,6,352.33649182863076,0.4111321548821549,0.13751229605508586,0.2045133316715867,130981.34901258718,229.90180121531682,131211.2508138025,2822,0,823.2444444444444,39,6,17,35.07184712187512,0.6247329059829059,44.088541666666686,1023.6458333333363,26.247329059829138,0
2952,4,1,1,45,0.021739130434782608,0.021739130434782608,0.9782608695652174,46,800,300,500,0.375,13,3,10,350.4430298385267,0.41430152979066026,0.131409206146629,0.20498071420485575,131276.04683059073,0.9551193073411639,131277.00194989805,2823,0,806.3260869565217,40,6,18,34.82249107497027,0.6260416666666664,43.800813008130106,1024.7967479674835,25.61991869918709,0
2953,4,0,0,45,0.0,0.0,1.0,45,1050,600,450,0.5714285714285714,15,6,9,355.1740265899765,0.41058501683501686,0.12780375415057188,0.20774090806136714,131274.74500868074,325.07595486113075,131599.82096354186,2824,2,825.2444444444444,39,6,19,34.70259876668701,0.6276709401709402,43.80208333333334,1024.7916666666683,26.276709401709443,0
2954,4,1,1,45,0.021739130434782608,0.021739130434782608,0.9782608695652174,46,1350,1200,150,0.8888888888888888,15,12,3,351.4410124477845,0.41259057971014496,0.13491661083244288,0.20732429260126056,131602.0390459493,50.09246988914515,131652.13151583844,2825,0,808.2826086956521,38,8,18,34.46784325975287,0.6326754385964912,43.48290598290598,1026.068376068376,27.00179937022042,0
2955,4,0,0,45,0.0,0.0,1.0,45,1250,900,350,0.72,16,9,7,353.5009138291939,0.41111111111111115,0.1429080287810791,0.20857891245987328,131609.2511638194,304.79811095719487,131914.0492747766,2826,1,820.0222222222222,37,8,18,34.407726009831165,0.6345720720720722,43.475877192982445,1026.0964912280683,27.732337600758605,0
2956,4,0,0,45,0.0,0.0,1.0,45,1200,800,400,0.6666666666666666,16,8,8,354.0006128718244,0.410753367003367,0.1342166724476821,0.20973772439569846,131766.52444480962,329.08608189055843,132095.61052670018,2827,2,821.0222222222222,38,7,18,34.23625563648975,0.6343201754385965,43.32264957264957,1026.709401709401,27.018668466036868,0
2957,4,0,0,45,0.0,0.0,1.0,45,1250,1000,250,0.8,15,10,5,356.2981469581259,0.41012205387205386,0.13565402306821084,0.21170892366226313,131876.23844875421,397.45187741979754,132273.69032617402,2828,3,822.0222222222222,38,7,19,34.06663892933914,0.6354166666666667,43.21581196581195,1027.1367521367501,27.02991452991448,0
2958,4,0,0,45,0.0,0.0,1.0,45,1350,800,550,0.5925925925925926,19,8,11,354.6137034011759,0.4094907407407407,0.14136835660902647,0.21147112293960965,132013.44515897767,362.7553373145963,132376.20049629227,2829,4,823.0222222222222,38,7,21,33.97161000797032,0.6367872807017545,43.08226495726494,1027.6709401709375,27.043972109761512,0
2959,4,0,0,45,0.0,0.0,1.0,45,1050,900,150,0.8571428571428571,12,9,3,350.19127372887937,0.40934343434343434,0.13743795738393705,0.20989671238569046,132205.65440317022,259.45330192122765,132465.10770509145,2830,5,824.0222222222222,38,7,21,33.89171687790011,0.6387061403508772,42.895299145299134,1028.4188034188019,27.063652721547417,0
2960,4,0,0,45,0.0,0.0,1.0,45,950,800,150,0.8421052631578947,11,8,3,350.60760443635564,0.4089646464646464,0.1369381844197508,0.2106051542805779,132288.07259706678,276.24084575204193,132564.31344281882,2831,6,825.0222222222222,38,7,21,33.79807525876691,0.63952850877193,42.81517094017093,1028.7393162393146,27.072087269455647,0
2961,4,2,3,44,0.0425531914893617,0.06382978723404255,0.9361702127659575,47,1400,800,600,0.5714285714285714,20,8,12,335.82182934169396,0.41427690410114093,0.12595321397628334,0.20499787950516682,132893.25741699536,-474.2173232157208,132419.04009377965,2832,0,790.8723404255319,38,9,15,33.57100300486997,0.6455592105263158,42.2275641025641,1031.0897435897432,27.133940620782717,0
2962,4,0,1,43,0.0,0.022727272727272728,0.9772727272727273,44,1250,1000,250,0.8,15,10,5,349.32303190038976,0.4066353946441155,0.1524370290243704,0.1933358960728167,129123.91067031863,221.1911932381598,129345.10186355679,2833,8,845.0227272727273,40,4,17,37.0335883078359,0.6044270833333333,45.90955284552846,1016.3617886178864,25.40904471544716,8
2963,4,0,0,43,0.0,0.0,1.0,43,1000,800,200,0.8,12,8,4,360.9060212355694,0.4029854189737911,0.16597267078376654,0.19973681504228286,129121.97401258661,720.1795789930306,129842.15359157964,2834,12,865.4883720930233,39,4,19,36.74124987188684,0.606036324786325,45.91145833333332,1016.354166666665,26.060363247863204,0
2964,4,3,2,44,0.06521739130434782,0.043478260869565216,0.9565217391304348,46,1000,600,400,0.6,14,6,8,343.28780189034364,0.4144726247987118,0.1660344608610984,0.1930758885768797,129756.71315980067,-291.19621770876006,129465.51694209191,2835,0,809.9782608695652,41,5,17,36.54373580006491,0.6092479674796749,45.2876984126984,1018.849206349204,24.84998064266351,0
2965,4,1,1,44,0.022222222222222223,0.022222222222222223,0.9777777777777777,45,1400,1000,400,0.7142857142857143,18,10,8,348.2563979386848,0.40803872053872053,0.1640706126687439,0.19612333989178543,129807.25623582743,41.24149659861564,129848.49773242604,2836,0,828.9555555555555,41,4,18,36.36584890965731,0.6097560975609757,45.23809523809523,1019.0476190476172,24.85481997677115,0
2966,4,0,0,44,0.0,0.0,1.0,44,1150,600,550,0.5217391304347826,17,6,11,354.6018743664536,0.4063711240310077,0.16410111085921608,0.19937654461714474,129744.3870732531,401.5205689404254,130145.90764219353,2837,2,848.7954545454545,40,4,18,36.26807980049877,0.6106770833333335,45.29979674796747,1018.8008130081281,25.4700203252032,0
2967,4,2,1,45,0.043478260869565216,0.021739130434782608,0.9782608695652174,46,1200,1000,200,0.8333333333333334,14,10,4,343.2699330200465,0.4123892914653784,0.1618164856620401,0.1953356134251832,130213.13252095695,-260.34934424015734,129952.7831767168,2838,0,812.8478260869565,42,4,19,36.08124465964113,0.6123511904761906,44.840116279069754,1020.6395348837183,24.3009413067552,0
2968,4,0,0,45,0.0,0.0,1.0,45,1000,700,300,0.7,13,7,6,350.28300127034055,0.40955387205387206,0.16450149098923927,0.19880300138323267,130110.72137188178,115.11479591833606,130225.83616780011,2839,1,831.9111111111112,41,4,20,36.0061746402178,0.6128048780487806,44.940476190476176,1020.2380952380928,24.883855981416897,0
2969,4,0,0,45,0.0,0.0,1.0,45,750,500,250,0.6666666666666666,10,5,5,350.0057787298809,0.40991161616161614,0.16898913301790985,0.1989038364649476,130161.33334120669,111.44376732172196,130272.7771085284,2840,2,832.9111111111112,41,4,20,35.96190615075505,0.6133130081300815,44.890873015873005,1020.4365079365066,24.88869531552455,0
2970,4,2,1,46,0.0425531914893617,0.02127659574468085,0.9787234042553191,47,1350,1100,250,0.8148148148148148,16,11,5,334.52422673972166,0.41394927536231885,0.1730367091978391,0.19273008412556186,130693.3532238123,-655.9026793588222,130037.45054445347,2841,0,798.4255319148937,41,6,14,35.81859820186926,0.6186483739837401,44.37003968253966,1022.5198412698383,24.939508323654593,0
2971,4,0,0,46,0.0,0.0,1.0,46,1150,700,450,0.6086956521739131,16,7,9,339.04358360630044,0.4118860708534622,0.170366576330087,0.19499367681508126,130625.94112507413,-342.4225618018643,130283.51856327226,2842,1,816.7826086956521,40,6,15,35.77124134274446,0.6195312500000001,44.435975609756085,1022.2560975609738,25.556402439024346,0
2972,4,1,1,46,0.02127659574468085,0.02127659574468085,0.9787234042553191,47,750,500,250,0.6666666666666666,10,5,5,332.31254401810355,0.4142383595436325,0.17211494479852885,0.19226784396093943,130856.7705985964,-702.9307320774409,130153.83986651896,2843,0,800.3829787234042,42,5,16,35.71005777062223,0.6187996031746034,44.21027131782944,1023.1589147286786,24.360926541159014,0
2973,4,0,0,46,0.0,0.0,1.0,46,850,500,350,0.5882352941176471,12,5,7,338.52342044313446,0.4107387278582931,0.17042061041656154,0.1951621598393635,130718.71456916051,-349.7307256236288,130368.98384353689,2844,1,818.6086956521739,41,5,17,35.69072564998059,0.6189024390243905,44.345238095238074,1022.6190476190437,24.941927990708383,0
2974,4,0,1,45,0.0,0.021739130434782608,0.9782608695652174,46,1200,700,500,0.5833333333333334,17,7,10,338.8487686711114,0.4101449275362319,0.1743115204108745,0.1957349946088414,130794.81336805511,-336.06770833337316,130458.74565972174,2845,2,819.6086956521739,41,5,18,35.60548200950443,0.6196646341463417,44.270833333333314,1022.9166666666631,24.949186991869833,0
2975,4,0,0,45,0.0,0.0,1.0,45,700,400,300,0.5714285714285714,10,4,6,346.3151685561926,0.40704966329966324,0.18079492871263092,0.19944344080388396,130677.89019639429,51.14711398637846,130729.03731038066,2846,3,838.6666666666666,40,5,18,35.53283305171786,0.6200520833333334,44.385162601626014,1022.4593495934955,25.56148373983739,0
2976,4,0,0,45,0.0,0.0,1.0,45,1450,1100,350,0.7586206896551724,18,11,7,349.72420648792513,0.40612373737373736,0.1882641234518847,0.20208518154462973,130807.80805902553,149.33137517349118,130957.13943419902,2847,4,839.6666666666666,40,5,18,35.31421782899531,0.6213541666666667,44.258130081300806,1022.9674796747953,25.574186991869883,0
2977,4,0,0,45,0.0,0.0,1.0,45,1100,700,400,0.6363636363636364,15,7,8,352.25630325355246,0.4057239057239057,0.1910215249506284,0.2042356493993396,130937.79047070211,224.7324054795607,131162.52287618167,2848,5,840.6666666666666,40,5,18,35.11795419190417,0.6226562499999999,44.13109756097562,1023.4756097560987,25.586890243902467,0
2978,4,1,1,45,0.021739130434782608,0.021739130434782608,0.9782608695652174,46,950,600,350,0.631578947368421,13,6,7,343.7235439775217,0.4075885668276973,0.1910130333748694,0.20079054084840758,131226.45817586302,-178.87534643485833,131047.58282942817,2849,0,823.3695652173913,41,5,19,35.04470049057578,0.6239837398373983,43.849206349206355,1024.6031746031754,24.990321331784767,0
2979,4,0,0,45,0.0,0.0,1.0,45,1000,800,200,0.8,12,8,4,343.38026307092315,0.4066287878787879,0.18229448961156258,0.20112272551296942,131328.12500000015,19.097222222237235,131347.2222222224,2850,1,816.7777777777778,41,4,20,34.95088075880759,0.6249999999999998,43.75000000000001,1025.0000000000011,25.00000000000003,0
2980,4,0,0,45,0.0,0.0,1.0,45,900,700,200,0.7777777777777778,11,7,4,344.77646633926344,0.4062289562289562,0.1892298313350942,0.2022222873486912,131381.51584201425,59.45095486114943,131440.9667968754,2851,2,817.7777777777778,39,6,20,34.86122400596086,0.6287393162393161,43.697916666666686,1025.2083333333362,26.287393162393236,0
2981,4,0,0,45,0.0,0.0,1.0,45,1150,900,250,0.782608695652174,14,9,5,343.475911020542,0.4060816498316498,0.18619008935824488,0.20230566816568782,131541.75347222234,36.28472222223246,131578.03819444455,2852,3,818.7777777777778,39,6,20,34.732940698619,0.6303418803418803,43.54166666666667,1025.8333333333344,26.30341880341883,0
2982,4,1,0,46,0.021739130434782608,0.0,1.0,46,1100,600,500,0.5454545454545454,16,6,10,342.4724464480535,0.40723631239935587,0.200588497023934,0.20410411969556627,131989.918942114,-159.4179106827806,131830.5010314312,2853,0,801.9565217391304,41,5,16,34.30721825320204,0.6316056910569106,43.105158730158735,1027.579365079366,25.06291134339917,0
2983,4,0,1,45,0.0,0.021739130434782608,0.9782608695652174,46,1450,1000,450,0.6896551724137931,19,10,9,344.35646553135757,0.40709541062801935,0.2107183164183617,0.20591841040400802,132117.3776947122,-100.90535635549452,132016.4723383567,2854,1,802.9565217391304,41,5,18,34.13054054488727,0.6328760162601625,42.9811507936508,1028.075396825397,25.075009678668224,0
2984,4,0,0,45,0.0,0.0,1.0,45,1400,1200,200,0.8571428571428571,16,12,4,346.9982497375097,0.4046296296296296,0.2068567034657003,0.20731761937949855,132084.41904826823,166.6124454689737,132251.03149373722,2855,2,821.6888888888889,40,5,18,34.09581479650685,0.6341145833333333,43.01321138211382,1027.9471544715448,25.69867886178862,0
2985,4,0,0,45,0.0,0.0,1.0,45,950,600,350,0.631578947368421,13,6,7,348.2945774174186,0.4041035353535354,0.2135537770751681,0.20895610065451664,132241.16478493303,211.7761211911034,132452.94090612413,2856,3,822.6888888888889,40,5,18,33.904752494812755,0.6356770833333333,42.86077235772358,1028.5569105691068,25.713922764227668,0
2986,4,0,0,45,0.0,0.0,1.0,45,1400,1200,200,0.8571428571428571,16,12,4,348.4464929126659,0.4039562289562289,0.21483456790123512,0.20962690081644333,132345.71358194522,223.07994993059566,132568.79353187582,2857,4,823.6888888888889,40,5,18,33.79567901234569,0.63671875,42.75914634146341,1028.963414634146,25.724085365853647,0
2987,4,1,1,45,0.021739130434782608,0.021739130434782608,0.9782608695652174,46,1400,1100,300,0.7857142857142857,17,11,6,342.7645290686105,0.40594806763285024,0.21299423103981985,0.20767497937686422,132612.50000000012,-109.0071220834011,132503.49287791672,2858,0,806.7608695652174,39,7,18,33.67381337648329,0.641025641025641,42.50000000000001,1030.000000000001,26.410256410256434,0
2988,4,0,0,45,0.0,0.0,1.0,45,800,500,300,0.625,11,5,6,349.6852626308333,0.40345117845117845,0.21973233737939624,0.21158921823594473,132562.98539201176,271.064472386582,132834.04986439834,2859,6,825.6888888888889,38,7,18,33.545362589480234,0.6422697368421053,42.54807692307692,1029.8076923076917,27.100202429149782,0
2989,4,0,0,45,0.0,0.0,1.0,45,1200,800,400,0.6666666666666666,16,8,8,346.9402474246597,0.40319865319865317,0.21664131987649204,0.21069847268031602,132700.54879830522,207.83224669442728,132908.38104499964,2860,7,826.6888888888889,38,7,16,33.4778532420849,0.643640350877193,42.414529914529915,1030.3418803418804,27.11426000899685,0
2990,4,0,0,45,0.0,0.0,1.0,45,850,500,350,0.5882352941176471,12,5,7,342.1939917850143,0.4022306397306397,0.2136188831318364,0.20873400889541016,132865.71905361972,93.1701548688759,132958.8892084886,2861,8,827.6888888888889,38,7,17,33.43436960276339,0.6452850877192982,42.254273504273506,1030.9829059829062,27.131129104813322,0
2991,4,1,0,46,0.021739130434782608,0.0,1.0,46,1150,800,350,0.6956521739130435,15,8,7,335.9791203474583,0.4041264090177134,0.21820328479007034,0.20620874635451816,133095.75195312497,-256.5212673611113,132839.23068576385,2862,0,810.6739130434783,39,7,18,33.36403862978668,0.6458333333333334,42.03125,1031.8749999999998,26.45833333333333,0
2992,4,0,0,46,0.0,0.0,1.0,46,1000,800,200,0.8,12,8,4,337.6867360944187,0.4034017713365539,0.22151454539074322,0.20815615224924608,133257.03124999997,-200.17361111111177,133056.85763888885,2863,1,811.6739130434783,39,7,20,33.158461124562834,0.6474358974358975,41.875,1032.4999999999998,26.474358974358967,0
2993,4,0,0,46,0.0,0.0,1.0,46,1550,800,750,0.5161290322580645,23,8,15,340.51499979797154,0.4023248792270531,0.21929681986355543,0.21067163560233643,133393.47367844894,-115.50426746642623,133277.9694109825,2864,2,812.6739130434783,40,6,20,32.948844072798835,0.6471354166666665,41.7428861788618,1033.0284552845549,25.825711382113873,0
2994,4,0,0,46,0.0,0.0,1.0,46,850,500,350,0.5882352941176471,12,5,7,341.7908644911066,0.40220410628019326,0.22507154345415747,0.2120642380623058,133499.13330078137,-74.21992640632763,133424.91337437503,2865,3,813.6739130434783,39,7,20,32.81013758693681,0.6498397435897435,41.64062500000001,1033.437500000001,26.49839743589746,0
2995,4,0,0,46,0.0,0.0,1.0,46,1300,1000,300,0.7692307692307693,16,10,6,339.5398828766441,0.40245571658615137,0.2195711325028804,0.2109739673002471,133552.9635959204,-130.6884765624739,133422.27511935792,2866,4,814.6739130434783,39,7,20,32.81444203701836,0.6503739316239315,41.58854166666668,1033.6458333333353,26.50373931623937,0
2996,4,0,0,46,0.0,0.0,1.0,46,1450,1100,350,0.7586206896551724,18,11,7,341.82956230347577,0.4022745571658615,0.21205584081608198,0.2134442506211522,133734.88519565092,-57.092545773000495,133677.79264987793,2867,5,815.6739130434783,40,6,14,32.573319905678915,0.6505208333333332,41.41260162601627,1034.3495934959365,25.85873983739841,0
2997,4,0,0,46,0.0,0.0,1.0,46,600,400,200,0.6666666666666666,8,4,4,343.77056620282144,0.4022342995169082,0.214219813170337,0.21480912175436007,133761.16569378373,-3.369666699693255,133757.79602708403,2868,6,816.6739130434783,40,6,14,32.49684808592854,0.6507812499999999,41.38719512195123,1034.4512195121972,25.86128048780493,0
2998,4,0,0,46,0.0,0.0,1.0,46,1300,1000,300,0.7692307692307693,16,10,6,341.1687916047016,0.4018921095008052,0.21573445373947964,0.21373763755126987,133856.92362882657,-66.43902352608302,133790.48460530047,2869,7,817.6739130434783,41,5,14,32.468423449333685,0.6501524390243902,41.294642857142854,1034.8214285714287,25.23954703832753,0
2999,4,0,0,46,0.0,0.0,1.0,46,1300,800,500,0.6153846153846154,18,8,10,341.43905262924415,0.4008252818035427,0.22148249370906758,0.2146540935686017,133985.2804547744,-50.438555051656806,133934.84189972273,2870,8,818.6739130434783,41,5,15,32.333189600102216,0.6514227642276422,41.17063492063492,1035.3174603174596,25.251645373596574,0
3000,4,0,0,46,0.0,0.0,1.0,46,850,600,250,0.7058823529411765,11,6,5,344.67312825222467,0.4003824476650564,0.23236011758533692,0.21759835581679143,134139.3898415848,46.84862370874828,134186.23846529354,2871,9,819.6739130434783,41,5,16,32.0955436378727,0.6529471544715446,41.0218253968254,1035.9126984126988,25.266163375919483,0
3001,4,0,0,46,0.0,0.0,1.0,46,1600,1300,300,0.8125,19,13,6,342.13864091490194,0.4008957326892109,0.23062626178533518,0.21645294393435213,134216.47775140154,-15.871342750052179,134200.60640865148,2872,10,820.6739130434783,41,5,16,32.08423089197384,0.6537093495934958,40.94742063492064,1036.210317460318,25.273422377080927,0
3002,4,0,1,45,0.0,0.021739130434782608,0.9782608695652174,46,1350,800,550,0.5925925925925926,19,8,11,343.9718014274248,0.40079508856682766,0.2296077346457377,0.21853187214091294,134370.72000385812,43.94772376543946,134414.66772762357,2873,11,821.6739130434783,41,5,17,31.88281424425095,0.6552337398373983,40.798611111111114,1036.805555555556,25.287940379403807,0
3003,4,0,0,45,0.0,0.0,1.0,45,900,600,300,0.6666666666666666,12,6,6,354.8752067005954,0.39859006734006736,0.23463129927261672,0.22575726989855815,134419.017284685,540.3953086786928,134959.41259336367,2874,21,840.6888888888889,40,5,17,31.551964915719328,0.6572916666666667,40.7520325203252,1036.9918699186987,25.92479674796747,0
3004,4,0,0,45,0.0,0.0,1.0,45,1300,800,500,0.6153846153846154,18,8,10,359.7421854013445,0.3973695286195286,0.24215884782136277,0.23003132632016132,134606.20896568376,684.8354544707597,135291.04442015453,2875,22,841.6888888888889,38,7,17,31.2388465630255,0.6625548245614037,40.57158119658118,1037.7136752136723,27.308254610886113,0
3005,4,0,0,45,0.0,0.0,1.0,45,1300,900,400,0.6923076923076923,17,9,8,359.2203850786801,0.3968855218855219,0.23717121815104525,0.2302233022047792,134689.37194097432,676.6336109284621,135366.00555190278,2876,23,842.6888888888889,38,7,17,31.169376972691087,0.6633771929824562,40.49145299145298,1038.0341880341866,27.316689158794386,0
3006,4,0,0,45,0.0,0.0,1.0,45,1300,800,500,0.6153846153846154,18,8,10,364.4197399122356,0.3961700336700336,0.23985549496404523,0.23409090893635273,134772.56059838188,822.756296113662,135595.31689449554,2877,24,843.6888888888889,38,7,18,30.95140103577185,0.6641995614035088,40.41132478632478,1038.3547008547005,27.325123706702644,0
3007,4,0,0,45,0.0,0.0,1.0,45,1400,900,500,0.6428571428571429,19,9,10,360.09648363412884,0.39640151515151517,0.2327426449585832,0.23237812231863983,134939.01495954779,718.212958397251,135657.22791794504,2878,25,844.6888888888889,38,7,14,30.897600685518427,0.6658442982456141,40.251068376068375,1038.9957264957263,27.341992802519115,0
3008,4,0,0,45,0.0,0.0,1.0,45,1000,500,500,0.5,15,5,10,360.2584980216097,0.39619107744107745,0.2347659195284122,0.23266096625220278,134966.76734056536,724.5849769888168,135691.35231755418,2879,26,845.6888888888889,38,7,15,30.86572074850915,0.6661184210526316,40.22435897435897,1039.1025641025635,27.344804318488514,0
3009,4,0,1,44,0.0,0.022222222222222223,0.9777777777777777,45,1350,800,550,0.5925925925925926,19,8,11,359.48457975708686,0.39566498316498316,0.22788574990538524,0.23331437419604972,135145.83875868074,716.5690104166863,135862.40776909742,2880,27,846.6888888888889,39,6,15,30.70735657516865,0.6661324786324785,40.05208333333334,1039.791666666668,26.661324786324823,0
3010,4,0,0,44,0.0,0.0,1.0,44,700,400,300,0.5714285714285714,10,4,6,364.0441332958104,0.39569018675123324,0.21636559782557852,0.2363736857483742,135161.11390760855,1040.922113558352,136202.03602116692,2881,28,831.9545454545455,38,6,15,30.573606972841535,0.6680372807017543,40.03739316239317,1039.8504273504293,27.364484930274454,0
3011,4,0,0,44,0.0,0.0,1.0,44,1000,600,400,0.6,14,6,8,366.79020230246346,0.3957342318534179,0.22013587337162055,0.23852388907244387,135216.66718030913,1119.2297419461006,136335.89692225523,2882,29,832.9545454545455,38,6,15,30.446841294298927,0.6685855263157894,39.983974358974365,1040.0641025641035,27.37010796221325,0
3012,4,0,0,44,0.0,0.0,1.0,44,500,300,200,0.6,7,3,4,366.79020230246346,0.3957342318534179,0.22013587337162055,0.23852388907244387,135216.66718030913,1119.2297419461006,136335.89692225523,2883,30,833.9545454545455,38,6,15,30.446841294298927,0.6685855263157894,39.983974358974365,1040.0641025641035,27.37010796221325,0
3013,4,0,1,43,0.0,0.022727272727272728,0.9772727272727273,44,1050,500,550,0.47619047619047616,16,5,11,368.6463119285196,0.3955580514446793,0.22457737867430838,0.2404719646263802,135327.80796853322,1177.6194617941505,136505.42743032737,2884,31,834.9545454545455,38,6,15,30.2878033336756,0.6696820175438596,39.87713675213676,1040.4914529914538,27.38135402609089,0
3014,4,0,0,43,0.0,0.0,1.0,43,1250,1000,250,0.8,15,10,5,372.78205682370793,0.39530269472129936,0.22757755206086538,0.24292281285325137,135291.24345952593,1486.829601415815,136778.07306094174,2885,32,850.9069767441861,37,6,15,30.216677206295675,0.6711711711711712,39.91228070175438,1040.350877192982,28.117591275485996,0
3015,4,0,1,42,0.0,0.023255813953488372,0.9767441860465116,43,1150,900,250,0.782608695652174,14,9,5,370.1994556968069,0.39553340716131413,0.22102090327639856,0.2416226158571319,135348.2862515389,1421.1723799630645,136769.45863150197,2886,33,851.9069767441861,37,6,15,30.2269933263084,0.6717342342342343,39.85745614035088,1040.5701754385964,28.1235182550972,0
3016,4,0,0,42,0.0,0.0,1.0,42,1100,700,400,0.6363636363636364,15,7,8,380.8539340293704,0.3933531746031746,0.23097145331395152,0.24811908621744194,135281.99440995065,1904.5359548738136,137186.53036482446,2887,34,871.4047619047619,36,6,15,30.015966659450104,0.6730324074074073,39.92117117117118,1040.3153153153166,28.897647647647684,0
3017,4,0,0,42,0.0,0.0,1.0,42,1150,800,350,0.6956521739130435,15,8,7,378.21632443223996,0.3932805845915602,0.229258868984896,0.24685508382819532,135348.28625153904,1838.186268851968,137186.47252039102,2888,35,872.4047619047619,37,5,15,30.018440463645938,0.6717342342342342,39.857456140350884,1040.5701754385975,28.12351825509723,0
3018,4,0,0,42,0.0,0.0,1.0,42,900,400,500,0.4444444444444444,14,4,10,376.47140373468375,0.3933531746031746,0.22883124178679237,0.24649789703841998,135462.40790435523,1799.5445714065938,137261.95247576182,2889,36,873.4047619047619,37,5,16,29.95005617583035,0.6728603603603602,39.74780701754386,1041.0087719298251,28.1353722143196,0
3019,4,0,0,42,0.0,0.0,1.0,42,950,700,250,0.7368421052631579,12,7,5,348.70729565636293,0.3934741579558653,0.19279406155561407,0.22728993608444878,135300.01849112439,1036.0207100591858,136336.03920118356,2890,37,874.4047619047619,38,4,18,30.834103512014785,0.669407894736842,39.90384615384616,1040.3846153846164,27.378542510121484,3
3020,4,0,0,42,0.0,0.0,1.0,42,1250,1000,250,0.8,15,10,5,348.70729565636293,0.39336527293844364,0.19279406155561407,0.22728993608444878,135300.01849112439,1036.0207100591858,136336.03920118356,2891,38,875.4047619047619,38,4,18,30.834103512014785,0.669407894736842,39.90384615384616,1040.3846153846164,27.378542510121484,0
3021,4,0,0,42,0.0,0.0,1.0,42,650,300,350,0.46153846153846156,10,3,7,346.88323516142486,0.39301442121564073,0.19088197907499738,0.22645058381181507,135355.60029951073,990.5177058222125,136346.11800533294,2892,39,876.4047619047619,38,4,18,30.82627481177277,0.6699561403508771,39.85042735042736,1040.598290598292,27.384165542060313,0
3022,4,0,0,42,0.0,0.0,1.0,42,1300,1000,300,0.7692307692307693,16,10,6,342.1820822981933,0.39213124274099886,0.1857240587358595,0.22424777350342273,135494.6047579262,872.7651992475837,136367.36995717377,2893,40,877.4047619047619,38,4,18,30.810458354711805,0.6713267543859648,39.71688034188035,1041.1324786324797,27.39822312190736,0
3023,4,0,0,42,0.0,0.0,1.0,42,1150,900,250,0.782608695652174,14,9,5,343.07744554488556,0.39103029423151375,0.1805728548471397,0.22553351426952728,135605.8596888926,904.6623885966931,136510.5220774893,2894,41,878.4047619047619,38,4,18,30.676650596642393,0.672423245614035,39.61004273504274,1041.5598290598296,27.40946918578499,0
3024,4,0,0,42,0.0,0.0,1.0,42,1350,800,550,0.5925925925925926,19,8,11,338.9693619067612,0.39012291908633373,0.16876104552955118,0.22370143139638357,135744.9925578932,802.6787018774216,136547.6712597706,2895,42,879.4047619047619,38,4,18,30.64554712596541,0.6737938596491228,39.47649572649573,1042.094017094017,27.42352676563203,0
3025,4,0,0,42,0.0,0.0,1.0,42,1200,700,500,0.5833333333333334,17,7,10,338.48410439823954,0.39002613240418116,0.16704738475956193,0.22372973729737305,135800.66568047344,793.2733399079634,136593.9390203814,2896,43,880.4047619047619,38,4,19,30.602962279622798,0.6743421052631577,39.42307692307693,1042.3076923076928,27.429149797570865,0
3026,4,0,0,42,0.0,0.0,1.0,42,650,300,350,0.46153846153846156,10,3,7,338.7083205001343,0.39003823073945026,0.1647632713021665,0.22405268360134314,135828.50652211634,801.2490640295164,136629.75558614585,2897,44,881.4047619047619,38,4,19,30.569505654060336,0.6746162280701754,39.39636752136752,1042.4145299145302,27.43196131354027,0
3027,4,0,0,42,0.0,0.0,1.0,42,750,400,350,0.5333333333333333,11,4,7,340.52141345042736,0.38974787069299266,0.16742794678847162,0.22542794792735918,135856.3502173279,852.3992804441657,136708.74949777208,2898,45,882.4047619047619,38,4,19,30.4946368791419,0.6748903508771928,39.369658119658126,1042.5213675213686,27.4347728295097,0
3028,4,0,0,42,0.0,0.0,1.0,42,1350,1100,250,0.8148148148148148,16,11,5,338.2795420575492,0.38909456058846303,0.15886754169044437,0.22482118237630075,135995.61149691377,800.9066358024907,136796.51813271627,2899,46,883.4047619047619,38,4,15,30.415002219263204,0.6762609649122806,39.23611111111112,1043.0555555555572,27.44883040935677,0
3029,4,0,0,42,0.0,0.0,1.0,42,850,500,350,0.5882352941176471,12,5,7,339.84602579301145,0.38861062717770034,0.1634342075112014,0.22657174975565492,136107.07188481634,851.0894924757135,136958.16137729204,2900,47,884.4047619047619,38,4,15,30.263685539742678,0.6773574561403508,39.129273504273506,1043.4829059829065,27.46007647323438,0
3030,4,0,0,42,0.0,0.0,1.0,42,1150,800,350,0.6956521739130435,15,8,7,338.30192691893063,0.38833236546651184,0.16324511380806173,0.22607454350191197,136190.6971382132,814.7150540580079,137005.4121922712,2901,48,885.4047619047619,38,4,15,30.22112760150119,0.6781798245614035,39.0491452991453,1043.8034188034192,27.46851102114261,0
3031,4,0,0,42,0.0,0.0,1.0,42,850,700,150,0.8235294117647058,10,7,3,337.00277167586745,0.3881508904374758,0.16400627579385363,0.2257387311575225,136274.34807372713,784.9666018335954,137059.31467556072,2902,49,886.4047619047619,38,4,17,30.17220062075787,0.6790021929824561,38.9690170940171,1044.123931623932,27.476945569050844,0
3032,4,0,1,41,0.0,0.023809523809523808,0.9761904761904762,42,1500,1000,500,0.6666666666666666,20,10,10,335.77370241264344,0.38674748354626404,0.15945003627793275,0.22598286551226723,136441.7269911061,762.7087670757642,137204.43575818185,2903,50,887.4047619047619,38,4,17,30.038645737464634,0.6806469298245613,38.80876068376069,1044.764957264958,27.493814664867315,0
3033,4,0,0,41,0.0,0.0,1.0,41,1000,700,300,0.7,13,7,6,343.34003242239794,0.38597560975609757,0.16684504027488312,0.23065283137205664,136377.11242882424,1164.744440597107,137541.85686942135,2904,51,908.0,37,4,17,29.904996850724338,0.6818693693693694,38.87061403508772,1044.517543859649,28.230203888098625,0
3034,4,0,0,41,0.0,0.0,1.0,41,1500,1200,300,0.8,18,12,6,344.7309805212634,0.3861788617886179,0.1722253946800789,0.2323786161597848,136497.54279211417,1210.9863530937262,137708.5291452079,2905,52,909.0,38,3,18,29.74942916538868,0.6811951754385964,38.75534188034188,1044.9786324786328,27.499437696806126,0
3035,4,0,0,41,0.0,0.0,1.0,41,1100,900,200,0.8181818181818182,13,9,4,345.3666188928076,0.3852388211382114,0.1697770355322359,0.2335461206541896,136609.20863695312,1236.05209931333,137845.26073626644,2906,53,910.0,38,3,19,29.622296031340497,0.6822916666666665,38.64850427350428,1045.4059829059836,27.51068376068378,0
3036,4,1,2,40,0.023809523809523808,0.047619047619047616,0.9523809523809523,42,900,800,100,0.8888888888888888,10,8,2,339.37139601011495,0.3875701703445606,0.16037999441184736,0.2313543288228955,136892.986303478,891.6040873548583,137784.59039083286,2907,0,889.3095238095239,37,5,20,29.498463257893274,0.6869369369369369,38.377192982456144,1046.4912280701758,28.283546704599345,0
3037,4,0,0,40,0.0,0.0,1.0,40,1050,500,550,0.47619047619047616,16,5,11,353.16899731750266,0.38425480769230774,0.16464143426294786,0.23958221169376553,136720.920138889,1657.1180555555657,138378.03819444455,2908,55,904.2,37,3,20,29.30776892430278,0.6852477477477477,38.54166666666667,1045.8333333333342,28.26576576576579,0
3038,4,0,0,40,0.0,0.0,1.0,40,1200,1100,100,0.9166666666666666,13,11,2,351.59948813600096,0.3841346153846154,0.16690908085388823,0.2395486791437516,136872.26890700014,1624.8439375428668,138497.112844543,2909,56,905.2,35,5,22,29.199042325701445,0.6907738095238095,38.39699074074074,1046.412037037037,29.89748677248677,0
3039,4,0,0,40,0.0,0.0,1.0,40,950,600,350,0.631578947368421,13,6,7,351.669965542027,0.384241452991453,0.16709886099745663,0.24001143384124915,136932.8318571031,1631.0328521519282,138563.86470925502,2910,57,906.2,35,5,22,29.137293118065536,0.6913690476190476,38.339120370370374,1046.643518518519,29.904100529100543,0
3040,4,0,0,40,0.0,0.0,1.0,40,1550,1200,350,0.7741935483870968,19,12,7,351.0687692628681,0.38297275641025647,0.17105946722670495,0.24043294137177645,137053.99794506593,1623.075676225988,138677.07362129193,2911,58,907.2,35,5,16,29.03322003610774,0.6925595238095238,38.223379629629626,1047.1064814814808,29.917328042328023,0
3041,4,0,0,40,0.0,0.0,1.0,40,950,500,450,0.5263157894736842,14,5,9,351.85521118322805,0.3816239316239316,0.1717300044189134,0.24202077292025673,137205.5309070644,1655.296210562412,138860.82711762682,2912,59,908.2,35,5,17,28.8628664015319,0.694047619047619,38.0787037037037,1047.6851851851848,29.933862433862423,0
3042,4,0,0,40,0.0,0.0,1.0,40,600,400,200,0.6666666666666666,8,4,4,353.86168518602665,0.38125000000000003,0.17797625621203772,0.24403789484839844,137296.4908720208,1716.7935260202426,139013.28439804105,2913,60,909.2,35,5,18,28.720435302779315,0.694940476190476,37.99189814814815,1048.0324074074078,29.94378306878308,0
3043,4,1,1,40,0.024390243902439025,0.024390243902439025,0.975609756097561,41,1050,700,350,0.6666666666666666,14,7,7,344.47356504783113,0.38447662601626015,0.17352200566435783,0.23989571592792897,137635.1922023375,1282.3370667965278,138917.52926913401,2914,0,888.0,36,5,18,28.63230664663376,0.6961805555555556,37.66891891891892,1049.3243243243244,29.1478978978979,0
3044,4,0,0,40,0.0,0.0,1.0,40,1150,900,250,0.782608695652174,14,9,5,352.4373894299942,0.3794738247863248,0.17762577228596665,0.24497641854244392,137569.55161179713,1696.9307270233344,139266.48233882047,2915,62,911.2,35,5,19,28.488158281847603,0.6976190476190476,37.73148148148149,1049.074074074075,29.973544973545,0
3045,4,0,0,40,0.0,0.0,1.0,40,1150,800,350,0.6956521739130435,15,8,7,352.09757041021186,0.37804487179487184,0.1775804721030041,0.24562495181311186,137694.28211995773,1696.364438763078,139390.64655872082,2916,63,912.2,36,4,19,28.374016452074375,0.6967592592592593,37.61261261261261,1049.549549549549,29.154154154154142,0
3046,4,0,0,40,0.0,0.0,1.0,40,1200,800,400,0.6666666666666666,16,8,8,351.15006734497126,0.3775507478632478,0.17892249033740737,0.24519034242840318,137726.16484158582,1672.510411857489,139398.6752534433,2917,64,913.2,37,3,19,28.367435321564116,0.6951013513513513,37.58223684210526,1049.6710526315785,28.36948790896158,0
3047,4,0,0,40,0.0,0.0,1.0,40,1200,900,300,0.75,15,9,6,352.4187452758881,0.3768963675213675,0.18253968253968278,0.2466931216931217,137812.5,1713.5957698522625,139526.09576985225,2918,65,914.2,35,5,19,28.24900793650793,0.7,37.5,1050.0,30.0,0
3048,4,0,0,40,0.0,0.0,1.0,40,1150,900,250,0.782608695652174,14,9,5,350.98622649059587,0.37658920940170937,0.18451068988318298,0.2461243446039926,137873.27058684838,1678.3237954389508,139551.59438228732,2919,66,915.2,35,5,20,28.2267100139593,0.700595238095238,37.442129629629626,1050.231481481481,30.006613756613746,0
3049,4,0,0,40,0.0,0.0,1.0,40,1150,800,350,0.6956521739130435,15,8,7,349.2752173386936,0.376428952991453,0.181311962987442,0.2457922808527644,137994.8519483024,1639.636381172833,139634.48832947525,2920,67,916.2,35,5,21,28.151850627891605,0.7017857142857142,37.326388888888886,1050.6944444444441,30.019841269841262,0
3050,4,0,0,40,0.0,0.0,1.0,40,700,600,100,0.8571428571428571,8,6,2,353.08585466185906,0.3754273504273504,0.18119425173439097,0.249135403743927,138086.07313368045,1751.2478298611004,139837.32096354154,2921,68,917.2,35,5,16,27.96188470432772,0.7026785714285715,37.23958333333333,1051.0416666666658,30.02976190476188,0
3051,4,0,0,40,0.0,0.0,1.0,40,900,800,100,0.8888888888888888,10,8,2,350.55173769097223,0.3751869658119658,0.1760293955741501,0.24778688198031895,138146.90400216464,1685.5274509173357,139832.43145308198,2922,69,918.2,35,5,16,27.968572241183168,0.7032738095238096,37.181712962962955,1051.273148148147,30.036375661375626,0
3052,4,0,0,40,0.0,0.0,1.0,40,1050,700,350,0.6666666666666666,14,7,7,351.8467231072645,0.37442574786324784,0.17777808339751378,0.25003400049428676,138329.47698313193,1734.1546371313511,140063.63162026327,2923,70,919.2,35,5,17,27.754818095133306,0.7050595238095239,37.008101851851855,1051.967592592593,30.056216931216944,0
3053,4,0,0,40,0.0,0.0,1.0,40,1250,800,450,0.64,17,8,9,352.4244850936019,0.373571047008547,0.17181623226657905,0.25134085042793103,138451.25928337182,1758.7227527006087,140209.98203607244,2924,71,920.2,35,5,18,27.61980369515013,0.70625,36.89236111111111,1052.4305555555547,30.06944444444442,0
3054,4,0,0,40,0.0,0.0,1.0,40,1100,900,200,0.8181818181818182,13,9,4,350.9358336851771,0.3739182692307692,0.17279549202858724,0.2507275261089304,138512.1705273704,1721.7768079132215,140233.94733528362,2925,72,921.2,35,5,19,27.59907000183251,0.7068452380952381,36.83449074074073,1052.662037037036,30.076058201058174,0
3055,4,0,0,40,0.0,0.0,1.0,40,1350,1100,250,0.8148148148148148,16,11,5,352.70905927933285,0.3730235042735042,0.1728786546493737,0.2526729938049895,138603.56251071655,1777.3464291837943,140380.90893990034,2926,73,922.2,35,5,20,27.462537554041184,0.7077380952380954,36.747685185185176,1053.0092592592578,30.085978835978793,0
3056,4,0,0,40,0.0,0.0,1.0,40,1250,700,550,0.56,18,7,11,358.4077198485389,0.3729166666666666,0.17087556609877042,0.24051180852933077,136338.42245962183,1780.0350654865351,138118.45752510836,2927,74,923.2,36,4,18,29.549906548774356,0.6834490740740741,38.90765765765766,1044.3693693693697,29.010260260260267,4
3057,4,0,0,40,0.0,0.0,1.0,40,1100,700,400,0.6363636363636364,15,7,8,377.09644609439874,0.37246260683760685,0.23031804563263458,0.23341247925871536,133410.72137188193,2070.739375613875,135481.4607474958,2928,75,924.2,34,6,21,31.986776907121456,0.6587009803921569,41.72619047619047,1033.095238095237,30.385154061624615,6
3058,4,0,0,40,0.0,0.0,1.0,40,750,600,150,0.8,9,6,3,375.53235450611976,0.37236912393162397,0.22654971770941357,0.23263706672081452,133441.47002551006,2022.31788548751,135463.78791099758,2929,76,925.2,34,6,21,31.996293735837448,0.6590073529411765,41.69642857142856,1033.2142857142846,30.388655462184843,0
3059,4,0,0,40,0.0,0.0,1.0,40,850,600,250,0.7058823529411765,11,6,5,376.312579928096,0.3730902777777778,0.228754895185441,0.2337014176634999,133533.73724489793,2050.0850340135994,135583.82227891154,2930,77,926.2,34,6,21,31.883494586500813,0.6599264705882353,41.607142857142854,1033.5714285714282,30.399159663865536,0
3060,4,0,1,39,0.0,0.025,0.975,40,1450,1000,450,0.6896551724137931,19,10,9,376.313649105135,0.37275641025641026,0.22006790976058888,0.23487162237251527,133718.36734693873,2064.009353741487,135782.3767006802,2931,78,927.2,34,6,17,31.6981756445672,0.661764705882353,41.42857142857142,1034.285714285714,30.420168067226882,0
3061,4,0,0,39,0.0,0.0,1.0,39,500,300,200,0.6,7,3,4,375.2643476026968,0.37128879892037786,0.2142751763004931,0.2346077108393837,133779.93905895684,2240.568310657586,136020.5073696144,2932,79,940.7948717948718,34,5,17,31.663550057537396,0.6623774509803921,41.36904761904761,1034.5238095238087,30.427170868347314,0
3062,4,0,1,38,0.0,0.02564102564102564,0.9743589743589743,39,550,400,150,0.7272727272727273,7,4,3,377.9975105682285,0.3709514170040486,0.22015355709132334,0.23690932655873156,133872.32320011323,2320.6809807256104,136193.00418083885,2933,80,941.7948717948718,34,5,17,31.500201311399973,0.663296568627451,41.2797619047619,1034.8809523809514,30.437675070027982,0
3063,4,1,0,39,0.02564102564102564,0.0,1.0,39,1050,800,250,0.7619047619047619,13,8,5,374.9836051077799,0.3734817813765183,0.22930773355963052,0.2368002417741579,134149.66695011317,2260.785147392271,136410.45209750545,2934,0,939.9230769230769,34,5,18,31.300275798666977,0.6660539215686276,41.01190476190475,1035.9523809523794,30.469187675069982,0
3064,4,0,0,39,0.0,0.0,1.0,39,1200,1000,200,0.8333333333333334,14,10,4,374.26282847463943,0.3726664417453891,0.2316292330075933,0.23714208040030607,134273.02295918346,2250.6802721088206,136523.70323129228,2935,1,940.9230769230769,34,5,19,31.19543992648748,0.667279411764706,40.89285714285713,1036.4285714285697,30.483193277310875,0
3065,4,0,0,39,0.0,0.0,1.0,39,1100,900,200,0.8181818181818182,13,9,4,375.55415937519524,0.3724696356275304,0.2363804923272097,0.22815457890365912,132713.49961553255,2168.5083469662445,134882.00796249878,2936,2,941.9230769230769,33,6,17,32.72775927687917,0.654040404040404,42.40196078431373,1030.3921568627454,31.224004753416526,2
3066,4,0,0,39,0.0,0.0,1.0,39,1150,800,350,0.6956521739130435,15,8,7,376.0917582584877,0.3721884840305893,0.2397919201344103,0.22867357882831688,132745.06987997398,2184.8653462610455,134929.93522623501,2937,3,942.9230769230769,33,6,17,32.682121338248706,0.6543560606060606,42.37132352941176,1030.5147058823525,31.227718360071286,0
3067,4,0,0,39,0.0,0.0,1.0,39,1000,800,200,0.8,12,8,4,379.4412339706538,0.3719354475933423,0.24901251543628944,0.2102607165908043,129171.97312510702,2004.6207405797895,131176.5938656868,2938,4,943.9230769230769,35,4,20,36.219235075334936,0.6139880952380953,45.86226851851851,1016.5509259259247,29.044312169312136,8
3068,4,0,0,39,0.0,0.0,1.0,39,850,600,250,0.7058823529411765,11,6,5,367.8665228932117,0.37201979307242466,0.20990222711277684,0.1927207053189964,126921.74437951471,1538.055505866393,128459.7998853811,2939,5,944.9230769230769,36,3,17,38.81849761585457,0.5891203703703705,48.08558558558559,1007.6576576576582,27.990490490490505,5
3069,4,1,0,40,0.025,0.0,1.0,40,1000,600,400,0.6,14,6,8,362.9011215588294,0.3795005341880342,0.22236842105263177,0.19215911846475708,127354.73632812488,1243.6635986704457,128598.39992679533,2940,0,922.275,35,5,17,38.498667010663894,0.5955357142857144,47.65624999999999,1009.3749999999991,28.839285714285687,0
3070,4,7,5,42,0.14893617021276595,0.10638297872340426,0.8936170212765957,47,1150,700,450,0.6086956521739131,16,7,9,318.5325025689783,0.406567992599445,0.20455279729018572,0.17435200388916725,128684.70687045538,-1201.9476556396983,127482.75921481568,2941,0,785.7659574468086,42,5,16,38.26222423837262,0.5969742063492064,46.342054263565885,1014.6317829457355,24.157899593946084,0
3071,4,1,1,42,0.023255813953488372,0.023255813953488372,0.9767441860465116,43,950,800,150,0.8421052631578947,11,8,3,344.60991620753623,0.3919112218530823,0.2371053109195882,0.18671949859884887,128279.78326576077,241.29707246693727,128521.08033822771,2942,0,859.8372093023256,38,5,19,38.01391232510722,0.5992324561403508,46.74145299145299,1013.0341880341875,26.658794421952305,0
3072,4,1,0,43,0.023255813953488372,0.0,1.0,43,1000,600,400,0.6,14,6,8,338.8338399368625,0.3919804355850867,0.24556325764701858,0.1739635721337184,126096.14257812515,-39.66529495624491,126056.4772831689,2943,0,860.8139534883721,39,4,19,40.39834405033534,0.5753205128205128,48.90625000000001,1004.3750000000011,25.753205128205156,8
3073,4,4,2,45,0.0851063829787234,0.0425531914893617,0.9574468085106383,47,900,500,400,0.5555555555555556,13,5,8,323.6286063372703,0.406567992599445,0.24921727238920854,0.1696579127409476,126948.82507604487,-1183.1457328971167,125765.67934314776,2944,0,788.468085106383,43,4,18,39.905171333709234,0.578003875968992,48.05871212121214,1007.7651515151542,23.436398872445448,0
3074,4,3,1,47,0.0625,0.020833333333333332,0.9791666666666666,48,1400,1200,200,0.8571428571428571,16,12,4,317.08322811543826,0.41108894799054374,0.2644175897952332,0.1676590231728597,127297.04231112445,-1526.9257483097044,125770.11656281474,2945,0,772.9791666666666,40,8,20,39.71383014434374,0.5859375,47.713414634146346,1009.1463414634155,25.22865853658539,0
3075,4,1,2,46,0.020833333333333332,0.041666666666666664,0.9583333333333334,48,1000,700,300,0.7,13,7,6,318.7219865755974,0.4120585845153664,0.25870991009125044,0.1691678236439712,127450.9220701966,-1475.7177853790406,125975.20428481756,2946,0,773.9583333333334,40,8,16,39.51518887546969,0.5874999999999999,47.56097560975611,1009.7560975609779,25.243902439024446,0
3076,4,2,2,46,0.041666666666666664,0.041666666666666664,0.9583333333333334,48,1150,800,350,0.6956521739130435,15,8,7,318.05420045423415,0.41287123226950356,0.25731472166331293,0.16924297390337756,127553.5602154804,-1486.2108781148593,126067.34933736554,2947,0,774.8958333333334,40,8,16,39.42718812877263,0.5885416666666666,47.45934959349594,1010.1626016260178,25.254065040650445,0
3077,4,2,2,46,0.041666666666666664,0.041666666666666664,0.9583333333333334,48,950,900,50,0.9473684210526315,10,9,1,318.6841570513531,0.4135084219858156,0.2699337585868502,0.1703773116659648,127743.06047650543,-1458.0620905769658,126284.99838592847,2948,0,775.8541666666666,41,7,17,39.217778868171415,0.5889227642276422,47.2718253968254,1010.9126984126985,24.6564072783585,0
3078,4,0,0,46,0.0,0.0,1.0,46,1100,800,300,0.7272727272727273,14,8,6,331.10402034273284,0.4076992753623188,0.27292394330832925,0.1761226376995878,127538.80343967033,-754.2778862847035,126784.52555338563,2949,1,810.5,39,7,17,39.11271956962634,0.5900106837606837,47.47395833333334,1010.1041666666682,25.900106837606877,0
3079,4,1,1,46,0.02127659574468085,0.02127659574468085,0.9787234042553191,47,1200,900,300,0.75,15,9,6,325.3569302879233,0.41290857230958994,0.26444931962068297,0.17427026749473473,127818.28826727446,-1082.6868189405438,126735.60144833391,2950,0,794.2340425531914,41,6,17,38.972313515811486,0.5896849593495934,47.19742063492063,1011.2103174603171,24.66366627951993,0
3080,4,1,1,46,0.02127659574468085,0.02127659574468085,0.9787234042553191,47,950,700,250,0.7368421052631579,12,7,5,328.71905442660886,0.4107308048103608,0.2727443428623888,0.1766215446281642,127943.71712805488,-988.492457168056,126955.22467088682,2951,0,795.2127659574468,41,6,18,38.75923383670002,0.5909552845528455,47.073412698412696,1011.7063492063489,24.675764614789,0
3081,4,1,0,47,0.02127659574468085,0.0,1.0,47,850,600,250,0.7058823529411765,11,6,5,331.32295941910655,0.41044172062904716,0.28364901333489034,0.17846656979903525,128044.10450522816,-915.209671831683,127128.89483339647,2952,0,795.9787234042553,41,6,19,38.590880873031416,0.591971544715447,46.974206349206355,1012.1031746031757,24.685443283004286,0
3082,4,0,0,47,0.0,0.0,1.0,47,900,500,400,0.5555555555555556,13,5,8,331.78288147877356,0.41076934936786924,0.2873586180425718,0.1794050161744035,128198.62349559856,-893.0601562069126,127305.56333939165,2953,1,796.9787234042553,38,9,19,38.4215546646974,0.5984100877192983,46.82158119658119,1012.7136752136744,26.650359874044064,0
3083,4,5,4,48,0.09615384615384616,0.07692307692307693,0.9230769230769231,52,1250,1000,250,0.8,15,10,5,299.3818347716695,0.4252215309200604,0.27060119666081506,0.16591966939978695,129177.3211966971,-2665.3313138487083,126511.98988284839,2954,0,721.25,43,9,20,38.24842803912437,0.6005329457364341,45.85700757575758,1016.5719696969697,23.64120859760395,0
3084,4,1,2,47,0.02040816326530612,0.04081632653061224,0.9591836734693877,49,1100,600,500,0.5454545454545454,16,6,10,317.51256512769896,0.4193948412698412,0.2754503911763999,0.17473433422834003,128898.98667800441,-1614.5904195011499,127284.39625850326,2955,0,766.1224489795918,41,8,20,38.070291129347396,0.6006097560975611,46.13095238095237,1015.4761904761895,24.76771196283389,0
3085,4,0,0,47,0.0,0.0,1.0,47,1150,700,450,0.6086956521739131,16,7,9,327.5804483253814,0.41275439407955594,0.27906661743855077,0.1791300385312119,128645.9974500866,-971.6172960069664,127674.38015407963,2956,2,799.6382978723404,39,8,20,38.07211982749767,0.6012286324786327,46.38020833333332,1014.4791666666649,26.01228632478628,0
3086,4,1,1,47,0.020833333333333332,0.020833333333333332,0.9791666666666666,48,1500,1000,500,0.6666666666666666,20,10,10,318.64304412668577,0.4162049349881796,0.2744567030254508,0.1754380132208248,128917.41569378342,-1384.2724444775013,127533.14324930593,2957,0,783.9583333333334,40,8,20,38.02286600620433,0.6023437500000001,46.11280487804878,1015.5487804878046,25.388719512195117,0
3087,4,3,1,49,0.06,0.02,0.98,50,800,500,300,0.625,11,5,6,311.36662411594097,0.42124149659863946,0.2911951647494637,0.17377577966166052,129453.6613835348,-1938.1776777349073,127515.4837057999,2958,0,753.54,41,9,18,37.663693377526485,0.6061991869918699,45.585317460317455,1017.6587301587294,24.820944638017792,0
3088,4,2,1,50,0.0392156862745098,0.0196078431372549,0.9803921568627451,51,850,700,150,0.8235294117647058,10,7,3,307.2307839662609,0.42366013071895425,0.29872774675782465,0.17273927607600373,129743.78511657957,-2227.7430367766297,127516.04207980294,2959,0,739.7254901960785,42,9,20,37.475231437448485,0.6076388888888888,45.30038759689923,1018.7984496124034,24.25710594315246,0
3089,4,0,0,50,0.0,0.0,1.0,50,600,300,300,0.5,9,3,6,312.170833998624,0.4206632653061224,0.3009739943508325,0.17523553595756564,129680.91699932294,-1903.4799973229974,127777.43700199995,2960,1,755.52,41,9,22,37.413050712639205,0.6084857723577235,45.36210317460318,1018.5515873015879,24.842721641502145,0
3090,4,2,0,52,0.038461538461538464,0.0,1.0,52,1500,1100,400,0.7333333333333333,19,11,8,303.1154793166295,0.42645487682252387,0.30738722730094925,0.17259808513227415,130238.42047068704,-2504.543750717392,127733.87671996964,2961,0,727.4230769230769,43,9,24,37.08029888363176,0.6111918604651163,44.815340909090914,1020.7386363636367,23.738107822410157,0
3091,4,1,3,50,0.018867924528301886,0.05660377358490566,0.9433962264150944,53,1350,800,550,0.5925925925925926,19,8,11,294.0964472745561,0.42826257861635225,0.29672651797775895,0.16863768550898287,130509.99907044353,-2923.4901041573494,127586.50896628619,2962,0,714.6792452830189,42,11,15,37.03670776039198,0.6153273809523809,44.549418604651166,1021.8023255813958,24.328626799557043,0
3092,4,0,0,50,0.0,0.0,1.0,50,1150,1000,150,0.8695652173913043,13,10,3,305.9169232169268,0.42397959183673467,0.295210510600179,0.17453420372291134,130314.46358194543,-2026.9200500693892,128287.54353187604,2963,2,748.84,40,10,24,36.93204439136061,0.6164062499999999,44.740853658536594,1021.0365853658549,25.52591463414637,0
3093,4,1,1,50,0.0196078431372549,0.0196078431372549,0.9803921568627451,51,1300,900,400,0.6923076923076923,17,9,8,297.8248820988064,0.4266176470588235,0.2855440924307222,0.17113718685242602,130591.93244716851,-2421.294623173362,128170.63782399514,2964,0,735.1372549019608,41,10,16,36.8589043644246,0.6176321138211383,44.469246031746025,1022.1230158730145,24.929829655439377,0
3094,4,0,0,50,0.0,0.0,1.0,50,1600,1000,600,0.625,22,10,12,303.931379017815,0.42404761904761906,0.29045436893203913,0.1743036305057626,130515.89269967253,-2066.4249496094662,128449.46775006306,2965,4,750.84,41,9,16,36.77953074433659,0.616869918699187,44.5436507936508,1021.8253968253973,24.922570654277983,0
3095,4,0,2,48,0.0,0.04,0.96,50,1050,700,350,0.6666666666666666,14,7,7,325.4652590148468,0.4245068027210885,0.2844155844155849,0.1871026167491889,130609.02970261693,-1438.204391523157,129170.82531109377,2966,5,751.84,42,8,12,36.13533668278194,0.6163194444444444,44.45251937984496,1022.1899224806193,24.337855297157603,4
3096,4,0,0,48,0.0,0.0,1.0,48,1050,600,450,0.5714285714285714,15,6,9,336.5765033366487,0.41717457151300236,0.30292064597426727,0.19266896421070565,130444.20070725089,-819.1094090819037,129625.09129816898,2967,6,783.9166666666666,40,8,19,36.0181224300305,0.6177083333333333,44.61382113821138,1021.5447154471539,25.538617886178848,0
3097,4,0,0,48,0.0,0.0,1.0,48,1300,900,400,0.6923076923076923,17,9,8,342.3400041690149,0.41690676713947994,0.3106393999668493,0.19636216439928375,130522.07396597594,-663.4145308678662,129858.65943510807,2968,7,784.9166666666666,40,8,12,35.79210177357865,0.6184895833333333,44.53760162601626,1021.849593495935,25.546239837398375,0
3098,4,0,0,48,0.0,0.0,1.0,48,1350,1100,250,0.8148148148148148,16,11,5,342.36626035824986,0.41687906323877066,0.30456349206349254,0.1969046433930036,130625.94112507423,-655.6170062462927,129970.32411882794,2969,8,785.9166666666666,40,8,13,35.68632567849687,0.6195312500000001,44.43597560975609,1022.2560975609746,25.556402439024364,0
3099,4,1,1,48,0.02040816326530612,0.02040816326530612,0.9795918367346939,49,1050,700,350,0.6666666666666666,14,7,7,340.20719150025127,0.4188633786848073,0.3147896879240164,0.19742732294148443,130972.46334876542,-888.4452160493834,130084.01813271604,2970,0,770.8571428571429,41,8,14,35.39122568973315,0.6214430894308943,44.09722222222222,1023.6111111111111,24.96612466124661,0
3100,4,0,0,48,0.0,0.0,1.0,48,1100,900,200,0.8181818181818182,13,9,4,347.8323820675413,0.41688829787234044,0.3299245432883242,0.2018068981672968,130963.7946989225,-489.3102650538776,130474.48443386862,2971,1,787.7291666666666,40,8,15,35.204858353190346,0.6229166666666668,44.105691056910565,1023.577235772357,25.589430894308926,0
3101,4,1,1,48,0.02040816326530612,0.02040816326530612,0.9795918367346939,49,1100,800,300,0.7272727272727273,14,8,6,340.33433675653083,0.4190051020408163,0.33041696254901454,0.1990805279611208,131278.46884201645,-864.2858752479017,130414.18296676854,2972,0,772.6326530612245,42,7,17,35.07903113968734,0.6230158730158731,43.79844961240309,1024.8062015503856,24.40014765596156,0
3102,4,0,1,47,0.0,0.020833333333333332,0.9791666666666666,48,1600,1200,400,0.75,20,12,8,319.00861163621124,0.41630651595744683,0.2170652173913048,0.18910304298022812,131786.1128826529,-1191.8096298146172,130594.30325283829,2973,1,789.4375,41,7,14,35.11473429951691,0.6295731707317074,43.30357142857142,1026.785714285713,25.043554006968613,7
3103,4,0,2,45,0.0,0.0425531914893617,0.9574468085106383,47,1600,1300,300,0.8125,19,13,6,320.656557572888,0.4133903792784459,0.23133133400617112,0.19020722220269118,131811.58002842328,-946.7504999685195,130864.82952845476,2974,4,807.2127659574468,41,6,14,35.0468352494123,0.6298272357723578,43.278769841269835,1026.8849206349196,25.045973674022427,0
3104,4,1,1,45,0.021739130434782608,0.021739130434782608,0.9782608695652174,46,1200,900,300,0.75,15,9,6,324.91390624935735,0.40702495974235103,0.2456565834729696,0.19299103106136506,131862.5217013887,-631.2065972222429,131231.31510416645,2975,0,824.5434782608696,41,5,15,34.886325219743064,0.6303353658536586,43.22916666666666,1027.0833333333317,25.050813008130042,0
3105,4,0,0,45,0.0,0.0,1.0,45,1450,1000,450,0.6896551724137931,19,10,9,330.8330422719027,0.4052188552188552,0.2410682492581595,0.19698009760712262,131953.86860499723,-269.06004197235484,131684.80856302488,2976,6,843.8666666666667,40,5,15,34.6424744477415,0.6328125,43.14024390243903,1027.4390243902455,25.685975609756138,0
3106,4,0,0,45,0.0,0.0,1.0,45,1400,1000,400,0.7142857142857143,18,10,8,327.5383491599707,0.4049873737373737,0.2357357357357357,0.19546643417611162,132040.89506172843,-350.30864197530434,131690.58641975312,2977,7,844.8666666666667,41,4,16,34.63963963963965,0.6321138211382114,43.05555555555556,1027.777777777778,25.067750677506783,0
3107,4,0,0,45,0.0,0.0,1.0,45,650,400,250,0.6153846153846154,9,4,5,330.55876004798836,0.4048821548821549,0.24107133284012594,0.19766765322431062,132117.3776947121,-265.4886896888439,131851.88900502326,2978,8,845.8666666666667,41,4,16,34.48516758338962,0.6328760162601625,42.98115079365079,1028.0753968253964,25.075009678668206,0
3108,4,0,0,45,0.0,0.0,1.0,45,950,700,250,0.7368421052631579,12,7,5,332.2522826646089,0.4046085858585859,0.24125514403292136,0.19935136959876532,132244.89795918367,-212.2661564625913,132032.63180272107,2979,9,846.8666666666667,41,4,16,34.31351273148147,0.6341463414634146,42.857142857142854,1028.5714285714284,25.08710801393728,0
3109,4,1,1,45,0.021739130434782608,0.021739130434782608,0.9782608695652174,46,600,200,400,0.3333333333333333,10,2,8,325.1216186368979,0.4073570853462158,0.23470877120681366,0.19600189009253,132424.15229030343,-589.0318979564767,131835.12039234696,2980,0,829.4347826086956,40,6,16,34.31699249605057,0.6375,42.6829268292683,1029.2682926829273,25.73170731707318,0
3110,4,0,0,45,0.0,0.0,1.0,45,1750,1400,350,0.8,21,14,7,332.6080823076876,0.40425084175084175,0.23654282898401724,0.20010504812617927,132346.95845930948,-196.06638951878801,132150.8920697907,2981,11,848.8666666666667,41,4,16,34.20185756523974,0.6351626016260163,42.7579365079365,1028.9682539682526,25.0967866821525,0
3111,4,0,0,45,0.0,0.0,1.0,45,1350,900,450,0.6666666666666666,18,9,9,335.6121957902834,0.40404040404040403,0.24022930365874262,0.20290682295944648,132532.04345703122,-104.10629276305417,132427.93716426817,2982,12,849.8666666666667,39,6,17,33.938732928679826,0.640224358974359,42.578125,1029.6874999999998,26.402243589743584,0
3112,4,0,0,45,0.0,0.0,1.0,45,1150,900,250,0.782608695652174,14,9,5,336.21872414407056,0.4041666666666666,0.23469974829198148,0.20370899168728984,132612.5,-82.6388888888884,132529.86111111112,2983,13,850.8666666666667,39,6,17,33.84236785329018,0.641025641025641,42.5,1030.0,26.41025641025641,0
3113,4,0,0,45,0.0,0.0,1.0,45,1400,1100,300,0.7857142857142857,17,11,6,335.4406525210323,0.4043981481481482,0.24139565710690958,0.20367363376829545,132692.9809570314,-97.87597656248596,132595.1049804689,2984,14,851.8666666666667,39,6,16,33.78165756748559,0.641826923076923,42.42187500000001,1030.3125000000011,26.41826923076926,0
3114,4,0,0,45,0.0,0.0,1.0,45,1200,800,400,0.6666666666666666,16,8,8,334.41404184766486,0.40406144781144776,0.23691727297224374,0.20377840875150838,132827.17013888914,-116.1458333333091,132711.02430555582,2985,15,852.8666666666667,39,6,16,33.673538129884115,0.6431623931623931,42.29166666666668,1030.8333333333353,26.43162393162398,0
3115,4,0,0,45,0.0,0.0,1.0,45,1000,700,300,0.7,13,7,6,335.621292563888,0.40406144781144776,0.24022543307175015,0.20466074753572397,132854.01611328137,-82.27267795137504,132771.74343533,2986,16,853.8666666666667,39,6,16,33.61551059243543,0.6434294871794872,42.26562500000001,1030.937500000001,26.434294871794894,0
3116,4,0,0,45,0.0,0.0,1.0,45,1350,1000,350,0.7407407407407407,17,10,7,340.06810280705554,0.4031355218855219,0.25500028044197665,0.20856808410550384,133068.88156467024,50.49641927084474,133119.37798394109,2987,17,854.8666666666667,39,6,17,33.28548292108361,0.6455662393162394,42.05729166666667,1031.7708333333342,26.455662393162413,0
3117,4,0,1,44,0.0,0.022222222222222223,0.9777777777777777,45,1650,1300,350,0.7878787878787878,20,13,7,345.6060547909364,0.40237794612794614,0.2603668340059717,0.21291764163863697,133236.04630387013,209.43686380461907,133445.48316767474,2988,18,855.8666666666667,40,5,17,32.97507136529185,0.6455729166666667,41.895325203252035,1032.4186991869924,25.81046747967481,0
3118,4,0,0,44,0.0,0.0,1.0,44,950,600,350,0.631578947368421,13,6,7,352.24597698652275,0.4014160500352361,0.26658396088826897,0.21697388924259986,133230.1445855037,585.956488715301,133816.101074219,2989,19,857.0,39,5,17,32.809609692933776,0.6471688034188033,41.90104166666668,1032.395833333335,26.47168803418808,0
3119,4,0,0,44,0.0,0.0,1.0,44,1450,1100,350,0.7586206896551724,18,11,7,352.2604772945221,0.40174638830162085,0.2652202814835187,0.2176113789641863,133337.7075195314,593.9208984375134,133931.6284179689,2990,20,858.0,39,5,17,32.70139939485627,0.6482371794871794,41.79687500000001,1032.8125000000011,26.482371794871824,0
3120,4,1,0,45,0.022222222222222223,0.0,1.0,45,700,300,400,0.42857142857142855,11,3,8,353.42984141264714,0.40446127946127947,0.27740114946500394,0.21511278738850514,132783.12108490392,386.106935983615,133169.22802088753,2991,0,839.9111111111112,38,7,18,33.22773055526761,0.6444627192982456,42.33440170940171,1030.662393162393,27.12269455690508,1
3121,4,0,0,45,0.0,0.0,1.0,45,1350,1000,350,0.7407407407407407,17,10,7,351.13550531850507,0.4039351851851852,0.2747838898672834,0.2146618766839476,132948.34270445266,336.57669935716774,133284.91940380982,2992,1,840.9111111111112,38,7,18,33.12096412168929,0.6461074561403508,42.17414529914531,1031.3034188034203,27.139563652721588,0
3122,4,0,0,45,0.0,0.0,1.0,45,1300,900,400,0.6923076923076923,17,9,8,347.6976993061445,0.4035563973063973,0.2687929308618964,0.21318836077456776,133058.54752218953,252.83016929653257,133311.37769148606,2993,2,841.9111111111112,38,7,18,33.09904732318524,0.647203947368421,42.0673076923077,1031.7307692307706,27.150809716599227,0
3123,4,0,0,45,0.0,0.0,1.0,45,1250,900,350,0.72,16,9,7,349.75280713467447,0.4037878787878788,0.27119946618807655,0.21460690033714672,133086.1058605451,309.44782306963026,133395.55368361474,2994,3,842.9111111111112,38,7,18,33.01839580313384,0.6474780701754386,42.0405982905983,1031.8376068376078,27.15362123256863,0
3124,4,0,0,45,0.0,0.0,1.0,45,950,900,50,0.9473684210526315,10,9,1,351.2268045214302,0.40372474747474746,0.272422360248447,0.21583021193874155,133141.23109796195,352.55382971729483,133493.78492767925,2995,4,843.9111111111112,38,7,19,32.92507763975154,0.6480263157894737,41.98717948717949,1032.0512820512827,27.15924426450744,0
3125,4,1,0,46,0.021739130434782608,0.0,1.0,46,1000,700,300,0.7,13,7,6,343.2175986822561,0.4066727053140096,0.27036412936557497,0.21249391645577462,133419.7206110782,-41.600775001636265,133378.11983607657,2996,0,826.5434782608696,40,6,20,32.852769034035035,0.6473958333333333,41.717479674796756,1033.1300813008143,25.828252032520357,0
3126,4,0,0,46,0.0,0.0,1.0,46,900,700,200,0.7777777777777778,11,7,4,342.9354380810388,0.4069545088566828,0.26930430608027756,0.21247308671112541,133446.59514558135,-47.286686665409405,133399.30845891594,2997,1,827.5434782608696,41,5,20,32.83315330452873,0.6460873983739838,41.69146825396825,1033.2341269841268,25.200832365466507,0
3127,4,0,0,46,0.0,0.0,1.0,46,1850,1400,450,0.7567567567567568,23,14,9,343.08772223821575,0.40613929146537847,0.26270249871964224,0.2136681451622555,133637.8718770545,-30.090005162982123,133607.78187189152,2998,2,828.5434782608696,38,8,20,32.637812564579455,0.6529605263157894,41.506410256410255,1033.9743589743587,27.209851551956806,0
3128,4,0,0,46,0.0,0.0,1.0,46,1100,500,600,0.45454545454545453,17,5,12,340.7233908382505,0.4053945249597424,0.25418733586226994,0.2133100219953753,133831.2596450617,-80.11188271605226,133751.14776234567,2999,3,829.5434782608696,38,8,14,32.5055928411633,0.6548793859649124,41.31944444444444,1034.7222222222222,27.22953216374269,0
3129,4,0,0,46,0.0,0.0,1.0,46,1250,800,450,0.64,17,8,9,355.5263332876857,0.4053945249597424,0.2749773761767764,0.21798843178153518,133058.54752218924,261.1635026298361,133319.7110248191,3000,4,830.5434782608696,38,8,16,32.89712125919023,0.647203947368421,42.067307692307686,1031.7307692307684,27.150809716599166,1
3130,4,1,1,46,0.02127659574468085,0.02127659574468085,0.9787234042553191,47,1350,1000,350,0.7407407407407407,17,10,7,357.9117789887594,0.408418131359852,0.2769240011242251,0.22142302634008237,133391.5052625866,148.47819010414796,133539.98345269077,3001,0,813.8510638297872,39,8,17,32.50153356189709,0.6487713675213677,41.74479166666666,1033.0208333333317,26.487713675213634,0
3131,4,0,0,46,0.0,0.0,1.0,46,1350,1100,250,0.8148148148148148,16,11,5,370.4267722109872,0.4044082125603865,0.2835214243963846,0.22932310417927337,133417.02849916008,684.2478449850425,134101.27634414512,3002,1,832.4347826086956,38,8,18,32.15270596346089,0.650767543859649,41.72008547008548,1033.1196581196593,27.18735942420156,0
3132,4,0,0,46,0.0,0.0,1.0,46,950,500,450,0.5263157894736842,14,5,9,370.2908765980201,0.40415660225442834,0.2876600161457732,0.2297558599036431,133500.5497484803,686.8185328107043,134187.36828129098,3003,2,833.4347826086956,37,9,18,32.07239168877099,0.6534346846846846,41.63925438596491,1033.4429824561403,27.93089141773352,0
3133,4,0,0,46,0.0,0.0,1.0,46,900,600,300,0.6666666666666666,12,6,6,368.3392647470978,0.40446859903381643,0.29141687111471826,0.22907009155907906,133585.55036164974,640.9606802092982,134226.51104185905,3004,3,834.4347826086956,37,9,18,32.037547730165464,0.6542792792792793,41.55701754385965,1033.7719298245615,27.93978188715031,0
3134,4,0,0,46,0.0,0.0,1.0,46,1200,800,400,0.6666666666666666,16,8,8,368.10229267146667,0.4043478260869566,0.2902726146220569,0.2302779458805222,133803.62426035505,650.6841715976338,134454.3084319527,3005,4,835.4347826086956,38,8,16,31.82504646840149,0.6546052631578947,41.34615384615385,1034.6153846153848,27.226720647773284,0
3135,4,0,1,45,0.0,0.021739130434782608,0.9782608695652174,46,1300,1100,200,0.8461538461538461,15,11,4,366.69367812084715,0.40461956521739134,0.29231691060632614,0.2299133760489737,133886.53897518065,619.069485535819,134505.60846071647,3006,5,836.4347826086956,38,8,16,31.778414369773937,0.6554276315789473,41.266025641025635,1034.9358974358963,27.235155195681482,0
3136,4,0,0,45,0.0,0.0,1.0,45,1400,1100,300,0.7857142857142857,17,11,6,371.7545114296448,0.40084175084175083,0.29294149506081313,0.23279677003062738,133840.71451071466,951.1778864650449,134791.8923971797,3007,6,854.5555555555555,37,8,16,31.69340097488609,0.6568130630630632,41.31030701754385,1034.758771929823,27.966453295400623,0
3137,4,0,0,45,0.0,0.0,1.0,45,1550,1200,350,0.7741935483870968,19,12,7,372.2599241442904,0.40069444444444446,0.286709501282685,0.23401319599003906,133982.57757194512,975.2688327177475,134957.84640466288,3008,7,855.5555555555555,37,8,17,31.538162818611877,0.6582207207207207,41.17324561403508,1035.3070175438588,27.981270744428617,0
3138,4,0,0,45,0.0,0.0,1.0,45,1250,1000,250,0.8,15,10,5,373.69573801006464,0.4006734006734007,0.2838251211821734,0.2352788366511364,134039.34383656492,1017.986303477971,135057.3301400429,3009,8,856.5555555555555,37,8,17,31.444126782436808,0.6587837837837839,41.11842105263157,1035.5263157894722,27.98719772403979,0
3139,4,0,1,44,0.0,0.022222222222222223,0.9777777777777777,45,1350,1000,350,0.7407407407407407,17,10,7,371.53497493962493,0.3998316498316498,0.2787964335285955,0.23428033199463927,134096.12212411506,964.2798745767902,135060.40199869184,3010,9,857.5555555555555,37,8,17,31.44320347236927,0.6593468468468469,41.06359649122807,1035.7456140350873,27.99312470365101,0
3140,4,0,0,44,0.0,0.0,1.0,44,1100,900,200,0.8181818181818182,13,9,4,376.98996250617625,0.3998634601832276,0.27439482169498075,0.237536370638481,134067.73147747366,1308.4378125961637,135376.1692900698,3011,10,867.5909090909091,37,7,17,31.330399682371628,0.6590653153153154,41.091008771929815,1035.6359649122792,27.990161213845383,0
3141,4,0,0,44,0.0,0.0,1.0,44,900,800,100,0.8888888888888888,10,8,2,374.53921689381707,0.3992468287526427,0.27251801537440246,0.23672381675114879,134181.31209843402,1251.232711026458,135432.54480946047,3012,11,868.5909090909091,37,7,17,31.280095777330928,0.6601914414414415,40.9813596491228,1036.074561403508,28.002015173067782,0
3142,4,1,1,44,0.022222222222222223,0.022222222222222223,0.9777777777777777,45,1450,1100,350,0.7586206896551724,18,11,7,365.2694197735327,0.40012626262626266,0.2578384771596258,0.23286510128712162,134496.75021701396,825.5099826388956,135322.26019965287,3013,0,850.2666666666667,39,6,17,31.204810202851974,0.6597222222222222,40.677083333333336,1037.2916666666672,26.597222222222236,0
3143,4,1,0,45,0.022222222222222223,0.0,1.0,45,1300,900,400,0.6923076923076923,17,9,8,367.997660551662,0.40065235690235695,0.2657013781666384,0.23566890390635403,134661.6480956422,911.0451437399239,135572.69323938212,3014,0,851.2444444444444,38,7,18,30.969291473666146,0.6631030701754387,40.51816239316238,1037.927350427348,27.31387764282495,0
3144,4,0,0,45,0.0,0.0,1.0,45,950,700,250,0.7368421052631579,12,7,5,369.34230063520715,0.4002104377104377,0.27111979791745267,0.23761591690766698,134828.03397116295,959.5392514062386,135787.5732225692,3015,1,852.2444444444444,38,7,15,30.76822514830436,0.6647478070175439,40.35790598290598,1038.568376068376,27.330746738641473,0
3145,4,0,1,44,0.0,0.022222222222222223,0.9777777777777777,45,1000,800,200,0.8,12,8,4,368.6121993765912,0.3998737373737374,0.27534165181224046,0.23769131477042227,134911.26543209862,945.9876543209741,135857.2530864196,3016,2,853.2444444444444,38,7,16,30.70409982174688,0.6655701754385965,40.27777777777777,1038.8888888888878,27.339181286549678,0
3146,4,0,0,44,0.0,0.0,1.0,44,900,700,200,0.7777777777777778,11,7,4,372.43304621406617,0.39752906976744184,0.2732415701969293,0.23978768710550652,134855.7749379062,1244.9494119365722,136100.72434984276,3017,16,873.5909090909091,38,6,16,30.660272234793922,0.6650219298245614,40.33119658119657,1038.6752136752125,27.333558254610853,0
3147,4,0,0,44,0.0,0.0,1.0,44,650,300,350,0.46153846153846156,10,3,7,373.28402535008377,0.39719873150105706,0.2796704837578874,0.24088833089114545,134939.01495954767,1274.1157361750134,136213.13069572268,3018,17,874.5909090909091,38,6,16,30.555055698371884,0.6658442982456141,40.25106837606837,1038.9957264957254,27.34199280251909,0
3148,4,0,0,44,0.0,0.0,1.0,44,900,700,200,0.7777777777777778,11,7,4,372.1570031827031,0.3973418780831572,0.27561550109360167,0.24034521998372943,134966.76734056522,1245.7655325443561,136212.53287310957,3019,18,875.5909090909091,38,6,16,30.556626567962162,0.6661184210526316,40.224358974358964,1039.1025641025624,27.344804318488485,0
3149,4,0,0,44,0.0,0.0,1.0,44,1350,1100,250,0.8148148148148148,16,11,5,368.0851919583149,0.39692344961240306,0.26746418860202437,0.23826352844726822,135050.04160502937,1141.9840976331166,136192.02570266247,3020,19,876.5909090909091,38,6,16,30.57932469935245,0.6669407894736843,40.14423076923076,1039.4230769230753,27.35323886639672,0
3150,4,0,0,44,0.0,0.0,1.0,44,600,200,400,0.3333333333333333,10,2,8,368.9720018703516,0.39681333685694153,0.26737651927766026,0.2392049667022245,135105.57204918173,1170.0346765651109,136275.60672574685,3021,20,877.5909090909091,38,6,16,30.500890624464766,0.6674890350877194,40.09081196581196,1039.6367521367513,27.35886189833556,0
3151,4,0,0,44,0.0,0.0,1.0,44,1100,700,400,0.6363636363636364,15,7,8,366.790202302464,0.3971326638477801,0.2668370920296963,0.2385238890724437,135216.6671803088,1119.2297419460715,136335.89692225488,3022,21,878.5909090909091,38,6,17,30.44684129429891,0.6685855263157896,39.98397435897435,1040.0641025641012,27.37010796221319,0
3152,4,0,1,43,0.0,0.022727272727272728,0.9772727272727273,44,1050,800,250,0.7619047619047619,13,8,5,375.4217456750251,0.3963838971106413,0.2773567295127868,0.24508095193530446,135355.6002995105,1363.0871502666284,136718.68744977712,3023,22,879.5909090909091,38,6,17,30.083846680355915,0.6699561403508772,39.850427350427346,1040.59829059829,27.384165542060266,0
3153,4,0,0,43,0.0,0.0,1.0,43,950,600,350,0.631578947368421,13,6,7,378.51418577416433,0.39348006644518274,0.2839850727617106,0.2472455703498,135376.81215614424,1648.4087651969855,137025.2209213412,3024,23,898.9767441860465,37,6,17,29.982241948512623,0.6720157657657657,39.83004385964912,1040.6798245614036,28.1264817449028,0
3154,4,0,0,43,0.0,0.0,1.0,43,850,500,350,0.5882352941176471,12,5,7,378.76306846221763,0.3929032853451458,0.2866983995551191,0.24780136519033974,135433.87298255225,1659.4698609187358,137093.34284347098,3025,24,899.9767441860465,37,6,17,29.91886565539521,0.6725788288288288,39.77521929824561,1040.8991228070167,28.132408724513965,0
3155,4,0,0,43,0.0,0.0,1.0,43,1400,900,500,0.6428571428571429,19,9,10,373.91254631387164,0.39228036175710596,0.2755352658292127,0.24619679472951084,135663.00834195683,1545.3674588423403,137208.37580079917,3026,25,900.9767441860465,36,7,18,29.816821604871542,0.6767939814814815,39.55518018018018,1041.7792792792793,28.938313313313316,0
3156,4,0,0,43,0.0,0.0,1.0,43,900,500,400,0.5555555555555556,13,5,8,369.3187877768994,0.39188815060908083,0.26958652142776374,0.24397183303891523,135780.35119156315,1429.2469411979484,137209.5981327611,3027,26,901.9767441860465,36,7,18,29.819692058346842,0.677951388888889,39.442567567567565,1042.2297297297293,28.950825825825817,0
3157,4,0,0,43,0.0,0.0,1.0,43,1050,800,250,0.7619047619047619,13,8,5,367.3827184243008,0.39221114802510154,0.26605776525142333,0.24329250408956912,135868.39161796935,1383.1398121094153,137251.53143007876,3028,27,902.9767441860465,36,7,16,29.78257543025852,0.6788194444444444,39.35810810810811,1042.567567567568,28.96021021021022,0
3158,4,0,0,43,0.0,0.0,1.0,43,1250,1100,150,0.88,14,11,3,366.49868986247435,0.3914267257290513,0.26903952107832696,0.2441128944339196,136073.93024358808,1374.1834317425419,137448.11367533062,3029,28,903.9767441860465,36,7,16,29.601322180248243,0.6808449074074074,39.16103603603603,1043.355855855855,28.982107107107083,0
3159,4,0,0,43,0.0,0.0,1.0,43,550,200,350,0.36363636363636365,9,2,7,367.1689030612041,0.391265227021041,0.27071303274183744,0.24496430703154623,136132.68409879468,1396.7376582663678,137529.42175706103,3030,29,904.9767441860465,36,7,16,29.525466709830578,0.6814236111111112,39.104729729729726,1043.5810810810806,28.988363363363348,0
3160,4,0,0,43,0.0,0.0,1.0,43,1450,1000,450,0.6896551724137931,19,10,9,368.4467826980741,0.39112679955703217,0.27405626762754576,0.24602051743845443,136162.0657819981,1433.6950125801354,137595.76079457824,3031,30,905.9767441860465,36,7,16,29.46293698748382,0.681712962962963,39.07657657657657,1043.693693693693,28.99149149149147,0
3161,4,0,0,43,0.0,0.0,1.0,43,900,500,400,0.5555555555555556,13,5,8,369.0384900004182,0.39068844592100405,0.2764710161468753,0.24702930258439507,136250.22985400914,1456.3158175066692,137706.5456715158,3032,31,906.9767441860465,36,7,16,29.35992161938662,0.6825810185185186,38.992117117117104,1044.0315315315295,29.00087587587582,0
3162,4,0,0,43,0.0,0.0,1.0,43,1050,700,350,0.6666666666666666,14,7,7,379.66548938820057,0.3905038759689923,0.2529692647834314,0.225593573237216,131876.23844875421,1422.6769758290156,133298.91542458322,3033,32,907.9767441860465,38,5,17,33.46660252409679,0.6354166666666667,43.21581196581195,1027.1367521367501,27.02991452991448,8
3163,4,0,0,43,0.0,0.0,1.0,43,1250,1000,250,0.8,15,10,5,378.1672323744359,0.3906423034330011,0.25435371005314367,0.22562862660782715,132032.19112507434,1386.0496604203809,133418.24078549474,3034,33,908.9767441860465,40,3,17,33.34754771086719,0.6335937500000001,43.0640243902439,1027.7439024390242,25.693597560975604,0
3164,4,0,0,43,0.0,0.0,1.0,43,600,200,400,0.3333333333333333,10,2,8,378.71954602999085,0.3902039497969731,0.25655880162211386,0.22642594134984523,132110.53688280765,1406.5685108070388,133517.10539361468,3035,34,909.9767441860465,40,3,17,33.254250691973105,0.6343750000000001,42.98780487804877,1028.0487804878032,25.70121951219508,0
3165,4,0,0,43,0.0,0.0,1.0,43,1000,600,400,0.6,14,6,8,376.7056853712911,0.39006552233296415,0.21422458358686636,0.22968786341510247,132849.77709487543,1416.659725838407,134266.43682071383,3036,35,910.9767441860465,37,6,14,32.56089129972346,0.6469594594594594,42.26973684210527,1030.9210526315796,27.862731152204855,2
3166,4,1,0,44,0.022727272727272728,0.0,1.0,44,800,500,300,0.625,11,5,6,371.2390408303235,0.3931686046511628,0.21494232325323193,0.2284657078027126,133196.3677496531,1089.5383610928568,134285.90611074594,3037,0,891.25,38,6,15,32.35333436831574,0.6485745614035088,41.93376068376069,1032.264957264958,27.16486729644626,0
3167,4,0,0,44,0.0,0.0,1.0,44,1300,800,500,0.6153846153846154,18,8,10,372.01608247742723,0.39293736786469347,0.205951653106335,0.2294534420640928,133279.0941289539,1116.3932947987394,134395.48742375264,3038,1,892.25,38,6,15,32.25017244352473,0.6493969298245614,41.85363247863248,1032.58547008547,27.173301844354473,0
3168,4,0,0,44,0.0,0.0,1.0,44,800,600,200,0.75,10,6,4,374.6677658545035,0.3928823114869626,0.20448433444916692,0.23160408953205502,133361.84619037184,1193.2769924757085,134555.12318284754,3039,2,893.25,38,6,16,32.0985898496759,0.6502192982456141,41.77350427350427,1032.905982905983,27.181736392262707,0
3169,4,0,1,43,0.0,0.022727272727272728,0.9772727272727273,44,700,400,300,0.5714285714285714,10,4,6,350.7257601438829,0.39280523255813954,0.05210079889535435,0.213062221815388,132711.95969867465,514.3768373654239,133226.33653604006,3040,3,894.25,40,4,13,33.36888088897656,0.6403645833333333,42.40345528455284,1030.3861788617878,25.759654471544696,7
3170,4,0,0,43,0.0,0.0,1.0,43,1150,800,350,0.6956521739130435,15,8,7,352.7151055908463,0.3912421557770395,0.039176595604623055,0.21431559118578924,132719.81336805545,762.4565972222119,133482.26996527766,3041,4,860.2558139534884,39,4,13,33.30974524868581,0.6420940170940173,42.39583333333333,1030.4166666666658,26.42094017094015,0
3171,4,0,0,43,0.0,0.0,1.0,43,950,800,150,0.8421052631578947,11,8,3,350.1929430316967,0.3910114433370247,0.03903780391788203,0.21324056438760838,132800.32687717,701.1474609374899,133501.4743381075,3042,5,861.2558139534884,39,4,14,33.293856324743146,0.6428952991452992,42.31770833333333,1030.7291666666656,26.428952991452963,0
3172,4,0,1,42,0.0,0.023255813953488372,0.9767441860465116,43,1250,1000,250,0.8,15,10,5,349.9958841501434,0.3910806570690291,0.0366895300666632,0.2134263256582852,132854.01611328125,699.6717664930549,133553.6878797743,3043,6,862.2558139534884,39,4,14,33.24502795459903,0.6434294871794872,42.265625,1030.9375,26.434294871794872,0
3173,4,0,0,42,0.0,0.0,1.0,42,1350,1100,250,0.8148148148148148,16,11,5,357.22065021879774,0.38874370886566006,0.03762644954354788,0.21790008056962065,132865.71905361972,1092.4757104244309,133958.19476404414,3044,43,883.6428571428571,38,4,15,33.04706390328152,0.6452850877192982,42.254273504273506,1030.9829059829062,27.131129104813322,0
3174,4,1,1,42,0.023255813953488372,0.023255813953488372,0.9767441860465116,43,1000,600,400,0.6,14,6,8,352.9364192193209,0.39271871539313397,0.04021992778630756,0.21661636733498113,133095.75195312512,794.867621527792,133890.6195746529,3045,0,864.0697674418604,39,4,15,32.92659331045158,0.6458333333333333,42.03125000000001,1031.875000000001,26.458333333333357,0
3175,4,0,0,42,0.0,0.0,1.0,42,700,500,200,0.7142857142857143,9,5,4,358.0149035057402,0.3883081687959737,0.03762448127791984,0.21925922012475876,133015.1489257814,1124.2811414930698,134139.43006727446,3046,45,885.6428571428571,39,3,15,32.876506277558974,0.6450320512820513,42.10937500000001,1031.5625000000011,26.450320512820543,0
3176,4,0,0,42,0.0,0.0,1.0,42,1000,500,500,0.5,15,5,10,349.32910304712766,0.3882234804490902,-0.014324428958574886,0.20460704607046085,131328.12500000026,776.1311848958638,132104.25618489613,3047,46,886.6428571428571,40,2,16,34.79844173441735,0.6265624999999999,43.750000000000014,1025.000000000002,25.62500000000005,3
3177,4,0,1,41,0.0,0.023809523809523808,0.9761904761904762,42,1650,1300,350,0.7878787878787878,20,13,7,350.0817652310148,0.38859852884243123,-0.0133701004730844,0.20549997405368625,131412.43128895437,801.0191837873258,132213.45047274168,3048,47,887.6428571428571,37,5,16,34.694038961964836,0.6326013513513513,43.66776315789474,1025.3289473684217,27.711593172119507,0
3178,4,0,0,41,0.0,0.0,1.0,41,1100,800,300,0.7272727272727273,14,8,6,356.01702842510514,0.3853404471544715,0.007821163210534054,0.20915426198961345,131443.57829112903,1159.2304297540882,132602.80872088313,3049,58,909.1463414634146,36,5,16,34.51044183322351,0.6348379629629629,43.63738738738739,1025.450450450451,28.484734734734747,0
3179,4,2,2,41,0.046511627906976744,0.046511627906976744,0.9534883720930233,43,1000,800,200,0.8,12,8,4,341.30271295095156,0.39168050941306753,0.01898196858106882,0.20294530519625242,131903.6740836622,403.8163625904125,132307.4904462526,3050,0,867.8139534883721,38,5,15,34.42407696307853,0.6356907894736842,43.18910256410257,1027.2435897435905,27.03272604588396,0
3180,4,2,2,41,0.046511627906976744,0.046511627906976744,0.9534883720930233,43,1050,900,150,0.8571428571428571,12,9,3,341.05955543179846,0.3926956441491325,0.01797104455517906,0.20343975658344193,132023.05230034745,405.5447048611354,132428.59700520858,3051,0,868.7674418604652,39,4,15,34.31017298466113,0.6351495726495726,43.07291666666668,1027.7083333333353,26.351495726495777,0
3181,4,0,0,41,0.0,0.0,1.0,41,650,400,250,0.6153846153846154,9,4,5,355.14920739279705,0.38358739837398376,0.013247863247862979,0.20986089527756183,131665.51246537396,1152.1804786087991,132817.69294398275,3052,61,912.1463414634146,37,4,15,34.30867165242164,0.6351351351351351,43.421052631578945,1026.3157894736842,27.738264580369844,0
3182,4,0,0,41,0.0,0.0,1.0,41,1150,700,450,0.6086956521739131,16,7,9,352.1474152625158,0.383155487804878,0.012911562570015578,0.20839469669327895,131721.78578985843,1077.0972799322872,132798.88306979073,3053,62,913.1463414634146,37,4,15,34.32893612475966,0.6356981981981982,43.36622807017544,1026.5350877192984,27.74419155998104,0
3183,4,0,0,41,0.0,0.0,1.0,41,1200,700,500,0.5833333333333334,17,7,10,353.2876079507394,0.382494918699187,0.011051910647229324,0.20968895665821427,131834.36850761753,1115.0897391504873,132949.45824676802,3054,63,914.1463414634146,37,4,16,34.18615203929106,0.6368243243243243,43.25657894736841,1026.9736842105249,27.756045519203376,0
3184,4,0,0,41,0.0,0.0,1.0,41,800,700,100,0.875,9,7,2,355.031289986793,0.38241869918699184,0.013060901400089087,0.21088003128131177,131862.52170138873,1163.0642361110922,133025.58593749983,3055,64,915.1463414634146,37,4,16,34.11299864773495,0.6371058558558559,43.22916666666666,1027.083333333332,27.75900900900897,0
3185,4,0,1,40,0.0,0.024390243902439025,0.975609756097561,41,1100,700,400,0.6363636363636364,15,7,8,342.92817775971116,0.3828760162601626,-0.03074109768453326,0.2051334008780817,132130.126953125,862.2287326388898,132992.35568576388,3056,65,916.1463414634146,39,2,17,34.15442418101993,0.6362179487179487,42.96875,1028.125,26.362179487179485,4
3186,4,0,0,40,0.0,0.0,1.0,40,1600,1300,300,0.8125,19,13,6,348.3878754946459,0.3824919871794872,-0.03826375519302805,0.20825196506703006,132103.35422092033,1204.641384548635,133307.99560546895,3057,66,914.725,39,1,17,34.04104181443579,0.6359508547008547,42.99479166666668,1028.0208333333348,26.359508547008584,0
3187,4,0,1,39,0.0,0.025,0.975,40,850,600,250,0.7058823529411765,11,6,5,347.52210974647954,0.38214476495726496,-0.04032462270839643,0.2083233630556765,132210.46142578125,1189.2116970486115,133399.67312282987,3058,67,915.725,39,1,18,33.955505756440125,0.6370192307692308,42.890625,1028.4375,26.370192307692307,0
3188,4,1,0,40,0.025,0.0,1.0,40,900,700,200,0.7777777777777778,11,7,4,342.4900844945031,0.38680555555555557,-0.01959732901659228,0.2069176036151386,132505.23003472213,1076.3454861111065,133581.57552083323,3059,0,911.275,39,1,19,33.78861459598004,0.639957264957265,42.604166666666664,1029.5833333333328,26.399572649572637,0
3189,4,0,0,40,0.0,0.0,1.0,40,950,800,150,0.8421052631578947,11,8,3,349.3103339931505,0.3871260683760684,-0.02572815533980566,0.21164096706643828,132612.5,1264.5833333333346,133877.08333333334,3060,1,912.275,39,1,19,33.50525889967636,0.641025641025641,42.5,1030.0,26.41025641025641,0
3190,4,0,0,40,0.0,0.0,1.0,40,700,400,300,0.5714285714285714,10,4,6,349.3103339931505,0.3871260683760684,-0.02572815533980566,0.21164096706643828,132612.5,1264.5833333333346,133877.08333333334,3061,2,913.275,39,1,19,33.50525889967636,0.641025641025641,42.5,1030.0,26.41025641025641,0
3191,4,0,1,39,0.0,0.025,0.975,40,1300,1000,300,0.7692307692307693,16,10,6,346.4331053277856,0.3866052350427351,-0.022771151319114002,0.21064921395253747,132746.64849175353,1197.566731770844,133944.21522352437,3062,3,914.275,39,1,16,33.44462835675056,0.642361111111111,42.36979166666667,1030.520833333334,26.423611111111125,0
3192,4,0,0,39,0.0,0.0,1.0,39,1050,600,450,0.5714285714285714,15,6,9,348.7112014554094,0.38602114260008996,-0.02650210486031357,0.21239682270465854,132810.65088757407,1462.5123274161872,134273.16321499026,3063,4,920.5128205128206,38,1,19,33.32167288557215,0.644736842105263,42.307692307692314,1030.7692307692316,27.125506072874515,0
3193,4,0,0,39,0.0,0.0,1.0,39,1100,800,300,0.7272727272727273,14,8,6,348.6564272363232,0.38543072424651376,-0.022453825437044772,0.21330349483773553,132975.88962853389,1472.579717291257,134448.46934582514,3064,5,921.5128205128206,38,1,19,33.15724052206338,0.6463815789473684,42.1474358974359,1031.4102564102566,27.14237516869096,0
3194,4,0,0,39,0.0,0.0,1.0,39,1050,500,550,0.47619047619047616,16,5,11,347.1181247251806,0.38543072424651376,0.027470166275494368,0.19749239027762738,130206.62607725464,1265.7144619828453,131472.34053923748,3065,6,922.5128205128206,37,2,18,35.98965047987393,0.6204954954954955,44.84649122807018,1020.6140350877201,27.584163110478922,6
3195,4,1,1,39,0.025,0.025,0.975,40,1350,1100,250,0.8148148148148148,16,11,5,339.0839825349923,0.3893162393162393,0.03094075346141434,0.19417611956229383,130458.54403518375,847.2925563634763,131305.8365915472,3066,0,900.425,37,3,18,35.939568351758425,0.6230292792792793,44.599780701754376,1021.6008771929812,27.610834518729224,0
3196,4,1,1,39,0.025,0.025,0.975,40,900,600,300,0.6666666666666666,12,6,6,338.29609042654505,0.3904113247863248,0.031031337196823383,0.19386488134037794,130486.54994806081,828.6179401354083,131315.1678881962,3067,0,901.4,37,3,18,35.93135150604563,0.6233108108108109,44.57236842105262,1021.7105263157885,27.613798008534822,0
3197,4,0,0,39,0.0,0.0,1.0,39,600,400,200,0.6666666666666666,8,4,4,347.14595022167487,0.3851495726495726,0.03347554786522666,0.19837848913423864,130377.57087746523,1252.0091459702835,131629.58002343553,3068,9,925.5128205128206,36,3,18,35.81569081486382,0.6241319444444444,44.67905405405405,1021.2837837837833,28.368993993993982,0
3198,4,0,0,39,0.0,0.0,1.0,39,1050,800,250,0.7619047619047619,13,8,5,343.48546926704404,0.3848965362123257,0.03308927721418353,0.1969809900368973,130514.55886667049,1165.9708996999066,131680.5297663704,3069,10,926.5128205128206,37,2,17,35.7704465786744,0.6235923423423423,44.54495614035088,1021.8201754385963,27.61676149834044,0
3199,4,0,0,39,0.0,0.0,1.0,39,1100,700,400,0.6363636363636364,15,7,8,339.198343535296,0.3855994152046784,-0.009861281627929985,0.19615639408135974,130838.01442912505,1092.0281075626217,131930.04253668766,3070,11,927.5128205128206,36,3,18,35.55288020546689,0.6287615740740742,44.2286036036036,1023.0855855855854,28.41904404404404,2
3200,4,1,0,40,0.025,0.0,1.0,40,1250,1100,150,0.88,14,11,3,330.798667698418,0.38969017094017094,-0.0003206130747575031,0.19333881912830755,131246.0064308021,683.2008136094657,131929.20724441158,3071,0,905.3,38,2,20,35.35606297570639,0.6291118421052632,43.830128205128204,1024.679487179487,26.96524966261808,0
3201,4,0,0,40,0.0,0.0,1.0,40,900,600,300,0.6666666666666666,12,6,6,334.1265119968274,0.389730235042735,0.0016260162601628991,0.1957026713124275,131328.12500000012,776.0416666666816,132104.1666666668,3072,1,906.3,38,2,20,35.18800813008131,0.6299342105263157,43.75000000000001,1025.000000000001,26.97368421052634,0
3202,4,2,2,40,0.047619047619047616,0.047619047619047616,0.9523809523809523,42,1400,1100,300,0.7857142857142857,17,11,6,321.3864905764868,0.39452671312427406,0.010667062353677759,0.19122401608226652,131927.76626222834,79.96036172253139,132007.72662395088,3073,0,864.0952380952381,40,2,16,34.91134137896924,0.6325520833333333,43.16565040650407,1027.337398373985,25.683434959349626,0
3203,4,0,0,40,0.0,0.0,1.0,40,1200,1000,200,0.8333333333333334,14,10,4,343.3664960162569,0.38924946581196584,0.050960094400343214,0.19734047323449744,130598.6036568945,995.2931580306933,131593.8968149252,3074,3,908.3,37,3,16,35.68842523063721,0.6244369369369369,44.46271929824562,1022.1491228070181,27.625651967757246,5
3204,4,1,0,41,0.024390243902439025,0.0,1.0,41,1200,800,400,0.6666666666666666,16,8,8,338.99194128337973,0.3905487804878049,0.05915779825856715,0.1965824937950837,130945.12473518902,677.86840711522,131622.99314230424,3075,0,887.1219512195122,38,3,17,35.44993910925539,0.62609649122807,44.12393162393163,1023.504273504275,26.934322986954605,0
3205,4,1,0,42,0.023809523809523808,0.0,1.0,42,650,300,350,0.46153846153846156,10,3,7,336.32270312859794,0.394683991482772,0.07041540020263426,0.19614732832098514,131163.9135437212,430.69606527138296,131594.60960899258,3076,0,866.9761904761905,38,4,18,35.2973769294952,0.6282894736842106,43.91025641025641,1024.3589743589741,26.956815114709844,2
3206,4,1,0,43,0.023255813953488372,0.0,1.0,43,950,600,350,0.631578947368421,13,6,7,333.6441741985314,0.39730989294942787,0.07887730905396761,0.19675288486231837,131587.96623904307,181.01985146228776,131768.98609050535,3077,0,847.7906976744187,36,7,16,34.93853583580287,0.6362847222222223,43.49662162162162,1026.0135135135133,28.50037537537537,0
3207,4,0,0,43,0.0,0.0,1.0,43,1050,600,450,0.5714285714285714,15,6,9,333.7223317992549,0.3972176079734219,0.0730669846948917,0.19719955969955963,131665.51246537393,187.94436749768738,131853.45683287163,3078,1,848.7906976744187,37,6,16,34.85844017094017,0.6351351351351351,43.421052631578945,1026.315789473684,27.738264580369837,0
3208,4,0,0,43,0.0,0.0,1.0,43,850,700,150,0.8235294117647058,10,7,3,331.2142393134782,0.39730989294942787,0.07458416435915827,0.1959548282834911,131711.6845642485,124.95708232885968,131836.64164657737,3079,2,849.7906976744187,38,5,16,34.876318345822924,0.6337719298245614,43.37606837606837,1026.4957264957252,27.013045434098032,0
3209,4,1,0,44,0.022727272727272728,0.0,1.0,44,1150,1000,150,0.8695652173913043,13,10,3,323.08939682543735,0.40025986610288933,0.08966783039637471,0.1931295734264227,132103.35422091998,-263.76139322918664,131839.5928276908,3080,0,831.4545454545455,39,5,18,34.691225892525416,0.6359508547008548,42.99479166666666,1028.020833333332,26.35950854700851,0
3210,4,1,2,43,0.022222222222222223,0.044444444444444446,0.9555555555555556,45,1050,600,450,0.5714285714285714,15,6,9,319.6920071175873,0.4038720538720539,0.086988390721356,0.19246143068208593,132371.85723610263,-536.3550548615386,131835.50218124109,3081,0,813.9555555555555,40,5,18,34.50914312989666,0.6369791666666667,42.73373983739837,1029.0650406504049,25.72662601626012,0
3211,4,0,0,43,0.0,0.0,1.0,43,1200,900,300,0.75,15,9,6,339.02916079879077,0.398140457733481,0.08215636913591595,0.20320639488475456,132205.65440317037,364.3144130323534,132569.96881620272,3082,2,852.6744186046511,38,5,19,34.17870004847981,0.6387061403508772,42.89529914529914,1028.4188034188028,27.06365272154744,0
3212,4,0,0,43,0.0,0.0,1.0,43,1300,900,400,0.6923076923076923,17,9,8,342.40849710698444,0.39786360280546323,0.08718576405234923,0.20628024094006123,132398.00347222213,466.8402777777682,132864.8437499999,3083,3,853.6744186046511,38,5,19,33.8984480431849,0.640625,42.70833333333333,1029.1666666666658,27.08333333333331,0
3213,4,0,0,43,0.0,0.0,1.0,43,950,700,250,0.7368421052631579,12,7,5,338.6162825341917,0.3979097452934662,0.08536944362672938,0.20474176480956932,132535.48127145867,375.73439440424954,132911.21566586292,3084,4,854.6744186046511,38,5,21,33.85794943625926,0.6419956140350878,42.57478632478632,1029.7008547008534,27.09739091318035,0
3214,4,0,0,43,0.0,0.0,1.0,43,850,400,450,0.47058823529411764,13,4,9,337.1722249961259,0.39770210409745294,0.0843047380102282,0.20416710106549327,132590.49236613337,341.16626488420246,132931.65863101758,3085,5,855.6744186046511,38,5,21,33.83990318118948,0.6425438596491229,42.521367521367516,1029.9145299145296,27.103013945119198,0
3215,4,0,0,43,0.0,0.0,1.0,43,1150,500,650,0.43478260869565216,18,5,13,336.0733330618045,0.3978174603174603,0.060395923745758306,0.20293146703111084,132484.94059938332,310.77522195420863,132795.71582133754,3086,6,856.6744186046511,36,7,22,33.97414861809962,0.6452546296296295,42.62387387387388,1029.5045045045058,28.597347347347384,1
3216,4,0,0,43,0.0,0.0,1.0,43,750,600,150,0.8,9,6,3,335.88503787918415,0.3969176818014027,0.06410924765089598,0.20328713907380153,132571.90626014545,305.78395118093005,132877.69021132638,3087,7,857.6744186046511,36,7,22,33.89169856023328,0.6461226851851851,42.53941441441442,1029.8423423423437,28.60673173173177,0
3217,4,0,0,43,0.0,0.0,1.0,43,900,500,400,0.5555555555555556,13,5,8,335.02295570282394,0.3961101882613511,0.06990604611561535,0.20335114288008643,132680.27181440472,290.18736534320794,132970.45917974794,3088,8,858.6744186046511,37,6,20,33.805165318575256,0.6452702702702702,42.4342105263158,1030.2631578947392,27.844950213371327,0
3218,4,0,0,43,0.0,0.0,1.0,43,900,800,100,0.8888888888888888,10,8,2,336.16712087044993,0.3955795496493171,0.0737098183240068,0.20419925241238687,132708.5151801519,322.4478926208339,133030.96307277275,3089,9,859.6744186046511,37,6,20,33.74736174665672,0.6455518018018016,42.40679824561405,1030.3728070175464,27.84791370317693,0
3219,4,0,0,43,0.0,0.0,1.0,43,850,500,350,0.5882352941176471,12,5,7,336.13907965774615,0.3953949796973053,0.07887033999163617,0.20449004593547973,132765.0109288438,325.501716874454,133090.51264571826,3090,10,860.6744186046511,37,6,20,33.691416640068084,0.6461148648648647,42.35197368421054,1030.5921052631604,27.85384068278812,0
3220,4,0,0,43,0.0,0.0,1.0,43,800,400,400,0.5,12,4,8,336.2752376641009,0.3954180509413068,0.07778327560613518,0.20472715246389608,132793.26331178859,331.01723607267144,133124.28054786124,3091,11,861.6744186046511,37,6,21,33.6595744680851,0.6463963963963961,42.32456140350879,1030.7017543859677,27.85680417259372,0
3221,4,0,0,43,0.0,0.0,1.0,43,750,600,150,0.8,9,6,3,343.4390227261631,0.3954180509413068,0.11100823071655164,0.19596989421385297,130320.0725007103,354.8622721274596,130674.93477283776,3092,12,862.6744186046511,36,7,22,35.96857652292194,0.6235532407407407,44.73536036036037,1021.0585585585596,28.362737737737767,5
3222,4,2,1,44,0.044444444444444446,0.022222222222222223,0.9777777777777777,45,1400,900,500,0.6428571428571429,19,9,10,334.76522138831666,0.39938973063973066,0.12568153871139898,0.19385618442909897,130890.4560687413,-236.4854993060162,130653.97056943529,3093,0,825.2888888888889,38,7,19,35.61329783531704,0.6255482456140351,44.177350427350426,1023.2905982905982,26.92869995501574,0
3223,4,0,0,44,0.0,0.0,1.0,44,1100,700,400,0.6363636363636364,15,7,8,345.26241486828076,0.3970445736434109,0.13517515489225795,0.19987523917808894,130878.94833025539,237.51635118497586,131116.46468144035,3094,1,845.0454545454545,37,7,19,35.35639019859979,0.6272522522522522,44.18859649122807,1023.2456140350871,27.655286865813164,0
3224,4,1,0,45,0.022222222222222223,0.0,1.0,45,1200,900,300,0.75,15,9,6,340.3340643877704,0.40044191919191924,0.1523087797360405,0.19862832278845577,131191.27498584622,-70.22803437067074,131121.04695147555,3095,0,827.2444444444444,38,7,21,35.16703166823097,0.6285635964912281,43.883547008547005,1024.4658119658113,26.959626630679246,0
3225,4,0,0,45,0.0,0.0,1.0,45,1150,800,350,0.6956521739130435,15,8,7,341.5509131051242,0.40018939393939396,0.1514644256943738,0.1996337689967384,131248.05908203125,-34.42111545138994,131213.63796657987,3096,1,828.2444444444444,39,6,21,35.07855121818982,0.6274038461538461,43.828125,1024.6875,26.27403846153846,0
3226,4,0,0,45,0.0,0.0,1.0,45,1400,1100,300,0.7857142857142857,17,11,6,340.607773820546,0.3991161616161616,0.15017271473384808,0.19964923149313785,131356.98356718203,-51.68480809251565,131305.29875908952,3097,2,829.2444444444444,36,9,22,34.992813724413175,0.6339699074074074,43.721846846846844,1025.1126126126126,28.47535035035035,0
3227,4,0,0,45,0.0,0.0,1.0,45,1250,800,450,0.64,17,8,9,346.05100967441444,0.3979587542087542,0.15855592145383546,0.20391492225963245,131559.0823086601,105.23065295025106,131664.31296161033,3098,3,830.2444444444444,36,9,17,34.649423710208545,0.6359953703703705,43.52477477477478,1025.9009009009014,28.497247247247262,0
3228,4,0,0,45,0.0,0.0,1.0,45,950,800,150,0.8421052631578947,11,8,3,328.7800387542636,0.39762205387205385,0.10309175794983094,0.19110461270938262,131034.66932508697,-383.6832682291478,130650.98605685783,3099,4,831.2444444444444,39,6,17,35.62088801844883,0.6252670940170939,44.03645833333334,1023.854166666668,26.252670940170976,5
3229,4,0,0,45,0.0,0.0,1.0,45,1100,900,200,0.8181818181818182,13,9,4,330.250068419779,0.3972011784511784,0.10607213346123734,0.19225476253414853,131093.85456945264,-341.24911180514687,130752.6054576475,3100,5,832.2444444444444,40,5,18,35.523551983063754,0.62421875,43.978658536585364,1024.085365853658,25.60213414634145,0
3230,4,0,0,45,0.0,0.0,1.0,45,1450,1100,350,0.7586206896551724,18,11,7,331.3487997901435,0.3973905723905724,0.10300866230245287,0.19354916567116054,131223.97898902785,-303.8184116597111,130920.16057736814,3101,6,833.2444444444444,40,5,18,35.36418038748926,0.6255208333333333,43.85162601626017,1024.5934959349606,25.614837398374014,0
3231,4,2,2,45,0.0425531914893617,0.0425531914893617,0.9574468085106383,47,1200,1000,200,0.8333333333333334,14,10,4,318.72050698976295,0.4035037002775208,0.10685811586526084,0.18819591324398693,131637.3803117306,-1008.6869247045729,130628.69338702604,3102,0,798.7446808510638,37,10,13,35.27164137906472,0.6348536036036035,43.448464912280706,1026.2061403508778,27.735301090564267,0
3232,4,1,1,45,0.021739130434782608,0.021739130434782608,0.9782608695652174,46,1200,1000,200,0.8333333333333334,14,10,4,323.6489889314109,0.400402576489533,0.09789600499107198,0.19204186923968902,131823.38271077067,-667.099093628135,131156.28361714253,3103,0,817.0869565217391,40,6,15,34.95814778162625,0.6315104166666667,43.267276422764226,1026.9308943089427,25.67327235772357,1
3233,4,0,0,45,0.0,0.0,1.0,45,1100,900,200,0.8181818181818182,13,9,4,331.09147905386135,0.39692760942760946,0.1069035179380009,0.19064653757794564,130671.89554569377,-345.8800970920128,130326.01544860176,3104,9,836.2444444444444,38,7,19,35.92803030303031,0.6233552631578946,44.39102564102565,1022.4358974358986,26.906207827260488,2
3234,4,2,3,44,0.0425531914893617,0.06382978723404255,0.9361702127659575,47,1550,1200,350,0.7741935483870968,19,12,7,318.37267468929366,0.403677150786309,0.11413910386793513,0.18622216076373774,131276.04683059032,-1041.0587695815902,130234.98806100873,3105,0,801.6170212765958,40,7,19,35.644130966547664,0.6260416666666666,43.800813008130085,1024.7967479674803,25.619918699187007,0
3235,4,2,1,45,0.043478260869565216,0.021739130434782608,0.9782608695652174,46,1050,900,150,0.8571428571428571,12,9,3,323.21014563551716,0.39848027375201284,0.12189048290493232,0.18892335643147404,131250.01161882837,-715.7329260030084,130534.27869282536,3106,0,819.7826086956521,40,6,20,35.546423022248675,0.6257812499999998,43.82621951219514,1024.695121951222,25.61737804878055,0
3236,4,0,0,45,0.0,0.0,1.0,45,1350,900,450,0.6666666666666666,18,9,9,330.97033670796077,0.3950126262626263,0.11867058304552236,0.19321258717824272,131201.04762101613,-315.2690184870105,130885.77860252911,3107,1,839.0,41,4,20,35.396997353216484,0.6237296747967478,43.874007936507944,1024.5039682539693,24.98790166473096,0
3237,4,2,1,46,0.0425531914893617,0.02127659574468085,0.9787234042553191,47,700,400,300,0.5714285714285714,10,4,6,318.5942035507566,0.4023859081097749,0.12570727619837396,0.18817686411163392,131648.6328125,-1011.2556886180398,130637.37712388196,3108,0,804.2553191489362,39,8,17,35.2635674651509,0.6314102564102565,43.4375,1026.25,26.314102564102566,0
3238,4,0,0,46,0.0,0.0,1.0,46,1550,900,650,0.5806451612903226,22,9,13,319.1351186218729,0.39923510466988726,0.11630236231589852,0.18876095191476217,131702.08875868068,-793.8476562499911,130908.2411024307,3109,1,822.7391304347826,39,7,17,35.195944117448065,0.6319444444444444,43.38541666666667,1026.4583333333344,26.31944444444447,0
3239,4,0,1,45,0.0,0.021739130434782608,0.9782608695652174,46,950,600,350,0.631578947368421,13,6,7,326.04747412617843,0.3989231078904992,0.17241164869138736,0.18425823768747326,129943.771701389,-724.5985243055466,129219.17317708346,3110,2,823.7391304347826,39,7,15,36.79335240430458,0.6143162393162394,45.10416666666667,1019.5833333333343,26.143162393162417,4
3240,4,0,0,45,0.0,0.0,1.0,45,1300,1000,300,0.7692307692307693,16,10,6,332.2293407879442,0.3961279461279461,0.17344550026679362,0.1876242676452171,129917.22140842032,-367.5374348958143,129549.6839735245,3111,3,842.9555555555555,39,6,15,36.6626860461156,0.6140491452991452,45.13020833333334,1019.4791666666681,26.14049145299149,0
3241,4,0,0,45,0.0,0.0,1.0,45,1350,800,550,0.5925925925925926,19,8,11,332.0287842444135,0.39551767676767674,0.17532629667461075,0.1878937455348444,129996.88042534729,-367.4587673611066,129629.42165798618,3112,4,843.9555555555555,39,6,15,36.587078651685395,0.6148504273504274,45.052083333333336,1019.7916666666672,26.148504273504287,0
3242,4,0,0,45,0.0,0.0,1.0,45,1050,700,350,0.6666666666666666,14,7,7,333.16882542826653,0.39581228956228953,0.17377410093169487,0.18866720472921658,130023.43885633671,-336.04871961806185,129687.39013671865,3113,5,844.9555555555555,39,6,15,36.531104245395426,0.6151175213675215,45.026041666666664,1019.8958333333326,26.151175213675195,0
3243,4,0,0,45,0.0,0.0,1.0,45,850,500,350,0.5882352941176471,12,5,7,331.72986286302125,0.39568602693602695,0.1729295344358106,0.18813019002367265,130081.09941998796,-369.6429456672774,129711.45647432069,3114,6,845.9555555555555,40,5,15,36.509389320581775,0.6140625000000002,44.96951219512194,1020.1219512195111,25.503048780487777,0
3244,4,1,1,45,0.021739130434782608,0.021739130434782608,0.9782608695652174,46,1000,800,200,0.8,12,8,4,321.66064673009055,0.3979770531400966,0.16809315286624216,0.1836389874059061,130340.40584308273,-814.7976361623464,129525.60820692038,3115,0,828.5434782608696,40,6,16,36.50394771762207,0.6166666666666667,44.71544715447154,1021.1382113821131,25.528455284552827,0
3245,4,0,0,45,0.0,0.0,1.0,45,900,700,200,0.7777777777777778,11,7,4,330.58247415077375,0.39545454545454545,0.17301650515509537,0.1882296128327875,130236.65229030342,-389.20905215149253,129847.44323815193,3116,8,847.9555555555555,40,5,16,36.38117283950617,0.615625,44.81707317073171,1020.7317073170734,25.518292682926834,0
3246,4,0,0,45,0.0,0.0,1.0,45,1200,800,400,0.6666666666666666,16,8,8,332.8273298371468,0.39499158249158245,0.18091967311593926,0.19002366420463343,130342.35161675369,-323.6980473784568,130018.65356937524,3117,9,848.9555555555555,39,6,16,36.21691063960012,0.6183226495726495,44.71354166666668,1021.1458333333351,26.18322649572654,0
3247,4,1,1,45,0.021739130434782608,0.021739130434782608,0.9782608695652174,46,1750,1200,550,0.6857142857142857,23,12,11,327.22238386404916,0.3975140901771337,0.18367783321454034,0.18895543853078922,130781.81932257592,-641.052263037864,130140.76705953805,3118,0,831.4782608695652,40,6,17,35.91592151018382,0.62109375,44.28353658536586,1022.8658536585372,25.571646341463428,0
3248,4,1,1,45,0.021739130434782608,0.021739130434782608,0.9782608695652174,46,1150,700,450,0.6086956521739131,16,7,9,324.9392677465599,0.39993961352657004,0.18065133189686766,0.18814338625302554,130885.78976014619,-694.0134633815737,130191.77629676461,3119,0,829.2391304347826,40,6,17,35.869376303505824,0.6221354166666666,44.181910569105696,1023.2723577235781,25.581808943089452,0
3249,4,1,1,45,0.021739130434782608,0.021739130434782608,0.9782608695652174,46,1800,1300,500,0.7222222222222222,23,13,10,321.6041475533992,0.3977757648953301,0.17788542453339073,0.1869683662204558,131041.82287535544,-771.2812520655514,130270.54162328989,3120,0,830.2173913043479,40,6,17,35.79735318444999,0.6236979166666666,44.029471544715456,1023.8821138211395,25.597052845528488,0
3250,4,0,0,45,0.0,0.0,1.0,45,1150,1000,150,0.8695652173913043,13,10,3,329.27339359944347,0.39364478114478113,0.1865413467478596,0.1910392638441014,130963.79469892281,-375.4213761649577,130588.37332275785,3121,3,849.6666666666666,40,5,17,35.679772306063015,0.6229166666666666,44.10569105691058,1023.5772357723595,25.589430894308986,0
3251,4,0,0,45,0.0,0.0,1.0,45,1200,700,500,0.5833333333333334,17,7,10,327.75341702386993,0.3933291245791246,0.18377663093820362,0.19067225346030695,131067.83743142328,-408.4136839843785,130659.4237474389,3122,4,850.6666666666666,40,5,18,35.61371079793571,0.6239583333333333,44.00406504065042,1023.9837398373998,25.599593495934993,0
3252,4,0,0,45,0.0,0.0,1.0,45,1400,1100,300,0.7857142857142857,17,11,6,330.6872929815233,0.39318181818181813,0.1901165994401468,0.1931627629107599,131223.97898902764,-321.17952277083714,130902.79946625681,3123,5,851.6666666666666,40,5,18,35.381124776830006,0.6255208333333333,43.85162601626016,1024.593495934959,25.614837398373975,0
3253,4,0,0,45,0.0,0.0,1.0,45,1100,800,300,0.7272727272727273,14,8,6,329.44512884565273,0.3935395622895623,0.18354346844500058,0.19337522333527396,131410.26925131492,-341.42276019427874,131068.84649112064,3124,6,852.6666666666666,38,7,18,35.22520058351568,0.6307565789473684,43.669871794871796,1025.320512820513,26.982118758434552,0
3254,4,0,0,45,0.0,0.0,1.0,45,850,500,350,0.5882352941176471,12,5,7,331.8910303854771,0.3931607744107744,0.19146616671874472,0.1953700663844859,131519.83486969466,-269.94929779384825,131249.8855719008,3125,7,853.6666666666666,38,7,19,35.05212130680831,0.6318530701754386,43.56303418803419,1025.7478632478633,26.99336482231219,0
3255,4,0,0,45,0.0,0.0,1.0,45,1350,900,450,0.6666666666666666,18,9,9,335.95119030398024,0.3931186868686869,0.20171402796571947,0.198614343707713,131684.2689043209,-152.1026234568024,131532.1662808641,3126,8,854.6666666666666,38,7,18,34.78236355435272,0.6334978070175439,43.40277777777777,1026.3888888888882,27.010233918128637,0
3256,4,0,0,45,0.0,0.0,1.0,45,1500,1000,500,0.6666666666666666,20,10,10,330.7731435622476,0.393476430976431,0.19895302478765764,0.1966842161627095,131903.67408366213,-273.96141518738165,131629.71266847476,3127,9,855.6666666666666,38,7,18,34.694487779511164,0.6356907894736842,43.18910256410256,1027.24358974359,27.032726045883948,0
3257,4,1,1,45,0.021739130434782608,0.021739130434782608,0.9782608695652174,46,700,300,400,0.42857142857142855,11,3,8,324.204527140568,0.3969605475040258,0.18948504471168692,0.1939332535077216,132130.126953125,-632.562934027777,131497.56401909722,3128,0,838.0434782608696,39,7,18,34.6356805133401,0.6362179487179487,42.96875,1028.125,26.362179487179485,0
3258,4,0,0,45,0.0,0.0,1.0,45,1000,600,400,0.6,14,6,8,329.4152932319711,0.3928030303030303,0.19076253585204217,0.1962709504931326,131979.97352972772,-304.75566379138934,131675.21786593634,3129,11,857.6666666666666,40,5,18,34.652647281838256,0.6330729166666667,43.114837398373986,1027.5406504065045,25.68851626016261,0
3259,4,0,0,45,0.0,0.0,1.0,45,900,500,400,0.5555555555555556,13,5,8,331.2778213126902,0.392739898989899,0.19186445147679287,0.1975165878015285,132006.0810364201,-253.86261484566717,131752.21842157445,3130,12,858.6666666666666,40,5,18,34.578553533755255,0.6333333333333333,43.08943089430894,1027.642276422764,25.691056910569102,0
3260,4,0,0,45,0.0,0.0,1.0,45,800,500,300,0.625,11,5,6,344.9262297521465,0.3925715488215488,0.16459463217911274,0.20116500552698163,131163.91354372108,89.44351994932454,131253.3570636704,3131,13,859.6666666666666,38,7,17,35.07704943679599,0.6282894736842106,43.9102564102564,1024.3589743589732,26.956815114709823,4
3261,4,0,0,45,0.0,0.0,1.0,45,900,300,600,0.3333333333333333,15,3,12,345.3632097296583,0.3926767676767677,0.17289972899729,0.2022841656987997,131328.12499999988,71.38601249176725,131399.51101249165,3132,14,860.6666666666666,36,9,17,34.9000677506775,0.6336805555555556,43.74999999999999,1024.999999999999,28.472222222222197,0
3262,4,0,0,45,0.0,0.0,1.0,45,1350,700,650,0.5185185185185185,20,7,13,318.1352071349438,0.3926767676767677,0.18332284802931542,0.18395560770979186,130833.79937743722,-671.0921491836982,130162.70722825352,3133,15,861.6666666666666,40,5,16,36.095866030926146,0.6216145833333333,44.23272357723577,1023.0691056910556,25.57672764227639,5
3263,4,0,2,43,0.0,0.044444444444444446,0.9555555555555556,45,1500,1200,300,0.8,18,12,6,316.2203755001542,0.3918139730639731,0.11792072774528961,0.17671138630890945,129504.14540816307,-808.6980138327569,128695.4473943303,3134,16,862.6666666666666,41,4,15,37.4890350877193,0.6067073170731708,45.53571428571428,1017.8571428571413,24.825783972125397,4
3264,4,1,1,43,0.022727272727272728,0.022727272727272728,0.9772727272727273,44,1250,900,350,0.72,16,9,7,320.99015541770746,0.3973749119097956,0.11172654690618744,0.17988374481462135,129614.99851279006,-478.97229658271726,129136.02621620733,3135,0,837.25,40,4,16,37.255281104457744,0.609375,45.426829268292686,1018.2926829268297,25.457317073170742,0
3265,4,0,0,43,0.0,0.0,1.0,43,1200,800,400,0.6666666666666666,16,8,8,321.24467511016223,0.3930417128091546,0.10134365378234733,0.18038293437698338,129692.6239031826,-267.3870340075349,129425.23686917506,3136,18,857.7209302325581,40,3,17,37.17013369250726,0.61015625,45.35060975609756,1018.5975609756094,25.464939024390237,0
3266,4,0,0,43,0.0,0.0,1.0,43,950,700,250,0.7368421052631579,12,7,5,324.3645667220097,0.39334163898117386,0.10762568970755715,0.18261670468958968,129796.16057117128,-179.7449228303244,129616.41564834095,3137,19,858.7209302325581,40,3,17,36.98576343871548,0.6111979166666668,45.2489837398374,1019.0040650406505,25.47510162601626,0
3267,4,1,0,44,0.022727272727272728,0.0,1.0,44,1050,700,350,0.6666666666666666,14,7,7,317.2849877450449,0.3972758104298802,0.13862771534251683,0.1760613881645353,129226.60506621632,-590.6798300371697,128635.92523617914,3138,0,840.1818181818181,41,3,15,37.74341805704622,0.6039126016260162,45.80853174603175,1016.7658730158731,24.79916763453349,4
3268,4,0,0,44,0.0,0.0,1.0,44,1050,600,450,0.5714285714285714,15,6,9,317.9278254529485,0.3970886187455955,0.1383124484529228,0.1766438015565407,129277.04480229584,-579.8460530045395,128697.1987492913,3139,1,841.1818181818181,41,3,15,37.67589747341722,0.6044207317073171,45.75892857142857,1016.9642857142851,24.8040069686411,0
3269,4,1,1,44,0.022222222222222223,0.022222222222222223,0.9777777777777777,45,1050,600,450,0.5714285714285714,15,6,9,313.56061946431555,0.40117845117845113,0.14063990692262984,0.1753035820900815,129521.75842985687,-877.4154385253389,128644.34299133153,3140,0,823.4666666666667,42,3,12,37.53887037918452,0.605406746031746,45.518410852713174,1017.9263565891464,24.236341823551104,0
3270,4,0,0,44,0.0,0.0,1.0,44,1300,1000,300,0.7692307692307693,16,10,6,318.8262294894431,0.3973418780831572,0.14189093390282626,0.17805325467241137,129478.9021656116,-543.7459648211138,128935.15620079049,3141,3,843.1818181818181,41,3,12,37.44831773727134,0.6064532520325203,45.56051587301587,1017.7579365079364,24.82336430507162,0
3271,4,1,1,44,0.022222222222222223,0.022222222222222223,0.9777777777777777,45,1350,1000,350,0.7407407407407407,17,10,7,311.1992744254374,0.40061026936026933,0.1424564296056734,0.17486039401574688,129719.10609526178,-926.3016608076352,128792.80443445416,3142,0,825.4222222222222,42,3,13,37.39913281968357,0.607390873015873,45.32461240310078,1018.7015503875975,24.254798818752324,0
3272,4,0,0,44,0.0,0.0,1.0,44,950,700,250,0.7368421052631579,12,7,5,307.4471981060907,0.3965931113460183,0.11498282106045088,0.1739831254022331,129996.88042534745,-806.5646701388687,129190.31575520858,3143,5,845.1818181818181,43,1,12,37.21378106911814,0.6087693798449612,45.05208333333334,1019.7916666666686,23.716085271317873,1
3273,4,0,1,43,0.0,0.022727272727272728,0.9772727272727273,44,1350,1000,350,0.7407407407407407,17,10,7,304.1827883793576,0.39695648343904155,0.12469424248047334,0.17309831537237175,130214.25637769769,-878.2128816574595,129336.04349604023,3144,6,846.1818181818181,43,1,13,37.07745716583163,0.6109496124031006,44.83901515151516,1020.6439393939414,23.735905567300964,0
3274,4,1,1,43,0.022727272727272728,0.022727272727272728,0.9772727272727273,44,650,400,250,0.6153846153846154,9,4,5,306.41722418380937,0.39678030303030304,0.13659984988299678,0.1751563199873579,130389.20899667732,-809.2821681109745,129579.92682856634,3145,0,846.3409090909091,41,3,14,36.843836004532946,0.615599593495935,44.66765873015873,1021.3293650793647,24.910472319008896,0
3275,4,0,0,43,0.0,0.0,1.0,43,1100,700,400,0.6363636363636364,15,7,8,306.8593609336092,0.3959948320413436,0.14140928556622345,0.17606848859661803,130534.75320743937,-588.8378102277616,129945.9153972116,3146,1,862.5813953488372,42,1,12,36.68571022188507,0.615575396825397,44.52519379844961,1021.8992248062008,24.33093392395716,0
3276,4,0,0,43,0.0,0.0,1.0,43,1500,1200,300,0.8,18,12,6,309.43815702271763,0.3956949058693245,0.14599679108556507,0.17823097341177468,130683.32732407894,-512.3184078481029,130171.00891623084,3147,2,863.5813953488372,42,1,14,36.46998199393479,0.6170634920634921,44.3798449612403,1022.4806201550376,24.344776670358037,0
3277,4,0,0,43,0.0,0.0,1.0,43,1400,900,500,0.6428571428571429,19,9,10,309.40448526313907,0.39594868955334067,0.14546447750410807,0.17889882559738346,130831.98594585655,-503.9993464936066,130327.98659936294,3148,3,864.5813953488372,42,1,14,36.32099671654985,0.6185515873015873,44.234496124031004,1023.0620155038754,24.358619416758938,0
3278,4,0,0,43,0.0,0.0,1.0,43,700,400,300,0.5714285714285714,10,4,6,309.4468672226295,0.39571797711332596,0.1467135555785548,0.17926869801087142,130906.34694617194,-498.2882075897055,130408.05873858223,3149,4,865.5813953488372,42,1,14,36.244989426506315,0.619295634920635,44.16182170542635,1023.3527131782932,24.36554078995936,0
3279,4,0,0,43,0.0,0.0,1.0,43,800,400,400,0.5,12,4,8,313.06322645504645,0.39594868955334067,0.14852989089756363,0.18171428155335767,130980.72907277194,-398.95007060874894,130581.7790021632,3150,5,866.5813953488372,42,1,14,36.077519563296725,0.6200396825396826,44.0891472868217,1023.6434108527121,24.372462163159813,0
3280,4,0,0,43,0.0,0.0,1.0,43,1000,800,200,0.8,12,8,4,311.967987458953,0.39590254706533773,0.14996665793684172,0.18142904366971666,131055.1323256563,-422.9988244396583,130632.13350121665,3151,6,867.5813953488372,42,1,14,36.03060629002239,0.6207837301587302,44.01647286821704,1023.9341085271302,24.379383536360244,0
3281,4,0,1,42,0.0,0.023255813953488372,0.9767441860465116,43,1150,700,450,0.6086956521739131,16,7,9,312.6346996449335,0.39551033591731266,0.14971095214212204,0.1824047486007856,131179.1846944293,-397.76699867797237,130781.41769575134,3152,7,868.5813953488372,42,1,14,35.88862876781435,0.6220238095238095,43.8953488372093,1024.418604651162,24.390919158361,0
3282,4,0,0,42,0.0,0.0,1.0,42,600,400,200,0.6666666666666666,8,4,4,312.9640585090972,0.3944662214479288,0.1352771937589916,0.18282199073992925,131226.45817586262,-186.1670131015685,131040.29116276104,3153,8,855.2619047619048,41,1,14,35.8326071520785,0.6239837398373985,43.849206349206334,1024.603174603172,24.99032133178468,0
3283,4,1,1,42,0.023255813953488372,0.023255813953488372,0.9767441860465116,43,900,800,100,0.8888888888888888,10,8,2,308.22781321952544,0.39767903285345146,0.13268447012556228,0.18135583118002618,131501.99549493694,-493.48549891835694,131008.50999601859,3154,0,836.3488372093024,42,1,14,35.67686191151,0.625248015873016,43.580426356589136,1025.6782945736413,24.42091177556289,0
3284,4,0,0,42,0.0,0.0,1.0,42,1000,700,300,0.7,13,7,6,310.10028357532576,0.39488966318234614,0.0607736501956786,0.18175372227915795,131354.1679576474,-238.75714890343363,131115.41080874397,3155,10,857.2619047619048,40,2,17,35.777485872905714,0.6268229166666668,43.724593495934954,1025.1016260162592,25.62754065040648,4
3285,4,0,0,42,0.0,0.0,1.0,42,1250,900,350,0.72,16,9,7,308.5490315832239,0.39462349980642664,0.06036518832612847,0.18204920899402624,131607.91175555848,-278.50125582642397,131329.41049973207,3156,11,858.2619047619048,41,1,12,35.562195849044436,0.6277947154471545,43.47718253968253,1026.091269841268,25.026616337591904,0
3286,4,0,0,42,0.0,0.0,1.0,42,1250,800,450,0.64,17,8,9,309.3636758154329,0.3940911730545877,0.06253624589213258,0.18289580514208395,131684.26890432098,-252.3341049382699,131431.93479938273,3157,12,859.2619047619048,41,1,12,35.46459179070816,0.6285569105691057,43.40277777777778,1026.388888888889,25.03387533875339,0
3287,4,0,0,42,0.0,0.0,1.0,42,600,300,300,0.5,9,3,6,311.4337324091577,0.39399438637243517,0.06491373360938568,0.18461277952089244,131786.1128826531,-191.47179705214955,131594.64108560095,3158,13,860.2619047619048,41,1,14,35.30917874396135,0.6295731707317073,43.30357142857143,1026.7857142857147,25.04355400696865,0
3288,4,0,0,42,0.0,0.0,1.0,42,1300,1000,300,0.7692307692307693,16,10,6,325.71212367675776,0.39336527293844364,0.03609336077114733,0.187604493943076,130683.3273240792,113.02881437414828,130796.35613845335,3159,14,861.2619047619048,42,0,14,36.053986606014675,0.6170634920634921,44.379844961240316,1022.4806201550397,24.344776670358087,7
3289,4,0,0,42,0.0,0.0,1.0,42,1050,700,350,0.6666666666666666,14,7,7,331.4809434170883,0.3934620596205962,0.03220624994360044,0.19117212441660944,130732.87080854525,267.0910702481879,130999.96187879345,3160,15,862.2619047619048,42,0,14,35.8564683216474,0.6175595238095237,44.33139534883721,1022.6744186046519,24.349390919158377,0
3290,4,0,0,42,0.0,0.0,1.0,42,1100,900,200,0.8181818181818182,13,9,4,330.3043820294507,0.3932684862562911,0.0312243480457155,0.19098322373860596,130831.98594585674,242.87565350640747,131074.86159936315,3161,16,863.2619047619048,42,0,14,35.78644945381068,0.6185515873015872,44.23449612403101,1023.0620155038769,24.358619416758973,0
3291,4,1,1,42,0.023255813953488372,0.023255813953488372,0.9767441860465116,43,850,600,250,0.7058823529411765,11,6,5,326.6970734000073,0.39712532299741604,0.040495005859647826,0.19026541996882526,131109.82090973682,-33.36104295796292,131076.45986677887,3162,0,844.1627906976744,43,0,15,35.59841655108645,0.6199127906976742,43.963068181818194,1024.1477272727293,23.81738900634254,0
3292,4,0,0,42,0.0,0.0,1.0,42,1500,1200,300,0.8,18,12,6,333.9724627186954,0.3923248161053039,0.05017344686218839,0.19460247689837995,131129.55670482558,358.73219758429195,131488.28890240987,3163,18,865.2619047619048,42,0,16,35.392226426994654,0.6215277777777777,43.94379844961241,1024.2248062015515,24.38630490956075,0
3293,4,0,1,41,0.0,0.023809523809523808,0.9761904761904762,42,1200,800,400,0.6666666666666666,16,8,8,334.7138627463546,0.393244289585753,0.04898332252719584,0.19579279935870847,131278.46884201677,388.14468030768035,131666.61352232445,3164,19,866.2619047619048,42,0,16,35.22302855521937,0.623015873015873,43.798449612403104,1024.806201550388,24.40014765596162,0
3294,4,0,0,41,0.0,0.0,1.0,41,900,600,300,0.6666666666666666,12,6,6,340.49943738704974,0.3928861788617886,0.042542079034352476,0.19957105316229923,131354.16795764753,745.2134470643721,132099.3814047119,3165,20,839.9268292682926,40,1,17,34.99843032285781,0.6268229166666666,43.72459349593496,1025.10162601626,25.6275406504065,0
3295,4,0,0,41,0.0,0.0,1.0,41,1550,1200,350,0.7741935483870968,19,12,7,344.1872484241938,0.3930132113821138,0.03208695715214427,0.20255871127378372,131510.47992473072,852.846044847656,132363.32596957838,3166,21,840.9268292682926,40,1,17,34.74623501436642,0.6283854166666667,43.57215447154472,1025.7113821138216,25.64278455284554,0
3296,4,0,0,41,0.0,0.0,1.0,41,850,500,350,0.5882352941176471,12,5,7,342.57236975403237,0.39291158536585363,0.02882659102002183,0.20174594517486621,131536.54095611093,812.156908916666,132348.69786502759,3167,22,841.9268292682926,40,1,17,34.7613681394888,0.6286458333333333,43.54674796747968,1025.8130081300826,25.645325203252064,0
3297,4,1,1,41,0.023809523809523808,0.023809523809523808,0.9761904761904762,42,1250,800,450,0.64,17,8,9,332.1722956267065,0.39747870692992643,0.033846691690586406,0.19717016079860458,131837.04963466869,358.523085159989,132195.57271982866,3168,0,822.8571428571429,41,1,16,34.725576378155594,0.6300813008130082,43.25396825396825,1026.984126984127,25.048393341076267,0
3298,4,0,0,41,0.0,0.0,1.0,41,750,600,150,0.8,9,6,3,335.6685536667716,0.3930894308943089,0.026614124175099674,0.1986284745511459,131719.04047070196,642.7879610350956,132361.82843173706,3169,24,843.9268292682926,40,1,16,34.75460350460349,0.63046875,43.36890243902439,1026.5243902439024,25.663109756097562,0
3299,4,0,1,40,0.0,0.024390243902439025,0.975609756097561,41,900,500,400,0.5555555555555556,13,5,8,335.1448310751889,0.3922002032520325,0.02276202841247832,0.1988013837512481,131811.58002842343,635.1939444759403,132446.77397289936,3170,25,844.9268292682926,41,0,16,34.67489050977362,0.6298272357723577,43.27876984126984,1026.8849206349207,25.045973674022456,0
3300,4,1,0,41,0.024390243902439025,0.0,1.0,41,900,700,200,0.7777777777777778,11,7,4,336.158663326291,0.3940548780487805,0.039951120623282765,0.200475969683192,132015.40577168346,675.6244685373913,132691.03024022086,3171,0,844.6341463414634,41,0,17,34.44378077034463,0.6318597560975611,43.08035714285713,1027.6785714285697,25.06533101045292,0
3301,4,0,0,41,0.0,0.0,1.0,41,1300,1200,100,0.9230769230769231,14,12,2,331.969948992952,0.3936229674796748,0.034403378197070955,0.19837788993454242,132091.8810232425,570.1070011337699,132661.98802437625,3172,1,845.6341463414634,41,0,17,34.47452229299363,0.6326219512195121,43.00595238095237,1027.9761904761892,25.07259001161437,0
3302,4,0,0,41,0.0,0.0,1.0,41,1600,1300,300,0.8125,19,13,6,330.0915809116697,0.3927845528455285,0.029446155366348092,0.197921308230843,132219.3889853393,528.9014274691178,132748.29041280842,3173,2,846.6341463414634,41,0,17,34.394693900517666,0.6338922764227644,42.881944444444436,1028.4722222222206,25.08468834688343,0
3303,4,0,1,40,0.0,0.024390243902439025,0.975609756097561,41,700,300,400,0.42857142857142855,11,3,8,328.16954839003256,0.3929623983739838,0.03062599822642076,0.19703474506405574,132270.40939350254,481.4241032060734,132751.83349670863,3174,3,847.6341463414634,41,0,17,34.39288182724146,0.6344004065040652,42.83234126984126,1028.6706349206331,25.08952768099105,0
3304,4,1,0,41,0.024390243902439025,0.0,1.0,41,1000,700,300,0.7,13,7,6,330.3851539167925,0.39435975609756097,0.057810702440949546,0.20000735661844538,132581.09941998817,560.6268995393419,133141.72631952752,3175,0,846.6341463414634,40,1,18,34.024077363331365,0.6390625,42.53048780487805,1029.8780487804881,25.746951219512205,0
3305,4,0,1,40,0.0,0.024390243902439025,0.975609756097561,41,1600,1300,300,0.8125,19,13,6,330.06370060216375,0.39451219512195124,0.051880345493229285,0.20047026868152473,132704.48022959183,560.1863662131507,133264.66659580497,3176,1,847.6341463414634,41,0,14,33.90862699788176,0.6387195121951219,42.410714285714285,1030.357142857143,25.130662020905923,0
3306,4,0,0,40,0.0,0.0,1.0,40,300,200,100,0.6666666666666666,4,2,2,337.58724467700205,0.39115918803418803,0.045110519044799346,0.2043673319926366,132581.09941998805,951.537609888282,133532.63702987632,3177,6,869.8,40,0,18,33.83864548384973,0.6390625000000001,42.53048780487804,1029.8780487804872,25.74695121951218,0
3307,4,0,0,40,0.0,0.0,1.0,40,1050,800,250,0.7619047619047619,13,8,5,340.5903976915094,0.3912526709401709,0.03630018743217889,0.20661668829436475,132659.6078413149,1036.5177184546362,133696.12555976954,3178,7,870.8,40,0,15,33.68250797408832,0.6398437499999999,42.45426829268293,1030.1829268292697,25.754573170731742,0
3308,4,0,1,39,0.0,0.025,0.975,40,1050,900,150,0.8571428571428571,12,9,3,343.4938824948656,0.39026442307692305,0.04093531209939849,0.20896049564369745,132764.32188388222,1120.7464761385697,133885.06836002078,3179,8,871.8,40,0,15,33.50261315452125,0.6408854166666667,42.35264227642278,1030.5894308943111,25.764735772357778,0
3309,4,0,0,39,0.0,0.0,1.0,39,1200,800,400,0.6666666666666666,16,8,8,350.3566193241909,0.3851495726495726,0.0404326291317092,0.2130349130285326,132746.6484917537,1501.733398437524,134248.38189019123,3180,35,894.9487179487179,39,0,15,33.34354678392129,0.6423611111111109,42.36979166666668,1030.5208333333353,26.42361111111116,0
3310,4,0,0,39,0.0,0.0,1.0,39,900,700,200,0.7777777777777778,11,7,4,346.9451856093191,0.38554318488529016,0.04310635145147179,0.21171784507774627,132880.8648003474,1420.475260416687,134301.34006076408,3181,36,895.9487179487179,39,0,17,33.29670977301812,0.6436965811965811,42.23958333333334,1031.041666666668,26.436965811965848,2
3311,4,0,0,39,0.0,0.0,1.0,39,800,500,300,0.625,11,5,6,347.7256267144126,0.385768106162843,0.036459870836764274,0.21280464497689217,132988.2866753473,1448.6870659722317,134436.97374131953,3182,37,896.9487179487179,39,0,17,33.16880428196324,0.6447649572649572,42.13541666666667,1031.4583333333342,26.447649572649595,0
3312,4,0,0,39,0.0,0.0,1.0,39,600,400,200,0.6666666666666666,8,4,4,354.4691807930704,0.385768106162843,0.10225023196138805,0.2024016849004211,130346.55044100122,1467.6984144159899,131814.24885541722,3183,38,897.9487179487179,37,2,19,35.660165897133034,0.621903153153153,44.70942982456141,1021.1622807017557,27.59898055950691,5
3313,4,1,1,39,0.025,0.025,0.975,40,1350,1000,350,0.7407407407407407,17,10,7,347.0870429475578,0.387633547008547,0.09618679481821979,0.20013958886108585,130726.51855504428,1074.6961520198788,131801.21470706415,3184,0,876.475,38,2,16,35.46389643404373,0.6239035087719298,44.33760683760684,1022.6495726495733,26.9118308591993,0
3314,4,0,1,38,0.0,0.02564102564102564,0.9743589743589743,39,850,500,350,0.5882352941176471,12,5,7,353.1661313921485,0.3848684210526316,0.09409868618277928,0.20311954614244315,130626.6245984343,1426.5799332487131,132053.204531683,3185,40,899.9487179487179,37,2,16,35.40962762344026,0.6247184684684683,44.43530701754387,1022.2587719298258,27.62861545756286,0
3315,4,1,1,38,0.02564102564102564,0.02564102564102564,0.9743589743589743,39,900,500,400,0.5555555555555556,13,5,8,352.47719871238803,0.3864428699955016,0.08856060168888358,0.20390357973870402,130850.90033712308,1424.3917599646124,132275.2920970877,3186,0,880.0,37,2,18,35.200206301575385,0.6269707207207207,44.21600877192983,1023.1359649122817,27.65232337600761,0
3316,4,0,0,38,0.0,0.0,1.0,38,900,500,400,0.5555555555555556,13,5,8,359.76554821173085,0.38301623992413464,0.09866755496335755,0.20805028679208012,130838.01442912531,1814.2019976057402,132652.21642673106,3187,42,904.1578947368421,36,2,18,35.02682993946065,0.628761574074074,44.22860360360362,1023.0855855855875,28.4190440440441,0
3317,4,0,0,38,0.0,0.0,1.0,38,550,300,250,0.5454545454545454,8,3,5,359.47156407881556,0.3829866050260787,0.09566297718545291,0.20819108367012107,130895.626940285,1810.651149460288,132706.2780897453,3188,43,905.1578947368421,36,2,18,34.97601885477424,0.6293402777777777,44.172297297297305,1023.3108108108117,28.425300300300325,0
3318,4,0,0,38,0.0,0.0,1.0,38,800,400,400,0.5,12,4,8,359.784871154846,0.3822605500237079,0.09613986234731087,0.20904239838038566,131019.23338190601,1827.7476002231522,132846.98098212917,3189,44,906.1578947368421,37,1,18,34.84289654064475,0.6286599099099099,44.0515350877193,1023.7938596491231,27.670104314841165,0
3319,4,1,1,38,0.02564102564102564,0.02564102564102564,0.9743589743589743,39,1650,1400,250,0.8484848484848485,19,14,5,353.61666987423195,0.38585245164192533,0.09587418569454487,0.207727581448732,131440.53939673727,1496.2768592258947,132936.81625596317,3190,0,883.8974358974359,37,2,19,34.575046335899636,0.632882882882883,43.64035087719297,1025.4385964912267,27.714556661925045,0
3320,4,0,0,38,0.0,0.0,1.0,38,300,200,100,0.6666666666666666,4,2,2,361.01550726294903,0.3820382882882883,0.10070731075495276,0.21114211081849302,131271.93583602633,1878.2409010464567,133150.1767370728,3191,46,908.1578947368421,37,1,19,34.55578143947497,0.6311936936936938,43.8048245614035,1024.7807017543848,27.69677572309148,0
3321,4,0,0,38,0.0,0.0,1.0,38,850,600,250,0.7058823529411765,11,6,5,361.48416474473476,0.38229018492176386,0.1052941209586169,0.21188184678360633,131356.22409058534,1896.6389898814741,133252.8630804668,3192,47,909.1578947368421,37,1,19,34.45856508717509,0.6320382882882885,43.72258771929823,1025.1096491228052,27.70566619250825,0
3322,4,0,0,38,0.0,0.0,1.0,38,950,500,450,0.5263157894736842,14,5,9,363.62320778279366,0.38211237553342814,0.11284185761162613,0.21344887733690512,131412.43128895407,1956.921961565074,133369.35325051914,3193,48,910.1578947368421,37,1,19,34.346928136028225,0.6326013513513514,43.667763157894726,1025.3289473684194,27.711593172119443,0
3323,4,0,0,38,0.0,0.0,1.0,38,950,500,450,0.5263157894736842,14,5,9,363.0330249696536,0.38162339971550496,0.10743457617965424,0.2138877192453446,131553.00188519518,1951.6168436441712,133504.61872883936,3194,49,911.1578947368421,37,1,19,34.22001923899102,0.6340090090090091,43.53070175438595,1025.877192982454,27.72641062114741,0
3324,4,0,0,38,0.0,0.0,1.0,38,1000,700,300,0.7,13,7,6,360.90306922575854,0.38051209103840683,0.11506586678211383,0.21341842267986902,131693.64762474992,1905.7283250615549,133599.37594981148,3195,50,912.1578947368421,37,1,15,34.13263807285546,0.6354166666666667,43.39364035087719,1026.4254385964912,27.74122807017544,0
3325,4,1,0,39,0.02564102564102564,0.0,1.0,39,950,700,250,0.7368421052631579,12,7,5,349.8709606723443,0.38467161493477287,0.11925835312177702,0.20894528321717093,132068.34781804736,1441.3759451019057,133509.72376314926,3196,0,889.7435897435897,38,1,16,34.038171707722675,0.6373355263157894,43.02884615384615,1027.8846153846155,27.049595141700408,0
3326,4,0,0,39,0.0,0.0,1.0,39,1100,800,300,0.7272727272727273,14,8,6,352.81765324184136,0.38492465137201975,0.11763013632949271,0.21147090473885197,132205.65440317037,1528.8977463656865,133734.55214953606,3197,1,890.7435897435897,38,1,16,33.82419142599903,0.6387061403508772,42.89529914529914,1028.4188034188028,27.06365272154744,0
3327,4,1,0,40,0.025,0.0,1.0,40,450,200,250,0.4444444444444444,7,2,5,346.32076236465997,0.3891559829059829,0.12128918413950585,0.20878937575851889,132425.49332493235,1172.479385820718,133597.97271075306,3198,0,869.45,38,2,17,33.77015431458028,0.6408991228070176,42.681623931623925,1029.2735042735035,27.086144849302723,0
3328,4,0,0,40,0.0,0.0,1.0,40,1050,800,250,0.7619047619047619,13,8,5,345.26890908780746,0.38876869658119656,0.1167029887920299,0.20845934887030768,132480.48159105846,1148.2782708744164,133628.75986193286,3199,1,870.45,38,2,17,33.74195724366956,0.6414473684210527,42.628205128205124,1029.487179487179,27.09176788124155,0
3329,4,0,0,40,0.0,0.0,1.0,40,1450,1000,450,0.6896551724137931,19,10,9,347.474432215312,0.38848824786324787,0.12500000000000022,0.21071374059245518,132645.51487508212,1218.184993425373,133863.6998685075,3200,2,871.45,38,2,14,33.51936838830118,0.6430921052631579,42.467948717948715,1030.1282051282046,27.108636977058016,0
3330,4,0,0,40,0.0,0.0,1.0,40,1550,1300,250,0.8387096774193549,18,13,5,348.07398856345134,0.3877403846153846,0.13294818652849738,0.21232073259401438,132865.71905361972,1249.420154868877,134115.1392084886,3201,3,872.45,38,2,14,33.282815198618316,0.6452850877192982,42.254273504273506,1030.9829059829062,27.131129104813322,0
3331,4,0,0,40,0.0,0.0,1.0,40,850,600,250,0.7058823529411765,11,6,5,349.36211146660514,0.387900641025641,0.12776108578532952,0.2134204493592198,132920.79863393964,1287.4981737161183,134208.29680765577,3202,4,873.45,38,2,14,33.19432932725514,0.6458333333333334,42.2008547008547,1031.196581196581,27.136752136752133,0
3332,4,0,1,39,0.0,0.025,0.975,40,1050,800,250,0.7619047619047619,13,8,5,348.98282308070566,0.3875534188034188,0.13065568676196393,0.21350317959576232,132975.88962853374,1281.2602728467987,134257.14990138053,3203,5,874.45,38,2,14,33.148824321524756,0.6463815789473685,42.14743589743589,1031.4102564102554,27.142375168690933,0
3333,4,0,0,39,0.0,0.0,1.0,39,700,600,100,0.8571428571428571,8,6,2,350.84705374818907,0.3853744939271255,0.13516444589770882,0.21521973766430608,133075.95245652492,1537.8611688211572,134613.81362534608,3204,6,881.4358974358975,37,2,15,33.00035423308537,0.6492117117117118,42.05043859649122,1031.7982456140337,27.88643907064956,0
3334,4,0,1,38,0.0,0.02564102564102564,0.9743589743589743,39,750,400,350,0.5333333333333333,11,4,7,352.51321427330674,0.38548695456590193,0.13333551299761104,0.21640586167815298,133104.23790252753,1584.2005472837632,134688.4384498113,3205,7,882.4358974358975,37,2,15,32.92899709559735,0.6494932432432433,42.023026315789465,1031.9078947368407,27.889402560455153,0
3335,4,0,0,38,0.0,0.0,1.0,38,1250,900,350,0.72,16,9,7,357.1090592576126,0.38005275011853956,0.14168604818100894,0.21951069940281806,133152.4065239225,1909.9861263290236,135062.3926502515,3206,8,906.421052631579,36,2,16,32.76209310783779,0.6519097222222223,41.97635135135135,1032.094594594594,28.669294294294275,0
3336,4,1,2,37,0.02564102564102564,0.05128205128205128,0.9487179487179487,39,800,600,200,0.75,10,6,4,349.39341080669465,0.3840249662618083,0.14323269598158217,0.21629334537586545,133415.57618690346,1522.9046437365112,134938.48083063998,3207,0,884.1538461538462,37,2,16,32.69741031628104,0.6525900900900903,41.721491228070164,1033.1140350877176,27.922000948316693,0
3337,4,0,0,37,0.0,0.0,1.0,37,1000,500,500,0.5,15,5,10,364.27034527137096,0.3793793793793794,0.15619924857593026,0.2243985828605405,133233.1318587105,2306.5757887517093,135539.7076474622,3208,10,922.1351351351351,35,2,16,32.496263079222715,0.6547619047619049,41.898148148148145,1032.407407407407,29.497354497354483,0
3338,4,1,1,37,0.02631578947368421,0.02631578947368421,0.9736842105263158,38,850,400,450,0.47058823529411764,13,4,9,357.1640141517356,0.38402382645803695,0.14441706798073684,0.2216203948826162,133502.12358807013,1936.64520640432,135438.76879447445,3209,0,898.8421052631579,35,3,16,32.40996098853922,0.6574404761904762,41.63773148148148,1033.449074074074,29.5271164021164,0
3339,4,0,0,37,0.0,0.0,1.0,37,1050,600,450,0.5714285714285714,15,6,9,369.28622435196183,0.37966091091091086,0.15079064726202662,0.22877294412144095,133442.32420535412,2455.682414909128,135898.00662026324,3210,12,924.1351351351351,35,2,16,32.1567762592883,0.6568452380952381,41.695601851851855,1033.2175925925928,29.520502645502653,0
3340,4,0,0,37,0.0,0.0,1.0,37,850,600,250,0.7058823529411765,11,6,5,370.4874238221845,0.3791916916916917,0.14974274055236925,0.23027503944509828,133564.50007086145,2496.796858050041,136061.2969289115,3211,13,925.1351351351351,34,3,16,32.00314791354755,0.660232843137255,41.57738095238094,1033.6904761904746,30.402661064425722,0
3341,4,0,0,37,0.0,0.0,1.0,37,1100,800,300,0.7272727272727273,14,8,6,369.53515033463503,0.378785035035035,0.1464780843019189,0.23006543230511126,133626.03635204065,2475.9034863945362,136101.93983843518,3212,14,926.1351351351351,34,3,17,31.966033390903856,0.6608455882352942,41.51785714285713,1033.92857142857,30.409663865546175,0
3342,4,1,0,38,0.02631578947368421,0.0,1.0,38,950,800,150,0.8421052631578947,11,8,3,359.74423208268627,0.3840534613560929,0.14768272728342868,0.22558435647148536,133891.14610125177,2033.3135073731182,135924.4596086249,3213,0,902.7368421052631,35,3,15,31.953608439573546,0.6613095238095238,41.261574074074076,1034.9537037037042,29.570105820105834,0
3343,4,0,0,38,0.0,0.0,1.0,38,900,700,200,0.7777777777777778,11,7,4,361.9344475477586,0.383445945945946,0.14968962372392647,0.22751255328985948,133981.00090288496,2098.4679087362842,136079.46881162125,3214,1,903.7368421052631,35,3,15,31.80699180175145,0.6622023809523809,41.17476851851852,1035.300925925926,29.58002645502646,0
3344,4,0,0,38,0.0,0.0,1.0,38,600,400,200,0.6666666666666666,8,4,4,363.9654769585478,0.38356448553816974,0.14565873281930908,0.229536790225655,134100.85419077936,2161.6162712191376,136262.47046199848,3215,2,904.7368421052631,35,3,16,31.634470331880653,0.6633928571428571,41.05902777777778,1035.7638888888891,29.593253968253975,0
3345,4,0,0,38,0.0,0.0,1.0,38,1100,800,300,0.7272727272727273,14,8,6,366.9256589208578,0.3828977003319109,0.14999294482855952,0.2319716453855592,134190.7793209876,2247.6080246913566,136438.38734567896,3216,3,905.7368421052631,35,3,16,31.467828418230567,0.6642857142857144,40.97222222222222,1036.1111111111109,29.603174603174597,0
3346,4,1,1,38,0.02564102564102564,0.02564102564102564,0.9743589743589743,39,1100,900,200,0.8181818181818182,13,9,4,359.65803067191916,0.38543072424651376,0.1406693610341032,0.22944389048128247,134521.5739388037,1876.3528731434185,136397.9268119471,3217,0,883.4871794871794,36,3,16,31.325535533362295,0.6655092592592593,40.653153153153156,1037.3873873873874,28.816316316316318,0
3347,4,0,0,38,0.0,0.0,1.0,38,750,500,250,0.6666666666666666,10,5,5,369.51146060694623,0.38175675675675674,0.15389111801716582,0.2349505447535579,134400.7218390989,2332.5214066786652,136733.24324577756,3218,5,907.7368421052631,35,3,16,31.190818357703606,0.6663690476190476,40.769675925925924,1036.921296296296,29.626322751322746,0
3348,4,0,0,38,0.0,0.0,1.0,38,1150,900,250,0.782608695652174,14,9,5,369.5101691908196,0.38128259838786155,0.15863453815261042,0.235918031098754,134550.78125,2343.576388888889,136894.35763888888,3219,6,908.7368421052631,35,3,17,31.04082998661311,0.6678571428571429,40.625,1037.5,29.642857142857142,0
3349,4,0,0,38,0.0,0.0,1.0,38,1300,1200,100,0.9230769230769231,14,12,2,363.3169677041573,0.38116405879563775,0.1523489932885902,0.22745474028537596,133831.25964506183,2124.633487654333,135955.89313271616,3220,7,909.7368421052631,35,3,16,31.921140939597304,0.6607142857142856,41.31944444444445,1034.722222222223,29.563492063492088,2
3350,4,0,0,38,0.0,0.0,1.0,38,1300,800,500,0.6153846153846154,18,8,10,363.59010627846175,0.38128259838786155,0.14746728180020696,0.2283672689996181,133951.04595336074,2140.6550068587076,136091.70096021943,3221,8,910.7368421052631,35,3,16,31.79412641621943,0.6619047619047618,41.2037037037037,1035.185185185185,29.576719576719572,0
3351,4,0,0,38,0.0,0.0,1.0,38,1050,700,350,0.6666666666666666,14,7,7,361.88964774562885,0.38128259838786155,0.14979349782907958,0.2276698163665538,134010.9592013888,2099.435763888879,136110.39496527766,3222,9,911.7368421052631,35,3,16,31.778169014084504,0.6625,41.14583333333333,1035.4166666666658,29.58333333333331,0
3352,4,0,0,38,0.0,0.0,1.0,38,800,600,200,0.75,10,6,4,361.188009680444,0.381578947368421,0.1475678410287482,0.22741373135896767,134040.92084887254,2082.794683427635,136123.71553230018,3223,10,912.7368421052631,35,3,16,31.76635091837115,0.662797619047619,41.116898148148145,1035.532407407407,29.586640211640198,0
3353,4,0,0,38,0.0,0.0,1.0,38,650,500,150,0.7692307692307693,8,5,3,360.9710058986924,0.3808677098150783,0.14915024992649206,0.2278343090827429,134130.82588520227,2083.467828360759,136214.29371356303,3224,11,913.7368421052631,35,3,16,31.68202979515828,0.6636904761904763,41.03009259259259,1035.879629629629,29.59656084656083,0
3354,4,0,1,37,0.0,0.02631578947368421,0.9736842105263158,38,1250,900,350,0.72,16,9,7,358.52724906036053,0.3801120199146515,0.14797306428961754,0.2275923862390963,134340.7215175969,2032.9618644976024,136373.6833820945,3225,12,914.7368421052631,35,3,16,31.53550761043504,0.6657738095238095,40.8275462962963,1036.689814814815,29.619708994709,0
3355,4,0,0,37,0.0,0.0,1.0,37,1000,600,400,0.6,14,6,8,370.3931355941601,0.3737174674674675,0.15716577755847494,0.23528474236976946,134365.57716836725,2553.6174886621216,136919.19465702938,3226,28,940.1351351351351,34,3,16,31.203113637233518,0.6681985294117647,40.80357142857142,1036.7857142857135,30.493697478991574,0
3356,4,0,1,36,0.0,0.02702702702702703,0.972972972972973,37,650,400,250,0.6153846153846154,9,4,5,370.75638889434686,0.37324824824824826,0.16020817696282452,0.2365132630179602,134519.90504535136,2574.8228458049753,137094.72789115633,3227,29,941.1351351351351,34,3,17,31.039371509448397,0.6697303921568627,40.6547619047619,1037.3809523809516,30.511204481792696,0
3357,4,0,0,36,0.0,0.0,1.0,36,750,400,350,0.5333333333333333,11,4,7,379.5378559224964,0.37180886243386246,0.16777909037212013,0.24210911457301681,134518.99697532202,3011.0103385717052,137530.00731389373,3228,30,963.9444444444445,33,3,17,30.812536916715878,0.6720328282828283,40.65563725490196,1037.3774509803925,31.435680332739167,0
3358,4,0,0,36,0.0,0.0,1.0,36,1250,900,350,0.72,16,9,7,379.0455744629054,0.3708498677248677,0.16043150837695652,0.2426407384827166,134646.15660142718,3007.405955642042,137653.56255706924,3229,31,964.9444444444445,33,3,17,30.698109772897226,0.6732954545454546,40.53308823529411,1037.8676470588223,31.450534759358252,0
3359,4,0,0,36,0.0,0.0,1.0,36,500,300,200,0.6,7,3,4,379.0455744629054,0.3705026455026455,0.16043150837695652,0.2426407384827166,134646.15660142718,3007.405955642042,137653.56255706924,3230,32,965.9444444444445,33,3,17,30.698109772897226,0.6732954545454546,40.53308823529411,1037.8676470588223,31.450534759358252,0
3360,4,0,0,36,0.0,0.0,1.0,36,1250,1000,250,0.8,15,10,5,380.75227330078917,0.37000661375661376,0.1669190429367422,0.24501712347943716,134837.00867755184,3067.8995158112157,137904.90819336305,3231,33,966.9444444444445,33,3,16,30.463003933136665,0.675189393939394,40.34926470588235,1038.60294117647,31.47281639928697,0
3361,4,0,0,36,0.0,0.0,1.0,36,1000,700,300,0.7,13,7,6,382.23573720407825,0.36965939153439153,0.1677022704630069,0.24618769821745917,134868.8304978852,3110.3373702421886,137979.1678681274,3232,34,967.9444444444445,33,3,16,30.39267736353627,0.6755050505050506,40.31862745098038,1038.7254901960766,31.476530005941715,0
3362,4,0,0,36,0.0,0.0,1.0,36,600,300,300,0.5,9,3,6,381.7783164150714,0.3697089947089947,0.1644744603043531,0.24610910937266606,134900.6560727844,3100.429071751236,138001.08514453564,3233,35,968.9444444444445,33,3,16,30.372748810506863,0.6758207070707072,40.287990196078425,1038.8480392156855,31.48024361259653,0
3363,4,0,0,36,0.0,0.0,1.0,36,550,200,350,0.36363636363636365,9,2,7,383.5630023304979,0.3697916666666667,0.16726298131110573,0.24747695081871834,134932.48540224906,3151.021842560539,138083.5072448096,3234,36,969.9444444444445,33,3,16,30.294585987261133,0.6761363636363638,40.257352941176464,1038.9705882352935,31.483957219251316,0
3364,4,0,0,36,0.0,0.0,1.0,36,1050,700,350,0.6666666666666666,14,7,7,378.19125224396686,0.37000661375661376,0.15759296370518805,0.24508757775290843,135091.6883680555,3018.0989583333276,138109.78732638882,3235,37,970.9444444444445,33,3,16,30.275133600534392,0.6777146464646465,40.104166666666664,1039.583333333333,31.502525252525242,0
3365,4,0,0,36,0.0,0.0,1.0,36,1050,700,350,0.6666666666666666,14,7,7,380.53264226885625,0.36974206349206346,0.1602810834871633,0.24747743562726318,135219.11832288068,3091.0576761341836,138310.17599901487,3236,38,971.9444444444445,33,3,16,30.087069439534968,0.6789772727272727,39.981617647058826,1040.073529411765,31.517379679144398,0
3366,4,0,0,36,0.0,0.0,1.0,36,500,400,100,0.8,6,4,2,381.64333737363376,0.3695767195767196,0.1631817646365885,0.24863931626744257,135282.8558276865,3125.960117502886,138408.8159451894,3237,39,972.9444444444445,33,3,16,29.99457631444615,0.6796085858585859,39.9203431372549,1040.3186274509806,31.524806892453956,0
3367,4,0,0,36,0.0,0.0,1.0,36,1400,900,500,0.6428571428571429,19,9,10,383.1342121754964,0.3686838624338624,0.1627591393630241,0.2509425699638275,135474.15845167733,3180.9569937043557,138655.11544538167,3238,40,973.9444444444445,33,3,17,29.764935256032974,0.6815025252525253,39.73651960784314,1041.053921568628,31.54708853238267,0
3368,4,0,0,36,0.0,0.0,1.0,36,700,500,200,0.7142857142857143,9,5,4,349.99996070173427,0.36906415343915344,0.06643024684463295,0.22145227195495598,134220.76106234998,2195.452219435874,136416.21328178587,3239,41,974.9444444444445,35,1,19,31.876303101381296,0.6645833333333333,40.94328703703704,1036.226851851852,29.606481481481485,7
3369,4,0,0,36,0.0,0.0,1.0,36,700,400,300,0.5714285714285714,10,4,6,350.9433843760276,0.36901455026455027,0.07172359901763792,0.2229610522865572,134370.7200038581,2231.303047839513,136602.02305169762,3240,42,975.9444444444445,35,1,19,31.702109845947763,0.6660714285714285,40.798611111111114,1036.8055555555559,29.623015873015884,0
3370,4,0,0,36,0.0,0.0,1.0,36,1100,800,300,0.7272727272727273,14,8,6,355.84861756220954,0.3675099206349206,0.07031685819480082,0.22700862343132294,134520.76266986033,2373.805485896787,136894.56815575712,3241,43,976.9444444444445,35,1,19,31.425141321730074,0.6675595238095238,40.65393518518519,1037.38425925926,29.639550264550287,0
3371,4,0,0,36,0.0,0.0,1.0,36,1300,1000,300,0.7692307692307693,16,10,6,359.24911562908204,0.36562500000000003,0.068441234171571,0.23073422581125588,134767.01388888896,2482.989460090888,137250.00334897984,3242,44,977.9444444444445,34,2,19,31.091158373461745,0.6721813725490196,40.41666666666667,1038.333333333334,30.539215686274527,0
3372,4,0,0,36,0.0,0.0,1.0,36,1100,700,400,0.6363636363636364,15,7,8,357.8539027312634,0.3661210317460317,0.06394182547642946,0.23018086517617364,134821.0991753471,2449.2513020833226,137270.35047743042,3243,45,978.9444444444445,35,1,17,31.07342861919092,0.6705357142857142,40.36458333333333,1038.5416666666656,29.67261904761902,0
3373,4,0,0,36,0.0,0.0,1.0,36,1200,900,300,0.75,15,9,6,356.279847865252,0.3655919312169312,0.057932263814617135,0.22973907431311086,134911.26543209876,2413.233024691359,137324.4984567901,3244,46,979.9444444444445,35,1,17,31.024398395721924,0.6714285714285714,40.27777777777778,1038.888888888889,29.682539682539684,0
3374,4,0,0,36,0.0,0.0,1.0,36,700,500,200,0.7142857142857143,9,5,4,355.30839155511944,0.36511243386243386,0.0595688982956446,0.2293029066132501,134941.32754897553,2389.157209147811,137330.48475812335,3245,47,980.9444444444445,35,1,17,31.01966599829192,0.6717261904761904,40.248842592592595,1039.00462962963,29.68584656084657,0
3375,4,0,0,36,0.0,0.0,1.0,36,800,600,200,0.75,10,6,4,354.27006810482084,0.3640046296296296,0.053786191536748795,0.22920354550297498,135031.53399348422,2367.526148834021,137399.06014231825,3246,48,981.9444444444445,35,1,17,30.956755753526352,0.6726190476190477,40.16203703703704,1039.351851851852,29.6957671957672,0
3376,4,0,0,36,0.0,0.0,1.0,36,800,600,200,0.75,10,6,4,350.2596075913127,0.3637566137566137,0.056467772459089405,0.22717559963846684,135121.770578811,2265.539667995555,137387.31024680656,3247,49,982.9444444444445,35,1,17,30.971116739025565,0.6735119047619047,40.07523148148149,1039.699074074075,29.705687830687857,0
3377,4,0,0,36,0.0,0.0,1.0,36,850,600,250,0.7058823529411765,11,6,5,352.7006182253411,0.3637566137566137,0.044412847106055864,0.22574350061574813,134640.85708429778,2298.5505615569236,136939.4076458547,3248,50,983.9444444444445,35,1,19,31.38696052191368,0.66875,40.53819444444444,1037.8472222222217,29.652777777777764,1
3378,4,1,1,36,0.02702702702702703,0.02702702702702703,0.972972972972973,37,950,700,250,0.7368421052631579,12,7,5,343.916092322243,0.3663038038038038,0.04490247889337451,0.22188600473881212,134930.76480196416,1880.9722729486325,136811.7370749128,3249,0,958.3243243243244,36,1,17,31.326098345256163,0.6695601851851851,40.25900900900901,1038.9639639639643,28.860110110110117,0
3379,4,0,0,36,0.0,0.0,1.0,36,950,700,250,0.7368421052631579,12,7,5,374.55146947948714,0.364103835978836,-0.021470637400506476,0.2249130818465775,132275.51197562364,2741.0721506462414,135016.58412626988,3250,52,985.9444444444445,34,2,17,33.19494271496356,0.6473651960784313,42.827380952380956,1028.6904761904766,30.25560224089637,6
3380,4,0,0,36,0.0,0.0,1.0,36,1050,500,550,0.47619047619047616,16,5,11,372.4306606154318,0.36383928571428575,-0.01528854435831195,0.22400265829500207,132336.75063775518,2657.25269274377,134994.00333049893,3251,53,986.9444444444445,34,2,17,33.18774345327625,0.6479779411764706,42.767857142857146,1028.928571428572,30.262605042016823,0
3381,4,0,0,36,0.0,0.0,1.0,36,550,400,150,0.7272727272727273,7,4,3,369.0622608142726,0.3626322751322751,-0.013951531038382203,0.22269932793168268,132459.27047902488,2577.1435657596257,135036.4140447845,3252,54,987.9444444444445,34,2,18,33.15094830577078,0.649203431372549,42.64880952380952,1029.4047619047615,30.27661064425769,0
3382,4,0,0,36,0.0,0.0,1.0,36,700,400,300,0.5714285714285714,10,4,6,367.50309064786654,0.36276455026455023,-0.015478484264611181,0.22230082056671666,132551.1975623584,2542.5949546485426,135093.79251700695,3253,55,988.9444444444445,34,2,18,33.09850674373796,0.6501225490196078,42.55952380952382,1029.7619047619057,30.287114845938405,0
3383,4,0,0,36,0.0,0.0,1.0,36,1000,800,200,0.8,12,8,4,366.46118408295933,0.3612268518518518,-0.01847037678926733,0.2225769507535448,132704.4802295918,2526.2081916099764,135230.68842120178,3254,56,989.9444444444445,34,2,14,32.971066820720196,0.6516544117647058,42.410714285714285,1030.3571428571427,30.30462184873949,0
3384,4,0,0,36,0.0,0.0,1.0,36,750,500,250,0.6666666666666666,10,5,5,368.65845696944933,0.3605654761904762,-0.01634194550331758,0.2242780226271624,132765.8180980725,2589.0483276643963,135354.8664257369,3255,57,990.9444444444445,34,2,15,32.85274922028417,0.6522671568627452,42.351190476190474,1030.5952380952376,30.31162464985993,0
3385,4,0,0,36,0.0,0.0,1.0,36,650,400,250,0.6153846153846154,9,4,5,366.20808645665045,0.36048280423280427,-0.013481905617304335,0.2232590982935923,132845.0671537422,2529.787567515421,135374.8547212576,3256,58,991.9444444444445,35,1,15,32.83618221623443,0.6508928571428572,42.27430555555555,1030.902777777777,29.454365079365054,0
3386,4,0,1,35,0.0,0.027777777777777776,0.9722222222222222,36,750,400,350,0.5333333333333333,11,4,7,364.5297665003857,0.3599537037037037,-0.00954403162844053,0.22259052020232595,132904.73257726766,2489.5462266375134,135394.27880390518,3257,59,992.9444444444445,35,1,15,32.81945691622704,0.6514880952380953,42.21643518518518,1031.1342592592591,29.460978835978832,0
3387,4,0,0,35,0.0,0.0,1.0,35,600,300,300,0.5,9,3,6,370.4083972926411,0.35973389355742297,-0.009039920818211922,0.22589695215170932,132857.85147392287,2842.332766439904,135700.18424036278,3258,60,1008.7714285714286,34,1,17,32.715069284064654,0.6531862745098038,42.26190476190476,1030.9523809523807,30.32212885154061,0
3388,4,0,0,35,0.0,0.0,1.0,35,750,400,350,0.5333333333333333,11,4,7,372.1787176914954,0.35990896358543417,-0.011228023880990756,0.2273492279720542,132919.22477324243,2893.941326530592,135813.16609977302,3259,61,1009.7714285714286,34,1,17,32.60770222427461,0.6537990196078433,42.20238095238094,1031.1904761904748,30.329131652661022,0
3389,4,0,0,35,0.0,0.0,1.0,35,900,800,100,0.8888888888888888,10,8,2,373.1678770669003,0.3584033613445378,-0.009078771695594012,0.2288921437040923,133072.72002551012,2931.69288548752,136004.41291099763,3260,62,1010.7714285714286,34,1,17,32.42783931387254,0.6553308823529412,42.05357142857142,1031.7857142857138,30.34663865546217,0
3390,4,0,0,35,0.0,0.0,1.0,35,950,600,350,0.631578947368421,13,6,7,347.1528711261361,0.3576330532212885,0.058529976289939833,0.20348993908432722,131357.78523930453,2120.246458118973,133478.03169742352,3261,63,1011.7714285714286,35,0,21,34.824267998946205,0.6360119047619048,43.7210648148148,1025.1157407407393,29.289021164021122,8
3391,4,1,0,36,0.027777777777777776,0.0,1.0,36,950,700,250,0.7368421052631579,12,7,5,340.00305115743924,0.36294642857142856,0.07272810385811002,0.2011114738027292,131703.53366457662,1755.9206588345037,133459.45432341113,3262,0,984.6388888888889,36,0,19,34.65898701773635,0.6374421296296298,43.384009009009006,1026.463963963963,28.512887887887857,0
3392,4,0,0,36,0.0,0.0,1.0,36,700,400,300,0.5714285714285714,10,4,6,338.576171327059,0.36256613756613754,0.07259145524115929,0.20072415670742005,131790.24252292817,1724.2071463355028,133514.44966926367,3263,1,985.6388888888889,36,0,19,34.608283980405055,0.6383101851851853,43.29954954954954,1026.8018018018004,28.522272272272232,0
3393,4,0,0,36,0.0,0.0,1.0,36,750,500,250,0.6666666666666666,10,5,5,338.0562230257841,0.362880291005291,0.07718756471634469,0.20087366841812232,131876.97991488106,1716.366746814375,133593.34666169542,3264,2,986.6388888888889,36,0,20,34.53431641267404,0.6391782407407408,43.21509009009009,1027.1396396396392,28.531656656656644,0
3394,4,0,1,35,0.0,0.027777777777777776,0.9722222222222222,36,450,400,50,0.8888888888888888,5,4,1,337.77393008642474,0.36254960317460316,0.0810010108760526,0.20101184371679393,131934.82069485018,1712.8285802694563,133647.64927511962,3265,3,987.6388888888889,36,0,20,34.483357082830956,0.6397569444444444,43.15878378378378,1027.3648648648643,28.537912912912898,0
3395,4,0,0,35,0.0,0.0,1.0,35,950,600,350,0.631578947368421,13,6,7,342.40964887919074,0.3613095238095238,0.08645794768611692,0.2035422393705838,131892.24222232922,2032.235269847378,133924.4774921766,3266,4,1007.9142857142857,35,0,20,34.40715962441316,0.6413690476190477,43.200231481481474,1027.1990740740728,29.348544973544936,0
3396,4,0,0,35,0.0,0.0,1.0,35,750,500,250,0.6666666666666666,10,5,5,341.2720230852292,0.3616596638655462,0.08666044475911572,0.20334315576850093,131981.42387902946,2008.3135073731096,133989.73738640256,3267,5,1008.9142857142857,35,0,20,34.346605842156634,0.6422619047619048,43.113425925925924,1027.546296296296,29.358465608465604,0
3397,4,0,0,35,0.0,0.0,1.0,35,1050,800,250,0.7619047619047619,13,8,5,342.1110299488679,0.3619047619047619,0.09196911196911217,0.2041630340017437,132040.89506172828,2034.5293209876424,134075.42438271592,3268,6,1009.9142857142857,35,0,20,34.2652027027027,0.6428571428571428,43.05555555555555,1027.777777777777,29.36507936507934,0
3398,4,0,0,35,0.0,0.0,1.0,35,650,400,250,0.6153846153846154,9,4,5,340.3800486714189,0.36176470588235293,0.08802097575884305,0.2032895233524459,132070.63567654745,1990.84187992969,134061.47755647713,3269,7,1010.9142857142857,35,0,20,34.279759223811126,0.643154761904762,43.02662037037037,1027.8935185185182,29.368386243386237,0
3399,4,0,0,35,0.0,0.0,1.0,35,850,600,250,0.7058823529411765,11,6,5,339.6084971192907,0.36134453781512604,0.08497146072835471,0.2034673969591974,132189.63162562158,1978.544426226002,134168.17605184758,3270,8,1011.9142857142857,35,0,20,34.17991465015946,0.644345238095238,42.91087962962963,1028.3564814814815,29.381613756613756,0
3400,4,0,0,35,0.0,0.0,1.0,35,450,300,150,0.6666666666666666,6,3,3,335.7886059617449,0.36134453781512604,0.0808858559196548,0.19976271223300607,131921.96609224982,1859.5786179698398,133781.54471021966,3271,9,1012.9142857142857,35,0,18,34.54728105753341,0.6416666666666666,43.171296296296305,1027.3148148148161,29.35185185185189,1
3401,4,0,0,35,0.0,0.0,1.0,35,850,600,250,0.7058823529411765,11,6,5,336.99766271799155,0.3602941176470588,0.08198925595908246,0.2014275397214806,132100.3796403464,1903.5038365912192,134003.88347693763,3272,10,1013.9142857142857,35,0,20,34.33676724461456,0.6434523809523809,42.99768518518518,1028.0092592592594,29.371693121693124,0
3402,4,0,0,35,0.0,0.0,1.0,35,1400,1100,300,0.7857142857142857,17,11,6,335.3855776202878,0.3596638655462185,0.08283175602937187,0.2018898558308718,132368.22601862554,1878.8787883659002,134247.10480699144,3273,11,1014.9142857142857,35,0,22,34.10904753870956,0.6461309523809524,42.73726851851851,1029.050925925925,29.401455026455,0
3403,4,0,0,35,0.0,0.0,1.0,35,700,400,300,0.5714285714285714,10,4,6,336.3090219036376,0.3598389355742297,0.07795537421085652,0.20276583944332513,132427.78427479835,1907.331720464659,134335.115995263,3274,12,1015.9142857142857,35,0,22,34.025474155702994,0.6467261904761905,42.67939814814814,1029.282407407406,29.408068783068742,0
3404,4,0,0,35,0.0,0.0,1.0,35,800,600,200,0.75,10,6,4,335.5038833004668,0.359593837535014,0.07952991041325519,0.20308255466718028,132576.7385223764,1896.0021219135651,134472.74064428997,3275,13,1016.9142857142857,35,0,22,33.89666217127446,0.6482142857142857,42.534722222222214,1029.86111111111,29.424603174603142,0
3405,4,0,0,35,0.0,0.0,1.0,35,1000,500,500,0.5,15,5,10,338.58553212978177,0.35955882352941176,0.08066773675762473,0.20527324495606636,132636.3436642659,1981.7493998628033,134618.0930641287,3276,14,1017.9142857142857,35,0,16,33.75749063670412,0.648809523809524,42.47685185185184,1030.092592592591,29.431216931216888,0
3406,4,0,0,35,0.0,0.0,1.0,35,1000,600,400,0.6,14,6,8,340.37823032381374,0.35878851540616247,0.08802464381979247,0.20701692368874522,132755.59413580218,2037.422839506136,134793.0169753083,3277,15,1018.9142857142857,35,0,17,33.59164420485174,0.6500000000000001,42.36111111111109,1030.5555555555532,29.444444444444375,0
3407,4,0,0,35,0.0,0.0,1.0,35,1100,900,200,0.8181818181818182,13,9,4,340.4003659450058,0.3584033613445378,0.09031471560103954,0.20736016820151973,132815.239465449,2042.0712234224673,134857.31068887148,3278,16,1019.9142857142857,35,0,17,33.531233625271334,0.6505952380952382,42.303240740740726,1030.7870370370351,29.451058201058146,0
3408,4,0,0,35,0.0,0.0,1.0,35,1150,800,350,0.6956521739130435,15,8,7,341.96510560146936,0.3584033613445378,0.08704184704184725,0.2089786756453421,132934.57031249977,2091.796874999971,135026.36718749974,3279,17,1020.9142857142857,35,0,19,33.37121212121212,0.6517857142857144,42.187499999999986,1031.2499999999982,29.464285714285662,0
3409,4,0,0,35,0.0,0.0,1.0,35,850,500,350,0.5882352941176471,12,5,7,341.548240284417,0.35798319327731093,0.08632982816106716,0.20905754927298897,132994.2558299038,2084.7908093278247,135079.04663923162,3280,18,1021.9142857142857,35,0,20,33.322112507480554,0.6523809523809525,42.12962962962962,1031.48148148148,29.470899470899425,0
3410,4,0,0,35,0.0,0.0,1.0,35,750,400,350,0.5333333333333333,11,4,7,334.04546275290704,0.35756302521008404,0.07960882780494205,0.20173360069044274,132489.90929705213,1860.586253534325,134350.49555058646,3281,19,1022.9142857142857,34,1,21,34.02135368485969,0.6495098039215687,42.61904761904761,1029.5238095238092,30.280112044817916,8
3411,4,0,0,35,0.0,0.0,1.0,35,1200,1000,200,0.8333333333333334,14,10,4,333.75206090282427,0.3572478991596639,0.0776902366912775,0.20172058523749303,132520.55165816317,1845.80144557822,134366.3531037414,3282,20,1023.9142857142857,34,1,22,33.9981500751532,0.6498161764705883,42.58928571428571,1029.6428571428564,30.28361344537813,0
3412,4,0,0,35,0.0,0.0,1.0,35,500,300,200,0.6,7,3,4,333.4641416269934,0.35749299719887956,0.07501032085473192,0.2018753176497634,132581.84700963707,1842.2583616779925,134424.10537131506,3283,21,1024.9142857142858,34,1,22,33.94405271066927,0.6504289215686274,42.5297619047619,1029.8809523809516,30.290616246498576,0
3413,4,0,0,35,0.0,0.0,1.0,35,1100,700,400,0.6363636363636364,15,7,8,346.9278904624223,0.35749299719887956,0.046897194085457894,0.19985001013962034,130688.2812499998,2067.8819444444157,132756.1631944442,3284,22,1025.9142857142858,34,1,20,35.506655800054325,0.6314338235294119,44.374999999999986,1022.4999999999984,30.07352941176466,3
3414,4,1,1,35,0.027777777777777776,0.027777777777777776,0.9722222222222222,36,1000,800,200,0.8,12,8,4,339.94666605626406,0.36357473544973545,0.04274663451878702,0.1978847435043302,131090.96364883377,1712.787208504771,132803.75085733854,3285,0,998.3888888888889,35,1,20,35.27821729957805,0.6333333333333335,43.98148148148147,1024.074074074072,29.259259259259203,0
3415,4,1,0,36,0.027777777777777776,0.0,1.0,36,900,600,300,0.6666666666666666,12,6,6,339.9004554507079,0.36448412698412697,0.04921917171945389,0.1983163435197239,131179.87403817274,1717.6197863082652,132897.493824481,3286,0,999.3611111111111,35,1,21,35.189644296313034,0.6342261904761907,43.89467592592591,1024.4212962962943,29.269179894179835,0
3416,4,1,1,36,0.02702702702702703,0.02702702702702703,0.972972972972973,37,600,400,200,0.6666666666666666,8,4,4,331.5821674960922,0.36755505505505504,0.04544672060595589,0.1947991753044783,131443.5782911288,1316.8693186429473,132760.44760977174,3287,0,973.3243243243244,36,1,21,35.136860311882266,0.6348379629629631,43.63738738738738,1025.4504504504491,28.484734734734698,0
3417,4,0,0,36,0.0,0.0,1.0,36,750,600,150,0.8,9,6,3,341.0040792634967,0.3620205026455026,0.04865030982664775,0.2000406711335134,131387.4488275891,1760.731202846357,133148.18003043547,3288,2,1001.3611111111111,35,1,21,34.95192669526606,0.6363095238095239,43.692129629629626,1025.231481481481,29.29232804232803,0
3418,4,0,0,36,0.0,0.0,1.0,36,600,300,300,0.5,9,3,6,340.6742570852616,0.361739417989418,0.048793715281696404,0.20031284618662917,131476.45968632106,1758.1290455675476,133234.5887318886,3289,3,1002.3611111111111,35,1,23,34.870617499905954,0.637202380952381,43.60532407407407,1025.578703703703,29.302248677248656,0
3419,4,0,0,36,0.0,0.0,1.0,36,1100,900,200,0.8181818181818182,13,9,4,341.40995343019324,0.36226851851851855,0.050433567660363776,0.2016843475726531,131654.57182623885,1789.6362472136464,133444.2080734525,3290,4,1003.3611111111111,35,1,18,34.67221627006505,0.6389880952380952,43.43171296296296,1026.273148148148,29.322089947089943,0
3420,4,0,1,35,0.0,0.027777777777777776,0.9722222222222222,36,1100,1000,100,0.9090909090909091,12,10,2,331.45084683935187,0.36245039682539687,0.04684824854097158,0.1995212917568504,132368.22601862584,1574.712121699262,133942.9381403251,3291,5,1004.3611111111111,35,1,21,34.21027349754432,0.6461309523809522,42.737268518518526,1029.0509259259272,29.401455026455064,1
3421,4,0,0,35,0.0,0.0,1.0,35,900,400,500,0.4444444444444444,14,4,10,339.2121491170026,0.353921568627451,0.056150678815339417,0.20336250910630002,132214.2874858276,1969.738520408158,134184.02600623577,3292,30,1033.9142857142858,34,1,21,34.16531620172089,0.6467524509803921,42.88690476190476,1028.4523809523805,30.248599439775898,0
3422,4,0,1,34,0.0,0.02857142857142857,0.9714285714285714,35,450,400,50,0.8888888888888888,5,4,1,337.14532685515536,0.35371148459383756,0.05509282986426833,0.20245120009419043,132275.51197562367,1919.2141439909383,134194.7261196146,3293,31,1034.9142857142858,34,1,21,34.15692628168037,0.6473651960784313,42.827380952380956,1028.6904761904768,30.255602240896376,0
3423,4,0,0,34,0.0,0.0,1.0,34,650,400,250,0.6153846153846154,9,4,5,347.2553674388239,0.35316399286987527,0.04597977852672086,0.19440684586804244,129575.43372741251,2199.1529700115257,131774.58669742403,3294,32,1044.1176470588234,33,1,17,36.62684561065637,0.6224747474747474,45.4656862745098,1018.1372549019607,30.852644087938202,6
3424,4,0,0,34,0.0,0.0,1.0,34,1150,800,350,0.6956521739130435,15,8,7,346.5560037632823,0.354742275698158,0.041022485890464644,0.1947130482076433,129716.28578514734,2190.7915249433036,131907.07731009065,3295,33,1045.1176470588234,34,0,19,36.50154843987378,0.6216299019607843,45.32738095238095,1018.6904761904758,29.961484593837525,0
3425,4,3,1,36,0.08108108108108109,0.02702702702702703,0.972972972972973,37,900,600,300,0.6666666666666666,12,6,6,322.35813816098965,0.37650150150150147,0.03961381447599721,0.18434983058765309,130406.3248214432,1008.6559739552167,131414.9807953984,3296,0,961.2972972972973,36,1,21,36.419514884233735,0.6244212962962963,44.65090090090091,1021.3963963963974,28.37212212212215,0
3426,4,1,1,36,0.02702702702702703,0.02702702702702703,0.972972972972973,37,750,500,250,0.6666666666666666,10,5,5,322.3188430016971,0.37615740740740744,0.0461907797151353,0.18487491664964628,130521.3723013557,1013.8995414333638,131535.27184278908,3297,0,962.2702702702703,36,1,14,36.304275953273105,0.6255787037037035,44.53828828828831,1021.8468468468492,28.3846346346347,0
3427,4,0,0,36,0.0,0.0,1.0,36,750,500,250,0.6666666666666666,10,5,5,328.0162013203683,0.37023809523809526,0.04034056106823436,0.18758555775383035,130406.32482144346,1355.0774592160162,131761.40228065947,3298,2,990.0,36,0,22,36.27503675119441,0.6244212962962961,44.65090090090092,1021.3963963963996,28.37212212212221,0
3428,4,0,0,36,0.0,0.0,1.0,36,550,300,250,0.5454545454545454,8,3,5,326.3092495086926,0.36974206349206346,0.03851051845321196,0.18716372503425296,130521.37230135573,1318.06620810003,131839.43850945577,3299,3,991.0,36,0,17,36.20233634560281,0.6255787037037035,44.53828828828831,1021.8468468468494,28.384634634634708,0
3429,4,1,3,34,0.02702702702702703,0.08108108108108109,0.9189189189189189,37,750,500,250,0.6666666666666666,10,5,5,318.6573410731148,0.3747497497497498,0.036994112465810414,0.18393785133230336,130766.77439212106,933.9585257002625,131700.73291782133,3300,0,965.1891891891892,37,0,18,36.15012149799887,0.626126126126126,44.29824561403511,1022.807017543863,27.643432906590892,0
3430,4,0,0,34,0.0,0.0,1.0,34,700,500,200,0.7142857142857143,9,5,4,342.02415660141594,0.3528483363042187,0.04021608643457397,0.19487422876127217,130262.58680555574,2110.590277777802,132373.17708333355,3301,39,1051.1176470588234,34,0,22,36.06292517006804,0.6271446078431371,44.79166666666668,1020.8333333333348,30.024509803921614,0
3431,4,1,1,34,0.02857142857142857,0.02857142857142857,0.9714285714285714,35,700,300,400,0.42857142857142855,11,3,8,334.3755617694398,0.35714285714285715,0.03774574049803414,0.19182598017299465,130528.56445312513,1729.1124131944598,132257.67686631958,3302,0,1022.0571428571428,35,0,19,35.988999320421335,0.6276785714285713,44.53125000000001,1021.875000000001,29.1964285714286,0
3432,4,1,2,33,0.02857142857142857,0.05714285714285714,0.9428571428571428,35,800,600,200,0.75,10,6,4,335.82542510112745,0.3595238095238095,0.03401006195706713,0.19295213591854624,130587.7074358068,1770.9344725222993,132358.6419083291,3303,0,1023.0285714285715,35,0,20,35.89214603857624,0.6282738095238094,44.47337962962963,1022.1064814814819,29.20304232804234,0
3433,4,1,1,33,0.029411764705882353,0.029411764705882353,0.9705882352941176,34,700,500,200,0.7142857142857143,9,5,4,338.39723808914533,0.3599970291146762,0.04627916855071845,0.1944764850223163,130597.00255102056,2038.7329931972968,132635.73554421787,3304,0,1044.9117647058824,34,0,20,35.81702771954344,0.6305147058823529,44.46428571428572,1022.1428571428584,30.06302521008407,0
3434,4,1,1,33,0.029411764705882353,0.029411764705882353,0.9705882352941176,34,1000,800,200,0.8,12,8,4,341.6141436000237,0.3579731134878194,0.04302699074739924,0.19678899258085888,130688.28125000012,2128.993055555572,132817.27430555568,3305,0,1045.8823529411766,34,0,20,35.64248845422441,0.6314338235294117,44.37500000000001,1022.5000000000009,30.07352941176473,0
3435,4,1,1,33,0.029411764705882353,0.029411764705882353,0.9705882352941176,34,1400,1100,300,0.7857142857142857,17,11,6,341.3357233049685,0.35574494949494945,0.04468411360820346,0.19724935241153968,130810.0357851474,2130.0276360544203,132940.0634212018,3306,0,1046.8529411764705,34,0,20,35.52649443345358,0.6326593137254901,44.25595238095238,1022.9761904761905,30.087535014005603,0
3436,4,0,0,33,0.0,0.0,1.0,33,850,600,250,0.7058823529411765,11,6,5,351.75348879453696,0.3508128156565657,0.058768633004702364,0.20285990767038123,130732.14215986659,2597.0974204633058,133329.2395803299,3307,45,1079.5757575757575,33,0,20,35.338900539245074,0.6341540404040403,44.332107843137265,1022.6715686274525,30.990047534165228,0
3437,4,0,1,32,0.0,0.030303030303030304,0.9696969696969697,33,900,700,200,0.7777777777777778,11,7,4,350.79496102969523,0.35144412878787884,0.057520212306362284,0.20263567748891814,130794.81336805565,2576.432291666673,133371.24565972234,3308,46,1080.5757575757575,33,0,21,35.29998302783433,0.6347853535353535,44.270833333333336,1022.9166666666674,30.99747474747477,0
3438,4,0,0,32,0.0,0.0,1.0,32,550,200,350,0.36363636363636365,9,2,7,354.576131687243,0.3513944892473118,0.06518518518518546,0.20456315289648636,130746.38429752066,2871.9094352617126,133618.2937327824,3309,47,1107.5625,32,0,21,35.25231481481483,0.63671875,44.31818181818182,1022.7272727272727,31.960227272727273,0
3439,4,0,0,32,0.0,0.0,1.0,32,700,500,200,0.7142857142857143,9,5,4,355.7788651372361,0.35114247311827956,0.06567822759812336,0.2056005966720321,130810.95838434859,2907.954864299562,133718.91324864814,3310,48,1108.5625,32,0,21,35.15618571546118,0.6373697916666666,44.255050505050505,1022.9797979797985,31.968118686868703,0
3440,4,0,0,32,0.0,0.0,1.0,32,650,500,150,0.7692307692307693,8,5,3,374.74503983119007,0.3517515120967742,0.11228374555979515,0.21465237737429363,130468.48127312415,3406.302469912199,133874.78374303636,3311,49,1109.5625,30,2,22,35.01869271587074,0.639236111111111,44.59005376344087,1021.6397849462373,34.05465949820791,3
3441,4,0,0,32,0.0,0.0,1.0,32,500,400,100,0.8,6,4,2,375.12224808495637,0.35242355510752693,0.10970587268183607,0.21524939261810747,130537.14889365826,3393.477750317956,133930.62664397623,3312,50,1110.5625,30,2,16,34.939333157963944,0.6399305555555554,44.52284946236559,1021.908602150538,34.063620071684596,0
3442,4,2,1,33,0.058823529411764705,0.029411764705882353,0.9705882352941176,34,550,300,250,0.5454545454545454,8,3,5,355.15575497921617,0.36222519310754603,0.09926289213267947,0.20627527660254205,131004.77629833703,2505.420046423852,133510.1963447609,3313,0,1046.1764705882354,32,2,17,34.97600106890314,0.6393229166666665,44.065656565656575,1023.7373737373748,31.991792929292963,0
3443,4,1,1,33,0.029411764705882353,0.029411764705882353,0.9705882352941176,34,350,200,150,0.5714285714285714,5,2,3,354.51901252756375,0.36506610219845514,0.10318600248090348,0.20607847115311953,131037.09323347126,2491.028179522521,133528.1214129938,3314,0,1047.1470588235295,32,2,17,34.95961277592797,0.6396484375,44.03409090909092,1023.8636363636379,31.995738636363683,0
3444,4,0,0,33,0.0,0.0,1.0,33,850,500,350,0.5882352941176471,12,5,7,364.3176179294819,0.35854640151515155,0.10917419519022764,0.21099278992688283,130894.7266472711,2937.451002332903,133832.177649604,3315,2,1079.878787878788,31,2,17,34.85295521058658,0.6407930107526882,44.173177083333336,1023.3072916666671,33.009912634408614,0
3445,4,1,0,34,0.029411764705882353,0.0,1.0,34,550,200,350,0.36363636363636365,9,2,7,353.7490881965078,0.36456476530005943,0.11411735714492766,0.20684636886187754,131263.42337516596,2486.8632665034356,133750.2866416694,3316,0,1049.0882352941176,32,2,18,34.75054419254147,0.6419270833333333,43.81313131313132,1024.747474747476,32.023358585858624,0
3446,4,0,0,34,0.0,0.0,1.0,34,850,400,450,0.47058823529411764,13,4,9,352.2952728082362,0.36389631610219847,0.11042688030611059,0.2061753230577522,131296.72369100832,2451.043018310281,133747.7667093186,3317,1,1050.0882352941176,33,1,18,34.75415022519831,0.6398358585858585,43.78063725490197,1024.8774509803927,31.056892453951296,0
3447,4,0,0,34,0.0,0.0,1.0,34,1150,700,450,0.6086956521739131,16,7,9,351.90624211692307,0.36352495543672014,0.1130497131931163,0.206794342277698,131453.7677816228,2451.8802864283343,133905.64806805112,3318,2,1051.0882352941176,33,1,20,34.60554094964944,0.6414141414141412,43.627450980392176,1025.490196078434,31.075460487225275,0
3448,4,0,0,34,0.0,0.0,1.0,34,850,600,250,0.7058823529411765,11,6,5,351.5344574950361,0.363543523469994,0.11190106344844053,0.20674573961883078,131485.18786344223,2444.314836841637,133929.50270028386,3319,3,1052.0882352941176,33,1,21,34.58335822678934,0.6417297979797978,43.596813725490215,1025.6127450980416,31.07917409388005,0
3449,4,0,0,34,0.0,0.0,1.0,34,1150,1000,150,0.8695652173913043,13,10,3,351.8362276494812,0.3632650029708853,0.10711726773346064,0.20777690905054713,131642.34459102285,2463.3091839677218,134105.65377499058,3320,4,1053.0882352941176,33,1,18,34.41704482127219,0.6433080808080807,43.4436274509804,1026.2254901960796,31.09774212715393,0
3450,4,0,0,34,0.0,0.0,1.0,34,800,700,100,0.875,9,7,2,350.745805301849,0.36302361853832443,0.10525373134328375,0.20730388986612466,131673.78720023562,2436.805705738194,134110.5929059738,3321,5,1054.0882352941176,33,1,18,34.413308457711445,0.6436237373737372,43.41299019607844,1026.3480392156873,31.101455733808706,0
3451,4,1,1,34,0.02857142857142857,0.02857142857142857,0.9714285714285714,35,700,500,200,0.7142857142857143,9,5,4,341.0974006710558,0.3670168067226891,0.09760442362134292,0.2028483439276736,131908.37762188227,1998.7209467120335,133907.09856859432,3322,0,1024.942857142857,34,1,18,34.424614671456716,0.643688725490196,43.18452380952382,1027.2619047619062,30.213585434173712,0
3452,4,0,0,34,0.0,0.0,1.0,34,900,600,300,0.6666666666666666,12,6,6,339.31985558063,0.3628379382055853,0.062485972536777235,0.2050857743477895,132520.55165816317,2193.370890022663,134713.92254818583,3323,7,1056.0882352941176,34,0,21,33.85482907465218,0.6498161764705883,42.58928571428571,1029.6428571428564,30.28361344537813,4
3453,4,0,0,34,0.0,0.0,1.0,34,900,800,100,0.8888888888888888,10,8,2,338.3788397691687,0.3630793226381462,0.06210736721873222,0.2050177676248492,132612.49999999988,2174.652777777763,134787.15277777764,3324,8,1057.0882352941176,34,0,21,33.7867448759439,0.6507352941176471,42.49999999999999,1029.999999999999,30.294117647058798,0
3454,4,0,0,34,0.0,0.0,1.0,34,700,300,400,0.42857142857142855,11,3,8,339.9940789178876,0.36255941770647654,0.06447205644448717,0.20633301254946676,132673.81660997713,2221.66241496597,134895.4790249431,3325,9,1058.0882352941176,34,0,18,33.683604884061324,0.6513480392156863,42.44047619047618,1030.2380952380938,30.30112044817923,0
3455,4,0,0,34,0.0,0.0,1.0,34,800,500,300,0.625,11,5,6,358.8132055459266,0.36255941770647654,0.07303177980643882,0.20364431599527077,130110.72137188191,2537.0890022675567,132647.81037414947,3326,10,1059.0882352941176,34,0,19,35.78860365616493,0.6256127450980392,44.94047619047618,1020.2380952380938,30.007002801120407,7
3456,4,0,0,34,0.0,0.0,1.0,34,450,100,350,0.2222222222222222,8,1,7,364.6153331231511,0.36248514557338085,0.011198383562423198,0.1978109956864971,128330.72015570945,2563.9385901419464,130894.6587458514,3327,11,1060.0882352941176,33,1,18,37.455148363167226,0.6098484848484848,46.69117647058824,1013.2352941176479,30.704099821746905,8
3457,4,2,1,35,0.05555555555555555,0.027777777777777776,0.9722222222222222,36,1100,900,200,0.8181818181818182,13,9,4,346.19731457519697,0.37928240740740743,0.02192982456140391,0.19112704574472206,129024.94454089513,1733.6178626543315,130758.56240354945,3328,0,1002.1388888888889,35,1,16,37.21377306903622,0.6124999999999999,46.00694444444445,1015.9722222222229,29.027777777777796,0
3458,4,2,1,36,0.05405405405405406,0.02702702702702703,0.972972972972973,37,700,500,200,0.7142857142857143,9,5,4,341.21714780924617,0.3825075075075075,0.023471810454058772,0.1897858414523833,129319.08543381348,1425.2984610768222,130744.3838948903,3329,0,976.0,35,2,18,37.04104081323016,0.6154761904761905,45.717592592592595,1017.12962962963,29.06084656084657,0
3459,4,1,1,36,0.02702702702702703,0.02702702702702703,0.972972972972973,37,800,600,200,0.75,10,6,4,344.5467652592157,0.3800988488488488,0.036949741099826294,0.19264391611282933,129525.18332315257,1525.4965867198384,131050.6799098724,3330,0,976.972972972973,35,2,17,36.746849535721054,0.6175595238095237,45.515046296296305,1017.9398148148159,29.08399470899474,0
3460,4,2,3,35,0.05263157894736842,0.07894736842105263,0.9210526315789473,38,850,700,150,0.8235294117647058,10,7,3,331.44825991444105,0.3832533191085823,0.05340124504810384,0.18749810323627122,129982.90339335169,1016.5214296706565,130999.42482302235,3331,0,951.7631578947369,37,1,17,36.616039426523294,0.6182432432432432,45.065789473684205,1019.7368421052623,27.560455192034116,0
3461,4,0,0,35,0.0,0.0,1.0,35,800,400,400,0.5,12,4,8,356.8686720347887,0.36946778711484596,0.056768544357736594,0.1992730422746838,129473.85381235834,2241.0324546485394,131714.8862670069,3332,2,1034.2857142857142,34,1,17,36.48550512730536,0.6191789215686274,45.5654761904762,1017.7380952380958,29.933473389355758,0
3462,4,2,1,36,0.05405405405405406,0.02702702702702703,0.972972972972973,37,850,400,450,0.47058823529411764,13,4,9,341.72089638112476,0.38322697697697694,0.062238273613204775,0.19327187487389696,129975.34855379054,1483.0585230501074,131458.40707684064,3333,0,979.3243243243244,36,1,18,36.361816675869704,0.6200810185185184,45.07319819819821,1019.7072072072093,28.325200200200257,0
3463,4,1,0,37,0.02702702702702703,0.0,1.0,37,700,500,200,0.7142857142857143,9,5,4,340.8859566667253,0.38166291291291293,0.07004531852749074,0.19336793246361125,130090.20580969505,1469.1848520818357,131559.39066177688,3334,0,980.2972972972973,36,1,19,36.26665010854767,0.6212384259259258,44.9605855855856,1020.1576576576595,28.33771271271276,0
3464,4,1,1,37,0.02631578947368421,0.02631578947368421,0.9736842105263158,38,950,800,150,0.8421052631578947,11,8,3,370.6478065427053,0.38830606922712185,0.05804142526565914,0.20338392087527077,128783.6897530969,1966.9689859234124,130750.6587390203,3335,0,955.4736842105264,37,1,18,36.8391262468042,0.6061373873873874,46.24451754385964,1015.0219298245597,27.433025130393506,6
3465,4,0,1,36,0.0,0.02702702702702703,0.972972972972973,37,850,500,350,0.5882352941176471,12,5,7,374.58335279947414,0.3877002002002002,0.05164938624002313,0.20563302936263442,128800.98637488829,2249.3410640369966,131050.32743892529,3336,1,960.972972972973,36,1,18,36.72158124399084,0.6082175925925927,46.22747747747747,1015.0900900900891,28.19694694694692,0
3466,4,2,2,36,0.05263157894736842,0.05263157894736842,0.9473684210526316,38,1300,1100,200,0.8461538461538461,15,11,4,364.57142724148713,0.3952850877192982,0.05038891727701089,0.20188632798856546,129145.65659626042,1816.5632694675296,130962.21986572795,3337,0,936.4736842105264,37,1,18,36.62396619920891,0.6097972972972973,45.88815789473684,1016.4473684210529,27.471550497866296,0
3467,4,0,0,36,0.0,0.0,1.0,36,1000,800,200,0.8,12,8,4,380.4970414201184,0.3853174603174603,0.055811965811966235,0.2095958279009127,128936.76757812499,2612.0117187499995,131548.77929687497,3338,3,989.5,35,1,18,36.43269230769232,0.6116071428571428,46.09375,1015.6249999999999,29.01785714285714,0
3468,4,1,0,37,0.02702702702702703,0.0,1.0,37,950,600,350,0.631578947368421,13,6,7,376.1915260298616,0.3900462962962963,0.05895010279906754,0.20906988748158056,129287.27027280677,2327.3551000324837,131614.62537283925,3339,0,963.7297297297297,36,1,19,36.184161960654045,0.6131365740740741,45.74887387387388,1017.0045045045059,28.250125125125166,0
3469,4,2,2,37,0.05128205128205128,0.05128205128205128,0.9487179487179487,39,1300,700,600,0.5384615384615384,19,7,12,364.2056681966379,0.398897885739991,0.05679671270280173,0.20549297931780733,129881.14458917745,1660.6898102491023,131541.83439942656,3340,0,915.2564102564103,38,1,18,35.884384935191974,0.6154057017543859,45.16559829059829,1019.3376068376069,26.824673864147552,0
3470,4,1,1,37,0.02631578947368421,0.02631578947368421,0.9736842105263158,38,900,600,300,0.6666666666666666,12,6,6,377.59965806786687,0.39389224751066854,0.12028220221606634,0.20498267152255653,128355.55555555577,2102.537050734192,130458.09260628995,3341,0,940.3157894736842,34,4,20,37.1008086622807,0.6078431372549018,46.66666666666668,1013.3333333333351,29.8039215686275,4
3471,4,1,1,37,0.02631578947368421,0.02631578947368421,0.9736842105263158,38,850,700,150,0.8235294117647058,10,7,3,370.15797871076876,0.39885609293504026,0.11841054433002096,0.2023976720773479,128643.06205257634,1923.6511649091296,130566.71321748546,3342,0,930.8157894736842,35,3,17,36.99527001331053,0.6086309523809523,46.383101851851855,1014.4675925925928,28.984788359788368,0
3472,4,2,1,38,0.05128205128205128,0.02564102564102564,0.9743589743589743,39,1050,700,350,0.6666666666666666,14,7,7,364.65678296374597,0.404942645074224,0.11763268136577865,0.20134231921045995,129029.711721857,1610.311916646383,130640.0236385034,3343,0,907.8974358974359,36,3,19,36.740052094879196,0.6105324074074074,46.002252252252255,1015.9909909909911,28.221971971971975,0
3473,4,0,0,38,0.0,0.0,1.0,38,1050,800,250,0.7619047619047619,13,8,5,371.07166337935587,0.4004119250829777,0.1281781376518223,0.20440388236998397,128936.76757812488,1968.9561631944312,130905.72374131932,3344,1,932.7894736842105,35,3,20,36.67200854700855,0.6116071428571429,46.09374999999999,1015.6249999999991,29.017857142857117,0
3474,4,2,1,39,0.05,0.025,0.975,40,800,500,300,0.625,11,5,6,351.78606412167693,0.405355235042735,0.12192937563971373,0.19639713408393045,129466.28146701383,1109.429253472218,130575.71072048605,3345,0,887.1,35,5,16,36.622526441487544,0.6169642857142856,45.572916666666664,1017.7083333333328,29.07738095238094,0
3475,4,0,0,39,0.0,0.0,1.0,39,900,700,200,0.7777777777777778,11,7,4,359.18652626269323,0.4027496626180837,0.12427812427812457,0.20025878929988505,129413.28124999991,1496.7013888888748,130909.98263888879,3346,1,910.8461538461538,34,5,21,36.48819273819274,0.6185661764705883,45.62499999999999,1017.4999999999993,29.926470588235276,0
3476,4,2,0,41,0.04878048780487805,0.0,1.0,41,1050,700,350,0.6666666666666666,14,7,7,346.9961062303523,0.4105436991869919,0.14181188516091892,0.19654432358525933,130032.77084094207,824.1730328301047,130856.94387377218,3347,0,867.3658536585366,36,5,18,36.169077325089255,0.6206597222222223,45.01689189189188,1019.9324324324307,28.331456456456408,0
3477,4,1,1,41,0.023809523809523808,0.023809523809523808,0.9761904761904762,42,1100,800,300,0.7272727272727273,14,8,6,338.7798643641166,0.4141744096012389,0.14153753987144024,0.19346632642618733,130351.21588059381,432.4792583616468,130783.69513895546,3348,0,847.6904761904761,35,7,19,36.05597585855153,0.6258928571428574,44.70486111111109,1021.1805555555529,29.176587301587226,0
3478,4,1,0,42,0.023809523809523808,0.0,1.0,42,900,600,300,0.6666666666666666,12,6,6,339.0946903188326,0.4122991676345335,0.15091948444156889,0.1946818020491083,130558.13426997565,454.31402177636573,131012.44829175202,3349,0,848.547619047619,35,7,16,35.83852397130993,0.6279761904761907,44.502314814814795,1021.9907407407379,29.199735449735368,0
3479,4,0,0,42,0.0,0.0,1.0,42,950,800,150,0.8421052631578947,11,8,3,333.3354232182128,0.41272260936895083,0.11020303183001601,0.19091028784315825,130463.84222059902,297.644012255504,130761.48623285453,3350,1,849.547619047619,36,6,20,36.08102770429159,0.625,44.5945945945946,1021.6216216216219,28.378378378378386,2
3480,4,1,2,41,0.023255813953488372,0.046511627906976744,0.9534883720930233,43,800,700,100,0.875,9,7,2,327.16463656488656,0.41447489848652636,0.11622172188270574,0.1887114758961471,130738.73842191834,-45.381631848258735,130693.35679007009,3351,0,830.7674418604652,37,6,17,35.96089757335332,0.6258445945945945,44.32565789473684,1022.6973684210532,27.64046941678522,0
3481,4,2,2,41,0.046511627906976744,0.046511627906976744,0.9534883720930233,43,1150,800,350,0.6956521739130435,15,8,7,325.8458176955714,0.41373661867847916,0.1185572920561333,0.18836068643740264,130822.85534972293,-74.38394506002481,130748.47140466291,3352,0,831.5116279069767,37,6,18,35.90969989281886,0.6266891891891893,44.243421052631575,1023.0263157894731,27.649359886201974,0
3482,4,1,0,42,0.023809523809523808,0.0,1.0,42,850,600,250,0.7058823529411765,11,6,5,335.1322674838086,0.4085002903600465,0.12589977089591775,0.19351598128133715,130780.41459956572,365.74737744500646,131146.16197701072,3353,0,852.1666666666666,36,6,19,35.715072112738085,0.6281828703703705,44.284909909909906,1022.8603603603599,28.412787787787774,0
3483,4,0,1,41,0.0,0.023809523809523808,0.9761904761904762,42,1900,1600,300,0.8421052631578947,22,16,6,339.23007561478323,0.4087301587301588,0.11765763664110285,0.1930183670658333,130209.42382812525,434.19053819447373,130643.61436631971,3354,1,853.1666666666666,39,3,20,36.18808260189156,0.6169871794871793,44.843750000000014,1020.6250000000019,26.169871794871845,5
3484,4,1,1,41,0.023809523809523808,0.023809523809523808,0.9761904761904762,42,1300,1000,300,0.7692307692307693,16,10,6,339.06533621970743,0.41093205574912894,0.11492683824657246,0.19374567739572723,130374.54433094799,441.11944300169677,130815.66377394968,3355,0,854.1190476190476,37,5,20,36.0250697874168,0.6221846846846846,44.68201754385965,1021.2719298245614,27.601944049312472,0
3485,4,0,0,41,0.0,0.0,1.0,41,1000,700,300,0.7,13,7,6,349.1008306738086,0.40678353658536587,0.12543477149781945,0.19920058097667862,130320.07250071016,898.9691126937745,131219.04161340394,3356,4,875.9512195121952,36,5,20,35.8240505863755,0.6235532407407407,44.73536036036036,1021.0585585585584,28.36273773773773,0
3486,4,0,0,41,0.0,0.0,1.0,41,1350,1100,250,0.8148148148148148,16,11,5,351.14538365202156,0.4064278455284553,0.1278209033881761,0.20096150000678134,130435.08193582078,960.3353776073161,131395.4173134281,3357,5,876.9512195121952,36,5,20,35.655293425936115,0.6247106481481483,44.62274774774774,1021.5090090090075,28.375250250250208,0
3487,4,1,0,42,0.023809523809523808,0.0,1.0,42,900,700,200,0.7777777777777778,11,7,4,342.77088646035276,0.40983110723964383,0.1290470220683344,0.19765077862641536,130726.51855504415,561.8489297976414,131288.3674848418,3358,0,857.047619047619,38,4,19,35.57424432372196,0.6239035087719298,44.337606837606835,1022.6495726495723,26.91183085919927,0
3488,4,0,0,42,0.0,0.0,1.0,42,1250,1100,150,0.88,14,11,3,342.2887878436692,0.40967382888114595,0.12015168469476545,0.1977921028125004,130808.47447083422,554.8548332602771,131363.32930409448,3359,1,858.047619047619,38,4,19,35.50369886858137,0.6247258771929824,44.25747863247863,1022.9700854700852,26.920265407107507,0
3489,4,0,1,41,0.0,0.023809523809523808,0.9761904761904762,42,1300,1000,300,0.7692307692307693,16,10,6,340.4075131596838,0.4096617305458769,0.11524294196049967,0.19731585939786978,130928.03955078124,513.7776692708326,131441.81722005206,3360,2,859.047619047619,39,3,19,35.430979643765895,0.624198717948718,44.140625,1023.4374999999999,26.241987179487175,0
3490,4,0,0,41,0.0,0.0,1.0,41,1050,500,550,0.47619047619047616,16,5,11,349.8129373789693,0.40663109756097565,0.12637400410959954,0.2027137402996459,130917.78897518075,959.3472633136022,131877.13623849436,3361,3,880.4878048780488,38,3,19,35.20069944670634,0.6258223684210527,44.15064102564102,1023.3974358974355,26.931511470985143,0
3491,4,0,0,41,0.0,0.0,1.0,41,1250,900,350,0.72,16,9,7,345.4814469836692,0.40696138211382116,0.1157682698229563,0.1974272994766789,130377.5708774652,809.8904740439207,131187.46135150912,3362,4,881.4878048780488,36,5,22,35.858189068989596,0.6241319444444444,44.67905405405405,1021.2837837837831,28.368993993993975,2
3492,4,1,1,41,0.023809523809523808,0.023809523809523808,0.9761904761904762,42,1250,1000,250,0.8,15,10,5,339.11595274599887,0.41118612078977934,0.1188331878264337,0.19560510150042837,130738.73842191813,467.1183681517249,131205.85679006984,3363,0,861.4761904761905,37,5,15,35.6553330831636,0.6258445945945947,44.325657894736835,1022.6973684210514,27.640469416785173,0
3493,4,1,1,41,0.023809523809523808,0.023809523809523808,0.9761904761904762,42,1250,700,550,0.56,18,7,11,341.42270317800205,0.41147648083623695,0.12181272766231022,0.19794034232692317,130935.05333371778,540.8399699907375,131475.89330370852,3364,0,862.452380952381,37,5,17,35.39791800585673,0.6278153153153154,44.13377192982455,1023.4649122806994,27.66121384542431,0
3494,4,0,0,41,0.0,0.0,1.0,41,1100,900,200,0.8181818181818182,13,9,4,350.83424468098985,0.4075965447154472,0.13094388042713812,0.2030369393102848,130866.81909950484,982.5123265156965,131849.33142602054,3365,1,884.3414634146342,36,5,18,35.2261262748551,0.6290509259259259,44.20045045045045,1023.1981981981976,28.422172172172154,0
3495,4,2,3,40,0.046511627906976744,0.06976744186046512,0.9302325581395349,43,1200,900,300,0.75,15,9,6,311.13309888992643,0.41620524178663715,0.03077193396171851,0.1789415575605358,130625.94112507439,-470.77760603525735,130155.16351903912,3366,0,844.1627906976744,40,3,14,36.484532922424364,0.61953125,44.4359756097561,1022.2560975609758,25.556402439024396,5
3496,4,1,0,41,0.024390243902439025,0.0,1.0,41,700,400,300,0.5714285714285714,10,4,6,325.0055464723452,0.4064278455284553,0.031463873960773325,0.18556768298582285,130344.39718934905,272.530407626558,130616.92759697561,3367,0,886.2682926829268,38,3,19,36.41452186649927,0.6200657894736842,44.71153846153846,1021.1538461538456,26.872469635627517,0
3497,4,2,3,40,0.046511627906976744,0.06976744186046512,0.9302325581395349,43,950,600,350,0.631578947368421,13,6,7,311.8321510309261,0.412375415282392,0.03862955408068314,0.18031098589479203,130833.79937743722,-440.3629825170319,130393.43639492018,3368,0,846.0,40,3,15,36.257077580212595,0.6216145833333334,44.23272357723577,1023.0691056910556,25.57672764227639,0
3498,4,0,0,40,0.0,0.0,1.0,40,800,600,200,0.75,10,6,4,333.2079087193952,0.40273771367521366,0.035465865178188505,0.190673518281934,130430.5411280394,692.0975684826163,131122.63869652202,3369,17,910.425,37,3,21,36.11796908544441,0.6227477477477477,44.627192982456144,1021.4912280701755,27.60787102892366,0
3499,4,0,1,39,0.0,0.025,0.975,40,1050,800,250,0.7619047619047619,13,8,5,334.61437672031855,0.40329861111111115,0.037472556194459106,0.19199679144150264,130535.38795976705,735.8034964204916,131271.19145618755,3370,18,911.425,38,2,16,35.975997560550624,0.6219846491228069,44.524572649572654,1021.90170940171,26.892150247413422,0
3500,4,1,0,40,0.025,0.0,1.0,40,1000,700,300,0.7,13,7,6,330.6756471173709,0.4038060897435898,0.06356396866840752,0.19108143157204735,130808.47447083419,651.0353888158315,131459.50985965002,3371,0,911.825,38,2,17,35.80069625761532,0.6247258771929824,44.25747863247863,1022.970085470085,26.9202654071075,0
3501,4,0,0,40,0.0,0.0,1.0,40,1050,700,350,0.6666666666666666,14,7,7,330.04258175304295,0.4032318376068376,0.057557411273486236,0.19139273203354445,130945.12473518887,643.4934071152036,131588.61814230407,3372,1,912.825,38,2,18,35.678931802366044,0.6260964912280702,44.123931623931625,1023.5042735042739,26.934322986954577,0
3502,4,1,1,40,0.024390243902439025,0.024390243902439025,0.975609756097561,41,950,700,250,0.7368421052631579,12,7,5,322.6216167183284,0.40688516260162605,0.05082375345916912,0.18843861176018295,131221.37586805565,266.97048611112007,131488.34635416677,3373,0,891.5365853658536,39,2,19,35.59034838010031,0.6271367521367521,43.85416666666667,1024.5833333333342,26.271367521367544,0
3503,4,0,0,40,0.0,0.0,1.0,40,1600,1300,300,0.8125,19,13,6,329.11977087707595,0.4032852564102564,0.0490198123044836,0.19222037775341996,131218.63928153983,637.3296990284045,131855.96898056823,3374,3,914.825,38,2,19,35.42665971498089,0.6288377192982457,43.8568376068376,1024.5726495726487,26.96243814664865,0
3504,4,0,0,40,0.0,0.0,1.0,40,850,600,250,0.7058823529411765,11,6,5,329.1691453499898,0.4030715811965812,0.04898373983739823,0.19279907084785136,131328.12500000015,645.8333333333476,131973.9583333335,3375,4,915.825,38,2,19,35.315040650406495,0.6299342105263157,43.75000000000001,1025.0000000000011,26.973684210526347,0
3505,4,0,0,40,0.0,0.0,1.0,40,1000,700,300,0.7,13,7,6,333.4739539618064,0.4029113247863248,0.0438301967493584,0.19589500109615648,131440.53939673727,766.3992767005018,132206.93867343778,3376,5,916.825,37,3,19,35.091424294268606,0.632882882882883,43.64035087719297,1025.4385964912267,27.714556661925045,0
3506,4,0,0,40,0.0,0.0,1.0,40,1250,400,850,0.32,21,4,17,332.34989136198453,0.4029647435897436,0.04213339033775121,0.19581017528858471,131553.00188519535,744.3251769775184,132297.32706217287,3377,6,917.825,37,3,19,35.006947413424534,0.6340090090090091,43.53070175438596,1025.8771929824554,27.726410621147444,0
3507,4,1,0,41,0.024390243902439025,0.0,1.0,41,1200,1000,200,0.8333333333333334,14,10,4,324.70286705267273,0.4064532520325203,0.04767945120682726,0.19293531296936914,131876.23844875433,364.1185440864784,132240.3569928408,3378,0,896.4146341463414,38,3,17,34.87795575896262,0.6354166666666667,43.21581196581196,1027.136752136751,27.029914529914503,0
3508,4,0,0,41,0.0,0.0,1.0,41,1400,1200,200,0.8571428571428571,16,12,4,322.9225825289217,0.4055132113821138,0.04671184223535385,0.19285153113040082,132068.3478180474,329.57038954635095,132397.91820759373,3379,1,897.4146341463414,38,3,18,34.73066729030244,0.6373355263157894,43.02884615384615,1027.8846153846157,27.04959514170041,0
3509,4,1,2,40,0.023809523809523808,0.047619047619047616,0.9523809523809523,42,1200,800,400,0.6666666666666666,16,8,8,315.8082214780624,0.40822202864885787,0.05343465455825003,0.19012001340534915,132371.20361328128,-39.217122395832575,132331.98649088544,3380,0,877.0238095238095,39,3,19,34.609715052130774,0.6386217948717949,42.734375,1029.0625000000002,26.386217948717956,0
3510,4,0,1,39,0.0,0.025,0.975,40,1200,1000,200,0.8333333333333334,14,10,4,321.3555412333541,0.403392094017094,0.06182398217540985,0.19277427789417617,132237.24500868065,499.0342881944499,132736.2792968751,3381,1,915.775,39,1,19,34.60139423401527,0.6372863247863249,42.864583333333336,1028.5416666666674,26.37286324786327,0
3511,4,0,0,39,0.0,0.0,1.0,39,1050,800,250,0.7619047619047619,13,8,5,329.2564409752817,0.4014563652721548,0.07756756468846215,0.19763597342331746,132260.59701219955,909.5306907005609,133170.12770290012,3382,2,939.5128205128206,38,1,20,34.37478361722754,0.6392543859649124,42.84188034188034,1028.6324786324785,27.069275753486277,0
3512,4,0,0,39,0.0,0.0,1.0,39,1200,900,300,0.75,15,9,6,333.567648259953,0.401006522717049,0.08498381463497728,0.20080772425249158,132370.51647308056,1030.9043757761656,133401.4208488567,3383,3,940.5128205128206,38,1,20,34.15351605758582,0.6403508771929824,42.73504273504273,1029.0598290598289,27.080521817363916,0
3513,4,0,0,39,0.0,0.0,1.0,39,1200,900,300,0.75,15,9,6,336.90812397186943,0.40075348627980206,0.08764757449388405,0.2034231753036578,132482.65241468514,1126.8992303383166,133609.55164502346,3384,4,941.5128205128206,37,2,20,33.954960592182324,0.6432995495495495,42.62609649122806,1029.4956140350866,27.824205784732072,0
3514,4,0,1,38,0.0,0.02564102564102564,0.9743589743589743,39,1300,900,400,0.6923076923076923,17,9,8,339.9063966150737,0.4001068376068376,0.0898445816478608,0.20600520579367756,132623.79410010777,1215.9351915974214,133839.72929170518,3385,5,942.5128205128206,37,2,20,33.7360726704989,0.6447072072072071,42.4890350877193,1030.043859649123,27.839023233760084,0
3515,4,0,0,38,0.0,0.0,1.0,38,1050,800,250,0.7619047619047619,13,8,5,346.0341422336985,0.39885609293504026,0.09991367154902053,0.2094296645087475,132571.90626014542,1574.8811734031522,134146.78743354857,3386,6,967.1578947368421,36,2,20,33.63039912520503,0.6461226851851851,42.53941441441442,1029.8423423423435,28.606731731731763,0
3516,4,0,0,38,0.0,0.0,1.0,38,600,300,300,0.5,9,3,6,343.57570655264925,0.39885609293504026,0.09628029522927406,0.20858487984407378,132687.90486009675,1517.6681326597009,134205.57299275644,3387,7,968.1578947368421,36,2,15,33.57721244580462,0.6472800925925926,42.42680180180181,1030.292792792794,28.61924424424428,0
3517,4,0,1,37,0.0,0.02631578947368421,0.9736842105263158,38,900,500,400,0.5555555555555556,13,5,8,339.87052965142595,0.39918207681365575,0.08736842105263176,0.20691599603130872,132793.26331178838,1426.5033471837678,134219.76665897216,3388,8,969.1578947368421,37,1,16,33.56693262411349,0.6463963963963963,42.32456140350878,1030.701754385966,27.856804172593677,0
3518,4,0,1,36,0.0,0.02702702702702703,0.972972972972973,37,700,400,300,0.5714285714285714,10,4,6,348.48227032236974,0.39408158158158163,0.09537595306531754,0.21156365568542562,132687.90486009675,1847.8764659930334,134535.78132608978,3389,9,994.918918918919,36,1,17,33.45083251357159,0.6472800925925926,42.42680180180181,1030.292792792794,28.61924424424428,0
3519,4,0,0,36,0.0,0.0,1.0,36,1050,600,450,0.5714285714285714,15,6,9,349.55050400648867,0.3939318783068783,0.09135539087257039,0.21293411687289918,132815.2394654491,2085.1267789780372,134900.36624442713,3390,10,1008.6666666666666,35,1,17,33.295437532749446,0.6505952380952382,42.30324074074073,1030.787037037036,29.451058201058174,0
3520,4,0,0,36,0.0,0.0,1.0,36,800,400,400,0.5,12,4,8,344.7669200509111,0.3937665343915344,0.08855702377052155,0.21060911853943906,132920.05423920532,1965.287542610166,134885.34178181548,3391,11,1009.6666666666666,36,0,17,33.31353973280914,0.6495949074074074,42.20157657657657,1031.193693693693,28.644269269269248,0
3521,4,0,0,36,0.0,0.0,1.0,36,950,700,250,0.7368421052631579,12,7,5,345.4460222019671,0.39401455026455023,0.09225085535415278,0.2111878952820838,132949.08717839466,1985.3466642317976,134934.43384262646,3392,12,1010.6666666666666,36,0,17,33.26690689379047,0.6498842592592593,42.17342342342342,1031.3063063063066,28.647397397397405,0
3522,4,0,0,36,0.0,0.0,1.0,36,1150,1000,150,0.8695652173913043,13,10,3,345.4629790659208,0.39389880952380957,0.0950461598185155,0.2113624198573659,132978.12328798385,1987.8037243324338,134965.92701231627,3393,13,1011.6666666666666,36,0,18,33.23734396040326,0.6501736111111112,42.14527027027027,1031.4189189189183,28.65052552552551,0
3523,4,1,1,36,0.02702702702702703,0.02702702702702703,0.972972972972973,37,1050,700,350,0.6666666666666666,14,7,7,339.4169698117123,0.397804054054054,0.10335686004475808,0.2097971033875541,133358.94217451502,1652.85761003383,135011.79978454884,3394,0,985.2972972972973,37,0,19,33.01176574663835,0.6520270270270272,41.77631578947367,1032.8947368421034,27.916073968705497,0
3524,4,0,1,35,0.0,0.027777777777777776,0.9722222222222222,36,1350,1300,50,0.9629629629629629,14,13,1,345.4601664903844,0.3939318783068783,0.10996291852982898,0.2130144093174399,133268.65875588404,2007.8026083515676,135276.4613642356,3395,1,1013.2777777777778,36,0,19,32.94615915948667,0.6530671296296298,41.863738738738725,1032.5450450450433,28.681806806806758,0
3525,4,0,0,35,0.0,0.0,1.0,35,1050,700,350,0.6666666666666666,14,7,7,347.3868983985692,0.3944327731092437,0.10165844912595268,0.21468702779147011,133352.6502486281,2264.992712620008,135617.64296124812,3396,2,1025.5428571428572,35,0,19,32.8122665471388,0.6559523809523811,41.7824074074074,1032.870370370369,29.510582010581974,0
3526,4,1,0,36,0.027777777777777776,0.0,1.0,36,850,600,250,0.7058823529411765,11,6,5,341.0323568267137,0.39636243386243386,0.09836952466233906,0.2124674390439232,133651.68065200606,1915.963112997246,135567.6437650033,3397,0,998.0277777777778,35,1,20,32.67713230355943,0.6589285714285715,41.49305555555555,1034.027777777777,29.54365079365077,0
3527,4,0,0,36,0.0,0.0,1.0,36,650,400,250,0.6153846153846154,9,4,5,340.8221119205187,0.39616402116402116,0.10203421864120155,0.21268061397498284,133711.52692043895,1914.368998628255,135625.8959190672,3398,1,999.0277777777778,35,1,17,32.62272455983287,0.6595238095238095,41.43518518518518,1034.2592592592591,29.550264550264547,0
3528,4,0,1,35,0.0,0.027777777777777776,0.9722222222222222,36,700,500,200,0.7142857142857143,9,5,4,341.2485321295081,0.3962466931216931,0.0990261152751366,0.21346540438808065,133801.3214404363,1931.9009077074693,135733.22234814375,3399,2,1000.0277777777778,35,1,17,32.52193105119887,0.6604166666666667,41.348379629629626,1034.6064814814808,29.560185185185166,0
3529,4,0,0,35,0.0,0.0,1.0,35,800,400,400,0.5,12,4,8,349.3732173078422,0.39380252100840335,0.09805314390949738,0.21805707700937743,133718.36734693882,2343.52324263039,136061.8905895692,3400,6,1029.5428571428572,34,1,17,32.39477823818294,0.6617647058823529,41.42857142857143,1034.2857142857147,30.420168067226903,0
3530,4,0,0,35,0.0,0.0,1.0,35,950,800,150,0.8421052631578947,11,8,3,348.55934936759945,0.3923669467787115,0.10168299257116598,0.21827650322069,133841.5249433108,2330.3429705215585,136171.86791383236,3401,7,1030.5428571428572,34,1,17,32.292625402669124,0.6629901960784312,41.30952380952382,1034.7619047619057,30.434173669467814,0
3531,4,0,0,35,0.0,0.0,1.0,35,1050,700,350,0.6666666666666666,14,7,7,349.97010912824965,0.3914565826330532,0.1090759780573527,0.22026338706204907,134026.3676303856,2381.044501133799,136407.41213151938,3402,8,1031.5428571428572,34,1,17,32.07130949643596,0.664828431372549,41.13095238095239,1035.4761904761913,30.455182072829157,0
3532,4,0,0,35,0.0,0.0,1.0,35,1450,1100,350,0.7586206896551724,18,11,7,350.3877316379218,0.3906862745098039,0.10588891806722733,0.22164061164073195,134211.33786848077,2405.2012471655407,136616.5391156463,3403,9,1032.5428571428572,34,1,19,31.87567018995099,0.6666666666666666,40.952380952380956,1036.1904761904766,30.47619047619049,0
3533,4,0,0,35,0.0,0.0,1.0,35,1000,700,300,0.7,13,7,6,352.6055659283487,0.390406162464986,0.10643562731777778,0.22341950924106282,134273.0229591836,2469.083049886613,136742.10600907024,3404,10,1033.5428571428572,34,1,19,31.756595068535116,0.6672794117647058,40.89285714285714,1036.4285714285709,30.483193277310907,0
3534,4,0,0,35,0.0,0.0,1.0,35,750,300,450,0.4,12,3,9,350.871854558635,0.38953081232493,0.11021204716532496,0.22326111943464338,134427.2976899092,2433.3510487528238,136860.648738662,3405,11,1034.5428571428572,34,1,19,31.64748593732063,0.6688112745098039,40.74404761904761,1037.0238095238087,30.50070028011202,0
3535,4,0,0,35,0.0,0.0,1.0,35,800,700,100,0.875,9,7,2,349.6578292314581,0.3892857142857143,0.10761511216056663,0.22267682808950756,134458.16326530615,2402.869897959187,136861.03316326535,3406,12,1035.5428571428572,34,1,19,31.64815771349862,0.6691176470588236,40.714285714285715,1037.1428571428573,30.504201680672274,0
3536,4,0,0,35,0.0,0.0,1.0,35,650,600,50,0.9230769230769231,7,6,1,358.3798019859936,0.38935574229691877,0.1276647763930865,0.21882493860015617,132902.9775206652,2531.0647665929273,135434.04228725814,3407,13,1036.5428571428572,33,2,20,32.9797559622851,0.6559343434343433,42.21813725490197,1031.127450980393,31.24628639334524,3
3537,4,0,0,35,0.0,0.0,1.0,35,1200,900,300,0.75,15,9,6,356.81214828143425,0.38883053221288516,0.13242106998598646,0.21850016006068038,133011.3112953515,2492.0103458049934,135503.3216411565,3408,14,1037.5428571428572,34,1,20,32.91137718792076,0.6547181372549019,42.11309523809524,1031.5476190476193,30.339635854341743,0
3538,4,0,0,35,0.0,0.0,1.0,35,900,500,400,0.5555555555555556,13,5,8,357.3485843214415,0.38872549019607844,0.1354424122590212,0.21973136355084383,133164.85969387757,2517.254818594107,135682.1145124717,3409,15,1038.5428571428572,34,1,20,32.74341599384853,0.65625,41.964285714285715,1032.1428571428573,30.35714285714286,0
3539,4,0,1,34,0.0,0.02857142857142857,0.9714285714285714,35,800,500,300,0.625,11,5,6,355.4703505456573,0.38907563025210085,0.1267842730312465,0.21911829070948713,133257.03124999988,2473.7847222222085,135730.8159722221,3410,16,1039.5428571428572,34,1,20,32.69942157654022,0.6571691176470589,41.87499999999999,1032.499999999999,30.367647058823504,0
3540,4,0,0,34,0.0,0.0,1.0,34,950,600,350,0.631578947368421,13,6,7,358.3604789328394,0.38926024955436717,0.12143998660088084,0.22161558891598696,133377.2636275711,2759.4280144655895,136136.6916420367,3411,17,1046.7058823529412,33,1,20,32.504226480009486,0.6606691919191918,41.75857843137255,1032.9656862745096,31.301990493166958,0
3541,4,0,0,34,0.0,0.0,1.0,34,1100,700,400,0.6363636363636364,15,7,8,356.40295774078663,0.3877005347593583,0.11201043260836818,0.22155436712405605,133570.09369260786,2720.989082641846,136291.0827752497,3412,18,1047.7058823529412,32,2,21,32.36151826065715,0.6650390625,41.571969696969695,1033.7121212121208,32.303503787878775,0
3542,4,0,0,34,0.0,0.0,1.0,34,800,700,100,0.875,9,7,2,357.43706717777724,0.38751485442661915,0.11370705322060459,0.22258951658698234,133635.36126734514,2753.246320528511,136388.60758787364,3413,19,1048.7058823529412,32,2,21,32.269406113892614,0.6656901041666667,41.50883838383838,1033.9646464646462,32.31139520202019,0
3543,4,0,0,34,0.0,0.0,1.0,34,700,600,100,0.8571428571428571,8,6,2,356.80645048735016,0.387310606060606,0.11800972372833862,0.22258961431392896,133700.64478433333,2741.050498673609,136441.69528300693,3414,20,1049.7058823529412,32,2,20,32.2203231188703,0.6663411458333334,41.44570707070707,1034.2171717171723,32.319286616161634,0
3544,4,0,0,34,0.0,0.0,1.0,34,1150,900,250,0.782608695652174,14,9,5,368.3202641998831,0.387310606060606,0.09612563856152989,0.2199923162766872,132073.33953486872,2929.057462248731,135002.39699711744,3415,21,1050.7058823529412,32,2,21,33.55904270564633,0.6500651041666667,43.02398989898989,1027.904040404039,32.12200126262622,6
3545,4,0,0,34,0.0,0.0,1.0,34,1050,700,350,0.6666666666666666,14,7,7,367.6685573237714,0.38758912655971484,0.09642609499595522,0.22016858315035245,132170.69686766653,2919.00188756249,135089.698755229,3416,22,1051.7058823529412,32,2,21,33.47761132940405,0.6510416666666667,42.92929292929293,1028.2828282828282,32.13383838383838,0
3546,4,0,0,34,0.0,0.0,1.0,34,800,400,400,0.5,12,4,8,366.3393925486406,0.3861593879976233,0.09919028340081026,0.22069714624271752,132398.00347222213,2900.520833333324,135298.52430555545,3417,23,1052.7058823529412,32,2,21,33.28272604588396,0.6533203125,42.70833333333333,1029.1666666666658,32.16145833333331,0
3547,4,0,0,34,0.0,0.0,1.0,34,850,800,50,0.9411764705882353,9,8,1,365.38358454063894,0.38573232323232326,0.1071073020819806,0.22069168506254594,132495.48037190078,2882.334710743795,135377.81508264458,3418,24,1053.7058823529412,32,2,21,33.20916114790286,0.654296875,42.61363636363636,1029.5454545454543,32.173295454545446,0
3548,4,0,0,34,0.0,0.0,1.0,34,300,200,100,0.6666666666666666,4,2,2,364.4777140031282,0.38539809863339275,0.10762196001500146,0.2205252400155425,132560.4848995,2863.068500663187,135423.5534001632,3419,25,1054.7058823529412,32,2,21,33.167044711459845,0.6549479166666667,42.550505050505045,1029.7979797979795,32.18118686868686,0
3549,4,1,0,35,0.02857142857142857,0.0,1.0,35,950,600,350,0.631578947368421,13,6,7,357.05959988775834,0.38925070028011205,0.108008966782148,0.2176511126272336,132839.803200692,2486.3453960015286,135326.14859669353,3420,0,1025.5428571428572,33,2,19,33.07725075289268,0.6553030303030304,42.27941176470588,1030.8823529411761,31.23885918003564,0
3550,4,2,0,37,0.05405405405405406,0.0,1.0,37,1050,500,550,0.47619047619047616,16,5,11,345.754126966969,0.39617742742742745,0.11837184250977395,0.21506099318029004,133591.8477794924,1837.9865397805172,135429.83431927292,3421,0,971.0540540540541,35,2,21,32.614942528735625,0.6583333333333334,41.550925925925924,1033.7962962962958,29.537037037037024,0
3551,4,0,0,37,0.0,0.0,1.0,37,900,600,300,0.6666666666666666,12,6,6,344.85903611533314,0.39580205205205204,0.1169607982548766,0.21467775398036715,133621.76254125926,1816.1344468021111,135437.89698806137,3422,1,972.0540540540541,35,2,21,32.60814302772492,0.6586309523809524,41.52199074074073,1033.9120370370358,29.54034391534388,0
3552,4,0,0,37,0.0,0.0,1.0,37,700,400,300,0.5714285714285714,10,4,6,343.41891288614414,0.3951138638638639,0.12035132715526675,0.21430107580660485,133711.52692043877,1783.8134430726843,135495.34036351147,3423,2,973.0540540540541,35,2,19,32.55558042375412,0.6595238095238096,41.435185185185176,1034.2592592592578,29.550264550264508,0
3553,4,0,0,37,0.0,0.0,1.0,37,950,800,150,0.8421052631578947,11,8,3,342.19724342542037,0.3953953953953954,0.12319099139416867,0.21388524207946877,133771.38658479063,1755.2399477023073,135526.62653249293,3424,3,974.0540540540541,35,2,19,32.52731781904974,0.6601190476190477,41.3773148148148,1034.4907407407393,29.556878306878264,0
3554,4,0,0,37,0.0,0.0,1.0,37,1100,800,300,0.7272727272727273,14,8,6,345.4809870673808,0.3943005505505506,0.12777841585714533,0.21664032162387917,133891.14610125154,1851.3690629286457,135742.5151641802,3425,4,975.0540540540541,35,2,19,32.32265339595914,0.6613095238095239,41.26157407407406,1034.9537037037023,29.57010582010578,0
3555,4,0,0,37,0.0,0.0,1.0,37,1400,1100,300,0.7857142857142857,17,11,6,345.0481561400599,0.3934872372372373,0.13149165261841333,0.2170745994957082,134010.9592013887,1848.0468749999764,135859.00607638867,3426,5,976.0540540540541,35,2,19,32.21411804158281,0.6625000000000001,41.14583333333332,1035.4166666666652,29.58333333333329,0
3556,4,0,0,37,0.0,0.0,1.0,37,800,600,200,0.75,10,6,4,344.0575640653623,0.393018018018018,0.1294434866102836,0.21733657416718802,134160.80092860496,1831.8076721107486,135992.6086007157,3427,6,977.0540540540541,35,2,19,32.09010631959183,0.6639880952380952,41.0011574074074,1035.995370370369,29.59986772486769,0
3557,4,0,1,36,0.0,0.02702702702702703,0.972972972972973,37,1100,800,300,0.7272727272727273,14,8,6,343.0947713848194,0.3926113613613614,0.13021509336005632,0.21726100303958082,134250.74615269198,1812.1458118998548,136062.89196459184,3428,7,978.0540540540541,35,2,20,32.02525872980418,0.6648809523809525,40.91435185185185,1036.3425925925922,29.609788359788347,0
3558,4,0,0,36,0.0,0.0,1.0,36,700,500,200,0.7142857142857143,9,5,4,352.4872026712418,0.38907076719576716,0.13924644676857056,0.22240689995957064,134118.83680555565,2255.034722222232,136373.87152777787,3429,8,1006.0,34,2,21,31.913716814159283,0.6657475490196079,41.04166666666667,1035.8333333333342,30.465686274509828,0
3559,4,0,0,36,0.0,0.0,1.0,36,750,400,350,0.5333333333333333,11,4,7,354.5918184168199,0.3890376984126984,0.14149943831699363,0.22429994095203498,134211.33786848077,2318.048469387763,136529.38633786852,3430,9,1007.0,34,2,21,31.76676432291668,0.6666666666666666,40.952380952380956,1036.1904761904766,30.47619047619049,0
3560,4,0,0,36,0.0,0.0,1.0,36,750,500,250,0.6666666666666666,10,5,5,357.79535297002633,0.38723544973544977,0.14845115525446229,0.22728225594573015,134365.5771683674,2415.07582199547,136780.65299036287,3431,10,1008.0,34,2,21,31.52964366364298,0.6681985294117647,40.80357142857143,1036.7857142857147,30.493697478991606,0
3561,4,0,0,36,0.0,0.0,1.0,36,1250,900,350,0.72,16,9,7,357.97503320999573,0.38683862433862437,0.15047066926874053,0.22778089951002745,134427.29768990944,2424.3232709750746,136851.62096088452,3432,11,1009.0,34,2,21,31.463331802701564,0.6688112745098038,40.74404761904763,1037.0238095238108,30.50070028011208,0
3562,4,0,0,36,0.0,0.0,1.0,36,1050,700,350,0.6666666666666666,14,7,7,359.78630648203045,0.38665674603174605,0.1538329125545097,0.22951521776606257,134519.9050453515,2479.683956916101,136999.5890022676,3433,12,1010.0,34,2,21,31.323875372963048,0.6697303921568627,40.654761904761905,1037.3809523809527,30.511204481792728,0
3563,4,0,0,36,0.0,0.0,1.0,36,350,200,150,0.5714285714285714,5,2,3,361.1232076901987,0.38673941798941797,0.1567380633645694,0.23056327875604987,134550.78125,2517.881944444445,137068.66319444444,3434,13,1011.0,34,2,21,31.258366800535473,0.6700367647058822,40.625,1037.5,30.514705882352942,0
3564,4,0,0,36,0.0,0.0,1.0,36,1200,900,300,0.75,15,9,6,359.22499405544306,0.3862103174603175,0.15785783488858307,0.22954582464715848,134581.66099773243,2469.019274376418,137050.68027210885,3435,14,1012.0,34,2,21,31.27677068991893,0.670343137254902,40.595238095238095,1037.6190476190475,30.51820728291316,0
3565,4,0,0,36,0.0,0.0,1.0,36,1050,700,350,0.6666666666666666,14,7,7,359.92428456672616,0.3860945767195767,0.16054657134482797,0.23057897407327604,134674.32149943308,2494.5117630385457,137168.83326247163,3436,15,1013.0,34,2,21,31.166131437091416,0.6712622549019608,40.50595238095238,1037.9761904761904,30.528711484593835,0
3566,4,0,0,36,0.0,0.0,1.0,36,800,500,300,0.625,11,5,6,359.92428456672616,0.3860945767195767,0.16054657134482797,0.23057897407327604,134674.32149943308,2494.5117630385457,137168.83326247163,3437,16,1014.0,34,2,21,31.166131437091416,0.6712622549019608,40.50595238095238,1037.9761904761904,30.528711484593835,0
3567,4,0,0,36,0.0,0.0,1.0,36,750,500,250,0.6666666666666666,10,5,5,359.6012014981905,0.38634259259259257,0.15675968399592266,0.23056782919589844,134705.21541950098,2488.0314625850165,137193.246882086,3438,17,1015.0,34,2,22,31.14368310397554,0.6715686274509804,40.47619047619047,1038.095238095237,30.532212885154028,0
3568,4,0,0,36,0.0,0.0,1.0,36,700,400,300,0.5714285714285714,10,4,6,360.50791417703465,0.38602843915343915,0.15877883500834322,0.2317399068066523,134797.91843820858,2519.14328231292,137317.0617205215,3439,18,1016.0,34,2,20,31.027647216171804,0.6724877450980392,40.38690476190476,1038.4523809523807,30.542717086834728,0
3569,4,1,1,36,0.02702702702702703,0.02702702702702703,0.972972972972973,37,1300,900,400,0.6923076923076923,17,9,8,350.9020322367546,0.389232982982983,0.15295558276744958,0.22759227116121047,135121.77057881077,2082.9007791066374,137204.6713579174,3440,0,989.5135135135135,35,2,20,30.954418531299854,0.6735119047619048,40.075231481481474,1039.6990740740732,29.705687830687808,0
3570,4,0,0,36,0.0,0.0,1.0,36,1050,700,350,0.6666666666666666,14,7,7,357.12458914303744,0.385896164021164,0.14746427980711774,0.23153444966489567,135107.1588010204,2450.0177154195035,137557.1765164399,3441,20,1018.0,34,2,21,30.807235008969815,0.6755514705882353,40.089285714285715,1039.642857142857,30.577731092436974,0
3571,4,0,0,36,0.0,0.0,1.0,36,700,600,100,0.8571428571428571,8,6,2,373.0069270277576,0.385896164021164,0.11269700301671937,0.2203928484882147,131661.99578179244,2702.744104640549,134364.739886433,3442,21,1019.0,31,5,21,33.854034509007874,0.648521505376344,43.424479166666664,1026.3020833333328,33.10651881720428,8
3572,4,1,1,36,0.02702702702702703,0.02702702702702703,0.972972972972973,37,900,600,300,0.6666666666666666,12,6,6,360.43489285310136,0.38866991991991995,0.10792111448201203,0.21444469175213246,131925.46323829767,2110.1080413783093,134035.571279676,3443,0,992.4324324324324,33,4,21,33.91076682969503,0.6461489898989898,43.16789215686274,1027.3284313725483,31.131164587046918,0
3573,4,0,0,36,0.0,0.0,1.0,36,850,700,150,0.8235294117647058,10,7,3,368.10613377885653,0.38566468253968256,0.1252048508685677,0.21892627956321473,131911.15702479339,2511.461202938472,134422.61822773184,3444,23,1021.0,32,4,21,33.728183382497534,0.6484375,43.18181818181818,1027.2727272727273,32.10227272727273,0
3574,4,0,1,35,0.0,0.027777777777777776,0.9722222222222222,36,750,500,250,0.6666666666666666,10,5,5,367.93671621626595,0.3860945767195767,0.12690953024532092,0.21938732111972054,132008.45457415047,2514.151457759395,134522.60603190988,3445,24,1022.0,32,4,21,33.63435311463325,0.6494140625,43.087121212121204,1027.651515151514,32.114109848484816,0
3575,4,0,0,35,0.0,0.0,1.0,35,750,400,350,0.5333333333333333,11,4,7,369.31930047104544,0.38343837535014,0.15348502657848107,0.22096745508712157,132138.24043783802,2760.240504795434,134898.48094263344,3446,25,1049.0,32,3,21,33.467906995783686,0.6507161458333334,42.96085858585859,1028.156565656566,32.12989267676769,0
3576,4,0,0,35,0.0,0.0,1.0,35,850,400,450,0.47058823529411764,13,4,9,367.978185444075,0.3828781512605042,0.1458774006840311,0.22054321710389907,132203.15728305772,2729.5755853994356,134932.73286845715,3447,26,1050.0,32,3,21,33.43692449355435,0.6513671875,42.897727272727266,1028.4090909090899,32.13778409090906,0
3577,4,0,0,35,0.0,0.0,1.0,35,1250,1100,150,0.88,14,11,3,369.37031879257796,0.3823179271708683,0.14920245398773035,0.2223314695834202,132365.51914345476,2778.3788006325885,135143.89794408734,3448,27,1051.0,32,3,21,33.23747443762782,0.6529947916666667,42.73989898989899,1029.040404040404,32.15751262626262,0
3578,4,0,0,35,0.0,0.0,1.0,35,1300,1100,200,0.8461538461538461,15,11,4,371.36770605180374,0.3816176470588235,0.15101266508880018,0.22432425147071158,132498.52710300032,2841.1387986595046,135339.6659016598,3449,28,1052.0,31,4,21,33.052068841954394,0.6569220430107525,42.61067708333334,1029.5572916666677,33.211525537634444,0
3579,4,0,0,35,0.0,0.0,1.0,35,950,600,350,0.631578947368421,13,6,7,373.1951363890556,0.3806022408963585,0.14282825364726204,0.22643557661888122,132666.15125868068,2902.072482638897,135568.22374131958,3450,29,1053.0,31,4,21,32.83619817997977,0.6586021505376343,42.44791666666667,1030.2083333333344,33.23252688172047,0
3580,4,0,0,35,0.0,0.0,1.0,35,1100,600,500,0.5454545454545454,16,6,10,372.3975004479447,0.37993697478991595,0.1425430917787205,0.2265585100726737,132766.77661471916,2888.403150770423,135655.1797654896,3451,30,1054.0,31,4,21,32.75544851547694,0.6596102150537633,42.35026041666668,1030.5989583333348,33.24512768817209,0
3581,4,0,0,35,0.0,0.0,1.0,35,950,600,350,0.631578947368421,13,6,7,370.85289664884675,0.3803221288515406,0.14780067116515672,0.2262259811760841,132867.44011773015,2854.855007595494,135722.29512532565,3452,31,1055.0,31,4,21,32.693967331817795,0.6606182795698924,42.25260416666667,1030.9895833333344,33.25772849462369,0
3582,4,0,0,35,0.0,0.0,1.0,35,1000,700,300,0.7,13,7,6,361.4081816332663,0.3803221288515406,0.12226625618696119,0.21790863729632443,132429.53619100808,2572.223573865797,135001.7597648739,3453,32,1056.0,33,2,21,33.37785748303368,0.651199494949495,42.67769607843136,1029.289215686273,31.190582293523427,3
3583,4,0,0,35,0.0,0.0,1.0,35,850,700,150,0.8235294117647058,10,7,3,358.633951546719,0.3789565826330532,0.11995035786538844,0.2169619218752393,132555.7046118076,2507.7952289984187,135063.499840806,3454,33,1057.0,33,2,21,33.32230056725773,0.6524621212121213,42.55514705882351,1029.7794117647031,31.20543672014252,0
3584,4,2,2,35,0.05405405405405406,0.05405405405405406,0.9459459459459459,37,650,500,150,0.7692307692307693,8,5,3,340.89553874468606,0.38757507507507505,0.10711339705953749,0.2086580385503184,132994.25582990365,1667.4296982166995,134661.68552812035,3455,0,1000.8108108108108,35,2,18,33.33894374625973,0.6523809523809525,42.12962962962961,1031.4814814814788,29.470899470899393,0
3585,4,0,0,35,0.0,0.0,1.0,35,1100,800,300,0.7272727272727273,14,8,6,356.2587305280371,0.3783263305322129,0.12260432241402786,0.21643232704333323,132713.49961553232,2456.0685793925213,135169.56819492482,3456,35,1059.0,33,2,18,33.22480574056455,0.6540404040404042,42.401960784313715,1030.3921568627436,31.224004753416473,0
3586,4,0,0,35,0.0,0.0,1.0,35,900,700,200,0.7777777777777778,11,7,4,356.2587305280371,0.3783263305322129,0.12260432241402786,0.21643232704333323,132713.49961553232,2456.0685793925213,135169.56819492482,3457,36,1060.0,33,2,18,33.22480574056455,0.6540404040404042,42.401960784313715,1030.3921568627436,31.224004753416473,0
3587,4,0,0,35,0.0,0.0,1.0,35,1000,700,300,0.7,13,7,6,355.37162740127377,0.37839635854341735,0.12190929165958919,0.21625726385272845,132776.64389898095,2437.010404652034,135213.654303633,3458,37,1061.0,33,2,19,33.18420531113754,0.6546717171717172,42.34068627450979,1030.637254901959,31.23143196672603,0
3588,4,0,1,34,0.0,0.02857142857142857,0.9714285714285714,35,1200,800,400,0.6666666666666666,16,8,8,351.82510409287397,0.37857142857142856,0.11336230309614348,0.21518605203819957,132966.16685890034,2356.1670991926026,135322.33395809293,3459,38,1062.0,33,2,19,33.08529388466411,0.6565656565656567,42.15686274509803,1031.372549019607,31.25371360665476,0
3589,4,0,0,34,0.0,0.0,1.0,34,650,400,250,0.6153846153846154,9,4,5,353.0472927601267,0.3786579025549614,0.10357304875677831,0.2160332085810842,132983.402921258,2589.8860766758507,135573.28899793385,3460,39,1067.5,32,2,20,33.03647937324032,0.6591796875,42.140151515151516,1031.4393939393938,32.232481060606055,0
3590,4,0,0,34,0.0,0.0,1.0,34,700,500,200,0.7142857142857143,9,5,4,354.12843039089734,0.37891785502079617,0.10738479702246817,0.21707302361020442,133048.5270157383,2623.2532075808713,135671.7802233192,3461,40,1068.5,32,2,21,32.943234202260015,0.6598307291666666,42.07702020202021,1031.69191919192,32.2403724747475,0
3591,4,0,0,34,0.0,0.0,1.0,34,700,400,300,0.5714285714285714,10,4,6,353.537457725673,0.3788807189542484,0.10478188583643444,0.217089529826591,133113.66705246916,2612.1334876543297,135725.80054012348,3462,41,1069.5,32,2,21,32.893113503813375,0.6604817708333333,42.01388888888889,1031.9444444444448,32.2482638888889,0
3592,4,0,0,34,0.0,0.0,1.0,34,1000,800,200,0.8,12,8,4,352.58042252335633,0.3784350861556744,0.10051807879114949,0.21688073394495425,133178.82303145106,2591.2491391184763,135770.07217056953,3463,42,1070.5,32,2,21,32.85244648318042,0.6611328125,41.950757575757585,1032.196969696971,32.25615530303035,0
3593,4,0,0,34,0.0,0.0,1.0,34,800,500,300,0.625,11,5,6,353.4772707999269,0.37698677956030896,0.10694892946786272,0.21819551682057375,133309.18281616678,2624.353222885432,135933.5360390522,3464,43,1071.5,32,2,21,32.69857765823043,0.6624348958333333,41.824494949494955,1032.7020202020208,32.27193813131315,0
3594,4,0,0,34,0.0,0.0,1.0,34,600,300,300,0.5,9,3,6,353.4316509346548,0.37745098039215685,0.1069538328778945,0.21835882965600276,133341.78272625248,2625.44128150189,135967.22400775438,3465,44,1072.5,32,2,21,32.667074164629184,0.6627604166666666,41.792929292929294,1032.8282828282831,32.27588383838385,0
3595,4,0,0,34,0.0,0.0,1.0,34,500,300,200,0.6,7,3,4,353.3758827539028,0.37732100415923947,0.10790784960848998,0.218516107090679,133374.38662190104,2626.2583218549353,136000.64494375596,3466,45,1073.5,32,2,21,32.63583302774721,0.6630859375,41.76136363636365,1032.954545454547,32.2798295454546,0
3596,4,0,0,34,0.0,0.0,1.0,34,400,300,100,0.75,5,3,2,353.3758827539028,0.37732100415923947,0.10790784960848998,0.218516107090679,133374.38662190104,2626.2583218549353,136000.64494375596,3467,46,1074.5,32,2,21,32.63583302774721,0.6630859375,41.76136363636365,1032.954545454547,32.2798295454546,0
3597,4,0,0,34,0.0,0.0,1.0,34,950,800,150,0.8421052631578947,11,8,3,355.3008931058091,0.3759655377302436,0.1091266990430757,0.22106411191112213,133602.72548719533,2693.833537394162,136296.5590245895,3468,47,1075.5,32,2,22,32.35731151278294,0.6653645833333333,41.54040404040405,1033.838383838385,32.30744949494953,0
3598,4,0,0,34,0.0,0.0,1.0,34,700,400,300,0.5714285714285714,10,4,6,353.2355585419474,0.37583556149732616,0.1086666140024557,0.2203619543044245,133700.6447843334,2645.5643875625133,136346.2091718959,3469,48,1076.5,32,2,18,32.312650063077356,0.6663411458333333,41.44570707070708,1034.217171717173,32.319286616161655,0
3599,4,0,0,34,0.0,0.0,1.0,34,900,500,400,0.5555555555555556,13,5,8,350.43322447489976,0.3758169934640523,0.10678545277031981,0.21919464437765854,133798.59995153546,2577.494962248742,136376.0949137842,3470,49,1077.5,32,2,18,32.28709014726223,0.6673177083333334,41.3510101010101,1034.595959595959,32.331123737373716,0
3600,4,0,0,34,0.0,0.0,1.0,34,950,700,250,0.7368421052631579,12,7,5,348.8404195282126,0.37516711229946526,0.10727382327824397,0.21877925928636252,133896.59098880214,2541.70859478624,136438.29958358838,3471,50,1078.5,32,2,19,32.230287503558216,0.6682942708333334,41.25631313131313,1034.9747474747471,32.34296085858585,0
3601,4,0,0,34,0.0,0.0,1.0,34,450,300,150,0.6666666666666666,6,3,3,348.9378906463661,0.3750742721330957,0.11035690197035208,0.21903467285749678,133929.26263901638,2546.598880216303,136475.86151923268,3472,51,1079.5,32,2,19,32.19509839798325,0.6686197916666667,41.224747474747474,1035.1010101010097,32.34690656565655,0
3602,4,0,0,34,0.0,0.0,1.0,34,1100,700,400,0.6363636363636364,15,7,8,349.81696389017293,0.37431298276886515,0.10232252881642845,0.22017259561498911,134027.3015030353,2577.0047380369215,136604.30624107222,3473,52,1080.5,32,2,19,32.07434052757794,0.6695963541666667,41.1300505050505,1035.4797979797972,32.358743686868664,0
3603,4,0,0,34,0.0,0.0,1.0,34,650,300,350,0.46153846153846156,10,3,7,350.5675033273169,0.37386734997029114,0.10257007837878596,0.22103806531852244,134092.68067352803,2601.707255637162,136694.38792916518,3474,53,1081.5,32,2,20,31.989566825145292,0.6702473958333335,41.06691919191918,1035.7323232323217,32.366635101010054,0
3604,4,0,0,34,0.0,0.0,1.0,34,800,500,300,0.625,11,5,6,349.6329340481781,0.37355169340463457,0.0990262999397713,0.22064527622548089,134125.3762371186,2578.9297648199044,136704.3060019385,3475,54,1082.5,32,2,20,31.981096619535183,0.6705729166666667,41.03535353535353,1035.8585858585852,32.37058080808079,0
3605,4,0,0,34,0.0,0.0,1.0,34,800,500,300,0.625,11,5,6,349.03485567906176,0.37334744503862155,0.10282828862018789,0.22085806172382869,134223.48684126613,2569.7350716763494,136793.22191294248,3476,55,1083.5,32,2,20,31.898582510864706,0.6715494791666667,40.94065656565656,1036.2373737373732,32.38241792929291,0
3606,4,0,0,34,0.0,0.0,1.0,34,800,400,400,0.5,12,4,8,349.01705550603543,0.37275326797385616,0.10591316560733244,0.22124177672965584,134288.91383851125,2573.824259004169,136862.73809751542,3477,56,1084.5,32,2,20,31.8337089373452,0.6722005208333335,40.877525252525245,1036.489898989898,32.39030934343431,0
3607,4,0,0,34,0.0,0.0,1.0,34,900,800,100,0.8888888888888888,10,8,2,351.37856352789333,0.37284610814022584,0.10877411592832908,0.22373825742776093,134452.5510789715,2648.748852157941,137101.29993112944,3478,57,1085.5,32,2,21,31.609142926710494,0.673828125,40.71969696969697,1037.121212121212,32.410037878787875,0
3608,4,0,0,34,0.0,0.0,1.0,34,850,600,250,0.7058823529411765,11,6,5,354.4496657913454,0.3714163695781343,0.12131503045311076,0.2267098679485655,134616.2879584991,2742.939655392304,137359.22761389142,3479,58,1086.5,32,2,22,31.366092793121616,0.6754557291666667,40.561868686868685,1037.7525252525252,32.42976641414141,0
3609,4,0,0,34,0.0,0.0,1.0,34,550,400,150,0.7272727272727273,7,4,3,357.263332453863,0.3713235294117647,0.12439366405769348,0.22912785643023886,134714.57791296815,2825.7158070605183,137540.29372002865,3480,59,1087.5,32,2,22,31.19501540582179,0.6764322916666666,40.46717171717172,1038.1313131313138,32.44160353535356,0
3610,4,0,0,34,0.0,0.0,1.0,34,650,200,450,0.3076923076923077,11,2,9,356.2956100773666,0.37098930481283426,0.12369106202792368,0.2289199294747081,134780.12447709416,2804.3133353739368,137584.4378124681,3481,60,1088.5,32,2,19,31.154750324254213,0.6770833333333334,40.4040404040404,1038.3838383838383,32.44949494949495,0
3611,4,0,0,34,0.0,0.0,1.0,34,950,700,250,0.7368421052631579,12,7,5,356.7011111373936,0.370599376114082,0.12016030430648006,0.22980266572649466,134878.47421500355,2822.260324201609,137700.73453920515,3482,61,1089.5,32,2,19,31.04614885944654,0.6780598958333334,40.30934343434343,1038.762626262626,32.461332070707066,0
3612,4,0,1,33,0.0,0.029411764705882353,0.9705882352941176,34,550,300,250,0.5454545454545454,8,3,5,356.4943235437101,0.37004233511586454,0.11851211072664358,0.22987737414715098,134911.2654320988,2819.020061728397,137730.2854938272,3483,62,1090.5,32,2,20,31.018827985739744,0.6783854166666666,40.27777777777778,1038.8888888888891,32.465277777777786,0
3613,4,0,0,33,0.0,0.0,1.0,33,500,300,200,0.6,7,3,4,356.6865937140325,0.3684895833333333,0.07502080517953558,0.22154758848998354,133539.5050048828,2926.3502332899307,136465.85523817275,3484,63,1038.7878787878788,31,2,25,32.384836650709666,0.6673387096774194,41.6015625,1033.59375,33.341733870967744,3
3614,4,1,1,33,0.029411764705882353,0.029411764705882353,0.9705882352941176,34,950,700,250,0.7368421052631579,12,7,5,346.2161690549214,0.36968954248366015,0.07015893982684629,0.21655689230809352,133798.5999515355,2464.6477400265194,136263.24769156202,3485,0,1009.2058823529412,32,2,18,32.39616385973476,0.6673177083333334,41.3510101010101,1034.5959595959591,32.33112373737372,0
3615,4,0,0,33,0.0,0.0,1.0,33,600,300,300,0.5,9,3,6,357.4587377728016,0.3686474116161616,0.07599032378684889,0.22283652240122362,133674.12143283413,2956.596544053813,136630.71797688794,3486,65,1040.7878787878788,31,2,26,32.23002182489717,0.6686827956989247,41.471354166666664,1034.1145833333328,33.35853494623654,0
3616,4,0,0,33,0.0,0.0,1.0,33,1000,800,200,0.8,12,8,4,370.7919891393129,0.3679371843434343,0.07296746334989423,0.22720687779975063,133035.29739379883,3265.6845092773433,136300.98190307617,3487,66,1041.7878787878788,31,2,20,32.52674176448316,0.6622983870967742,42.08984375,1031.640625,33.27872983870968,2
3617,4,0,0,33,0.0,0.0,1.0,33,1100,900,200,0.8181818181818182,13,9,4,370.62930517582856,0.3687657828282828,0.07406387875729292,0.2277215405289627,133136.0626220703,3268.825276692708,136404.88789876303,3488,67,1042.7878787878788,31,2,21,32.42966187231895,0.6633064516129032,41.9921875,1032.03125,33.29133064516129,0
3618,4,0,0,33,0.0,0.0,1.0,33,750,500,250,0.6666666666666666,10,5,5,360.190451895397,0.36872632575757575,0.10577952331446672,0.2106016980993145,131261.4017062716,2856.2445746527737,134117.64628092438,3489,68,1043.7878787878788,31,2,21,34.587568826768326,0.644489247311828,43.815104166666664,1024.7395833333326,33.05611559139783,5
3619,4,0,0,33,0.0,0.0,1.0,33,950,800,150,0.8421052631578947,11,8,3,360.40693578189956,0.36916035353535354,0.10650901238987065,0.21127950896581518,131361.49300469304,2868.7186347113816,134230.2116394044,3490,69,1044.7878787878788,31,2,21,34.48084698759471,0.645497311827957,43.71744791666667,1025.1302083333344,33.0687163978495,0
3620,4,0,0,33,0.0,0.0,1.0,33,850,600,250,0.7058823529411765,11,6,5,359.7272461577224,0.3690814393939394,0.10272631072631078,0.21124922173691751,131428.24172973633,2855.6638929578994,134283.90562269423,3491,70,1045.7878787878788,31,2,21,34.43082010582011,0.6461693548387097,43.65234375,1025.390625,33.07711693548387,0
3621,4,0,0,33,0.0,0.0,1.0,33,700,500,200,0.7142857142857143,9,5,4,358.46416676350395,0.36943655303030304,0.10370267796010402,0.21105984348003634,131528.3966064454,2829.643419053833,134358.04002549924,3492,71,1046.7878787878788,31,2,21,34.3620419734281,0.6471774193548386,43.55468750000001,1025.7812500000007,33.08971774193551,0
3622,4,0,0,33,0.0,0.0,1.0,33,700,300,400,0.42857142857142855,11,3,8,362.90545739194965,0.36916035353535354,0.11327890779945538,0.2148007977536136,131728.8208007814,2961.0215928819584,134689.84239366336,3493,72,1047.7878787878788,31,2,20,34.0457466599019,0.6491935483870968,43.35937500000001,1026.5625000000011,33.11491935483875,0
3623,4,0,0,33,0.0,0.0,1.0,33,650,400,250,0.6153846153846154,9,4,5,362.2895547078343,0.3689236111111111,0.10966737764454937,0.21462457842759392,131762.23966810445,2947.2166273329076,134709.45629543735,3494,73,1048.7878787878788,31,2,20,34.02782181357006,0.649529569892473,43.32682291666667,1026.692708333334,33.11911962365593,0
3624,4,1,0,34,0.029411764705882353,0.0,1.0,34,1100,1000,100,0.9090909090909091,12,10,2,349.935806755416,0.37312462863933454,0.10474690858661706,0.2095497948688318,132170.69686766676,2450.251887562518,134620.94875522927,3495,0,1018.9117647058823,32,2,22,33.9334684020956,0.6510416666666665,42.92929292929294,1028.28282828283,32.13383838383844,0
3625,4,0,0,34,0.0,0.0,1.0,34,700,200,500,0.2857142857142857,12,2,10,352.1590938350208,0.3729946524064171,0.10341951927450732,0.21142521278363435,132268.09007052876,2515.882148505281,134783.97221903404,3496,1,1019.9117647058823,32,2,22,33.77828239433739,0.6520182291666665,42.83459595959597,1028.661616161618,32.14567550505056,0
3626,4,0,0,34,0.0,0.0,1.0,34,700,400,300,0.5714285714285714,10,4,6,354.122988055214,0.37253045157456927,0.10295560815101346,0.21352149398122067,132430.49178655236,2579.3362922150764,135009.82807876743,3497,2,1020.9117647058823,32,2,23,33.56436048413477,0.6536458333333334,42.676767676767675,1029.292929292929,32.165404040404034,0
3627,4,0,0,34,0.0,0.0,1.0,34,900,700,200,0.7777777777777778,11,7,4,354.122988055214,0.37253045157456927,0.10295560815101346,0.21352149398122067,132430.49178655236,2579.3362922150764,135009.82807876743,3498,3,1021.9117647058823,32,2,23,33.56436048413477,0.6536458333333334,42.676767676767675,1029.292929292929,32.165404040404034,0
3628,4,0,0,34,0.0,0.0,1.0,34,700,500,200,0.7142857142857143,9,5,4,353.6980839386147,0.37275326797385616,0.10576763515414744,0.21344933222439127,132462.9840864453,2570.3807328333864,135033.36481927868,3499,4,1022.9117647058823,32,2,24,33.54261212641561,0.6539713541666666,42.64520202020202,1029.4191919191921,32.169349747474755,0
3629,4,1,1,34,0.02857142857142857,0.02857142857142857,0.9714285714285714,35,750,400,350,0.5333333333333333,11,4,7,345.56505830073195,0.3774159663865546,0.1014710378800745,0.2102895904709952,132776.64389898113,2176.5937379853817,134953.2376369665,3500,0,994.6571428571428,33,2,17,33.43688069758224,0.6546717171717171,42.3406862745098,1030.6372549019604,31.231431966726074,0
3630,4,0,0,34,0.0,0.0,1.0,34,850,600,250,0.7058823529411765,11,6,5,354.6958479565237,0.3728832442067736,0.10316109773156645,0.21497836015076688,132625.5053693502,2608.343217528838,135233.84858687903,3501,6,1024.9117647058824,32,2,17,33.35350780420037,0.6555989583333333,42.487373737373744,1030.050505050506,32.18907828282831,0
3631,4,0,0,34,0.0,0.0,1.0,34,1050,800,250,0.7619047619047619,13,8,5,355.3083746848685,0.3729946524064171,0.10226732202314892,0.21609738853784646,132755.59413580262,2633.8348765432315,135389.42901234585,3502,7,1025.9117647058824,32,2,18,33.20698562443846,0.6569010416666665,42.36111111111112,1030.5555555555568,32.20486111111115,0
3632,4,0,0,34,0.0,0.0,1.0,34,450,300,150,0.6666666666666666,6,3,3,356.0894946285311,0.37262329174093883,0.1053137903452448,0.2167605178711933,132788.12629132243,2656.891356749323,135445.01764807175,3503,8,1026.9117647058824,32,2,18,33.15417126056597,0.6572265625,42.32954545454546,1030.6818181818192,32.20880681818185,0
3633,4,0,0,34,0.0,0.0,1.0,34,800,600,200,0.75,10,6,4,355.4297554257602,0.37210338680926913,0.10113670743830228,0.2169237206880989,132885.74667125827,2646.3096877869893,135532.05635904527,3504,9,1027.9117647058824,32,2,19,33.07310800881705,0.6582031249999998,42.2348484848485,1031.0606060606078,32.220643939393995,0
3634,4,0,0,34,0.0,0.0,1.0,34,1200,1000,200,0.8333333333333334,14,10,4,357.4254842472738,0.3716763220439691,0.09849270104517549,0.21928536465981419,133081.09504132255,2713.314967860453,135794.410009183,3505,10,1028.9117647058824,32,2,19,32.82550171316692,0.6601562499999998,42.04545454545456,1031.8181818181838,32.244318181818244,0
3635,4,0,1,33,0.0,0.029411764705882353,0.9705882352941176,34,1000,600,400,0.6,14,6,8,358.77249389781997,0.37180629827688655,0.1000215866162979,0.22068962660757566,133178.82303145103,2756.1796946740315,135935.00272612507,3506,11,1029.9117647058824,32,2,20,32.69266055045871,0.6611328125,41.950757575757585,1032.1969696969709,32.25615530303034,0
3636,4,0,0,33,0.0,0.0,1.0,33,700,600,100,0.8571428571428571,8,6,2,368.8403078309733,0.367779356060606,0.1043251902282738,0.2262885131827865,133081.0950413224,3217.134412304884,136298.22945362728,3507,86,1061.7878787878788,32,1,20,32.53105115026923,0.66015625,42.045454545454554,1031.8181818181827,32.24431818181821,0
3637,4,0,0,33,0.0,0.0,1.0,33,700,400,300,0.5714285714285714,10,4,6,370.50375282072935,0.3678977272727273,0.10074070778744137,0.22770659214711597,133146.2430491788,3266.236544740346,136412.47959391915,3508,87,1062.7878787878788,32,1,20,32.42267147867221,0.6608072916666666,41.98232323232324,1032.070707070708,32.25220959595963,0
3638,4,0,0,33,0.0,0.0,1.0,33,1100,800,300,0.7272727272727273,14,8,6,367.47720242517784,0.3681344696969697,0.10401360468605803,0.22683743687815314,133309.18281616675,3197.617111774305,136506.79992794106,3509,88,1063.7878787878788,32,1,22,32.33713371642824,0.6624348958333334,41.82449494949495,1032.7020202020203,32.271938131313135,0
3639,4,0,0,33,0.0,0.0,1.0,33,800,600,200,0.75,10,6,4,367.36897012033455,0.36785827020202017,0.10312142325343676,0.2271689754009416,133374.38662190086,3199.522210743808,136573.90883264467,3510,89,1064.7878787878788,32,1,22,32.274477447744786,0.6630859375,41.76136363636364,1032.9545454545457,32.279829545454554,0
3640,4,1,0,34,0.029411764705882353,0.0,1.0,34,600,400,200,0.6666666666666666,8,4,4,361.07765948670044,0.3703394236482472,0.1217504236566942,0.2265356207781989,133909.86336602096,2870.443749405892,136780.30711542684,3511,0,1034.4411764705883,31,3,21,31.900370067513755,0.6710349462365592,41.24348958333333,1035.0260416666658,33.38793682795696,0
3641,4,0,0,34,0.0,0.0,1.0,34,900,700,200,0.7777777777777778,11,7,4,359.1459075341053,0.37019087938205586,0.1241834175501415,0.2257366886010806,133977.256351047,2823.4766642252407,136800.73301527224,3512,1,1035.4411764705883,31,3,21,31.88291305076929,0.671706989247312,41.17838541666666,1035.2864583333323,33.396337365591364,0
3642,4,0,0,34,0.0,0.0,1.0,34,1150,900,250,0.782608695652174,14,9,5,357.0410524516646,0.36974524658348185,0.12457063771504018,0.22511973507002303,134092.68067352794,2775.318366748257,136867.9990402762,3513,2,1036.4411764705883,32,2,22,31.821945223292293,0.6702473958333335,41.066919191919176,1035.732323232321,32.36663510101003,0
3643,4,0,0,34,0.0,0.0,1.0,34,550,400,150,0.7272727272727273,7,4,3,357.0410524516646,0.3692067736185383,0.12457063771504018,0.22511973507002303,134092.68067352794,2775.318366748257,136867.9990402762,3514,3,1037.4411764705883,32,2,22,31.821945223292293,0.6702473958333335,41.066919191919176,1035.732323232321,32.36663510101003,0
3644,4,0,0,34,0.0,0.0,1.0,34,700,300,400,0.42857142857142855,11,3,8,353.88021188968526,0.3695224301841949,0.12419176785995889,0.22372426955059724,134190.7793209874,2697.492283950586,136888.271604938,3515,4,1038.4411764705883,32,2,22,31.80574173369078,0.6712239583333335,40.97222222222221,1036.1111111111093,32.378472222222165,0
3645,4,0,1,33,0.0,0.029411764705882353,0.9705882352941176,34,950,800,150,0.8421052631578947,11,8,3,353.880253753292,0.3690953654188948,0.12362401100791232,0.22412416071041782,134256.19834710716,2702.1235078052914,136958.32185491244,3516,5,1039.4411764705883,32,2,22,31.740375243664722,0.6718750000000002,40.90909090909089,1036.363636363634,32.38636363636356,0
3646,4,1,1,33,0.029411764705882353,0.029411764705882353,0.9705882352941176,34,1100,800,300,0.7272727272727273,14,8,6,352.4673360050243,0.3717691622103387,0.12154379530672532,0.22402954824096422,134387.08422609913,2673.4115141311845,137060.4957402303,3517,0,1029.2941176470588,32,2,22,31.64626968663744,0.6731770833333335,40.78282828282827,1036.868686868685,32.40214646464641,0
3647,4,0,0,33,0.0,0.0,1.0,33,850,600,250,0.7058823529411765,11,6,5,362.24337769248234,0.3673453282828283,0.12986142835389036,0.22957462471593612,134280.73459201382,3128.4613715277583,137409.19596354157,3518,7,1061.4848484848485,31,2,22,31.499162479061965,0.674731182795699,40.88541666666666,1036.4583333333326,33.43413978494621,0
3648,4,0,0,33,0.0,0.0,1.0,33,500,400,100,0.8,6,4,2,362.80232390127304,0.3667929292929293,0.1281937740778465,0.23059850494405965,134387.08422609916,3151.1892919089623,137538.27351800812,3519,8,1062.4848484848485,32,1,22,31.378369053417753,0.6731770833333335,40.78282828282827,1036.8686868686852,32.402146464646414,0
3649,4,0,0,33,0.0,0.0,1.0,33,950,700,250,0.7368421052631579,12,7,5,360.57544165373287,0.3666745580808081,0.11691156944321479,0.2300068189927847,134518.03387409437,3100.7798949086637,137618.81376900303,3520,9,1063.4848484848485,32,1,22,31.305278318727666,0.6744791666666667,40.65656565656565,1037.3737373737365,32.417929292929266,0
3650,4,0,0,33,0.0,0.0,1.0,33,700,400,300,0.5714285714285714,10,4,6,357.5470190207258,0.3656881313131313,0.11439946914399468,0.22889692339177292,134649.04729109266,3028.6730945821732,137677.72038567482,3521,10,1064.4848484848485,32,1,23,31.253041362530414,0.67578125,40.530303030303024,1037.878787878787,32.433712121212096,0
3651,4,0,0,33,0.0,0.0,1.0,33,600,300,300,0.5,9,3,6,358.6992236913012,0.36580650252525254,0.11480576351030125,0.22984149009868923,134681.81060924887,3062.052182175267,137743.86279142415,3522,11,1065.4848484848485,32,1,23,31.19044722864209,0.6761067708333335,40.49873737373736,1038.005050505049,32.43765782828278,0
3652,4,0,0,33,0.0,0.0,1.0,33,1050,900,150,0.8571428571428571,12,9,3,362.09208788172407,0.36549084595959597,0.11578086310576596,0.2326441664640077,134780.12447709413,3160.5633353739363,137940.68781246807,3523,12,1066.4848484848485,32,1,20,31.00427610246433,0.6770833333333334,40.4040404040404,1038.383838383838,32.44949494949494,0
3653,4,0,0,33,0.0,0.0,1.0,33,750,500,250,0.6666666666666666,10,5,5,359.9823357138239,0.3654513888888889,0.11302569770654913,0.2314976318409853,134812.90373750124,3106.052794357719,137918.95653185897,3524,13,1067.4848484848485,32,1,20,31.026342451874378,0.6774088541666667,40.37247474747475,1038.510101010101,32.453440656565654,0
3654,4,0,0,33,0.0,0.0,1.0,33,900,600,300,0.6666666666666666,12,6,6,360.40327181279497,0.36426767676767674,0.11229063458362831,0.23253416578606362,134932.48540224915,3126.021842560555,138058.5072448097,3525,14,1068.4848484848485,33,0,21,30.89614295824487,0.6761363636363636,40.25735294117647,1038.9705882352941,31.483957219251337,0
3655,4,0,0,33,0.0,0.0,1.0,33,900,700,200,0.7777777777777778,11,7,4,359.7721609113564,0.36407039141414144,0.10959119496855374,0.23253566497929135,134996.15532487503,3113.57170319108,138109.72702806612,3526,15,1069.4848484848485,33,0,21,30.84905660377359,0.6767676767676767,40.19607843137255,1039.2156862745096,31.491384432560896,0
3656,4,0,0,33,0.0,0.0,1.0,33,950,700,250,0.7368421052631579,12,7,5,359.55678892855855,0.36316287878787884,0.10833788789700605,0.2330114775004556,135091.68836805562,3114.626736111122,138206.31510416674,3527,16,1070.4848484848485,33,0,21,30.759435537742156,0.6777146464646464,40.10416666666667,1039.583333333334,31.50252525252527,0
3657,4,0,0,33,0.0,0.0,1.0,33,900,600,300,0.6666666666666666,12,6,6,356.62749664525506,0.3629261363636364,0.024673528407968437,0.2216767084895157,133567.21460796334,2926.7482759035047,136493.96288386686,3528,17,1071.4848484848485,33,0,16,32.35860007903577,0.6625631313131313,41.57475490196079,1033.7009803921571,31.324272133095672,5
3658,4,0,0,33,0.0,0.0,1.0,33,750,400,350,0.5333333333333333,11,4,7,354.564727413941,0.3625315656565657,0.023934976169182942,0.2207721479846067,133630.56163795176,2876.1367322664405,136506.6983702182,3529,18,1072.4848484848485,33,0,16,32.34846015566355,0.6631944444444444,41.513480392156865,1033.9460784313726,31.33169934640523,0
3659,4,0,0,33,0.0,0.0,1.0,33,950,700,250,0.7368421052631579,12,7,5,354.81819314098493,0.3623342803030303,0.027351016684982188,0.22111934370189293,133662.24078479433,2885.158953287201,136547.39973808153,3530,19,1073.4848484848485,33,0,16,32.31018408785652,0.663510101010101,41.4828431372549,1034.0686274509806,31.33541295306002,0
3660,4,0,0,33,0.0,0.0,1.0,33,1050,900,150,0.8571428571428571,12,9,3,352.273972718865,0.3627683080808081,0.020505971933528322,0.22009952655217901,133757.3007527153,2823.8431432622065,136581.1438959775,3531,20,1074.4848484848485,33,0,14,32.28080697389725,0.6644570707070707,41.39093137254902,1034.4362745098038,31.346553773024358,0
3661,4,0,1,32,0.0,0.030303030303030304,0.9696969696969697,33,600,400,200,0.6666666666666666,8,4,4,351.8395881739078,0.3631234217171717,0.01806264492831655,0.22001702247141716,133788.9949178202,2814.452974817391,136603.4478926376,3532,21,1075.4848484848485,33,0,14,32.26032535734028,0.6647727272727272,41.360294117647065,1034.5588235294128,31.350267379679178,0
3662,4,0,0,32,0.0,0.0,1.0,32,1050,900,150,0.8571428571428571,12,9,3,354.7806234749166,0.36092909946236557,-0.002282087533808763,0.21064128403977891,131846.31191970207,2955.303349148046,134801.61526885012,3533,22,1054.5625,32,0,14,34.135777805097945,0.6477864583333334,43.244949494949495,1027.020202020202,32.094381313131315,2
3663,4,0,0,32,0.0,0.0,1.0,32,900,800,100,0.8888888888888888,10,8,2,358.4018681672072,0.36057207661290325,-0.0021539808330262034,0.21370203699728224,132008.45457415067,3062.415346648313,135070.86992079898,3534,23,1055.5625,32,0,15,33.87931564074209,0.6494140625,43.08712121212122,1027.651515151516,32.11410984848487,0
3664,4,0,0,32,0.0,0.0,1.0,32,1200,900,300,0.75,15,9,6,360.44712614902716,0.3608030913978495,-0.005066322770817866,0.21547433928820703,132105.7879935722,3123.430325987158,135229.21831955935,3535,24,1056.5625,32,0,15,33.7286600343896,0.650390625,42.99242424242425,1028.030303030304,32.125946969697,0
3665,4,0,0,32,0.0,0.0,1.0,32,950,800,150,0.8421052631578947,11,8,3,363.6440802849818,0.3596900201612903,-0.013290935313612362,0.2183204364098562,132268.09007052865,3219.7015929497115,135487.79166347836,3536,25,1057.5625,32,0,16,33.482928276257105,0.6520182291666666,42.834595959595966,1028.661616161617,32.145675505050534,0
3666,4,0,0,32,0.0,0.0,1.0,32,700,600,100,0.8571428571428571,8,6,2,365.2359551536634,0.3598790322580645,-0.012909609720176407,0.21946479075162592,132300.5624426079,3264.1844582185513,135564.74690082643,3537,26,1058.5625,32,0,16,33.40927221404027,0.65234375,42.803030303030305,1028.7878787878788,32.14962121212121,0
3667,4,0,0,32,0.0,0.0,1.0,32,700,600,100,0.8571428571428571,8,6,2,367.14477914494773,0.3596900201612903,-0.0097442937783776,0.22080168304444112,132333.03880024992,3317.076860779506,135650.11566102944,3538,27,1059.5625,32,0,16,33.32745326624944,0.6526692708333334,42.77146464646464,1028.914141414141,32.15356691919191,0
3668,4,1,1,32,0.030303030303030304,0.030303030303030304,0.9696969696969697,33,650,400,250,0.6153846153846154,9,4,5,357.5165769504216,0.36482007575757575,-0.012503380022713673,0.2166493748571227,132618.81134960108,2882.6846945886164,135501.4960441897,3539,0,1028.4242424242425,33,0,16,33.287601626016254,0.6530934343434343,42.493872549019606,1030.0245098039213,31.212863933452162,0
3669,4,0,0,32,0.0,0.0,1.0,32,850,500,350,0.5882352941176471,12,5,7,369.520641795741,0.35960601478494625,-0.005943439607602796,0.22338330866154668,132527.980642919,3394.3648926129813,135922.34553553196,3540,29,1061.5625,32,0,17,33.06994686286532,0.6546223958333335,42.5820707070707,1029.6717171717162,32.17724116161613,0
3670,4,0,0,32,0.0,0.0,1.0,32,500,400,100,0.8,6,4,2,372.00834343350294,0.3590389784946237,-0.009356608631682084,0.22508160601214003,132560.48489949995,3462.7212784409635,136023.2061779409,3541,30,1062.5625,32,0,17,32.9731690371097,0.6549479166666667,42.550505050505045,1029.797979797979,32.181186868686844,0
3671,4,0,0,32,0.0,0.0,1.0,32,550,400,150,0.7272727272727273,7,4,3,370.2417936585497,0.3590599798387097,-0.007457255791150752,0.224595003305584,132658.02158261903,3423.108770788685,136081.1303534077,3542,31,1063.5625,32,0,13,32.92044572455775,0.6559244791666667,42.455808080808076,1030.176767676767,32.19302398989897,0
3672,4,0,0,32,0.0,0.0,1.0,32,1250,1200,50,0.96,13,12,1,366.0097832743314,0.3585769489247312,-0.011115874571288487,0.2229928261680329,132820.66243240488,3322.7323742475273,136143.3948066524,3543,32,1064.5625,32,0,14,32.865833741629935,0.6575520833333334,42.2979797979798,1030.8080808080808,32.212752525252526,0
3673,4,1,1,32,0.030303030303030304,0.030303030303030304,0.9696969696969697,33,550,300,250,0.5454545454545454,8,3,5,357.530142574235,0.36264993686868685,-0.01297056071402869,0.2194171866235465,133092.5905901576,2916.922577854667,136009.51316801226,3544,0,1033.2727272727273,33,0,14,32.811262866191605,0.6578282828282829,42.03431372549019,1031.8627450980389,31.268568033273905,0
3674,4,0,0,32,0.0,0.0,1.0,32,700,400,300,0.5714285714285714,10,4,6,369.4185222528011,0.3571068548387097,-0.010350367197062393,0.2262480754726675,133015.9629757167,3427.7120957045117,136443.67507142122,3545,34,1066.5625,32,0,15,32.58159934720523,0.6595052083333334,42.108585858585855,1031.5656565656561,32.236426767676754,0
3675,4,0,0,32,0.0,0.0,1.0,32,1050,800,250,0.7619047619047619,13,8,5,371.8076657749011,0.3562668010752688,-0.014887142158062305,0.2285079594018078,133146.24304917877,3500.958766962568,136647.20181614134,3546,35,1067.5625,32,0,15,32.38902821955796,0.6608072916666666,41.98232323232324,1032.0707070707078,32.25220959595962,0
3676,4,0,0,32,0.0,0.0,1.0,32,800,500,300,0.625,11,5,6,372.400982038133,0.35458669354838707,-0.007061628760087535,0.2296753567954638,133276.58689164362,3526.4663682277233,136803.05325987135,3547,36,1068.5625,32,0,16,32.24275495231108,0.662109375,41.8560606060606,1032.5757575757568,32.2679924242424,0
3677,4,0,0,32,0.0,0.0,1.0,32,800,500,300,0.625,11,5,6,373.15578054646664,0.3541666666666667,-0.00957895380102669,0.23095012075878896,133406.99450311193,3556.3182328333833,136963.3127359453,3548,37,1069.5625,32,0,16,32.092296097123764,0.6634114583333334,41.72979797979798,1033.080808080808,32.28377525252525,0
3678,4,0,0,32,0.0,0.0,1.0,32,750,500,250,0.6666666666666666,10,5,5,372.44647100288455,0.35441868279569894,-0.012597727827999172,0.23132373381104787,133537.46588358324,3547.111583001726,137084.57746658497,3549,38,1070.5625,32,0,18,31.979650215815628,0.6647135416666667,41.60353535353535,1033.585858585858,32.29955808080806,0
3679,4,0,0,32,0.0,0.0,1.0,32,1150,800,350,0.6956521739130435,15,8,7,378.96413623271667,0.35441868279569894,-0.001267514749262233,0.22538393365419454,131911.15702479333,3597.9195362718037,135509.07656106513,3550,39,1071.5625,32,0,17,33.4493301376598,0.6484375,43.18181818181818,1027.2727272727268,32.10227272727271,3
3680,4,0,0,32,0.0,0.0,1.0,32,650,600,50,0.9230769230769231,7,6,1,378.45792785660586,0.35506972446236557,-0.0006335237744194977,0.22566073808241152,132008.45457415062,3591.929235537188,135600.3838096878,3551,40,1072.5625,32,0,18,33.364049637547595,0.6494140625,43.08712121212121,1027.6515151515152,32.11410984848485,0
3681,4,0,0,32,0.0,0.0,1.0,32,650,400,250,0.6153846153846154,9,4,5,378.50768064478814,0.35523773521505375,-0.0034201879375999056,0.22607711138145423,132073.3395348689,3598.154684470967,135671.49421933986,3552,41,1073.5625,32,0,18,33.297250542521375,0.6500651041666667,43.023989898989896,1027.9040404040404,32.12200126262626,0
3682,4,0,0,32,0.0,0.0,1.0,32,700,300,400,0.42857142857142855,11,3,8,376.84238372862035,0.35456569220430106,-0.0031652854511972084,0.22585586574463667,132203.1572830579,3563.9505853994515,135767.10786845736,3553,42,1074.5625,32,0,18,33.20902394106813,0.6513671875,42.89772727272727,1028.4090909090912,32.1377840909091,0
3683,4,0,0,32,0.0,0.0,1.0,32,850,600,250,0.7058823529411765,11,6,5,375.45720920494153,0.3543136760752688,-0.0013923836995213268,0.2254126664253986,132268.09007052853,3532.2015929496965,135800.29166347822,3554,43,1075.5625,32,0,18,33.17913546908882,0.6520182291666667,42.83459595959596,1028.6616161616162,32.145675505050505,0
3684,4,0,0,32,0.0,0.0,1.0,32,1400,1100,300,0.7857142857142857,17,11,6,374.1151319242539,0.3532006048387097,-0.002277048577036034,0.22557592865728673,132430.49178655233,3508.850181103966,135939.3419676563,3555,44,1076.5625,32,0,18,33.04991617598954,0.6536458333333334,42.676767676767675,1029.2929292929289,32.16540404040403,0
3685,4,0,0,32,0.0,0.0,1.0,32,700,600,100,0.8571428571428571,8,6,2,372.46813256791586,0.3532216061827957,-0.006955088902514062,0.22516513128920326,132527.98064291902,3472.4898926129827,136000.470535532,3556,45,1077.5625,32,0,19,32.99407316574697,0.6546223958333335,42.5820707070707,1029.6717171717164,32.17724116161614,0
3686,4,0,0,32,0.0,0.0,1.0,32,950,700,250,0.7368421052631579,12,7,5,371.70469290657445,0.35294858870967744,-0.0025275735294116863,0.22567784926470597,132690.54178145083,3464.339416896232,136154.88119834705,3557,46,1078.5625,32,0,16,32.850030637254896,0.65625,42.42424242424242,1030.30303030303,32.19696969696969,0
3687,4,0,0,32,0.0,0.0,1.0,32,500,300,200,0.6,7,3,4,372.30912300840583,0.35198252688172044,0.002526954177897167,0.2264371879280632,132755.59413580247,3485.223765432092,136240.81790123455,3558,47,1079.5625,32,0,16,32.768980233602875,0.6569010416666667,42.36111111111111,1030.5555555555554,32.20486111111111,0
3688,4,0,0,32,0.0,0.0,1.0,32,950,500,450,0.5263157894736842,14,5,9,370.257888206034,0.3518565188172043,0.007831638902498828,0.22558099994881056,132820.6624324049,3435.5795964697522,136256.24202887467,3559,48,1080.5625,32,0,16,32.75635921933694,0.6575520833333334,42.2979797979798,1030.808080808081,32.21275252525253,0
3689,4,0,0,32,0.0,0.0,1.0,32,900,600,300,0.6666666666666666,12,6,6,369.6300318195466,0.35118447580645157,0.0007575293829575891,0.22598339071123175,132950.846852362,3428.5251504948437,136379.37200285686,3560,49,1081.5625,32,0,18,32.641609533137455,0.6588541666666667,42.17171717171717,1031.3131313131312,32.22853535353535,0
3690,4,0,0,32,0.0,0.0,1.0,32,1000,800,200,0.8,12,8,4,371.4494103643903,0.35068044354838707,0.005804882525697552,0.22788923284518003,133081.09504132232,3486.5788567493137,136567.67389807163,3561,50,1082.5625,32,0,18,32.463748164464036,0.66015625,42.04545454545455,1031.818181818182,32.24431818181819,0
3691,4,0,0,32,0.0,0.0,1.0,32,900,600,300,0.6666666666666666,12,6,6,371.8076657749009,0.35084845430107525,0.0042895155370688,0.22850795940180774,133146.2430491788,3500.95876696257,136647.20181614137,3562,51,1083.5625,32,0,18,32.389028219557936,0.6608072916666666,41.98232323232324,1032.070707070708,32.25220959595963,0
3692,4,0,0,32,0.0,0.0,1.0,32,800,500,300,0.625,11,5,6,368.81872827030685,0.35021841397849457,0.005548422597211999,0.22746603015042025,133276.58689164388,3430.9802571166424,136707.5671487605,3563,52,1084.5625,32,0,18,32.33522866226462,0.662109375,41.856060606060616,1032.5757575757589,32.267992424242465,0
3693,4,0,0,32,0.0,0.0,1.0,32,750,600,150,0.8,9,6,3,368.81872827030685,0.35021841397849457,0.005548422597211999,0.22746603015042025,133276.58689164388,3430.9802571166424,136707.5671487605,3564,53,1085.5625,32,0,18,32.33522866226462,0.662109375,41.856060606060616,1032.5757575757589,32.267992424242465,0
3694,4,0,0,32,0.0,0.0,1.0,32,600,500,100,0.8333333333333334,7,5,2,368.8464872697199,0.35070144489247307,-0.0001260234632776136,0.22848378541469488,133439.60636988576,3443.746014437307,136883.35238432308,3565,54,1086.5625,32,0,18,32.17086235691881,0.6637369791666666,41.698232323232325,1033.2070707070711,32.28772095959597,0
3695,4,0,0,32,0.0,0.0,1.0,32,900,800,100,0.8888888888888888,10,8,2,366.80116029116573,0.3514154905913978,-0.00667598021253224,0.22801830670491843,133570.093692608,3398.7330693296726,136968.82676193767,3566,55,1087.5625,32,0,19,32.09279956027849,0.6650390625,41.5719696969697,1033.712121212122,32.30350378787881,0
3696,4,0,0,32,0.0,0.0,1.0,32,950,800,150,0.8421052631578947,11,8,3,364.5974874591386,0.35166750672043007,-0.0031475094616042476,0.2274499634255754,133700.6447843333,3349.3838320069426,137050.02861634025,3567,56,1088.5625,32,0,16,32.01888251332764,0.6663411458333334,41.44570707070707,1034.217171717172,32.31928661616163,0
3697,4,0,0,32,0.0,0.0,1.0,32,650,600,50,0.9230769230769231,7,6,1,362.0159939991775,0.35166750672043007,-0.024826622265672782,0.22425260249017934,133439.60636988565,3261.4543477706247,136701.06071765628,3568,57,1089.5625,32,0,18,32.347295205507336,0.6637369791666667,41.69823232323232,1033.2070707070702,32.287720959595944,1
3698,4,0,0,32,0.0,0.0,1.0,32,850,700,150,0.8235294117647058,10,7,3,360.0353481935898,0.35179351478494625,-0.028334503602393424,0.22420756398154446,133635.36126734526,3222.690764972971,136858.05203231823,3569,58,1090.5625,32,0,18,32.20224284609436,0.6656901041666666,41.50883838383839,1033.964646464647,32.31139520202022,0
3699,4,0,0,32,0.0,0.0,1.0,32,900,500,400,0.5555555555555556,13,5,8,356.7848217590969,0.3522135416666667,-0.021523709264005486,0.22297010256844269,133765.9442435722,3145.131714876047,136911.07595844823,3570,59,1091.5625,32,0,16,32.15549859636276,0.6669921875,41.382575757575765,1034.4696969696977,32.32717803030305,0
3700,4,0,0,32,0.0,0.0,1.0,32,500,300,200,0.6,7,3,4,390.4081484264062,0.3522135416666667,0.011143802012172577,0.21632319359814167,129169.29913082857,3685.7493814406826,132855.04851226925,3571,60,1092.5625,32,0,17,35.943257566347874,0.6207682291666666,45.864898989899,1016.5404040404047,31.766887626262648,8
3701,4,1,1,32,0.030303030303030304,0.030303030303030304,0.9696969696969697,33,1050,700,350,0.6666666666666666,14,7,7,382.7669929945314,0.35909880050505055,0.01315174870088165,0.21360867673565775,129450.69204152247,3309.8904267589346,132760.5824682814,3572,0,1060.4242424242425,33,0,16,35.850192678227344,0.6212121212121213,45.588235294117645,1017.6470588235293,30.837789661319068,0
3702,4,0,0,32,0.0,0.0,1.0,32,500,300,200,0.6,7,3,4,394.14916305150683,0.35217153897849457,0.01113826815642427,0.21910776455347744,129297.68207644633,3792.5146349862316,133090.19671143257,3573,62,1094.5625,32,0,17,35.716945996275605,0.6220703125,45.73863636363637,1017.045454545455,31.782670454545467,0
3703,4,1,1,32,0.030303030303030304,0.030303030303030304,0.9696969696969697,33,850,600,250,0.7058823529411765,11,6,5,383.6554043620347,0.3590593434343434,0.015127809567573758,0.2149556813785667,129606.62853529883,3344.8566957420126,132951.48523104086,3574,0,1062.3636363636363,33,0,16,35.66852709912946,0.6227904040404041,45.43504901960784,1018.2598039215679,30.85635769459297,0
3704,4,2,2,32,0.058823529411764705,0.058823529411764705,0.9411764705882353,34,650,500,150,0.7692307692307693,8,5,3,374.48461859006557,0.3670528817587641,0.006251975211949201,0.21122116629566123,129867.92091836724,2926.707766439899,132794.62868480713,3575,0,1032.0588235294117,34,0,16,35.63590087985674,0.6231617647058825,45.17857142857142,1019.2857142857133,29.978991596638625,0
3705,4,2,0,34,0.058823529411764705,0.0,1.0,34,800,500,300,0.625,11,5,6,375.4923759171845,0.36790701128936426,0.026666209074061697,0.213110573616574,130110.72137188194,2971.116780045335,133081.83815192728,3576,0,1033.0,34,0,19,35.363185530921825,0.6256127450980392,44.94047619047618,1020.238095238094,30.007002801120414,0
3706,4,0,0,34,0.0,0.0,1.0,34,800,500,300,0.625,11,5,6,371.01207830070825,0.36770276292335113,0.022448979591837004,0.21139060275272892,130262.58680555539,2865.7986111110913,133128.38541666648,3577,1,1034.0,34,0,19,35.32312925170067,0.6271446078431373,44.79166666666666,1020.833333333332,30.02450980392153,0
3707,4,1,0,35,0.02857142857142857,0.0,1.0,35,800,400,400,0.5,12,4,8,365.1125354442347,0.37356442577030813,0.026086956521739646,0.20993970788043476,130617.28395061713,2538.0015432098594,133155.285493827,3578,0,1005.4285714285714,35,0,18,35.11379076086957,0.6285714285714286,44.444444444444436,1022.2222222222209,29.20634920634917,0
3708,4,1,1,35,0.027777777777777776,0.027777777777777776,0.9722222222222222,36,800,600,200,0.75,10,6,4,358.8083978785028,0.3786541005291005,0.01934081655111708,0.20780700519579068,130895.62694028488,2193.2900383491624,133088.91697863405,3579,0,978.4722222222222,36,0,18,34.99298448332785,0.6293402777777778,44.1722972972973,1023.3108108108108,28.4253003003003,0
3709,4,1,1,35,0.027777777777777776,0.027777777777777776,0.9722222222222222,36,750,500,250,0.6666666666666666,10,5,5,357.04576905851167,0.37620701058201056,0.023849236897735437,0.20771702994555646,131068.54056336745,2159.493572964859,133228.0341363323,3580,0,979.4444444444445,36,0,19,34.86312731405109,0.6310763888888888,44.00337837837838,1023.9864864864868,28.444069069069077,0
3710,4,0,0,35,0.0,0.0,1.0,35,750,400,350,0.5333333333333333,11,4,7,364.17763163950804,0.3698529411764706,0.03349486334560958,0.21133772796717917,130972.46334876544,2539.448302469135,133511.91165123458,3581,1,1008.3142857142857,35,0,19,34.777815468113964,0.6321428571428571,44.09722222222222,1023.6111111111112,29.246031746031747,0
3711,4,1,1,35,0.027777777777777776,0.027777777777777776,0.9722222222222222,36,950,800,150,0.8421052631578947,11,8,3,353.76120084160874,0.3750165343915344,0.024227541304429945,0.20736353116175554,131357.78523930462,2094.339822316519,133452.12506162113,3582,0,981.2777777777778,35,1,19,34.65491042866283,0.6360119047619048,43.72106481481481,1025.11574074074,29.289021164021143,0
3712,4,0,0,35,0.0,0.0,1.0,35,700,300,400,0.42857142857142855,11,3,8,360.23530967017,0.3697829131652661,0.027409988385598272,0.21099496709252794,131328.12499999988,2461.8055555555416,133789.93055555542,3583,3,1010.3142857142857,34,1,19,34.5189701897019,0.6378676470588236,43.74999999999999,1024.999999999999,30.147058823529385,0
3713,4,0,0,35,0.0,0.0,1.0,35,500,300,200,0.6,7,3,4,360.40781373618285,0.3692226890756303,0.02795773830256576,0.21160139738989356,131419.65880102027,2472.9343820861513,133892.59318310642,3584,4,1011.3142857142857,34,1,19,34.42204613181623,0.6387867647058825,43.66071428571428,1025.3571428571418,30.157563025210052,0
3714,4,1,0,36,0.027777777777777776,0.0,1.0,36,800,500,300,0.625,11,5,6,353.3431283189188,0.37139550264550264,0.03531710249473985,0.20954948091212866,131803.0907064471,2114.343278463637,133917.43398491075,3585,0,984.1944444444445,35,1,18,34.21626089570183,0.6404761904761905,43.28703703703703,1026.851851851851,29.338624338624317,0
3715,4,0,1,35,0.0,0.027777777777777776,0.9722222222222222,36,750,600,150,0.8,9,6,3,352.2330083646268,0.3709656084656085,0.029519598528587654,0.20945694278371102,131905.89871966562,2092.322305413524,133998.22102507914,3586,1,985.1944444444445,36,0,18,34.141133157933204,0.6394675925925927,43.18693693693694,1027.2522522522524,28.53478478478479,0
3716,4,0,0,35,0.0,0.0,1.0,35,1000,600,400,0.6,14,6,8,354.21279737999544,0.37013305322128853,0.0356917530419103,0.21072337731533775,131921.96609224967,2345.6897290809347,134267.6558213306,3587,2,1008.4,35,0,18,34.0740949376596,0.6416666666666666,43.1712962962963,1027.314814814815,29.35185185185186,0
3717,4,0,0,35,0.0,0.0,1.0,35,800,600,200,0.75,10,6,4,353.36804874778977,0.36936274509803924,0.03683812527150754,0.21071557453536777,132011.15779588916,2329.7050486539924,134340.86284454315,3588,3,1009.4,35,0,18,34.00591752074183,0.6425595238095237,43.08449074074075,1027.6620370370379,29.36177248677251,0
3718,4,0,1,34,0.0,0.02857142857142857,0.9714285714285714,35,700,400,300,0.5714285714285714,10,4,6,355.2593133674211,0.3691526610644258,0.03984555984555982,0.21200959023539673,132040.89506172857,2381.7515432098944,134422.64660493846,3589,4,1010.4,35,0,18,33.92736486486487,0.6428571428571427,43.055555555555564,1027.7777777777792,29.365079365079406,0
3719,4,0,0,34,0.0,0.0,1.0,34,800,600,200,0.75,10,6,4,363.3542749496824,0.3662730243612597,0.043896121600436544,0.21625844088384555,131938.9526643992,2788.1164965986554,134727.06916099787,3590,5,1040.8529411764705,34,0,18,33.822180378524536,0.6439950980392156,43.15476190476191,1027.3809523809532,30.21708683473392,0
3720,4,0,0,34,0.0,0.0,1.0,34,850,600,250,0.7058823529411765,11,6,5,360.9788873804748,0.3649546939988117,0.04351306243400699,0.21571298910244996,132091.8810232427,2736.4760487528465,134828.35707199553,3591,6,1041.8529411764705,34,0,18,33.72900984365953,0.6455269607843137,43.00595238095239,1027.976190476191,30.23459383753503,0
3721,4,0,0,34,0.0,0.0,1.0,34,900,500,400,0.5555555555555556,13,5,8,359.6804269547329,0.364230540701129,0.045751633986928386,0.21580825617283947,132244.8979591835,2713.1802721088243,134958.0782312923,3592,7,1042.8529411764705,34,0,19,33.608217592592595,0.6470588235294118,42.85714285714285,1028.571428571427,30.25210084033609,0
3722,4,1,1,34,0.02857142857142857,0.02857142857142857,0.9714285714285714,35,500,300,200,0.6,7,3,4,351.93616361769836,0.36757703081232496,0.046253914719345035,0.2125235692721947,132487.35592689045,2325.418354552471,134812.77428144292,3593,0,1014.0285714285715,35,0,19,33.563448566610454,0.6473214285714286,42.62152777777778,1029.513888888889,29.41468253968254,0
3723,4,0,0,34,0.0,0.0,1.0,34,450,300,150,0.6666666666666666,6,3,3,358.0767212122005,0.36482471776589426,0.04573046247652246,0.2155442324622744,132367.37528344663,2679.5351473922833,135046.9104308389,3594,9,1044.8529411764705,34,0,19,33.526145303100414,0.6482843137254901,42.738095238095234,1029.0476190476184,30.266106442577012,0
3724,4,0,0,34,0.0,0.0,1.0,34,750,400,350,0.5333333333333333,11,4,7,353.6618245278702,0.3648061497326203,0.042024095402009465,0.21340640591015297,132459.27047902488,2569.1574546485163,135028.4279336734,3595,10,1045.8529411764705,34,0,19,33.54728036698661,0.649203431372549,42.64880952380952,1029.4047619047615,30.27661064425769,0
3725,4,0,0,34,0.0,0.0,1.0,34,650,200,450,0.3076923076923077,11,2,9,354.6838269461326,0.3649732620320856,0.0397575774065404,0.21419732789316726,132489.90929705213,2598.405612244887,135088.314909297,3596,11,1046.8529411764705,34,0,19,33.49016150169595,0.6495098039215687,42.61904761904761,1029.5238095238092,30.280112044817916,0
3726,4,0,0,34,0.0,0.0,1.0,34,950,800,150,0.8421052631578947,11,8,3,354.4069376227061,0.3649546939988117,0.045088068741884646,0.21490422083036276,132643.15653344677,2601.9309807256227,135245.0875141724,3597,12,1047.8529411764705,34,0,18,33.34320466890095,0.6510416666666667,42.470238095238095,1030.119047619048,30.297619047619058,0
3727,4,0,0,34,0.0,0.0,1.0,34,1050,700,350,0.6666666666666666,14,7,7,353.6204915776122,0.36402629233511585,0.044115948331510335,0.21512948668920476,132765.81809807237,2589.7427721088256,135355.5608701812,3598,13,1048.8529411764705,34,0,18,33.24020060837088,0.6522671568627452,42.35119047619047,1030.5952380952367,30.311624649859905,0
3728,4,0,0,34,0.0,0.0,1.0,34,850,500,350,0.5882352941176471,12,5,7,351.70194212274424,0.3638406120023767,0.047661253625107536,0.21466458919838535,132888.5363520408,2547.431264172329,135435.96761621314,3599,14,1049.8529411764705,34,0,18,33.166397259746745,0.6534926470588236,42.232142857142854,1031.0714285714284,30.325630252100837,0
3729,4,0,0,34,0.0,0.0,1.0,34,900,600,300,0.6666666666666666,12,6,6,350.9891097859497,0.3625779857397504,0.04097693075153219,0.21528822466488517,133072.72002551024,2541.415107709754,135614.13513322,3600,15,1050.8529411764705,34,0,18,32.999932694896344,0.6553308823529411,42.05357142857143,1031.7857142857147,30.346638655462197,0
3730,4,1,1,34,0.02857142857142857,0.02857142857142857,0.9714285714285714,35,650,400,250,0.6153846153846154,9,4,5,342.179319522936,0.3670868347338936,0.037343920087084426,0.21146871519547633,133352.6502486281,2126.103823731119,135478.75407235924,3601,0,1021.8,35,0,18,32.946735395189,0.6559523809523811,41.7824074074074,1032.870370370369,29.510582010581974,0
3731,4,0,0,34,0.0,0.0,1.0,34,850,700,150,0.8235294117647058,10,7,3,354.48498807859045,0.3617795603089721,0.054579231415941454,0.21905354391523105,133349.23469387728,2654.060374149629,136003.2950680269,3602,17,1052.8529411764705,34,0,18,32.63240548639926,0.6580882352941178,41.78571428571427,1032.8571428571408,30.378151260504143,0
3732,4,1,1,34,0.02857142857142857,0.02857142857142857,0.9714285714285714,35,1000,800,200,0.8,12,8,4,347.2629689835409,0.3646008403361345,0.04397473818850495,0.2165243983159758,133681.60211173247,2284.5340095593074,135966.13612129178,3603,0,1023.7428571428571,35,0,18,32.486126655474735,0.6592261904761906,41.46412037037036,1034.1435185185169,29.546957671957625,0
3733,4,0,0,34,0.0,0.0,1.0,34,650,200,450,0.3076923076923077,11,2,9,356.83921141769423,0.3600527332144979,0.05370534716247488,0.2217920452927584,133564.50007086145,2732.2101757369405,136296.7102465984,3604,19,1054.8529411764705,34,0,18,32.35584859303621,0.660232843137255,41.57738095238094,1033.6904761904746,30.402661064425722,0
3734,4,0,0,34,0.0,0.0,1.0,34,900,600,300,0.6666666666666666,12,6,6,355.88387883494465,0.3597927807486631,0.05462862018296466,0.22193562494179186,133687.58680555545,2715.4513888888796,136403.03819444432,3605,20,1055.8529411764705,34,0,19,32.257252215954885,0.6614583333333334,41.45833333333333,1034.1666666666658,30.416666666666643,0
3735,4,0,0,34,0.0,0.0,1.0,34,1050,600,450,0.5714285714285714,15,6,9,353.74790684061566,0.35947712418300654,0.05518935600010888,0.22152570650278308,133841.52494331053,2669.231859410418,136510.75680272095,3606,21,1056.8529411764705,34,0,16,32.15840236232552,0.6629901960784315,41.3095238095238,1034.7619047619037,30.434173669467754,0
3736,4,0,0,34,0.0,0.0,1.0,34,1100,700,400,0.6363636363636364,15,7,8,352.22466296818135,0.35934714795008915,0.05268409836620069,0.2211258804699161,133933.93034297056,2634.9666950113383,136568.8970379819,3607,22,1057.8529411764705,34,0,16,32.10537665324899,0.6639093137254901,41.220238095238095,1035.119047619048,30.444677871148468,0
3737,4,0,0,34,0.0,0.0,1.0,34,750,500,250,0.6666666666666666,10,5,5,362.80284926855666,0.3599041889483066,0.0941046647489292,0.21232968928300486,131297.62081916086,2727.0301870748162,134024.65100623568,3608,23,1058.8529411764705,34,0,18,34.48401866263988,0.6375612745098039,43.7797619047619,1024.8809523809514,30.14355742296916,8
3738,4,0,0,34,0.0,0.0,1.0,34,850,700,150,0.8235294117647058,10,7,3,363.6067011321653,0.3597185086155674,0.09503917697609765,0.21313936715106035,131358.63272392293,2752.5758219954646,134111.2085459184,3609,24,1059.8529411764705,34,0,18,34.401734215925366,0.6381740196078431,43.720238095238095,1025.1190476190477,30.150560224089638,0
3739,4,1,1,34,0.02857142857142857,0.02857142857142857,0.9714285714285714,35,950,700,250,0.7368421052631579,12,7,5,353.8963383385351,0.36628151260504205,0.08747381650607489,0.2088977986490981,131624.87809713653,2316.312478566539,133941.19057570308,3610,0,1030.5428571428572,35,0,15,34.38181442213701,0.6386904761904761,43.46064814814815,1026.1574074074078,29.31878306878308,0
3740,4,0,0,34,0.0,0.0,1.0,34,1100,900,200,0.8181818181818182,13,9,4,347.0381119237601,0.3590686274509804,0.08656362614927149,0.1994423848043777,130597.00255102034,2264.42743764171,132861.42998866204,3611,26,1061.8529411764705,34,0,19,35.59622253280532,0.630514705882353,44.46428571428571,1022.1428571428567,30.06302521008402,3
3741,4,2,1,35,0.05555555555555555,0.027777777777777776,0.9722222222222222,36,1000,600,400,0.6,14,6,8,342.0582986317669,0.3687169312169312,0.06775067750677533,0.20034843205574912,131328.12499999997,1784.3749999999986,133112.49999999997,3612,0,1003.8055555555555,36,0,20,34.98475609756098,0.6336805555555556,43.75,1024.9999999999998,28.472222222222214,4
3742,4,1,1,35,0.027777777777777776,0.027777777777777776,0.9722222222222222,36,1150,900,250,0.782608695652174,14,9,5,342.09207864362986,0.36789021164021163,0.07039882912550355,0.20158207221497232,131559.08230866023,1801.0639862836126,133360.14629494384,3613,0,1003.8333333333334,36,0,14,34.75096048298574,0.6359953703703702,43.52477477477479,1025.9009009009028,28.4972472472473,0
3743,4,0,0,35,0.0,0.0,1.0,35,1000,800,200,0.8,12,8,4,356.1898144741843,0.36253501400560223,0.07916552469086002,0.20943582920077974,131476.45968632135,2366.115156678688,133842.57484300004,3614,2,1033.5142857142857,35,0,21,34.472806869051645,0.6372023809523808,43.60532407407408,1025.5787037037053,29.302248677248723,0
3744,4,1,0,36,0.027777777777777776,0.0,1.0,36,600,300,300,0.5,9,3,6,351.8018346229327,0.36836970899470894,0.09433600175457801,0.20872354781564928,131819.15181651275,2074.8438894976375,133893.99570601038,3615,0,1005.7777777777778,36,0,16,34.23963702160326,0.6385995370370369,43.27139639639641,1026.9144144144168,28.525400400400468,0
3745,4,0,2,34,0.0,0.05555555555555555,0.9444444444444444,36,1000,600,400,0.6,14,6,8,351.9196986910674,0.367906746031746,0.09812500761201792,0.20943009857525183,131934.82069485038,2086.0924691583587,134020.91316400873,3616,1,1006.7777777777778,36,0,16,34.12003544155796,0.6397569444444444,43.15878378378379,1027.364864864866,28.537912912912944,0
3746,4,0,0,34,0.0,0.0,1.0,34,1350,900,450,0.6666666666666666,18,9,9,370.9466502079851,0.3592171717171717,0.10960334029227559,0.2193622783328704,131694.4515306123,2970.323129251707,134664.77465986402,3617,2,1066.764705882353,34,0,17,33.87410113662723,0.6415441176470588,43.392857142857146,1026.428571428572,30.18907563025212,0
3747,4,0,0,34,0.0,0.0,1.0,34,700,500,200,0.7142857142857143,9,5,4,371.82176589644104,0.3586972667855021,0.10957792207792183,0.22023289210789218,131755.55555555562,2997.916666666672,134753.4722222223,3618,3,1067.764705882353,34,0,17,33.78990800865802,0.642156862745098,43.333333333333336,1026.6666666666672,30.196078431372566,0
3748,4,0,0,34,0.0,0.0,1.0,34,1150,900,250,0.782608695652174,14,9,5,381.1181722117864,0.35736036838978014,0.1245313884534116,0.2268310224957046,131938.9526643991,3256.866496598641,135195.81916099775,3619,4,1068.764705882353,34,0,17,33.365923136346076,0.6439950980392157,43.154761904761905,1027.3809523809525,30.217086834733898,0
3749,4,0,0,34,0.0,0.0,1.0,34,700,500,200,0.7142857142857143,9,5,4,381.3156577466519,0.3571561200237671,0.12248938504842322,0.2271315004838754,131969.53125000015,3264.4097222222367,135233.9409722224,3620,5,1069.764705882353,34,0,17,33.329954041632874,0.6443014705882353,43.12500000000001,1027.5000000000011,30.22058823529415,0
3750,4,1,1,34,0.02857142857142857,0.02857142857142857,0.9714285714285714,35,750,700,50,0.9333333333333333,8,7,1,371.1654457415004,0.3632703081232493,0.11365558038225987,0.22272432925757704,132249.14969403733,2817.262919024364,135066.4126130617,3621,0,1040.1714285714286,35,0,17,33.30860151532201,0.644940476190476,42.85300925925927,1028.587962962964,29.38822751322754,0
3751,4,1,0,35,0.02857142857142857,0.0,1.0,35,1150,900,250,0.782608695652174,14,9,5,374.8681213369011,0.36257002801120447,0.13020476993495556,0.226371482640308,132487.35592689048,2933.0572434413607,135420.41317033183,3622,0,1041.142857142857,35,0,20,32.973229342327144,0.6473214285714286,42.62152777777778,1029.5138888888891,29.41468253968255,0
3752,4,0,0,35,0.0,0.0,1.0,35,1300,1000,300,0.7692307692307693,16,10,6,371.90770843709697,0.36221988795518206,0.1294527474997187,0.22529657572373898,132606.5394188314,2863.4788398062306,135470.01825863763,3623,1,1042.142857142857,35,0,20,32.92937876915009,0.6485119047619048,42.50578703703703,1029.9768518518515,29.427910052910043,0
3753,4,0,0,35,0.0,0.0,1.0,35,1100,700,400,0.6363636363636364,15,7,8,370.46510528987835,0.3608543417366947,0.11849475473998283,0.2256745709789092,132815.23946544903,2840.6823345335793,135655.9217999826,3624,2,1043.142857142857,35,0,16,32.75647503555654,0.6505952380952382,42.303240740740726,1030.7870370370354,29.451058201058153,0
3754,4,0,0,35,0.0,0.0,1.0,35,900,400,500,0.4444444444444444,14,4,10,369.6144064928493,0.36022408963585434,0.12187740446268269,0.22623651034782086,132994.25582990394,2831.3185871056176,135825.57441700954,3625,3,1044.142857142857,35,0,17,32.598369239976066,0.6523809523809524,42.129629629629626,1031.481481481481,29.470899470899457,0
3755,4,0,0,35,0.0,0.0,1.0,35,900,700,200,0.7777777777777778,11,7,4,369.7163558491132,0.36067927170868347,0.11929813316240723,0.2268424853678485,133083.80922335797,2840.652193715682,135924.46141707365,3626,4,1045.142857142857,35,0,17,32.50572536922789,0.6532738095238096,42.04282407407406,1031.8287037037019,29.480820105820055,0
3756,4,0,0,35,0.0,0.0,1.0,35,1100,800,300,0.7272727272727273,14,8,6,369.5203427962479,0.36127450980392156,0.12342395744885404,0.2270856579403267,133143.5282305597,2839.8484385716565,135983.37666913134,3627,5,1046.142857142857,35,0,17,32.450772868303986,0.6538690476190477,41.984953703703695,1032.060185185184,29.487433862433832,0
3757,4,1,0,36,0.027777777777777776,0.0,1.0,36,650,300,350,0.46153846153846156,10,3,7,360.74277176557814,0.3659556878306878,0.11815469446332849,0.20647961761368297,130439.8750964505,2218.4463145147356,132658.32141096523,3628,0,1018.0555555555555,35,1,18,35.40533650577838,0.6267857142857143,44.61805555555555,1021.5277777777768,29.18650793650791,8
3758,4,1,1,36,0.02702702702702703,0.02702702702702703,0.972972972972973,37,850,700,150,0.8235294117647058,10,7,3,353.03034031611946,0.3704954954954955,0.11120439672984306,0.20309311973318972,130636.47050766986,1823.7275282038825,132460.19803587373,3629,0,991.5135135135135,36,1,16,35.40312660644783,0.6267361111111112,44.42567567567568,1022.2972972972975,28.39714714714715,0
3759,4,0,0,36,0.0,0.0,1.0,36,1050,700,350,0.6666666666666666,14,7,7,358.4667414933836,0.36638558201058197,0.11171497584541057,0.2061183763586956,130617.28395061727,2164.390432098762,132781.67438271604,3630,2,1020.0555555555555,35,1,16,35.283627717391305,0.6285714285714286,44.44444444444444,1022.2222222222222,29.206349206349206,0
3760,4,2,0,38,0.05263157894736842,0.0,1.0,38,1300,800,500,0.6153846153846154,18,8,10,344.8572796959545,0.3761557610241821,0.12030919996620737,0.20154417002868638,131243.84576263858,1452.0791253077953,132695.92488794637,3631,0,967.3157894736842,37,1,19,34.998105047262364,0.6309121621621621,43.83223684210527,1024.6710526315794,27.69381223328593,0
3761,4,0,0,38,0.0,0.0,1.0,38,1200,1000,200,0.8333333333333334,14,10,4,344.70222751008,0.3759038643907065,0.11767222935387256,0.20189701897018983,131328.12500000012,1453.819444444459,132781.94444444458,3632,1,968.3157894736842,37,1,20,34.9170054200542,0.6317567567567567,43.75000000000001,1025.000000000001,27.702702702702727,0
3762,4,2,1,39,0.05,0.025,0.975,40,550,400,150,0.7272727272727273,7,4,3,330.183209647495,0.38404113247863253,0.12021103896103891,0.195570054945055,131755.55555555574,700.694444444465,132456.2500000002,3633,0,920.85,39,1,17,34.85863095238094,0.6324786324786323,43.33333333333334,1026.6666666666683,26.324786324786366,0
3763,4,0,0,39,0.0,0.0,1.0,39,850,500,350,0.5882352941176471,12,5,7,334.74745055108826,0.3799201529464687,0.12205512580278333,0.19776039421855807,131656.85609796192,1014.3593852728536,132671.2154832348,3634,1,945.4615384615385,38,1,17,34.840854674161974,0.6332236842105262,43.42948717948718,1026.2820512820517,27.007422402159257,0
3764,4,0,0,39,0.0,0.0,1.0,39,1400,1100,300,0.7857142857142857,17,11,6,333.2717685913833,0.37938596491228066,0.12252312814110589,0.19774124936422055,131821.37573964478,986.4686061801254,132807.8443458249,3635,2,946.4615384615385,38,1,20,34.7131190178943,0.6348684210526316,43.26923076923076,1026.9230769230755,27.02429149797567,0
3765,4,0,0,39,0.0,0.0,1.0,39,1100,700,400,0.6363636363636364,15,7,8,333.67421475529596,0.3805386864597391,0.11905751905751938,0.19912816041848286,132040.89506172817,1011.7283950617036,133052.62345678988,3636,3,947.4615384615385,38,1,21,34.481981981981974,0.637061403508772,43.05555555555554,1027.777777777776,27.04678362573095,0
3766,4,0,0,39,0.0,0.0,1.0,39,1000,700,300,0.7,13,7,6,336.6233729889744,0.38067926225820964,0.12034017520301865,0.20147160084862462,132150.7232084152,1097.0044378697949,133247.727646285,3637,4,948.4615384615385,38,1,21,34.29577098919367,0.6381578947368423,42.948717948717935,1028.205128205126,27.058029689608578,0
3767,4,0,0,39,0.0,0.0,1.0,39,1500,1200,300,0.8,18,12,6,330.7370949976488,0.38084795321637427,0.0807500956754692,0.20144895786220401,132810.65088757378,985.0817718605999,133795.73265943438,3638,5,949.4615384615385,38,1,18,33.7848517827529,0.6447368421052633,42.3076923076923,1030.7692307692294,27.125506072874458,1
3768,4,0,0,39,0.0,0.0,1.0,39,1150,800,350,0.6956521739130435,15,8,7,334.2140297312899,0.38003261358524515,0.08582414547617523,0.2047697126323183,133030.99203740235,1092.1647855942779,134123.15682299662,3639,6,950.4615384615385,38,1,19,33.474437310135315,0.6469298245614035,42.0940170940171,1031.623931623932,27.147998200629793,0
3769,4,0,0,39,0.0,0.0,1.0,39,1150,800,350,0.6956521739130435,15,8,7,333.99758983844845,0.3799201529464687,0.08293704845428951,0.20478823651237446,133058.5475221894,1088.2468359631832,134146.79435815258,3640,7,951.4615384615385,38,1,19,33.45241793517656,0.647203947368421,42.06730769230769,1031.7307692307695,27.1508097165992,0
3770,4,0,1,38,0.0,0.02564102564102564,0.9743589743589743,39,900,700,200,0.7777777777777778,11,7,4,335.7786398846978,0.37938596491228066,0.0803222442464917,0.2067959845255474,133223.9403558516,1146.750698553602,134370.6910544052,3641,8,952.4615384615385,38,1,21,33.240841353616894,0.6488486842105262,41.90705128205129,1032.3717948717963,27.16767881241569,0
3771,4,0,0,38,0.0,0.0,1.0,38,600,300,300,0.5,9,3,6,339.4699698321904,0.37476292081555235,0.07522272368840466,0.20839868793807872,133104.23790252794,1436.9783250615828,134541.21622758952,3642,9,978.2631578947369,37,1,21,33.2654827683916,0.6494932432432431,42.02302631578949,1031.907894736844,27.889402560455242,0
3772,4,0,0,38,0.0,0.0,1.0,38,750,600,150,0.8,9,6,3,340.15134534513777,0.375014817449028,0.07300870109826185,0.2089754871010733,133132.5263542631,1457.0415897199414,134589.56794398304,3643,10,979.2631578947369,37,1,21,33.219560135996595,0.6497747747747746,41.99561403508773,1032.0175438596511,27.89236605026084,0
3773,4,0,0,38,0.0,0.0,1.0,38,1000,800,200,0.8,12,8,4,340.15134534513777,0.375014817449028,0.07300870109826185,0.2089754871010733,133132.5263542631,1457.0415897199414,134589.56794398304,3644,11,980.2631578947369,37,1,21,33.219560135996595,0.6497747747747746,41.99561403508773,1032.0175438596511,27.89236605026084,0
3774,4,0,0,38,0.0,0.0,1.0,38,950,600,350,0.631578947368421,13,6,7,338.58763323965286,0.3746295637743006,0.06937006630020837,0.208217385406002,133168.79799702342,1417.8616270363339,134586.65962405974,3645,12,981.2631578947369,38,0,21,33.22357071386674,0.6483004385964911,41.9604700854701,1032.1581196581217,27.162055780476887,0
3775,4,0,0,38,0.0,0.0,1.0,38,1050,800,250,0.7619047619047619,13,8,5,342.0165919257924,0.37428876244665715,0.07412752701289649,0.2107938995134479,133251.51581561862,1514.8458616407634,134766.36167725938,3646,13,982.2631578947369,38,0,21,33.052221302428265,0.6491228070175437,41.880341880341895,1032.4786324786346,27.17049032838512,0
3776,4,0,0,38,0.0,0.0,1.0,38,600,300,300,0.5,9,3,6,345.37715454709917,0.3732515410146989,0.08152777475339157,0.21349784719701792,133361.84619037207,1612.0269924757379,134973.8731828478,3647,14,983.2631578947369,38,0,21,32.8549510412357,0.6502192982456139,41.77350427350429,1032.9059829059847,27.181736392262756,0
3777,4,0,0,38,0.0,0.0,1.0,38,800,700,100,0.875,9,7,2,346.55762019010893,0.37264402560455195,0.07525059332681816,0.21502999146094653,133500.54974848038,1653.1722200778681,135153.72196855824,3648,15,984.2631578947369,37,1,21,32.685565870910715,0.6534346846846846,41.63925438596492,1033.442982456141,27.93089141773354,0
3778,4,0,0,38,0.0,0.0,1.0,38,1000,700,300,0.7,13,7,6,342.5101161224617,0.37234767662399243,0.0762551464949448,0.2131492214609044,133610.2564673279,1552.5728915552802,135162.8293588832,3649,16,985.2631578947369,38,0,21,32.680367538148886,0.6526864035087718,41.533119658119666,1033.8675213675224,27.207040035987433,0
3779,4,0,0,38,0.0,0.0,1.0,38,1450,1000,450,0.6896551724137931,19,10,9,343.774040344016,0.3726884779516359,0.06549598904324028,0.21505864384311701,133803.62426035502,1599.6425049309676,135403.26676528598,3650,17,986.2631578947369,38,0,17,32.454306071871144,0.6546052631578947,41.34615384615385,1034.6153846153845,27.226720647773277,0
3780,4,0,0,38,0.0,0.0,1.0,38,1050,700,350,0.6666666666666666,14,7,7,345.9464260143996,0.3719327880512091,0.07236230868282556,0.21690505040786331,133886.53897518077,1663.5139299802781,135550.05290516105,3651,18,987.2631578947369,38,0,17,32.31521626922681,0.6554276315789473,41.26602564102564,1034.9358974358972,27.235155195681507,0
3781,4,0,0,38,0.0,0.0,1.0,38,750,600,150,0.8,9,6,3,348.0573667202858,0.37153271692745377,0.07246077621800184,0.2183924720716404,133914.18292059313,1721.9635747680597,135636.1464953612,3652,19,988.2631578947369,38,0,17,32.23296001926784,0.6557017543859649,41.23931623931624,1035.0427350427346,27.237966711650913,0
3782,4,0,0,38,0.0,0.0,1.0,38,1250,1100,150,0.88,14,11,3,346.5944448571014,0.3717549786628734,0.07128811294414139,0.21763795050035364,133941.8297195742,1684.6988229600493,135626.52854253424,3653,20,989.2631578947369,38,0,17,32.24317955069321,0.6559758771929824,41.21260683760684,1035.1495726495732,27.240778227620346,0
3783,4,0,0,38,0.0,0.0,1.0,38,650,300,350,0.46153846153846156,10,3,7,348.17955093047965,0.37122155049786626,0.06873170440289145,0.21896223413804547,133997.13187824175,1731.0122406677035,135728.14411890946,3654,21,990.2631578947369,38,0,17,32.14688026691432,0.6565241228070174,41.15918803418804,1035.3632478632487,27.24640125955918,0
3784,4,0,0,38,0.0,0.0,1.0,38,800,600,200,0.75,10,6,4,354.81318972332303,0.37122155049786626,0.03968124765982384,0.22448356993649737,134218.454655654,1924.495603221545,136142.95025887556,3655,22,991.2631578947369,38,0,15,31.75391792968347,0.658717105263158,40.94551282051281,1036.2179487179474,27.268893387314403,1
3785,4,0,0,38,0.0,0.0,1.0,38,750,400,350,0.5333333333333333,11,4,7,354.068430488885,0.3709103840682788,0.042093331019221525,0.22486125978168442,134356.87413251502,1914.305509898446,136271.17964241345,3656,23,992.2631578947369,38,0,16,31.63493576532013,0.6600877192982457,40.811965811965806,1036.7521367521358,27.28295096716147,0
3786,4,0,1,37,0.0,0.02631578947368421,0.9736842105263158,38,1350,1000,350,0.7407407407407407,17,10,7,355.7156592985437,0.3711919155998103,0.04239751020695848,0.22642176424989896,134439.96006145424,1964.4798058659985,136404.43986732024,3657,24,993.2631578947369,38,0,16,31.50926307475705,0.6609100877192984,40.731837606837594,1037.0726495726478,27.29138551506968,0
3787,4,0,0,37,0.0,0.0,1.0,37,1000,700,300,0.7,13,7,6,362.1725773803902,0.3671171171171171,0.05235057392417808,0.2301548314320542,134380.19390581705,2333.764235149265,136713.9581409663,3658,25,1020.3243243243244,37,0,16,31.40157924421884,0.6621621621621623,40.78947368421052,1036.842105263157,28.022759601706944,0
3788,4,0,1,36,0.0,0.02702702702702703,0.972972972972973,37,850,600,250,0.7058823529411765,11,6,5,362.3323861280074,0.36727352352352355,0.05298543072092099,0.23079475019426396,134465.4740521121,2344.2392130270796,136809.7132651392,3659,26,1021.3243243243244,37,0,16,31.31222028403284,0.6630067567567568,40.70723684210526,1037.1710526315783,28.03165007112374,0
3789,4,0,0,36,0.0,0.0,1.0,36,1200,1000,200,0.8333333333333334,14,10,4,362.4135094595247,0.36575727513227513,0.06548415885765269,0.2313870868087736,134550.78125000015,2552.604166666682,137103.38541666683,3660,27,1041.5,36,0,16,31.224899598393577,0.665798611111111,40.62500000000001,1037.5000000000011,28.819444444444475,0
3790,4,0,0,36,0.0,0.0,1.0,36,650,500,150,0.7692307692307693,8,5,3,360.966261126496,0.3656415343915344,0.06781950172442919,0.23064792857278338,134579.99173159656,2515.767287557839,137095.7590191544,3661,28,1042.5,36,0,16,31.233268215035086,0.6660879629629629,40.59684684684685,1037.6126126126135,28.822572572572597,0
3791,4,0,0,36,0.0,0.0,1.0,36,700,300,400,0.42857142857142855,11,3,8,360.30333719135785,0.36501322751322757,0.06668957368827155,0.2305941358024692,134638.42220598992,2502.1345669994466,137140.55677298937,3662,29,1043.5,36,0,17,31.19212962962964,0.6666666666666665,40.54054054054055,1037.8378378378388,28.828828828828858,0
3792,4,0,1,35,0.0,0.027777777777777776,0.9722222222222222,36,800,600,200,0.75,10,6,4,360.2496290404299,0.36474867724867727,0.06779007256334224,0.2309305341095052,134696.86536198366,2504.899155912674,137201.76451789634,3663,30,1044.5,36,0,17,31.135188399508202,0.6672453703703705,40.484234234234236,1038.0630630630635,28.835085085085097,0
3793,4,0,0,35,0.0,0.0,1.0,35,800,700,100,0.875,9,7,2,367.7229561190592,0.36442577030812323,0.07361681796464414,0.23594241175879538,134730.9630594135,2908.733603395055,137639.69666280856,3664,31,1062.057142857143,35,0,17,30.907190635451506,0.6696428571428572,40.451388888888886,1038.194444444444,29.662698412698397,0
3794,4,0,0,35,0.0,0.0,1.0,35,1250,800,450,0.64,17,8,9,372.0438102319201,0.364250700280112,0.06944232238349946,0.23990411211506546,134911.26543209862,3038.5802469135674,137949.84567901219,3665,32,1063.057142857143,35,0,15,30.61497326203209,0.6714285714285715,40.27777777777777,1038.8888888888878,29.68253968253965,0
3795,4,0,0,35,0.0,0.0,1.0,35,550,300,250,0.5454545454545454,8,3,5,375.52261658760756,0.3644957983193277,0.07514677103718226,0.24275144523687026,135001.46182966817,3139.2204378858005,138140.682267554,3666,33,1064.057142857143,35,0,15,30.434555629802883,0.6723214285714285,40.19097222222222,1039.2361111111109,29.69246031746031,0
3796,4,0,0,35,0.0,0.0,1.0,35,1000,700,300,0.7,13,7,6,374.09488315308,0.3641456582633053,0.06985399370168932,0.24243291778361917,135091.6883680554,3107.4218749999804,138199.11024305536,3667,34,1065.057142857143,35,0,15,30.3815965263861,0.6732142857142858,40.10416666666666,1039.583333333332,29.70238095238091,0
3797,4,0,0,35,0.0,0.0,1.0,35,950,600,350,0.631578947368421,13,6,7,372.17277275148047,0.3636904761904762,0.07211217449365703,0.24199309232596253,135212.0373049554,3064.447766632369,138276.48507158775,3668,35,1066.057142857143,35,0,15,30.31150307886342,0.674404761904762,39.988425925925924,1040.046296296296,29.715608465608458,0
3798,4,0,0,35,0.0,0.0,1.0,35,850,500,350,0.5882352941176471,12,5,7,373.24354145536296,0.36365546218487393,0.0741560175472058,0.24309514134788404,135272.23186728387,3097.897376543199,138370.12924382708,3669,36,1067.057142857143,35,0,16,30.223631508678224,0.675,39.93055555555555,1040.2777777777771,29.722222222222204,0
3799,4,0,0,35,0.0,0.0,1.0,35,1200,900,300,0.75,15,9,6,370.78431124225904,0.36323529411764705,0.06725978647686826,0.24230323595133646,135392.661179698,3040.2949245541586,138432.95610425217,3670,37,1068.057142857143,35,0,18,30.167556346381964,0.6761904761904762,39.8148148148148,1040.740740740739,29.735449735449688,0
3800,4,0,1,34,0.0,0.02857142857142857,0.9714285714285714,35,500,300,200,0.6,7,3,4,368.2196848154498,0.3634453781512605,0.06175545601829846,0.24103113866303877,135452.8959297838,2975.28452932097,138428.18045910477,3671,38,1069.057142857143,35,0,18,30.174282855236825,0.6767857142857143,39.756944444444436,1040.972222222221,29.74206349206346,0
3801,4,0,0,34,0.0,0.0,1.0,34,850,500,350,0.5882352941176471,12,5,7,376.30090511941154,0.3571004159239453,0.06639847155696699,0.2462855624524054,135447.73242630393,3393.820861678015,138841.55328798195,3672,41,1100.3823529411766,34,0,19,29.969121683440072,0.678921568627451,39.761904761904766,1040.9523809523816,30.61624649859946,0
3802,4,0,0,34,0.0,0.0,1.0,34,950,700,250,0.7368421052631579,12,7,5,379.0140724355309,0.35624628639334527,0.06991431377032908,0.24849003579618836,135509.70096371876,3472.016723356003,138981.71768707476,3673,42,1101.3823529411766,34,0,20,29.836734888329914,0.6795343137254901,39.70238095238095,1041.1904761904757,30.623249299719873,0
3803,4,0,0,34,0.0,0.0,1.0,34,750,500,250,0.6666666666666666,10,5,5,379.84000000000015,0.3553178847296494,0.0614117647058825,0.24989473684210525,135633.68055555547,3503.8194444444357,139137.4999999999,3674,43,1102.3823529411766,34,0,21,29.69166666666667,0.6807598039215688,39.58333333333333,1041.666666666666,30.637254901960766,0
3804,4,0,0,34,0.0,0.0,1.0,34,850,600,250,0.7058823529411765,11,6,5,379.84000000000015,0.3553178847296494,0.0614117647058825,0.24989473684210525,135633.68055555547,3503.8194444444357,139137.4999999999,3675,44,1103.3823529411766,34,0,21,29.69166666666667,0.6807598039215688,39.58333333333333,1041.666666666666,30.637254901960766,0
3805,4,0,0,34,0.0,0.0,1.0,34,450,300,150,0.6666666666666666,6,3,3,380.51579330835625,0.35464943553178846,0.06139773093881051,0.2507736613730974,135695.69160997728,3526.87074829931,139222.5623582766,3676,45,1104.3823529411766,34,0,21,29.6122790981109,0.6813725490196079,39.52380952380952,1041.9047619047615,30.64425770308122,0
3806,4,0,0,34,0.0,0.0,1.0,34,700,600,100,0.8571428571428571,8,6,2,381.1381666216025,0.353665329768271,0.06055363321799301,0.2518388414167644,135788.73476473914,3550.8538832199424,139339.58864795908,3677,46,1105.3823529411766,34,0,21,29.50337902151151,0.6822916666666667,39.4345238095238,1042.2619047619041,30.654761904761887,0
3807,4,0,0,34,0.0,0.0,1.0,34,550,200,350,0.36363636363636365,9,2,7,381.4331531405939,0.3535724896019014,0.06019401821943915,0.2522529221222839,135819.75623582758,3561.231575963705,139380.98781179127,3678,47,1106.3823529411766,34,0,21,29.46479556875284,0.6825980392156863,39.4047619047619,1042.3809523809518,30.658263305322112,0
3808,4,1,0,35,0.02857142857142857,0.0,1.0,35,1100,800,300,0.7272727272727273,14,8,6,373.9825737746061,0.3584733893557423,0.0720844026233245,0.249820359281437,136176.75781250006,3185.546875,139362.30468750006,3679,0,1075.7428571428572,35,0,18,29.303892215568855,0.6839285714285714,39.0625,1043.7500000000005,29.821428571428584,0
3809,4,0,0,35,0.0,0.0,1.0,35,1200,1000,200,0.8333333333333334,14,10,4,377.6480941588291,0.3586484593837535,0.07252454862210977,0.25269924401429067,136237.16670953357,3289.941272290802,139527.10798182437,3680,1,1076.7428571428572,35,0,18,29.14818920916481,0.6845238095238095,39.004629629629626,1043.981481481481,29.828042328042315,0
3810,4,0,0,35,0.0,0.0,1.0,35,550,400,150,0.7272727272727273,7,4,3,377.134226092616,0.35910364145658263,0.07000031668619555,0.2527864032546493,136297.58900248617,3280.497149348409,139578.08615183458,3681,2,1077.7428571428572,35,0,19,29.1015480676864,0.6851190476190476,38.94675925925925,1044.2129629629621,29.83465608465606,0
3811,4,0,0,35,0.0,0.0,1.0,35,850,600,250,0.7058823529411765,11,6,5,378.0463317500633,0.3587535014005602,0.07316818361693689,0.254048260911714,136388.24755926343,3312.2153367198043,139700.46289598325,3682,3,1078.7428571428572,35,0,20,28.987650046168042,0.6860119047619049,38.859953703703695,1044.5601851851843,29.844576719576693,0
3812,4,0,0,35,0.0,0.0,1.0,35,1250,1100,150,0.88,14,11,3,379.5114652411079,0.3581232492997199,0.07587822014051548,0.25568876926841194,136478.93625685864,3359.0642146776345,139838.00047153627,3683,4,1079.7428571428572,35,0,20,28.859289617486347,0.6869047619047619,38.773148148148145,1044.907407407407,29.85449735449734,0
3813,4,0,0,35,0.0,0.0,1.0,35,700,400,300,0.5714285714285714,10,4,6,385.66236698444044,0.3581232492997199,0.03079060237198128,0.2484607903822231,134878.47421500352,3416.691908563748,138295.16612356727,3684,5,1080.7428571428572,32,3,17,30.294052104857997,0.6780598958333334,40.30934343434343,1038.7626262626259,32.46133207070706,6
3814,4,0,0,35,0.0,0.0,1.0,35,850,400,450,0.47058823529411764,13,4,9,384.49381210210026,0.3574229691876751,0.02611411911703465,0.24883278783211407,135042.4701561066,3384.5988292011125,138427.0689853077,3685,6,1081.7428571428572,32,3,17,30.160501700680268,0.6796875,40.151515151515156,1039.39393939394,32.48106060606062,0
3815,4,0,0,35,0.0,0.0,1.0,35,850,600,250,0.7058823529411765,11,6,5,383.3524109077274,0.356687675070028,0.022669789227166115,0.24877124537629122,135140.91554752065,3361.319157483926,138502.23470500458,3686,7,1082.7428571428572,32,3,17,30.091833636915585,0.6806640625,40.05681818181818,1039.7727272727273,32.49289772727273,0
3816,4,0,0,35,0.0,0.0,1.0,35,850,500,350,0.5882352941176471,12,5,7,384.97303674034845,0.35644257703081234,0.016246294659108873,0.2511926204099138,135337.91394054177,3420.2895431588613,138758.20348370064,3687,8,1083.7428571428572,32,3,18,29.853021477975975,0.6826171875,39.86742424242424,1040.530303030303,32.51657196969697,0
3817,4,0,0,35,0.0,0.0,1.0,35,1250,800,450,0.64,17,8,9,380.2520561354232,0.35679271708683474,0.012927091740651653,0.24927634791099954,135506.05536332174,3305.291234140711,138811.34659746246,3688,9,1084.7428571428572,33,2,20,29.8081450094162,0.6818181818181819,39.705882352941174,1041.1764705882347,31.550802139037415,0
3818,4,0,0,35,0.0,0.0,1.0,35,1000,700,300,0.7,13,7,6,376.5194791856599,0.3571778711484594,0.013103173641290766,0.24793792679655866,135666.56344059284,3216.280834960889,138882.84427555374,3689,10,1085.7428571428572,32,3,21,29.745384397850785,0.6858723958333333,39.55176767676768,1041.7929292929296,32.55602904040405,0
3819,4,0,1,34,0.0,0.02857142857142857,0.9714285714285714,35,1050,700,350,0.6666666666666666,14,7,7,374.49986434461596,0.35654761904761906,0.01492609643809062,0.24728975042403686,135765.2360090808,3168.812493623113,138934.04850270392,3690,11,1086.7428571428572,32,3,21,29.69974153945561,0.6868489583333333,39.45707070707071,1042.171717171718,32.56786616161619,0
3820,4,0,0,34,0.0,0.0,1.0,34,600,400,200,0.6666666666666666,8,4,4,381.0288367673139,0.35134432560903145,0.027471073408118718,0.25115261547051465,135701.50587293843,3541.2373860677194,139242.74325900615,3691,12,1116.3529411764705,31,3,21,29.593122552695164,0.6888440860215054,39.51822916666667,1041.927083333334,33.61055107526884,0
3821,4,0,0,34,0.0,0.0,1.0,34,1050,900,150,0.8571428571428571,12,9,3,383.59876108407065,0.3507315805109923,0.03323242861971165,0.25380922985446863,135837.20737033428,3621.3968912760474,139458.60426161034,3692,13,1117.3529411764705,31,3,21,29.390977600133233,0.6901881720430108,39.388020833333336,1042.4479166666672,33.627352150537654,0
3822,4,0,0,34,0.0,0.0,1.0,34,950,700,250,0.7368421052631579,12,7,5,384.340933791483,0.3506573083778966,0.031762355291766964,0.2547849501491885,135905.08355034734,3646.77734375001,139551.86089409734,3693,14,1118.3529411764705,31,3,17,29.304029304029292,0.6908602150537635,39.32291666666667,1042.7083333333342,33.63575268817207,0
3823,4,0,0,34,0.0,0.0,1.0,34,750,500,250,0.6666666666666666,10,5,5,383.419165363052,0.3501931075460487,0.03290783163059219,0.25441624651140704,135939.02799818243,3624.325731065528,139563.35372924796,3694,15,1119.3529411764705,31,3,17,29.294257501976936,0.6911962365591398,39.29036458333333,1042.838541666666,33.63995295698923,0
3824,4,0,0,34,0.0,0.0,1.0,34,750,400,350,0.5333333333333333,11,4,7,382.74754831994983,0.34978461081402257,0.03481632333359452,0.2543746980427277,135995.61149691363,3610.397376543217,139606.00887345686,3695,16,1120.3529411764705,32,2,17,29.25543719485132,0.6891276041666666,39.236111111111114,1043.0555555555559,32.59548611111112,0
3825,4,0,0,34,0.0,0.0,1.0,34,700,500,200,0.7142857142857143,9,5,4,384.1888933619962,0.3500445632798574,0.02759644339401035,0.25580602948027215,136061.46893493025,3654.661035863705,139716.12997079396,3696,17,1121.3529411764705,32,2,18,29.152295372947677,0.6897786458333333,39.17297979797981,1043.308080808082,32.60337752525256,0
3826,4,0,0,34,0.0,0.0,1.0,34,650,400,250,0.6153846153846154,9,4,5,385.9548080988947,0.349691770647653,0.028280269281678372,0.2576980972330746,136160.28498367517,3710.343332313034,139870.6283159882,3697,18,1122.3529411764705,32,2,18,29.007883700298418,0.6907552083333333,39.07828282828283,1043.686868686869,32.61521464646466,0
3827,4,0,0,34,0.0,0.0,1.0,34,800,400,400,0.5,12,4,8,388.27217445085654,0.34902332144979203,0.037093676648410234,0.2602115788256554,136292.09551321313,3783.685657075835,140075.78117028897,3698,19,1123.3529411764705,32,2,19,28.816253526803706,0.6920572916666666,38.952020202020215,1044.1919191919208,32.630997474747524,0
3828,4,0,0,34,0.0,0.0,1.0,34,1200,800,400,0.6666666666666666,16,8,8,391.70878782891396,0.3478349673202614,0.038850022767727976,0.26380008886487544,136464.7085856403,3890.885116301442,140355.59370194175,3699,20,1124.3529411764705,33,1,19,28.554812729689584,0.6912878787878787,38.78676470588236,1044.8529411764719,31.662210338680964,0
3829,4,0,0,34,0.0,0.0,1.0,34,650,300,350,0.46153846153846156,10,3,7,396.1826816376109,0.3482248960190137,0.041991682357079396,0.26754094154292835,136560.75975886683,4020.6016015474825,140581.3613604143,3700,21,1125.3529411764705,33,1,19,28.342395552428957,0.6922348484848484,38.69485294117647,1045.2205882352944,31.673351158645286,0
3830,4,0,0,34,0.0,0.0,1.0,34,900,600,300,0.6666666666666666,12,6,6,396.75239340535114,0.34716651812240046,0.04395907448774139,0.2686580492487666,136656.84472318352,4043.78604382931,140700.63076701283,3701,22,1126.3529411764705,33,1,19,28.23195030473512,0.6931818181818181,38.602941176470594,1045.5882352941187,31.684491978609657,0
3831,4,0,0,34,0.0,0.0,1.0,34,800,700,100,0.875,9,7,2,396.75239340535114,0.34716651812240046,0.04395907448774139,0.2686580492487666,136656.84472318352,4043.78604382931,140700.63076701283,3702,23,1127.3529411764705,33,1,19,28.23195030473512,0.6931818181818181,38.602941176470594,1045.5882352941187,31.684491978609657,0
3832,4,0,0,34,0.0,0.0,1.0,34,1100,800,300,0.7272727272727273,14,8,6,405.4173835322905,0.34716651812240046,0.12620168863376713,0.25395729870524186,133852.39451172622,4053.21751249519,137905.6120242214,3703,24,1128.3529411764705,33,1,17,30.81083214906048,0.6654040404040404,41.299019607843135,1034.8039215686272,31.357694592988704,8
3833,4,0,0,34,0.0,0.0,1.0,34,900,700,200,0.7777777777777778,11,7,4,405.75193219544826,0.3465909090909091,0.12048167597609738,0.2546048157000561,133915.8091238946,4067.319660707415,137983.128784602,3704,25,1129.3529411764705,33,1,17,30.738416607467055,0.6660353535353536,41.23774509803921,1035.0490196078429,31.36512180629827,0
3834,4,1,1,34,0.02857142857142857,0.02857142857142857,0.9714285714285714,35,600,300,300,0.5,9,3,6,395.5193596215289,0.35283613445378154,0.10877694062802656,0.24997857565622109,134180.50063775506,3614.1971371882028,137794.69777494326,3705,0,1098.057142857143,34,1,17,30.737485158374504,0.666360294117647,40.982142857142854,1036.0714285714282,30.472689075630242,0
3835,4,0,0,34,0.0,0.0,1.0,34,1200,800,400,0.6666666666666666,16,8,8,409.929655074297,0.34573677956030896,0.12033983217133559,0.25900936502228006,134169.6177551903,4200.021025567089,138369.63878075738,3706,27,1131.3529411764705,33,1,17,30.375167573535208,0.6685606060606061,40.99264705882353,1036.0294117647059,31.39483065953654,0
3836,4,0,0,34,0.0,0.0,1.0,34,800,500,300,0.625,11,5,6,405.2941300335029,0.3444741532976827,0.12060647829083426,0.25680427191205774,134273.0229591836,4084.0136054421682,138357.03656462577,3707,28,1132.3529411764705,34,0,18,30.391396737881923,0.6672794117647058,40.89285714285714,1036.4285714285709,30.483193277310907,0
3837,4,0,0,34,0.0,0.0,1.0,34,800,500,300,0.625,11,5,6,402.27820225183774,0.34384284016636957,0.12270663892566702,0.2553235120414725,134334.72222222228,4007.9861111111168,138342.7083333334,3708,29,1133.3529411764705,34,0,18,30.407623258306536,0.6678921568627452,40.833333333333336,1036.666666666667,30.49019607843138,0
3838,4,0,0,34,0.0,0.0,1.0,34,600,400,200,0.6666666666666666,8,4,4,400.5941051181618,0.3447898098633393,0.12774585210045464,0.2548995799623307,134427.29768990932,3970.1566043083926,138397.45429421772,3709,30,1134.3529411764705,34,0,18,30.35840699498718,0.6688112745098038,40.74404761904762,1037.0238095238096,30.50070028011205,0
3839,4,0,0,34,0.0,0.0,1.0,34,800,700,100,0.875,9,7,2,398.45701787976725,0.3450497623291741,0.1265350625502124,0.253968982939752,134489.03238378675,3917.6197562358143,138406.65214002258,3710,31,1135.3529411764705,34,0,18,30.351916676230925,0.6694240196078431,40.6845238095238,1037.261904761904,30.507703081232467,0
3840,4,0,0,34,0.0,0.0,1.0,34,450,300,150,0.6666666666666666,6,3,3,396.60650634667167,0.34438131313131315,0.12343491613512847,0.253218000205952,134550.78125000003,3872.771400226758,138423.55265022677,3711,32,1136.3529411764705,32,2,18,30.338018741633192,0.6748046875,40.625,1037.5000000000002,32.42187500000001,0
3841,4,0,0,34,0.0,0.0,1.0,34,850,600,250,0.7058823529411765,11,6,5,396.0862618867829,0.34438131313131315,0.13418960552112447,0.24709387441847977,133700.64478433327,3791.3977208958304,137492.0425052291,3712,33,1137.3529411764705,32,2,16,31.204726732592697,0.6663411458333334,41.44570707070707,1034.2171717171718,32.31928661616162,1
3842,4,0,0,34,0.0,0.0,1.0,34,800,400,400,0.5,12,4,8,392.0666968964926,0.3442142008318479,0.13599370096297259,0.24517237445927328,133788.99491782003,3690.841863706264,137479.8367815263,3713,34,1138.3529411764705,33,1,16,31.21989260048961,0.6647727272727273,41.36029411764706,1034.5588235294115,31.350267379679135,0
3843,4,0,0,34,0.0,0.0,1.0,34,1050,900,150,0.8571428571428571,12,9,3,394.06067959423774,0.34306298276886515,0.14196189839572204,0.24769528431637802,133979.2387543253,3759.1899750096172,137738.42872933493,3714,35,1139.3529411764705,33,1,16,30.977252998737384,0.6666666666666666,41.1764705882353,1035.2941176470592,31.372549019607856,0
3844,4,0,0,34,0.0,0.0,1.0,34,900,700,200,0.7777777777777778,11,7,4,409.0528211094523,0.34306298276886515,0.1671784695163463,0.24039992858545395,131457.57607642084,3964.7708153059084,135422.34689172675,3715,36,1140.3529411764705,32,2,16,33.13659402446031,0.6438802083333333,43.62373737373738,1025.505050505051,32.047032828282845,4
3845,4,0,0,34,0.0,0.0,1.0,34,450,200,250,0.4444444444444444,7,2,5,409.91099406637665,0.3432300950683304,0.16921812428036564,0.24110840005801473,131489.94880943294,3979.8351252423486,135469.7839346753,3716,37,1141.3529411764705,32,2,16,33.08173293939021,0.6442057291666665,43.59217171717173,1025.631313131315,32.05097853535359,0
3846,4,0,0,34,0.0,0.0,1.0,34,1050,800,250,0.7619047619047619,13,8,5,406.3114338939109,0.3426730540701129,0.1659066727466183,0.23980341490601415,131619.47959710748,3895.69989669422,135515.1794938017,3717,38,1142.3529411764705,32,2,14,33.04263565891474,0.6455078125,43.46590909090909,1026.136363636364,32.066761363636374,0
3847,4,1,1,34,0.02857142857142857,0.02857142857142857,0.9714285714285714,35,550,500,50,0.9090909090909091,6,5,1,409.250025186558,0.34940476190476194,0.15660540110145282,0.2400859139582182,131389.14399092997,3786.485155356936,135175.6291462869,3718,0,1110.6857142857143,34,1,15,33.20100828301593,0.6384803921568626,43.690476190476204,1025.2380952380972,30.15406162464992,5
3848,4,0,0,34,0.0,0.0,1.0,34,1300,1100,200,0.8461538461538461,15,11,4,419.39321832242695,0.34310011883541297,0.16977522716403626,0.24564459930313592,131328.12500000012,4215.625000000015,135543.75000000012,3719,40,1144.3529411764705,34,0,15,33.0030487804878,0.6378676470588235,43.75000000000001,1025.000000000001,30.147058823529438,0
3849,4,0,0,34,0.0,0.0,1.0,34,800,500,300,0.625,11,5,6,418.86399705574405,0.3443441770647653,0.1679233170105381,0.24592199090941547,131419.6588010205,4209.392715419514,135629.05151644003,3720,41,1145.3529411764705,34,0,15,32.92358450404428,0.6387867647058822,43.66071428571429,1025.3571428571436,30.157563025210106,0
3850,4,0,0,34,0.0,0.0,1.0,34,850,600,250,0.7058823529411765,11,6,5,419.89827610138184,0.3437314319667261,0.1596209514446445,0.2471204608531085,131511.22448979603,4244.267290249443,135755.49178004547,3721,42,1146.3529411764705,34,0,15,32.80403706282884,0.6397058823529411,43.57142857142858,1025.7142857142865,30.168067226890777,0
3851,4,1,2,33,0.02857142857142857,0.05714285714285714,0.9428571428571428,35,850,600,250,0.7058823529411765,11,6,5,411.95855533990687,0.35157563025210087,0.15651165786422783,0.24431125019890731,131803.0907064472,3859.4821673525403,135662.57287379974,3722,0,1114.5714285714287,35,0,14,32.71152690111212,0.6404761904761904,43.28703703703704,1026.851851851852,29.338624338624342,0
3852,4,0,0,33,0.0,0.0,1.0,33,950,800,150,0.8421052631578947,11,8,3,424.37072360346986,0.3435527146464647,0.15847030129332507,0.2506121607514427,131642.34459102273,4573.031406189931,136215.37599721266,3723,44,1174.0,33,0,14,32.55612610460951,0.6433080808080808,43.443627450980394,1026.2254901960787,31.0977421271539,0
3853,4,0,0,33,0.0,0.0,1.0,33,750,500,250,0.6666666666666666,10,5,5,420.8275976570159,0.34367108585858586,0.15720239645741074,0.24893022302084525,131705.23356401396,4485.039407920047,136190.272971934,3724,45,1175.0,33,0,14,32.5831741483604,0.6439393939393938,43.38235294117648,1026.470588235295,31.105169340463487,0
3854,4,1,0,34,0.029411764705882353,0.0,1.0,34,900,700,200,0.7777777777777778,11,7,4,413.07190426265356,0.3504901960784314,0.16095736418264295,0.24664334864479626,132061.2882653062,4110.161564625863,136171.44982993207,3725,0,1141.4117647058824,34,0,15,32.42124160296503,0.645220588235294,43.03571428571429,1027.8571428571436,30.231092436974812,0
3855,4,1,0,35,0.02857142857142857,0.0,1.0,35,800,500,300,0.625,11,5,6,406.1113709169988,0.3542016806722689,0.16497509392903908,0.24568422244892318,132555.70461180806,3767.3332108578866,136323.03782266594,3726,0,1109.7714285714285,33,2,17,32.10001884247689,0.6524621212121211,42.555147058823536,1029.7794117647068,31.20543672014263,0
3856,4,0,0,35,0.0,0.0,1.0,35,1450,1100,350,0.7586206896551724,18,11,7,402.62749038902723,0.35346638655462187,0.17212833534317307,0.24522084153961685,132808.2216725539,3694.4481990100007,136502.66987156388,3727,1,1110.7714285714285,33,2,15,31.934743193437157,0.6549873737373737,42.310049019607845,1030.759803921569,31.23514557338088,0
3857,4,0,0,35,0.0,0.0,1.0,35,900,700,200,0.7777777777777778,11,7,4,402.4674146889437,0.3542717086834734,0.17625046690889312,0.24574461735796613,132902.97752066515,3697.8235534409855,136600.80107410613,3728,2,1111.7714285714285,33,2,15,31.84325726962997,0.6559343434343434,42.21813725490196,1031.1274509803925,31.246286393345226,0
3858,4,0,0,35,0.0,0.0,1.0,35,1000,800,200,0.8,12,8,4,404.37867758678,0.3542016806722689,0.17999728408473614,0.24732928419842606,132966.16685890054,3753.7365436370765,136719.90340253763,3729,3,1112.7714285714285,33,2,15,31.730236058301646,0.6565656565656566,42.156862745098046,1031.3725490196089,31.253713606654813,0
3859,4,0,0,35,0.0,0.0,1.0,35,950,500,450,0.5263157894736842,14,5,9,405.4819609928246,0.3543417366946779,0.181754612264295,0.24821393932193508,132997.76715986652,3785.6390871299636,136783.40624699648,3730,4,1113.7714285714285,33,2,15,31.669909112510396,0.6568813131313129,42.126225490196084,1031.4950980392166,31.257427213309594,0
3860,4,0,0,35,0.0,0.0,1.0,35,600,300,300,0.5,9,3,6,405.4819609928246,0.3543417366946779,0.181754612264295,0.24821393932193508,132997.76715986652,3785.6390871299636,136783.40624699648,3731,5,1114.7714285714285,33,2,15,31.669909112510396,0.6568813131313129,42.126225490196084,1031.4950980392166,31.257427213309594,0
3861,4,0,0,35,0.0,0.0,1.0,35,850,600,250,0.7058823529411765,11,6,5,403.9224494054639,0.35360644257703083,0.18624187829745353,0.24809853730440673,133124.20590938602,3754.371065215325,136878.57697460134,3732,6,1115.7714285714285,33,2,16,31.582625776827765,0.6581439393939392,42.003676470588246,1031.9852941176487,31.272281639928746,0
3862,4,0,0,35,0.0,0.0,1.0,35,900,600,300,0.6666666666666666,12,6,6,402.97915760374246,0.3536414565826331,0.1843796342066233,0.2477893118031527,133164.85969387784,3732.532596371914,136897.39229024976,3733,7,1116.7714285714285,34,1,17,31.565984236832005,0.6562499999999998,41.96428571428573,1032.1428571428594,30.35714285714292,0
3863,4,0,0,35,0.0,0.0,1.0,35,950,600,350,0.631578947368421,13,6,7,406.4933926553284,0.353046218487395,0.19156562994201365,0.2503629759308958,133226.3038548754,3831.1224489796086,137057.42630385503,3734,8,1117.7714285714285,34,1,17,31.413361008610106,0.6568627450980391,41.90476190476191,1032.3809523809534,30.364145658263336,0
3864,4,1,0,36,0.027777777777777776,0.0,1.0,36,800,500,300,0.625,11,5,6,381.08084723361156,0.35806878306878304,0.15571805695642982,0.23532071971387655,133322.7656276791,2961.350496184834,136284.11612386393,3735,0,1087.6944444444443,35,1,19,31.972267361500236,0.6556547619047619,41.81134259259259,1032.754629629629,29.50727513227512,2
3865,4,1,0,37,0.02702702702702703,0.0,1.0,37,700,500,200,0.7142857142857143,9,5,4,375.0671268976034,0.3630505505505506,0.1551731962568188,0.2334825536290097,133621.7625412593,2623.509837962949,136245.27237922224,3736,0,1059.2702702702702,35,2,20,31.82733031083249,0.6586309523809524,41.52199074074073,1033.912037037036,29.540343915343886,0
3866,4,0,0,37,0.0,0.0,1.0,37,850,600,250,0.7058823529411765,11,6,5,372.63292374942824,0.36255005005005003,0.14793486413898305,0.23253127141235247,133711.52692043877,2565.0634430726845,136276.59036351147,3737,1,1060.2702702702702,35,2,16,31.80020889286781,0.6595238095238096,41.435185185185176,1034.2592592592578,29.550264550264508,0
3867,4,0,1,36,0.0,0.02702702702702703,0.972972972972973,37,950,700,250,0.7368421052631579,12,7,5,375.6391503429868,0.36236236236236236,0.15075404226505928,0.23536017121349975,133861.2011986667,2656.7015764317416,136517.90277509845,3738,2,1061.2702702702702,35,2,16,31.572367930507404,0.6610119047619047,41.29050925925925,1034.837962962962,29.56679894179891,0
3868,4,0,0,36,0.0,0.0,1.0,36,750,600,150,0.8,9,6,3,384.1450978119676,0.3568948412698412,0.15583186225599333,0.239360424648117,133656.80980725627,3068.721655328804,136725.5314625851,3739,4,1091.6944444444443,34,2,20,31.55748714406326,0.6611519607843137,41.48809523809524,1034.0476190476193,30.41316526610645,0
3869,4,0,0,36,0.0,0.0,1.0,36,750,500,250,0.6666666666666666,10,5,5,386.37573808966624,0.3564980158730158,0.16013147125025595,0.24115175377320552,133718.3673469388,3133.1065759637236,136851.4739229025,3740,5,1092.6944444444443,34,2,16,31.437998772252925,0.661764705882353,41.42857142857143,1034.2857142857144,30.420168067226896,0
3870,4,0,0,36,0.0,0.0,1.0,36,550,300,250,0.5454545454545454,8,3,5,388.56614682167117,0.3566633597883598,0.16331031837360976,0.2429237277611743,133779.93905895695,3196.471088435377,136976.41014739234,3741,6,1093.6944444444443,34,2,16,31.31952435749905,0.6623774509803921,41.36904761904762,1034.5238095238096,30.427170868347343,0
3871,4,0,0,36,0.0,0.0,1.0,36,900,500,400,0.5555555555555556,13,5,8,388.6964484250521,0.3570271164021164,0.16494433580019674,0.24361486850461267,133872.32320011337,3207.139314058958,137079.46251417234,3742,7,1094.6944444444443,34,2,16,31.22339813643161,0.663296568627451,41.279761904761905,1034.8809523809525,30.437675070028014,0
3872,4,0,0,36,0.0,0.0,1.0,36,1100,600,500,0.5454545454545454,16,6,10,388.7407866150856,0.35806878306878304,0.16769523663497954,0.24425504916219543,133964.7392290249,3215.5116213151914,137180.2508503401,3743,8,1095.6944444444443,34,2,16,31.12949440355719,0.6642156862745099,41.19047619047619,1035.238095238095,30.448179271708675,0
3873,4,0,0,36,0.0,0.0,1.0,36,950,800,150,0.8421052631578947,11,8,3,387.33287475315433,0.3578869047619047,0.16592886435935772,0.24357440431874056,133995.55165816325,3180.1764455782295,137175.72810374148,3744,9,1096.6944444444443,34,2,16,31.135017822237554,0.6645220588235294,41.160714285714285,1035.3571428571427,30.451680672268903,0
3874,4,0,0,36,0.0,0.0,1.0,36,650,500,150,0.7692307692307693,8,5,3,388.05181283513707,0.3578869047619047,0.1641855385676516,0.24443611295096718,134057.18714569157,3204.2268990929674,137261.41404478453,3745,10,1097.6944444444443,34,2,16,31.05457523853316,0.6651348039215685,41.101190476190474,1035.5952380952378,30.45868347338935,0
3875,4,0,0,36,0.0,0.0,1.0,36,900,700,200,0.7777777777777778,11,7,4,389.3735129906233,0.3569279100529101,0.1604778684234045,0.24609423990975984,134180.50063775506,3249.266581632646,137429.7672193877,3746,11,1098.6944444444443,34,2,16,30.89667356084108,0.666360294117647,40.982142857142854,1036.0714285714282,30.472689075630242,0
3876,4,0,0,36,0.0,0.0,1.0,36,650,400,250,0.6153846153846154,9,4,5,386.22280928378444,0.35667989417989415,0.16434387523291738,0.2447202167121271,134273.0229591836,3171.8608276643895,137444.883786848,3747,12,1099.6944444444443,34,2,17,30.88554828087909,0.6672794117647058,40.89285714285714,1036.4285714285709,30.483193277310907,0
3877,4,0,0,36,0.0,0.0,1.0,36,1100,800,300,0.7272727272727273,14,8,6,388.0021065998401,0.3562334656084656,0.15954604012806284,0.24688724255596828,134427.2976899092,3231.6149376417106,137658.91262755092,3748,13,1100.6944444444443,34,2,19,30.684862051811884,0.6688112745098039,40.74404761904761,1037.0238095238087,30.50070028011202,0
3878,4,1,1,36,0.02702702702702703,0.02702702702702703,0.972972972972973,37,700,700,0,1.0,7,7,0,381.49588011261403,0.36067317317317316,0.1538566430207302,0.24481424359544532,134736.11288265287,2880.3110827664214,137616.4239654193,3749,0,1071.918918918919,34,3,19,30.544566754577076,0.671875,40.44642857142856,1038.2142857142842,30.535714285714242,0
3879,4,0,0,36,0.0,0.0,1.0,36,1300,1000,300,0.7692307692307693,16,10,6,390.38741867184456,0.35557208994708994,0.16290085550831912,0.24968282940431866,134614.36106305264,3310.3505863129535,137924.71164936558,3750,15,1102.6944444444443,33,3,19,30.43565973862384,0.6729797979797979,40.56372549019608,1037.7450980392155,31.4468211527035,0
3880,4,0,0,36,0.0,0.0,1.0,36,1100,800,300,0.7272727272727273,14,8,6,387.0931984379428,0.3547619047619048,0.1548874201712631,0.2486611577228724,134773.3763005814,3233.971459294494,138007.3477598759,3751,16,1103.6944444444443,33,3,20,30.362007750108177,0.6745580808080809,40.41053921568627,1038.3578431372543,31.465389185977404,0
3881,4,0,0,36,0.0,0.0,1.0,36,1150,700,450,0.6086956521739131,16,7,9,389.3529349599238,0.3537533068783069,0.1644845482425099,0.25121264707688234,134932.48540224915,3307.271842560555,138239.7572448097,3752,17,1104.6944444444443,33,3,17,30.144196744515213,0.6761363636363636,40.25735294117647,1038.9705882352941,31.483957219251337,0
3882,4,0,0,36,0.0,0.0,1.0,36,800,700,100,0.875,9,7,2,390.80407905360926,0.353968253968254,0.16711548793751874,0.2523707377224336,134964.3184862793,3348.9212382256833,138313.239724505,3753,18,1105.6944444444443,33,3,17,30.07466977237882,0.6764520202020202,40.22671568627451,1039.093137254902,31.487670825906125,0
3883,4,0,1,35,0.0,0.027777777777777776,0.9722222222222222,36,950,800,150,0.8421052631578947,11,8,3,392.0064578053901,0.3531084656084656,0.16093297706524146,0.254040548629727,135091.68836805565,3391.362847222233,138483.05121527787,3754,19,1106.6944444444443,33,3,17,29.916082164328653,0.6777146464646464,40.10416666666667,1039.5833333333342,31.502525252525277,0
3884,4,0,0,35,0.0,0.0,1.0,35,950,800,150,0.8421052631578947,11,8,3,393.9154871809151,0.3496148459383754,0.17547451334189224,0.25539371035020936,135108.09643148675,3644.2343255790443,138752.3307570658,3755,20,1135.8,32,3,17,29.850062747955636,0.6803385416666665,40.08838383838385,1039.6464646464658,32.488952020202056,0
3885,4,0,0,35,0.0,0.0,1.0,35,1050,600,450,0.5714285714285714,15,6,9,395.5567499776046,0.3498949579831933,0.1787561800676556,0.2566910824322755,135140.9155475207,3691.180268595052,138832.09581611576,3756,21,1136.8,32,3,17,29.77459016393443,0.6806640625,40.05681818181819,1039.7727272727277,32.49289772727274,0
3886,4,0,1,34,0.0,0.02857142857142857,0.9714285714285714,35,1000,700,300,0.7,13,7,6,394.63877538354154,0.3492997198879552,0.17280199771095628,0.25679575289175466,135239.39680899907,3674.1419880624417,138913.5387970615,3757,22,1137.8,32,3,18,29.700018208302986,0.681640625,39.96212121212121,1040.151515151515,32.504734848484844,0
3887,4,0,0,34,0.0,0.0,1.0,34,950,800,150,0.8421052631578947,11,8,3,404.50761143165937,0.3442699049316696,0.1820198387548455,0.2616515198093605,135024.01563856352,4123.648410373285,139147.6640489368,3758,32,1171.6176470588234,31,3,18,29.658920070157855,0.6821236559139785,40.16927083333334,1039.3229166666679,33.52654569892477,0
3888,4,0,0,34,0.0,0.0,1.0,34,800,500,300,0.625,11,5,6,404.45620700318466,0.34298871063576947,0.18596015560532808,0.26210863285011593,135091.68836805562,4127.73437500001,139219.42274305562,3759,33,1172.6176470588234,31,3,18,29.592518370073478,0.6827956989247311,40.10416666666667,1039.583333333334,33.53494623655916,0
3889,4,0,0,34,0.0,0.0,1.0,34,500,300,200,0.6,7,3,4,406.61126919517096,0.34306298276886515,0.1920198582814039,0.2639998045359867,135159.37805175784,4191.465250651042,139350.84330240887,3760,34,1173.6176470588234,31,3,18,29.46875782619584,0.6834677419354839,40.0390625,1039.8437500000002,33.54334677419356,0
3890,4,0,0,34,0.0,0.0,1.0,34,500,300,200,0.6,7,3,4,406.61126919517096,0.34306298276886515,0.1920198582814039,0.2639998045359867,135159.37805175784,4191.465250651042,139350.84330240887,3761,35,1174.6176470588234,31,3,18,29.46875782619584,0.6834677419354839,40.0390625,1039.8437500000002,33.54334677419356,0
3891,4,0,0,34,0.0,0.0,1.0,34,1350,1200,150,0.8888888888888888,15,12,3,404.4785526267008,0.34284016636957815,0.18333038921274225,0.2641007020091988,135362.548828125,4150.249565972222,139512.79839409722,3762,36,1175.6176470588234,31,3,19,29.320987654320994,0.685483870967742,39.84375,1040.625,33.568548387096776,0
3892,4,0,0,34,0.0,0.0,1.0,34,700,400,300,0.5714285714285714,10,4,6,402.29759510025303,0.34224598930481287,0.1818496225110009,0.2631724202317041,135430.3063286676,4096.6573079427135,139526.9636366103,3763,37,1176.6176470588234,31,3,19,29.31000333583522,0.6861559139784946,39.778645833333336,1040.885416666667,33.57694892473119,0
3893,4,0,0,34,0.0,0.0,1.0,34,850,600,250,0.7058823529411765,11,6,5,403.7563542374406,0.342635918003565,0.182454449830451,0.2648760922753745,135531.97436862535,4144.379170735697,139676.35353936104,3764,38,1177.6176470588234,31,3,19,29.17044412488017,0.6871639784946236,39.68098958333334,1041.2760416666679,33.589549731182835,0
3894,4,0,0,34,0.0,0.0,1.0,34,650,500,150,0.7692307692307693,8,5,3,406.61604156571445,0.34362002376708256,0.1888718996721408,0.2680182507915032,135701.50587293843,4235.681830512163,139937.1877034506,3765,39,1178.6176470588234,31,3,19,28.926622511038907,0.6888440860215053,39.51822916666667,1041.927083333334,33.61055107526884,0
3895,4,0,0,34,0.0,0.0,1.0,34,750,600,150,0.8,9,6,3,406.61604156571445,0.34362002376708256,0.1888718996721408,0.2680182507915032,135701.50587293843,4235.681830512163,139937.1877034506,3766,40,1179.6176470588234,31,3,19,28.926622511038907,0.6888440860215053,39.51822916666667,1041.927083333334,33.61055107526884,0
3896,4,0,0,34,0.0,0.0,1.0,34,950,800,150,0.8421052631578947,11,8,3,402.2251474798928,0.3442513368983957,0.18960451313392523,0.2666406441240878,135905.08355034716,4132.888454861106,140037.97200520826,3767,41,1180.6176470588234,31,3,19,28.837828837828837,0.6908602150537635,39.322916666666664,1042.708333333333,33.63575268817203,0
3897,4,0,0,34,0.0,0.0,1.0,34,1050,800,250,0.7619047619047619,13,8,5,400.3754727369753,0.3438985442661913,0.1880561510675165,0.26642925976483783,136040.88677300353,4093.4868706597276,140134.37364366325,3768,42,1181.6176470588234,31,3,19,28.75062406390414,0.6922043010752688,39.192708333333336,1043.229166666667,33.65255376344087,0
3898,4,0,0,34,0.0,0.0,1.0,34,750,500,250,0.6666666666666666,10,5,5,403.98937760455533,0.34386140819964345,0.19677050166537047,0.270382873925987,136244.71876356332,4208.283827039921,140453.00259060322,3769,43,1182.6176470588234,31,3,19,28.45316787228734,0.694220430107527,38.99739583333333,1044.0104166666663,33.677755376344074,0
3899,4,0,0,34,0.0,0.0,1.0,34,750,400,350,0.5333333333333333,11,4,7,403.3230481048719,0.342635918003565,0.1959244430756597,0.2709763393548813,136380.6915283203,4201.095241970486,140581.7867702908,3770,44,1183.6176470588234,31,3,19,28.3350993102302,0.6955645161290323,38.8671875,1044.53125,33.694556451612904,0
3900,4,0,0,34,0.0,0.0,1.0,34,1150,800,350,0.6956521739130435,15,8,7,406.9449345694273,0.34230169340463457,0.19859720613887233,0.2744655499877499,136516.7321099176,4310.958523220496,140827.6906331381,3771,45,1184.6176470588234,31,3,19,28.10501287482349,0.6969086021505376,38.73697916666667,1045.052083333334,33.71135752688174,0
3901,4,0,1,33,0.0,0.029411764705882353,0.9705882352941176,34,1000,800,200,0.8,12,8,4,405.81609438856765,0.34181892453951274,0.1989589209703062,0.27449851911085166,136618.80705091683,4288.422139485672,140907.2291904025,3772,46,1185.6176470588234,31,3,19,28.032885996595677,0.6979166666666667,38.639322916666664,1045.442708333333,33.72395833333332,0
3902,4,0,0,33,0.0,0.0,1.0,33,600,400,200,0.6666666666666666,8,4,4,414.0080073677358,0.3405934343434343,0.19653724179309195,0.28001341576576055,136615.51371545834,4711.983321771285,141327.49703722962,3773,47,1207.090909090909,30,3,19,27.82206222679352,0.7006944444444445,38.64247311827956,1045.4301075268809,34.84767025089603,0
3903,4,0,0,33,0.0,0.0,1.0,33,650,400,250,0.6153846153846154,9,4,5,410.60064366479185,0.339804292929293,0.19718781646802186,0.27826419927805573,136685.78014799397,4624.653861718109,141310.43400971207,3774,48,1208.090909090909,30,3,19,27.841152527849175,0.701388888888889,38.5752688172043,1045.6989247311826,34.85663082437275,0
3904,4,0,0,33,0.0,0.0,1.0,33,1100,700,400,0.6363636363636364,15,7,8,413.4877234145503,0.34011994949494945,0.19833012202954414,0.2816274651603039,136861.52526664932,4718.112101109953,141579.63736775928,3775,49,1209.090909090909,30,3,20,27.59071933204881,0.703125,38.40725806451613,1046.3709677419354,34.87903225806451,0
3905,4,0,0,33,0.0,0.0,1.0,33,750,600,150,0.8,9,6,3,414.96287467925725,0.339883207070707,0.19713311855068416,0.2834851638598293,136967.0265348595,4767.246213435075,141734.27274829458,3776,50,1210.090909090909,30,3,16,27.447140900530734,0.7041666666666666,38.306451612903224,1046.7741935483868,34.89247311827956,0
3906,4,0,0,33,0.0,0.0,1.0,33,700,600,100,0.8571428571428571,8,6,2,416.34073826516493,0.33956755050505055,0.1990719672660377,0.2852867802835443,137072.56845083242,4813.778868944382,141886.3473197768,3777,51,1211.090909090909,30,3,17,27.306079664570245,0.7052083333333334,38.20564516129032,1047.1774193548383,34.90591397849461,0
3907,4,0,0,33,0.0,0.0,1.0,33,550,300,250,0.5454545454545454,8,3,5,415.3011671002532,0.3394491792929293,0.1962619003173416,0.2848615047574977,137107.75812232628,4788.202393340271,141895.96051566655,3778,52,1212.090909090909,30,3,17,27.298297399041743,0.7055555555555555,38.17204301075269,1047.3118279569894,34.91039426523298,0
3908,4,0,0,33,0.0,0.0,1.0,33,650,400,250,0.6153846153846154,9,4,5,419.71395785443286,0.3383838383838384,0.20061033685151708,0.2887617212246517,137213.35423531622,4918.071995317377,142131.4262306336,3779,53,1213.090909090909,30,3,17,27.077720761171683,0.7065972222222223,38.071236559139784,1047.715053763441,34.92383512544803,0
3909,4,0,0,33,0.0,0.0,1.0,33,700,500,200,0.7142857142857143,9,5,4,418.3399105377074,0.33862058080808083,0.19860591750737155,0.28797102310495554,137232.0577833387,4881.929355197479,142113.98713853618,3780,54,1214.090909090909,31,2,17,27.095113085621968,0.7039650537634409,38.053385416666664,1047.786458333333,33.799563172043,0
3910,4,0,0,33,0.0,0.0,1.0,33,800,600,200,0.75,10,6,4,405.37847016256615,0.33862058080808083,0.14989317842418504,0.2624748231999151,135059.84026576325,4350.07028546714,139409.9105512304,3781,55,1215.090909090909,33,0,18,29.600428358091648,0.6773989898989898,40.13480392156863,1039.4607843137262,31.49881164587049,7
3911,4,0,0,33,0.0,0.0,1.0,33,1250,1100,150,0.88,14,11,3,399.865952576171,0.33866003787878785,0.1449318824436634,0.26028084397749557,135250.98519800082,4216.452806612846,139467.43800461368,3782,56,1216.090909090909,33,0,19,29.552505497957906,0.6792929292929293,39.950980392156865,1040.1960784313728,31.521093285799175,0
3912,4,0,0,33,0.0,0.0,1.0,33,1200,1000,200,0.8333333333333334,14,10,4,399.787459217878,0.33885732323232326,0.14531469629185678,0.261617463682331,135442.2652945982,4229.62382256824,139671.88911716646,3783,57,1217.090909090909,33,0,19,29.363374146456323,0.6811868686868687,39.7671568627451,1040.9313725490194,31.54337492572786,0
3913,4,0,0,33,0.0,0.0,1.0,33,650,500,150,0.7692307692307693,8,5,3,397.85601489350086,0.33905460858585856,0.14647593981476525,0.26104884622008306,135537.95602953187,4184.918210544016,139722.87424007588,3784,58,1218.090909090909,33,0,19,29.318068141697065,0.6821338383838385,39.67524509803921,1041.2990196078429,31.554515745692207,0
3914,4,1,0,34,0.029411764705882353,0.0,1.0,34,600,400,200,0.6666666666666666,8,4,4,393.1486664331103,0.34751931075460485,0.14975405969948108,0.2542361376267447,135014.34948979595,3816.1422902494373,138830.49178004538,3785,0,1183.235294117647,34,0,17,29.96372661321115,0.6746323529411764,40.17857142857143,1039.2857142857147,30.567226890756313,1
3915,4,0,0,34,0.0,0.0,1.0,34,850,700,150,0.8235294117647058,10,7,3,392.9142948394173,0.34670231729055256,0.14830508474576298,0.2545198533039906,135076.21882086172,3814.6754535147425,138890.89427437645,3786,1,1184.235294117647,34,0,17,29.907953504351813,0.6752450980392157,40.11904761904762,1039.5238095238096,30.574229691876752,0
3916,4,0,0,34,0.0,0.0,1.0,34,700,500,200,0.7142857142857143,9,5,4,389.751780861195,0.34670231729055256,0.14685677339403846,0.25290431307887645,135138.10232426302,3734.0632086167825,138872.1655328798,3787,2,1185.235294117647,34,0,17,29.9282974582093,0.6758578431372548,40.05952380952381,1039.7619047619046,30.581232492997195,0
3917,4,0,0,34,0.0,0.0,1.0,34,950,700,250,0.7368421052631579,12,7,5,389.09798591912545,0.346182412358883,0.14278405342452838,0.25334859917744545,135261.91184807254,3726.027494331064,138987.9393424036,3788,3,1186.235294117647,34,0,18,29.821612497138922,0.6770833333333333,39.94047619047619,1040.2380952380952,30.595238095238095,0
3918,4,0,0,34,0.0,0.0,1.0,34,600,400,200,0.6666666666666666,8,4,4,391.92224916085854,0.3460338680926916,0.1465203930542469,0.2556268998258137,135323.8378684807,3807.2845804988633,139131.1224489796,3789,4,1187.235294117647,34,0,18,29.686308161708613,0.6776960784313726,39.88095238095238,1040.4761904761904,30.60224089635854,0
3919,4,0,0,34,0.0,0.0,1.0,34,800,400,400,0.5,12,4,8,391.6819919490996,0.34517973856209155,0.14221516602981543,0.2563523456289616,135447.73242630382,3810.487528344666,139258.2199546485,3790,5,1188.235294117647,34,0,19,29.56884720951509,0.678921568627451,39.76190476190476,1040.9523809523807,30.616246498599434,0
3920,4,1,1,34,0.02857142857142857,0.02857142857142857,0.9714285714285714,35,1050,900,150,0.8571428571428571,12,9,3,386.1547428209257,0.35206582633053224,0.13846812967106192,0.25469239191331816,135724.11807966811,3482.102382330234,139206.22046199834,3791,0,1155.2571428571428,35,0,19,29.43706264578474,0.6794642857142857,39.49652777777777,1042.0138888888882,29.771825396825378,0
3921,4,0,0,34,0.0,0.0,1.0,34,800,700,100,0.875,9,7,2,393.5709661823639,0.34519830659536543,0.14742861369030402,0.2587041610164912,135602.68034297033,3873.8555839002033,139476.53592687054,3792,7,1190.235294117647,34,0,19,29.36502266925743,0.6804534313725491,39.61309523809523,1041.5476190476177,30.63375350140052,0
3922,4,0,0,34,0.0,0.0,1.0,34,650,500,150,0.7692307692307693,8,5,3,394.8800000000001,0.34517973856209155,0.14564705882352968,0.25978947368421046,135633.68055555547,3911.805555555546,139545.486111111,3793,8,1191.235294117647,34,0,19,29.300000000000004,0.6807598039215688,39.58333333333333,1041.666666666666,30.637254901960766,0
3923,4,0,0,34,0.0,0.0,1.0,34,1100,800,300,0.7272727272727273,14,8,6,401.62509150132746,0.34542112299465244,0.15041901600123708,0.26491517904379175,135726.70245181394,4102.249858276632,139828.95231009056,3794,9,1192.235294117647,34,0,19,29.031474922883586,0.6816789215686274,39.49404761904761,1042.0238095238085,30.647759103641427,0
3924,4,0,0,34,0.0,0.0,1.0,34,700,500,200,0.7142857142857143,9,5,4,401.8463885965568,0.3442699049316696,0.1534066864155732,0.2659840381662923,135850.78125,4118.229166666667,139969.01041666666,3795,10,1193.235294117647,34,0,19,28.90187849720224,0.6829044117647058,39.375,1042.5,30.66176470588235,0
3925,4,0,0,34,0.0,0.0,1.0,34,350,200,150,0.5714285714285714,5,2,3,402.0601855203985,0.34430704099821746,0.15102113456411237,0.2665893387564853,135912.84190759636,4129.028486394556,140041.87039399092,3796,11,1194.235294117647,34,0,16,28.834389389960798,0.6835171568627451,39.31547619047619,1042.7380952380952,30.668767507002798,0
3926,4,0,0,34,0.0,0.0,1.0,34,700,400,300,0.5714285714285714,10,4,6,400.0776672713246,0.34458556149732616,0.15229653505237706,0.2655060882800609,135943.87755102038,4077.621882086166,140021.49943310654,3797,12,1195.235294117647,34,0,16,28.855117960426178,0.6838235294117647,39.285714285714285,1042.8571428571427,30.67226890756302,0
3927,4,0,0,34,0.0,0.0,1.0,34,1000,700,300,0.7,13,7,6,393.97666608825233,0.34391711229946526,0.15152227024995302,0.2623716946502618,136068.05555555562,3921.5277777777874,139989.5833333334,3798,13,1196.235294117647,34,0,16,28.890441959531415,0.6850490196078431,39.16666666666667,1043.333333333334,30.68627450980394,0
3928,4,0,0,34,0.0,0.0,1.0,34,500,200,300,0.4,8,2,6,397.25071807679575,0.3432115270350564,0.15665472212156617,0.26501520507314996,136130.1658163265,4015.5612244897893,140145.7270408163,3799,14,1197.235294117647,34,0,16,28.743155373032167,0.6856617647058824,39.107142857142854,1043.5714285714282,30.69327731092436,0
3929,4,0,0,34,0.0,0.0,1.0,34,700,300,400,0.42857142857142855,11,3,8,396.97871781594665,0.34298871063576947,0.1575582331472738,0.2652979723940716,136192.29024943302,4013.0881519274294,140205.37840136045,3800,15,1198.235294117647,34,0,16,28.68836488746959,0.6862745098039216,39.047619047619044,1043.8095238095232,30.700280112044798,0
3930,4,0,0,34,0.0,0.0,1.0,34,450,300,150,0.6666666666666666,6,3,3,395.23567618077783,0.3429330065359477,0.15671852045642054,0.2643647326032981,136223.3577806122,3968.0661848072464,140191.42396541944,3801,16,1199.235294117647,34,0,16,28.70291177253202,0.6865808823529411,39.01785714285714,1043.9285714285709,30.703781512605026,0
3931,4,0,0,34,0.0,0.0,1.0,34,650,400,250,0.6153846153846154,9,4,5,393.9531556825472,0.3427473262032086,0.15879536172010722,0.2639696813209794,136285.50347222213,3938.020833333322,140223.52430555545,3802,17,1200.235294117647,34,0,17,28.674514498536844,0.6871936274509804,38.95833333333333,1044.1666666666658,30.710784313725465,0
3932,4,0,0,34,0.0,0.0,1.0,34,1100,800,300,0.7272727272727273,14,8,6,394.86261440495014,0.34311868686868685,0.16439141483562536,0.26504435471879306,136347.66333616772,3967.7189625850224,140315.38229875275,3803,18,1201.235294117647,34,0,17,28.588899654242173,0.6878063725490196,38.89880952380952,1044.4047619047612,30.71778711484592,0
3933,4,0,0,34,0.0,0.0,1.0,34,1200,800,400,0.6666666666666666,16,8,8,398.06369862615304,0.34291443850267384,0.17031744329454668,0.26789931128398137,136440.92970521533,4062.436224489782,140503.36592970512,3804,19,1202.235294117647,34,0,17,28.41247910969309,0.6887254901960784,38.8095238095238,1044.761904761904,30.728291316526587,0
3934,4,0,0,34,0.0,0.0,1.0,34,900,700,200,0.7777777777777778,11,7,4,395.13633956582896,0.3425616458704694,0.1673277808674447,0.26663350692147664,136534.22796201814,3989.9270124716545,140524.1549744898,3805,20,1203.235294117647,34,0,17,28.3961252230702,0.6896446078431373,38.720238095238095,1045.1190476190475,30.73879551820728,0
3935,4,0,0,34,0.0,0.0,1.0,34,850,500,350,0.5882352941176471,12,5,7,399.8169693365319,0.34176322043969104,0.1657090431801136,0.27098705699476044,136689.7959183673,4130.1799886621275,140819.97590702944,3806,21,1204.235294117647,34,0,17,28.119070658773527,0.6911764705882353,38.57142857142857,1045.7142857142853,30.756302521008394,0
3936,4,0,0,34,0.0,0.0,1.0,34,750,600,150,0.8,9,6,3,398.57399939238644,0.3414661319073084,0.1659056520400104,0.2706237371454024,136752.04790249426,4101.16213151927,140853.21003401352,3807,22,1205.235294117647,34,0,18,28.089669170650275,0.6917892156862746,38.51190476190476,1045.9523809523805,30.76330532212884,0
3937,4,0,0,34,0.0,0.0,1.0,34,550,200,350,0.36363636363636365,9,2,7,395.7086348351469,0.34128045157456927,0.1637594045355968,0.2691553779358568,136814.31405895684,4027.721088435367,140842.0351473922,3808,23,1206.235294117647,34,0,18,28.10271582460932,0.6924019607843137,38.45238095238095,1046.1904761904757,30.770308123249286,0
3938,4,1,0,35,0.02857142857142857,0.0,1.0,35,800,500,300,0.625,11,5,6,386.198453517579,0.3454131652661065,0.16119742326638908,0.2647214854111405,137084.29783950615,3588.348765432096,140672.64660493826,3809,0,1172.7428571428572,35,0,18,28.08355437665782,0.6928571428571428,38.19444444444444,1047.2222222222222,29.92063492063492,0
3939,4,0,0,35,0.0,0.0,1.0,35,750,400,350,0.5333333333333333,11,4,7,384.12128168392815,0.3454131652661065,0.1590808661069376,0.26421472962028236,137205.53090706444,3540.712877229078,140746.24378429353,3810,1,1173.7428571428572,35,0,18,28.017749300338778,0.694047619047619,38.0787037037037,1047.685185185185,29.93386243386243,0
3940,4,0,0,35,0.0,0.0,1.0,35,900,700,200,0.7777777777777778,11,7,4,384.84188136734815,0.34597338935574234,0.16107280902421728,0.26540314057740566,137296.4908720207,3567.487970464671,140863.97884248535,3811,2,1174.7428571428572,35,0,18,27.9087290631327,0.6949404761904763,37.991898148148145,1048.032407407407,29.943783068783056,0
3941,4,0,0,35,0.0,0.0,1.0,35,500,400,100,0.8,6,4,2,387.17250721142153,0.34590336134453786,0.1669426962570384,0.26747684193850846,137357.14759355714,3636.18224344136,140993.32983699848,3812,3,1175.7428571428572,35,0,18,27.78755382577012,0.6955357142857143,37.93402777777778,1048.2638888888891,29.950396825396833,0
3942,4,0,0,35,0.0,0.0,1.0,35,850,400,450,0.47058823529411764,13,4,9,391.6758862352859,0.34537815126050425,0.17235582609244182,0.2710612569446488,137417.81771101247,3764.649107295948,141182.46681830843,3813,4,1176.7428571428572,35,0,18,27.609398572322178,0.6961309523809524,37.876157407407405,1048.49537037037,29.95701058201057,0
3943,4,0,0,35,0.0,0.0,1.0,35,550,300,250,0.5454545454545454,8,3,5,391.8600061400817,0.3451680672268908,0.16938505203405896,0.27142596755574466,137448.15779320983,3772.087191358023,141220.24498456786,3814,5,1177.7428571428572,35,0,18,27.574503311258283,0.6964285714285714,37.84722222222222,1048.6111111111109,29.96031746031745,0
3944,4,0,0,35,0.0,0.0,1.0,35,450,300,150,0.6666666666666666,6,3,3,394.09475741332375,0.34443277310924375,0.17593088879780572,0.2734522734823536,137508.84800454383,3838.3032193072604,141347.1512238511,3815,6,1178.7428571428572,35,0,18,27.455767674538357,0.6970238095238095,37.78935185185185,1048.8425925925922,29.966931216931204,0
3945,4,0,0,35,0.0,0.0,1.0,35,950,700,250,0.7368421052631579,12,7,5,391.3178280693604,0.3432072829131652,0.1762876364839534,0.2727193502770857,137660.63214002465,3773.811915937909,141434.44405596255,3816,7,1179.7428571428572,35,0,18,27.378244366015956,0.6985119047619048,37.64467592592592,1049.4212962962947,29.983465608465565,0
3946,4,0,0,35,0.0,0.0,1.0,35,600,400,200,0.6666666666666666,8,4,4,392.16267738494895,0.3424019607843137,0.17829025093332063,0.2737893241881525,137721.36923707553,3801.8361786265314,141523.20541570208,3817,8,1180.7428571428572,35,0,19,27.2959394641085,0.6991071428571429,37.58680555555555,1049.6527777777771,29.990079365079346,0
3947,4,0,0,35,0.0,0.0,1.0,35,700,400,300,0.5714285714285714,10,4,6,368.82357279091104,0.3424019607843137,0.15732706599758672,0.24183213271334067,135513.14407578864,2996.0883916323623,138509.232467421,3818,9,1181.7428571428572,35,0,16,30.098562323995843,0.6773809523809524,39.69907407407407,1041.2037037037028,29.74867724867722,5
3948,4,0,0,35,0.0,0.0,1.0,35,450,400,50,0.8888888888888888,5,4,1,366.61912071053916,0.3428571428571428,0.15544584318892607,0.24099382522090146,135603.5414121441,2942.9702235510836,138546.5116356952,3819,10,1182.7428571428572,35,0,17,30.065956402563245,0.6782738095238096,39.61226851851851,1041.5509259259252,29.75859788359786,0
3949,4,0,0,35,0.0,0.0,1.0,35,500,200,300,0.4,8,2,6,368.41133614244603,0.34299719887955177,0.15472566540225752,0.2425801343539248,135663.8230479465,2996.018063057251,138659.84111100374,3820,11,1183.7428571428572,35,0,17,29.95928693108172,0.6788690476190478,39.55439814814814,1041.782407407406,29.7652116402116,0
3950,4,0,0,35,0.0,0.0,1.0,35,700,400,300,0.5714285714285714,10,4,6,369.04999154461115,0.34247198879551816,0.15258399162463165,0.24402821026804442,135814.58574459862,3024.4743441357878,138839.0600887344,3821,12,1184.7428571428572,35,0,18,29.79263824117256,0.6803571428571429,39.409722222222214,1042.36111111111,29.781746031746,0
3951,4,0,0,35,0.0,0.0,1.0,35,950,800,150,0.8421052631578947,11,8,3,367.8539242974807,0.342156862745098,0.15367489653203914,0.24385548226607812,135905.0835503471,2998.6436631944257,138903.72721354154,3822,13,1185.7428571428572,35,0,14,29.733807858807843,0.6812500000000001,39.32291666666666,1042.7083333333323,29.79166666666664,0
3952,4,0,0,35,0.0,0.0,1.0,35,800,400,400,0.5,12,4,8,367.8539242974807,0.342156862745098,0.15367489653203914,0.24385548226607812,135905.0835503471,2998.6436631944257,138903.72721354154,3823,14,1186.7428571428572,35,0,14,29.733807858807843,0.6812500000000001,39.32291666666666,1042.7083333333323,29.79166666666664,0
3953,4,0,0,35,0.0,0.0,1.0,35,500,400,100,0.8,6,4,2,368.8207267751925,0.34219187675070023,0.15204274141129104,0.2449110957237476,135965.4321657448,3029.3739015346105,138994.80606727942,3824,15,1187.7428571428572,35,0,14,29.64860078422667,0.6818452380952382,39.26504629629628,1042.9398148148132,29.798280423280378,0
3954,4,0,0,35,0.0,0.0,1.0,35,1100,800,300,0.7272727272727273,14,8,6,363.9000447985993,0.3416666666666666,0.14922043351502157,0.2426718050224977,136116.36231138528,2906.550068587083,139022.91237997237,3825,16,1188.7428571428572,35,0,14,29.626959479443936,0.6833333333333333,39.12037037037036,1043.518518518517,29.814814814814774,0
3955,4,0,0,35,0.0,0.0,1.0,35,1100,800,300,0.7272727272727273,14,8,6,343.70380994498015,0.34093137254901956,0.10630168234958637,0.2295941450432469,136176.75781250015,2360.8940972222385,138537.6519097224,3826,17,1189.7428571428572,35,0,18,30.09397870924817,0.6839285714285713,39.06250000000001,1043.7500000000011,29.821428571428605,6
3956,4,0,0,35,0.0,0.0,1.0,35,900,600,300,0.6666666666666666,12,6,6,342.8371157909007,0.34065126050420164,0.10330181956387485,0.229601605163305,136267.37618152017,2343.5028452932224,138610.8790268134,3827,18,1190.7428571428572,35,0,19,30.026812437645496,0.6848214285714285,38.97569444444445,1044.097222222223,29.83134920634923,0
3957,4,0,0,35,0.0,0.0,1.0,35,900,700,200,0.7777777777777778,11,7,4,342.7425685856406,0.34030112044817923,0.10237831332932212,0.22973428334172738,136297.58900248635,2342.997149348424,138640.58615183478,3828,19,1191.7428571428572,35,0,20,29.99935343235054,0.6851190476190476,38.94675925925926,1044.2129629629633,29.834656084656093,0
3958,4,0,0,35,0.0,0.0,1.0,35,1000,700,300,0.7,13,7,6,344.1178134902669,0.3407212885154061,0.10805471124620047,0.23105053191489366,136358.02469135812,2384.6450617284045,138742.66975308652,3829,20,1192.7428571428572,35,0,20,29.903590425531917,0.6857142857142857,38.88888888888889,1044.4444444444453,29.841269841269863,0
3959,4,0,0,35,0.0,0.0,1.0,35,850,600,250,0.7058823529411765,11,6,5,344.996913546499,0.34065126050420164,0.10824668850591124,0.23223617737391858,136448.70334201396,2414.8763020833403,138863.5796440973,3830,21,1193.7428571428572,35,0,20,29.79083582585576,0.6866071428571427,38.802083333333336,1044.7916666666672,29.851190476190492,0
3960,4,0,0,35,0.0,0.0,1.0,35,800,500,300,0.625,11,5,6,345.6476495890615,0.341141456582633,0.062103284308304696,0.23590126001765155,136932.8318571031,2466.102296596371,139398.93415369946,3831,22,1194.7428571428572,35,0,23,29.294873567031587,0.6913690476190476,38.339120370370374,1046.643518518519,29.904100529100543,6
3961,4,0,1,34,0.0,0.02857142857142857,0.9714285714285714,35,1200,1000,200,0.8333333333333334,14,10,4,345.01650686801764,0.3404411764705882,0.05456009345941948,0.23669858761551837,137114.60108292586,2461.360141246541,139575.9612241724,3832,23,1195.7428571428572,35,0,20,29.13178712196559,0.693154761904762,38.165509259259245,1047.337962962961,29.923941798941744,0
3962,4,0,0,34,0.0,0.0,1.0,34,500,400,100,0.8,6,4,2,347.0859118333109,0.3327948603683898,0.07617904499528594,0.2379824447698857,137094.6871456915,2716.726899092957,139811.41404478447,3833,24,1230.5294117647059,34,0,20,29.097277480959406,0.6951593137254903,38.1845238095238,1047.261904761904,30.80182072829129,0
3963,4,0,0,34,0.0,0.0,1.0,34,950,600,350,0.631578947368421,13,6,7,347.41735537190107,0.33195929887106357,0.07767379679144426,0.23884943181818166,137188.20861677988,2732.312925170052,139920.52154194994,3834,25,1231.5294117647059,34,0,20,28.996212121212128,0.6960784313725491,38.09523809523809,1047.6190476190463,30.81232492997195,0
3964,4,0,0,34,0.0,0.0,1.0,34,600,400,200,0.6666666666666666,8,4,4,352.26795694802394,0.33195929887106357,0.05909934879715828,0.23055621373903618,135447.73242630393,2742.779195011348,138190.5116213153,3835,26,1232.5294117647059,34,0,20,30.594550548947836,0.6789215686274509,39.761904761904766,1040.9523809523816,30.61624649859946,3
3965,4,0,0,34,0.0,0.0,1.0,34,850,600,250,0.7058823529411765,11,6,5,352.80092076706376,0.331866458704694,-0.01929046253862632,0.21892348527068803,133503.882596237,2640.5233937937865,136144.4059900308,3836,27,1233.5294117647059,33,1,20,32.52092474010829,0.6619318181818181,41.6360294117647,1033.455882352941,31.316844919786092,6
3966,4,0,0,34,0.0,0.0,1.0,34,1150,900,250,0.782608695652174,14,9,5,352.80092076706376,0.331866458704694,-0.01929046253862632,0.21892348527068803,133503.882596237,2620.0585411860766,136123.94113742307,3837,28,1234.5294117647059,33,1,20,32.52092474010829,0.6619318181818181,41.6360294117647,1033.455882352941,31.316844919786092,0
3967,4,0,0,34,0.0,0.0,1.0,34,500,300,200,0.6,7,3,4,352.0781849696888,0.3324977718360071,-0.018734962864813687,0.21884889389972909,133567.21460796322,2605.220498125713,136172.43510608893,3838,29,1235.5294117647059,33,1,20,32.47616577751432,0.6625631313131313,41.57475490196078,1033.7009803921565,31.32427213309565,0
3968,4,0,0,34,0.0,0.0,1.0,34,850,700,150,0.8235294117647058,10,7,3,354.737056765082,0.3320150029708853,-0.023075636226761898,0.2212583903947175,133693.92368620244,2685.2377991637863,136379.16148536623,3839,30,1236.5294117647059,33,1,21,32.2805575305131,0.6638257575757576,41.45220588235294,1034.1911764705883,31.339126559714796,0
3969,4,0,0,34,0.0,0.0,1.0,34,900,800,100,0.8888888888888888,10,8,2,355.8433521311949,0.33238636363636365,-0.018728614535495236,0.22232966212726976,133757.3007527153,2719.3292543733173,136476.63000708862,3840,31,1237.5294117647059,33,1,17,32.18849958535719,0.6644570707070707,41.39093137254902,1034.4362745098038,31.346553773024358,0
3970,4,0,0,34,0.0,0.0,1.0,34,800,400,400,0.5,12,4,8,355.34144418609463,0.3329805407011289,-0.014777278584613196,0.22278088315898797,133884.09994052764,2714.9138852845003,136599.01382581214,3841,32,1238.5294117647059,33,1,18,32.07457568581014,0.665719696969697,41.268382352941174,1034.926470588235,31.36140819964348,0
3971,4,0,0,34,0.0,0.0,1.0,34,650,300,350,0.46153846153846156,10,3,7,355.00730742604543,0.3318293226381462,-0.00846253994555557,0.22334004024144874,134010.9592013888,2714.9739583333244,136725.9331597221,3842,33,1239.5294117647059,33,1,18,31.95632126089873,0.6669823232323233,41.14583333333333,1035.4166666666658,31.3762626262626,0
3972,4,0,0,34,0.0,0.0,1.0,34,750,500,250,0.6666666666666666,10,5,5,355.1640346901704,0.33142082590612004,-0.005939415870453102,0.2242122169705759,134137.87853529895,2728.190029075357,136866.06856437432,3843,34,1240.5294117647059,33,1,19,31.82536279033085,0.6682449494949495,41.02328431372549,1035.9068627450981,31.39111705288176,0
3973,4,0,0,34,0.0,0.0,1.0,34,1000,800,200,0.8,12,8,4,355.9065162284051,0.33181075460487225,-0.002943263891787895,0.22487546249588475,134169.6177551903,2750.368247789311,136919.9860029796,3844,35,1241.5294117647059,33,1,19,31.774406592540018,0.6685606060606061,40.99264705882353,1036.0294117647059,31.39483065953654,0
3974,4,0,0,34,0.0,0.0,1.0,34,1200,1000,200,0.8333333333333334,14,10,4,355.625974548564,0.33147653000594174,0.004853288833263969,0.22587055140246629,134360.13192041515,2756.3905709342475,137116.5224913494,3845,36,1242.5294117647059,33,1,21,31.591312056737593,0.6704545454545454,40.80882352941176,1036.7647058823525,31.417112299465227,0
3975,4,0,0,34,0.0,0.0,1.0,34,1000,800,200,0.8,12,8,4,358.53615487894126,0.33147653000594174,0.0003018642847272268,0.20462116333846125,130327.04132550243,2565.951255680067,132892.9925811825,3846,37,1243.5294117647059,32,2,22,35.57613041506944,0.6324869791666667,44.72853535353535,1021.085858585858,31.908933080808062,8
3976,4,1,1,34,0.02857142857142857,0.02857142857142857,0.9714285714285714,35,1000,900,100,0.9,11,9,2,348.68678546478327,0.34124649859943973,-0.0030067978288039754,0.20076562119618255,130669.48596993927,2112.544604238734,132782.030574178,3847,0,1208.9714285714285,33,2,15,35.48071736785328,0.6335227272727273,44.39338235294117,1022.4264705882339,30.982620320855574,0
3977,4,0,0,34,0.0,0.0,1.0,34,650,300,350,0.46153846153846156,10,3,7,360.5225318093775,0.33192216280451575,-0.0040075573156992395,0.20712774272511794,130585.01882779821,2615.7683208346143,133200.78714863284,3848,39,1245.5294117647059,32,2,16,35.26379452336834,0.6350911458333333,44.476010101010104,1022.0959595959598,31.940498737373744,0
3978,4,0,0,34,0.0,0.0,1.0,34,700,500,200,0.7142857142857143,9,5,4,362.1598492491218,0.3315508021390374,-0.007181308981539569,0.20841565738238366,130649.55305899904,2663.2044880624435,133312.75754706148,3849,40,1246.5294117647059,32,2,16,35.15653945905893,0.6357421875,44.41287878787879,1022.3484848484845,31.94839015151514,0
3979,4,0,0,34,0.0,0.0,1.0,34,550,400,150,0.7272727272727273,7,4,3,362.1598492491218,0.3315508021390374,-0.007181308981539569,0.20841565738238366,130649.55305899904,2663.2044880624435,133312.75754706148,3850,41,1247.5294117647059,32,2,16,35.15653945905893,0.6357421875,44.41287878787879,1022.3484848484845,31.94839015151514,0
3980,4,0,0,34,0.0,0.0,1.0,34,500,200,300,0.4,8,2,6,362.75790756507575,0.3311794414735591,-0.00627891606080655,0.20910863298003934,130714.10323245089,2683.5149155698523,133397.61814802073,3851,42,1248.5294117647059,32,2,16,35.07583240729308,0.6363932291666666,44.34974747474748,1022.6010101010111,31.956281565656596,0
3981,4,0,0,34,0.0,0.0,1.0,34,800,600,200,0.75,10,6,4,362.543209876543,0.3316065062388592,-0.0042701525054467115,0.20915954415954405,130746.38429752071,2680.242768595044,133426.62706611576,3852,43,1249.5294117647059,32,2,17,35.048611111111114,0.63671875,44.31818181818182,1022.7272727272731,31.960227272727284,0
3982,4,1,0,35,0.02857142857142857,0.0,1.0,35,1200,800,400,0.6666666666666666,16,8,8,357.8340697328355,0.33869047619047615,0.011291866028707798,0.2089031300954266,131202.54229142654,2389.7479334871396,133592.29022491368,3853,0,1214.8,33,2,19,34.70743620414673,0.6388888888888888,43.87254901960785,1024.50980392157,31.04575163398697,0
3983,4,2,3,34,0.05405405405405406,0.08108108108108109,0.9189189189189189,37,600,400,200,0.6666666666666666,8,4,4,338.70807112364804,0.3519144144144144,0.006897849125227173,0.19997695706067448,131633.3616780046,1517.1164789445265,133150.47815694913,3854,0,1150.081081081081,34,3,16,34.762906032482604,0.6409313725490196,43.452380952380956,1026.1904761904768,30.18207282913167,0
3984,4,2,2,34,0.05555555555555555,0.05555555555555555,0.9444444444444444,36,900,700,200,0.7777777777777778,11,7,4,340.2518439334033,0.3506613756613757,0.006600564382079233,0.20137211051734655,131725.0017715421,1763.9349489796123,133488.9367205217,3855,0,1168.9444444444443,34,2,16,34.63097723143531,0.6418504901960783,43.36309523809525,1026.5476190476202,30.19257703081236,0
3985,4,1,1,34,0.02857142857142857,0.02857142857142857,0.9714285714285714,35,1050,800,250,0.7619047619047619,13,8,5,350.3050057060287,0.3477240896358544,0.011652340019102203,0.20721431693458303,131705.23356401385,2227.4005190311423,133932.63408304498,3856,0,1203.3142857142857,33,2,16,34.39290830945559,0.6439393939393939,43.38235294117647,1026.4705882352941,31.10516934046346,0
3986,4,0,0,34,0.0,0.0,1.0,34,850,500,350,0.5882352941176471,12,5,7,359.3167639217158,0.338031045751634,0.01696804737154567,0.211887374719003,131587.09092184465,2656.2895367819615,134243.3804586266,3857,4,1239.7058823529412,32,2,16,34.2809090163262,0.6451822916666667,43.49747474747475,1026.0101010101007,32.06281565656565,0
3987,4,1,1,34,0.02857142857142857,0.02857142857142857,0.9714285714285714,35,550,300,250,0.5454545454545454,8,3,5,351.22914897539454,0.34555322128851546,0.012473360271427092,0.20827664821407132,131799.59518274205,2258.3719302671875,134057.96711300925,3858,0,1205.2571428571428,33,2,16,34.274053188526885,0.6448863636363638,43.29044117647058,1026.8382352941164,31.11631016042777,0
3988,4,1,0,35,0.02857142857142857,0.0,1.0,35,500,300,200,0.6,7,3,4,350.1736816709567,0.3429271708683473,0.01921117642047898,0.2086855949403676,131988.41979346875,2243.774179402143,134232.1939728709,3859,0,1206.2285714285715,33,2,18,34.110887497515414,0.6467803030303031,43.10661764705882,1027.573529411764,31.138591800356483,0
3989,4,0,0,35,0.0,0.0,1.0,35,750,400,350,0.5333333333333333,11,4,7,350.25815370703594,0.34254201680672264,0.02624525313761228,0.20943090887015858,132114.37795859767,2254.8276203863907,134369.20557898405,3860,1,1207.2285714285715,33,2,19,33.981876067866644,0.6480429292929293,42.98406862745098,1028.0637254901962,31.153446226975642,0
3990,4,0,0,35,0.0,0.0,1.0,35,1000,700,300,0.7,13,7,6,351.44801758631615,0.34282212885154056,0.027985836851422974,0.21066798311316876,132208.88600538232,2292.910178777362,134501.79618415967,3861,2,1208.2285714285715,33,2,20,33.856152685096916,0.6489898989898992,42.89215686274508,1028.4313725490179,31.164587046939936,0
3991,4,0,0,35,0.0,0.0,1.0,35,750,600,150,0.8,9,6,3,350.81902649177,0.3427871148459383,0.026719576719577143,0.2104914158950617,132244.89795918346,2278.8052721088243,134523.70323129228,3862,3,1209.2285714285715,34,1,21,33.83608217592595,0.6470588235294118,42.85714285714285,1028.5714285714268,30.252100840336084,0
3992,4,1,1,35,0.027777777777777776,0.027777777777777776,0.9722222222222222,36,1150,800,350,0.6956521739130435,15,8,7,342.95775318803976,0.35097552910052915,0.030674038967877904,0.20762263980613907,132581.847009637,1894.0830498865946,134475.93005952358,3863,0,1176.611111111111,34,2,22,33.69962046776865,0.6504289215686276,42.52976190476189,1029.8809523809507,30.29061624649855,0
3993,4,0,0,35,0.0,0.0,1.0,35,850,700,150,0.8235294117647058,10,7,3,352.4642260791787,0.34317226890756297,0.04171795830924663,0.21305067823865162,132524.1568747596,2342.0048779315516,134866.16175269114,3864,5,1211.2285714285715,33,2,22,33.51285408236134,0.6521464646464648,42.58578431372548,1029.656862745097,31.201723113487787,0
3994,4,0,0,35,0.0,0.0,1.0,35,850,800,50,0.9411764705882353,9,8,1,345.53150217973695,0.34317226890756297,0.017028169698540818,0.19672319675423483,130233.05047850213,1999.924313057261,132232.9747915594,3865,6,1212.2285714285715,35,0,21,36.00334977510678,0.6247023809523811,44.82060185185185,1020.7175925925918,29.163359788359767,7
3995,4,1,1,35,0.027777777777777776,0.027777777777777776,0.9722222222222222,36,1000,800,200,0.8,12,8,4,337.6450865715257,0.34991732804232806,0.011209650765671597,0.19409781195755152,130607.69120049098,1619.8090404593715,132227.50024095035,3866,0,1179.5277777777778,36,0,15,35.82543792001763,0.6264467592592593,44.453828828828826,1022.1846846846843,28.39401901901901,0
3996,4,0,0,35,0.0,0.0,1.0,35,650,400,250,0.6153846153846154,9,4,5,347.60469889335525,0.3426120448179271,0.017243834552398418,0.199263265053931,130498.99798525362,2072.4129801097206,132571.41096536335,3867,8,1214.2285714285715,35,0,16,35.68097719377739,0.6273809523809524,44.560185185185176,1021.759259259258,29.193121693121658,0
3997,4,1,0,36,0.027777777777777776,0.0,1.0,36,850,600,250,0.7058823529411765,11,6,5,342.5156346121403,0.3520337301587302,0.033599339570721254,0.19807476387341139,130838.01442912505,1762.8131087168226,132600.82753784186,3868,0,1181.4722222222222,36,0,17,35.46803338836911,0.6287615740740742,44.2286036036036,1023.0855855855854,28.41904404404404,0
3998,4,0,0,36,0.0,0.0,1.0,36,700,400,300,0.5714285714285714,10,4,6,345.54507387224595,0.35170304232804234,0.029972610444713554,0.20012543570918415,130895.6269402849,1846.0678161269398,132741.69475641183,3869,1,1182.4722222222222,36,0,17,35.33229705440007,0.6293402777777778,44.1722972972973,1023.310810810811,28.425300300300304,0
3999,4,0,0,36,0.0,0.0,1.0,36,950,700,250,0.7368421052631579,12,7,5,345.8535538943367,0.3525958994708995,0.027020007577702287,0.20090445101938753,131010.89000740604,1862.1163815842833,132873.00638899032,3870,2,1183.4722222222222,36,0,18,35.20789792102079,0.6304976851851851,44.05968468468468,1023.7612612612611,28.43781281281281,0
4000,4,1,0,37,0.02702702702702703,0.0,1.0,37,1150,800,350,0.6956521739130435,15,8,7,360.12892142374267,0.3585147647647648,0.07603234085623711,0.19186916169915783,127603.50722343964,1791.1263036685273,129394.63352710816,3871,0,1152.4594594594594,36,1,17,38.31341023926288,0.5960648148148149,47.409909909909906,1010.3603603603602,28.065565565565564,7
4001,4,3,1,39,0.075,0.025,0.975,40,1000,800,200,0.8,12,8,4,342.01223546207024,0.3770299145299145,0.0795899088686376,0.18561074153725615,128344.14439777611,782.4870901306658,129126.63148790678,3872,0,1066.95,36,4,19,38.014003111802616,0.603587962962963,46.677927927927925,1013.288288288288,28.146896896896887,0
4002,4,3,4,38,0.07142857142857142,0.09523809523809523,0.9047619047619048,42,850,500,350,0.5882352941176471,12,5,7,329.7095311822492,0.39190137437088657,0.08598343031560551,0.1809688189348671,128794.39153928337,92.94769066403396,128887.3392299474,3873,0,1017.0714285714286,38,4,16,37.86706662456582,0.6044407894736842,46.23397435897436,1015.0641025641027,26.712213225371123,0
4003,4,1,0,39,0.02564102564102564,0.0,1.0,39,700,400,300,0.5714285714285714,10,4,6,353.05650585241176,0.3715137201979308,0.09456281392317956,0.19163110407550296,128349.69142500426,1262.9387163494494,129612.63014135371,3874,0,1096.2564102564102,35,4,19,37.72855987055017,0.6056547619047619,46.6724537037037,1013.310185185185,28.951719576719572,0
4004,4,2,1,40,0.04878048780487805,0.024390243902439025,0.975609756097561,41,850,500,350,0.5882352941176471,12,5,7,340.88044446725047,0.38150406504065043,0.11085708265289984,0.18744375984363046,128867.17547706972,585.6600107725266,129452.83548784224,3875,0,1043.7317073170732,37,4,18,37.50944924406046,0.606981981981982,46.162280701754376,1015.3508771929812,27.441915599810304,0
4005,4,2,0,42,0.047619047619047616,0.0,1.0,42,700,400,300,0.5714285714285714,10,4,6,333.56353839072045,0.38534407665505227,0.12449766033581056,0.18484898472846256,129174.23575726844,217.5630296223053,129391.79878689075,3876,0,1019.8333333333334,38,4,20,37.38286039586616,0.60827850877193,45.860042735042725,1016.5598290598277,26.751574448942836,0
4006,4,1,1,42,0.023255813953488372,0.023255813953488372,0.9767441860465116,43,1150,700,450,0.6086956521739131,16,7,9,326.2863165726335,0.3914036544850498,0.11863028749313353,0.1820666177711968,129445.89548405632,-152.71225984369025,129293.18322421264,3877,0,997.0930232558139,38,5,15,37.29199475065617,0.6110197368421053,45.59294871794871,1017.6282051282034,26.779689608636932,0
4007,4,0,0,42,0.0,0.0,1.0,42,950,600,350,0.631578947368421,13,6,7,332.70456329878726,0.38523519163763065,0.12666338224049212,0.18541535392489156,129396.54659366333,210.16430536317924,129606.71089902651,3878,2,1021.8333333333334,37,5,22,37.178822250960955,0.612331081081081,45.64144736842105,1017.4342105263149,27.49822190611662,0
4008,4,0,0,42,0.0,0.0,1.0,42,850,500,350,0.5882352941176471,12,5,7,334.87896808517473,0.3848722415795587,0.12652672832571543,0.18715722219955888,129508.13140822166,273.90988092488465,129782.04128914654,3879,3,1022.8333333333334,37,5,15,37.010193364214146,0.6134572072072072,45.53179824561403,1017.872807017543,27.510075865339,0
4009,4,1,2,41,0.023255813953488372,0.046511627906976744,0.9534883720930233,43,950,700,250,0.7368421052631579,12,7,5,329.5424983927934,0.3898578811369509,0.12746439204956972,0.1854186906886175,129772.26382725165,-46.90479125576584,129725.35903599588,3880,0,1000.0232558139535,38,5,16,36.87808010904898,0.6143092105263158,45.27243589743589,1018.9102564102551,26.81342780026987,0
4010,4,2,0,43,0.046511627906976744,0.0,1.0,43,1050,700,350,0.6666666666666666,14,7,7,330.30904115347136,0.3916112956810631,0.1415812784119974,0.18701839305166287,130017.30974687697,-10.821416831041375,130006.48833004593,3881,0,1000.8837209302326,38,5,19,36.61022941546199,0.6167763157894738,45.03205128205128,1019.8717948717941,26.838731443994583,0
4011,4,1,0,44,0.022727272727272728,0.0,1.0,44,1100,600,500,0.5454545454545454,16,6,10,322.8442029467883,0.394357822410148,0.1341257430407281,0.1844911201338642,130377.57087746535,-380.9779924254933,129996.59288503985,3882,0,979.1136363636364,36,8,20,36.43616532510016,0.6241319444444444,44.679054054054056,1021.2837837837842,28.368993993994007,0
4012,4,1,1,44,0.022222222222222223,0.022222222222222223,0.9777777777777777,45,1250,800,450,0.64,17,8,9,316.50328042053326,0.3989688552188552,0.10642249496720568,0.1775531517375516,129655.65653344682,-726.9704593244547,128928.68607412236,3883,0,958.3333333333334,41,4,14,37.328316773816475,0.6082317073170731,45.386904761904766,1018.4523809523818,24.840301974448337,8
4013,4,0,0,44,0.0,0.0,1.0,44,800,600,200,0.75,10,6,4,322.6747710142227,0.39353197674418605,0.10963487555462814,0.18070869372786458,129589.12854658274,-436.9715240597507,129152.15702252298,3884,1,981.0681818181819,40,4,15,37.23862161892406,0.6091145833333333,45.452235772357724,1018.1910569105692,25.45477642276423,0
4014,4,0,0,44,0.0,0.0,1.0,44,1200,600,600,0.5,18,6,12,324.5912631019493,0.39354298801973225,0.11939130908002449,0.18226208571825414,129692.62390318252,-380.5814784519929,129312.04242473053,3885,2,982.0681818181819,40,4,16,37.08491303335662,0.6101562500000001,45.350609756097555,1018.5975609756089,25.464939024390222,0
4015,4,0,0,44,0.0,0.0,1.0,44,1500,1300,200,0.8666666666666667,17,13,4,324.4337513209722,0.39347692036645526,0.12182416625863701,0.1825349489755367,129770.27253123125,-379.62873454955627,129390.6437966817,3886,3,983.0681818181819,40,4,16,37.01023173083316,0.6109375000000001,45.27439024390243,1018.902439024389,25.472560975609724,0
4016,4,0,0,44,0.0,0.0,1.0,44,1600,1300,300,0.8125,19,13,6,321.2688967104826,0.3934218639887244,0.11475979017576754,0.1815107449969008,129933.65698420547,-451.27147502521916,129482.38550918025,3887,4,984.0681818181819,41,3,18,36.92539570562096,0.6110264227642277,45.11408730158729,1019.5436507936488,24.866918312040216,0
4017,4,0,0,44,0.0,0.0,1.0,44,1350,900,450,0.6666666666666666,18,9,9,327.09758758511526,0.39377422480620156,0.09297645263571486,0.1750561537861382,127784.6470871339,-416.8236125902729,127367.82347454362,3888,5,985.0681818181819,40,4,16,38.96266793982647,0.5908854166666667,47.230691056910565,1011.077235772357,25.276930894308926,5
4018,4,0,0,44,0.0,0.0,1.0,44,700,400,300,0.5714285714285714,10,4,6,330.73490214618596,0.3937522022551092,0.09326790460619483,0.17745576717309894,127887.419494431,-340.6333655562388,127546.78612887477,3889,6,986.0681818181819,40,4,17,38.76574064771091,0.5919270833333334,47.129065040650396,1011.4837398373966,25.287093495934915,0
4019,4,1,2,43,0.022222222222222223,0.044444444444444446,0.9555555555555556,45,750,600,150,0.8,9,6,3,314.5658522238227,0.39865319865319865,0.04625770472556545,0.17147613736425,128521.48216057237,-914.047890838634,127607.43426973374,3890,0,965.1333333333333,41,4,13,38.528825457391655,0.596798780487805,46.50297619047618,1013.9880952380937,24.731416957026674,2
4020,4,1,1,43,0.022727272727272728,0.022727272727272728,0.9772727272727273,44,700,400,300,0.5714285714285714,10,4,6,330.925088928851,0.3963178294573643,0.07893646471729188,0.18102055686447774,128659.52934967614,-284.66676168285994,128374.86258799328,3891,0,987.6818181818181,40,4,14,37.97351330595345,0.5997395833333332,46.36686991869919,1014.5325203252034,25.363313008130085,0
4021,4,0,0,43,0.0,0.0,1.0,43,1150,700,450,0.6086956521739131,16,7,9,335.8399861093602,0.39320321151716503,0.07106911779808978,0.18340291333409103,128593.1654188369,37.345377604175724,128630.51079644107,3892,1,1011.3023255813954,39,4,15,37.91647410222176,0.6006944444444444,46.43229166666667,1014.2708333333342,26.006944444444464,0
4022,4,3,2,44,0.06521739130434782,0.043478260869565216,0.9565217391304348,46,800,400,400,0.5,12,4,8,315.6056594923393,0.4048510466988728,0.07103344122650301,0.17512952918987498,129226.60506621649,-1041.6354124838424,128184.96965373265,3893,0,946.2826086956521,41,5,17,37.78610514846978,0.6039126016260161,45.808531746031754,1016.7658730158745,24.799167634533525,0
4023,4,2,1,45,0.043478260869565216,0.021739130434782608,0.9782608695652174,46,750,500,250,0.6666666666666666,10,5,5,319.89265140028374,0.40466988727858294,0.08803330394085296,0.17830538221528852,129403.1872008062,-920.9742693373692,128482.21293146884,3894,0,947.2391304347826,41,5,18,37.497968668746765,0.6056910569105691,45.63492063492063,1017.4603174603171,24.816105303910174,0
4024,4,1,1,45,0.021739130434782608,0.021739130434782608,0.9782608695652174,46,1400,1000,400,0.7142857142857143,18,10,8,320.91241749598163,0.4052234299516908,0.09221967963386724,0.17933340977716622,129504.14540816325,-888.1023242630413,128616.04308390021,3895,0,948.2173913043479,41,5,14,37.36963937621832,0.6067073170731707,45.535714285714285,1017.8571428571428,24.825783972125432,0
4025,4,0,0,45,0.0,0.0,1.0,45,1000,300,700,0.3,17,3,14,324.9786328993778,0.40189393939393936,0.0935973817052198,0.18152041318947393,129485.67450137141,-583.9845040981028,128901.68999727331,3896,2,970.2888888888889,40,5,14,37.28490597437176,0.6080729166666667,45.55386178861788,1017.7845528455275,25.444613821138187,0
4026,4,2,3,44,0.0425531914893617,0.06382978723404255,0.9361702127659575,47,1200,700,500,0.5833333333333334,17,7,10,319.46671730445604,0.40889993832870797,0.11422858757307752,0.18078492268269494,129996.88042534713,-1094.0646701388978,128902.81575520823,3897,0,929.9574468085107,43,4,16,36.90734593122234,0.6087693798449614,45.05208333333333,1019.7916666666658,23.71608527131781,0
4027,4,1,1,44,0.022222222222222223,0.022222222222222223,0.9777777777777777,45,1250,700,550,0.56,18,7,11,330.7948923271109,0.4074705387205387,0.1184781433175437,0.18653055564043552,129857.80915375397,-408.74000062989705,129449.06915312407,3898,0,970.2222222222222,41,4,17,36.75945753033545,0.6102642276422765,45.188492063492056,1019.2460317460308,24.8596593108788,0
4028,4,0,0,44,0.0,0.0,1.0,44,1450,1100,350,0.7586206896551724,18,11,7,339.41219980611044,0.40183447850599013,0.10847756511963147,0.19108849676899883,129796.16057117128,10.880077169675758,129807.04064834095,3899,2,993.2727272727273,40,4,17,36.602423456667005,0.6111979166666668,45.2489837398374,1019.0040650406505,25.47510162601626,0
4029,4,1,0,45,0.022222222222222223,0.0,1.0,45,900,600,300,0.6666666666666666,12,6,6,333.9237309651833,0.40597643097643094,0.1140775930324629,0.18905579711718948,130015.40927716176,-316.95389024097153,129698.45538692079,3900,0,972.1777777777778,42,3,18,36.51999208234364,0.6103670634920635,45.03391472868217,1019.8643410852708,24.282484311554065,0
4030,4,2,1,46,0.0425531914893617,0.02127659574468085,0.9787234042553191,47,700,400,300,0.5714285714285714,10,4,6,326.4145687073984,0.4115016959605304,0.12968631989151214,0.18747865890864107,130574.0023816015,-874.8097196653449,129699.19266193616,3901,0,931.7659574468086,40,7,14,36.14646514865268,0.6190104166666668,44.48678861788618,1022.0528455284549,25.55132113821137,0
4031,4,1,0,47,0.02127659574468085,0.0,1.0,47,950,600,350,0.631578947368421,13,6,7,349.0075760721599,0.4113282454517422,0.195399172782319,0.19603360634173775,129704.91672092023,-318.9256266550276,129385.9910942652,3902,0,932.7446808510638,39,8,17,36.45066383747487,0.6119123931623931,45.33854166666667,1018.645833333334,26.11912393162395,5
4032,4,1,1,47,0.020833333333333332,0.020833333333333332,0.9791666666666666,48,1150,900,250,0.782608695652174,14,9,5,345.9086405704886,0.41425642730496454,0.21206743382816873,0.19604093875810277,130055.18297846874,-602.5576913543277,129452.62528711441,3903,0,914.2916666666666,40,8,18,36.17407259805387,0.6138020833333333,44.994918699187004,1020.020325203254,25.50050813008135,0
4033,4,2,2,47,0.04081632653061224,0.04081632653061224,0.9591836734693877,49,1250,900,350,0.72,16,9,7,337.491607409777,0.416312358276644,0.22459651084863963,0.19323920658995755,130453.51765103391,-994.1107904738705,129459.40686056003,3904,0,895.9387755102041,38,11,19,35.98532385135605,0.6211622807017543,44.604700854700866,1021.5811965811985,26.883715699505224,0
4034,4,0,0,47,0.0,0.0,1.0,47,1250,1000,250,0.8,15,10,5,347.4355930421479,0.41181005242059826,0.22498234185695565,0.19825037898761239,130320.07250071043,-344.4336650839756,129975.63883562647,3905,1,934.4468085106383,36,11,19,35.86655821477151,0.6235532407407407,44.735360360360374,1021.0585585585607,28.362737737737795,0
4035,4,0,0,47,0.0,0.0,1.0,47,1500,1200,300,0.8,18,12,6,348.05163581722576,0.4115595127967931,0.23042025672586663,0.1997829598381608,130550.14209733382,-312.36189737033817,130237.78019996348,3906,2,935.4468085106383,36,11,16,35.617768595041326,0.6258680555555556,44.51013513513514,1021.9594594594595,28.387762762762762,0
4036,4,0,0,47,0.0,0.0,1.0,47,1500,1200,300,0.8,18,12,6,355.0876781721784,0.4104995374653099,0.23388328321013296,0.20519188731018262,130809.21292914543,-110.25205949192312,130698.96086965351,3907,3,936.4468085106383,36,11,16,35.17562931161014,0.6284722222222222,44.25675675675676,1022.9729729729736,28.41591591591593,0
4037,4,0,0,47,0.0,0.0,1.0,47,1300,1000,300,0.7692307692307693,16,10,6,352.83990207568746,0.410827166204132,0.23301466439079466,0.20435029892681777,130895.62694028486,-162.95996165083866,130732.66697863402,3908,4,937.4468085106383,36,11,16,35.14567514031036,0.6293402777777778,44.1722972972973,1023.3108108108106,28.425300300300293,0
4038,4,1,1,47,0.020833333333333332,0.020833333333333332,0.9791666666666666,48,450,200,250,0.4444444444444444,7,2,5,345.25743003470626,0.4140625,0.23129037727094293,0.20089465041084872,131075.36844269387,-549.051030124658,130526.31741256922,3909,0,918.8958333333334,37,11,16,35.158006745904274,0.629222972972973,43.99671052631579,1024.0131578947364,27.676031294452336,0
4039,4,0,0,47,0.0,0.0,1.0,47,1200,600,600,0.5,18,6,12,352.7803676317312,0.4105380820228184,0.23272271157248392,0.20508178404780683,131039.71370018659,-154.35232529827817,130885.3613748883,3910,6,939.4468085106383,36,11,17,35.00146649068778,0.6307870370370371,44.03153153153153,1023.8738738738732,28.440940940940923,0
4040,4,1,1,47,0.020833333333333332,0.020833333333333332,0.9791666666666666,48,1250,800,450,0.64,17,8,9,344.04124529050176,0.4119385342789598,0.23543360433604366,0.20150987224157943,131328.12499999988,-563.2246266536945,130764.90037334619,3911,0,920.8541666666666,36,12,18,34.93394308943089,0.6336805555555556,43.74999999999999,1024.999999999999,28.472222222222197,0
4041,4,0,0,47,0.0,0.0,1.0,47,1150,1000,150,0.8695652173913043,13,10,3,343.95630210844797,0.407531606537157,0.23780247000128507,0.20191632048339253,131414.71021274655,-359.8164465140808,131054.89376623246,3912,1,940.531914893617,36,11,18,34.84875526267618,0.6345486111111112,43.66554054054054,1025.337837837838,28.481606606606608,0
4042,4,0,0,47,0.0,0.0,1.0,47,1200,900,300,0.75,15,9,6,343.78894248860433,0.407531606537157,0.24017697791980885,0.20227581965027186,131501.32395909424,-358.2597800503215,131143.06417904393,3913,2,941.531914893617,36,11,18,34.765682184160426,0.6354166666666667,43.58108108108108,1025.6756756756758,28.490990990990994,0
4043,4,0,0,47,0.0,0.0,1.0,47,1000,600,400,0.6,14,6,8,340.4425240474694,0.4073581560283688,0.23450031529532644,0.2006100513630302,131559.0823086601,-442.3387914941911,131116.7435171659,3914,3,942.531914893617,36,11,17,34.793267471642885,0.6359953703703705,43.52477477477478,1025.9009009009014,28.497247247247262,0
4044,4,0,0,47,0.0,0.0,1.0,47,1250,800,450,0.64,17,8,9,339.23483583737317,0.40612473018809747,0.2302949975031856,0.2011146445491006,131790.24252292822,-458.431742553371,131331.81078037486,3915,4,943.531914893617,36,11,18,34.591376032755726,0.6383101851851853,43.299549549549546,1026.801801801801,28.52227227227225,0
4045,4,0,0,47,0.0,0.0,1.0,47,1200,700,500,0.5833333333333334,17,7,10,342.00561080877316,0.4062596361393771,0.23197810990302914,0.20322040235744773,131876.9799148812,-379.4665865189448,131497.51332836226,3916,5,944.531914893617,36,11,18,34.43290209406863,0.6391782407407407,43.215090090090094,1027.1396396396403,28.531656656656676,0
4046,4,1,0,48,0.020833333333333332,0.0,1.0,48,800,400,400,0.5,12,4,8,339.0969485627256,0.40818003841607564,0.24203366033980234,0.20306840253009187,132172.40521121878,-636.1481417359312,131536.25706948285,3917,0,925.8333333333334,37,11,19,34.210386009810186,0.6402027027027027,42.92763157894736,1028.28947368421,27.79160739687054,0
4047,4,0,0,48,0.0,0.0,1.0,48,1050,600,450,0.5714285714285714,15,6,9,344.88382979374427,0.40776447990543735,0.2538167430459337,0.20730589205347233,132313.381581352,-473.45084545244936,131839.93073589954,3918,1,926.8333333333334,37,11,19,33.91983285374257,0.6416103603603605,42.790570175438596,1028.837719298246,27.80642484589854,0
4048,4,0,1,47,0.0,0.020833333333333332,0.9791666666666666,48,1550,1100,450,0.7096774193548387,20,11,9,348.2693505088341,0.40705341312056736,0.2613551650692221,0.21044074654298295,132510.87474030486,-370.1047437673012,132140.76999653757,3919,2,927.8333333333334,37,11,19,33.63418530351438,0.643581081081081,42.59868421052632,1029.605263157896,27.827169274537727,0
4049,4,1,1,47,0.020833333333333332,0.020833333333333332,0.9791666666666666,48,1500,1200,300,0.8,18,12,6,348.2349079678007,0.40644392730496454,0.25555688548427113,0.21184853721614,132765.01092884364,-353.3177275700046,132411.69320127362,3920,0,927.5625,37,11,19,33.37977001099408,0.6461148648648647,42.351973684210535,1030.592105263159,27.853840682788082,0
4050,4,0,1,46,0.0,0.02127659574468085,0.9787234042553191,47,750,400,350,0.5333333333333333,11,4,7,354.35221012446755,0.4044480419364786,0.25462590319683986,0.21462949098002543,132600.90115453315,-2.5155222790071434,132598.38563225413,3921,4,948.2978723404256,36,11,20,33.38709089583789,0.646412037037037,42.511261261261275,1029.9549549549567,28.60985985985991,0
4051,4,1,0,47,0.02127659574468085,0.0,1.0,47,1150,700,450,0.6086956521739131,16,7,9,355.4675962644675,0.4055465618254703,0.2541292399223769,0.2168091834644374,132861.99787202763,45.62700369290906,132907.62487572053,3922,0,947.8297872340426,36,11,20,33.09598580010925,0.6490162037037036,42.257882882882896,1030.96846846847,28.638013013013058,0
4052,4,0,0,47,0.0,0.0,1.0,47,1350,900,450,0.6666666666666666,18,9,9,357.8515647337671,0.40583564600678385,0.2590642758569415,0.2187720046616716,132949.08717839475,115.20777534292267,133064.29495373767,3923,1,948.8297872340426,36,11,20,32.94705903763557,0.6498842592592593,42.17342342342343,1031.3063063063073,28.647397397397427,0
4053,4,0,0,47,0.0,0.0,1.0,47,1050,600,450,0.5714285714285714,15,6,9,359.15885212694576,0.40508402713536845,0.2634052771159323,0.22025524787062098,133065.2506391527,158.31253550848675,133223.5631746612,3924,2,949.8297872340426,36,11,20,32.79669650003638,0.6510416666666666,42.060810810810814,1031.756756756757,28.65990990990992,0
4054,4,0,0,47,0.0,0.0,1.0,47,1350,900,450,0.6666666666666666,18,9,9,359.667202583293,0.4052189330866482,0.2672271716472996,0.2212556764347962,133181.46482631282,180.20097800503353,133361.66580431786,3925,3,950.8297872340426,36,11,20,32.666921230634955,0.6521990740740742,41.9481981981982,1032.2072072072074,28.67242242242243,0
4055,4,0,0,47,0.0,0.0,1.0,47,1100,400,700,0.36363636363636365,18,4,14,362.72114325489036,0.4051611162503854,0.2719802850957094,0.2236577109955677,133268.65875588436,267.87205279605456,133536.53080868043,3926,4,951.8297872340426,36,11,21,32.50059075871598,0.6530671296296295,41.863738738738746,1032.5450450450458,28.681806806806826,0
4056,4,0,0,47,0.0,0.0,1.0,47,1550,1300,250,0.8387096774193549,18,13,5,362.4350471076669,0.4051611162503854,0.27140882055469473,0.22400635121775775,133355.881219057,266.56901834268103,133622.45023739967,3927,5,952.8297872340426,36,11,21,32.42045537142027,0.6539351851851851,41.77927927927929,1032.8828828828837,28.691191191191212,0
4057,4,0,0,47,0.0,0.0,1.0,47,1700,1600,100,0.9411764705882353,18,16,2,363.7290610344577,0.40429386370644466,0.27223006637778546,0.2256890867554577,133501.3153990139,311.6616193896649,133812.97701840356,3928,6,953.8297872340426,36,11,21,32.24115542479386,0.6553819444444444,41.638513513513516,1033.4459459459463,28.706831831831842,0
4058,4,0,0,47,0.0,0.0,1.0,47,1050,700,350,0.6666666666666666,14,7,7,365.17554976481046,0.40435168054270737,0.27148750753256423,0.22712137851225997,133588.61395178954,356.65910843274696,133945.27306022227,3929,7,954.8297872340426,36,11,21,32.11624001452432,0.65625,41.55405405405405,1033.783783783783,28.716216216216196,0
4059,4,0,0,47,0.0,0.0,1.0,47,1000,700,300,0.7,13,7,6,364.3399304462325,0.4044480419364786,0.27003965173218547,0.22677999331707527,133617.7198101818,336.45414840516173,133954.17395858697,3930,8,955.8297872340426,36,11,21,32.108657372109064,0.6565393518518519,41.5259009009009,1033.8963963963963,28.719344344344343,0
4060,4,0,0,47,0.0,0.0,1.0,47,1400,1200,200,0.8571428571428571,16,12,4,365.0594584103853,0.4045829478877583,0.27413647773691907,0.2284854430432301,133821.54959013063,370.5644834023162,134192.11407353295,3931,9,956.8297872340426,36,11,17,31.885793063416045,0.6585648148148149,41.328828828828826,1034.6846846846843,28.74124124124123,0
4061,4,0,0,47,0.0,0.0,1.0,47,1300,900,400,0.6923076923076923,17,9,8,365.5077608366952,0.4045251310514955,0.27501215474729723,0.2291279892284602,133879.81520371707,386.8222952682251,134266.63749898528,3932,10,957.8297872340426,36,11,17,31.81583242655059,0.6591435185185186,41.272522522522515,1034.9099099099087,28.747497497497463,0
4062,4,0,0,47,0.0,0.0,1.0,47,1400,1000,400,0.7142857142857143,18,10,8,367.59084115776875,0.4039855072463768,0.2733373754391162,0.23116485592370212,133996.38447569186,451.1687363038644,134447.55321199572,3933,11,958.8297872340426,36,11,17,31.64518526575303,0.6603009259259259,41.159909909909906,1035.36036036036,28.760010010009996,0
4063,4,0,0,47,0.0,0.0,1.0,47,1050,800,250,0.7619047619047619,13,8,5,368.9008175538621,0.40404332408263954,0.2764384144817824,0.23235698070036395,134054.68813407992,490.57680991800976,134545.26494399793,3934,12,959.8297872340426,36,11,17,31.55289437436566,0.6608796296296298,41.103603603603595,1035.5855855855846,28.76626626626624,0
4064,4,0,0,47,0.0,0.0,1.0,47,1600,1000,600,0.625,22,10,12,369.52643070113504,0.40371569534381746,0.2773128293384779,0.23312099517071616,134113.0044740687,511.65997078159535,134624.6644448503,3935,13,960.8297872340426,36,11,17,31.478310502283108,0.6614583333333334,41.0472972972973,1035.810810810811,28.77252252252253,0
4065,4,0,0,47,0.0,0.0,1.0,47,1500,1100,400,0.7333333333333333,19,11,8,367.4856793007466,0.40344588344125815,0.27708366574401055,0.23238733575575043,134200.5027620525,463.3525840029104,134663.8553460554,3936,14,961.8297872340426,36,11,17,31.44359308770785,0.662326388888889,40.96283783783783,1036.1486486486478,28.781906906906883,0
4066,4,0,0,47,0.0,0.0,1.0,47,1400,800,600,0.5714285714285714,20,8,12,367.1414740568412,0.4036578785075547,0.27772821610328124,0.23309685587360573,134346.3966500285,464.82682006331294,134811.22347009182,3937,15,962.8297872340426,36,11,18,31.30657542182634,0.6637731481481481,40.822072072072075,1036.7117117117123,28.797547547547563,0
4067,4,0,1,46,0.0,0.02127659574468085,0.9787234042553191,47,1200,900,300,0.75,15,9,6,366.5048099784731,0.4033880666049954,0.2735667928922447,0.233251057020854,134433.9710276154,454.13940122554106,134888.11042884094,3938,16,963.8297872340426,36,11,18,31.235521410214645,0.6646412037037037,40.73761261261261,1037.049549549549,28.806931931931917,0
4068,4,0,0,46,0.0,0.0,1.0,46,1600,1200,400,0.75,20,12,8,372.75386076852294,0.40070450885668274,0.27946398217051294,0.23703850483125402,134404.7763980196,819.9798616183712,135224.75625963797,3939,17,985.3260869565217,36,10,18,31.102709600347513,0.6643518518518519,40.765765765765764,1036.9369369369367,28.8038038038038,0
4069,4,0,0,46,0.0,0.0,1.0,46,1250,900,350,0.72,16,9,7,372.38273483174794,0.3998792270531401,0.2744001737053525,0.23737144432769758,134492.36979800742,816.527295876954,135308.89709388438,3940,18,986.3260869565217,36,10,19,31.024725871240918,0.6652199074074074,40.681306306306304,1037.2747747747744,28.813188188188178,0
4070,4,0,0,46,0.0,0.0,1.0,46,1400,1000,400,0.7142857142857143,18,10,8,372.8154659870717,0.4002113526570048,0.2725955808653764,0.23883747596923405,134674.321499433,841.759348461793,135516.08084789477,3941,19,987.3260869565217,34,12,20,30.831612952555712,0.6712622549019609,40.50595238095237,1037.9761904761895,30.528711484593806,0
4071,4,0,0,46,0.0,0.0,1.0,46,850,600,250,0.7058823529411765,11,6,5,375.6975088869244,0.4001107085346216,0.27038432967898607,0.24109330206054938,134736.1128826529,924.0043934240177,135660.11727607693,3942,20,988.3260869565217,34,12,20,30.695065550586705,0.671875,40.44642857142856,1038.2142857142844,30.53571428571425,0
4072,4,0,0,46,0.0,0.0,1.0,46,1450,1200,250,0.8275862068965517,17,12,5,371.3856701485542,0.39991948470209343,0.26882934440835515,0.23902931163852856,134843.0287339704,815.7537182452666,135658.78245221567,3943,21,989.3260869565217,36,10,18,30.70019697133977,0.6686921296296295,40.343468468468465,1038.6261261261257,28.850725725725713,0
4073,4,0,0,46,0.0,0.0,1.0,46,700,400,300,0.5714285714285714,10,4,6,374.84209813042617,0.3998993558776167,0.27040443688419136,0.24203415251570623,134960.0164987623,917.739149622598,135877.7556483849,3944,22,990.3260869565217,36,10,18,30.493614753802245,0.669849537037037,40.23085585585586,1039.0765765765768,28.863238238238246,0
4074,4,0,0,46,0.0,0.0,1.0,46,1650,1300,350,0.7878787878787878,20,13,7,374.2938691003891,0.4000402576489533,0.2681442021920468,0.2424636284677678,135077.05498995614,911.7027077753411,135988.7576977315,3945,23,991.3260869565217,36,10,18,30.391028418733978,0.6710069444444444,40.11824324324324,1039.5270270270269,28.875750750750747,0
4075,4,0,0,46,0.0,0.0,1.0,46,1200,700,500,0.5833333333333334,17,7,10,375.53011087207676,0.39991948470209343,0.2664085120406767,0.24405493130919262,135194.14420755208,953.894392703507,136148.0386002556,3946,24,992.3260869565217,36,10,18,30.242059195091137,0.6721643518518519,40.00563063063063,1039.977477477477,28.888263263263248,0
4076,4,0,0,46,0.0,0.0,1.0,46,1350,1000,350,0.7407407407407407,17,10,7,374.05551540297597,0.39945652173913043,0.2671120062871475,0.2438884196759418,135311.2841515502,922.7864266293336,136234.07057817956,3947,25,993.3260869565217,36,10,18,30.163572897499733,0.6733217592592593,39.89301801801802,1040.427927927928,28.90077577577578,0
4077,4,0,0,46,0.0,0.0,1.0,46,1600,1200,400,0.75,20,12,8,374.578872403183,0.399104267310789,0.2686866216394179,0.2452271314798176,135457.78041555072,947.9245292589949,136405.70494480972,3948,26,994.3260869565217,36,10,18,30.003921462570307,0.6747685185185186,39.752252252252255,1040.9909909909913,28.916416416416425,0
4078,4,0,0,46,0.0,0.0,1.0,46,1750,1500,250,0.8571428571428571,20,15,5,382.3173015414944,0.3977958937198068,0.28165249264737824,0.25216136745626916,135724.1180796682,1178.049850068257,136902.16792973646,3949,27,995.3260869565217,35,11,18,29.53702932355883,0.6794642857142856,39.49652777777778,1042.013888888889,29.7718253968254,0
4079,4,0,0,46,0.0,0.0,1.0,46,950,700,250,0.7368421052631579,12,7,5,386.69622086205504,0.3977355072463768,0.28912391955870187,0.25634630270391845,135905.0835503471,1310.796440972203,137215.8799913193,3950,28,996.3260869565217,35,11,16,29.24263236763235,0.6812500000000001,39.32291666666666,1042.7083333333323,29.79166666666664,0
4080,4,0,0,46,0.0,0.0,1.0,46,1700,1400,300,0.8235294117647058,20,14,6,390.8326403676592,0.3972020933977456,0.29824002778903513,0.2597480645275325,135995.6114969134,1430.3047839505948,137425.91628086398,3951,29,997.3260869565217,35,11,16,29.04460719041278,0.6821428571428572,39.2361111111111,1043.055555555554,29.801587301587258,0
4081,4,0,0,46,0.0,0.0,1.0,46,1500,1000,500,0.6666666666666666,20,10,10,391.44747082967046,0.39683977455716585,0.3006985079522817,0.26037756860426675,136025.79417706176,1449.3906196416126,137475.18479670337,3952,30,998.3260869565217,35,11,16,28.99850678649358,0.6824404761904763,39.20717592592592,1043.1712962962952,29.80489417989415,0
4082,4,0,0,46,0.0,0.0,1.0,46,650,400,250,0.6153846153846154,9,4,5,397.3196956510958,0.39606481481481487,0.3122628272200825,0.26518369324100105,136146.55838745256,1618.7418284893347,137765.30021594188,3953,31,999.3260869565217,35,11,16,28.725024028686544,0.6836309523809525,39.09143518518517,1043.634259259257,29.81812169312163,0
4083,4,0,0,46,0.0,0.0,1.0,46,1150,900,250,0.782608695652174,14,9,5,395.8072969159446,0.39564210950080514,0.30886917960088667,0.26485028324790927,136237.16670953343,1584.7329389574545,137821.8996484909,3954,32,1000.3260869565217,35,11,17,28.67424242424242,0.6845238095238096,39.00462962962962,1043.9814814814802,29.82804232804229,0
4084,4,0,0,46,0.0,0.0,1.0,46,900,700,200,0.7777777777777778,11,7,4,400.5824316689225,0.3954911433172303,0.31033494114075655,0.268732734643025,136327.80517243218,1722.104740011994,138049.9099124442,3955,33,1001.3260869565217,35,11,17,28.459330784291993,0.6854166666666668,38.91782407407407,1044.328703703703,29.837962962962944,0
4085,4,0,0,46,0.0,0.0,1.0,46,1350,1000,350,0.7407407407407407,17,10,7,403.1864703309523,0.39536030595813204,0.315589545947248,0.27094250891562477,136388.2475592634,1797.979225608693,138186.2267848721,3956,34,1002.3260869565217,35,11,17,28.331140350877185,0.6860119047619049,38.859953703703695,1044.560185185184,29.84457671957669,0
4086,4,0,0,46,0.0,0.0,1.0,46,1850,1400,450,0.7567567567567568,23,14,9,403.34573601059503,0.39460547504025767,0.3190723701154268,0.27316303128069824,136662.03946767707,1824.410178759831,138486.4496464369,3957,35,1003.3260869565217,36,10,18,28.054433674385205,0.6866319444444444,38.59797297297297,1045.6081081081074,29.044669669669652,0
4087,4,0,0,46,0.0,0.0,1.0,46,850,500,350,0.5882352941176471,12,5,7,406.9557362019114,0.3947564412238325,0.32578869892338647,0.27654631156337395,136781.449599194,1932.8117856814401,138714.26138487543,3958,36,1004.3260869565217,35,11,19,27.841244375599317,0.6898809523809524,38.48379629629629,1046.064814814814,29.887566137566118,0
4088,4,0,0,46,0.0,0.0,1.0,46,1450,1200,250,0.8275862068965517,17,12,5,406.803199754827,0.39437399355877617,0.3257118952136404,0.27739928598666247,136902.54870756165,1938.478973765421,138841.02768132708,3959,37,1005.3260869565217,35,11,20,27.72478433974784,0.6910714285714287,38.36805555555555,1046.5277777777771,29.900793650793634,0
4089,4,0,0,46,0.0,0.0,1.0,46,1100,900,200,0.8181818181818182,13,9,4,411.58454582745634,0.3939512882447665,0.3236832490433246,0.28114581816189665,136963.118355624,2074.3805727023127,139037.4989283263,3960,38,1006.3260869565217,35,11,16,27.539436827362522,0.6916666666666667,38.310185185185176,1046.759259259258,29.907407407407373,0
4090,4,0,0,46,0.0,0.0,1.0,46,1150,700,450,0.6086956521739131,16,7,9,370.6628439343058,0.3935990338164251,0.23086085019850855,0.23980924629179154,135031.53399348425,872.1772119341587,135903.7112054184,3961,39,1007.3260869565217,35,11,17,30.530809205642154,0.6726190476190477,40.16203703703704,1039.3518518518522,29.695767195767207,8
4091,4,0,0,46,0.0,0.0,1.0,46,1800,1400,400,0.7777777777777778,22,14,8,369.7912341677614,0.3932467793880838,0.23539148329008874,0.23993552108720603,135135.59325795405,794.3915621702948,135929.98482012434,3962,40,1008.3260869565217,36,10,17,30.4496552222102,0.6715856481481481,40.061936936936945,1039.7522522522534,28.882007007007036,0
4092,4,2,1,47,0.041666666666666664,0.020833333333333332,0.9791666666666666,48,950,600,350,0.631578947368421,13,6,7,356.80000000000007,0.39412492612293143,0.2423333333333333,0.23473684210526324,135633.6805555556,80.65193571950851,135714.3324912751,3963,0,967.2708333333334,36,12,19,30.29166666666667,0.6765046296296295,39.583333333333336,1041.666666666667,28.935185185185194,0
4093,4,0,0,47,0.0,0.0,1.0,47,850,700,150,0.8235294117647058,10,7,3,369.23005861795775,0.3932508479802652,0.24829341404564476,0.24233433771214552,135548.030704159,609.6814644890725,136157.71216864808,3964,1,988.8510638297872,37,10,19,30.053240496999045,0.673704954954955,39.665570175438596,1041.3377192982457,28.144262683736372,0
4094,4,0,0,47,0.0,0.0,1.0,47,1500,1100,400,0.7333333333333333,19,11,8,369.60000000000025,0.3932508479802652,0.25055319148936195,0.24315789473684205,135633.68055555533,626.0957698522368,136259.77632540755,3965,2,989.8510638297872,35,12,20,29.958333333333336,0.6785714285714286,39.58333333333332,1041.666666666665,29.761904761904713,0
4095,4,0,0,47,0.0,0.0,1.0,47,1400,1100,300,0.7857142857142857,17,11,6,371.1192547814532,0.3934050262102991,0.24946084269482083,0.24495988471808613,135751.01072356143,675.9627871114361,136426.97351067286,3966,3,990.8510638297872,36,11,20,29.80197752323319,0.6776620370370371,39.47072072072072,1042.1171171171172,28.947697697697702,0
4096,4,0,0,47,0.0,0.0,1.0,47,1350,1000,350,0.7407407407407407,17,10,7,371.6901697540226,0.39311594202898553,0.24765406001562495,0.24655092922079128,135927.1010875739,704.5534554824937,136631.6545430564,3967,4,991.8510638297872,36,11,15,29.6119060475162,0.6793981481481483,39.301801801801794,1042.7927927927915,28.96646646646643,0
4097,4,0,0,47,0.0,0.0,1.0,47,1050,700,350,0.6666666666666666,14,7,7,372.71185436962924,0.3930195806352143,0.2510367199902588,0.24743257944925703,135956.4605779766,734.5169071098071,136690.97748508642,3968,5,992.8510638297872,36,11,15,29.556068459129676,0.6796875,39.273648648648646,1042.9054054054052,28.96959459459459,0
4098,4,0,1,46,0.0,0.02127659574468085,0.9787234042553191,47,1100,400,700,0.36363636363636365,18,4,14,371.95130833717866,0.39303885291396856,0.24158475854611083,0.24815498735497724,136132.68409879468,726.9459915997007,136859.63009039438,3969,6,993.8510638297872,36,11,15,29.40069601812884,0.6814236111111112,39.104729729729726,1043.5810810810806,28.988363363363348,0
4099,4,0,0,46,0.0,0.0,1.0,46,1300,800,500,0.6153846153846154,18,8,10,373.22084022716535,0.39277375201288245,0.24558017139881883,0.24941484989658214,136191.45063560182,965.8975275951616,137157.348163197,3970,7,1011.1739130434783,36,10,15,29.309166756572086,0.6820023148148149,39.04842342342342,1043.8063063063062,28.994619619619616,0
4100,4,0,0,46,0.0,0.0,1.0,46,1000,800,200,0.8,12,8,4,371.6115713539286,0.39294484702093396,0.24615637165236137,0.24854540161983524,136220.83865960548,924.2479810891907,137145.08664069467,3971,8,1012.1739130434783,36,10,15,29.321961524631426,0.6822916666666667,39.02027027027027,1043.9189189189183,28.99774774774773,0
4101,4,0,0,46,0.0,0.0,1.0,46,550,400,150,0.7272727272727273,7,4,3,372.8611135210638,0.3929347826086957,0.24794708136170307,0.24958811432879274,136250.2298540093,960.4824841733487,137210.71233818264,3972,9,1013.1739130434783,36,10,15,29.260148132168403,0.6825810185185186,38.99211711711711,1044.0315315315306,29.00087587587585,0
4102,4,0,1,45,0.0,0.021739130434782608,0.9782608695652174,46,1450,1100,350,0.7586206896551724,18,11,7,371.88978750604133,0.39202898550724635,0.2503597021150954,0.250182854147465,136426.6435988352,947.1350996266395,137373.77869846183,3973,10,1014.1739130434783,36,10,15,29.110299665840245,0.6843171296296298,38.82319819819819,1044.7072072072062,29.019644644644618,0
4103,4,0,0,45,0.0,0.0,1.0,45,1200,800,400,0.6666666666666666,16,8,8,378.9332245599554,0.3891835016835017,0.25858854532244746,0.2542092554055372,136327.80517243218,1331.8269622342143,137659.6321346664,3974,11,1036.1555555555556,35,10,16,29.024552994199997,0.6854166666666668,38.91782407407407,1044.328703703703,29.837962962962944,0
4104,4,0,0,45,0.0,0.0,1.0,45,800,700,100,0.875,9,7,2,378.3317071918964,0.3888678451178451,0.2591538498394901,0.2543047040515964,136397.23338203062,1320.6796323350288,137717.91301436565,3975,12,1037.1555555555556,36,9,16,28.971269943941344,0.6840277777777779,38.85135135135135,1044.5945945945941,29.016516516516504,0
4105,4,0,0,45,0.0,0.0,1.0,45,1250,800,450,0.64,17,8,9,381.02001623694787,0.3888678451178451,0.1608559670781895,0.2410066367763824,134209.71476800533,1273.1298218887587,135482.84458989408,3976,13,1038.1555555555556,37,8,15,31.083774250440918,0.6604729729729731,40.95394736842104,1036.184210526314,28.004978662873352,7
4106,4,0,0,45,0.0,0.0,1.0,45,1750,1300,450,0.7428571428571429,22,13,9,379.4005446858569,0.38876262626262625,0.16442375511355656,0.2403548222768575,134266.52912434575,1188.158856571233,135454.687980917,3977,14,1039.1555555555556,37,8,16,31.06882141345747,0.6610360360360361,40.899122807017534,1036.4035087719283,28.01090564248455,0
4107,4,0,0,45,0.0,0.0,1.0,45,1000,700,300,0.7,13,7,6,381.82765643476057,0.38899410774410775,0.16336757245754474,0.24230698171265383,134329.18453000564,1258.1195439768926,135587.30407398252,3978,15,1040.1555555555556,38,7,16,30.9431790855062,0.6598135964912282,40.8386752136752,1036.6452991452975,27.28013945119204,0
4108,4,0,0,45,0.0,0.0,1.0,45,1050,700,350,0.6666666666666666,14,7,7,382.1867183935368,0.3886994949494949,0.16170358921518124,0.24290256070787647,134384.566588593,1271.999301446414,135656.56589003943,3979,16,1041.1555555555556,38,7,16,30.878413189077797,0.6603618421052632,40.78525641025641,1036.8589743589741,27.2857624831309,0
4109,4,0,0,45,0.0,0.0,1.0,45,1300,900,400,0.6923076923076923,17,9,8,378.60680820635287,0.3881523569023569,0.1626623636717368,0.24135873282176462,134495.3649485899,1184.1721683468274,135679.53711693673,3980,17,1042.1555555555556,38,7,17,30.86032718783259,0.6614583333333335,40.67841880341879,1037.2863247863233,27.29700854700851,0
4110,4,0,0,45,0.0,0.0,1.0,45,850,400,450,0.47058823529411764,13,4,9,376.59976052868564,0.387962962962963,0.16185687586664232,0.2408304506087328,134609.2053835931,1138.7817310320384,135747.98711462514,3981,18,1043.1555555555556,36,9,18,30.79851691083379,0.6663773148148149,40.568693693693696,1037.7252252252256,28.82570070070071,0
4111,4,1,1,45,0.021739130434782608,0.021739130434782608,0.9782608695652174,46,1100,700,400,0.6363636363636364,15,7,8,373.28402535008377,0.38983494363929144,0.16470548787303008,0.24088833089114545,134939.01495954767,874.1157361750134,135813.13069572268,3982,0,1021.4565217391304,38,8,14,30.555055698371884,0.6658442982456141,40.25106837606837,1038.9957264957254,27.34199280251909,0
4112,4,0,0,45,0.0,0.0,1.0,45,850,700,150,0.8235294117647058,10,7,3,386.4742527049858,0.3875,0.17325450450450464,0.2486877800014688,134835.33394890715,1422.076985226201,136257.41093413334,3983,20,1045.1555555555556,37,8,14,30.316107122747745,0.6666666666666667,40.350877192982445,1038.5964912280685,28.070175438596447,0
4113,4,0,0,45,0.0,0.0,1.0,45,800,400,400,0.5,12,4,8,384.9850361760297,0.38716329966329965,0.17143248988548376,0.24786917362273864,134855.774937906,1383.4910786032249,136239.26601650924,3984,21,1046.1555555555556,38,7,14,30.334336213399165,0.6650219298245617,40.331196581196565,1038.675213675211,27.333558254610814,0
4114,4,0,0,45,0.0,0.0,1.0,45,1200,1000,200,0.8333333333333334,14,10,4,384.0555083437963,0.3867003367003367,0.17366509013640452,0.24802947371525613,134966.76734056522,1366.9460880999131,136333.71342866513,3985,22,1047.1555555555556,38,7,15,30.247532387415173,0.6661184210526316,40.224358974358964,1039.1025641025624,27.344804318488485,0
4115,4,0,0,45,0.0,0.0,1.0,45,900,700,200,0.7777777777777778,11,7,4,378.93077774246234,0.38646885521885527,0.1746720104134558,0.24566125237920716,135105.57204918173,1239.1318987873328,136344.70394796907,3986,23,1048.1555555555556,38,7,15,30.242052889391285,0.6674890350877194,40.09081196581196,1039.6367521367513,27.35886189833556,0
4116,4,0,0,45,0.0,0.0,1.0,45,650,500,150,0.7692307692307693,8,5,3,378.93077774246234,0.38646885521885527,0.1746720104134558,0.24566125237920716,135105.57204918173,1239.1318987873328,136344.70394796907,3987,24,1049.1555555555556,38,7,15,30.242052889391285,0.6674890350877194,40.09081196581196,1039.6367521367513,27.35886189833556,0
4117,4,0,0,45,0.0,0.0,1.0,45,1050,600,450,0.5714285714285714,15,6,9,375.6044109143288,0.38613215488215485,0.17454022398027336,0.24387976860768226,135161.1139076081,1153.4221135583084,136314.5360211664,3988,25,1050.1555555555556,38,7,15,30.27308298229391,0.6680372807017545,40.03739316239315,1039.8504273504257,27.364484930274358,0
4118,4,0,0,45,0.0,0.0,1.0,45,950,700,250,0.7368421052631579,12,7,5,375.32262339428036,0.3856902356902357,0.17573026205975628,0.24414308759556272,135227.08468967007,1150.7568359374902,136377.84152560757,3989,26,1051.1555555555556,39,6,15,30.21459272241695,0.6669337606837608,39.97395833333333,1040.104166666666,26.66933760683759,0
4119,4,0,1,44,0.0,0.022222222222222223,0.9777777777777777,45,1000,600,400,0.6,14,6,8,374.16661380877645,0.38552188552188554,0.1717088797677444,0.24412477500560864,135335.45057508678,1127.601453993051,136463.05202907984,3990,27,1052.1555555555556,39,6,15,30.136587746521155,0.6680021367521367,39.869791666666664,1040.5208333333333,26.680021367521366,0
4120,4,0,0,44,0.0,0.0,1.0,44,1000,800,200,0.8,12,8,4,377.7851926000077,0.3853285764622974,0.18811993811993832,0.2466715081094166,135362.54882812485,1427.5933159722078,136790.14214409707,3991,28,1075.2727272727273,39,5,16,30.015432098765437,0.6682692307692308,39.84374999999999,1040.6249999999989,26.682692307692278,0
4121,4,0,0,44,0.0,0.0,1.0,44,1050,900,150,0.8571428571428571,12,9,3,379.07648171259217,0.3847890239605356,0.1849674837418709,0.24845045473556446,135498.0807834201,1472.8271484374955,136970.9079318576,3992,29,1076.2727272727273,39,5,16,29.846694180423544,0.6696047008547009,39.713541666666664,1041.145833333333,26.696047008547,0
4122,4,0,0,44,0.0,0.0,1.0,44,1050,600,450,0.5714285714285714,15,6,9,379.3944904845395,0.38407329105003524,0.18948708395429703,0.24923299605676646,135580.7555026768,1487.7183306893876,137068.47383336618,3993,30,1077.2727272727273,40,4,16,29.756009302628158,0.6687500000000002,39.634146341463406,1041.463414634145,26.036585365853625,0
4123,4,0,0,44,0.0,0.0,1.0,44,950,700,250,0.7368421052631579,12,7,5,378.45073747963636,0.38404025722339674,0.18394475222703832,0.24917951883534445,135662.23651748596,1468.325675177409,137130.56219266338,3994,31,1078.2727272727273,37,7,16,29.699395677647967,0.6748310810810811,39.55592105263157,1041.7763157894722,28.156116642958708,0
4124,4,0,0,44,0.0,0.0,1.0,44,500,200,300,0.4,8,2,6,377.75163248648147,0.3832364341085271,0.1865052035506587,0.2493160774410773,135747.92243767285,1455.7998614958142,137203.72229916867,3995,32,1079.2727272727273,37,7,16,29.632260101010097,0.6756756756756758,39.4736842105263,1042.1052631578925,28.165007112375473,0
4125,4,0,0,44,0.0,0.0,1.0,44,1250,900,350,0.72,16,9,7,376.7616356019067,0.3829171071176885,0.18580919606156177,0.2498607499703021,135919.37543282547,1441.8412396121853,137361.21667243764,3996,33,1080.2727272727273,37,7,14,29.48738170347003,0.6773648648648649,39.30921052631579,1042.7631578947367,28.182788051209098,0
4126,4,0,0,44,0.0,0.0,1.0,44,1100,700,400,0.6363636363636364,15,7,8,379.5292937086089,0.38162878787878785,0.18952610710361628,0.2527096731726673,136062.3355864305,1527.928425092342,137590.26401152284,3997,34,1081.2727272727273,37,7,15,29.27296812051148,0.6787725225225225,39.17214912280702,1043.3114035087724,28.197605500237092,0
4127,4,0,0,44,0.0,0.0,1.0,44,1350,900,450,0.6666666666666666,18,9,9,376.02129086928915,0.3804395701198027,0.18507448433919005,0.2513850203002549,136205.3708833486,1443.2238765773955,137648.594759926,3998,35,1082.2727272727273,37,7,15,29.222251400560218,0.6801801801801801,39.03508771929824,1043.859649122806,28.21242294926503,0
4128,4,0,0,44,0.0,0.0,1.0,44,1300,800,500,0.6153846153846154,18,8,10,370.37378775286606,0.3801422656800564,0.18135094423833298,0.24887591222403938,136385.92260437217,1302.7541502301153,137688.6767546023,3999,36,1083.2727272727273,38,6,16,29.190319116293345,0.6800986842105263,38.86217948717949,1044.5512820512824,27.488191632928487,0
4129,4,0,0,44,0.0,0.0,1.0,44,1000,700,300,0.7,13,7,6,371.10730550641745,0.3798229386892178,0.17795593976575552,0.2499607057749835,136469.6334648257,1328.9755917159682,137798.60905654167,4000,37,1084.2727272727273,38,6,16,29.08806237218814,0.680921052631579,38.78205128205128,1044.8717948717942,27.49662618083669,0
4130,4,0,0,44,0.0,0.0,1.0,44,1000,500,500,0.5,15,5,10,367.9970129459697,0.3796577695560253,0.16679123069257584,0.24867676935439764,136584.77783203125,1252.5580512152787,137837.33588324653,4001,38,1085.2727272727273,39,5,16,29.05507806012291,0.6802884615384615,38.671875,1045.3125,26.802884615384617,0
4131,4,0,0,44,0.0,0.0,1.0,44,1000,900,100,0.9,11,9,2,371.2348796848294,0.37907417195207893,0.1724415118606608,0.251253168401661,136639.2266167534,1345.0493706597176,137984.27598741313,4002,39,1086.2727272727273,39,5,16,28.9164466474046,0.6808226495726496,38.619791666666664,1045.520833333333,26.808226495726487,0
4132,4,0,0,44,0.0,0.0,1.0,44,1650,1100,550,0.6666666666666666,22,11,11,372.1607882951027,0.3781272022551092,0.17377871578165083,0.2530852516837897,136806.9396953868,1382.884532380128,138189.82422776692,4003,40,1087.2727272727273,37,7,17,28.725915347797216,0.6860923423423424,38.45942982456139,1046.1622807017525,28.274656235182498,0
4133,4,0,0,44,0.0,0.0,1.0,44,1150,700,450,0.6086956521739131,16,7,9,370.5652346026746,0.3780721458773784,0.17675478493326202,0.25238636353954036,136860.62372160103,1343.157827452673,138203.7815490537,4004,41,1088.2727272727273,38,6,17,28.714434007215292,0.6847587719298247,38.408119658119645,1046.3675213675194,27.535987404408406,0
4134,4,0,0,44,0.0,0.0,1.0,44,1200,800,400,0.6666666666666666,16,8,8,370.0375366750809,0.3777968639887244,0.17628716730390925,0.2524295062165104,136916.52512966597,1332.8507378186664,138249.37586748463,4005,42,1089.2727272727273,38,6,17,28.67284265686675,0.6853070175438598,38.354700854700845,1046.5811965811952,27.54161043634724,0
4135,4,0,2,42,0.0,0.045454545454545456,0.9545454545454546,44,800,400,400,0.5,12,4,8,370.8706148929632,0.377488548273432,0.1782247812410107,0.2531999591711748,136944.48011405134,1357.7367092190711,138302.21682327043,4006,43,1090.2727272727273,38,6,17,28.623345581980878,0.6855811403508772,38.32799145299145,1046.6880341880335,27.54442195231667,0
4136,4,0,0,42,0.0,0.0,1.0,42,450,300,150,0.6666666666666666,6,3,3,377.5981319893578,0.3749637049941928,0.17859705225180922,0.25723180663087347,136868.17729892055,1936.2336153721285,138804.41091429268,4007,44,1124.6190476190477,36,6,18,28.522967785909017,0.6886574074074074,38.4009009009009,1046.3963963963965,29.06656656656657,0
4137,4,0,0,42,0.0,0.0,1.0,42,1300,1100,200,0.8461538461538461,15,11,4,376.8883781922099,0.3742620015485869,0.18517160713662206,0.25756287377244275,136979.05996316162,1925.1631511618803,138904.2231143235,4008,45,1125.6190476190477,37,5,15,28.43159718585244,0.6877815315315315,38.29495614035087,1046.8201754385955,28.292437174016094,0
4138,4,0,0,42,0.0,0.0,1.0,42,850,600,250,0.7058823529411765,11,6,5,378.4988350100051,0.3742257065427797,0.19202692595362736,0.2593015691783034,137065.16067443826,1975.800727146805,139040.96140158505,4009,46,1126.6190476190477,37,5,15,28.30410122164047,0.6886261261261262,38.21271929824561,1047.1491228070172,28.3013276434329,0
4139,4,0,0,42,0.0,0.0,1.0,42,1100,800,300,0.7272727272727273,14,8,6,377.5395843632112,0.3734998064266357,0.194480464291785,0.25940964433646,137168.22271760172,1957.2867585287445,139125.50947613045,4010,47,1127.6190476190477,38,4,15,28.227095019547846,0.6877741228070176,38.11431623931624,1047.5427350427349,27.56691408007197,0
4140,4,0,0,42,0.0,0.0,1.0,42,900,600,300,0.6666666666666666,12,6,6,378.69988497040123,0.3731005613627565,0.19126256006989983,0.2612549839352767,137308.1545857987,1999.7164694279998,139307.87105522671,4011,48,1128.6190476190477,38,4,15,28.05810397553518,0.6891447368421053,37.980769230769226,1048.0769230769222,27.580971659919005,0
4141,4,0,0,42,0.0,0.0,1.0,42,1350,1100,250,0.8148148148148148,16,11,5,377.90444041415236,0.3733425280681378,0.1903548618795261,0.26112664572842675,137364.1473080574,1982.1042442837145,139346.25155234113,4012,49,1129.6190476190477,38,4,16,28.023508628889793,0.6896929824561404,37.92735042735042,1048.290598290597,27.586594691857815,0
4142,4,0,0,42,0.0,0.0,1.0,42,1250,1000,250,0.8,15,10,5,380.06991626347076,0.373015873015873,0.1994747792181346,0.2641122793907303,137560.2117233727,2056.499630177511,139616.7113535502,4013,50,1130.6190476190477,38,4,17,27.772685609532545,0.6916118421052632,37.74038461538461,1049.038461538461,27.60627530364371,0
4143,4,0,0,42,0.0,0.0,1.0,42,800,700,100,0.875,9,7,2,381.02152388616275,0.3729795780100658,0.19618368732421687,0.26498805698031996,137588.23233983482,2084.8155909854545,139673.0479308203,4014,51,1131.6190476190477,38,4,17,27.720001697216553,0.6918859649122807,37.71367521367521,1049.1452991452986,27.609086819613122,0
4144,4,0,0,42,0.0,0.0,1.0,42,950,500,450,0.5263157894736842,14,5,9,384.23115908467423,0.3726166279519938,0.20202299437190807,0.2683227574564282,137730.4809570311,2184.0684678819302,139914.54942491304,4015,52,1132.6190476190477,39,3,17,27.495058879957657,0.6915064102564104,37.57812499999999,1049.6874999999989,26.915064102564074,0
4145,4,0,0,42,0.0,0.0,1.0,42,800,400,400,0.5,12,4,8,379.81859410430854,0.3722657762291908,0.1974678760393047,0.26587301587301576,137812.49999999988,2068.7988281249864,139881.29882812488,4016,53,1133.6190476190477,37,5,17,27.52976190476189,0.695945945945946,37.49999999999999,1049.999999999999,28.378378378378354,0
4146,4,0,0,42,0.0,0.0,1.0,42,1350,900,450,0.6666666666666666,18,9,9,367.7191301699353,0.37218108788230736,0.16430779834102616,0.2538840525050836,137336.14952014407,1700.2258884871212,139036.3754086312,4017,54,1134.6190476190477,38,4,17,28.31812931063772,0.6894188596491226,37.95405982905984,1048.1837606837619,27.58378317588847,1
4147,4,0,0,42,0.0,0.0,1.0,42,800,700,100,0.875,9,7,2,367.85940499134455,0.3714309910956253,0.1685155260514477,0.25439072171811616,137392.14794954,1708.1987590401268,139100.34670858012,4018,55,1135.6190476190477,38,4,17,28.25906960154897,0.6899671052631577,37.900641025641036,1048.3974358974376,27.589406207827306,0
4148,4,0,0,42,0.0,0.0,1.0,42,1050,800,250,0.7619047619047619,13,8,5,370.5329654892069,0.3703663375919473,0.17416171847712247,0.2568609879408231,137476.1669953978,1787.890368178838,139264.05736357663,4019,56,1136.6190476190477,38,4,17,28.105898533007352,0.6907894736842104,37.820512820512825,1048.717948717949,27.5978407557355,0
4149,4,0,0,42,0.0,0.0,1.0,42,700,300,400,0.42857142857142855,11,3,8,367.4491803009356,0.3697493224932249,0.17904791002866194,0.2553420736995674,137560.2117233728,1709.2774079553024,139269.4891313281,4020,57,1137.6190476190477,38,4,17,28.103676545473075,0.691611842105263,37.74038461538462,1049.038461538462,27.606275303643734,0
4150,4,0,0,42,0.0,0.0,1.0,42,950,700,250,0.7368421052631579,12,7,5,367.3843074846033,0.36961624080526523,0.17466717216640681,0.25081979515168384,136944.4801140516,1669.0563591204814,138613.53647317208,4021,58,1138.6190476190477,38,4,19,28.714572488176657,0.6855811403508771,38.32799145299146,1046.6880341880355,27.544421952316725,5
4151,4,0,0,42,0.0,0.0,1.0,42,750,600,150,0.8,9,6,3,367.758618296126,0.3692532907471932,0.17619144810694953,0.2514770900686492,137000.3986435279,1676.6154622324739,138677.01410576038,4022,59,1139.6190476190477,38,4,16,28.649394496037004,0.6861293859649122,38.27457264957266,1046.9017094017113,27.55004498425556,0
4152,4,0,0,42,0.0,0.0,1.0,42,850,400,450,0.47058823529411764,13,4,9,365.0908681549859,0.36886614401858303,0.17771883289124668,0.2502531950807815,137084.29783950624,1609.6450617284065,138693.94290123464,4023,60,1140.6190476190477,38,4,17,28.636162687886834,0.6869517543859649,38.19444444444445,1047.2222222222229,27.55847953216376,0
4153,4,0,0,42,0.0,0.0,1.0,42,850,600,250,0.7058823529411765,11,6,5,365.3240809705428,0.36840640727835855,0.17148393112088778,0.25121794796613917,137196.20338410413,1624.2153827891088,138820.41876689324,4024,61,1141.6190476190477,38,4,17,28.51931640492215,0.688048245614035,38.08760683760684,1047.6495726495734,27.569725596041405,0
4154,4,0,0,42,0.0,0.0,1.0,42,1500,1100,400,0.7333333333333333,19,11,8,361.63061470695516,0.3685757839721255,0.17263725061890223,0.249479348120621,137308.15458579885,1530.9664694280136,138839.12105522686,4025,62,1142.6190476190477,38,4,18,28.505351681957194,0.6891447368421052,37.98076923076923,1048.0769230769233,27.580971659919033,0
4155,4,0,0,42,0.0,0.0,1.0,42,850,400,450,0.47058823529411764,13,4,9,361.2254135519789,0.3682612272551297,0.1682971568327729,0.2498030291180811,137392.14794953985,1525.9070923734462,138918.0550419133,4026,63,1143.6190476190477,38,4,18,28.43294609191888,0.6899671052631579,37.90064102564103,1048.3974358974365,27.589406207827277,0
4156,4,0,0,42,0.0,0.0,1.0,42,1050,800,250,0.7619047619047619,13,8,5,360.44290954998206,0.3677047038327526,0.16297746750666864,0.24992694306812863,137484.5703125004,1511.0677083333776,138995.63802083378,4027,64,1144.6190476190477,39,3,18,28.362137465236408,0.6891025641025639,37.81250000000002,1048.7500000000032,26.891025641025724,0
4157,4,0,0,42,0.0,0.0,1.0,42,650,400,250,0.6153846153846154,9,4,5,360.84308567832943,0.367595818815331,0.16531882392444452,0.25040172499621677,137511.8828667538,1524.0424262153124,139035.9252929691,4028,65,1145.6190476190477,39,3,18,28.324663985169007,0.689369658119658,37.78645833333335,1048.8541666666692,26.893696581196647,0
4158,4,0,0,42,0.0,0.0,1.0,42,900,500,400,0.5555555555555556,13,5,8,361.09979991293363,0.36653116531165314,0.16919582287397272,0.25137237626281855,137621.16021050367,1538.9946831597458,139160.15489366342,4029,66,1146.6190476190477,39,3,18,28.21000446738809,0.6904380341880341,37.68229166666668,1049.2708333333348,26.90438034188038,0
4159,4,0,0,42,0.0,0.0,1.0,42,1050,900,150,0.8571428571428571,12,9,3,363.6662255000899,0.3661319202477739,0.17266986206831336,0.25335916706002143,137648.48632812515,1611.621093750013,139260.10742187515,4030,67,1147.6190476190477,39,3,18,28.115693865396068,0.6907051282051282,37.65625000000001,1049.3750000000011,26.90705128205131,0
4160,4,0,0,42,0.0,0.0,1.0,42,550,200,350,0.36363636363636365,9,2,7,363.41352367501224,0.36556329849012775,0.17337756857407527,0.25358411804358905,137703.14670138896,1608.637152777787,139311.78385416674,4031,68,1148.6190476190477,39,3,18,28.068347227735874,0.6912393162393162,37.60416666666667,1049.583333333334,26.91239316239318,0
4161,4,0,0,42,0.0,0.0,1.0,42,1200,800,400,0.6666666666666666,16,8,8,366.59108087679493,0.3651035617499032,0.18499622071050625,0.25661375661375657,137812.50000000015,1704.166666666681,139516.66666666683,4032,69,1149.6190476190477,39,3,19,27.87698412698413,0.6923076923076923,37.50000000000001,1050.0000000000011,26.92307692307695,0
4162,4,0,0,42,0.0,0.0,1.0,42,950,800,150,0.8421052631578947,11,8,3,363.6553309203877,0.364353464963221,0.17431669216675183,0.2553691056407514,137921.89670138893,1631.2065972222272,139553.10329861115,4033,70,1150.6190476190477,39,3,19,27.846092820309394,0.6933760683760684,37.395833333333336,1050.416666666667,26.933760683760692,0
4163,4,0,0,42,0.0,0.0,1.0,42,800,600,200,0.75,10,6,4,363.100761226972,0.364353464963221,0.2023969319271337,0.22731938412949082,133831.25964506165,1358.8638117283922,135190.12345679005,4034,71,1151.6190476190477,38,4,14,31.926733780760628,0.6548793859649124,41.31944444444444,1034.7222222222217,27.229532163742675,7
4164,4,0,0,42,0.0,0.0,1.0,42,1350,1000,350,0.7407407407407407,17,10,7,362.75542261238064,0.3636517615176152,0.2036572961658094,0.22812866972982354,133997.13187824163,1321.63724066769,135318.76911890932,4035,72,1152.6190476190477,38,4,15,31.76959722078905,0.6565241228070176,41.159188034188034,1035.3632478632478,27.246401259559153,0
4165,4,0,0,42,0.0,0.0,1.0,42,1450,1100,350,0.7586206896551724,18,11,7,360.4481152377687,0.3629742547425474,0.20482320039842117,0.2274299529139832,134118.83680555568,1268.5763888888991,135387.41319444458,4036,73,1153.6190476190477,39,3,15,31.707562349155264,0.655982905982906,41.04166666666667,1035.8333333333344,26.559829059829088,0
4166,4,0,0,42,0.0,0.0,1.0,42,1450,1100,350,0.7586206896551724,18,11,7,359.56438228876254,0.3634944831591173,0.20510371636339286,0.22737361161006486,134199.77349175338,1250.6917317708292,135450.46522352422,4037,74,1154.6190476190477,39,3,15,31.6495132535773,0.656784188034188,40.963541666666664,1036.1458333333328,26.567841880341867,0
4167,4,0,0,42,0.0,0.0,1.0,42,850,600,250,0.7058823529411765,11,6,5,360.7059011418373,0.3632041231126597,0.20818681498293112,0.22831272960541998,134234.6561756395,1283.846524059753,135518.50269969925,4038,75,1155.6190476190477,40,2,15,31.585065869046442,0.65546875,40.92987804878049,1036.2804878048782,25.907012195121958,0
4168,4,0,0,42,0.0,0.0,1.0,42,800,600,200,0.75,10,6,4,359.8692810457519,0.36408730158730157,0.2042577030812327,0.22827529021558876,134313.6525877453,1267.071518276155,135580.72410602146,4039,76,1156.6190476190477,40,2,15,31.527777777777786,0.65625,40.853658536585364,1036.585365853658,25.91463414634145,0
4169,4,0,0,42,0.0,0.0,1.0,42,1050,900,150,0.8571428571428571,12,9,3,365.53063102670234,0.3648978900503291,0.21343637415765992,0.23253582038631376,134419.01728468513,1426.853642012041,135845.8709266972,4040,77,1157.6190476190477,40,2,15,31.27572520580165,0.6572916666666666,40.75203252032521,1036.9918699186999,25.9247967479675,0
4170,4,0,0,42,0.0,0.0,1.0,42,1250,1000,250,0.8,15,10,5,369.8430504809539,0.3649220867208672,0.21496933277879005,0.23630574893141623,134577.80083550338,1554.5974266490389,136132.39826215242,4041,78,1158.6190476190477,39,3,16,31.00519107853964,0.6605235042735043,40.59895833333333,1037.6041666666658,26.60523504273502,0
4171,4,0,0,42,0.0,0.0,1.0,42,500,400,100,0.8,6,4,2,368.2127598334335,0.36504307007355785,0.21740169371642715,0.23578868502444275,134658.87586805545,1516.6232638888803,136175.49913194432,4042,79,1159.6190476190477,39,3,16,30.966479325572056,0.6613247863247864,40.52083333333333,1037.9166666666658,26.613247863247842,0
4172,4,0,0,42,0.0,0.0,1.0,42,850,700,150,0.8235294117647058,10,7,3,364.8994626986629,0.3648132017034456,0.21352606458455847,0.2341888567107255,134739.9753146699,1433.308919270809,136173.2842339407,4043,80,1160.6190476190477,39,3,16,30.97147670646466,0.6621260683760685,40.44270833333332,1038.2291666666647,26.62126068376063,0
4173,4,0,0,42,0.0,0.0,1.0,42,750,500,250,0.6666666666666666,10,5,5,368.2763435743542,0.3644865466511808,0.2165305440129921,0.23688484809266508,134821.09917534713,1530.2842881944348,136351.38346354157,4044,81,1161.6190476190477,39,3,14,30.802825142092946,0.6629273504273505,40.36458333333333,1038.5416666666658,26.62927350427348,0
4174,4,0,0,42,0.0,0.0,1.0,42,1200,1000,200,0.8333333333333334,14,10,4,365.6875029679134,0.36389372822299654,0.21906958091036732,0.23592284311785025,134929.30230034704,1468.3919270833144,136397.69422743036,4045,82,1162.6190476190477,39,3,14,30.762064701557385,0.6639957264957266,40.26041666666666,1038.958333333332,26.63995726495723,0
4175,4,0,1,41,0.0,0.023809523809523808,0.9761904761904762,42,950,700,250,0.7368421052631579,12,7,5,364.6321856724513,0.36354287650019357,0.2141506710253045,0.23569713847575757,134999.26155892646,1445.015161279651,136444.2767202061,4046,83,1163.6190476190477,40,2,14,30.7196932655323,0.6630208333333334,40.193089430894304,1039.2276422764219,25.980691056910548,0
4176,4,0,0,41,0.0,0.0,1.0,41,1200,900,300,0.75,15,9,6,372.4222723389382,0.3621443089430894,0.2176958223426071,0.2408073241170181,135010.48312717024,1856.1821831597313,136866.66531032996,4047,84,1189.3658536585365,39,2,14,30.506101533527115,0.6647970085470085,40.18229166666667,1039.2708333333342,26.647970085470106,0
4177,4,0,0,41,0.0,0.0,1.0,41,500,200,300,0.4,8,2,6,369.903864956774,0.36168699186991865,0.21633234670857582,0.23953735680750476,135064.61724175353,1792.1847873263932,136856.80202907993,4048,85,1190.3658536585365,39,2,14,30.517524301032175,0.6653311965811965,40.130208333333336,1039.479166666667,26.653311965811973,0
4178,4,0,0,41,0.0,0.0,1.0,41,1000,700,300,0.7,13,7,6,369.9242768252967,0.3610010162601626,0.21496941750301168,0.23990995497032414,135118.76220703137,1796.742078993069,136915.50428602443,4049,86,1191.3658536585365,39,2,14,30.462983835954983,0.6658653846153846,40.07812500000001,1039.687500000001,26.658653846153868,0
4179,4,0,0,41,0.0,0.0,1.0,41,1050,700,350,0.6666666666666666,14,7,7,360.24175171803734,0.3610010162601626,0.2216228430764502,0.21991653507407963,132895.27253123128,1384.3279711796138,134279.6005024109,4050,87,1192.3658536585365,40,1,14,32.93949996714633,0.6421875000000001,42.225609756097555,1031.0975609756088,25.77743902439022,4
4180,4,0,0,41,0.0,0.0,1.0,41,950,500,450,0.5263157894736842,14,5,9,360.410504742659,0.3617632113821138,0.21894017324091308,0.2203280603691864,132947.67086390345,1383.147432084043,134330.8182959875,4051,88,1193.3658536585365,40,1,14,32.882505584023114,0.6427083333333334,42.17479674796746,1031.3008130081275,25.782520325203187,0
4181,4,0,0,41,0.0,0.0,1.0,41,1650,1400,250,0.8484848484848485,19,14,5,361.5947044756691,0.3628048780487805,0.21722626915781773,0.22218958716245626,133139.26214293583,1428.4904297367011,134567.75257267253,4052,89,1194.3658536585365,41,0,14,32.659549328719265,0.6430386178861789,41.9890873015873,1032.0436507936504,25.171796360820743,0
4182,4,0,0,41,0.0,0.0,1.0,41,1000,700,300,0.7,13,7,6,361.1666526981241,0.36272865853658537,0.2146453990491468,0.2220790694250165,133164.85969387743,1418.941326530601,134583.80102040802,4053,90,1195.3658536585365,41,0,14,32.64489619377162,0.6432926829268293,41.96428571428571,1032.1428571428562,25.174216027874543,0
4183,4,0,0,41,0.0,0.0,1.0,41,850,600,250,0.7058823529411765,11,6,5,361.0566852654889,0.3626270325203252,0.21127741118833576,0.2221640928555534,133190.45970529405,1417.8611780360143,134608.32088333007,4054,91,1196.3658536585365,41,0,14,32.62203668108281,0.6435467479674797,41.93948412698412,1032.2420634920625,25.176635694928354,0
4184,4,0,0,41,0.0,0.0,1.0,41,450,200,250,0.4444444444444444,7,2,5,362.11601483501613,0.36219512195121956,0.21241800195459493,0.2231226386256961,133241.66710955193,1449.788300736941,134691.45541028888,4055,92,1197.3658536585365,41,0,14,32.543300182569425,0.6440548780487806,41.88988095238094,1032.4404761904746,25.181475029035965,0
4185,4,0,0,41,0.0,0.0,1.0,41,700,300,400,0.42857142857142855,11,3,8,363.1604562241196,0.3618394308943089,0.20623589964648148,0.22438359108304473,133344.11144376712,1485.0616693436452,134829.17311311077,4056,93,1198.3658536585365,41,0,16,32.41353296193128,0.6450711382113822,41.790674603174594,1032.8373015872999,25.191153697251217,0
4186,4,1,1,41,0.023809523809523808,0.023809523809523808,0.9761904761904762,42,1450,1100,350,0.7586206896551724,18,11,7,356.7126031042557,0.36614401858304296,0.1944967096333321,0.22210489742856196,133629.78902273797,1133.609002661221,134763.3980253992,4057,0,1170.8095238095239,40,2,16,32.29371436996266,0.6494791666666666,41.51422764227643,1033.9430894308957,25.848577235772392,0
4187,4,1,0,42,0.023809523809523808,0.0,1.0,42,750,600,150,0.8,9,6,3,355.7763136815341,0.3656479868370112,0.20001730921271133,0.22231105567614118,133761.16569378367,1117.810888855861,134878.97658263953,4058,0,1171.7857142857142,40,2,14,32.18636408291581,0.6507812499999999,41.38719512195123,1034.4512195121968,25.86128048780492,0
4188,4,0,0,42,0.0,0.0,1.0,42,1050,800,250,0.7619047619047619,13,8,5,350.08444365714763,0.364704316686024,0.198703973678227,0.21956852276582467,133898.11051206355,975.1291050718087,134873.23961713535,4059,1,1172.7857142857142,42,0,14,32.196579596167645,0.6490575396825398,41.25484496124031,1034.9806201550387,24.64239571797711,0
4189,4,0,0,42,0.0,0.0,1.0,42,1050,500,550,0.47619047619047616,16,5,11,348.242269315571,0.36412359659310883,0.1921140004902291,0.21900933770670233,133998.41811076543,932.7826415179211,134931.20075228336,4060,2,1173.7857142857142,42,0,14,32.143971299329266,0.6500496031746033,41.1579457364341,1035.3682170542625,24.651624215577677,0
4190,4,0,0,42,0.0,0.0,1.0,42,800,600,200,0.75,10,6,4,348.242269315571,0.36412359659310883,0.1921140004902291,0.21900933770670233,133998.41811076543,932.7826415179211,134931.20075228336,4061,3,1174.7857142857142,42,0,14,32.143971299329266,0.6500496031746033,41.1579457364341,1035.3682170542625,24.651624215577677,0
4191,4,0,0,42,0.0,0.0,1.0,42,1000,800,200,0.8,12,8,4,347.59080501048817,0.3634581881533101,0.19081479897348208,0.21904779032736407,134073.67345712386,920.5552175349931,134994.22867465887,4062,4,1175.7857142857142,42,0,14,32.08563342065868,0.6507936507936508,41.08527131782945,1035.6589147286813,24.65854558877813,0
4192,4,0,0,42,0.0,0.0,1.0,42,800,500,300,0.625,11,5,6,349.5161482211315,0.36363966318234614,0.18993491306149224,0.2204116878074143,134098.7632673065,973.9366436812553,135072.69991098775,4063,5,1176.7857142857142,42,0,14,32.01071194686127,0.6510416666666667,41.0610465116279,1035.7558139534872,24.660852713178265,0
4193,4,0,0,42,0.0,0.0,1.0,42,1100,700,400,0.6363636363636364,15,7,8,336.5896650286594,0.36386953155245844,0.10509816013978823,0.21787630412933015,135050.0416050298,786.2851650269449,135836.32677005677,4064,6,1177.7857142857142,38,4,13,31.39775413711584,0.6669407894736841,40.14423076923078,1039.4230769230787,27.353238866396808,6
4194,4,0,1,41,0.0,0.023809523809523808,0.9761904761904762,42,1400,1200,200,0.8571428571428571,16,12,4,338.4532361937036,0.3635670731707317,0.10884283855313237,0.2199268225039729,135188.88911717455,751.0234038279078,135939.91252100246,4065,7,1178.7857142857142,38,4,16,31.211261214985278,0.6683114035087718,40.01068376068377,1039.9572649572663,27.36729644624385,0
4195,4,0,0,41,0.0,0.0,1.0,41,750,600,150,0.8,9,6,3,330.3454799333363,0.3601880081300813,0.1059420527091175,0.206812926512887,133831.2596450617,642.1103395061702,134473.3699845679,4066,103,1208.3658536585365,38,3,15,32.77404921700223,0.6548793859649124,41.31944444444444,1034.7222222222222,27.22953216374269,6
4196,4,0,0,41,0.0,0.0,1.0,41,1050,600,450,0.5714285714285714,15,6,9,327.96261526428884,0.36056910569105693,0.10113592878290478,0.2057837964171263,133914.18292059316,583.7691303236159,134497.95205091676,4067,104,1209.3658536585365,38,3,15,32.75293318194331,0.6557017543859649,41.23931623931624,1035.0427350427349,27.237966711650916,0
4197,4,0,0,41,0.0,0.0,1.0,41,850,500,350,0.5882352941176471,12,5,7,330.4998663754917,0.3601371951219512,0.09898533364202788,0.20800030551371868,134024.78723792837,659.0348546278133,134683.8220925562,4068,105,1210.3658536585365,38,3,16,32.576910510386575,0.656798245614035,41.13247863247864,1035.4700854700864,27.249212775528587,0
4198,4,0,0,41,0.0,0.0,1.0,41,750,500,250,0.6666666666666666,10,5,5,330.62655846464133,0.36001016260162605,0.09751568267771771,0.2082367271733446,134052.44545118365,664.259738658797,134716.70518984244,4069,106,1211.3658536585365,38,3,17,32.54603837821108,0.6570723684210525,41.10576923076924,1035.5769230769247,27.252024291498017,0
4199,4,0,0,41,0.0,0.0,1.0,41,700,300,400,0.42857142857142855,11,3,8,330.74467822017624,0.35990853658536587,0.0984013244299966,0.20846806961419972,134080.10651800735,669.2563372050708,134749.3628552124,4070,107,1212.3658536585365,38,3,18,32.51538752492951,0.65734649122807,41.07905982905984,1035.683760683762,27.254835807467423,0
4200,4,0,0,41,0.0,0.0,1.0,41,1500,1200,300,0.8,18,12,6,330.5305899028144,0.36001016260162605,0.10085661454861072,0.2084901801631614,134107.77043839963,665.3440947111072,134773.11453311073,4071,108,1213.3658536585365,38,3,18,32.49333849063091,0.6576206140350875,41.05235042735044,1035.7905982906,27.257647323436842,0
4201,4,0,0,41,0.0,0.0,1.0,41,1150,900,250,0.782608695652174,14,9,5,327.32638755013346,0.3600609756097561,0.09537317148612212,0.2070931919666503,134218.4546556544,586.6483809993651,134805.10303665377,4072,109,1214.3658536585365,38,3,18,32.46597587380143,0.6587171052631577,40.94551282051283,1036.2179487179505,27.26889338731449,0
4202,4,0,0,41,0.0,0.0,1.0,41,800,500,300,0.625,11,5,6,330.3723728287546,0.3603912601626016,0.10000370109922607,0.1997388932973847,132532.0434570313,556.9851345486129,133089.02859157993,4073,110,1215.3658536585365,39,2,20,34.073617433822264,0.640224358974359,42.578125,1029.6875000000005,26.402243589743602,6
4203,4,0,0,41,0.0,0.0,1.0,41,1050,700,350,0.6666666666666666,14,7,7,331.2774425304821,0.3604928861788618,0.1036529871821108,0.2008585302994447,132639.3242730037,588.0832248264096,133227.4074978301,4074,111,1216.3658536585365,39,2,11,33.94270148650014,0.641292735042735,42.47395833333334,1030.1041666666686,26.4129273504274,0
4204,4,0,0,41,0.0,0.0,1.0,41,850,400,450,0.47058823529411764,13,4,9,333.74762027552197,0.3601371951219512,0.10042113360882854,0.20279063020672405,132719.81336805577,658.9843750000205,133378.7977430558,4075,112,1217.3658536585365,39,2,12,33.798355573527424,0.642094017094017,42.39583333333334,1030.4166666666686,26.42094017094022,0
4205,4,0,0,41,0.0,0.0,1.0,41,1050,600,450,0.5714285714285714,15,6,9,334.4170097171244,0.3596290650406504,0.0943332536669137,0.20421924609437506,132907.71620008704,689.3202039930809,133597.03640408014,4076,113,1218.3658536585365,39,2,14,33.59272401252652,0.6439636752136751,42.21354166666668,1031.1458333333353,26.439636752136803,0
4206,4,0,0,41,0.0,0.0,1.0,41,1150,900,250,0.782608695652174,14,9,5,338.913760426814,0.35983231707317076,0.1003689818760436,0.2074118699472382,132988.2866753473,814.3120659722331,133802.59874131953,4077,114,1219.3658536585365,39,2,14,33.3960311048273,0.6447649572649572,42.13541666666667,1031.4583333333342,26.447649572649595,0
4207,4,0,0,41,0.0,0.0,1.0,41,900,500,400,0.5555555555555556,13,5,8,338.91403745989606,0.36016260162601627,0.10617856632836453,0.20801006537036756,133095.75195312512,821.6037326389043,133917.35568576402,4078,115,1220.3658536585365,39,2,15,33.28832693990175,0.6458333333333333,42.03125000000001,1031.875000000001,26.458333333333357,0
4208,4,0,0,41,0.0,0.0,1.0,41,950,600,350,0.631578947368421,13,6,7,339.7581258572355,0.3599847560975609,0.10509217100243617,0.2091306228102614,133203.26063368074,851.3780381944637,134054.6386718752,4079,116,1221.3658536585365,39,2,16,33.15884628321561,0.6469017094017093,41.92708333333334,1032.2916666666683,26.469017094017136,0
4209,4,1,0,42,0.023809523809523808,0.0,1.0,42,1250,1000,250,0.8,15,10,5,336.23829344432863,0.3635791715060008,0.11021505376344098,0.2084677419354839,133472.2222222223,575.6944444444545,134047.91666666677,4080,0,1193.2619047619048,40,2,18,32.98051075268816,0.6479166666666667,41.66666666666667,1033.3333333333342,25.833333333333353,0
4210,4,0,0,42,0.0,0.0,1.0,42,500,300,200,0.6,7,3,4,336.4954091242892,0.3630952380952381,0.11259198921408942,0.20921951721346402,133577.25642805215,589.6267102915037,134166.88313834366,4081,1,1194.2619047619048,40,2,19,32.868822912570465,0.6489583333333333,41.56504065040651,1033.7398373983744,25.84349593495936,0
4211,4,0,0,42,0.0,0.0,1.0,42,400,200,200,0.5,6,2,4,336.86417931545816,0.3632404181184669,0.11208240299953709,0.20959751046948955,133603.52143441397,601.2481203318113,134204.76955474578,4082,2,1195.2619047619048,40,2,19,32.8330302434549,0.64921875,41.53963414634146,1033.8414634146336,25.84603658536584,0
4212,4,0,0,42,0.0,0.0,1.0,42,1050,700,350,0.6666666666666666,14,7,7,336.30899918258274,0.36328881145954317,0.10544083998933185,0.20984774277628104,133708.60727947977,593.4815792517663,134302.08885873153,4083,3,1196.2619047619048,40,2,13,32.74233565883856,0.6502604166666668,41.4380081300813,1034.2479674796746,25.856199186991866,0
4213,4,0,0,42,0.0,0.0,1.0,42,1250,900,350,0.72,16,9,7,336.9564933094987,0.36340979481223384,0.10461547817869676,0.21055126736632201,133761.16569378338,614.3386666336089,134375.504360417,4084,4,1197.2619047619048,40,2,13,32.67306873628713,0.6507812500000001,41.387195121951216,1034.4512195121945,25.861280487804862,0
4214,4,0,0,42,0.0,0.0,1.0,42,750,600,150,0.8,9,6,3,335.62492368148327,0.36340979481223384,0.09976333132211734,0.21001827584518606,133813.73443593414,582.2448815189211,134395.97931745305,4085,5,1198.2619047619048,40,2,13,32.654986412598625,0.6513020833333334,41.33638211382113,1034.6544715447142,25.866361788617855,0
4215,4,0,0,42,0.0,0.0,1.0,42,800,300,500,0.375,13,3,10,335.4604519385963,0.3627322880371661,0.09370689856698733,0.21051538527385083,133918.9029037773,584.8991382444159,134503.80204202174,4086,6,1199.2619047619048,40,2,13,32.554205531009664,0.6523437500000002,41.23475609756097,1035.0609756097547,25.876524390243866,0
4216,4,0,0,42,0.0,0.0,1.0,42,1100,600,500,0.5454545454545454,16,6,10,335.4604519385963,0.3627322880371661,0.09370689856698733,0.21051538527385083,133918.9029037773,584.8991382444159,134503.80204202174,4087,7,1200.2619047619048,40,2,13,32.554205531009664,0.6523437500000002,41.23475609756097,1035.0609756097547,25.876524390243866,0
4217,4,0,0,42,0.0,0.0,1.0,42,800,500,300,0.625,11,5,6,316.9513367366086,0.3630105497483546,0.056532476004100385,0.2039825353556765,134840.88918633098,147.60001487211156,134988.4892012031,4088,8,1201.2619047619048,40,2,12,32.11574527071104,0.6614583333333333,40.34552845528456,1038.6178861788626,25.965447154471565,3
4218,4,0,0,42,0.0,0.0,1.0,42,800,600,200,0.75,10,6,4,315.29724131501945,0.3625508130081301,0.060968843654356064,0.20316784084981968,134885.50056886184,105.80524455152911,134991.30581341338,4089,9,1202.2619047619048,41,1,12,32.11439133479769,0.6603150406504066,40.30257936507937,1038.7896825396829,25.33633372048007,0
4219,4,0,1,41,0.0,0.023809523809523808,0.9761904761904762,42,1000,900,100,0.9,11,9,2,316.9348952819475,0.3627322880371661,0.05949880429544341,0.20465943854396537,134962.8025399975,154.88433799445255,135117.68687799195,4090,10,1203.2619047619048,41,1,12,31.995098975240264,0.6610772357723577,40.2281746031746,1039.0873015873017,25.343592721641503,0
4220,4,0,0,41,0.0,0.0,1.0,41,800,400,400,0.5,12,4,8,322.573585762878,0.3588668699186992,0.07200906434492227,0.20835849111973662,134972.8597085896,507.7358673739331,135480.59557596353,4091,128,1233.3658536585365,40,1,14,31.83863080684597,0.6627604166666666,40.21849593495936,1039.1260162601636,25.978150406504092,0
4221,4,0,0,41,0.0,0.0,1.0,41,850,400,450,0.47058823529411764,13,4,9,323.0171028971214,0.3577997967479675,0.07216440760418585,0.2091024638247947,135052.0730054861,524.8258724965276,135576.89887798263,4092,129,1234.3658536585365,40,1,16,31.74842751922827,0.6635416666666667,40.142276422764226,1039.4308943089427,25.98577235772357,0
4222,4,0,0,41,0.0,0.0,1.0,41,750,500,250,0.6666666666666666,10,5,5,325.73526390573033,0.35785060975609756,0.07474429583005504,0.21117057983242205,135104.89477989287,601.6857112168591,135706.58049110972,4093,130,1235.3658536585365,40,1,17,31.625325839035526,0.6640625,40.09146341463414,1039.6341463414628,25.990853658536572,0
4223,4,0,0,41,0.0,0.0,1.0,41,900,600,300,0.6666666666666666,12,6,6,327.4063895142223,0.35792682926829267,0.07884471028393714,0.21303270163242632,135236.99440024124,655.4912130676122,135892.48561330885,4094,131,1236.3658536585365,40,1,17,31.450700211691906,0.6653645833333334,39.96443089430894,1040.1422764227639,26.003556910569095,0
4224,4,0,0,41,0.0,0.0,1.0,41,900,700,200,0.7777777777777778,11,7,4,329.5150756835937,0.3569867886178862,0.07493330792682884,0.2151935188137755,135369.1585696345,721.2357062594998,136090.394275894,4095,132,1237.3658536585365,40,1,19,31.26464843749999,0.6666666666666667,39.83739837398374,1040.6504065040651,26.01626016260163,0
4225,4,0,0,41,0.0,0.0,1.0,41,850,500,350,0.5882352941176471,12,5,7,328.95179978232574,0.3566310975609756,0.07352552486766695,0.21530052940385694,135448.48805481187,711.2047846850364,136159.6928394969,4096,133,1238.3658536585365,40,1,20,31.20057600312409,0.6674479166666667,39.761178861788615,1040.955284552845,26.023882113821124,0
4226,4,1,0,42,0.023809523809523808,0.0,1.0,42,800,700,100,0.875,9,7,2,320.97048881936433,0.36088124274099886,0.07344225303837426,0.21164586682004632,135715.0729709202,312.35969458232694,136027.43266550254,4097,0,1209.857142857143,39,3,21,31.144094271718465,0.6717414529914529,39.505208333333336,1041.9791666666672,26.717414529914542,0
4227,4,0,0,42,0.0,0.0,1.0,42,1400,1100,300,0.7857142857142857,17,11,6,321.7285280494033,0.3600222609368951,0.08070117846319258,0.21311587274960148,135877.93104383687,343.16134982639477,136221.09239366328,4098,1,1210.857142857143,39,3,14,30.963070736337308,0.673344017094017,39.348958333333336,1042.6041666666672,26.733440170940185,0
4228,4,0,0,42,0.0,0.0,1.0,42,750,500,250,0.6666666666666666,10,5,5,321.7285280494033,0.3600222609368951,0.08070117846319258,0.21311587274960148,135877.93104383687,343.16134982639477,136221.09239366328,4099,2,1211.857142857143,39,3,14,30.963070736337308,0.673344017094017,39.348958333333336,1042.6041666666672,26.733440170940185,0
4229,4,0,1,41,0.0,0.023809523809523808,0.9761904761904762,42,1450,1200,250,0.8275862068965517,17,12,5,322.7075150850785,0.36026422764227645,0.07919466598184277,0.21441740866270004,135986.55734592007,376.77680121527385,136363.33414713535,4100,3,1212.857142857143,39,3,15,30.830025133992496,0.6744123931623932,39.244791666666664,1043.0208333333328,26.744123931623918,0
4230,4,0,0,41,0.0,0.0,1.0,41,1000,700,300,0.7,13,7,6,329.22954421981706,0.35543699186991873,0.07289331423901402,0.21812295465316983,135884.19676610763,747.4184335962992,136631.61519970393,4101,138,1243.3658536585365,38,3,15,30.76134849882159,0.6751644736842106,39.34294871794871,1042.6282051282037,27.437584345479046,0
4231,4,0,0,41,0.0,0.0,1.0,41,600,400,200,0.6666666666666666,8,4,4,328.30124002743923,0.35513211382113824,0.07480551880736086,0.2178014389605497,135932.23876953125,725.3445095486125,136657.58327907987,4102,139,1244.3658536585365,39,2,15,30.737959078347142,0.6738782051282052,39.296875,1042.8125,26.73878205128205,0
4232,4,0,0,41,0.0,0.0,1.0,41,550,300,250,0.5454545454545454,8,3,5,341.72208389354785,0.35513211382113824,0.06564467347706993,0.2072613930393726,132652.0314543898,881.2221218307495,133533.25357622054,4103,140,1245.3658536585365,37,4,17,33.66096771332268,0.6449887387387387,42.46162280701754,1030.1535087719296,27.841986723565665,5
4233,4,1,0,42,0.023809523809523808,0.0,1.0,42,950,700,250,0.7368421052631579,12,7,5,335.323740828163,0.3598649825783972,0.0651864462205809,0.20521481345367543,132988.28667534713,518.825954861106,133507.11263020823,4104,0,1216.6904761904761,39,3,18,33.48860499562378,0.6447649572649572,42.135416666666664,1031.4583333333328,26.44764957264956,0
4234,4,0,0,42,0.0,0.0,1.0,42,550,300,250,0.5454545454545454,8,3,5,334.5213388611326,0.35982868757259,0.06663444939724861,0.20487104630437825,133015.14892578122,499.2811414930553,133514.43006727428,4105,1,1217.6904761904761,39,3,18,33.48238328452659,0.6450320512820513,42.109375,1031.5624999999998,26.450320512820507,0
4235,4,0,0,42,0.0,0.0,1.0,42,550,400,150,0.7272727272727273,7,4,3,334.1970832958542,0.3596593108788231,0.06914497247662332,0.2049673133155065,133068.88156466995,494.2464192708143,133563.12798394077,4106,2,1218.6904761904761,39,3,18,33.43692158842336,0.6455662393162394,42.05729166666666,1031.7708333333317,26.45566239316235,0
4236,4,0,0,42,0.0,0.0,1.0,42,750,600,150,0.8,9,6,3,334.1970832958542,0.3599375725900116,0.06914497247662332,0.2049673133155065,133068.88156466995,494.2464192708143,133563.12798394077,4107,3,1219.6904761904761,39,3,18,33.43692158842336,0.6455662393162394,42.05729166666666,1031.7708333333317,26.45566239316235,0
4237,4,0,0,42,0.0,0.0,1.0,42,850,500,350,0.5882352941176471,12,5,7,333.52101995631006,0.3595625241966705,0.07435933506834558,0.2048944922962084,133131.14636005333,480.4071443915425,133611.55350444486,4108,4,1220.6904761904761,40,2,18,33.392007221401606,0.6445312500000002,41.996951219512184,1032.0121951219496,25.800304878048742,0
4238,4,0,0,42,0.0,0.0,1.0,42,1400,800,600,0.5714285714285714,20,8,12,330.72414253780767,0.3588245257452574,0.07081470651634048,0.20418096819375448,133314.74837233115,418.08116861655157,133732.82954094769,4109,5,1221.6904761904761,40,2,21,33.28044020205997,0.6463541666666668,41.819105691056905,1032.7235772357712,25.818089430894283,0
4239,4,1,1,42,0.023255813953488372,0.023255813953488372,0.9767441860465116,43,1150,900,250,0.782608695652174,14,9,5,320.7454238900041,0.36378737541528244,0.06781844267515136,0.19960472456485978,133610.2564673278,-28.745478793071598,133581.51098853472,4110,0,1194.2558139534883,38,5,21,33.24291274844133,0.6526864035087719,41.53311965811966,1033.8675213675215,27.207040035987408,0
4240,4,0,0,42,0.0,0.0,1.0,42,1100,800,300,0.7272727272727273,14,8,6,332.04770716511575,0.35974399922570655,0.08788822087262615,0.1965000401061827,131721.78578985826,347.58339104338336,132069.36918090165,4111,7,1223.6904761904761,37,5,18,34.8447625151321,0.6356981981981983,43.36622807017543,1026.535087719297,27.744191559981,2
4241,4,0,0,42,0.0,0.0,1.0,42,1850,1700,150,0.918918918918919,20,17,3,334.1429082798852,0.3598165892373209,0.09059512373633405,0.19876729572534874,131918.83710612872,415.94877750844955,132334.78588363717,4112,8,1224.6904761904761,37,5,20,34.592694880278934,0.637668918918919,43.17434210526315,1027.3026315789466,27.764935988620177,0
4242,4,0,0,42,0.0,0.0,1.0,42,500,300,200,0.6,7,3,4,333.23135554900017,0.3598528842431281,0.08979519235655853,0.19837216019657736,131946.99931709736,393.7754886118536,132340.77480570922,4113,9,1225.6904761904761,37,5,20,34.58778014941301,0.6379504504504505,43.14692982456139,1027.4122807017527,27.76789947842575,0
4243,4,0,0,42,0.0,0.0,1.0,42,900,600,300,0.6666666666666666,12,6,6,330.4861728455642,0.3586672473867596,0.07926178792404515,0.19732340027097572,132059.67821829783,328.77952831638675,132388.4577466142,4114,10,1226.6904761904761,37,5,20,34.545018135267746,0.6390765765765767,43.037280701754376,1027.8508771929814,27.779753437648147,0
4244,4,1,0,43,0.023255813953488372,0.0,1.0,43,800,500,300,0.625,11,5,6,325.0425457500471,0.3623108157991879,0.09315363516958985,0.19567561254152802,132370.51647308026,5.209931331692587,132375.72640441195,4115,0,1199.139534883721,38,5,21,34.37283707087486,0.6403508771929827,42.73504273504272,1029.0598290598266,27.08052181736386,0
4245,4,1,1,43,0.022727272727272728,0.022727272727272728,0.9772727272727273,44,1050,700,350,0.6666666666666666,14,7,7,317.9798175208569,0.3656404157857646,0.09024619196005168,0.19271628424457593,132623.79410010757,-365.65632348771214,132258.13777661984,4116,0,1172.8636363636363,37,7,22,34.3007061244766,0.6447072072072073,42.48903508771929,1030.0438596491215,27.83902323376004,0
4246,4,0,0,43,0.0,0.0,1.0,43,1000,500,500,0.5,15,5,10,323.04867412707665,0.3617801771871539,0.09199296629269149,0.19520122587215216,132510.87474030445,-38.50752154512051,132472.36721875935,4117,2,1201.139534883721,37,6,22,34.28336883209088,0.6435810810810811,42.5986842105263,1029.6052631578928,27.827169274537642,0
4247,4,0,0,43,0.0,0.0,1.0,43,850,700,150,0.8235294117647058,10,7,3,326.4886392589113,0.36145717977113323,0.09190428328819511,0.19787317917407796,132623.79410010754,60.03241381961473,132683.82651392714,4118,3,1202.139534883721,37,6,23,34.0815946348733,0.6447072072072073,42.48903508771929,1030.0438596491213,27.839023233760035,0
4248,4,0,0,43,0.0,0.0,1.0,43,900,600,300,0.6666666666666666,12,6,6,326.4886392589113,0.36120339608711705,0.09190428328819511,0.19787317917407796,132623.79410010754,60.03241381961473,132683.82651392714,4119,4,1203.139534883721,37,6,23,34.0815946348733,0.6447072072072073,42.48903508771929,1030.0438596491213,27.839023233760035,0
4249,4,0,0,43,0.0,0.0,1.0,43,950,700,250,0.7368421052631579,12,7,5,327.1720020348687,0.3609496124031008,0.09063728256457448,0.19858579658395506,132680.2718144044,81.85403200984693,132762.12584641424,4120,5,1204.139534883721,37,6,14,34.007379026536114,0.6452702702702702,42.43421052631579,1030.2631578947367,27.84495021337126,0
4250,4,0,0,43,0.0,0.0,1.0,43,1450,1100,350,0.7586206896551724,18,11,7,332.38411661799097,0.3611111111111111,0.09851878049805962,0.20281686233348276,132878.0384950177,233.3098886195722,133111.3483836373,4121,6,1205.139534883721,37,6,16,33.674868836187045,0.647240990990991,42.24232456140351,1031.030701754386,27.865694642010432,0
4251,4,0,0,43,0.0,0.0,1.0,43,800,500,300,0.625,11,5,6,333.13878037002803,0.3608803986710964,0.10230184087919003,0.2034309799090742,132906.30290089262,255.24873037857708,133161.5516312712,4122,7,1206.139534883721,37,6,16,33.627091308662976,0.6475225225225225,42.21491228070175,1031.1403508771932,27.868658131816034,0
4252,4,0,0,43,0.0,0.0,1.0,43,1350,900,450,0.6666666666666666,18,9,9,334.69519818757124,0.3607650424510889,0.09654858702450664,0.20484565578077313,132991.1141529125,302.29746171899546,133293.41161463148,4123,8,1207.139534883721,37,6,17,33.50197990857872,0.648367117117117,42.13267543859649,1031.4692982456145,27.877548601232824,0
4253,4,0,0,43,0.0,0.0,1.0,43,900,700,200,0.7777777777777778,11,7,4,322.55006674676144,0.3607650424510889,0.10684189519211484,0.18656527416485444,130845.5582030267,-107.56991761897791,130737.98828540772,4124,9,1208.139534883721,41,2,13,35.97108423025955,0.6201727642276422,44.221230158730165,1023.1150793650803,24.95402632597757,6
4254,4,2,2,43,0.044444444444444446,0.044444444444444446,0.9555555555555556,45,1450,1200,250,0.8275862068965517,17,12,5,313.2652956631965,0.3671717171717172,0.11783939207229444,0.18302000534966456,131231.07854109284,-777.9714761248717,130453.10706496796,4125,0,1155.4,43,2,14,35.82024029574861,0.6211240310077519,43.844696969696976,1024.621212121213,23.828400281888673,0
4255,4,0,0,43,0.0,0.0,1.0,43,1350,1100,250,0.8148148148148148,16,11,5,324.6259064967194,0.36157253599114064,0.12637716685517075,0.18888323601235277,131074.03175390535,-89.99472474173194,130984.03702916362,4126,1,1209.6511627906978,41,2,14,35.6875282567978,0.6224593495934958,43.99801587301588,1024.0079365079373,24.975803329461886,0
4256,4,0,0,43,0.0,0.0,1.0,43,1500,1100,400,0.7333333333333333,19,11,8,320.94204963980104,0.3617801771871539,0.1284380669635492,0.1876153772769983,131253.64428407256,-175.03727615526822,131078.6070079173,4127,2,1210.6511627906978,42,1,15,35.60086682427106,0.6227678571428571,43.822674418604656,1024.7093023255823,24.39784053156148,0
4257,4,1,0,44,0.022727272727272728,0.0,1.0,44,950,700,250,0.7368421052631579,12,7,5,316.9004336130557,0.3670388477801268,0.1421663442940042,0.18660310270837094,131531.5767510707,-463.4750061864061,131068.1017448843,4128,0,1184.1136363636363,41,3,16,35.42472598323661,0.6270325203252034,43.5515873015873,1025.79365079365,25.019357336430485,0
4258,4,1,0,45,0.022222222222222223,0.0,1.0,45,1100,900,200,0.8181818181818182,13,9,4,310.09012621031326,0.37117003367003365,0.15046864188211595,0.18400532797183097,131825.20300012027,-824.4612327985029,131000.74176732176,4129,0,1158.7777777777778,42,3,16,35.3044206454048,0.6284722222222222,43.265503875968996,1026.9379844961247,24.450904392764876,0
4259,4,1,0,46,0.021739130434782608,0.0,1.0,46,1000,800,200,0.8,12,8,4,305.62454346238076,0.3761976650563607,0.15663924794359496,0.18238884045335663,132040.89506172866,-1129.0123456789925,130911.88271604967,4130,0,1134.5652173913043,44,2,17,35.202702702702695,0.6278409090909091,43.055555555555564,1027.7777777777799,23.358585858585908,0
4260,4,0,0,46,0.0,0.0,1.0,46,800,400,400,0.5,12,4,8,306.3386817216707,0.37626811594202897,0.1586206491385418,0.18292983893449546,132064.68728566545,-1108.6955589849015,130955.99172668056,4131,1,1135.5652173913043,44,2,17,35.16049605140677,0.6280776515151515,43.03240740740741,1027.8703703703716,23.360690235690264,0
4261,4,0,0,46,0.0,0.0,1.0,46,1050,800,250,0.7619047619047619,13,8,5,304.4931104610118,0.37597624798711754,0.15698612329282002,0.18217087815512292,132136.07681755858,-1153.0949931412629,130982.98182441732,4132,2,1136.5652173913043,44,2,17,35.136362271854004,0.6287878787878787,42.962962962962976,1028.1481481481505,23.36700336700342,0
4262,4,0,0,46,0.0,0.0,1.0,46,1200,800,400,0.6666666666666666,16,8,8,304.86827830591375,0.3764794685990338,0.1593615671904729,0.18262497836383382,132183.68055555565,-1140.2777777777685,131043.40277777788,4133,3,1137.5652173913043,44,2,17,35.07901134521881,0.6292613636363635,42.91666666666667,1028.3333333333342,23.37121212121214,0
4263,4,0,0,46,0.0,0.0,1.0,46,1000,700,300,0.7,13,7,6,305.2001869853951,0.3757145732689211,0.15882675224044096,0.18328508526528334,132278.91375171475,-1125.6901577503386,131153.22359396442,4134,4,1138.5652173913043,44,2,17,34.97506000600062,0.6302083333333333,42.824074074074076,1028.7037037037042,23.37962962962964,0
4264,4,0,0,46,0.0,0.0,1.0,46,1550,1200,350,0.7741935483870968,19,12,7,303.39785933222936,0.3752415458937198,0.1609751804259807,0.18277871037819693,132398.00347222234,-1166.09224965706,131231.91122256528,4135,5,1139.5652173913043,43,3,18,34.9021592442645,0.6327519379844961,42.708333333333336,1029.1666666666674,23.9341085271318,0
4265,4,0,0,46,0.0,0.0,1.0,46,500,200,300,0.4,8,2,6,303.4121030381453,0.3750905797101449,0.1586890530449978,0.18314230828027098,132471.1077841627,-1161.3325190828687,131309.77526507984,4136,6,1140.5652173913043,43,3,18,34.82861512280378,0.6334786821705427,42.63731060606061,1029.4507575757582,23.940715292459494,0
4266,4,0,0,46,0.0,0.0,1.0,46,1000,600,400,0.6,14,6,8,304.3401588087317,0.3747181964573269,0.16080239262380913,0.18405978236296724,132544.23227301432,-1132.2934601698728,131411.93881284446,4137,7,1141.5652173913043,43,3,18,34.731546195818765,0.634205426356589,42.56628787878788,1029.7348484848492,23.94732205778719,0
4267,4,0,0,46,0.0,0.0,1.0,46,1150,900,250,0.782608695652174,14,9,5,304.8714017664689,0.375,0.15693465669482065,0.18474018033503523,132617.37693877693,-1113.7508788165808,131503.62605996034,4138,8,1142.5652173913043,43,3,19,34.64468220403909,0.6349321705426356,42.49526515151515,1030.018939393939,23.95392882311486,0
4268,4,0,0,46,0.0,0.0,1.0,46,1000,600,400,0.6,14,6,8,301.5478686002327,0.37477858293075683,0.14697538189824266,0.1832016950440609,132714.9345461002,-1196.018871240821,131518.9156748594,4139,9,1143.5652173913043,43,3,13,34.6327122200778,0.6359011627906977,42.40056818181818,1030.3977272727273,23.962737843551796,0
4269,4,0,1,45,0.0,0.021739130434782608,0.9782608695652174,46,1300,800,500,0.6153846153846154,18,8,10,295.22908945275395,0.3743156199677939,0.09078148252423235,0.17139776890355926,130988.61932535598,-1421.3120193411291,129567.30730601485,4140,10,1144.5652173913043,43,3,13,36.52597903176072,0.6187015503875968,44.0814393939394,1023.6742424242436,23.806377730796363,7
4270,4,0,1,44,0.0,0.022222222222222223,0.9777777777777777,45,1100,700,400,0.6363636363636364,15,7,8,299.50040089338586,0.36902356902356903,0.09027330682320334,0.17361817970559515,130931.13864100719,-1157.2142975181675,129773.92434348902,4141,12,1170.7777777777778,42,3,13,36.47450766900211,0.6195436507936507,44.13759689922481,1023.449612403101,24.367847914359547,0
4271,4,1,0,45,0.022222222222222223,0.0,1.0,45,1350,1100,250,0.8148148148148148,16,11,5,298.6767058575808,0.36952861952861954,0.10092032274331841,0.17471265714323966,131278.4688420166,-1158.035875247892,130120.4329667687,4142,0,1171.4,42,3,15,36.14630610186586,0.623015873015873,43.7984496124031,1024.8062015503867,24.40014765596159,0
4272,4,0,0,45,0.0,0.0,1.0,45,850,600,250,0.7058823529411765,11,6,5,297.77248992002126,0.3689604377104377,0.09647696476964773,0.17440960123886945,131328.12499999985,-1178.8194444444598,130149.30555555539,4143,1,1172.4,42,3,15,36.119579945799444,0.6235119047619049,43.74999999999999,1024.9999999999989,24.404761904761877,0
4273,4,0,0,45,0.0,0.0,1.0,45,650,300,350,0.46153846153846156,10,3,7,296.3584567548772,0.36879208754208753,0.09369834819225265,0.17391951363967564,131402.62684221187,-1211.5440591010258,130191.08278311085,4144,2,1173.4,42,3,16,36.08098635919731,0.6242559523809523,43.677325581395344,1025.2906976744175,24.41168327796232,0
4274,4,0,0,45,0.0,0.0,1.0,45,1250,1100,150,0.88,14,11,3,294.057830499337,0.36887626262626266,0.08915146107059746,0.17322068938549842,131546.61068246374,-1263.537810634768,130283.07287182898,4145,3,1174.4,43,2,17,35.995434474906915,0.6242732558139534,43.53693181818181,1025.8522727272718,23.857029598308646,0
4275,4,1,1,45,0.021739130434782608,0.021739130434782608,0.9782608695652174,46,950,600,350,0.631578947368421,13,6,7,289.3532591033898,0.3725342190016103,0.09298090155931948,0.17149322769628494,131779.3220593279,-1573.8447359396466,130205.47732338826,4146,0,1149.8478260869565,44,2,13,35.882781735653936,0.6252367424242424,43.31018518518518,1026.7592592592596,23.335437710437716,0
4276,4,0,0,45,0.0,0.0,1.0,45,850,700,150,0.8235294117647058,10,7,3,295.1739965056348,0.36841329966329966,0.0892169526972999,0.1744327030604181,131668.07008293146,-1227.0019082874278,130441.06817464402,4147,5,1176.4,43,2,13,35.84494371655288,0.6254844961240311,43.4185606060606,1026.3257575757566,23.868040873854806,0
4277,4,0,0,45,0.0,0.0,1.0,45,1150,1000,150,0.8695652173913043,13,10,3,293.2286335395188,0.36940235690235695,0.09239722939464667,0.17394810186556572,131813.8953455005,-1269.6783172635498,130544.21702823695,4148,6,1177.4,43,2,13,35.74864748555267,0.626937984496124,43.27651515151515,1026.8939393939395,23.88125440451022,0
4278,4,0,0,45,0.0,0.0,1.0,45,700,500,200,0.7142857142857143,9,5,4,294.85200703091675,0.36936026936026933,0.09313339888561112,0.17535935154996632,131911.15702479339,-1221.1461202938528,130690.01090449953,4149,7,1178.4,43,2,13,35.609482546706005,0.627906976744186,43.18181818181818,1027.2727272727273,23.890063424947144,0
4279,4,1,1,45,0.021739130434782608,0.021739130434782608,0.9782608695652174,46,1050,700,350,0.6666666666666666,14,7,7,291.3838090463489,0.374194847020934,0.10123720220034049,0.17443758487653382,132159.8776148833,-1498.1502914952102,130661.72732338808,4150,0,1153.7608695652175,44,2,13,35.44949722347291,0.6290246212121213,42.93981481481481,1028.2407407407397,23.369107744107723,0
4280,4,1,0,46,0.021739130434782608,0.0,1.0,46,1200,800,400,0.6666666666666666,16,8,8,292.0601701741975,0.3743357487922705,0.10853130270433131,0.17550462686887536,132302.7274091219,-1471.9285836762879,130830.79882544561,4151,0,1154.7391304347825,44,2,14,35.28916539165391,0.6304450757575759,42.80092592592592,1028.796296296295,23.381734006733975,0
4281,4,0,0,46,0.0,0.0,1.0,46,1150,900,250,0.782608695652174,14,9,5,291.92414233965496,0.3739935587761675,0.11045590565041397,0.17586649550706032,132398.0034722221,-1469.9309842249754,130928.07248799712,4152,1,1155.7391304347825,43,3,15,35.19736842105263,0.6327519379844961,42.70833333333333,1029.1666666666656,23.93410852713176,0
4282,4,0,0,46,0.0,0.0,1.0,46,950,700,250,0.7368421052631579,12,7,5,290.41621775791356,0.3742954911433172,0.10575976960921607,0.17518447763754275,132446.7374383035,-1507.063891758488,130939.67354654502,4153,2,1156.7391304347825,43,3,15,35.18744250229992,0.6332364341085273,42.66098484848485,1029.3560606060607,23.93851303735025,0
4283,4,0,0,46,0.0,0.0,1.0,46,1000,800,200,0.8,12,8,4,289.65124078554913,0.37446658615136874,0.10886762947290918,0.17483612651747402,132471.10778416274,-1525.9158524162003,130945.19193174654,4154,3,1157.7391304347825,43,3,15,35.182768374574536,0.6334786821705427,42.63731060606061,1029.4507575757584,23.940715292459497,0
4284,4,0,0,46,0.0,0.0,1.0,46,800,400,400,0.5,12,4,8,290.3919113146744,0.374969806763285,0.10962735775494936,0.1755103530697306,132519.85520151796,-1503.4611921774635,131016.3940093405,4155,4,1158.7391304347825,43,3,15,35.11498283209171,0.6339631782945736,42.58996212121212,1029.640151515151,23.945119802677933,0
4285,4,0,0,46,0.0,0.0,1.0,46,1000,800,200,0.8,12,8,4,292.5904789704695,0.3750503220611916,0.11841789660520963,0.17718341031641555,132592.99314164364,-1440.9105257116676,131152.08261593198,4156,5,1159.7391304347825,43,3,15,34.98528870908421,0.6346899224806202,42.51893939393939,1029.9242424242418,23.951726568005622,0
4286,4,0,0,46,0.0,0.0,1.0,46,1300,1000,300,0.7692307692307693,16,10,6,294.2349353191683,0.3753119967793881,0.11970311038633996,0.17841068151627168,132641.76297778933,-1394.4318899219375,131247.33108786738,4157,6,1160.7391304347825,43,3,12,34.894205429919715,0.6351744186046512,42.471590909090914,1030.113636363637,23.956131078224114,0
4287,4,0,0,46,0.0,0.0,1.0,46,1550,1400,150,0.9032258064516129,17,14,3,305.8130773641405,0.3753119967793881,0.13305149268683647,0.18211151972562672,131959.80131571376,-1128.9934142562165,130830.80790145755,4158,7,1161.7391304347825,43,3,12,35.27918586789555,0.6283914728682172,43.13446969696969,1027.4621212121197,23.894467935165572,2
4288,4,0,0,46,0.0,0.0,1.0,46,700,400,300,0.5714285714285714,10,4,6,304.92400945162245,0.3756239935587762,0.13427463454304367,0.1819318457712179,132032.78456618715,-1148.006790203201,130884.77777598395,4159,8,1162.7391304347825,43,3,12,35.22883457722902,0.6291182170542637,43.063446969696955,1027.7462121212097,23.90107470049325,0
4289,4,0,0,46,0.0,0.0,1.0,46,1200,1000,200,0.8333333333333334,14,10,4,304.95278446484315,0.3758856682769726,0.13162026208708522,0.1822999685104807,132105.7879935717,-1142.794421487634,130962.99357208406,4160,9,1163.7391304347825,43,3,12,35.154906656841085,0.6298449612403102,42.99242424242423,1028.0303030303,23.907681465820932,0
4290,4,0,0,46,0.0,0.0,1.0,46,1200,1000,200,0.8333333333333334,14,10,4,306.1974095214838,0.37510064412238325,0.13260469212907333,0.18351566597148516,132203.15728305775,-1103.9471418732935,131099.21014118445,4161,10,1164.7391304347825,43,3,13,35.02532228360957,0.6308139534883722,42.897727272727266,1028.40909090909,23.91649048625791,0
4291,4,0,1,45,0.0,0.021739130434782608,0.9782608695652174,46,700,500,200,0.7142857142857143,9,5,4,278.69956876678594,0.37488929146537847,0.06739869860987824,0.16387534643487017,131477.1498107085,-1871.3315287567675,129605.81828195174,4162,11,1165.7391304347825,42,4,18,36.45892384731668,0.625,43.604651162790695,1025.5813953488373,24.41860465116279,8
4292,4,1,1,45,0.021739130434782608,0.021739130434782608,0.9782608695652174,46,1300,900,400,0.6923076923076923,17,9,8,279.717392757088,0.37723429951690823,0.06594825639404278,0.16500988701419536,131601.4017055016,-1837.759806351772,129763.64189914984,4163,0,1166.2826086956522,42,4,14,36.30831523278872,0.6262400793650793,43.48352713178295,1026.0658914728692,24.430140273163552,0
4293,4,0,0,45,0.0,0.0,1.0,45,1150,900,250,0.782608695652174,14,9,5,286.87226185888693,0.3725799663299663,0.0568923275306259,0.16892136603763622,131531.57675107082,-1453.4478143109034,130078.12893675992,4164,13,1193.2,41,4,18,36.194793681495824,0.6270325203252032,43.551587301587304,1025.7936507936508,25.01935733643051,0
4294,4,0,0,45,0.0,0.0,1.0,45,750,400,350,0.5333333333333333,11,4,7,286.8470776966101,0.3726220538720539,0.05047692704305229,0.16935765820169732,131633.3616780046,-1448.2709750566817,130185.09070294793,4165,14,1194.2,41,4,15,36.093387470997705,0.6280487804878048,43.452380952380956,1026.1904761904768,25.029036004645775,0
4295,4,0,0,45,0.0,0.0,1.0,45,850,600,250,0.7058823529411765,11,6,5,287.3522857963809,0.37367424242424246,0.04370570802731599,0.17010992296458521,131735.18597253718,-1429.1186381960224,130306.06733434115,4166,15,1195.2,41,4,15,35.978369411158326,0.6290650406504066,43.3531746031746,1026.5873015873017,25.038714672861015,0
4296,4,0,0,45,0.0,0.0,1.0,45,1550,1000,550,0.6451612903225806,21,10,11,287.04509392052887,0.37327441077441076,0.04329405704719558,0.17061222172520998,131887.99622858418,-1428.4395471151358,130459.55668146904,4167,16,1196.2,41,4,15,35.83317236494751,0.630589430894309,43.20436507936508,1027.1825396825407,25.053232675183917,0
4297,4,0,0,45,0.0,0.0,1.0,45,950,600,350,0.631578947368421,13,6,7,284.1490138787437,0.37329545454545454,0.04018018018018066,0.16957279860505678,132040.8950617284,-1496.1419753086388,130544.75308641976,4168,17,1197.2,41,4,15,35.75450450450452,0.6321138211382114,43.05555555555556,1027.7777777777778,25.067750677506776,0
4298,4,0,0,45,0.0,0.0,1.0,45,950,800,150,0.8421052631578947,11,8,3,280.8574525630611,0.3733796296296296,0.03450405248938604,0.16806042946671865,132142.87682665666,-1577.3376480221664,130565.5391786345,4169,18,1198.2,41,4,16,35.73708671040782,0.6331300813008129,42.95634920634921,1028.1746031746038,25.077429345722045,0
4299,4,0,0,45,0.0,0.0,1.0,45,950,700,250,0.7368421052631579,12,7,5,281.24599798536343,0.3731902356902357,0.04163693059440021,0.16886159543197635,132270.4093935027,-1559.8953412383567,130710.51405226433,4170,19,1199.2,41,4,17,35.59960378692899,0.6344004065040652,42.832341269841265,1028.6706349206343,25.08952768099108,0
4300,4,0,0,45,0.0,0.0,1.0,45,850,400,450,0.47058823529411764,13,4,9,281.1027656553237,0.3734006734006734,0.04399871423979396,0.168889668588975,132295.92328829685,-1562.2500157470374,130733.67327254982,4171,20,1200.2,41,4,17,35.57778849244615,0.6346544715447153,42.807539682539684,1028.7698412698417,25.09194734804492,0
4301,4,0,0,45,0.0,0.0,1.0,45,1750,1300,450,0.7428571428571429,22,13,9,282.8265960454776,0.37380050505050505,0.0401914490379367,0.17073249489028036,132474.58944515302,-1506.532560941047,130968.05688421197,4172,21,1201.2,41,4,17,35.35493157945456,0.6364329268292683,42.63392857142857,1029.4642857142853,25.108885017421592,0
4302,4,0,0,45,0.0,0.0,1.0,45,1000,900,100,0.9,11,9,2,285.7830198135589,0.3728535353535354,0.045472061657033214,0.17286874974736255,132551.19756235825,-1423.8236961451228,131127.37386621314,4173,22,1202.2,41,4,18,35.20231213872834,0.6371951219512195,42.55952380952381,1029.7619047619046,25.11614401858304,0
4303,4,0,0,45,0.0,0.0,1.0,45,1400,1100,300,0.7857142857142857,17,11,6,287.8725227033725,0.37260101010101015,0.04613903331407698,0.17484467957878522,132704.48022959183,-1359.6053004535158,131344.8749291383,4174,23,1203.2,41,4,13,34.995426535721165,0.6387195121951219,42.410714285714285,1030.357142857143,25.130662020905923,0
4304,4,0,0,45,0.0,0.0,1.0,45,1300,1100,200,0.8461538461538461,15,11,4,287.3368889833193,0.3726641414141414,0.04871819552732082,0.17487656354116587,132781.1547796201,-1369.4152140022775,131411.7395656178,4175,24,1204.2,41,4,14,34.93268120127057,0.6394817073170731,42.33630952380952,1030.6547619047612,25.137921022067346,0
4305,4,0,0,45,0.0,0.0,1.0,45,1050,700,350,0.6666666666666666,14,7,7,286.70678940011345,0.37247474747474746,0.050356111645813106,0.17461216540839272,132806.71788391285,-1384.6824609473408,131422.0354229655,4176,25,1205.2,41,4,14,34.92340391401988,0.6397357723577235,42.31150793650794,1030.7539682539684,25.14034068912118,0
4306,4,0,0,45,0.0,0.0,1.0,45,1300,1200,100,0.9230769230769231,14,12,2,285.08069907308413,0.3720117845117845,0.04681584881786938,0.17410228447598508,132910.1573709395,-1421.9758845557853,131488.18148638372,4177,26,1206.2,43,2,15,34.86211237640431,0.6378391472868217,42.21117424242424,1031.155303030303,23.980355884425652,0
4307,4,0,0,45,0.0,0.0,1.0,45,900,400,500,0.4444444444444444,14,4,10,287.0052179978644,0.3718855218855219,0.04779797238031125,0.17585122862028899,133032.2444975323,-1363.8103334480998,131668.43416408417,4178,27,1207.2,43,2,15,34.69073190135243,0.6390503875968991,42.09280303030304,1031.6287878787891,23.99136715997184,0
4308,4,0,1,44,0.0,0.022222222222222223,0.9777777777777777,45,1400,1000,400,0.7142857142857143,18,10,8,280.17505153495557,0.3720959595959596,0.022688633115173218,0.16486794865224266,131506.1366705246,-1629.5995386312675,129876.53713189333,4179,28,1208.2,41,4,16,36.39203904310541,0.6267784552845528,43.576388888888886,1025.694444444444,25.01693766937668,2
4309,4,0,0,44,0.0,0.0,1.0,44,600,400,200,0.6666666666666666,8,4,4,285.71663093515104,0.3713002114164905,0.025623356033582567,0.1680333472842392,131484.42147531232,-1286.5428151232652,130197.87866018906,4180,29,1230.1818181818182,40,4,17,36.27171687144937,0.6281249999999999,43.59756097560976,1025.609756097561,25.64024390243903,0
4310,4,0,0,44,0.0,0.0,1.0,44,850,700,150,0.8235294117647058,10,7,3,285.4879998825385,0.37178470754052145,0.03292685123475647,0.16812811381647297,131536.54095611093,-1289.5792021944467,130246.96175391648,4181,30,1231.1818181818182,40,4,18,36.225315368866,0.6286458333333333,43.54674796747968,1025.8130081300826,25.645325203252064,0
4311,4,0,0,44,0.0,0.0,1.0,44,1300,700,600,0.5384615384615384,19,7,12,284.47446998952097,0.37137729034531364,0.03715512467808724,0.16784480565325816,131607.91175555866,-1312.1818113819652,130295.7299441767,4182,31,1232.1818181818182,41,3,11,36.17976328595829,0.6277947154471545,43.47718253968254,1026.0912698412694,25.026616337591935,0
4312,4,0,0,44,0.0,0.0,1.0,44,950,700,250,0.7368421052631579,12,7,5,283.8795549119566,0.3711680761099366,0.03786121071503867,0.16760560022884013,131633.3616780045,-1326.3959750566958,130306.9657029478,4183,32,1233.1818181818182,41,3,11,36.16951856148491,0.6280487804878049,43.45238095238095,1026.190476190476,25.029036004645754,0
4313,4,0,0,44,0.0,0.0,1.0,44,1200,800,400,0.6666666666666666,16,8,8,283.69562832512617,0.37050739957716705,0.030199794406810643,0.16783297119954727,131709.72620819163,-1326.9052933673483,130382.82091482427,4184,33,1234.1818181818182,41,3,11,36.097721561805365,0.6288109756097562,43.37797619047619,1026.4880952380954,25.036295005807204,0
4314,4,0,0,44,0.0,0.0,1.0,44,1400,1100,300,0.7857142857142857,17,11,6,284.7569838269273,0.3700669485553207,0.02752305665349164,0.16879924299018878,131786.1128826529,-1294.5967970521656,130491.51608560074,4185,34,1235.1818181818182,41,3,11,35.99396135265702,0.6295731707317074,43.30357142857142,1026.785714285713,25.043554006968613,0
4315,4,0,0,44,0.0,0.0,1.0,44,1250,1000,250,0.8,15,10,5,298.47515081873064,0.3701220049330514,0.019060092449922905,0.17401219267099863,131150.23389274653,-942.2838521983239,130207.95004054821,4186,35,1236.1818181818182,41,3,16,36.280367231638415,0.6232215447154472,43.92361111111109,1024.3055555555525,24.98306233062323,4
4316,4,0,0,44,0.0,0.0,1.0,44,1200,900,300,0.75,15,9,6,299.33793809407206,0.369813689217759,0.022327568422500388,0.17509944874352337,131278.46884201647,-940.6747641367924,130337.79407787968,4187,36,1237.1818181818182,42,2,16,36.12936522945033,0.6230158730158731,43.79844961240309,1024.8062015503858,24.400147655961568,0
4317,4,0,1,43,0.0,0.022727272727272728,0.9772727272727273,44,1200,1000,200,0.8333333333333334,14,10,4,298.5603013331864,0.3698467230443974,0.018446427087085437,0.1752372716769563,131408.21533203137,-953.3165581831813,130454.89877384818,4188,37,1238.1818181818182,39,5,16,36.01893477598293,0.6290064102564102,43.67187500000001,1025.312500000001,26.290064102564127,0
4318,4,1,1,43,0.022727272727272728,0.022727272727272728,0.9772727272727273,44,800,500,300,0.625,11,5,6,297.61225213002007,0.37109099718111344,0.03753415552765649,0.1752921925225146,131541.75347222248,-970.312499999975,130571.44097222251,4189,0,1238.3181818181818,39,5,17,35.909152450582184,0.6303418803418803,43.54166666666668,1025.8333333333355,26.30341880341886,0
4319,4,0,0,43,0.0,0.0,1.0,43,550,400,150,0.7272727272727273,7,4,3,300.9208349925072,0.3719776670358066,0.03683331719494287,0.17711700311842335,131515.04041883696,-684.8768446180363,130830.16357421892,4190,1,1250.2558139534883,39,4,17,35.851126400595774,0.6300747863247862,43.56770833333334,1025.729166666668,26.3007478632479,0
4320,4,1,1,43,0.022727272727272728,0.022727272727272728,0.9772727272727273,44,950,800,150,0.8421052631578947,11,8,3,296.69681550982983,0.37606809372797745,0.04232797092060747,0.17592867511216698,131797.29327781108,-979.2325583316582,130818.06071947943,4191,0,1222.8181818181818,40,4,14,35.67625857746108,0.6312499999999999,43.29268292682928,1026.829268292685,25.670731707317124,0
4321,4,0,0,43,0.0,0.0,1.0,43,1050,700,350,0.6666666666666666,14,7,7,302.91844634053217,0.3702934662236988,0.042429176548322456,0.17929497229345037,131728.8208007814,-619.3820529513735,131109.43874783002,4192,1,1252.2093023255813,39,4,15,35.585257060713694,0.6322115384615383,43.35937500000001,1026.5625000000011,26.322115384615415,0
4322,4,0,0,43,0.0,0.0,1.0,43,1250,800,450,0.64,17,8,9,300.31927651552894,0.36985511258767073,0.0466175035445322,0.17807664142681376,131797.29327781094,-683.7464472205608,131113.54683059038,4193,2,1253.2093023255813,40,3,16,35.583267352863544,0.6312499999999999,43.29268292682927,1026.8292682926838,25.670731707317096,0
4323,4,0,0,43,0.0,0.0,1.0,43,800,600,200,0.75,10,6,4,300.93077608416877,0.36934754521963825,0.04906620024625097,0.178561684810953,131823.3827107709,-666.057426961452,131157.32528380945,4194,3,1254.2093023255813,40,3,16,35.54139864753421,0.6315104166666666,43.26727642276423,1026.9308943089445,25.67327235772361,0
4324,4,0,0,43,0.0,0.0,1.0,43,1150,800,350,0.6956521739130435,15,8,7,306.7095752981132,0.3693706164636397,0.021756694929278897,0.1748756981831005,130289.8540799179,-578.5946696129944,129711.2594103049,4195,4,1255.2093023255813,38,5,16,36.93665410911124,0.6195175438596492,44.76495726495725,1020.9401709401686,26.866846603688646,6
4325,4,0,1,42,0.0,0.023255813953488372,0.9767441860465116,43,1100,400,700,0.36363636363636365,18,4,14,307.9294620275006,0.36943983019564414,0.022708532482978994,0.17618872450298806,130426.23325525956,-567.5840318869326,129858.64922337263,4196,5,1256.2093023255813,38,5,17,36.767859010563726,0.620888157894737,44.63141025641025,1021.4743589743579,26.880904183535733,0
4326,4,2,1,43,0.045454545454545456,0.022727272727272728,0.9772727272727273,44,1300,700,600,0.5384615384615384,19,7,12,301.3707905325936,0.3765636011275546,0.03956846188743546,0.17396589019632772,130768.17626953125,-918.0582682291665,129850.11800130208,4197,0,1228.5,39,5,15,36.59072970770953,0.6225961538461539,44.296875,1022.8125,26.22596153846154,0
4327,4,0,0,43,0.0,0.0,1.0,43,1000,700,300,0.7,13,7,6,310.08847450832457,0.3728313030638612,0.0409436423662477,0.17893170382568988,130753.83434007248,-490.9485946745369,130262.88574539794,4198,1,1258.0697674418604,38,5,15,36.382273059646934,0.6241776315789472,44.310897435897445,1022.7564102564116,26.91464237516873,0
4328,4,0,0,43,0.0,0.0,1.0,43,1200,900,300,0.75,15,9,6,310.26644170556426,0.3726467331118494,0.03859289451566994,0.17916109245410602,130781.15297866928,-484.59940463142607,130296.55357403785,4199,2,1259.0697674418604,38,5,16,36.35018452753986,0.6244517543859647,44.28418803418805,1022.8632478632501,26.91745389113816,0
4329,4,0,0,43,0.0,0.0,1.0,43,1000,500,500,0.5,15,5,10,311.1099535985969,0.37269287559985237,0.04032175949495964,0.1798358360383654,130821.45317925385,-460.0287543402387,130361.42442491361,4200,3,1260.0697674418604,39,4,16,36.28799256694838,0.6231303418803418,44.244791666666686,1023.0208333333363,26.231303418803495,0
4330,4,0,0,43,0.0,0.0,1.0,43,800,500,300,0.625,11,5,6,311.1099535985969,0.37285437430786267,0.04032175949495964,0.1798358360383654,130821.45317925385,-460.0287543402387,130361.42442491361,4201,4,1261.0697674418604,39,4,16,36.28799256694838,0.6231303418803418,44.244791666666686,1023.0208333333363,26.231303418803495,0
4331,4,0,0,43,0.0,0.0,1.0,43,900,800,100,0.8888888888888888,10,8,2,313.0404566626698,0.37285437430786267,0.03965608666010123,0.18132720791592424,130901.38888888927,-404.5138888888505,130496.87500000042,4202,5,1262.0697674418604,39,4,17,36.158048317046685,0.6239316239316237,44.166666666666686,1023.3333333333363,26.239316239316317,0
4332,4,0,0,43,0.0,0.0,1.0,43,900,700,200,0.7777777777777778,11,7,4,316.1067106784817,0.3724160206718346,0.04183460993300714,0.1836481547505781,131015.81090124926,-317.00459382642657,130698.80630742284,4203,6,1263.0697674418604,40,3,17,35.96428098736019,0.6234375,44.05487804878049,1023.7804878048781,25.594512195121954,0
4333,4,0,1,42,0.0,0.023255813953488372,0.9767441860465116,43,1450,1400,50,0.9655172413793104,15,14,1,317.1796994752692,0.3719545957918051,0.04484555351975472,0.18477092550935076,131119.87428944433,-282.2875355277798,130837.58675391655,4204,7,1264.0697674418604,40,3,17,35.831968975325765,0.6244791666666667,43.95325203252033,1024.1869918699203,25.604674796748007,0
4334,4,0,0,42,0.0,0.0,1.0,42,800,600,200,0.75,10,6,4,320.9797804892798,0.3677047038327526,0.045778458252409004,0.18685807325190498,131093.85456945281,15.695332639312369,131109.54990209214,4205,8,1293.357142857143,40,2,19,35.760891138235586,0.6242187499999999,43.97865853658537,1024.0853658536594,25.602134146341484,0
4335,4,1,0,43,0.023255813953488372,0.0,1.0,43,1250,900,350,0.72,16,9,7,318.06942372147614,0.37343115540789956,0.05765779381482239,0.18734136870867815,131541.7534722223,-231.6997777447193,131310.0536944776,4206,0,1264.2558139534883,39,4,21,35.3845112374763,0.6303418803418803,43.54166666666667,1025.8333333333342,26.303418803418825,0
4336,4,0,0,43,0.0,0.0,1.0,43,550,200,350,0.36363636363636365,9,2,7,318.06942372147614,0.37343115540789956,0.05765779381482239,0.18734136870867815,131541.7534722223,-232.11805555554588,131309.63541666677,4207,1,1265.2558139534883,39,4,21,35.3845112374763,0.6303418803418803,43.54166666666667,1025.8333333333342,26.303418803418825,0
4337,4,0,0,43,0.0,0.0,1.0,43,550,200,350,0.36363636363636365,9,2,7,318.97040340212425,0.3728082318198597,0.05694617238717403,0.1882670727330332,131621.90890842004,-203.30132378472706,131418.60758463532,4208,2,1266.2558139534883,39,4,17,35.28078790647312,0.6311431623931625,43.463541666666664,1026.1458333333326,26.311431623931604,0
4338,4,1,0,44,0.022727272727272728,0.0,1.0,44,1250,700,550,0.56,18,7,11,314.47772255019,0.3776757399577167,0.07029964298240099,0.1871133194384853,131927.76626222802,-502.3313049441638,131425.43495728387,4209,0,1238.4545454545455,40,4,18,35.088782273221874,0.6325520833333333,43.16565040650406,1027.3373983739823,25.683434959349558,0
4339,4,0,0,44,0.0,0.0,1.0,44,1150,700,450,0.6086956521739131,16,7,9,313.1941636581678,0.3777087737843552,0.06966969936708867,0.1867346334263792,132006.08103642007,-531.2931704012226,131474.78786601886,4210,1,1239.4545454545455,40,4,18,35.04314181170886,0.6333333333333333,43.08943089430894,1027.6422764227639,25.691056910569095,0
4340,4,0,0,44,0.0,0.0,1.0,44,1000,700,300,0.7,13,7,6,311.6986491690459,0.3778409090909091,0.06336496638987721,0.18635600088617416,132110.53688280782,-564.2648225262795,131546.27206028154,4211,2,1240.4545454545455,40,4,19,34.97676947410042,0.6343750000000001,42.98780487804878,1028.0487804878046,25.701219512195117,0
4341,4,0,0,44,0.0,0.0,1.0,44,1200,700,500,0.5833333333333334,17,7,10,314.67000734271755,0.37790697674418605,0.07014013654329854,0.18865287170072859,132215.0340405841,-479.17885352636074,131735.85518705775,4212,3,1241.4545454545455,40,4,20,34.795578063241095,0.6354166666666667,42.88617886178861,1028.455284552844,25.7113821138211,0
4342,4,0,0,44,0.0,0.0,1.0,44,1000,600,400,0.6,14,6,8,313.11841529860396,0.3775876497533474,0.07245651217299964,0.1881126242176714,132293.43401951526,-515.2979170798045,131778.13610243547,4213,4,1242.4545454545455,40,4,20,34.7568655536896,0.6361979166666668,42.809959349593484,1028.7601626016242,25.719004065040604,0
4343,4,0,0,44,0.0,0.0,1.0,44,1400,900,500,0.6428571428571429,19,9,10,314.13285725840507,0.37691596194503174,0.07160100511531953,0.1896403959492038,132476.45767235098,-476.95836638245777,131999.49930596852,4214,5,1243.4545454545455,40,4,20,34.54734287594602,0.6380208333333335,42.632113821138205,1029.471544715446,25.736788617886152,0
4344,4,0,0,44,0.0,0.0,1.0,44,900,700,200,0.7777777777777778,11,7,4,312.379927016269,0.37702607470049326,0.0711914885982381,0.189107418182967,132581.09941998802,-516.8651678894971,132064.2342520985,4215,6,1244.4545454545455,40,4,21,34.48765706203538,0.6390625000000001,42.53048780487804,1029.878048780487,25.746951219512177,0
4345,4,0,0,44,0.0,0.0,1.0,44,950,800,150,0.8421052631578947,11,8,3,312.379927016269,0.37702607470049326,0.0711914885982381,0.189107418182967,132581.09941998802,-516.8651678894971,132064.2342520985,4216,7,1245.4545454545455,40,4,21,34.48765706203538,0.6390625000000001,42.53048780487804,1029.878048780487,25.746951219512177,0
4346,4,0,0,44,0.0,0.0,1.0,44,650,400,250,0.6153846153846154,9,4,5,310.7761061875826,0.37649753347427767,0.07288200206305762,0.18826753354519715,132607.26631180177,-557.7660246876956,132049.50028711406,4217,8,1246.4545454545455,40,4,21,34.50275448117085,0.6393229166666667,42.505081300813,1029.9796747967473,25.749491869918682,0
4347,4,0,0,44,0.0,0.0,1.0,44,1150,600,550,0.5217391304347826,17,6,11,311.47190951654943,0.3767838266384778,0.07148205942227825,0.18895216916632301,132659.60784131457,-536.051725989837,132123.55611532473,4218,9,1247.4545454545455,40,4,15,34.432442208411416,0.6398437500000002,42.45426829268292,1030.1829268292672,25.754573170731682,0
4348,4,0,0,44,0.0,0.0,1.0,44,1000,700,300,0.7,13,7,6,309.8215370358121,0.37651955602536996,0.07713736317917386,0.18847631716137783,132764.32188388178,-573.3507460836961,132190.9711377981,4219,10,1248.4545454545455,40,4,15,34.37017223810932,0.6408854166666667,42.352642276422756,1030.5894308943077,25.764735772357692,0
4349,4,0,0,44,0.0,0.0,1.0,44,1150,900,250,0.782608695652174,14,9,5,307.7164262598436,0.3762773079633545,0.07250100810968241,0.18771997260409562,132869.07723783777,-622.8004783858976,132246.27675945187,4220,11,1249.4545454545455,40,4,16,34.319656645309664,0.6419270833333335,42.251016260162594,1030.9959349593485,25.77489837398371,0
4350,4,0,0,44,0.0,0.0,1.0,44,1050,1000,50,0.9523809523809523,11,10,1,309.7272649542702,0.37580382311486965,0.06897007318231063,0.18947691452808246,132973.87390318266,-562.8731451186482,132411.000758064,4221,12,1250.4545454545455,40,4,18,34.16305383124774,0.64296875,42.14939024390244,1031.4024390243903,25.78506097560976,0
4351,4,0,0,44,0.0,0.0,1.0,44,1100,900,200,0.8181818181818182,13,9,4,307.36459249227954,0.37534134954193094,0.06525836519434436,0.18856028444556586,133078.71187991608,-619.263190726421,132459.44868918965,4222,13,1251.4545454545455,40,4,19,34.119225844577954,0.6440104166666667,42.047764227642276,1031.808943089431,25.795223577235777,0
4352,4,0,0,44,0.0,0.0,1.0,44,950,800,150,0.8421052631578947,11,8,3,311.02597091220986,0.3754294397463002,0.0645964818047533,0.1910749385731088,133131.14636005348,-518.5511889417758,132612.5951711117,4223,14,1252.4545454545455,40,4,19,33.97238634498603,0.64453125,41.99695121951219,1032.0121951219508,25.80030487804877,0
4353,4,0,0,44,0.0,0.0,1.0,44,1200,1000,200,0.8333333333333334,14,10,4,312.8590194680388,0.37491190979563077,0.07028006442376489,0.19287910423515017,133262.27774472864,-461.5388905413491,132800.73885418728,4224,15,1253.4545454545455,40,4,19,33.79408628608922,0.6458333333333334,41.86991869918699,1032.5203252032518,25.813008130081293,0
4354,4,0,0,44,0.0,0.0,1.0,44,1050,800,250,0.7619047619047619,13,8,5,312.85701234957554,0.37481280831571534,0.06367566151427839,0.1931697211482251,133318.49666950083,-458.0746882086477,132860.4219812922,4225,16,1254.4545454545455,41,3,19,33.73799231508166,0.6448170731707318,41.815476190476176,1032.7380952380927,25.18873403019738,0
4355,4,0,0,44,0.0,0.0,1.0,44,1000,700,300,0.7,13,7,6,314.26794590575815,0.3738217935165609,0.06278507668829314,0.19471464887815784,133447.19109616306,-412.36507346313476,133034.82602269994,4226,17,1255.4545454545455,42,2,20,33.5730641783113,0.644593253968254,41.690891472868216,1033.236434108527,24.60086747877445,0
4356,4,0,0,44,0.0,0.0,1.0,44,850,600,250,0.7058823529411765,11,6,5,316.127962997492,0.37395392882311485,0.07005094280845148,0.1962842083142127,133526.04709201405,-357.72950304404327,133168.31758897,4227,18,1256.4545454545455,39,5,21,33.446297789424186,0.6501068376068375,41.61458333333334,1033.541666666668,26.501068376068414,0
4357,4,0,0,44,0.0,0.0,1.0,44,1050,800,250,0.7619047619047619,13,8,5,315.16728105628476,0.3738328047921071,0.06451797572704354,0.1961150636039893,133606.80474175364,-378.3013237847029,133228.50341796895,4228,19,1257.4545454545455,39,5,23,33.39053316540722,0.6509081196581196,41.53645833333334,1033.854166666668,26.509081196581235,0
4358,4,0,0,44,0.0,0.0,1.0,44,950,800,150,0.8421052631578947,11,8,3,314.81055789057217,0.37306201550387597,0.06803529400990849,0.19617855669678047,133660.65673828142,-384.4428168402625,133276.21392144117,4229,20,1258.4545454545455,39,5,23,33.34603018703201,0.6514423076923077,41.48437500000001,1034.0625000000014,26.514423076923112,0
4359,4,0,0,44,0.0,0.0,1.0,44,850,500,350,0.5882352941176471,12,5,7,314.54203135023084,0.37279774489076817,0.06761927297729309,0.19682559441774458,133813.7344359344,-381.99122959216,133431.74320634225,4230,21,1259.4545454545455,40,4,15,33.200324133189284,0.6513020833333333,41.336382113821145,1034.6544715447164,25.866361788617912,0
4360,4,0,0,44,0.0,0.0,1.0,44,1000,600,400,0.6,14,6,8,311.03194065998713,0.37166358350951373,0.06060531693691629,0.1954646748613997,133971.50262946993,-466.11670880427664,133505.38592066566,4231,22,1260.4545454545455,40,4,17,33.13393704394489,0.6528645833333333,41.1839430894309,1035.2642276422769,25.881605691056922,0
4361,4,0,0,44,0.0,0.0,1.0,44,1000,800,200,0.8,12,8,4,321.1741654964344,0.37166358350951373,0.08496944044242039,0.19786587915574746,133236.04630386995,-241.60480286206132,132994.44150100788,4232,23,1261.4545454545455,40,4,18,33.60566984939464,0.6455729166666667,41.89532520325203,1032.418699186991,25.810467479674777,1
4362,4,0,1,43,0.0,0.022727272727272728,0.9772727272727273,44,1150,600,550,0.5217391304347826,17,6,11,323.0386130843403,0.3711570648343904,0.09146145107475423,0.19957698630858028,133340.9875590751,-185.14246232403684,133155.84509675106,4233,24,1262.4545454545455,40,4,18,33.45263865656465,0.6466145833333334,41.79369918699186,1032.8252032520309,25.82063008130077,0
4363,4,0,0,43,0.0,0.0,1.0,43,1400,800,600,0.5714285714285714,20,8,12,333.448811891612,0.3708702473237357,0.09067797405180267,0.20613955228910374,133364.60503472216,294.0538194444357,133658.6588541666,4234,25,1278.6046511627908,39,4,18,33.16021245125722,0.6485042735042736,41.77083333333333,1032.916666666666,26.485042735042718,0
4364,4,0,1,42,0.0,0.023255813953488372,0.9767441860465116,43,900,700,200,0.7777777777777778,11,7,4,331.2823551997117,0.37093946105574016,0.09016258904411512,0.20509727833150676,133418.40820312488,239.83289930554076,133658.24110243042,4235,26,1279.6046511627908,39,4,18,33.16234791960744,0.6490384615384617,41.71874999999999,1033.124999999999,26.490384615384592,0
4365,4,0,0,42,0.0,0.0,1.0,42,1050,700,350,0.6666666666666666,14,7,7,335.28193906693946,0.37153987611304684,0.08474280002560453,0.20772015584345715,133444.62393390652,548.3144541237202,133992.93838803025,4236,27,1298.9285714285713,38,4,18,33.03282149381312,0.6510416666666667,41.693376068376054,1033.2264957264936,27.190170940170884,0
4366,4,0,0,42,0.0,0.0,1.0,42,1250,1000,250,0.8,15,10,5,334.8054249409833,0.3711285327138986,0.08376521978221563,0.2080689908959566,133559.51126379726,543.2954918542338,134102.8067556515,4237,28,1299.9285714285713,36,6,18,32.93023931437702,0.6559606481481484,41.58220720720719,1033.6711711711687,28.713088088088018,0
4367,4,0,0,42,0.0,0.0,1.0,42,1450,1100,350,0.7586206896551724,18,11,7,334.3453538420812,0.37002758420441345,0.0818187325820916,0.20856781596815507,133698.92659279765,540.3229839950583,134239.2495767927,4238,29,1300.9285714285713,37,5,18,32.80278131184619,0.6554054054054055,41.44736842105262,1034.2105263157882,27.951635846372653,0
4368,4,0,0,42,0.0,0.0,1.0,42,850,400,450,0.47058823529411764,13,4,9,333.7042831603958,0.3698340108401084,0.08331061913847626,0.20848782830034232,133755.63274276673,526.9655086180092,134282.59825138474,4239,30,1301.9285714285713,37,5,14,32.76270228252421,0.6559684684684686,41.39254385964911,1034.4298245614013,27.95756282598382,0
4369,4,0,0,42,0.0,0.0,1.0,42,1050,700,350,0.6666666666666666,14,7,7,333.4093161366989,0.3701122725512969,0.08972146968756767,0.20910634784148185,133897.4507180094,528.531495267772,134425.98221327717,4240,31,1302.9285714285713,37,5,14,32.6286991912985,0.6573761261261262,41.25548245614035,1034.9780701754387,27.972380275011858,0
4370,4,0,0,42,0.0,0.0,1.0,42,950,600,350,0.631578947368421,13,6,7,333.3867107181893,0.3698824041811846,0.0904217225971089,0.20957638632497622,133982.57757194526,533.6021660510959,134516.17973799637,4241,32,1303.9285714285713,37,5,14,32.544305584974936,0.6582207207207207,41.17324561403509,1035.30701754386,27.98127074442865,0
4371,4,0,0,42,0.0,0.0,1.0,42,1300,800,500,0.6153846153846154,18,8,10,333.0662843786871,0.37018486256291133,0.08954467782667219,0.21018551693556836,134124.51577648905,534.470822753168,134658.98659924223,4242,33,1304.9285714285713,37,5,17,32.41097261917364,0.6596283783783783,41.03618421052632,1035.8552631578957,27.99608819345664,0
4372,4,0,0,42,0.0,0.0,1.0,42,1300,900,400,0.6923076923076923,17,9,8,332.83413118333726,0.3704389276035618,0.0896699420508944,0.2105276130978943,134209.71476800574,533.9147622345532,134743.6295302403,4243,34,1305.9285714285713,37,5,19,32.33201058201058,0.6604729729729728,40.95394736842106,1036.1842105263172,28.004978662873437,0
4373,4,0,0,42,0.0,0.0,1.0,42,750,600,150,0.8,9,6,3,354.2850005992179,0.3704389276035618,0.1318566658716911,0.20603564597954516,131054.49631090659,886.5612862927117,131941.0575971993,4244,35,1306.9285714285713,38,4,16,34.94800361713968,0.6271929824561404,44.01709401709402,1023.9316239316241,26.945569050832216,4
4374,4,0,0,42,0.0,0.0,1.0,42,1250,900,350,0.72,16,9,7,356.54502133853225,0.3702332559039876,0.13823130670560024,0.20808948323890353,131191.27498584634,955.1191878515662,132146.3941736979,4245,36,1307.9285714285713,38,4,18,34.75184238884835,0.628563596491228,43.88354700854701,1024.4658119658122,26.95962663067927,0
4375,4,0,1,41,0.0,0.023809523809523808,0.9761904761904762,42,900,700,200,0.7777777777777778,11,7,4,357.5851970230537,0.37029374758033295,0.1376811594202898,0.20899449266594194,131246.0064308021,986.3258136094648,132232.33224441158,4246,37,1308.9285714285713,38,4,18,34.66987279741424,0.6291118421052632,43.830128205128204,1024.679487179487,26.96524966261808,0
4376,4,0,0,41,0.0,0.0,1.0,41,850,600,250,0.7058823529411765,11,6,5,357.709181542881,0.37032520325203255,0.13619495493050393,0.20920838615142456,131271.93583602642,1191.435345490916,132463.37118151734,4247,38,1319.6097560975609,37,4,19,34.640487909265985,0.6311936936936937,43.80482456140351,1024.7807017543855,27.696775723091502,0
4377,4,0,0,41,0.0,0.0,1.0,41,800,600,200,0.75,10,6,4,360.36005668539724,0.3701473577235772,0.13840019031867068,0.2114046872053569,131389.14399092956,1269.5159440738278,132658.65993500338,4248,39,1320.6097560975609,34,7,19,34.45410473757549,0.6384803921568627,43.69047619047618,1025.238095238094,30.154061624649824,0
4378,4,2,1,42,0.046511627906976744,0.023255813953488372,0.9767441860465116,43,1050,1000,50,0.9523809523809523,11,10,1,340.68914821444355,0.378483757844223,0.13970316392276438,0.20243815771100596,131876.97991488117,385.81119125883384,132262.79110614,4249,0,1260.139534883721,36,7,16,34.4667068669371,0.6391782407407407,43.215090090090094,1027.13963963964,28.53165665665667,0
4379,4,0,0,42,0.0,0.0,1.0,42,500,300,200,0.6,7,3,4,346.76147769706444,0.3754113433991482,0.1356345717184404,0.20548570932870117,131773.3802324459,738.7864101080089,132512.1666425539,4250,1,1291.142857142857,35,7,17,34.415158944876545,0.6401785714285715,43.315972222222214,1026.7361111111104,29.33531746031744,0
4380,4,0,0,42,0.0,0.0,1.0,42,1050,700,350,0.6666666666666666,14,7,7,349.0242708260475,0.3752903600464576,0.1356611610161309,0.20731200664727864,131862.52170138876,804.6440972222025,132667.16579861095,4251,2,1292.142857142857,35,7,17,34.26724137931034,0.6410714285714286,43.22916666666666,1027.0833333333321,29.34523809523806,0
4381,4,0,0,42,0.0,0.0,1.0,42,900,400,500,0.4444444444444444,14,4,10,349.49340312912835,0.37605255516840885,0.12842339008142156,0.2082417740255302,131981.42387902946,825.3273962619983,132806.75127529146,4252,3,1293.142857142857,35,7,18,34.135409626792814,0.6422619047619048,43.113425925925924,1027.546296296296,29.358465608465604,0
4382,4,0,0,42,0.0,0.0,1.0,42,800,500,300,0.625,11,5,6,349.49340312912835,0.37605255516840885,0.12842339008142156,0.2082417740255302,131981.42387902946,825.3273962619983,132806.75127529146,4253,4,1294.142857142857,35,7,18,34.135409626792814,0.6422619047619048,43.113425925925924,1027.546296296296,29.358465608465604,0
4383,4,0,0,42,0.0,0.0,1.0,42,700,500,200,0.7142857142857143,9,5,4,350.57651407684887,0.3757742934572203,0.13360933285333387,0.2092682697174233,132050.5402995902,858.7636200389635,132909.30391962916,4254,5,1295.142857142857,36,6,18,34.03797341222015,0.6409143518518519,43.046171171171174,1027.815315315316,28.550425425425445,0
4384,4,0,0,42,0.0,0.0,1.0,42,1200,1000,200,0.8333333333333334,14,10,4,351.3884668840398,0.3762824235385211,0.13441129381333083,0.2103952846634865,132166.3106307321,888.343453250549,133054.65408398266,4255,6,1296.142857142857,36,6,19,33.900540284014156,0.6420717592592593,42.93355855855856,1028.265765765766,28.562937937937946,0
4385,4,0,0,42,0.0,0.0,1.0,42,1150,900,250,0.782608695652174,14,9,5,351.06882141591404,0.3769115369725126,0.13444105611593327,0.21084902587997198,132282.13168827607,888.0264132375572,133170.15810151363,4256,7,1297.142857142857,36,6,20,33.79219120598431,0.6432291666666667,42.820945945945944,1028.7162162162158,28.57545045045044,0
4386,4,0,0,42,0.0,0.0,1.0,42,650,400,250,0.6153846153846154,9,4,5,350.73380079413647,0.3770204219899342,0.12843802436711216,0.21113343028042295,132369.03077063552,885.2586539242038,133254.28942455974,4257,8,1298.142857142857,36,6,20,33.71338549646167,0.6440972222222222,42.73648648648649,1029.0540540540544,28.584834834834844,0
4387,4,1,0,43,0.023255813953488372,0.0,1.0,43,800,500,300,0.625,11,5,6,341.6611818954189,0.38102159468438535,0.1299953765258115,0.2076320479464106,132725.77649444877,469.4554738163803,133195.23196826514,4258,0,1268.9302325581396,35,8,17,33.588514171253124,0.649702380952381,42.3900462962963,1030.4398148148152,29.441137566137577,0
4388,4,0,0,43,0.0,0.0,1.0,43,800,500,300,0.625,11,5,6,341.032105259334,0.3807216685123662,0.12781295054221742,0.20741460828067695,132755.59413580256,454.7839506172911,133210.37808641986,4259,1,1269.9302325581396,35,8,17,33.57479784366576,0.6499999999999999,42.361111111111114,1030.555555555556,29.44444444444446,0
4389,4,0,0,43,0.0,0.0,1.0,43,850,500,350,0.5882352941176471,12,5,7,340.4003659450058,0.38039867109634556,0.13096997581980308,0.2073601682015199,132815.2394654492,442.0712234224954,133257.31068887172,4260,2,1270.9302325581396,35,8,18,33.53123362527136,0.6505952380952381,42.30324074074074,1030.7870370370367,29.451058201058192,0
4390,4,0,0,43,0.0,0.0,1.0,43,800,600,200,0.75,10,6,4,338.33383785070674,0.37986803248431156,0.13735310160162673,0.2069246965743065,132964.41139671206,397.27192108196454,133361.68331779403,4261,3,1271.9302325581396,35,8,19,33.43491658250104,0.6520833333333333,42.15856481481482,1031.3657407407404,29.467592592592585,0
4391,4,0,0,43,0.0,0.0,1.0,43,1300,800,500,0.6153846153846154,18,8,10,337.9000482732156,0.3800526024363234,0.13787543149671588,0.20698990585973698,133024.10361207573,389.7702064043321,133413.87381848006,4262,4,1272.9302325581396,35,8,20,33.38627566475934,0.6526785714285714,42.10069444444445,1031.597222222223,29.474206349206373,0
4392,4,0,0,43,0.0,0.0,1.0,43,950,700,250,0.7368421052631579,12,7,5,338.48482815046816,0.37996031746031744,0.14001492295891982,0.20751401362677271,133053.95474322716,407.349001200288,133461.30374442745,4263,5,1273.9302325581396,35,8,20,33.34127963503103,0.6529761904761904,42.07175925925927,1031.712962962964,29.477513227513256,0
4393,4,0,1,42,0.0,0.023255813953488372,0.9767441860465116,43,1100,900,200,0.8181818181818182,13,9,4,338.6474751335482,0.37993724621631597,0.14241447306645005,0.20794634216878202,133113.66705246913,415.7214506172917,133529.38850308643,4264,6,1274.9302325581396,35,8,20,33.27725437415883,0.6535714285714285,42.01388888888889,1031.9444444444446,29.484126984126988,0
4394,4,0,0,42,0.0,0.0,1.0,42,850,500,350,0.5882352941176471,12,5,7,346.0569868654028,0.37543554006968644,0.13800868715039005,0.2119866614385799,133024.10361207573,806.7840952932215,133830.88770736897,4265,7,1305.9285714285713,35,7,20,33.1759087849209,0.6526785714285714,42.10069444444445,1031.597222222223,29.474206349206373,0
4395,4,0,0,42,0.0,0.0,1.0,42,1550,1300,250,0.8387096774193549,18,13,5,349.2851253795573,0.37566540843979873,0.14091394405295765,0.21516735624210306,133233.1318587106,907.2702331961679,134140.40209190678,4266,8,1306.9285714285713,35,7,21,32.88303437967116,0.6547619047619048,41.89814814814815,1032.4074074074078,29.49735449735451,0
4396,4,0,0,42,0.0,0.0,1.0,42,1350,900,450,0.6666666666666666,18,9,9,347.7123720782961,0.3752903600464576,0.13285735629975903,0.21488817232871982,133352.65024862823,873.6732681755764,134226.3235168038,4267,9,1307.9285714285713,35,7,21,32.80386224413566,0.655952380952381,41.782407407407405,1032.87037037037,29.510582010582,0
4397,4,0,0,42,0.0,0.0,1.0,42,800,600,200,0.75,10,6,4,347.9617324345176,0.37537504839334107,0.11698748900191003,0.20700458023383234,131921.96609224967,780.8127572016473,132702.7788494513,4268,10,1308.9285714285713,35,7,15,34.23464022833107,0.6416666666666666,43.1712962962963,1027.314814814815,29.35185185185186,4
4398,4,0,0,42,0.0,0.0,1.0,42,1050,800,250,0.7619047619047619,13,8,5,348.30663914430465,0.3747580332946187,0.11185649054142188,0.20759621699489092,131992.67415641996,794.7849454183925,132787.45910183835,4269,11,1309.9285714285713,36,6,16,34.15456621004566,0.6403356481481481,43.10247747747748,1027.5900900900904,28.544169169169177,0
4399,4,0,0,42,0.0,0.0,1.0,42,1250,900,350,0.72,16,9,7,348.536880988976,0.37495160665892374,0.11046690557042216,0.20836890547140555,132108.4191243608,808.9312707978204,132917.35039515863,4270,12,1310.9285714285713,36,6,17,34.03211377660934,0.6414930555555556,42.98986486486486,1028.0405405405402,28.55668168168167,0
4400,4,0,0,42,0.0,0.0,1.0,42,650,500,150,0.7692307692307693,8,5,3,346.97954623601987,0.37531455671699576,0.1057989603374474,0.2080738145616263,132224.2148187038,775.8196118415626,133000.03443054535,4271,13,1311.9285714285713,36,6,18,33.955618818205046,0.642650462962963,42.87725225225225,1028.4909909909904,28.56919419419418,0
4401,4,0,1,41,0.0,0.023809523809523808,0.9761904761904762,42,700,400,300,0.5714285714285714,10,4,6,347.24693315016543,0.3750241966705381,0.10865554495848917,0.20887394523983285,132340.0612394489,790.9360796607425,133130.99731910965,4272,14,1312.9285714285713,36,6,19,33.832220641348364,0.6438078703703705,42.76463963963964,1028.9414414414414,28.581706706706704,0
4402,4,0,0,41,0.0,0.0,1.0,41,700,600,100,0.8571428571428571,8,6,2,345.4193256122578,0.3732469512195122,0.1253251186224562,0.20826328376872952,132428.63520408166,948.7073359901592,133377.3425400718,4273,15,1338.4146341463415,34,7,19,33.79019199629888,0.6488970588235294,42.67857142857143,1029.2857142857144,30.273109243697483,0
4403,4,0,0,41,0.0,0.0,1.0,41,1350,1100,250,0.8148148148148148,16,11,5,346.4939998853289,0.37350101626016263,0.1300963425915478,0.20925140440002263,132489.9092970521,981.3917233559973,133471.3010204081,4274,16,1339.4146341463415,34,7,19,33.70095205057045,0.6495098039215687,42.61904761904761,1029.523809523809,30.280112044817912,0
4404,4,1,1,41,0.023809523809523808,0.023809523809523808,0.9761904761904762,42,950,700,250,0.7368421052631579,12,7,5,337.7721600946761,0.37791569879984516,0.13157922115754817,0.20585661474744776,132832.9744440386,573.4561419527672,133406.4305859914,4275,0,1308.5,36,6,12,33.58117580656911,0.6487268518518519,42.28603603603604,1030.8558558558557,28.63488488488488,0
4405,4,0,0,41,0.0,0.0,1.0,41,1150,700,450,0.6086956521739131,16,7,9,343.000112320778,0.3728404471544715,0.13379730039380378,0.2090428114636752,132832.9744440386,912.3450308416552,133745.31947488026,4276,18,1341.4146341463415,36,5,12,33.44644417740881,0.6487268518518519,42.28603603603604,1030.8558558558557,28.63488488488488,0
4406,4,0,0,41,0.0,0.0,1.0,41,1050,900,150,0.8571428571428571,12,9,3,343.4252386811696,0.3728912601626016,0.1323775426482967,0.2096267656909859,132891.0244704163,927.6263594675693,133818.65082988387,4277,19,1342.4146341463415,36,5,12,33.37724807048202,0.6493055555555556,42.229729729729726,1031.0810810810806,28.641141141141127,0
4407,4,0,1,40,0.0,0.024390243902439025,0.975609756097561,41,700,500,200,0.7142857142857143,9,5,4,343.8137139740992,0.3726371951219512,0.1315496513777108,0.21018998615319076,132949.08717839446,941.9438864540057,133891.03106484847,4278,20,1343.4146341463415,36,5,12,33.30899213802141,0.6498842592592593,42.173423423423415,1031.306306306305,28.647397397397363,0
4408,4,0,0,40,0.0,0.0,1.0,40,650,300,350,0.46153846153846156,10,3,7,365.25208399478413,0.3720219017094017,0.15996929151129624,0.2165389142954775,131790.2425229284,1627.3321463355328,133417.57466926394,4279,21,1368.125,36,4,14,33.92351210060686,0.6383101851851851,43.29954954954955,1026.8018018018024,28.52227227227229,2
4409,4,0,0,40,0.0,0.0,1.0,40,450,100,350,0.2222222222222222,8,1,7,365.25208399478413,0.3720219017094017,0.15996929151129624,0.2165389142954775,131790.2425229284,1627.3321463355328,133417.57466926394,4280,22,1369.125,36,4,14,33.92351210060686,0.6383101851851851,43.29954954954955,1026.8018018018024,28.52227227227229,0
4410,4,1,0,41,0.024390243902439025,0.0,1.0,41,800,400,400,0.5,12,4,8,358.7509614566555,0.37512703252032525,0.16748973549048496,0.21419945940730492,132059.6782182979,1275.3073060941783,133334.98552439208,4281,0,1336.7073170731708,37,4,15,33.81871844107816,0.6390765765765766,43.03728070175438,1027.8508771929821,27.779753437648164,0
4411,4,0,1,40,0.0,0.024390243902439025,0.975609756097561,41,1000,700,300,0.7,13,7,6,360.4431296382981,0.37578760162601627,0.16526165474942567,0.21569082492778058,132144.21895438983,1326.0951687057573,133470.3141230956,4282,1,1337.7073170731708,37,4,15,33.69003501475241,0.6399211711711712,42.95504385964912,1028.1798245614036,27.788643907064962,0
4412,4,1,2,39,0.024390243902439025,0.04878048780487805,0.9512195121951219,41,800,700,100,0.875,9,7,2,361.4162261376574,0.37594004065040654,0.1626571037007949,0.21659570510831247,132200.59447378045,1355.88798957372,133556.4824633542,4283,0,1338.0975609756097,37,4,15,33.60821605004089,0.6404842342342343,42.90021929824562,1028.3991228070179,27.79457088667616,0
4413,4,1,1,39,0.025,0.025,0.975,40,1200,1000,200,0.8333333333333334,14,10,4,359.9277276419,0.3775240384615384,0.1612835249042146,0.21616961157191047,132282.13168827622,1522.4014132375723,133804.53310151378,4284,0,1348.35,36,4,16,33.564358693669035,0.6432291666666665,42.82094594594595,1028.716216216217,28.57545045045047,0
4414,4,0,0,39,0.0,0.0,1.0,39,1100,800,300,0.7272727272727273,14,8,6,367.1888246268126,0.3731443994601889,0.16386015035424162,0.21999141650770251,132189.63162562152,1907.7110928926554,134097.34271851418,4285,4,1383.923076923077,35,4,18,33.470854436315875,0.6443452380952381,42.910879629629626,1028.356481481481,29.381613756613746,0
4415,4,0,0,39,0.0,0.0,1.0,39,800,400,400,0.5,12,4,8,368.5401536260748,0.3735098965362123,0.1619633600733832,0.22149786515092484,132308.68115837188,1952.2123360339458,134260.8934944058,4286,5,1384.923076923077,35,4,19,33.31610698616265,0.6455357142857143,42.795138888888886,1028.8194444444443,29.394841269841265,0
4416,4,0,0,39,0.0,0.0,1.0,39,650,300,350,0.46153846153846156,10,3,7,367.3783184301062,0.37373481781376516,0.16133367944391575,0.2209738329393535,132338.4519140089,1923.6555855624133,134262.1074995713,4287,6,1385.923076923077,35,4,19,33.31599175103112,0.6458333333333334,42.7662037037037,1028.9351851851852,29.39814814814815,0
4417,4,0,0,39,0.0,0.0,1.0,39,800,400,400,0.5,12,4,8,365.4117497610408,0.37325686009896536,0.1663137541000137,0.22031729347517126,132428.63520408145,1878.2092575970482,134306.8444616785,4288,7,1386.923076923077,34,5,19,33.275744082041776,0.6488970588235295,42.678571428571416,1029.2857142857129,30.273109243697437,0
4418,4,0,0,39,0.0,0.0,1.0,39,750,700,50,0.9333333333333333,8,7,1,368.73459195711575,0.37286324786324787,0.16964531940824368,0.22250160618654372,132459.27047902456,1968.4630102040433,134427.73348922862,4289,8,1387.923076923077,34,5,19,33.15938090281794,0.6492034313725492,42.648809523809504,1029.404761904759,30.276610644257616,0
4419,4,1,0,40,0.025,0.0,1.0,40,700,400,300,0.5714285714285714,10,4,6,365.89003625913676,0.37896634615384617,0.17863799685605208,0.22288759664321955,132815.23946544912,1719.1545567558153,134534.39402220494,4290,0,1354.2,35,5,12,32.874373081817495,0.6505952380952382,42.30324074074073,1030.7870370370363,29.451058201058178,0
4420,4,0,0,40,0.0,0.0,1.0,40,950,600,350,0.631578947368421,13,6,7,363.9035077726135,0.3787660256410256,0.17944544229905768,0.22203098953687922,132874.8981910149,1670.728309327826,134545.6265003427,4291,1,1355.2,35,5,12,32.86558898368508,0.6511904761904763,42.24537037037036,1031.0185185185169,29.45767195767191,0
4421,4,0,0,40,0.0,0.0,1.0,40,750,700,50,0.9333333333333333,8,7,1,363.8766253076517,0.3787660256410256,0.18075822202267422,0.22219169670088182,132904.73257726748,1672.1851155263882,134576.91769279388,4292,2,1356.2,35,5,13,32.836293822726084,0.6514880952380953,42.216435185185176,1031.1342592592578,29.460978835978793,0
4422,4,0,0,40,0.0,0.0,1.0,40,1300,1000,300,0.7692307692307693,16,10,6,363.74473217520637,0.37885950854700856,0.17643013100436722,0.2227207049949796,133007.1625679736,1676.130945134356,134683.29351310796,4293,3,1357.2,36,4,14,32.73676310043669,0.6504629629629628,42.11711711711713,1031.5315315315333,28.653653653653706,0
4423,4,0,0,40,0.0,0.0,1.0,40,800,600,200,0.75,10,6,4,360.44098271892324,0.3785924145299145,0.1762877878424094,0.2212137123009711,133094.2994303427,1594.5280161918845,134688.8274465346,4294,4,1358.2,36,4,14,32.73445741933136,0.6513310185185185,42.032657657657666,1031.8693693693708,28.663038038038078,0
4424,4,0,0,40,0.0,0.0,1.0,40,1200,900,300,0.75,15,9,6,363.8442819182152,0.37836538461538466,0.18248881858841548,0.22400003575179855,133210.52629910322,1693.5776570489518,134904.10395615216,4295,5,1359.2,36,4,14,32.529953456237955,0.6524884259259258,41.92004504504505,1032.3198198198204,28.675550550550568,0
4425,4,0,0,40,0.0,0.0,1.0,40,850,600,250,0.7058823529411765,11,6,5,363.19048915181975,0.37763087606837603,0.18727238032929883,0.22429764148224524,133326.80389426593,1684.6054246814444,135011.40931894738,4296,6,1360.2,36,4,14,32.430123941409526,0.6536458333333334,41.807432432432435,1032.7702702702707,28.688063063063073,0
4426,4,0,0,40,0.0,0.0,1.0,40,450,200,250,0.4444444444444444,7,2,5,367.52800074263257,0.37773771367521364,0.19228442167229987,0.227332053325163,133384.96171424797,1804.5416615940233,135189.503375842,4297,7,1361.2,36,4,14,32.25975689523602,0.6542245370370371,41.751126126126124,1032.9954954954949,28.694319319319302,0
4427,4,1,1,40,0.024390243902439025,0.024390243902439025,0.975609756097561,41,950,600,350,0.631578947368421,13,6,7,357.2195468550064,0.3795731707317073,0.18986683769923252,0.22266606387241003,133670.57802641185,1349.9486620883158,135020.52668850016,4298,0,1328.9756097560976,37,4,15,32.239754532923314,0.6551238738738739,41.474780701754376,1034.1008771929814,27.948672356567066,0
4428,4,0,0,40,0.0,0.0,1.0,40,700,400,300,0.5714285714285714,10,4,6,369.25220002207396,0.37645566239316236,0.1966254493953592,0.2294763672310503,133559.5112637974,1863.4286736060192,135422.93993740343,4299,9,1363.2,36,4,15,32.0400733558485,0.6559606481481483,41.5822072072072,1033.6711711711698,28.71308808808805,0
4429,4,1,1,40,0.024390243902439025,0.024390243902439025,0.975609756097561,41,950,600,350,0.631578947368421,13,6,7,364.3062338408508,0.3794461382113821,0.19400578751550235,0.22866029570861882,133925.8233302553,1558.0024622960757,135483.8257925514,4300,0,1330.9268292682927,37,4,13,31.80084745762713,0.6576576576576577,41.22807017543859,1035.0877192982443,27.975343764817413,0
4430,4,0,0,40,0.0,0.0,1.0,40,650,200,450,0.3076923076923077,11,2,9,309.7170982357888,0.37735042735042734,0.08197571090047373,0.18671516493643275,132424.15229030346,202.80483673740144,132626.95712704086,4301,11,1365.2,40,0,17,34.71337710637178,0.6375,42.6829268292683,1029.2682926829275,25.731707317073187,8
4431,4,0,0,40,0.0,0.0,1.0,40,800,500,300,0.625,11,5,6,310.5289674507805,0.37721688034188033,0.080745310957552,0.18746474614281333,132476.45767235113,227.55552250644607,132704.01319485757,4302,12,1366.2,40,0,18,34.640095426127004,0.6380208333333333,42.63211382113821,1029.4715447154472,25.73678861788618,0
4432,4,0,0,40,0.0,0.0,1.0,40,950,700,250,0.7368421052631579,12,7,5,309.3424592458112,0.37716346153846153,0.08072937228582666,0.18700822178273044,132528.77338224617,199.35533577897695,132728.12871802514,4303,13,1367.2,40,0,18,34.618247466771926,0.6385416666666666,42.581300813008134,1029.6747967479687,25.741869918699216,0
4433,4,0,1,39,0.0,0.025,0.975,40,1100,900,200,0.8181818181818182,13,9,4,313.1157748460866,0.37724358974358974,0.0889721838626949,0.19008189972392947,132685.78247901367,309.20231839512286,132994.98479740878,4304,14,1368.2,40,0,13,34.363903136713375,0.6401041666666667,42.42886178861788,1030.2845528455273,25.757113821138184,0
4434,4,0,0,39,0.0,0.0,1.0,39,1000,700,300,0.7,13,7,6,317.82366394341824,0.3717386414754836,0.09727515490912864,0.19283902063806144,132666.1512586804,632.888454861092,133299.03971354148,4305,24,1403.923076923077,39,0,14,34.26230198854061,0.6415598290598292,42.44791666666666,1030.208333333332,26.415598290598254,0
4435,4,0,0,39,0.0,0.0,1.0,39,1250,900,350,0.72,16,9,7,318.3774166579325,0.3718229869545659,0.09373023525874347,0.19345143768920553,132719.81336805545,650.9982638888798,133370.81163194432,4306,25,1404.923076923077,39,0,16,34.19429842296806,0.6420940170940173,42.39583333333333,1030.4166666666658,26.42094017094015,0
4436,4,0,0,39,0.0,0.0,1.0,39,750,400,350,0.5333333333333333,11,4,7,317.5896154789588,0.3715137201979308,0.0895647711899985,0.1932491793080452,132773.48632812488,633.4960937499862,133406.98242187488,4307,26,1405.923076923077,39,0,16,34.16085506367495,0.6426282051282053,42.34374999999999,1030.624999999999,26.426282051282026,0
4437,4,0,0,39,0.0,0.0,1.0,39,1300,1100,200,0.8461538461538461,15,11,4,319.79652799662443,0.37156995051731895,0.09841015800009845,0.1955716753362925,132961.4271375867,704.1205512152678,133665.54768880198,4308,27,1406.923076923077,39,0,18,33.915871292462036,0.6444978632478633,42.16145833333333,1031.3541666666658,26.444978632478612,0
4438,4,0,0,39,0.0,0.0,1.0,39,1100,800,300,0.7272727272727273,14,8,6,319.84570226847165,0.37156995051731895,0.08760144449190466,0.19616542916218005,133068.88156467,712.3019748263835,133781.1835394964,4309,28,1407.923076923077,39,0,19,33.80710499747603,0.6455662393162394,42.057291666666664,1031.7708333333323,26.455662393162367,0
4439,4,0,0,39,0.0,0.0,1.0,39,1750,1600,150,0.9142857142857143,19,16,3,318.7957170802822,0.37232905982905984,0.08257279443720145,0.19651138978232313,133257.03124999988,696.3541666666522,133953.38541666654,4310,29,1408.923076923077,39,0,19,33.64608555286521,0.6474358974358976,41.87499999999999,1032.499999999999,26.47435897435895,0
4440,4,0,0,39,0.0,0.0,1.0,39,1050,600,450,0.5714285714285714,15,6,9,319.1292537020534,0.37232905982905984,0.07798843619739149,0.1972871371389998,133364.60503472202,712.109374999975,134076.714409722,4311,30,1409.923076923077,39,0,19,33.52998520908968,0.6485042735042736,41.77083333333332,1032.916666666665,26.48504273504269,0
4441,4,0,0,39,0.0,0.0,1.0,39,600,400,200,0.6666666666666666,8,4,4,321.8934545338971,0.37156995051731895,0.07879206185487075,0.1994291802324625,133445.31385633672,791.0346137152669,134236.348470052,4312,31,1410.923076923077,39,0,19,33.37796568874549,0.6493055555555556,41.69270833333333,1033.229166666666,26.49305555555554,0
4442,4,0,0,39,0.0,0.0,1.0,39,850,500,350,0.5882352941176471,12,5,7,321.2550665203513,0.3717386414754836,0.08021269884187276,0.19932650791862458,133499.82336410615,777.5016397318224,134277.32500383796,4313,32,1411.923076923077,38,1,20,33.340009993452554,0.6515899122807018,41.63995726495726,1033.4401709401704,27.195793972109747,0
4443,4,0,0,39,0.0,0.0,1.0,39,850,500,350,0.5882352941176471,12,5,7,321.8160900894747,0.37145748987854255,0.08379953379953364,0.20072034484962098,133693.11125721398,804.9188673387578,134498.03012455275,4314,33,1412.923076923077,38,1,21,33.13253271349863,0.6535087719298245,41.45299145299146,1034.1880341880355,27.215474583895674,0
4444,4,1,0,40,0.025,0.0,1.0,40,1150,1000,150,0.8695652173913043,13,10,3,325.38718325251006,0.3752003205128205,0.08867252066115716,0.20294767615233883,133693.11125721384,703.1472578347614,134396.2585150486,4315,0,1378.575,38,2,19,33.04020316804408,0.6535087719298245,41.452991452991455,1034.1880341880344,27.21547458389564,3
4445,4,0,0,40,0.0,0.0,1.0,40,800,600,200,0.75,10,6,4,325.67876134067376,0.3752403846153846,0.08978199577081858,0.20354410188006508,133768.3932834203,713.1049262152974,134481.4982096356,4316,1,1379.575,39,1,15,32.95751099251502,0.6525106837606838,41.38020833333334,1034.479166666668,26.525106837606874,0
4446,4,0,0,40,0.0,0.0,1.0,40,800,600,200,0.75,10,6,4,319.4290484360272,0.37522702991452994,0.08095633363517507,0.2008099501837872,133983.99658203122,559.6761067708323,134543.67268880206,4317,2,1380.575,39,1,15,32.90415283227689,0.6546474358974359,41.171875,1035.3124999999998,26.546474358974354,5
4447,4,0,0,40,0.0,0.0,1.0,40,1050,700,350,0.6666666666666666,14,7,7,317.73102341738047,0.3748931623931624,0.08276347546259077,0.2004769858415247,134118.83680555547,522.7430555555505,134641.57986111104,4318,3,1381.575,39,1,16,32.81375703942076,0.6559829059829061,41.041666666666664,1035.8333333333328,26.559829059829045,0
4448,4,0,0,40,0.0,0.0,1.0,40,850,700,150,0.8235294117647058,10,7,3,315.57937676905874,0.3746928418803419,0.07697044334975378,0.19955931727411477,134199.77349175338,470.13617621527237,134669.90966796866,4319,4,1382.575,39,1,16,32.788885258536915,0.656784188034188,40.963541666666664,1036.1458333333328,26.567841880341867,0
4449,4,0,0,40,0.0,0.0,1.0,40,800,600,200,0.75,10,6,4,318.63083182561905,0.37466613247863245,0.06663903125314063,0.20208383731655402,134307.7270507811,558.9165581597069,134866.64360894082,4320,5,1383.575,39,1,17,32.602355709643916,0.6578525641025642,40.85937499999999,1036.5624999999989,26.57852564102561,0
4450,4,0,0,40,0.0,0.0,1.0,40,1500,1300,200,0.8666666666666667,17,13,4,318.7544948854042,0.37495993589743587,0.06813046098222397,0.203060684937554,134469.73876953122,572.566731770833,135042.30550130206,4321,6,1384.575,39,1,17,32.43792055840114,0.6594551282051282,40.703125,1037.1874999999998,26.594551282051277,0
4451,4,0,0,40,0.0,0.0,1.0,40,900,500,400,0.5555555555555556,13,5,8,319.1596440072437,0.37473290598290593,0.06668591224018461,0.20362017262448037,134523.7643771701,586.9113498263839,135110.67572699647,4322,7,1385.575,39,1,17,32.37366954513505,0.6599893162393162,40.651041666666664,1037.395833333333,26.599893162393155,0
4452,4,0,0,40,0.0,0.0,1.0,40,1000,700,300,0.7,13,7,6,319.86975718620226,0.3744123931623931,0.06500301114122298,0.20467966543648886,134631.84814453122,612.9313151041672,135244.77945963538,4323,8,1386.575,39,1,17,32.24775419050488,0.6610576923076923,40.546875,1037.8124999999998,26.610576923076916,0
4453,4,0,0,40,0.0,0.0,1.0,40,800,500,300,0.625,11,5,6,319.85254965384394,0.3743990384615385,0.06857752132463646,0.20497303262382965,134685.90630425327,615.926106770814,135301.83241102408,4324,9,1387.575,39,1,17,32.1944514132798,0.6615918803418804,40.49479166666666,1038.0208333333317,26.61591880341876,0
4454,4,0,0,40,0.0,0.0,1.0,40,1150,700,450,0.6086956521739131,16,7,9,317.2798798529184,0.3730235042735042,0.06172282390693962,0.20438727144013574,134875.19531249985,558.6371527777634,135433.8324652776,4325,10,1388.575,39,1,14,32.07313812006952,0.6634615384615385,40.31249999999999,1038.7499999999989,26.634615384615355,0
4455,4,0,0,40,0.0,0.0,1.0,40,1000,700,300,0.7,13,7,6,318.95025785013917,0.3735977564102564,0.05936090225563917,0.2059241956022743,134956.35986328125,608.8731553819448,135565.2330186632,4326,11,1389.575,39,1,14,31.949143692564743,0.6642628205128206,40.234375,1039.0625,26.642628205128204,0
4456,4,0,0,40,0.0,0.0,1.0,40,800,700,100,0.875,9,7,2,317.3303175183439,0.37354433760683764,0.06301362998596893,0.20533864514902953,135037.548828125,570.3016493055563,135607.85047743056,4327,12,1390.575,39,1,14,31.910620030734282,0.6650641025641026,40.15625,1039.375,26.650641025641026,0
4457,4,0,0,40,0.0,0.0,1.0,40,1250,1000,250,0.8,15,10,5,318.37672466821743,0.3733573717948718,0.06434081346423559,0.206634360574652,135145.83875868062,605.4578993055608,135751.29665798618,4328,13,1391.575,39,1,15,31.77594670406733,0.6661324786324787,40.052083333333336,1039.7916666666672,26.6613247863248,0
4458,4,0,0,40,0.0,0.0,1.0,40,1300,1000,300,0.7692307692307693,16,10,6,319.2152569467018,0.372769764957265,0.05962154585502599,0.20811501216603542,135308.35503472242,638.4982638889093,135946.85329861133,4329,14,1392.575,39,1,17,31.592911493792542,0.6677350427350428,39.89583333333334,1040.4166666666683,26.67735042735047,0
4459,4,0,0,40,0.0,0.0,1.0,40,1000,800,200,0.8,12,8,4,317.44336516398045,0.372008547008547,0.054625738016611525,0.20774142423599606,135443.8598632814,599.1509331597375,136043.01079644114,4330,15,1393.575,39,1,17,31.50465742686547,0.6690705128205128,39.76562500000001,1040.9375000000011,26.690705128205156,0
4460,4,0,0,40,0.0,0.0,1.0,40,1150,600,550,0.5217391304347826,17,6,11,318.99118371383804,0.37167467948717947,0.05223544708941774,0.20954493132529273,135579.43250868065,649.7287326388991,136229.16124131955,4331,16,1394.575,39,1,19,31.330016003200644,0.670405982905983,39.63541666666667,1041.4583333333342,26.70405982905985,0
4461,4,0,0,40,0.0,0.0,1.0,40,600,400,200,0.6666666666666666,8,4,4,318.31000275242764,0.3719951923076923,0.0476466365873669,0.2097404828947077,135689.33084958722,638.2651059358761,136327.5959555231,4332,17,1395.575,38,2,20,31.238891167623738,0.6732456140350876,39.52991452991453,1041.8803418803416,27.417903733693198,0
4462,4,0,0,40,0.0,0.0,1.0,40,1350,1000,350,0.7407407407407407,17,10,7,317.9381550334603,0.3709935897435897,0.048362713948959746,0.21031339516348999,135828.50652211646,637.0129529184203,136465.51947503487,4333,18,1396.575,38,2,20,31.110783710840085,0.6746162280701753,39.39636752136753,1042.4145299145312,27.431961313540295,0
4463,4,0,0,40,0.0,0.0,1.0,40,350,300,50,0.8571428571428571,4,3,1,318.1581272324163,0.3709268162393162,0.04878561180569774,0.21062327038900436,135856.35021732806,644.7603915552921,136501.11060888335,4334,19,1397.575,38,2,20,31.077491972398718,0.6748903508771928,39.36965811965813,1042.5213675213697,27.43477282950973,0
4464,4,0,0,40,0.0,0.0,1.0,40,950,700,250,0.7368421052631579,12,7,5,319.0863628215631,0.3700587606837607,0.05344995389816609,0.2117336497281634,135939.89842437388,675.3135501132597,136615.21197448715,4335,20,1398.575,38,2,17,30.970614349622657,0.6757127192982455,39.28952991452993,1042.8418803418826,27.443207377417963,0
4465,4,0,0,40,0.0,0.0,1.0,40,850,500,350,0.5882352941176471,12,5,7,320.3060706743291,0.3702590811965812,0.016642228739003118,0.2190746678222414,137007.75719452128,789.6929410359082,137797.45013555718,4336,21,1399.575,37,3,15,29.884094400223436,0.6880630630630631,38.267543859649116,1046.9298245614025,28.295400663821688,4
4466,4,0,0,40,0.0,0.0,1.0,40,950,700,250,0.7368421052631579,12,7,5,321.70992455297164,0.369911858974359,0.02062395309882792,0.2207595689173839,137122.57617728526,822.738727300703,137945.31490458595,4337,22,1400.575,37,3,16,29.734174343941948,0.6891891891891893,38.1578947368421,1047.368421052631,28.30725462304408,0
4467,4,0,0,40,0.0,0.0,1.0,40,800,400,400,0.5,12,4,8,321.88506708383795,0.3696981837606838,0.026392087083944027,0.22124387992222924,137180.00370306234,831.2389389042627,138011.2426419666,4338,23,1401.575,37,3,16,29.67299909287559,0.6897522522522523,38.10307017543859,1047.5877192982443,28.313181602655252,0
4468,4,0,0,40,0.0,0.0,1.0,40,900,600,300,0.6666666666666666,12,6,6,320.186238434206,0.3692975427350427,0.023011928429423678,0.22062147661973364,137266.16753472213,790.1475694444349,138056.31510416657,4339,24,1402.575,37,3,16,29.632620941020544,0.6905968468468469,38.02083333333333,1047.9166666666658,28.32207207207205,0
4469,4,0,0,40,0.0,0.0,1.0,40,1100,700,400,0.6363636363636364,15,7,8,320.186238434206,0.3692975427350427,0.023011928429423678,0.22062147661973364,137266.16753472213,790.1475694444349,138056.31510416657,4340,25,1403.575,37,3,16,29.632620941020544,0.6905968468468469,38.02083333333333,1047.9166666666658,28.32207207207205,0
4470,4,0,0,40,0.0,0.0,1.0,40,900,600,300,0.6666666666666666,12,6,6,323.19024430919274,0.36832264957264954,0.014270027190964374,0.2236139736674748,137409.83403547248,881.9035664819958,138291.73760195446,4341,26,1404.575,37,3,16,29.412431151084164,0.6920045045045045,37.88377192982456,1048.4649122807018,28.336889521100048,0
4471,4,0,1,39,0.0,0.025,0.975,40,750,500,250,0.6666666666666666,10,5,5,320.59997368536466,0.3683760683760684,0.014536423841059687,0.22206695424995446,137448.15779320986,813.1751543209868,138261.33294753084,4342,27,1405.575,38,2,16,29.44260485651214,0.690515350877193,37.84722222222222,1048.611111111111,27.59502923976608,0
4472,4,0,0,39,0.0,0.0,1.0,39,1000,800,200,0.8,12,8,4,327.2605521612019,0.36530026990553305,0.01090011801308921,0.22605569932522313,137352.35841797473,1190.0017313019362,138542.36014927668,4343,62,1441.923076923077,37,2,16,29.362360529986066,0.6914414414414414,37.93859649122807,1048.2456140350873,28.330962541488848,0
4473,4,0,0,39,0.0,0.0,1.0,39,1150,900,250,0.782608695652174,14,9,5,333.57922463929793,0.36530026990553305,0.06495005609396709,0.21686079134364236,135205.70181450067,1220.362635618657,136426.06445011933,4344,63,1442.923076923077,37,2,18,31.32127481989105,0.6703265765765766,39.99451754385965,1040.021929824562,28.108700806069244,3
4474,4,0,0,39,0.0,0.0,1.0,39,800,600,200,0.75,10,6,4,332.9888306488406,0.3651596941070625,0.05883895100718117,0.2168198377738883,135262.72657211844,1208.195430324724,136470.92200244317,4345,64,1443.923076923077,37,2,18,31.279975229261098,0.6708896396396395,39.939692982456144,1040.2412280701762,28.11462778568044,0
4475,4,0,0,39,0.0,0.0,1.0,39,1050,800,250,0.7619047619047619,13,8,5,324.4955827321477,0.3653565002249213,0.04873387482083169,0.1994037741216633,133141.2310979619,840.7482741617389,133981.97937212363,4346,65,1444.923076923077,38,1,16,33.61477743271223,0.6480263157894737,41.98717948717949,1032.0512820512822,27.159244264507425,8
4476,4,0,0,39,0.0,0.0,1.0,39,900,700,200,0.7777777777777778,11,7,4,325.0791152252093,0.3652440395861449,0.05158452199015118,0.20035488326125162,133251.51581561848,863.4569727518596,134114.97278837033,4347,66,1445.923076923077,38,1,16,33.48941087196469,0.6491228070175438,41.88034188034189,1032.4786324786335,27.170490328385092,0
4477,4,0,0,39,0.0,0.0,1.0,39,900,500,400,0.5555555555555556,13,5,8,323.2289208078052,0.3649066576698156,0.05739324638672927,0.19965840111495553,133334.25931633078,819.4977491051368,134153.7570654359,4348,67,1446.923076923077,38,1,16,33.454449846557026,0.6499451754385963,41.80021367521368,1032.7991452991464,27.178924876293326,0
4478,4,0,0,39,0.0,0.0,1.0,39,1000,900,100,0.9,11,9,2,323.2289208078052,0.3649066576698156,0.05739324638672927,0.19965840111495553,133334.25931633078,819.4977491051368,134153.7570654359,4349,68,1447.923076923077,38,1,16,33.454449846557026,0.6499451754385963,41.80021367521368,1032.7991452991464,27.178924876293326,0
4479,4,0,0,39,0.0,0.0,1.0,39,800,600,200,0.75,10,6,4,322.9909942324004,0.3648785425101215,0.07433662228182736,0.19500884839745683,132480.4815910585,758.0004930966383,133238.4820841551,4350,69,1448.923076923077,38,1,18,34.31532793690325,0.6414473684210527,42.628205128205124,1029.4871794871792,27.09176788124156,4
4480,4,0,0,39,0.0,0.0,1.0,39,850,600,250,0.7058823529411765,11,6,5,323.9153996845633,0.3654970760233918,0.06916854147719165,0.1964271876577707,132645.51487508198,793.1849934253579,133438.69986850733,4351,70,1449.923076923077,38,1,15,34.12608898568762,0.643092105263158,42.46794871794871,1030.1282051282035,27.108636977057987,0
4481,4,0,0,39,0.0,0.0,1.0,39,900,600,300,0.6666666666666666,12,6,6,324.04513152681756,0.3654127305443095,0.06882982909527913,0.19679415922195384,132700.5487983051,800.1933578055232,133500.74215611062,4352,71,1450.923076923077,38,1,15,34.06759816120559,0.6436403508771931,42.41452991452991,1030.3418803418795,27.114260008996826,0
4482,4,0,0,39,0.0,0.0,1.0,39,950,900,50,0.9473684210526315,10,9,1,326.2996570479334,0.364484930274404,0.07070618473127088,0.1986001761224866,132783.1210849039,865.4173743516708,133648.53845925556,4353,72,1451.923076923077,38,1,17,33.92678207387445,0.6444627192982456,42.33440170940171,1030.6623931623928,27.122694556905074,0
4483,4,0,0,39,0.0,0.0,1.0,39,1150,500,650,0.43478260869565216,18,5,13,329.78066525275864,0.36426000899685107,0.07610468978344676,0.20116203664280144,132865.71905361957,963.3090437577505,133829.02809737733,4354,73,1452.923076923077,38,1,17,33.75431778929188,0.6452850877192983,42.2542735042735,1030.982905982905,27.131129104813294,0
4484,4,0,0,39,0.0,0.0,1.0,39,700,500,200,0.7142857142857143,9,5,4,333.83294121407005,0.36397885739991004,0.07859918664849741,0.2040841913577843,132948.3427044523,1076.5072549126794,134024.849959365,4355,74,1453.923076923077,38,1,17,33.56706895956352,0.646107456140351,42.17414529914529,1031.3034188034173,27.13956365272151,0
4485,4,0,0,39,0.0,0.0,1.0,39,850,500,350,0.5882352941176471,12,5,7,333.446530270861,0.362657444894287,0.08489308717099164,0.20460143515603385,133086.1058605448,1075.4200452918235,134161.52590583664,4356,75,1454.923076923077,38,1,17,33.43903154552357,0.6474780701754387,42.04059829059828,1031.8376068376056,27.153621232568568,0
4486,4,1,1,39,0.025,0.025,0.975,40,800,600,200,0.75,10,6,4,326.2890327968327,0.3682959401709402,0.08131302944735808,0.20171334471405186,133364.60503472213,703.0815972222128,134067.68663194435,4357,0,1419.525,39,1,17,33.345098830173455,0.6485042735042736,41.77083333333333,1032.9166666666658,26.485042735042715,0
4487,4,0,0,39,0.0,0.0,1.0,39,900,600,300,0.6666666666666666,12,6,6,336.2262317455145,0.36217948717948717,0.08973563163507348,0.20753274304292088,133306.6752958579,1164.2402202498274,134470.91551610772,4358,77,1456.923076923077,38,1,18,33.146466997723984,0.649671052631579,41.82692307692307,1032.692307692307,27.176113360323868,0
4488,4,0,0,39,0.0,0.0,1.0,39,750,500,250,0.6666666666666666,10,5,5,342.1242256084712,0.36198268106162845,0.09215389918595673,0.2118016172620947,133417.02849916,1329.0395116516956,134746.0680108117,4359,78,1457.923076923077,38,1,18,32.88370389520855,0.6507675438596492,41.72008547008547,1033.1196581196587,27.187359424201542,0
4489,4,0,0,39,0.0,0.0,1.0,39,400,300,100,0.75,5,3,2,344.1870608218331,0.36164529914529914,0.08569858601685465,0.21372247926920943,133528.88028047088,1391.7939819873773,134920.67426245825,4360,79,1458.923076923077,37,2,18,32.718456043567436,0.6537162162162162,41.61184210526316,1033.5526315789473,27.933854907539114,0
4490,4,0,1,38,0.0,0.02564102564102564,0.9743589743589743,39,900,500,400,0.5555555555555556,13,5,8,340.5186379254483,0.3599865047233468,0.08110326533052836,0.21274522054229664,133755.63274276705,1309.257175284704,135064.88991805175,4361,80,1459.923076923077,37,2,14,32.586477987421375,0.6559684684684685,41.39254385964912,1034.4298245614036,27.95756282598388,0
4491,4,0,0,38,0.0,0.0,1.0,38,1350,1000,350,0.7407407407407407,17,10,7,340.8132177489507,0.3586711711711712,0.07008991321032454,0.2132568648991445,133812.35091566635,1521.0035780239987,135333.35449369033,4362,81,1459.3947368421052,37,1,14,32.522166878620865,0.6565315315315315,41.33771929824561,1034.6491228070174,27.963489805595067,0
4492,4,0,0,38,0.0,0.0,1.0,38,1000,700,300,0.7,13,7,6,341.1889016409848,0.35921941678520625,0.06915038948149022,0.213985517780017,133897.4507180094,1536.864828601105,135434.3155466105,4363,82,1460.3947368421052,37,1,15,32.42740668149874,0.6573761261261262,41.25548245614035,1034.9780701754387,27.972380275011858,0
4493,4,0,0,38,0.0,0.0,1.0,38,750,700,50,0.9333333333333333,8,7,1,343.01535935031353,0.3583896396396396,0.07156077355766288,0.21546294129250232,133954.19894823412,1589.6695377423841,135543.8684859765,4364,83,1461.3947368421052,37,1,16,32.32344296155069,0.6579391891891893,41.20065789473684,1035.197368421053,27.978307254623054,0
4494,4,0,0,38,0.0,0.0,1.0,38,900,500,400,0.5555555555555556,13,5,8,342.8620009797215,0.3588637980085348,0.07524091919940679,0.21569925884420446,134010.95920138882,1589.4531249999914,135600.41232638882,4365,84,1462.3947368421052,37,1,16,32.27070757880616,0.6585022522522523,41.14583333333333,1035.416666666666,27.98423423423422,0
4495,4,0,0,38,0.0,0.0,1.0,38,500,300,200,0.6,7,3,4,342.8620009797215,0.3588637980085348,0.07524091919940679,0.21569925884420446,134010.95920138882,1589.4531249999914,135600.41232638882,4366,85,1463.3947368421052,37,1,16,32.27070757880616,0.6585022522522523,41.14583333333333,1035.416666666666,27.98423423423422,0
4496,4,0,0,38,0.0,0.0,1.0,38,1000,700,300,0.7,13,7,6,342.9975049890414,0.3592490516832622,0.07468446128555906,0.21611817442438241,134067.73147747366,1596.9794792628309,135664.7109567365,4367,86,1464.3947368421052,37,1,16,32.21049497088408,0.6590653153153154,41.091008771929815,1035.6359649122792,27.990161213845383,0
4497,4,0,0,38,0.0,0.0,1.0,38,1150,800,350,0.6956521739130435,15,8,7,342.48788860600513,0.35963430535798957,0.07797807388921063,0.21629850077202756,134152.9124345951,1589.1495460141448,135742.06198060926,4368,87,1465.3947368421052,37,1,17,32.138636042901496,0.6599099099099099,41.008771929824555,1035.9649122807007,27.99905168326218,0
4498,4,0,0,38,0.0,0.0,1.0,38,1200,900,300,0.75,15,9,6,343.195608557589,0.3583303698435278,0.07305610619863212,0.2174185584508264,134266.5291243459,1615.9366343490253,135882.46575869492,4369,88,1466.3947368421052,37,1,17,32.00689448441248,0.6610360360360361,40.89912280701754,1036.4035087719294,28.01090564248458,0
4499,4,1,1,38,0.02564102564102564,0.02564102564102564,0.9743589743589743,39,1000,600,400,0.6,14,6,8,333.7503470679544,0.36082995951417,0.06624041663695635,0.21276310700477796,134495.36494859002,1177.5749461246207,135672.93989471465,4370,0,1429.7692307692307,38,1,17,32.02355203076184,0.6614583333333334,40.6784188034188,1037.2863247863243,27.297008547008534,0
4500,4,0,0,38,0.0,0.0,1.0,38,900,700,200,0.7777777777777778,11,7,4,340.7646435090201,0.3571153390232338,0.06991018463901355,0.21688775224147447,134437.0443309479,1562.2782971683519,135999.32262811624,4371,90,1468.3947368421052,37,1,19,31.89980263621626,0.6627252252252254,40.734649122807014,1037.0614035087713,28.02868658131814,0
4501,4,0,0,38,0.0,0.0,1.0,38,700,500,200,0.7142857142857143,9,5,4,338.54292672698847,0.35637446657183497,0.07366307334601552,0.2161466378333848,134550.78124999997,1510.2911472760852,136061.07239727606,4372,91,1469.3947368421052,36,2,19,31.84404283801876,0.6657986111111112,40.625,1037.4999999999998,28.81944444444444,0
4502,4,0,0,38,0.0,0.0,1.0,38,1200,800,400,0.6666666666666666,16,8,8,337.26263738172526,0.35652264106211473,0.07755947111402994,0.2156748926767938,134609.2053835931,1479.731124705792,136088.93650829888,4373,92,1470.3947368421052,36,2,19,31.819045035268587,0.6663773148148149,40.568693693693696,1037.7252252252256,28.82570070070071,0
4503,4,0,0,38,0.0,0.0,1.0,38,1050,700,350,0.6666666666666666,14,7,7,339.6540393638757,0.35624110953058324,0.08015742098984546,0.21825434822120543,134784.55387397538,1556.0236334307322,136340.57750740612,4374,93,1471.3947368421052,36,2,15,31.58234826302281,0.6681134259259258,40.39977477477478,1038.4009009009012,28.844469469469477,0
4504,4,0,0,38,0.0,0.0,1.0,38,950,500,450,0.5263157894736842,14,5,9,338.07989471867506,0.35659672830725464,0.1072685167057299,0.20723086185068498,133047.67001625506,1396.1484543321105,134443.81847058717,4375,94,1472.3947368421052,37,1,14,33.3580215750877,0.6489301801801801,42.077850877192986,1031.6885964912285,27.883475580844014,5
4505,4,0,0,38,0.0,0.0,1.0,38,1050,600,450,0.5714285714285714,15,6,9,337.4075805113544,0.356967164532954,0.10206866125263514,0.20779920015814,133223.94035585131,1390.1534763313516,134614.09383218267,4376,95,1473.3947368421052,38,0,15,33.19879954465487,0.6488486842105263,41.90705128205128,1032.371794871794,27.16767881241563,0
4506,4,1,1,38,0.02564102564102564,0.02564102564102564,0.9743589743589743,39,1000,800,200,0.8,12,8,4,328.4339229968784,0.36201079622132254,0.09574028122415257,0.20362903225806447,133472.22222222213,967.5922501643603,134439.8144723865,4377,0,1436.5897435897436,38,1,15,33.18212365591398,0.6513157894736842,41.666666666666664,1033.3333333333328,27.19298245614034,0
4507,4,0,0,38,0.0,0.0,1.0,38,1200,700,500,0.5833333333333334,17,7,10,333.34067666286285,0.3559447605500237,0.09403472486801223,0.20636391442572893,133417.02849916,1294.664511651695,134711.6930108117,4378,97,1475.3947368421052,38,0,16,33.110565322302655,0.6507675438596492,41.72008547008547,1033.1196581196587,27.187359424201542,0
4508,4,0,0,38,0.0,0.0,1.0,38,750,400,350,0.5333333333333333,11,4,7,335.3092191032422,0.3555446894262684,0.10070458314025199,0.20836915019685306,133557.2138181939,1356.604428470897,134913.8182466648,4379,98,1476.3947368421052,37,1,16,32.919517520596855,0.6539977477477478,41.5844298245614,1033.6622807017534,27.936818397344688,0
4509,4,0,0,38,0.0,0.0,1.0,38,950,700,250,0.7368421052631579,12,7,5,333.5164790254372,0.35548541963015645,0.09300515098583051,0.2078912038128815,133670.5780264119,1316.268106532773,134986.8461329447,4380,99,1477.3947368421052,37,1,16,32.85253861379139,0.6551238738738738,41.47478070175438,1034.1008771929821,27.948672356567084,0
4510,4,0,0,38,0.0,0.0,1.0,38,900,600,300,0.6666666666666666,12,6,6,332.0818177401447,0.3560040303461356,0.09608582618301109,0.20747416348082948,133755.63274276705,1283.562730840259,135039.1954736073,4381,100,1478.3947368421052,37,1,13,32.80466044802487,0.6559684684684685,41.39254385964912,1034.4298245614036,27.95756282598388,0
4511,4,0,0,38,0.0,0.0,1.0,38,700,400,300,0.5714285714285714,10,4,6,331.40690699405786,0.35638928402086295,0.10124718323999904,0.207371059310075,133812.3509156664,1269.2674669129005,135081.6183825793,4382,101,1479.3947368421052,37,1,13,32.76547265790589,0.6565315315315314,41.33771929824562,1034.6491228070179,27.963489805595078,0
4512,4,0,0,38,0.0,0.0,1.0,38,1100,600,500,0.5454545454545454,16,6,10,330.14727626601416,0.35650782361308675,0.09299434776307436,0.20753998551955435,133982.57757194526,1246.7966104955392,135229.3741824408,4383,102,1480.3947368421052,37,1,15,32.62815081550519,0.6582207207207207,41.17324561403509,1035.30701754386,27.98127074442865,0
4513,4,0,0,38,0.0,0.0,1.0,38,1250,900,350,0.72,16,9,7,331.40000042139764,0.3562707444286392,0.08848635456946408,0.20897225660751143,134096.12212411506,1287.8909856879002,135384.01310980297,4384,103,1481.3947368421052,37,1,15,32.48244406803585,0.6593468468468469,41.06359649122807,1035.7456140350873,27.99312470365101,0
4514,4,0,0,38,0.0,0.0,1.0,38,1250,700,550,0.56,18,7,11,333.8211161672342,0.35612256993835945,0.09167650399804028,0.2114797044244434,134266.52912434586,1364.2005232379129,135630.72964758376,4385,104,1482.3947368421052,37,1,16,32.24978840457047,0.661036036036036,40.89912280701754,1036.4035087719292,28.010905642484573,0
4515,4,0,0,38,0.0,0.0,1.0,38,800,400,400,0.5,12,4,8,335.3648280324439,0.3553224276908487,0.09161545996972142,0.21311893910448834,134380.19390581705,1413.2781240381535,135793.4720298552,4386,105,1483.3947368421052,37,1,16,32.096464326001126,0.6621621621621623,40.78947368421052,1036.842105263157,28.022759601706944,0
4516,4,0,0,38,0.0,0.0,1.0,38,650,400,250,0.6153846153846154,9,4,5,339.41499975841793,0.35536688003793265,0.09363123953238595,0.21619706954308904,134465.47405211203,1527.9197685826198,135993.39382069465,4387,106,1484.3947368421052,37,1,16,31.90645152764561,0.6630067567567568,40.70723684210525,1037.1710526315776,28.031650071123718,0
4517,4,0,0,38,0.0,0.0,1.0,38,900,600,300,0.6666666666666666,12,6,6,339.2724079887774,0.35447783309625414,0.09941365939952962,0.21644344248023048,134522.342511638,1527.943814442888,136050.2863260809,4388,107,1485.3947368421052,37,1,18,31.853464221541063,0.6635698198198199,40.652412280701746,1037.3903508771916,28.03757705073491,0
4518,4,0,0,38,0.0,0.0,1.0,38,900,700,200,0.7777777777777778,11,7,4,339.1880776116516,0.35434447605500236,0.09839357429718865,0.21655854185974652,134550.78124999985,1527.6041666666515,136078.3854166665,4389,108,1486.3947368421052,37,1,19,31.827309236947794,0.6638513513513514,40.62499999999999,1037.4999999999989,28.04054054054051,0
4519,4,0,0,38,0.0,0.0,1.0,38,700,600,100,0.8571428571428571,8,6,2,338.2382726808726,0.35379623044096725,0.10251897572775048,0.21645877288197823,134636.1154994805,1507.8174294013454,136143.93292888187,4390,109,1487.3947368421052,37,1,20,31.76692639549216,0.6646959459459459,40.54276315789473,1037.8289473684204,28.049431009957306,0
4520,4,0,0,38,0.0,0.0,1.0,38,1050,800,250,0.7619047619047619,13,8,5,341.42164050539174,0.3531294452347084,0.10523536931028721,0.21935298070461745,134778.39936326563,1603.252443059403,136381.65180632504,4391,110,1488.3947368421052,37,1,21,31.542590637099615,0.6661036036036037,40.405701754385966,1038.3771929824563,28.064248458985308,0
4521,4,0,0,38,0.0,0.0,1.0,38,1000,600,400,0.6,14,6,8,342.194195710034,0.3532035324798483,0.10576597198686577,0.22036747899124076,134863.80575032698,1629.922307825477,136493.72805815245,4392,111,1489.3947368421052,37,1,13,31.43748460536963,0.6669481981981982,40.3234649122807,1038.706140350877,28.07313892840208,0
4522,4,0,0,38,0.0,0.0,1.0,38,900,600,300,0.6666666666666666,12,6,6,343.2921245880362,0.35304054054054057,0.10516871659833527,0.22124827131612626,134892.2805574793,1661.4915166205074,136553.7720740998,4393,112,1490.3947368421052,37,1,13,31.380620645978464,0.6672297297297296,40.29605263157895,1038.8157894736848,28.0761024182077,0
4523,4,0,0,38,0.0,0.0,1.0,38,700,500,200,0.7142857142857143,9,5,4,342.7724396237841,0.353381341868184,0.1090043049576439,0.22108705687102487,134920.75837036397,1649.4235005001506,136570.18187086412,4394,113,1491.3947368421052,37,1,13,31.36576517150393,0.6675112612612613,40.26864035087719,1038.9254385964914,28.07906590801328,0
4524,4,0,0,38,0.0,0.0,1.0,38,950,700,250,0.7368421052631579,12,7,5,341.16255763338324,0.35309981033665244,0.10003776057573721,0.2205688077250483,135006.20984341344,1611.812769313638,136618.02261272707,4395,114,1492.3947368421052,37,1,14,31.3225364000844,0.6683558558558558,40.18640350877193,1039.254385964913,28.08795637743008,0
4525,4,0,0,38,0.0,0.0,1.0,38,750,600,150,0.8,9,6,3,342.85894201741274,0.3531294452347084,0.10281730806602951,0.22184026698860465,135034.6996792283,1659.5708535318615,136694.27053276016,4396,115,1493.3947368421052,37,1,14,31.250109892042055,0.6686373873873874,40.15899122807018,1039.36403508772,28.090919867235673,0
4526,4,0,0,38,0.0,0.0,1.0,38,700,600,100,0.8571428571428571,8,6,2,344.20044159754457,0.35261083451872927,0.09906565908763021,0.22394275644679748,135234.21269044324,1709.5351454293686,136943.7478358726,4397,116,1494.3947368421052,37,1,16,31.01676154332701,0.6706081081081081,39.9671052631579,1040.1315789473688,28.11166429587483,0
4527,4,0,0,38,0.0,0.0,1.0,38,1350,1000,350,0.7407407407407407,17,10,7,341.6657817931875,0.3523589378852537,0.09748961401290135,0.22282244697151599,135319.76335266628,1646.8265475915784,136966.58990025785,4398,117,1495.3947368421052,37,1,16,30.997624442336733,0.6714527027027026,39.88486842105264,1040.4605263157903,28.12055476529163,0
4528,4,0,0,38,0.0,0.0,1.0,38,700,500,200,0.7142857142857143,9,5,4,339.37688161645735,0.35222558084400185,0.09401823141925614,0.22185711847819656,135405.341066482,1590.6884810711017,136996.0295475531,4399,118,1496.3947368421052,37,1,16,30.972134428992828,0.6722972972972973,39.80263157894737,1040.7894736842109,28.129445234708403,0
4529,4,0,0,38,0.0,0.0,1.0,38,1000,700,300,0.7,13,7,6,344.7010302531663,0.35221076339497387,0.09834261799839239,0.22587551982428028,135490.94583189092,1740.7737236457751,137231.7195555367,4400,119,1497.3947368421052,37,1,16,30.748529928032305,0.6731418918918917,39.720394736842124,1041.1184210526342,28.138335704125247,0
4530,4,0,0,38,0.0,0.0,1.0,38,650,600,50,0.9230769230769231,7,6,1,340.8600905623346,0.3523293029871977,0.08638667084463347,0.22286302028578947,135411.19352217106,1631.2543374242057,137042.44785959527,4401,120,1498.3947368421052,38,0,17,30.927727023882834,0.6705043859649124,39.797008547008545,1040.8119658119656,27.389788573999095,1
4531,4,0,0,38,0.0,0.0,1.0,38,1150,900,250,0.782608695652174,14,9,5,339.29614380516495,0.3520922238027501,0.08150712303023067,0.22252895138123405,135522.4142103148,1596.4465081452197,137118.86071846003,4402,121,1499.3947368421052,38,0,18,30.857958820712764,0.6716008771929824,39.69017094017094,1041.239316239316,27.401034637876734,0
4532,4,1,1,38,0.02564102564102564,0.02564102564102564,0.9743589743589743,39,650,400,250,0.6153846153846154,9,4,5,330.49394147078016,0.357146873594242,0.06749298262213399,0.21844843448434476,135800.66568047318,1176.305108115984,136976.97078858915,4403,0,1461.923076923077,38,1,19,30.811167486674854,0.674342105263158,39.42307692307691,1042.3076923076908,27.429149797570812,0
4533,4,0,0,38,0.0,0.0,1.0,38,850,600,250,0.7058823529411765,11,6,5,333.4563016350617,0.3519292318634424,0.07585583641317539,0.22023467992214113,135772.82769239886,1454.8609969683525,137227.6886893672,4404,123,1501.3947368421052,38,0,20,30.761575260550153,0.6740679824561404,39.44978632478632,1042.2008547008536,27.42633828160141,0
4534,4,0,0,38,0.0,0.0,1.0,38,750,400,350,0.5333333333333333,11,4,7,334.8738284139797,0.3515143432906591,0.07457803574222055,0.22151619958204696,135828.50652211602,1497.082397362821,137325.58891947885,4405,124,1502.3947368421052,38,0,20,30.66943391069659,0.6746162280701755,39.39636752136751,1042.4145299145277,27.431961313540203,0
4535,4,0,0,38,0.0,0.0,1.0,38,900,700,200,0.7777777777777778,11,7,4,334.02069493609406,0.35104018492176386,0.07119743718349048,0.22129721397700874,135884.19676610763,1477.6267669296326,137361.82353303727,4406,125,1503.3947368421052,38,0,14,30.636463777026325,0.6751644736842106,39.34294871794871,1042.6282051282037,27.437584345479046,0
4536,4,0,0,38,0.0,0.0,1.0,38,750,300,450,0.4,12,3,9,332.2157230217681,0.35139580369843526,0.06843506903076624,0.22079115751269682,135995.61149691333,1435.976080246891,137431.58757716022,4407,126,1504.3947368421052,38,0,15,30.573124722592105,0.6762609649122808,39.2361111111111,1043.0555555555536,27.448830409356674,0
4537,4,0,0,38,0.0,0.0,1.0,38,750,500,250,0.6666666666666666,10,5,5,333.1780717836911,0.3519292318634424,0.06800064677823592,0.22177804164742604,136051.33598372765,1465.8643573306863,137517.20034105834,4408,127,1505.3947368421052,38,0,15,30.492831541218635,0.6768092105263158,39.1826923076923,1043.2692307692296,27.454453441295517,0
4538,4,0,0,38,0.0,0.0,1.0,38,600,300,300,0.5,9,3,6,333.1780717836911,0.3519292318634424,0.06800064677823592,0.22177804164742604,136051.33598372765,1465.8643573306863,137517.20034105834,4409,128,1506.3947368421052,38,0,15,30.492831541218635,0.6768092105263158,39.1826923076923,1043.2692307692296,27.454453441295517,0
4539,4,0,0,38,0.0,0.0,1.0,38,1300,900,400,0.6923076923076923,17,9,8,334.3622153263577,0.3514254385964912,0.07784829562903073,0.22326619832694347,136162.81920017878,1505.5403745708038,137668.3595747496,4410,129,1507.3947368421052,38,0,16,30.35153717541883,0.677905701754386,39.07585470085469,1043.6965811965797,27.46569950517315,0
4540,4,0,0,38,0.0,0.0,1.0,38,550,200,350,0.36363636363636365,9,2,7,335.3202924341799,0.35084755808440016,0.07750931770687464,0.224434924497726,136246.46157498693,1537.2406676893534,137783.70224267629,4411,130,1508.3947368421052,38,0,16,30.24372356392413,0.6787280701754387,38.99572649572648,1044.0170940170917,27.47413405308136,0
4541,4,0,0,38,0.0,0.0,1.0,38,1000,700,300,0.7,13,7,6,337.00277167586796,0.35050675675675674,0.07697630959625612,0.22573873115752238,136274.34807372684,1584.966601833566,137859.3146755604,4412,131,1509.3947368421052,38,0,16,30.172200620757877,0.6790021929824562,38.96901709401708,1044.1239316239298,27.476945569050784,0
4542,4,0,0,38,0.0,0.0,1.0,38,800,500,300,0.625,11,5,6,334.6749094612951,0.34975106685633,0.0795772676371782,0.22471029635258358,136358.02469135783,1527.1219135802255,137885.14660493805,4413,132,1510.3947368421052,38,0,16,30.15015514184397,0.6798245614035088,38.88888888888888,1044.4444444444428,27.48538011695902,0
4543,4,0,0,38,0.0,0.0,1.0,38,1000,500,500,0.5,15,5,10,317.7173214270107,0.3492028212422949,0.06264593547688091,0.2034689372223733,134661.6480956422,956.8676263788124,135618.515722021,4414,133,1511.3947368421052,38,0,21,32.27397495282208,0.6631030701754387,40.51816239316238,1037.927350427348,27.31387764282495,5
4544,4,0,0,38,0.0,0.0,1.0,38,850,500,350,0.5882352941176471,12,5,7,317.5761675039305,0.3489361071597914,0.06326676524593355,0.2036889517911346,134717.09863987495,956.5879766600809,135673.68661653504,4415,134,1512.3947368421052,38,0,21,32.22252238345168,0.6636513157894738,40.464743589743584,1038.1410256410247,27.31950067476381,0
4545,4,0,0,38,0.0,0.0,1.0,38,1000,500,500,0.5,15,5,10,315.5829771814576,0.34890647226173543,0.057961873101640915,0.20302992198417913,134828.03397116283,909.8864736284468,135737.9204447913,4416,135,1513.3947368421052,38,0,19,32.16404347975174,0.6647478070175439,40.357905982905976,1038.568376068375,27.330746738641448,0
4546,4,0,0,38,0.0,0.0,1.0,38,900,800,100,0.8888888888888888,10,8,2,313.7323484082045,0.3487286628733997,0.05098328975787214,0.20214841773180728,134883.51875821818,863.4646203155738,135746.98337853377,4417,136,1514.3947368421052,38,0,19,32.156998868661944,0.665296052631579,40.304487179487175,1038.7820512820506,27.33636977058028,0
4547,4,0,0,38,0.0,0.0,1.0,38,700,300,400,0.42857142857142855,11,3,8,313.13596923097265,0.34890647226173543,0.049073197131646706,0.20207347715800972,134939.01495954764,850.8518472861244,135789.86680683377,4418,137,1515.3947368421052,38,0,19,32.11739502999142,0.6658442982456141,40.25106837606837,1038.9957264957252,27.341992802519083,0
4548,4,0,0,38,0.0,0.0,1.0,38,750,400,350,0.5333333333333333,11,4,7,310.0894494730351,0.3489509246088194,0.04220048476454252,0.2005684949783034,135022.28066330616,773.7969354956379,135796.07759880178,4419,138,1516.3947368421052,38,0,19,32.11391515899123,0.6666666666666667,40.17094017094016,1039.3162393162381,27.35042735042732,0
4549,4,0,0,38,0.0,0.0,1.0,38,1000,600,400,0.6,14,6,8,313.7051859864191,0.3491139165481271,0.03914320685434558,0.19493241325745708,133555.03420857998,779.3813691650344,134334.415577745,4420,139,1517.3947368421052,38,0,21,33.479974160206716,0.6521381578947367,41.58653846153847,1033.6538461538469,27.2014170040486,3
4550,4,0,0,38,0.0,0.0,1.0,38,700,400,300,0.5714285714285714,10,4,6,314.83194703296084,0.34963252726410626,0.04008548960746516,0.19607101566184032,133637.87187705483,814.6942800789234,134452.56615713376,4421,140,1518.3947368421052,38,0,22,33.368206240958884,0.6529605263157894,41.50641025641027,1033.9743589743612,27.209851551956874,0
4551,4,0,0,38,0.0,0.0,1.0,38,550,500,50,0.9090909090909091,6,5,1,314.0246140973976,0.34992887624466573,0.03880491518051321,0.19586071291641832,133693.11125721398,796.5855340054243,134489.6967912194,4422,141,1519.3947368421052,38,0,22,33.333978994490366,0.6535087719298245,41.45299145299146,1034.1880341880355,27.215474583895674,0
4552,4,0,0,38,0.0,0.0,1.0,38,750,400,350,0.5333333333333333,11,4,7,314.4818276341553,0.3505512091038407,0.038584894378064005,0.19643955194541254,133748.36205164745,812.285868215365,134560.64791986282,4423,142,1520.3947368421052,38,0,15,33.26705914755904,0.6540570175438596,41.399572649572654,1034.4017094017104,27.221097615834484,0
4553,4,0,0,38,0.0,0.0,1.0,38,550,200,350,0.36363636363636365,9,2,7,313.28263076027747,0.3505215742057847,0.04006065349246701,0.19598378528956917,133803.6242603552,783.6702827087598,134587.29454306397,4424,143,1521.3947368421052,38,0,15,33.242978108219724,0.6546052631578946,41.346153846153854,1034.615384615386,27.226720647773313,0
4554,4,0,0,38,0.0,0.0,1.0,38,750,400,350,0.5333333333333333,11,4,7,316.61880395848414,0.34981033665244193,0.039832239558433624,0.19866599564441667,133914.18292059316,879.9496858791719,134794.13260647233,4425,144,1522.3947368421052,38,0,15,33.04646641893753,0.6557017543859649,41.23931623931624,1035.0427350427349,27.237966711650916,0
4555,4,0,0,38,0.0,0.0,1.0,38,850,700,150,0.8235294117647058,10,7,3,315.16237129756564,0.34926209103840683,0.03633257465058004,0.19790072686339036,133941.8297195741,842.6849340711464,134784.51465364525,4426,145,1523.3947368421052,38,0,15,33.05660198850929,0.6559758771929824,41.212606837606835,1035.1495726495725,27.24077822762033,0
4556,4,0,0,38,0.0,0.0,1.0,38,750,500,250,0.6666666666666666,10,5,5,312.40669187953034,0.3492917259364628,0.03821557503867967,0.19705809224281387,134107.77043839952,779.2329835999824,134887.00342199948,4427,146,1524.3947368421052,38,0,16,32.962652570053294,0.6576206140350876,41.05235042735043,1035.790598290599,27.257647323436817,0
4557,4,0,0,38,0.0,0.0,1.0,38,1150,1000,150,0.8695652173913043,13,10,3,312.69541217143785,0.34909909909909914,0.03894454635247646,0.19768709955923125,134190.77932098776,792.1682098765566,134982.9475308643,4428,147,1525.3947368421052,38,0,17,32.872542448614844,0.6584429824561402,40.97222222222223,1036.111111111112,27.26608187134505,0
4558,4,0,0,38,0.0,0.0,1.0,38,750,700,50,0.9333333333333333,8,7,1,312.2607272784573,0.34875829777145567,0.03861511835459175,0.19786030799009247,134273.81388569294,785.6877556797433,135059.50164137268,4429,148,1526.3947368421052,38,0,18,32.801171700511965,0.659265350877193,40.89209401709402,1036.4316239316242,27.27451641925327,0
4559,4,1,2,37,0.02564102564102564,0.05128205128205128,0.9487179487179487,39,900,400,500,0.4444444444444444,14,4,10,305.8437007766519,0.3539136302294197,0.03255022236643201,0.19483593913199776,134469.7387695314,425.34450954862643,134895.08327908002,4430,0,1488.2307692307693,39,0,18,32.77269341501791,0.6594551282051282,40.70312500000001,1037.1875000000011,26.59455128205131,0
4560,4,1,0,38,0.02631578947368421,0.0,1.0,38,1400,1200,200,0.8571428571428571,16,12,4,310.50134646244703,0.35357396870554764,0.04692937286573806,0.19809251472735612,134523.07167251068,753.9189769157624,135276.99064942644,4431,0,1520.4473684210527,38,0,20,32.59891005835909,0.6617324561403508,40.6517094017094,1037.3931623931617,27.29982006297794,0
4561,4,0,0,38,0.0,0.0,1.0,38,950,600,350,0.631578947368421,13,6,7,308.1903380793544,0.35345542911332384,0.05135805948148753,0.19691740548859785,134578.49368105776,695.1582931550845,135273.65197421284,4432,1,1521.4473684210527,38,0,20,32.603780546403065,0.6622807017543859,40.598290598290596,1037.6068376068374,27.305443094916775,0
4562,4,0,0,38,0.0,0.0,1.0,38,850,700,150,0.8235294117647058,10,7,3,309.84391467794524,0.35308499288762446,0.05460587250775917,0.19872959200829013,134717.0986398751,748.2546433267619,135465.35328320187,4433,2,1522.4473684210527,38,0,21,32.423201605433775,0.6636513157894737,40.46474358974359,1038.1410256410259,27.319500674763837,0
4563,4,0,0,38,0.0,0.0,1.0,38,1350,1200,150,0.8888888888888888,15,12,3,310.1104712011358,0.3522552157420578,0.048037617962197965,0.1995091919620278,134828.03397116295,762.3170291840165,135590.35100034697,4434,3,1523.4473684210527,38,0,15,32.30613277097693,0.6647478070175439,40.35790598290598,1038.568376068376,27.330746738641473,0
4564,4,0,0,38,0.0,0.0,1.0,38,650,500,150,0.7692307692307693,8,5,3,309.549212348991,0.3519292318634424,0.05203884441124429,0.1994530809588627,134883.51875821815,750.6173980933511,135634.1361563115,4435,4,1524.4473684210527,38,0,15,32.26563303507149,0.665296052631579,40.304487179487175,1038.7820512820504,27.336369770580273,0
4565,4,0,0,38,0.0,0.0,1.0,38,850,500,350,0.5882352941176471,12,5,7,309.7680004679926,0.35221076339497387,0.05633764716066514,0.20036057902610596,135022.2806633064,765.1163799401106,135787.39704324648,4436,5,1525.4473684210527,38,0,15,32.12226733826756,0.6666666666666665,40.17094017094018,1039.31623931624,27.350427350427367,0
4566,4,0,0,38,0.0,0.0,1.0,38,1150,800,350,0.6956521739130435,15,8,7,310.4172898987999,0.3517217875770507,0.05999935109529697,0.20155380137325007,135161.1139076082,791.2693357805454,135952.38324338876,4437,6,1526.4473684210527,38,0,17,31.967704373437456,0.6680372807017544,40.03739316239316,1039.8504273504268,27.36448493027439,0
4567,4,0,0,38,0.0,0.0,1.0,38,1150,900,250,0.782608695652174,14,9,5,310.0630262597317,0.3519144144144144,0.061772910089521016,0.2017896807262532,135244.44809701218,786.8605723573606,136031.30866936955,4438,7,1527.4473684210527,38,0,18,31.894301218844138,0.668859649122807,39.957264957264954,1040.17094017094,27.37291947818263,0
4568,4,0,0,38,0.0,0.0,1.0,38,850,700,150,0.8235294117647058,10,7,3,310.3734427239887,0.35231448553816974,0.06837890846611439,0.20277315262068257,135383.3954840567,803.8821088100087,136187.2775928667,4439,8,1528.4473684210527,38,0,18,31.74853711117954,0.6702302631578947,39.823717948717956,1040.7051282051295,27.386977058029725,0
4569,4,0,0,38,0.0,0.0,1.0,38,900,800,100,0.8888888888888888,10,8,2,310.3734427239887,0.35231448553816974,0.06837890846611439,0.20277315262068257,135383.3954840567,803.8821088100087,136187.2775928667,4440,9,1529.4473684210527,38,0,18,31.74853711117954,0.6702302631578947,39.823717948717956,1040.7051282051295,27.386977058029725,0
4570,4,0,0,38,0.0,0.0,1.0,38,1050,700,350,0.6666666666666666,14,7,7,308.2306594055811,0.3510253674727359,0.06739607072267106,0.20215450919022854,135522.41421031498,754.4326192563452,136276.84682957132,4441,10,1530.4473684210527,38,0,19,31.6666239140844,0.6716008771929824,39.690170940170944,1041.2393162393173,27.401034637876773,0
4571,4,0,0,38,0.0,0.0,1.0,38,750,600,150,0.8,9,6,3,312.86454582564863,0.3502104077761972,0.07867038926650416,0.20599626125360257,135662.23651748605,888.8264598439309,136551.06297732997,4442,11,1531.4473684210527,37,1,19,31.407549205346815,0.674831081081081,39.555921052631575,1041.7763157894728,28.156116642958725,0
4572,4,0,0,38,0.0,0.0,1.0,38,1200,1000,200,0.8333333333333334,14,10,4,314.3479923984419,0.3494102655286866,0.08416236235903729,0.20796843171412563,135833.63540945284,939.8061182286764,136773.4415276815,4443,12,1532.4473684210527,37,1,21,31.19926983626099,0.6765202702702704,39.39144736842105,1042.4342105263152,28.1738975817923,0
4573,4,0,0,38,0.0,0.0,1.0,38,650,300,350,0.46153846153846156,10,3,7,314.3467174430263,0.3496769796111901,0.08045286736664958,0.20830124990701995,135890.79241930207,943.3649055478564,136834.15732484992,4444,13,1533.4473684210527,37,1,15,31.1427551091948,0.6770833333333334,39.33662280701754,1042.6535087719296,28.179824561403503,0
4574,4,0,0,38,0.0,0.0,1.0,38,800,400,400,0.5,12,4,8,316.2664944514464,0.3504030346135609,0.08411426927630217,0.2104167432315422,136033.737544244,1004.5826600492071,137038.3202042932,4445,14,1534.4473684210527,37,1,16,30.951317356877585,0.6784909909909911,39.19956140350875,1043.201754385962,28.194642010431405,0
4575,4,0,0,38,0.0,0.0,1.0,38,300,200,100,0.6666666666666666,4,2,2,316.36890503116354,0.35044748696064487,0.08173521033271558,0.2106543129021355,136062.33558643024,1009.1784250923141,137071.51401152255,4446,15,1535.4473684210527,37,1,17,30.92036696444211,0.6787725225225226,39.17214912280701,1043.3114035087704,28.197605500237035,0
4576,4,1,0,39,0.02564102564102564,0.0,1.0,39,800,600,200,0.75,10,6,4,308.42251797033265,0.3545602789023841,0.08511204202407052,0.2069775210957535,136339.89257812503,610.0585937500014,136949.95117187503,4447,0,1497.051282051282,39,0,19,30.853530819868336,0.6778846153846154,38.90625,1044.3750000000002,26.77884615384616,0
4577,4,0,0,39,0.0,0.0,1.0,39,1250,1000,250,0.8,15,10,5,307.70006725484546,0.35436347278452546,0.08304951264664062,0.20681074225412807,136394.2925347222,593.7065972222188,136987.9991319444,4448,1,1498.051282051282,39,0,19,30.81870761866772,0.6784188034188035,38.854166666666664,1044.5833333333333,26.78418803418803,0
4578,4,0,0,39,0.0,0.0,1.0,39,850,400,450,0.47058823529411764,13,4,9,306.84959176270957,0.35436347278452546,0.07935960074757586,0.2063980252037703,136421.49658203125,572.1761067708343,136993.6726888021,4449,2,1499.051282051282,39,0,19,30.814076677634862,0.6786858974358975,38.828125,1044.6875,26.786858974358974,0
4579,4,0,0,39,0.0,0.0,1.0,39,800,600,200,0.75,10,6,4,307.9874182477745,0.3547570850202429,0.08159321488002558,0.2074829947913651,136475.91281467024,606.5728081597334,137082.48562282996,4450,3,1500.051282051282,39,0,19,30.73067241551191,0.6792200854700854,38.77604166666667,1044.8958333333342,26.792200854700877,0
4580,4,0,0,39,0.0,0.0,1.0,39,1050,700,350,0.6666666666666666,14,7,7,305.76095843723056,0.3543353576248313,0.07685153958569657,0.20678011987035355,136612.00086805565,554.1232638888948,137166.12413194455,4451,4,1501.051282051282,39,0,21,30.65464328417697,0.6805555555555556,38.645833333333336,1045.4166666666672,26.805555555555568,0
4581,4,0,0,39,0.0,0.0,1.0,39,750,500,250,0.6666666666666666,10,5,5,309.04271360772054,0.3541666666666667,0.08152007355194657,0.2096478949068588,136720.92013888873,650.5642361110918,137371.48437499983,4452,5,1502.051282051282,38,1,21,30.461487383798136,0.683388157894737,38.54166666666666,1045.833333333332,27.521929824561365,0
4582,4,0,0,39,0.0,0.0,1.0,39,850,700,150,0.8235294117647058,10,7,3,309.63053542158593,0.35430724246513723,0.08543516408684981,0.2102137962397587,136748.855148294,668.3242475710181,137417.17939586504,4453,6,1503.051282051282,38,1,21,30.418581886278535,0.6836622807017545,38.51495726495725,1045.940170940169,27.524741340530767,0
4583,4,0,1,38,0.0,0.02564102564102564,0.9743589743589743,39,1000,800,200,0.8,12,8,4,310.3908831738671,0.3533232118758434,0.09268263306862323,0.21123404579024854,136832.67729792147,694.3231107093065,137527.0004086308,4454,7,1504.051282051282,38,1,21,30.31608461826474,0.6844846491228072,38.43482905982905,1046.260683760682,27.533175888439,0
4584,4,0,0,38,0.0,0.0,1.0,38,550,400,150,0.7272727272727273,7,4,3,316.12761450188776,0.35261083451872927,0.09599470374048358,0.2148046611358979,136778.263504155,1047.8772314558178,137826.14073561082,4455,8,1508.3947368421052,37,1,21,30.21968902865129,0.6858108108108109,38.48684210526315,1046.0526315789464,28.271692745376928,0
4585,4,0,0,38,0.0,0.0,1.0,38,1050,800,250,0.7619047619047619,13,8,5,313.0557267210445,0.3523737553342816,0.09758680019411448,0.21341456113040347,136892.98630347796,971.0266620498548,137864.0129655278,4456,9,1509.3947368421052,37,1,22,30.186941184688447,0.6869369369369369,38.37719298245614,1046.491228070175,28.283546704599328,0
4586,4,0,0,38,0.0,0.0,1.0,38,900,700,200,0.7777777777777778,11,7,4,315.4181148457293,0.3517366050260787,0.1036506370146586,0.2155545270173355,136979.05996316162,1041.135373384102,138020.19533654573,4457,10,1510.3947368421052,37,1,15,30.040304982367932,0.6877815315315315,38.29495614035087,1046.8201754385955,28.292437174016094,0
4587,4,0,0,38,0.0,0.0,1.0,38,1000,700,300,0.7,13,7,6,315.24081640058034,0.3501511379800854,0.10145654066084164,0.21667703308569386,137180.0037030625,1048.9472722376104,138228.95097530013,4458,11,1511.3947368421052,37,1,17,29.847009978368558,0.6897522522522522,38.103070175438596,1047.5877192982457,28.313181602655288,0
4588,4,0,0,38,0.0,0.0,1.0,38,1400,1100,300,0.7857142857142857,17,11,6,312.96465525549235,0.34970661450924606,0.09446481866939793,0.21582367784502127,137294.8948234071,993.6898853493306,138288.58470875645,4459,12,1512.3947368421052,37,1,17,29.793541187138178,0.6908783783783784,37.993421052631575,1048.0263157894728,28.325035561877645,0
4589,4,0,0,38,0.0,0.0,1.0,38,1000,800,200,0.8,12,8,4,312.459127688412,0.34983997155049784,0.09221671243884066,0.21636833005679101,137438.57635282012,988.7875355878762,138427.363888408,4460,13,1513.3947368421052,37,1,17,29.66544232981282,0.692286036036036,37.85635964912281,1048.5745614035088,28.339853010905642,0
4590,4,0,0,38,0.0,0.0,1.0,38,1150,700,450,0.6086956521739131,16,7,9,311.42601173364955,0.34902501185395923,0.09059804611864108,0.21654971513572377,137582.3330255463,969.3434518313313,138551.67647737765,4461,14,1514.3947368421052,37,1,18,29.551194955406906,0.6936936936936937,37.719298245614034,1049.1228070175437,28.35467045993361,0
4591,4,0,0,38,0.0,0.0,1.0,38,1000,700,300,0.7,13,7,6,309.42779023117293,0.34868421052631576,0.0871459344757739,0.21554608196103406,137644.2821334648,918.1932117028241,138562.47534516762,4462,15,1515.3947368421052,38,0,18,29.54273569537773,0.6924342105263157,37.66025641025641,1049.3589743589741,27.61470985155195,0
4592,4,0,0,38,0.0,0.0,1.0,38,750,600,150,0.8,9,6,3,310.36830262748276,0.3483730440967283,0.08661465840106741,0.21637670948969223,137672.31131063253,945.8243160566808,138618.1356266892,4463,16,1516.3947368421052,38,0,18,29.490523940411954,0.6927083333333334,37.633547008547005,1049.4658119658113,27.617521367521352,0
4593,4,0,0,38,0.0,0.0,1.0,38,1100,900,200,0.8181818181818182,13,9,4,310.9323063975497,0.34844713134186817,0.08105241732460544,0.21729877970571287,137756.41596354733,966.5840273212013,138722.99999086853,4464,17,1517.3947368421052,38,0,18,29.393106723658335,0.6935307017543859,37.5534188034188,1049.7863247863245,27.625955915429593,0
4594,4,0,0,38,0.0,0.0,1.0,38,1050,700,350,0.6666666666666666,14,7,7,312.8817715932696,0.34775071123755336,0.08880767602652728,0.21920529828003307,137842.06239601097,1025.676565055257,138867.73896106624,4465,18,1518.3947368421052,36,2,18,29.257819481680066,0.6982060185185185,37.47184684684685,1050.1126126126132,29.16979479479481,0
4595,4,0,0,38,0.0,0.0,1.0,38,550,400,150,0.7272727272727273,7,4,3,312.8817715932696,0.34775071123755336,0.08880767602652728,0.21920529828003307,137842.06239601097,1025.6537365067875,138867.71613251776,4466,19,1519.3947368421052,36,2,18,29.257819481680066,0.6982060185185185,37.47184684684685,1050.1126126126132,29.16979479479481,0
4596,4,0,0,38,0.0,0.0,1.0,38,500,100,400,0.2,9,1,8,314.09070040623635,0.3471580132764343,0.09411555585651143,0.2204306969668147,137901.19669923303,1062.6966916240567,138963.8933908571,4467,20,1520.3947368421052,36,2,18,29.16800686179908,0.6987847222222222,37.41554054054054,1050.337837837838,29.176051051051054,0
4597,4,0,0,38,0.0,0.0,1.0,38,1300,900,400,0.6923076923076923,17,9,8,315.77167987972007,0.34698020388809864,0.09449824862230605,0.2223747581100127,138019.50335047892,1116.5300858290816,139136.033436308,4468,21,1521.3947368421052,36,2,19,29.007698353159718,0.6999421296296295,37.30292792792793,1050.7882882882889,29.18856356356358,0
4598,4,0,0,38,0.0,0.0,1.0,38,500,400,100,0.8,6,4,2,315.4249274677115,0.3468320293978189,0.10280776928931834,0.2228986902279401,138137.86072812695,1114.4249401428642,139252.28566826982,4469,22,1522.3947368421052,36,2,17,28.90064274236744,0.701099537037037,37.190315315315324,1051.23873873874,29.201076076076113,0
4599,4,0,0,38,0.0,0.0,1.0,38,950,600,350,0.631578947368421,13,6,7,314.6026656224864,0.34649122807017546,0.09897306985604937,0.22289527250248722,138226.66205056425,1097.2952682412324,139323.95731880548,4470,23,1523.3947368421052,36,2,17,28.83513600342686,0.7019675925925926,37.105855855855864,1051.576576576578,29.2104604604605,0
4600,4,0,0,38,0.0,0.0,1.0,38,950,700,250,0.7368421052631579,12,7,5,315.8832524747012,0.34540955429113324,0.10148042159342485,0.22477511255682672,138374.72766262907,1142.0518068744648,139516.77946950353,4471,24,1524.3947368421052,36,2,17,28.65625780441686,0.7034143518518517,36.9650900900901,1052.1396396396412,29.226101101101147,0
4601,4,0,0,38,0.0,0.0,1.0,38,650,300,350,0.46153846153846156,10,3,7,313.80309605855336,0.34540955429113324,0.07451917781057915,0.21604484048526945,137237.44325176996,1013.1069175130995,138250.55016928306,4472,25,1525.3947368421052,37,1,17,29.82811845960654,0.6903153153153152,38.048245614035096,1047.807017543861,28.319108582266516,3
4602,4,0,0,38,0.0,0.0,1.0,38,700,400,300,0.5714285714285714,10,4,6,311.96518700915755,0.34539473684210525,0.07361096578424187,0.2149568343364472,137266.16753472242,964.4531250000203,138230.62065972245,4473,26,1526.3947368421052,37,1,17,29.847995361166348,0.6905968468468466,38.02083333333334,1047.9166666666683,28.322072072072118,0
4603,4,0,0,38,0.0,0.0,1.0,38,1100,800,300,0.7272727272727273,14,8,6,313.32303819049866,0.34459459459459457,0.07451506158428822,0.2162494528565328,137323.62511782482,1005.3310874499941,138328.95620527482,4474,27,1527.3947368421052,37,1,17,29.755880147853667,0.6911599099099097,37.96600877192983,1048.1359649122815,28.327999051683282,0
4604,4,0,0,38,0.0,0.0,1.0,38,1000,700,300,0.7,13,7,6,314.96152488448513,0.34471313418681837,0.06998001750532556,0.217740212539448,137381.09472385747,1053.9518169052155,138435.04654076268,4475,28,1528.3947368421052,37,1,17,29.656394902904175,0.6917229729729729,37.91118421052632,1048.3552631578957,28.333926031294478,0
4605,4,0,0,38,0.0,0.0,1.0,38,450,400,50,0.8888888888888888,5,4,1,312.45883900679434,0.3445501422475106,0.06495850668075498,0.21654756059862182,137467.32167590028,990.5759464450656,138457.89762234534,4476,29,1529.3947368421052,37,1,17,29.637181095775823,0.6925675675675675,37.828947368421055,1048.6842105263158,28.34281650071124,0
4606,4,0,0,38,0.0,0.0,1.0,38,650,400,250,0.6153846153846154,9,4,5,314.0283459609588,0.34444642010431487,0.06572481910474082,0.21781589043629962,137496.07000471302,1035.5326879424515,138531.60269265546,4477,30,1530.3947368421052,37,1,17,29.567760062728716,0.6928490990990991,37.8015350877193,1048.793859649123,28.34577999051684,0
4607,4,0,0,38,0.0,0.0,1.0,38,1050,700,350,0.6666666666666666,14,7,7,310.32659356152203,0.34332029397818875,0.054646987335646324,0.21632453219062853,137668.62309797248,944.4469692597777,138613.07006723224,4478,31,1531.3947368421052,37,1,17,29.49524170236479,0.6945382882882882,37.637061403508774,1049.4517543859652,28.36356092935041,0
4608,4,0,1,37,0.0,0.02631578947368421,0.9736842105263158,38,700,400,300,0.5714285714285714,10,4,6,310.32659356152203,0.34332029397818875,0.054646987335646324,0.21632453219062853,137668.62309797248,944.4469692597777,138613.07006723224,4479,32,1532.3947368421052,37,1,17,29.49524170236479,0.6945382882882882,37.637061403508774,1049.4517543859652,28.36356092935041,0
4609,4,0,0,37,0.0,0.0,1.0,37,900,700,200,0.7777777777777778,11,7,4,315.2116237514122,0.34353103103103105,0.05173777456386164,0.2191820360504006,137582.3330255463,1273.5101184979985,138855.8431440443,4480,33,1529.6756756756756,37,0,17,29.45190565774805,0.6936936936936937,37.719298245614034,1049.1228070175437,28.35467045993361,0
4610,4,0,0,37,0.0,0.0,1.0,37,850,600,250,0.7058823529411765,11,6,5,317.89307198794864,0.34450075075075076,0.05129233297658797,0.22159902345205099,137668.6230979726,1352.7803025931257,139021.40340056573,4481,34,1530.6756756756756,37,0,17,29.296725350886355,0.6945382882882882,37.63706140350878,1049.451754385966,28.363560929350434,0
4611,4,0,0,37,0.0,0.0,1.0,37,800,500,300,0.625,11,5,6,317.1151401008154,0.34434434434434436,0.04999421232577017,0.22142547309884056,137726.16484158594,1335.0104118575036,139061.17525344345,4482,35,1531.6756756756756,37,0,17,29.26057226922943,0.6951013513513513,37.58223684210527,1049.6710526315794,28.369487908961606,0
4612,4,0,0,37,0.0,0.0,1.0,37,1150,900,250,0.782608695652174,14,9,5,316.5982843068752,0.3434684684684685,0.04460672825675993,0.2219896315586568,137870.0718009389,1329.885637888601,139199.9574388275,4483,36,1532.6756756756756,37,0,18,29.132734739333213,0.6965090090090089,37.4451754385965,1050.2192982456152,28.3843053579896,0
4613,4,0,0,37,0.0,0.0,1.0,37,700,500,200,0.7142857142857143,9,5,4,318.2203703784413,0.34375,0.047384754274107044,0.22350081731858285,137927.65562480772,1378.2779316712922,139305.93355647902,4484,37,1533.6756756756756,37,0,18,29.033576896311757,0.697072072072072,37.390350877192986,1050.4385964912287,28.390232337600775,0
4614,4,0,0,37,0.0,0.0,1.0,37,750,500,250,0.6666666666666666,10,5,5,319.0148029122453,0.34274899899899897,0.04908466851490978,0.2246229872379167,138014.05390360494,1405.7052410357032,139419.75914464064,4485,38,1534.6756756756756,37,0,20,28.927854012313478,0.6979166666666666,37.30811403508772,1050.767543859649,28.399122807017545,0
4615,4,0,0,37,0.0,0.0,1.0,37,650,600,50,0.9230769230769231,7,6,1,320.9889204425625,0.3424674674674675,0.058068918073091114,0.22658319524023596,138100.47923399514,1465.7447483841252,139566.22398237928,4486,39,1535.6756756756756,37,0,14,28.791118992975864,0.6987612612612613,37.22587719298246,1051.0964912280706,28.40801327643434,0
4616,4,0,0,37,0.0,0.0,1.0,37,750,500,250,0.6666666666666666,10,5,5,319.1151095726287,0.3420608108108108,0.06083547307866799,0.2258298734827998,138186.93161597804,1419.507564827637,139606.43918080567,4487,40,1536.6756756756756,37,0,15,28.75549674974796,0.6996058558558558,37.14364035087719,1051.4254385964916,28.416903745851126,0
4617,4,0,0,37,0.0,0.0,1.0,37,750,600,150,0.8,9,6,3,317.6366587979962,0.34193568568568566,0.06061494236676701,0.2249730840378719,138215.75508810417,1380.4781278855178,139596.2332159897,4488,41,1537.6756756756756,37,0,15,28.766075773375043,0.6998873873873873,37.116228070175445,1051.5350877192993,28.41986723565674,0
4618,4,0,0,37,0.0,0.0,1.0,37,1250,800,450,0.64,17,8,9,318.802967637859,0.34159159159159164,0.06316542749358289,0.22637134482235258,138302.24353887746,1418.233134233617,139720.4766731111,4489,42,1538.6756756756756,37,0,16,28.650556829632713,0.7007319819819819,37.03399122807018,1051.8640350877201,28.42875770507352,0
4619,4,0,0,37,0.0,0.0,1.0,37,1050,900,150,0.8571428571428571,12,9,3,322.1561965800574,0.3409972472472473,0.0656937800390236,0.22991653018379,138475.30159520262,1522.1352964373837,139997.43689164,4490,43,1539.6756756756756,37,0,16,28.392606000625047,0.7024211711711711,36.86951754385966,1052.5219298245634,28.446538643907118,0
4620,4,0,0,37,0.0,0.0,1.0,37,600,400,200,0.6666666666666666,8,4,4,322.12990905023366,0.33952702702702703,0.06523862193965302,0.23067960601114046,138590.73374740302,1528.8440914512128,140119.57783885422,4491,44,1540.6756756756756,37,0,17,28.28011645666285,0.7035472972972974,36.75986842105263,1052.9605263157891,28.458392603129436,0
4621,4,0,0,37,0.0,0.0,1.0,37,1100,1000,100,0.9090909090909091,12,10,2,322.07129020347134,0.33840090090090086,0.06412239502770212,0.23201687397716347,138792.8557344567,1540.238823484146,140333.09455794084,4492,45,1541.6756756756756,37,0,17,28.08359347901492,0.7055180180180181,36.56798245614035,1053.7280701754382,28.4791370317686,0
4622,4,0,0,37,0.0,0.0,1.0,37,600,400,200,0.6666666666666666,8,4,4,320.32628793699956,0.33796296296296297,0.06368165918727775,0.23115437534913186,138850.6319252076,1495.5015004616662,140346.13342566925,4493,46,1542.6756756756756,37,0,18,28.072981689554737,0.7060810810810811,36.513157894736835,1053.9473684210514,28.485064011379766,0
4623,4,0,0,37,0.0,0.0,1.0,37,750,600,150,0.8,9,6,3,320.53548364567405,0.3375563063063063,0.06388870926476309,0.231503200923055,138879.52452918192,1503.1631126885077,140382.68764187043,4494,47,1543.6756756756756,37,0,18,28.03917871632165,0.7063626126126126,36.48574561403508,1054.0570175438586,28.488027501185368,0
4624,4,0,0,37,0.0,0.0,1.0,37,750,400,350,0.5333333333333333,11,4,7,321.24067281984054,0.33724349349349353,0.0640890500484883,0.23241001272857525,138937.31875432818,1526.4635512850032,140463.7823056132,4495,48,1544.6756756756756,37,0,18,27.964010227075754,0.7069256756756757,36.430921052631575,1054.276315789473,28.49395448079657,0
4625,4,0,0,37,0.0,0.0,1.0,37,900,500,400,0.5555555555555556,13,5,8,331.07749865722815,0.3368055555555556,0.0850054894998713,0.21888952339795037,135809.69482996516,1596.8216593790712,137406.51648934424,4496,49,1545.6756756756756,36,1,21,30.787012028233924,0.6782407407407407,39.414414414414416,1042.3423423423428,28.953953953953967,8
4626,4,0,0,37,0.0,0.0,1.0,37,750,600,150,0.8,9,6,3,332.33378531142756,0.33708708708708707,0.08728979546562421,0.2202633155474954,135897.7447675718,1632.6823867786893,137530.4271543505,4497,50,1546.6756756756756,36,1,16,30.667008676242936,0.6791087962962963,39.329954954954964,1042.6801801801817,28.963338338338378,0
4627,4,0,0,37,0.0,0.0,1.0,37,1100,900,200,0.8181818181818182,13,9,4,330.803069170953,0.3374624624624625,0.08246947573517849,0.22051951359266575,136103.30558599153,1604.6782424316348,137707.98382842317,4498,51,1547.6756756756756,36,1,16,30.503318584070783,0.6811342592592593,39.13288288288289,1043.4684684684696,28.985235235235265,0
4628,4,0,0,37,0.0,0.0,1.0,37,700,500,200,0.7142857142857143,9,5,4,329.23501941631184,0.33708708708708707,0.08378669932067995,0.2202026428563647,136220.83865960577,1569.7340922003318,137790.5727518061,4499,52,1548.6756756756756,36,1,16,30.42790363178714,0.6822916666666666,39.02027027027028,1043.9189189189206,28.997747747747795,0
4629,4,0,0,37,0.0,0.0,1.0,37,750,500,250,0.6666666666666666,10,5,5,329.4803426629149,0.3359296796796796,0.08800907021547588,0.22091621240153378,136309.0217540176,1582.2286391120933,137891.25039312968,4500,53,1549.6756756756756,36,1,16,30.33425895970379,0.6831597222222222,38.935810810810814,1044.2567567567573,29.00713213213215,0
4630,4,0,0,37,0.0,0.0,1.0,37,1000,600,400,0.6,14,6,8,329.0690419279137,0.33549174174174173,0.0895286661324397,0.22100762953522127,136367.82633562642,1574.885992411358,137942.71232803777,4501,54,1550.6756756756756,36,1,17,30.28683737646002,0.6837384259259258,38.87950450450452,1044.4819819819838,29.01338838838844,0
4631,4,0,0,37,0.0,0.0,1.0,37,650,400,250,0.6153846153846154,9,4,5,329.00936839699625,0.33561686686686687,0.08770089623905908,0.2211515145833726,136397.23338203088,1575.1935212239496,137972.42690325485,4502,55,1551.6756756756756,36,1,18,30.259316156389254,0.6840277777777777,38.85135135135136,1044.5945945945962,29.01651651651656,0
4632,4,0,0,37,0.0,0.0,1.0,37,500,400,100,0.8,6,4,2,328.77749449037844,0.33552302302302306,0.09256589275987892,0.2215487560912294,136485.47354364532,1574.6704052025366,138060.14394884786,4503,56,1552.6756756756756,36,1,21,30.178135215720086,0.6848958333333333,38.76689189189191,1044.932432432435,29.02590090090097,0
4633,4,0,0,37,0.0,0.0,1.0,37,700,300,400,0.42857142857142855,11,3,8,338.2339047372796,0.33552302302302306,0.10954394627863984,0.22454366966107148,135956.46057797672,1797.0169071098212,137753.47748508654,4504,57,1553.6756756756756,36,1,16,30.454999460101504,0.6796875,39.27364864864865,1042.905405405406,28.969594594594614,4
4634,4,0,0,37,0.0,0.0,1.0,37,700,600,100,0.8571428571428571,8,6,2,338.93455336831596,0.335304054054054,0.10900686910188084,0.22519453610454412,135985.82323877935,1818.0588527716936,137803.88209155106,4505,58,1554.6756756756756,36,1,16,30.407624343194403,0.6799768518518519,39.2454954954955,1043.0180180180182,28.97272272272273,0
4635,4,0,0,37,0.0,0.0,1.0,37,1000,600,400,0.6,14,6,8,342.3086086233947,0.33461586586586584,0.11053435826849722,0.2285674484669757,136162.06578199822,1921.889457024594,138083.95523902282,4506,59,1555.6756756756756,36,1,20,30.144943173644076,0.681712962962963,39.07657657657658,1043.6936936936938,28.991491491491495,0
4636,4,0,0,37,0.0,0.0,1.0,37,500,200,300,0.4,8,2,6,345.1660539793256,0.3342092092092092,0.11420741129478995,0.23085781532383481,136220.83865960562,2003.7618699780928,138224.60052958372,4507,60,1556.6756756756756,36,1,20,30.012135922330096,0.6822916666666667,39.020270270270274,1043.9189189189194,28.997747747747763,0
4637,4,0,0,37,0.0,0.0,1.0,37,1150,700,450,0.6086956521739131,16,7,9,343.2083923616875,0.33433433433433435,0.10817223608422899,0.22992978424693397,136279.6242188134,1954.4621479587663,138234.0863667722,4508,61,1557.6756756756756,36,1,21,30.004988136324407,0.6828703703703705,38.96396396396396,1044.144144144144,29.004004004004003,0
4638,4,0,0,37,0.0,0.0,1.0,37,650,400,250,0.6153846153846154,9,4,5,341.2616815435929,0.33449074074074076,0.10483210483210503,0.2288155873430035,136309.02175401757,1903.4091946676472,138212.4309486852,4509,62,1558.6756756756756,36,1,21,30.02669039145908,0.6831597222222222,38.935810810810814,1044.256756756757,29.007132132132142,0
4639,4,0,0,37,0.0,0.0,1.0,37,1250,1000,250,0.8,15,10,5,344.28338299154603,0.3338963963963964,0.10473410020628626,0.23141830874127398,136397.23338203062,1991.860187890585,138389.0935699212,4510,63,1559.6756756756756,36,1,21,29.860437329308606,0.6840277777777779,38.85135135135135,1044.5945945945941,29.016516516516504,0
4640,4,0,0,37,0.0,0.0,1.0,37,850,600,250,0.7058823529411765,11,6,5,344.0416341767694,0.3338963963963964,0.10097197100106925,0.23183459139624119,136485.47354364494,1991.3370718691572,138476.81061551408,4511,64,1560.6756756756756,36,1,21,29.779385350432868,0.6848958333333334,38.76689189189189,1044.9324324324318,29.025900900900883,0
4641,4,0,0,37,0.0,0.0,1.0,37,550,400,150,0.7272727272727273,7,4,3,342.7673424631483,0.3334897397397398,0.097212273682862,0.23155505624038886,136573.74223886052,1962.6037354922546,138536.34597435276,4512,65,1561.6756756756756,36,1,21,29.7253196150255,0.6857638888888888,38.682432432432435,1045.2702702702707,29.035285285285298,0
4642,4,0,0,37,0.0,0.0,1.0,37,800,500,300,0.625,11,5,6,342.7673424631483,0.3334897397397398,0.097212273682862,0.23155505624038886,136573.74223886052,1962.6037354922546,138536.34597435276,4513,66,1562.6756756756756,36,1,21,29.7253196150255,0.6857638888888888,38.682432432432435,1045.2702702702707,29.035285285285298,0
4643,4,0,0,37,0.0,0.0,1.0,37,400,200,200,0.5,6,2,4,342.7363909287379,0.3334897397397398,0.09310715178978635,0.21400637326175773,133734.17494775177,1772.7062789140437,135506.8812266658,4514,67,1563.6756756756756,36,1,17,32.55058065686808,0.6576967592592593,41.413288288288285,1034.3468468468466,28.73185685685685,4
4644,4,0,0,37,0.0,0.0,1.0,37,600,500,100,0.8333333333333334,7,5,2,341.95116883077486,0.3329266766766767,0.09401063194466897,0.21385332798150627,133792.4215389376,1750.0949851878897,135542.5165241255,4515,68,1564.6756756756756,36,1,17,32.51265374986394,0.658275462962963,41.35698198198198,1034.5720720720722,28.738113113113116,0
4645,4,0,0,37,0.0,0.0,1.0,37,800,600,200,0.75,10,6,4,342.86768805362675,0.33405280280280275,0.10103891292010125,0.2151055918703672,133908.95276611054,1782.61060891971,135691.56337503024,4516,69,1565.6756756756756,36,1,17,32.37247488485112,0.6594328703703705,41.24436936936936,1035.022522522521,28.750625625625585,0
4646,4,0,0,37,0.0,0.0,1.0,37,750,500,250,0.6666666666666666,10,5,5,342.6497660536479,0.33386511511511513,0.0961908177483557,0.21548029747587122,133996.38447569186,1782.7659585260876,135779.15043421794,4517,70,1566.6756756756756,36,1,17,32.29076027844247,0.6603009259259259,41.159909909909906,1035.36036036036,28.760010010009996,0
4647,4,0,0,37,0.0,0.0,1.0,37,1000,800,200,0.8,12,8,4,342.67551317298347,0.3335835835835836,0.09905011579652734,0.21583863144786003,134054.68813408003,1787.4518099180248,135842.13994399805,4518,71,1567.6756756756756,36,1,17,32.23185805422648,0.6608796296296295,41.1036036036036,1035.5855855855855,28.766266266266264,0
4648,4,0,0,37,0.0,0.0,1.0,37,650,500,150,0.7692307692307693,8,5,3,342.67551317298347,0.3335835835835836,0.09905011579652734,0.21583863144786003,134054.68813408003,1787.4518099180248,135842.13994399805,4519,72,1568.6756756756756,36,1,17,32.23185805422648,0.6608796296296295,41.1036036036036,1035.5855855855855,28.766266266266264,0
4649,4,0,0,37,0.0,0.0,1.0,37,850,400,450,0.47058823529411764,13,4,9,343.9597866766371,0.3334271771771771,0.0997337846652917,0.21699191480464383,134113.00447406856,1825.896081892692,135938.90055596124,4520,73,1569.6756756756756,36,1,17,32.14036565920127,0.6614583333333335,41.04729729729729,1035.81081081081,28.772522522522497,0
4650,4,0,0,37,0.0,0.0,1.0,37,1150,800,350,0.6956521739130435,15,8,7,344.5230438500724,0.3332707707707708,0.0985850539159967,0.21786642793570546,134200.5027620526,1847.0331395584797,136047.5359016111,4521,74,1570.6756756756756,36,1,18,32.038410679998556,0.6623263888888888,40.96283783783784,1036.1486486486488,28.78190690690691,0
4651,4,0,0,37,0.0,0.0,1.0,37,1150,800,350,0.6956521739130435,15,8,7,364.1755933627387,0.3332707707707708,0.12368194281237699,0.2158772847253349,131786.1128826531,2245.5537299227008,134031.66661257582,4522,75,1571.6756756756756,34,3,19,33.95531400966182,0.6424632352941178,43.30357142857143,1026.7857142857147,30.199579831932784,5
4652,4,0,0,37,0.0,0.0,1.0,37,1300,1000,300,0.7692307692307693,16,10,6,362.12080559859004,0.3333333333333333,0.12030254228260251,0.21483177916736151,131816.67375283438,2146.712018140577,133963.38577097497,4523,76,1572.6756756756756,34,3,19,33.977220032459996,0.6427696078431373,43.27380952380952,1026.9047619047612,30.203081232492977,0
4653,4,0,0,37,0.0,0.0,1.0,37,750,300,450,0.4,12,3,9,362.03843070804515,0.33298923923923923,0.12104224734583968,0.21547528669037447,131938.95266439905,2153.3942743764173,134092.34693877547,4524,77,1573.6756756756756,34,3,19,33.85597721127851,0.6439950980392157,43.154761904761905,1027.380952380952,30.217086834733884,0
4654,4,0,0,37,0.0,0.0,1.0,37,700,400,300,0.5714285714285714,10,4,6,363.2789488383851,0.3332394894894895,0.12125385373792996,0.21708745489407993,132091.8810232426,2197.2399376417206,134289.12096088432,4525,78,1574.6756756756756,34,3,20,33.66989963327543,0.6455269607843137,43.00595238095238,1027.9761904761904,30.234593837535012,0
4655,4,2,0,39,0.05128205128205128,0.0,1.0,39,800,500,300,0.625,11,5,6,351.8222817023248,0.34531039136302294,0.14424967647602593,0.214419518422309,132832.97444403864,1546.7200308416552,134379.6944748803,4526,0,1494.871794871795,36,3,16,33.219084553200794,0.6487268518518519,42.28603603603604,1030.855855855856,28.634884884884887,0
4656,4,0,1,38,0.0,0.02564102564102564,0.9743589743589743,39,850,800,50,0.9411764705882353,9,8,1,354.913409923604,0.34531039136302294,0.14177880065628456,0.21697576822966394,132949.08717839463,1637.0827753429082,134586.16995373755,4527,1,1495.871794871795,36,3,17,33.02281247725121,0.6498842592592593,42.17342342342342,1031.3063063063064,28.6473973973974,0
4657,4,0,0,38,0.0,0.0,1.0,38,1100,700,400,0.6363636363636364,15,7,8,353.62884002974766,0.3457799905168326,0.12188002757986638,0.21652674964388297,133007.1625679734,1807.0337229121033,134814.1962908855,4528,2,1464.2894736842106,36,2,17,32.997634643377,0.650462962962963,42.11711711711712,1031.5315315315318,28.65365365365366,0
4658,4,0,0,38,0.0,0.0,1.0,38,800,600,200,0.75,10,6,4,352.28834621166027,0.3462393314366998,0.12146964048777376,0.2162101886361315,133094.29943034257,1777.5141273029806,134871.81355764554,4529,3,1465.2894736842106,36,2,17,32.94476881661756,0.6513310185185186,42.03265765765766,1031.8693693693697,28.663038038038046,0
4659,4,2,1,39,0.05,0.025,0.975,40,1250,900,350,0.72,16,9,7,336.76347461852896,0.35733173076923075,0.11010762379387118,0.20991515724569376,133670.5780264119,1003.6094597102756,134674.1874861222,4530,0,1392.975,37,3,18,32.76859558901495,0.6551238738738738,41.47478070175438,1034.1008771929821,27.948672356567084,0
4660,4,0,0,39,0.0,0.0,1.0,39,850,600,250,0.7058823529411765,11,6,5,344.0102164980388,0.3521704903283851,0.12104507704594858,0.21429455955800503,133646.82883897415,1395.1749046343728,135042.0037436085,4531,1,1429.6923076923076,36,3,19,32.60500617149496,0.6568287037037037,41.49774774774775,1034.0090090090096,28.72247247247249,0
4661,4,0,0,39,0.0,0.0,1.0,39,850,500,350,0.5882352941176471,12,5,7,363.6369304242379,0.3521704903283851,0.15750542356046937,0.20861276534864176,130528.564453125,1725.3679170090695,132253.93237013408,4532,2,1430.6923076923076,35,4,16,35.24146279306831,0.6276785714285715,44.53125,1021.875,29.196428571428573,7
4662,4,0,0,39,0.0,0.0,1.0,39,850,600,250,0.7058823529411765,11,6,5,363.8131601761143,0.35127080521817367,0.15615683610702358,0.20935255008701079,130646.86381440745,1706.2096782835933,132353.07349269104,4533,3,1431.6923076923076,35,4,16,35.1170091324201,0.6288690476190477,44.41550925925925,1022.3379629629619,29.209656084656054,0
4663,4,0,0,39,0.0,0.0,1.0,39,900,600,300,0.6666666666666666,12,6,6,365.4143035564383,0.3520580296896086,0.15526163127973103,0.21140461017270365,130854.01663237298,1763.1858710562237,132617.2025034292,4534,4,1432.6923076923076,35,4,16,34.866138763197576,0.630952380952381,44.212962962962955,1023.1481481481471,29.232804232804202,0
4664,4,1,0,40,0.025,0.0,1.0,40,1200,1000,200,0.8333333333333334,14,10,4,359.51681042784907,0.3573851495726496,0.1568601583113458,0.20962595561869968,131155.04017531045,1430.488343072803,132585.52851838325,4535,0,1397.85,36,4,17,34.71237357080035,0.6319444444444444,43.91891891891892,1024.3243243243244,28.453453453453456,0
4665,4,0,0,40,0.0,0.0,1.0,40,700,700,0,1.0,7,7,0,361.134887090931,0.3570379273504274,0.15370879120879155,0.2112035650724597,131270.41737683638,1481.2654715526423,132751.68284838903,4536,1,1398.85,36,4,17,34.55425824175824,0.6331018518518519,43.80630630630631,1024.7747747747753,28.46596596596598,0
4666,4,0,0,40,0.0,0.0,1.0,40,650,400,250,0.6153846153846154,9,4,5,360.56580077995864,0.3567708333333333,0.15813008130081307,0.2111885404568331,131328.12500000015,1470.498792711643,132798.6237927118,4537,2,1399.85,35,5,17,34.51050135501353,0.6357142857142857,43.75000000000001,1025.0000000000011,29.285714285714317,0
4667,4,0,0,40,0.0,0.0,1.0,40,1050,700,350,0.6666666666666666,14,7,7,358.2976050229988,0.35701121794871793,0.16138672536403664,0.21034847467851223,131417.11576485357,1417.2875675154564,132834.40333236902,4538,3,1400.85,35,5,17,34.478708093464284,0.6366071428571427,43.66319444444446,1025.3472222222238,29.295634920634964,0
4668,4,0,0,40,0.0,0.0,1.0,40,1050,600,450,0.5714285714285714,15,6,9,357.74347894766333,0.356517094017094,0.15854401805869123,0.21018615540293764,131446.7860510975,1404.8461076817687,132851.63215877928,4539,4,1401.85,35,5,17,34.46294206170054,0.6369047619047619,43.63425925925927,1025.4629629629637,29.298941798941822,0
4669,4,1,1,40,0.024390243902439025,0.024390243902439025,0.975609756097561,41,1200,900,300,0.75,15,9,6,349.03841190794907,0.36026422764227645,0.14918147685910133,0.2064023104150546,131693.64762475004,993.2283250615683,132686.8759498116,4540,0,1368.6341463414635,37,4,12,34.4370927251362,0.6354166666666665,43.3936403508772,1026.425438596492,27.741228070175463,0
4670,4,1,0,41,0.024390243902439025,0.0,1.0,41,900,400,500,0.4444444444444444,14,4,10,350.8756947079197,0.3626524390243902,0.15672261794694808,0.20810328568332292,131806.21831957914,1049.5196839412174,132855.73800352035,4541,0,1369.6097560975609,37,4,14,34.276450436020646,0.6365427927927928,43.28399122807018,1026.8640350877197,27.75308202939783,0
4671,4,0,0,41,0.0,0.0,1.0,41,800,500,300,0.625,11,5,6,354.4617612804752,0.36270325203252035,0.15099664660182022,0.2106978286596123,131890.67790089254,1150.040397045241,133040.71829793777,4542,1,1370.6097560975609,37,4,15,34.099238542556215,0.6373873873873874,43.20175438596491,1027.19298245614,27.761972498814597,0
4672,4,0,0,41,0.0,0.0,1.0,41,1200,700,500,0.5833333333333334,17,7,10,353.0835942334383,0.3621443089430894,0.14923539760365578,0.21050250923382835,132003.3327562326,1121.6422360726274,133124.97499230521,4543,2,1371.6097560975609,37,4,15,34.0211089770949,0.6385135135135136,43.09210526315789,1027.6315789473676,27.773826458036964,0
4673,4,0,1,40,0.0,0.024390243902439025,0.975609756097561,41,400,200,200,0.5,6,2,4,352.5332764444445,0.3612042682926829,0.15004097560975604,0.21064368812407055,132087.85545792943,1113.0728926208164,133200.92835055024,4544,3,1372.6097560975609,37,4,15,33.95011111111113,0.6393581081081081,43.00986842105264,1027.96052631579,27.782716927453784,0
4674,4,0,0,40,0.0,0.0,1.0,40,850,300,550,0.35294117647058826,14,3,11,358.1049266407605,0.35554220085470084,0.14886612620508322,0.21392550853251724,132079.47812677556,1459.6623650677852,133539.14049184334,4545,4,1407.7,36,4,16,33.81536663745254,0.6412037037037036,43.018018018018026,1027.927927927929,28.553553553553584,0
4675,4,0,0,40,0.0,0.0,1.0,40,700,400,300,0.5714285714285714,10,4,6,359.5302670388011,0.3549813034188034,0.14870784056066544,0.2154350655248253,132195.26113951812,1505.639507751018,133700.90064726913,4546,5,1408.7,36,4,17,33.6620765805227,0.6423611111111109,42.90540540540542,1028.3783783783801,28.566066066066114,0
4676,4,0,0,40,0.0,0.0,1.0,40,550,400,150,0.7272727272727273,7,4,3,358.0541262661097,0.3551949786324786,0.15156557915480584,0.21487952623617929,132253.17166829004,1470.7587655222933,133723.93043381235,4547,6,1409.7,36,4,18,33.641704985037585,0.6429398148148147,42.84909909909911,1028.6036036036048,28.572322322322357,0
4677,4,1,0,41,0.024390243902439025,0.0,1.0,41,900,600,300,0.6666666666666666,12,6,6,352.6146813887124,0.35871443089430893,0.15245036186553484,0.2130836769290815,132513.92598257065,1145.3504179855809,133659.27640055623,4548,0,1376.2926829268292,36,5,19,33.51926792810529,0.6455439814814814,42.595720720720735,1029.617117117119,28.60047547547553,0
4678,4,0,0,41,0.0,0.0,1.0,41,1000,700,300,0.7,13,7,6,351.2038930143203,0.3580538617886179,0.14927991851253353,0.21288681308164292,132629.89921932085,1116.0273871845045,133745.92660650535,4549,1,1377.2926829268292,36,5,14,33.43901461317008,0.6467013888888888,42.48310810810812,1030.067567567569,28.61298798798803,0
4679,4,0,0,41,0.0,0.0,1.0,41,1050,700,350,0.6666666666666666,14,7,7,350.7720000815726,0.3582825203252033,0.15341674020084817,0.2129537510780566,132687.90486009684,1108.6403548819367,133796.54521497877,4550,2,1378.2926829268292,36,5,14,33.39185521186285,0.6472800925925924,42.426801801801815,1030.292792792795,28.619244244244303,0
4680,4,0,1,40,0.0,0.024390243902439025,0.975609756097561,41,700,500,200,0.7142857142857143,9,5,4,350.3041486312028,0.35851117886178857,0.14887350709372016,0.21299888798167066,132745.92318247329,1100.2895209398916,133846.21270341318,4551,3,1379.2926829268292,36,5,14,33.34562707172258,0.6478587962962962,42.37049549549551,1030.5180180180203,28.625500500500564,0
4681,4,0,0,40,0.0,0.0,1.0,40,850,500,350,0.5882352941176471,12,5,7,358.1609002128883,0.353659188034188,0.1505253399258344,0.21696894833182392,132606.53941883147,1498.895506472911,134105.43492530438,4552,11,1414.7,35,5,21,33.283351125594635,0.6485119047619048,42.50578703703704,1029.9768518518522,29.42791005291006,0
4682,4,0,0,40,0.0,0.0,1.0,40,1000,900,100,0.9,11,9,2,356.66357263447907,0.3550614316239316,0.135406424123238,0.21720170860435084,132803.9541864503,1473.2665520250355,134277.22073847536,4553,12,1415.7,36,4,17,33.12347499908955,0.6484374999999998,42.31418918918921,1030.743243243246,28.631756756756836,0
4683,4,0,0,40,0.0,0.0,1.0,40,850,600,250,0.7058823529411765,11,6,5,358.4813040624168,0.35543536324786323,0.13834498198099787,0.2189868780053071,132920.05423920558,1529.8708759435292,134449.92511514912,4554,13,1416.7,36,4,17,32.95998507517019,0.6495949074074073,42.201576576576585,1031.193693693695,28.644269269269305,0
4684,4,0,1,39,0.0,0.025,0.975,40,450,200,250,0.4444444444444444,7,2,5,359.1574113160619,0.3551549145299145,0.13751364926839926,0.21957033196478626,132949.08717839475,1549.929997565146,134499.0171759599,4555,14,1417.7,36,4,17,32.91339084225085,0.6498842592592593,42.17342342342343,1031.3063063063073,28.647397397397427,0
4685,4,0,0,39,0.0,0.0,1.0,39,900,700,200,0.7777777777777778,11,7,4,354.8201962446885,0.34944331983805665,0.10511422419819372,0.21895701208370077,133297.72973987513,1659.345325054795,134957.07506492993,4556,26,1454.6923076923076,36,3,21,32.675390766993814,0.6533564814814814,41.83558558558559,1032.6576576576585,28.684934934934958,6
4686,4,0,0,39,0.0,0.0,1.0,39,1300,1000,300,0.7692307692307693,16,10,6,357.97011953431513,0.34919028340080976,0.10444791020330624,0.22159364889391386,133414.04537983923,1751.6483544355074,135165.69373427474,4557,27,1455.6923076923076,36,3,21,32.477427149189744,0.654513888888889,41.72297297297297,1033.1081081081074,28.69744744744743,0
4687,4,0,0,39,0.0,0.0,1.0,39,900,500,400,0.5555555555555556,13,5,8,358.0254942767947,0.3487966711650922,0.10504549214226655,0.22197580645161297,133472.2222222223,1757.2916666666765,135229.513888889,4558,28,1456.6923076923076,36,3,21,32.41767473118279,0.6550925925925926,41.66666666666667,1033.3333333333342,28.703703703703727,0
4688,4,1,1,39,0.025,0.025,0.975,40,800,500,300,0.625,11,5,6,346.72860740145995,0.352991452991453,0.10063139560200351,0.21666999915576945,133763.29665814462,1275.9123143413724,135039.208972486,4559,0,1421.25,36,4,16,32.418217940344014,0.6579861111111112,41.38513513513514,1034.4594594594596,28.73498498498499,0
4689,4,0,0,39,0.0,0.0,1.0,39,1100,800,300,0.7272727272727273,14,8,6,354.639592489286,0.3471941070625281,0.11425109443402137,0.22126426748788072,133705.05640775923,1683.421343640951,135388.47775140018,4560,30,1458.6923076923076,36,3,17,32.271931257259006,0.6574074074074073,41.44144144144145,1034.2342342342351,28.728728728728754,0
4690,4,0,0,39,0.0,0.0,1.0,39,1000,600,400,0.6,14,6,8,352.656496159422,0.3475033738191633,0.1113222976725754,0.22054834787042943,133792.4215389376,1636.5533185212232,135428.97485745882,4561,31,1459.6923076923076,36,3,17,32.23576793294873,0.658275462962963,41.35698198198198,1034.5720720720722,28.738113113113116,0
4691,4,0,0,39,0.0,0.0,1.0,39,1050,800,250,0.7619047619047619,13,8,5,353.88782086746403,0.3482624831309042,0.12056387380073597,0.2220193147844958,133908.95276611077,1677.7494978086277,135586.7022639194,4562,32,1460.6923076923076,36,3,17,32.087322743263336,0.6594328703703705,41.24436936936937,1035.022522522523,28.75062562562564,0
4692,4,1,0,40,0.025,0.0,1.0,40,1250,1100,150,0.88,14,11,3,345.1335251671656,0.3523504273504274,0.12145540154480994,0.2184766876326111,134238.12044330942,1266.015144082787,135504.1355873922,4563,0,1425.15,37,3,18,31.98504126547456,0.6607545045045045,40.926535087719294,1036.2938596491224,28.007942152678982,0
4693,4,0,0,40,0.0,0.0,1.0,40,700,500,200,0.7142857142857143,9,5,4,345.12805501669123,0.35224358974358977,0.11981646038294724,0.21881257572587393,134294.94081111494,1269.790344144349,135564.7311552593,4564,1,1426.15,37,3,18,31.928466271730315,0.6613175675675675,40.87171052631579,1036.5131578947367,28.01386913229018,0
4694,4,0,0,40,0.0,0.0,1.0,40,600,500,100,0.8333333333333334,7,5,2,341.82452667050313,0.351963141025641,0.11424492385786822,0.21722397340028743,134380.1939058172,1186.8892351492802,135567.08314096648,4565,2,1427.15,37,3,18,31.929022137619846,0.6621621621621622,40.78947368421053,1036.8421052631581,28.022759601706976,0
4695,4,0,0,40,0.0,0.0,1.0,40,800,500,300,0.625,11,5,6,339.0253386910056,0.351161858974359,0.10956659619450315,0.21611723072890257,134493.906779009,1119.3684595260193,135613.27523853502,4566,3,1428.15,37,3,18,31.888213530655392,0.6632882882882882,40.679824561403514,1037.2807017543867,28.03461356092937,0
4696,4,0,0,40,0.0,0.0,1.0,40,1450,1100,350,0.7586206896551724,18,11,7,343.540332935475,0.3507745726495726,0.10994466145833393,0.21986581307870365,134638.4222059896,1250.7577010406603,135889.17990703025,4567,4,1429.15,36,4,18,31.627061631944457,0.6666666666666667,40.54054054054053,1037.8378378378363,28.828828828828787,0
4697,4,0,0,40,0.0,0.0,1.0,40,900,700,200,0.7777777777777778,11,7,4,343.49389802635534,0.35112179487179485,0.11175417661097864,0.22018962114095567,134696.8653619835,1253.510267023771,135950.3756290073,4568,5,1430.15,36,4,18,31.57002603601649,0.6672453703703705,40.48423423423423,1038.0630630630624,28.835085085085066,0
4698,4,0,0,40,0.0,0.0,1.0,40,1650,1400,250,0.8484848484848485,19,14,5,335.54076872943307,0.35112179487179485,0.12898851308232318,0.2045884764976736,132849.7770948753,915.3032663896532,133765.08036126493,4569,6,1431.15,37,3,17,33.62183577962137,0.6469594594594594,42.26973684210526,1030.9210526315785,27.862731152204823,3
4699,4,0,0,40,0.0,0.0,1.0,40,1050,900,150,0.8571428571428571,12,9,3,339.1082542597695,0.35140224358974353,0.12661616161616163,0.2072328220476368,132934.57031249988,1015.8420138888755,133950.41232638876,4570,7,1432.15,37,3,17,33.444865319865315,0.6478040540540542,42.18749999999999,1031.249999999999,27.871621621621596,0
4700,4,0,0,40,0.0,0.0,1.0,40,800,600,200,0.75,10,6,4,339.91693385666304,0.3514823717948718,0.12456415435314194,0.2080415482621746,132991.11415291217,1041.1863506078557,134032.30050352003,4571,8,1433.15,37,3,18,33.36732840792318,0.6483671171171173,42.13267543859648,1031.469298245612,27.877548601232757,0
4701,4,0,0,40,0.0,0.0,1.0,40,1100,900,200,0.8181818181818182,13,9,4,341.0625411499515,0.3517361111111111,0.1234059511158343,0.20921763443422672,133075.9524565248,1077.444502154477,134153.39695867928,4572,9,1434.15,37,3,18,33.252745306411605,0.6492117117117119,42.05043859649121,1031.7982456140328,27.886439070649534,0
4702,4,0,0,40,0.0,0.0,1.0,40,900,500,400,0.5555555555555556,13,5,8,340.4773571693436,0.35144230769230766,0.12842116447088858,0.20917577582753616,133132.52635426258,1065.722145275441,134198.24849953802,4573,10,1435.15,37,3,18,33.21114888794447,0.6497747747747749,41.995614035087705,1032.017543859647,27.89236605026073,0
4703,4,0,1,39,0.0,0.025,0.975,40,1200,1000,200,0.8333333333333334,14,10,4,340.81650688579487,0.3517494658119658,0.1294494000212385,0.21018133892230034,133274.0136989264,1084.396761503521,134358.4104604299,4574,11,1436.15,37,3,19,33.060665994124086,0.6511824324324325,41.85855263157894,1032.5657894736828,27.907183499288724,0
4704,4,0,0,39,0.0,0.0,1.0,39,800,600,200,0.75,10,6,4,350.48562372259113,0.3467723796671165,0.13661041696385867,0.21577580340261862,133210.52629910305,1537.674879271145,134748.2011783742,4575,45,1473.6923076923076,36,3,19,32.87471364677647,0.652488425925926,41.920045045045036,1032.3198198198188,28.675550550550522,0
4705,4,1,1,39,0.025,0.025,0.975,40,1000,800,200,0.8,12,8,4,342.5340970574841,0.3507745726495726,0.13384197558517208,0.2125425262422706,133502.12358807,1146.3194765202677,134648.44306459028,4576,0,1437.825,35,5,20,32.787942845410086,0.6574404761904762,41.637731481481474,1033.449074074073,29.52711640211637,0
4706,4,0,0,39,0.0,0.0,1.0,39,900,700,200,0.7777777777777778,11,7,4,352.5598382742501,0.34696918578497526,0.14644986540767646,0.21807359382937966,133384.96171424814,1605.2361060384815,134990.19782028662,4577,47,1475.6923076923076,36,3,20,32.64630800537811,0.654224537037037,41.75112612612613,1032.9954954954962,28.69431931931934,0
4707,4,0,0,39,0.0,0.0,1.0,39,950,600,350,0.631578947368421,13,6,7,354.39155661617326,0.34668803418803423,0.14539976410479993,0.21937841703082148,133414.04537983937,1656.162243324411,135070.2076231638,4578,48,1476.6923076923076,36,3,20,32.56985320834242,0.6545138888888888,41.722972972972975,1033.1081081081086,28.69744744744746,0
4708,4,0,0,39,0.0,0.0,1.0,39,1250,800,450,0.64,17,8,9,353.84653090924735,0.34623819163292846,0.14110391394114452,0.219566957456982,133502.97796201822,1647.9384867838141,135150.91644880205,4579,49,1477.6923076923076,34,5,20,32.4948162654072,0.6596200980392157,41.636904761904766,1033.4523809523816,30.395658263305343,0
4709,4,0,0,39,0.0,0.0,1.0,39,700,400,300,0.5714285714285714,10,4,6,354.21038351105034,0.34606950067476383,0.14366298678669076,0.21997528967403002,133533.73724489793,1659.8072562358218,135193.54450113376,4580,50,1478.6923076923076,34,5,20,32.454599554634115,0.6599264705882353,41.607142857142854,1033.5714285714282,30.399159663865536,0
4710,4,0,0,39,0.0,0.0,1.0,39,600,300,300,0.5,9,3,6,353.2947607508895,0.345338506522717,0.14555009373662253,0.2199544800803924,133626.03635204077,1641.875708616773,135267.91206065755,4581,51,1479.6923076923076,34,5,20,32.385818460947995,0.6608455882352942,41.51785714285714,1033.9285714285709,30.409663865546204,0
4711,4,0,0,39,0.0,0.0,1.0,39,1150,800,350,0.6956521739130435,15,8,7,365.75585039927864,0.345338506522717,0.19215143533193424,0.2150844130504971,131480.6990504534,1817.9669784580328,133298.66602891142,4582,52,1480.6923076923076,34,5,19,34.22325401431611,0.6393995098039216,43.60119047619047,1025.5952380952372,30.164565826330506,3
4712,4,0,0,39,0.0,0.0,1.0,39,900,600,300,0.6666666666666666,12,6,6,367.7605534258836,0.34525416104363477,0.19333874898456593,0.21660920634797243,131541.75347222213,1875.1736111111065,133416.92708333323,4583,53,1481.6923076923076,34,5,19,34.11014080693204,0.6400122549019608,43.541666666666664,1025.8333333333328,30.171568627450966,0
4713,4,0,0,39,0.0,0.0,1.0,39,750,600,150,0.8,9,6,3,366.4265753809059,0.3452260458839406,0.19119357650509716,0.21616910699575814,131602.82206632654,1844.5542800453454,133447.3763463719,4584,54,1482.6923076923076,34,5,17,34.08264686545228,0.640625,43.482142857142854,1026.0714285714284,30.178571428571423,0
4714,4,1,0,40,0.025,0.0,1.0,40,850,700,150,0.8235294117647058,10,7,3,356.1868178890936,0.3508680555555555,0.19298107255520502,0.21189773428844458,131921.96609224958,1397.7730624142541,133319.73915466384,4585,0,1446.6,35,5,18,34.023396424815964,0.6416666666666667,43.17129629629629,1027.3148148148143,29.351851851851837,0
4715,4,0,1,39,0.0,0.025,0.975,40,450,200,250,0.4444444444444444,7,2,5,360.49045808539415,0.3508680555555555,0.15850005103603104,0.20497533475697116,130182.84640842037,1385.9347873264135,131568.7811957468,4586,1,1447.6,39,1,18,35.67259109931613,0.6167200854700854,44.86979166666668,1020.5208333333353,26.167200854700905,7
4716,4,1,0,40,0.025,0.0,1.0,40,750,600,150,0.8,9,6,3,357.4659996477195,0.3511084401709402,0.16870772039085202,0.20411286662901346,130346.55044100095,1318.9408189298501,131665.4912599308,4587,0,1448.55,37,3,19,35.58365993772146,0.6219031531531531,44.7094298245614,1021.1622807017533,27.598980559506845,0
4717,4,1,1,40,0.024390243902439025,0.024390243902439025,0.975609756097561,41,1500,1100,400,0.7333333333333333,19,11,8,354.73746898860736,0.3586890243902439,0.17062980531622696,0.20484056261139497,130781.15297866904,1078.5950398129892,131859.74801848203,4588,0,1414.1951219512196,38,3,19,35.212990042476136,0.6244517543859649,44.284188034188034,1022.8632478632481,26.91745389113811,0
4718,4,0,0,40,0.0,0.0,1.0,40,1400,1000,400,0.7142857142857143,18,10,8,361.8987296887649,0.3506944444444444,0.17068947029809212,0.20859502800231255,130710.70545744828,1460.8076523545544,132171.51310980282,4589,2,1450.55,37,3,19,35.101240260204456,0.6255630630630631,44.35307017543859,1022.5877192982442,27.637505926979575,0
4719,4,1,0,41,0.024390243902439025,0.0,1.0,41,850,500,350,0.5882352941176471,12,5,7,356.1912748789286,0.3571138211382114,0.1719661086833142,0.206997027723758,131027.1491366242,1134.1454589451282,132161.2945955693,4590,0,1416.1463414634147,38,3,20,34.926867021461625,0.6269188596491229,44.043803418803414,1023.8247863247855,26.942757534862775,0
4720,4,0,0,41,0.0,0.0,1.0,41,800,500,300,0.625,11,5,6,354.28500059921856,0.35746951219512196,0.1679017875320663,0.20603564597954516,131054.49631090638,1086.128460807933,132140.62477171433,4591,1,1417.1463414634147,38,3,20,34.94800361713969,0.6271929824561404,44.01709401709401,1023.9316239316224,26.94556905083217,0
4721,4,0,0,41,0.0,0.0,1.0,41,1250,900,350,0.72,16,9,7,367.11899794346056,0.35772357723577236,0.23381098522432708,0.2031648067153077,129119.93805473376,1287.3278727445427,130407.26592747831,4592,2,1418.1463414634147,38,3,20,36.58546199936928,0.6077302631578947,45.91346153846154,1016.3461538461542,26.745951417004058,6
4722,4,0,0,41,0.0,0.0,1.0,41,650,300,350,0.46153846153846156,10,3,7,362.25542678530223,0.35795223577235774,0.1762125194348334,0.19045465919907345,127065.75656467023,1006.0776569434222,128071.83422161365,4593,3,1419.1463414634147,39,2,18,38.81179615662774,0.5852029914529915,47.942708333333336,1008.2291666666674,25.852029914529933,7
4723,4,4,1,44,0.08888888888888889,0.022222222222222223,0.9777777777777777,45,1000,800,200,0.8,12,8,4,343.4555209209462,0.3824705387205387,0.2157843455667423,0.18585229330678243,128227.80957842778,-178.20202189618385,128049.6075565316,4594,0,1293.911111111111,37,8,18,38.096220814838865,0.6005067567567568,46.792763157894726,1012.8289473684196,27.37375533428161,0
4724,4,1,0,45,0.022222222222222223,0.0,1.0,45,550,300,250,0.5454545454545454,8,3,5,356.04359058821734,0.38358585858585864,0.30638401075944466,0.17791588247588716,124975.19964293593,-84.65868826113427,124890.5409546748,4595,0,1294.7333333333333,41,4,17,41.12459486721565,0.5607215447154472,50.02480158730159,999.9007936507941,24.38782423538522,8
4725,4,4,2,47,0.08163265306122448,0.04081632653061224,0.9591836734693877,49,1000,600,400,0.6,14,6,8,332.00256599215686,0.3996421485260771,0.3057637194340752,0.16933766346220633,125825.00018778906,-1445.1480329132987,124379.85215487576,4596,0,1189.9591836734694,42,7,17,40.848947266756824,0.5679563492063493,49.17635658914728,1003.2945736434098,23.887966039128806,0
4726,4,4,0,51,0.0784313725490196,0.0,1.0,51,1150,800,350,0.6956521739130435,15,8,7,330.90518648110873,0.4044771241830065,0.3476085237368791,0.17164754455779616,126517.47453900508,-1826.3718892294335,124691.10264977565,4597,0,1144.2156862745098,41,10,18,40.16441097196198,0.5764735772357725,48.487103174603156,1006.0515873015846,24.537843592721575,0
4727,4,4,3,52,0.07272727272727272,0.05454545454545454,0.9454545454545454,55,1000,600,400,0.6,14,6,8,312.8936794441129,0.4148989898989899,0.3563650326825909,0.1657048021743423,127360.84937991969,-3026.014270362881,124334.8351095568,4598,0,1061.9272727272728,42,13,18,39.7543278615084,0.5835813492063494,47.65019379844959,1009.3992248061984,24.033314876338057,0
4728,4,5,3,54,0.08771929824561403,0.05263157894736842,0.9473684210526316,57,1100,600,500,0.5454545454545454,16,6,10,305.111539519381,0.41942094820384296,0.36882320414216196,0.16382142660348228,127915.35391724361,-3594.309887628705,124321.0440296149,4599,0,1025.5438596491229,45,12,21,39.385222659980904,0.5851851851851855,47.10144927536229,1011.5942028985454,22.479871175523233,0
4729,4,0,0,54,0.0,0.0,1.0,54,1700,1100,600,0.6470588235294118,23,11,12,324.66583137917144,0.41181865828092246,0.3781222257732326,0.17329911060822684,127678.93024006947,-2509.4027928009396,125169.52744726853,4600,1,1083.4259259259259,42,12,22,39.13211089805048,0.5868055555555556,47.335271317829445,1010.6589147286802,24.063307493540005,0
4730,4,0,0,54,0.0,0.0,1.0,54,1550,1100,450,0.7096774193548387,20,11,9,325.94502672341764,0.4120879920801304,0.38230626011049074,0.17457801063494074,127816.61629801085,-2467.7619170096145,125348.85438100123,4601,2,1084.4259259259259,44,10,22,38.95915361841102,0.5854640151515154,47.19907407407407,1011.2037037037027,22.981902356902335,0
4731,4,1,0,55,0.01818181818181818,0.0,1.0,55,1300,700,600,0.5384615384615384,19,7,12,321.5500645877329,0.41471661054994385,0.3873299928418046,0.17343839391083482,128098.67937408084,-2761.9722747322207,125336.70709934861,4602,0,1065.6909090909091,45,10,23,38.78251014077784,0.5870370370370372,46.920289855072454,1012.3188405797082,22.495974235104626,0
4732,4,4,5,54,0.06779661016949153,0.0847457627118644,0.9152542372881356,59,800,300,500,0.375,13,3,10,299.70295797056696,0.4235705240600039,0.36336088878307193,0.1645289698663657,128801.62144204378,-4079.5135890634156,124722.10785298036,4603,0,994.3728813559322,44,15,16,38.62119553650155,0.595407196969697,46.22685185185185,1015.0925925925916,23.070286195286172,0
4733,4,2,2,54,0.03571428571428571,0.03571428571428571,0.9642857142857143,56,1150,900,250,0.782608695652174,14,9,5,314.29446492030877,0.4158887987012987,0.3684388717661342,0.17125449546573773,128504.33601820772,-3122.359694243565,125381.97632396415,4604,0,1048.375,43,13,16,38.55314669530837,0.59375,46.51988636363637,1013.9204545454552,23.57954545454547,0
4734,4,2,2,54,0.03571428571428571,0.03571428571428571,0.9642857142857143,56,1000,600,400,0.6,14,6,8,317.7728351267241,0.4174715909090909,0.3834510141216949,0.17377745700421623,128648.39916386883,-3023.8066926365836,125624.59247123224,4605,0,1049.3392857142858,43,13,18,38.318417654563014,0.5952034883720929,46.377840909090914,1014.4886363636366,23.592758985200852,0
4735,4,1,1,54,0.01818181818181818,0.01818181818181818,0.9818181818181818,55,1400,900,500,0.6428571428571429,19,9,10,317.3801013537473,0.41755050505050506,0.38110556856357514,0.17387756472938434,128720.4610020662,-2829.3374081726274,125891.12359389357,4606,0,1056.9818181818182,43,12,18,38.255101405997294,0.5959302325581395,46.30681818181819,1014.7727272727279,23.599365750528555,0
4736,4,2,1,55,0.03571428571428571,0.017857142857142856,0.9821428571428571,56,1250,900,350,0.72,16,9,7,309.26289331903337,0.4218479437229437,0.3785880338095664,0.17038195262764863,128942.64510459565,-3224.5649005486707,125718.08020404697,4607,0,1039.0714285714287,44,12,19,38.23540584070259,0.5968276515151514,46.087962962962976,1015.6481481481508,23.082912457912517,0
4737,4,1,2,54,0.017857142857142856,0.03571428571428571,0.9642857142857143,56,1350,700,650,0.5185185185185185,20,7,13,308.9542801401871,0.4208400974025974,0.3600967659791181,0.17093032658643537,129109.31592627642,-3221.706157734748,125887.60976854168,4608,0,1040.0535714285713,45,11,24,38.07412358882949,0.5972222222222221,45.92391304347828,1016.3043478260904,22.58454106280201,1
4738,4,1,2,53,0.01818181818181818,0.03636363636363636,0.9636363636363636,55,1100,800,300,0.7272727272727273,14,8,6,285.0705188760023,0.4184624017957352,0.27525128067267035,0.1559051436117004,128651.28125,-3665.062499999999,124986.21875,4609,0,1059.6181818181817,49,6,14,39.144898965007386,0.5880102040816326,46.375,1014.5,20.70408163265306,4
4739,4,1,3,51,0.018518518518518517,0.05555555555555555,0.9444444444444444,54,1500,1100,400,0.7333333333333333,19,11,8,293.78832311383655,0.4161498369438621,0.27979797979798016,0.16106401636948267,128747.91843820858,-3235.072987528343,125512.84545068024,4610,0,1079.9814814814815,48,6,15,38.82575757575758,0.5900607638888888,46.279761904761905,1014.8809523809521,21.143353174603167,0
4740,4,0,0,51,0.0,0.0,1.0,51,1600,1100,500,0.6875,21,11,10,309.5640277264522,0.4080882352941177,0.30355059090839,0.16924706972163367,128638.69024602642,-2235.617785196917,126403.07246082951,4611,1,1144.0980392156862,46,5,15,38.53647790497829,0.5912590579710144,46.387411347517734,1014.4503546099296,22.05326857847673,0
4741,4,3,2,52,0.05555555555555555,0.037037037037037035,0.962962962962963,54,750,500,250,0.6666666666666666,10,5,5,306.5108813422571,0.41326723736314935,0.3252754106519049,0.16929740776210148,129043.70948550105,-2885.655745435362,126158.05374006569,4612,0,1081.4814814814815,46,8,16,38.20274554285547,0.5953351449275364,45.988475177304956,1016.0460992907787,22.08795868023432,1
4742,4,0,1,51,0.0,0.019230769230769232,0.9807692307692307,52,1550,1200,350,0.7741935483870968,19,12,7,312.92636786331747,0.40815108094519864,0.25206340273869765,0.16599109125167627,127426.43498192156,-2419.1560278556685,125007.27895406589,4613,1,1123.8846153846155,43,9,15,39.68650347026823,0.5828488372093023,47.58522727272727,1009.6590909090914,23.480443974630035,6
4743,4,2,2,51,0.03773584905660377,0.03773584905660377,0.9622641509433962,53,1050,800,250,0.7619047619047619,13,8,5,308.6269210593959,0.41334059022738273,0.2754913935934402,0.165302334717492,127816.61629801101,-2710.4702503429326,125106.14604766808,4614,0,1103.622641509434,44,9,18,39.39695693312577,0.5854640151515151,47.199074074074076,1011.203703703704,22.981902356902363,0
4744,4,1,0,52,0.019230769230769232,0.0,1.0,52,1350,1000,350,0.7407407407407407,17,10,7,315.08128742930825,0.4111990950226245,0.2857908982277315,0.16953467459564886,128000.75058109501,-2333.8717429981657,125666.87883809685,4615,0,1125.6346153846155,43,9,19,39.04602595296027,0.5886627906976745,47.01704545454545,1011.9318181818179,23.533298097251578,0
4745,4,1,1,52,0.018867924528301886,0.018867924528301886,0.9811320754716981,53,1700,1300,400,0.7647058823529411,21,13,8,303.5225778032105,0.41343130140299955,0.2816527255172656,0.16450640492133578,128291.73920024339,-2811.9507061277295,125479.78849411567,4616,0,1105.377358490566,42,11,19,39.04232424677186,0.5930059523809523,46.729651162790695,1013.0813953488373,24.120985603543744,0
4746,4,3,1,54,0.05454545454545454,0.01818181818181818,0.9818181818181818,55,1450,1200,250,0.8275862068965517,17,12,5,293.97440258468436,0.4188271604938272,0.299128473460317,0.16138414499428605,128801.6214420438,-3427.1240569273086,125374.4973851165,4617,0,1066.1272727272728,44,11,17,38.7665708899632,0.595407196969697,46.22685185185185,1015.0925925925918,23.070286195286176,0
4747,4,3,4,53,0.05263157894736842,0.07017543859649122,0.9298245614035088,57,1400,1100,300,0.7857142857142857,17,11,6,286.3416184970614,0.4244073725981621,0.30183819762115593,0.1590617290934525,129268.99524828994,-3996.9813358231363,125272.0139124668,4618,0,1029.6666666666667,46,11,18,38.487090634353294,0.5975996376811594,45.76684397163121,1016.9326241134761,22.107230958988612,0
4748,4,4,1,56,0.07017543859649122,0.017543859649122806,0.9824561403508771,57,1250,600,650,0.48,19,6,13,289.9346045202524,0.42209690893901425,0.320249129832503,0.1625416692105485,129629.86115040736,-3883.163494668285,125746.69765573907,4619,0,1030.122807017544,46,11,16,38.03085371869649,0.6012228260869565,45.41223404255319,1018.3510638297868,22.138066604995366,0
4749,4,0,0,56,0.0,0.0,1.0,56,1900,1400,500,0.7368421052631579,24,14,10,293.3084978399391,0.421387987012987,0.31585317813302094,0.1643755798961416,129616.12335249972,-3596.497912728397,126019.62543977132,4620,1,1049.517857142857,45,11,16,37.95884480815988,0.6023148148148147,45.42572463768117,1018.2971014492774,22.62882447665061,0
4750,4,0,0,56,0.0,0.0,1.0,56,1600,1300,300,0.8125,19,13,6,294.44835555555557,0.4218344155844156,0.30899999999999994,0.165792992992993,129800.66310255199,-3556.0816398865777,126244.58146266542,4621,2,1050.517857142857,45,11,17,37.74333333333334,0.6041666666666666,45.244565217391305,1019.0217391304349,22.644927536231886,0
4751,4,2,3,55,0.034482758620689655,0.05172413793103448,0.9482758620689655,58,1600,1200,400,0.75,20,12,8,285.8756900644647,0.4259805404315386,0.31396324381407803,0.16241994860839956,130151.84284728269,-4158.550422574247,125993.29242470844,4622,0,1015.2586206896551,47,11,17,37.60748972068625,0.6052748226950353,44.90017361111112,1020.399305555557,21.71062352245866,0
4752,4,1,3,53,0.017857142857142856,0.05357142857142857,0.9464285714285714,56,1300,800,500,0.6153846153846154,18,8,10,294.3437150975218,0.42144886363636364,0.3097612279343649,0.1664202511729181,129962.2430703238,-3549.2861104547537,126412.95695986906,4623,0,1052.4107142857142,45,11,17,37.58281883864853,0.6057870370370371,45.08605072463767,1019.6557971014479,22.659017713365508,0
4753,4,3,1,55,0.05357142857142857,0.017857142857142856,0.9821428571428571,56,1350,1000,350,0.7407407407407407,17,10,7,314.2281940845708,0.421090367965368,0.3490895089690167,0.18046049980777773,130569.96313443055,-2993.9006086214395,127576.06252580912,4624,0,1052.375,44,12,13,36.46191942984842,0.6131628787878789,44.49074074074073,1022.0370370370356,23.228114478114446,0
4754,4,0,0,55,0.0,0.0,1.0,55,1550,1300,250,0.8387096774193549,18,13,5,323.8128784411045,0.41983726150392814,0.3523148460138825,0.18588237149661688,130552.75769054177,-2545.0671487603327,128007.69054178143,4625,1,1072.509090909091,43,12,14,36.23440202619226,0.6143410852713178,44.50757575757576,1021.9696969696968,23.76673713883016,0
4755,4,1,0,56,0.017857142857142856,0.0,1.0,56,1000,700,300,0.7,13,7,6,320.1977056490747,0.4218073593073593,0.3579091332350437,0.1847912150783529,130759.297839506,-2826.2345679012433,127933.06327160477,4626,0,1054.3392857142858,44,12,15,36.118278109722986,0.6150568181818181,44.30555555555555,1022.7777777777765,23.244949494949466,0
4756,4,0,1,55,0.0,0.017857142857142856,0.9821428571428571,56,1750,1000,750,0.5714285714285714,25,10,15,323.8639043808357,0.4217735389610389,0.3527548805540124,0.18817462904565926,131019.8570387515,-2713.4795096022144,128306.3775291493,4627,1,1055.3392857142858,44,12,18,35.761659280696996,0.617660984848485,44.05092592592592,1023.7962962962947,23.268097643097608,0
4757,4,1,1,55,0.017857142857142856,0.017857142857142856,0.9821428571428571,56,2100,1600,500,0.7619047619047619,26,16,10,323.3695140715508,0.42151650432900434,0.35395684846606823,0.18870043795820865,131185.8024691357,-2715.7021604938345,128470.10030864186,4628,0,1056.1785714285713,44,12,19,35.6070363340564,0.6193181818181819,43.888888888888886,1024.4444444444437,23.282828282828266,0
4758,4,0,1,54,0.0,0.01818181818181818,0.9818181818181818,55,1500,900,600,0.6,21,9,12,334.3673996185683,0.41930415263748594,0.35969453335685664,0.19547215728106568,131255.33679300098,-2222.498870092976,129032.837922908,4629,1,1076.2,43,12,19,35.25523288051012,0.6213662790697675,43.82102272727273,1024.7159090909088,23.83060253699788,0
4759,4,0,0,54,0.0,0.0,1.0,54,950,400,550,0.42105263157894735,15,4,11,339.9005286457116,0.41669578383414857,0.3600060245605923,0.19856951325413005,131228.82207349318,-1879.050800733135,129349.77127276004,4630,2,1096.9444444444443,42,12,19,35.14024178803354,0.6225198412698413,43.8468992248062,1024.612403100775,24.39553340716131,0
4760,4,2,1,55,0.03571428571428571,0.017857142857142856,0.9821428571428571,56,1850,1100,750,0.5945945945945946,26,11,15,324.9801503992839,0.4187702922077922,0.35310762379107685,0.1925374202529528,131765.27795712816,-2635.7424725787378,129129.53548454941,4631,0,1058.732142857143,43,13,15,34.982398696427474,0.6264534883720929,43.32386363636364,1026.704545454546,23.876849894291766,0
4761,4,0,0,55,0.0,0.0,1.0,55,850,600,250,0.7058823529411765,11,6,5,329.42461673821197,0.417003367003367,0.35722914307285736,0.19522277622808148,131775.4529475394,-2317.9843834504995,129457.4685640889,4632,1,1078.9818181818182,42,13,15,34.85808323895807,0.6279761904761905,43.3139534883721,1026.744186046513,24.446290143964596,0
4762,4,1,0,56,0.017857142857142856,0.0,1.0,56,1250,700,550,0.56,18,7,11,323.66146425469907,0.41895292207792206,0.35316601071461484,0.19311148276834814,132032.78456618756,-2653.2151235364868,129379.56944265107,4633,0,1060.6964285714287,43,13,16,34.747400872262666,0.6291182170542635,43.063446969696976,1027.7462121212131,23.90107470049333,0
4763,4,0,1,55,0.0,0.017857142857142856,0.9821428571428571,56,1350,1000,350,0.7407407407407407,17,10,7,325.32442113611376,0.41841856060606064,0.3563219714417314,0.19435314207113488,132081.4512758985,-2606.1356641700804,129475.31561172841,4634,1,1061.6964285714287,43,13,17,34.65578458467681,0.6296027131782944,43.0160984848485,1027.9356060606085,23.905479210711825,0
4764,4,0,1,54,0.0,0.01818181818181818,0.9818181818181818,55,1150,1000,150,0.8695652173913043,13,10,3,330.5731664295947,0.4163299663299664,0.35587673053019553,0.19706174423754116,131999.40212614945,-2272.907934469067,129726.49419168038,4635,2,1081.8909090909092,42,13,18,34.603371051390845,0.6302083333333333,43.095930232558146,1027.6162790697688,24.467054263565924,0
4765,4,0,0,54,0.0,0.0,1.0,54,2000,1500,500,0.75,25,15,10,334.8435811198142,0.4139296529233636,0.3556703242483723,0.1996916900875161,132015.40577168364,-1959.0977536848175,130056.30801799882,4636,3,1102.7592592592594,41,13,19,34.47756781542617,0.631859756097561,43.08035714285714,1027.678571428571,25.065331010452955,0
4766,4,0,0,54,0.0,0.0,1.0,54,1600,1300,300,0.8125,19,13,6,337.6496919907219,0.41362392266480313,0.351279581824145,0.20247535767172445,132223.54144131966,-1870.9523916831943,130352.58904963646,4637,4,1103.7592592592594,42,12,19,34.19618742541297,0.6324404761904763,42.877906976744185,1028.4883720930234,24.487818383167223,0
4767,4,0,0,54,0.0,0.0,1.0,54,1550,1200,350,0.7741935483870968,19,12,7,333.69632679696866,0.41364576054041463,0.3492850666108671,0.20089880899001156,132373.0732828555,-1965.5183357370395,130407.55494711846,4638,5,1104.7592592592594,42,12,20,34.14763810420591,0.6339285714285714,42.73255813953488,1029.0697674418598,24.501661129568088,0
4768,4,0,0,54,0.0,0.0,1.0,54,1500,1000,500,0.6666666666666666,20,10,10,334.4456907195597,0.413711274167249,0.34856860809476786,0.20190314940340534,132476.45767235116,-1938.7592272081151,130537.69844514305,4639,6,1105.7592592592594,40,14,20,34.02455577492596,0.6380208333333334,42.63211382113821,1029.4715447154474,25.736788617886184,0
4769,4,0,0,54,0.0,0.0,1.0,54,950,500,450,0.5263157894736842,14,5,9,335.22670319756764,0.41354385045422787,0.3503746521087565,0.20277699179433273,132551.19756235817,-1913.059807256247,130638.13775510192,4640,7,1106.7592592592594,41,13,20,33.929431599229275,0.6371951219512195,42.5595238095238,1029.761904761904,25.11614401858302,0
4770,4,0,0,54,0.0,0.0,1.0,54,1400,900,500,0.6428571428571429,19,9,10,335.78853349257423,0.41293966922897746,0.3530075871884599,0.20353136854952675,132627.82782383764,-1893.0192389455988,130734.80858489205,4641,8,1107.7592592592594,41,13,15,33.83806462486758,0.6379573170731708,42.48511904761904,1030.059523809522,25.12340301974444,0
4771,4,0,0,54,0.0,0.0,1.0,54,950,400,550,0.42105263157894735,15,4,11,337.91322207170634,0.41266305613789894,0.35923358367032554,0.20523782014249942,132704.4802295917,-1831.4803004535297,130872.99992913815,4642,9,1108.7592592592594,41,13,16,33.706431735027905,0.6387195121951219,42.41071428571428,1030.3571428571418,25.130662020905895,0
4772,4,0,0,54,0.0,0.0,1.0,54,1450,1000,450,0.6896551724137931,19,10,9,337.320081436088,0.4122626950850221,0.358336204826196,0.20593361942406266,132897.10020619255,-1834.227867165438,131062.87233902712,4643,10,1109.7592592592594,42,12,16,33.528529586818266,0.6391369047619048,42.223837209302324,1031.1046511627908,24.55011074197121,0
4773,4,0,0,54,0.0,0.0,1.0,54,1500,1100,400,0.7333333333333333,19,11,8,335.73812706543475,0.41225541579315167,0.3546631177913462,0.20551652458950853,132997.03222650386,-1869.565099002464,131127.46712750138,4644,11,1110.7592592592594,42,12,16,33.469156098324724,0.6401289682539684,42.126937984496124,1031.4922480620157,24.559339239571802,0
4774,4,0,0,54,0.0,0.0,1.0,54,1350,1100,250,0.8148148148148148,16,11,5,338.2353589455359,0.4119278476589798,0.3599826117197016,0.20773971007900535,133122.00006760392,-1794.6865047172817,131327.31356288664,4645,12,1111.7592592592594,42,12,16,33.27953834115807,0.6413690476190477,42.005813953488364,1031.976744186045,24.5708748615725,0
4775,4,0,1,53,0.0,0.018518518518518517,0.9814814814814815,54,1200,900,300,0.75,15,9,6,342.2403460219395,0.41137462147682274,0.3639356458016123,0.21076466164842408,133222.016593053,-1681.210188690616,131540.8064043624,4646,13,1112.7592592592594,42,12,17,33.07599649583879,0.6423611111111112,41.908914728682156,1032.364341085269,24.58010335917307,0
4776,4,0,0,53,0.0,0.0,1.0,53,1500,1100,400,0.7333333333333333,19,11,8,353.51435453482543,0.41002963231736816,0.36936028889243433,0.21797259490512214,133267.2745023935,-1177.6210947342,132089.6534076593,4647,14,1134.4716981132076,41,12,17,32.739639379964125,0.6443089430894309,41.86507936507936,1032.539682539682,25.183894696089805,0
4777,4,0,0,53,0.0,0.0,1.0,53,1200,800,400,0.6666666666666666,16,8,8,351.42103354934596,0.41001451378809867,0.3634712733194103,0.21729398014130058,133372.11180217512,-1226.0469247641552,132146.06487741097,4648,15,1135.4716981132076,42,11,18,32.68859443402126,0.6438492063492064,41.76356589147286,1032.9457364341067,24.59394610557397,0
4778,4,0,0,53,0.0,0.0,1.0,53,900,600,300,0.6666666666666666,12,6,6,350.64446273359806,0.4099993952588292,0.36203549173234095,0.21695998939076538,133397.13588613961,-1245.0065914007666,132152.12929473884,4649,16,1136.4716981132076,42,11,18,32.68357408623329,0.6440972222222223,41.73934108527131,1033.0426356589144,24.596253229974153,0
4779,4,0,0,53,0.0,0.0,1.0,53,1000,700,300,0.7,13,7,6,353.29711759945235,0.40960631349782295,0.3687517584169562,0.2188964070286435,133447.19109616292,-1170.6984067964806,132276.49268936642,4650,17,1137.4716981132076,42,11,18,32.56490512363625,0.6445932539682541,41.69089147286821,1033.2364341085258,24.600867478774425,0
4780,4,0,0,53,0.0,0.0,1.0,53,2150,2100,50,0.9767441860465116,22,21,1,360.9505686323422,0.4089562167392356,0.381171846670332,0.22479276726021924,133637.8718770545,-952.6574415724493,132685.21443548205,4651,18,1138.4716981132076,38,15,18,32.17606943583385,0.6529605263157894,41.506410256410255,1033.9743589743587,27.209851551956806,0
4781,4,0,0,53,0.0,0.0,1.0,53,1100,900,200,0.8181818181818182,13,9,4,357.19960888855877,0.4085782535074988,0.37922910995539794,0.2232901105789486,133775.99172921688,-1043.0536151289305,132732.93811408794,4652,19,1139.4716981132076,38,15,16,32.134712038280156,0.6543311403508771,41.37286324786325,1034.508547008547,27.22390913180387,0
4782,4,0,0,53,0.0,0.0,1.0,53,1450,1000,450,0.6896551724137931,19,10,9,357.97791014574165,0.4083817126269957,0.37964033434136946,0.2250437981618296,133983.99658203122,-1007.3377821180561,132976.65879991316,4653,20,1140.4716981132076,39,14,17,31.906399872555923,0.6546474358974359,41.171875,1035.3124999999998,26.546474358974354,0
4783,4,0,0,53,0.0,0.0,1.0,53,1550,1200,350,0.7741935483870968,19,12,7,352.0884558998241,0.40797351233671986,0.3644356095520487,0.2223785451947219,134155.68300118996,-1153.0665443849366,133002.61645680503,4654,21,1141.4716981132076,40,13,17,31.887221241253023,0.6546874999999999,41.00609756097562,1035.975609756099,25.899390243902474,0
4784,4,0,0,53,0.0,0.0,1.0,53,1350,800,550,0.5925925925925926,19,8,11,353.7462517705153,0.4080944605708757,0.36902373849900383,0.2237466987005074,134208.3292021947,-1104.861317668031,133103.46788452668,4655,22,1142.4716981132076,40,13,18,31.791674839806465,0.6552083333333333,40.95528455284554,1036.1788617886198,25.904471544715495,0
4785,4,0,0,53,0.0,0.0,1.0,53,1000,600,400,0.6,14,6,8,352.29918819324007,0.407595549104983,0.3688136170275753,0.2229916090630959,134234.65617563977,-1141.847920384663,133092.8082552551,4656,23,1143.4716981132076,40,13,18,31.80285868392665,0.6554687499999998,40.9298780487805,1036.28048780488,25.907012195122,0
4786,4,0,0,53,0.0,0.0,1.0,53,1100,600,500,0.5454545454545454,16,6,10,356.0189571514669,0.407625786163522,0.3730243578259984,0.22570910584457102,134293.58780549272,-1037.7873834718905,133255.80042202084,4657,24,1144.4716981132076,41,12,18,31.647604007146512,0.654471544715447,40.87301587301588,1036.5079365079378,25.280681378242384,0
4787,4,0,0,53,0.0,0.0,1.0,53,1750,1200,550,0.6857142857142857,23,12,11,356.5458853170692,0.4073234155781325,0.3766654936249696,0.22715949000548186,134473.59738166092,-1010.7984339569227,133462.798947704,4658,25,1145.4716981132076,41,12,18,31.4541487326638,0.65625,40.69940476190476,1037.2023809523803,25.29761904761903,0
4788,4,0,0,53,0.0,0.0,1.0,53,1950,1500,450,0.7692307692307693,24,15,9,354.333493871803,0.4064163038219642,0.3706557858163959,0.2270696634361745,134685.9063042533,-1055.2101602359846,133630.6961440173,4659,26,1146.4716981132076,39,14,19,31.29965295199865,0.6615918803418804,40.49479166666666,1038.020833333332,26.615918803418765,0
4789,4,0,0,53,0.0,0.0,1.0,53,1500,900,600,0.6,21,9,12,356.5394255137814,0.4060081035316884,0.37696493578245516,0.22967772294724967,134875.19531249985,-982.335069444458,133892.8602430554,4660,27,1147.4716981132076,39,14,17,31.053616793688995,0.6634615384615385,40.31249999999999,1038.7499999999989,26.634615384615355,0
4790,4,0,0,53,0.0,0.0,1.0,53,1550,1100,450,0.7096774193548387,20,11,9,356.4673902208926,0.4060383405902274,0.37920443025525397,0.23031856767121925,134983.42013888893,-976.5624999999956,134006.85763888893,4661,28,1148.4716981132076,39,14,17,30.947607591553076,0.6645299145299146,40.208333333333336,1039.166666666667,26.645299145299152,0
4791,4,0,0,53,0.0,0.0,1.0,53,1350,900,450,0.6666666666666666,18,9,9,357.18548736665446,0.4059778664731495,0.38055041846779925,0.23112819668900636,135037.548828125,-953.309461805555,134084.23936631944,4662,29,1149.4716981132076,39,14,18,30.875008351707095,0.6650641025641026,40.15625,1039.375,26.650641025641026,0
4792,4,0,1,52,0.0,0.018867924528301886,0.9811320754716981,53,1900,1400,500,0.7368421052631579,24,14,10,358.8583767539999,0.40511611030478956,0.3896065111391731,0.2334974879896495,135236.9944002412,-893.8143424879421,134343.18005775326,4663,30,1150.4716981132076,40,13,18,30.63283667155188,0.6653645833333334,39.96443089430894,1040.1422764227636,26.003556910569092,0
4793,4,0,0,52,0.0,0.0,1.0,52,1450,1200,250,0.8275862068965517,17,12,5,393.0004206477981,0.40345336852689795,0.38965414430530787,0.2442054636973309,133555.0342085797,155.86672014656244,133710.90092872625,4664,31,1169.1346153846155,38,14,16,31.43087855297157,0.652138157894737,41.58653846153845,1033.6538461538446,27.20141700404854,7
4794,4,0,0,52,0.0,0.0,1.0,52,1400,1200,200,0.8571428571428571,16,12,4,393.26002070216833,0.40335910005027653,0.3910229910643308,0.24454909770656666,133582.6439111694,106.54266199135498,133689.18657316075,4665,32,1170.1346153846155,38,14,16,31.3964103624087,0.6524122807017545,41.55982905982905,1033.7606837606825,27.20422852001796,0
4795,4,0,0,52,0.0,0.0,1.0,52,950,500,450,0.5263157894736842,14,5,9,378.1992652198952,0.40335910005027653,0.33284623178240214,0.22623192410426451,132130.126953125,-405.6966145833312,131724.43033854166,4666,33,1171.1346153846155,43,9,14,33.247847011144884,0.6300872093023255,42.96875,1028.125,23.90988372093023,4
4796,4,0,0,52,0.0,0.0,1.0,52,1200,1000,200,0.8333333333333334,14,10,4,378.09590671835406,0.4035083584715938,0.32774472304859015,0.2266071493908016,132203.1572830579,-402.90547520661016,131800.25180785128,4667,34,1172.1346153846155,43,9,14,33.17679558011049,0.6308139534883721,42.89772727272727,1028.4090909090912,23.916490486257935,0
4797,4,0,0,52,0.0,0.0,1.0,52,1250,1000,250,0.8,15,10,5,380.9629606366583,0.4028170563097034,0.3318785484715907,0.22921060522026196,132349.2784736571,-315.9654069100044,132033.3130667471,4668,35,1173.1346153846155,43,9,14,32.95562611203142,0.632267441860465,42.75568181818182,1028.9772727272732,23.92970401691333,0
4798,4,0,0,52,0.0,0.0,1.0,52,1500,1100,400,0.7333333333333333,19,11,8,389.5265094884172,0.40265208647561584,0.34101625051894957,0.23498413153789593,132449.05832703426,-81.49818993639492,132367.56013709787,4669,36,1174.1346153846155,41,11,14,32.63460549987149,0.6361788617886179,42.658730158730144,1029.3650793650772,25.10646535036774,0
4799,4,1,0,53,0.018867924528301886,0.0,1.0,53,1450,700,750,0.4827586206896552,22,7,15,382.00036980804975,0.4037100870827286,0.3476246940289711,0.2325331110173832,132788.1262913223,-454.9773301193776,132333.1489612029,4670,0,1152.9622641509434,43,10,13,32.48652456204826,0.6366279069767442,42.32954545454545,1030.681818181818,23.96934460887949,0
4800,4,1,0,54,0.018518518518518517,0.0,1.0,54,600,300,300,0.5,9,3,6,377.29570598260244,0.40550023293733983,0.349757673667205,0.2312337049536941,133042.01388888896,-760.7638888888825,132281.2500000001,4671,0,1132.5925925925926,44,10,14,32.352248249865376,0.6377840909090909,42.083333333333336,1031.6666666666672,23.44696969696971,0
4801,4,0,0,54,0.0,0.0,1.0,54,1350,700,650,0.5185185185185185,20,7,13,378.4908414074091,0.40544927789424645,0.35514122716957597,0.23271028180741235,133161.44654492446,-719.9224108367733,132441.5241340877,4672,1,1133.5925925925926,44,10,16,32.20130229359171,0.638967803030303,41.96759259259259,1032.1296296296289,23.457491582491567,0
4802,4,0,0,54,0.0,0.0,1.0,54,1600,1200,400,0.75,20,12,8,383.4065316822045,0.40510715117633356,0.35528920240182815,0.236490577506634,133280.93278463642,-579.8439643347128,132701.0888203017,4673,2,1134.5925925925926,44,10,16,31.954283237685317,0.6401515151515152,41.85185185185185,1032.592592592592,23.468013468013453,0
4803,4,0,0,54,0.0,0.0,1.0,54,1200,600,600,0.5,18,6,12,380.7610852341272,0.4051653855112975,0.3482656944195406,0.23516108220938275,133328.7422839505,-646.7206790123571,132682.02160493814,4674,3,1135.5925925925926,44,10,16,31.974515868746625,0.640625,41.80555555555555,1032.777777777777,23.472222222222204,0
4804,4,0,1,53,0.0,0.018518518518518517,0.9814814814814815,54,1700,1400,300,0.8235294117647058,20,14,6,380.530873067656,0.404888772420219,0.35221970913779277,0.23609630556589373,133498.47690073715,-639.6329643767169,132858.84393636044,4675,4,1136.5925925925926,40,14,16,31.809912479103158,0.6481770833333333,41.64126016260163,1033.4349593495947,25.835873983739866,0
4805,4,0,0,53,0.0,0.0,1.0,53,1350,1000,350,0.7407407407407407,17,10,7,379.42117053727964,0.40445089501693277,0.35528748870947635,0.23607654849392967,133603.5214344142,-461.5991018903942,133141.9223325238,4676,5,1150.0188679245282,40,13,16,31.73310069137258,0.64921875,41.53963414634147,1033.8414634146354,25.846036585365887,0
4806,4,0,0,53,0.0,0.0,1.0,53,1250,600,650,0.48,19,6,13,374.6126498000232,0.4040275761973875,0.3440313989554691,0.23374818743193373,133708.6072794799,-582.2128651926632,133126.39441428724,4677,6,1151.0188679245282,40,13,13,31.751948838885077,0.6502604166666666,41.43800813008131,1034.2479674796757,25.856199186991894,0
4807,4,0,0,53,0.0,0.0,1.0,53,1400,1100,300,0.7857142857142857,17,11,6,375.1142947846988,0.4033925979680697,0.3409900703910873,0.23506393007954443,133866.31350593266,-556.9664427589018,133309.34706317374,4678,7,1152.0188679245282,40,13,13,31.580820976136707,0.6518229166666665,41.285569105691074,1034.8577235772386,25.871443089430965,0
4808,4,0,0,53,0.0,0.0,1.0,53,1300,1000,300,0.7692307692307693,16,10,6,374.7372000130816,0.4032565312046444,0.33840726852332126,0.23499529833332697,133892.6069138743,-565.0918765284946,133327.51503734582,4679,8,1153.0188679245282,40,13,13,31.564218381775333,0.6520833333333332,41.26016260162603,1034.959349593498,25.87398373983745,0
4809,4,0,0,53,0.0,0.0,1.0,53,1450,1000,450,0.6896551724137931,19,10,9,375.44515146218987,0.40284833091436867,0.33901177766674695,0.2364397368106323,134048.58599430646,-534.4216656150247,133514.16432869143,4680,9,1154.0188679245282,42,11,14,31.38957768004742,0.6505456349206348,41.10949612403102,1035.5620155038778,24.656238464378042,0
4810,4,0,1,52,0.0,0.018867924528301886,0.9811320754716981,53,1350,1100,250,0.8148148148148148,16,11,5,372.39088492531096,0.40299951620706337,0.33824647810813757,0.23537427336613678,134182.60306366225,-606.3243407082095,133576.27872295404,4681,10,1155.0188679245282,43,10,14,31.334449166742846,0.6504360465116279,40.98011363636364,1036.079545454546,24.09487315010572,0
4811,4,0,0,52,0.0,0.0,1.0,52,1450,1100,350,0.7586206896551724,18,11,7,373.42474612168803,0.4009709653092006,0.3407312582705253,0.23662032491217874,134274.45766480386,-371.71894717864876,133902.7387176252,4682,11,1176.6153846153845,42,10,15,31.215719272002005,0.6527777777777777,40.89147286821706,1036.4341085271324,24.67700258397934,0
4812,4,0,0,52,0.0,0.0,1.0,52,1800,1300,500,0.7222222222222222,23,13,10,371.9479074154392,0.4003032302664655,0.3382357073115907,0.236676440099156,134427.99914091197,-399.9574042986714,134028.0417366133,4683,12,1177.6153846153845,43,9,16,31.10037515599794,0.6528585271317829,40.74337121212121,1037.026515151515,24.116895701198022,0
4813,4,0,0,52,0.0,0.0,1.0,52,1150,800,350,0.6956521739130435,15,8,7,343.41428165066566,0.4002796631473102,0.2814071186515761,0.21335917713287314,133549.1182149942,-1202.636290505368,132346.48192448885,4684,13,1178.6153846153845,41,11,16,32.71817112966695,0.6471036585365855,41.5922619047619,1033.6309523809514,25.21051103368174,4
4814,4,0,0,52,0.0,0.0,1.0,52,1400,900,500,0.6428571428571429,19,9,10,344.4829483175085,0.39968262946204125,0.2765290158805127,0.2147661634725898,133677.32741244615,-1190.08802595115,132487.239386495,4685,14,1179.6153846153845,41,11,16,32.56227615758505,0.6483739837398375,41.468253968253954,1034.1269841269818,25.222609368950778,0
4815,4,0,1,51,0.0,0.019230769230769232,0.9807692307692307,52,1300,900,400,0.6923076923076923,17,9,8,343.3771076631341,0.39988687782805427,0.2769983181375588,0.21467245076205993,133779.93905895684,-1212.606292517019,132567.33276643982,4686,15,1180.6153846153845,41,11,16,32.48825278097429,0.649390243902439,41.36904761904761,1034.5238095238087,25.232288037166068,0
4816,4,0,0,51,0.0,0.0,1.0,51,1500,600,900,0.4,24,6,18,342.4675235273462,0.4007516339869281,0.2700931997451532,0.21485049145885726,133908.25897778064,-1028.1540336042074,132880.10494417645,4687,16,1189.0,41,10,16,32.38352263650596,0.6506605691056911,41.24503968253967,1035.019841269839,25.244386372435095,0
4817,4,0,0,51,0.0,0.0,1.0,51,700,400,300,0.5714285714285714,10,4,6,342.7000635604373,0.40091503267973855,0.27932299680435624,0.21559738175890789,134010.9592013888,-1014.8871527777865,132996.072048611,4688,17,1190.0,41,10,16,32.27489939637827,0.6516768292682926,41.14583333333333,1035.4166666666658,25.254065040650385,0
4818,4,0,0,51,0.0,0.0,1.0,51,1100,800,300,0.7272727272727273,14,8,6,340.69175161661974,0.401078431372549,0.2779256296248511,0.21533844335282715,134182.60306366225,-1057.018785152653,133125.5842785096,4689,18,1191.0,43,8,17,32.15551975748714,0.6504360465116279,40.98011363636364,1036.079545454546,24.09487315010572,0
4819,4,0,0,51,0.0,0.0,1.0,51,1450,1200,250,0.8275862068965517,17,12,5,340.2276006865304,0.40116013071895423,0.28204342849773556,0.2159113938965477,134329.81380746377,-1059.4579495236474,133270.35585794013,4690,19,1192.0,43,8,17,32.02066395663955,0.6518895348837209,40.83806818181818,1036.6477272727268,24.108086680761087,0
4820,4,0,0,51,0.0,0.0,1.0,51,1200,900,300,0.75,15,9,6,336.91217312413147,0.400718954248366,0.2822183196295045,0.2146712642366849,134477.10525891013,-1138.605246355599,133338.50001255452,4691,20,1193.0,43,8,17,31.959756079004215,0.653343023255814,40.69602272727273,1037.2159090909092,24.121300211416493,0
4821,4,0,0,51,0.0,0.0,1.0,51,1950,1500,450,0.7692307692307693,24,15,9,335.2193003301298,0.39977124183006535,0.283305215011435,0.2143272543675523,134602.24946460058,-1175.705268500694,133426.5441960999,4692,21,1194.0,41,10,17,31.878983428935637,0.6575203252032521,40.57539682539682,1037.698412698412,25.3097173828881,0
4822,4,0,0,51,0.0,0.0,1.0,51,1250,900,350,0.72,16,9,7,337.1084057127566,0.39967320261437905,0.28531538774355214,0.2159929729928089,134679.4702400635,-1119.6837010267204,133559.78653903678,4693,22,1195.0,41,10,17,31.75306237854025,0.6582825203252034,40.500992063492056,1037.9960317460307,25.31697638404953,0
4823,4,0,1,50,0.0,0.0196078431372549,0.9803921568627451,51,1000,700,300,0.7,13,7,6,334.998489949777,0.3995588235294118,0.2846612892648701,0.21494538303644467,134730.9630594134,-1173.0661651234766,133557.8968942899,4694,23,1196.0,41,10,17,31.756549609810484,0.6587906504065042,40.45138888888888,1038.194444444443,25.321815718157147,0
4824,4,0,0,50,0.0,0.0,1.0,50,1050,800,250,0.7619047619047619,13,8,5,340.0529650587787,0.39785714285714285,0.2943562126701267,0.21774049731318515,134656.23889756415,-841.9493398440218,133814.28955772013,4695,24,1219.7,40,10,17,31.699794379712127,0.6596354166666667,40.52337398373983,1037.9065040650396,25.94766260162599,0
4825,4,0,1,49,0.0,0.02,0.98,50,1350,1000,350,0.7407407407407407,17,10,7,341.91945348956597,0.3978146258503401,0.295177684371418,0.21985336849685336,134808.22074200035,-781.289367598908,134026.93137440144,4696,25,1220.7,41,9,14,31.499968156922687,0.6595528455284554,40.37698412698412,1038.4920634920622,25.32907471931859,0
4826,4,0,0,49,0.0,0.0,1.0,49,1000,700,300,0.7,13,7,6,351.4278363776689,0.39686082766439906,0.3032694014060471,0.22548695939253877,134730.96305941368,-330.35783179011605,134400.60522762357,4697,26,1246.0816326530612,41,8,18,31.330128205128208,0.658790650406504,40.45138888888889,1038.1944444444453,25.3218157181572,0
4827,4,0,0,49,0.0,0.0,1.0,49,1150,800,350,0.6956521739130435,15,8,7,353.570167732613,0.3969316893424036,0.307186714227238,0.22766787553262363,134859.73816609982,-263.52395124715844,134596.21421485266,4698,27,1247.0816326530612,41,8,15,31.1461318051576,0.660060975609756,40.327380952380956,1038.6904761904766,25.33391405342626,0
4828,4,0,0,49,0.0,0.0,1.0,49,1100,600,500,0.5454545454545454,16,6,10,356.47689407100665,0.39721513605442177,0.30979104768399,0.23035752408351598,134988.57478465917,-175.93842513858016,134812.63635952058,4699,28,1248.0816326530612,41,8,16,30.94222354813046,0.6613313008130082,40.20337301587301,1039.1865079365075,25.346012388695303,0
4829,4,0,0,49,0.0,0.0,1.0,49,1750,1100,650,0.6285714285714286,24,11,13,355.7013827253713,0.3968785430839002,0.3129524354832123,0.23051297399994786,135091.6883680552,-189.53993055558772,134902.14843749962,4700,29,1249.0816326530612,41,8,16,30.85963593854374,0.6623475609756099,40.10416666666665,1039.5833333333305,25.3556910569105,0
4830,4,0,0,49,0.0,0.0,1.0,49,1350,900,450,0.6666666666666666,18,9,9,358.4773670131666,0.39647108843537415,0.31352077311611404,0.23331068858678128,135246.43255739773,-103.44299178006793,135142.98956561767,4701,30,1250.0816326530612,41,8,16,30.633345255126365,0.6638719512195124,39.95535714285713,1040.1785714285695,25.370209059233403,0
4831,4,0,0,49,0.0,0.0,1.0,49,1250,800,450,0.64,17,8,9,356.61654251495617,0.39608134920634924,0.3079473162000739,0.2329332211072158,135375.453711577,-144.5747511967988,135230.87896038019,4702,31,1251.0816326530612,41,8,16,30.55330473466793,0.6651422764227644,39.831349206349195,1040.6746031746015,25.382307394502476,0
4832,4,0,0,49,0.0,0.0,1.0,49,800,500,300,0.625,11,5,6,357.0333545432334,0.39625850340136054,0.30989779768159,0.23340811084290128,135406.66806569608,-131.06061459648612,135275.60745109958,4703,32,1252.0816326530612,42,7,16,30.511397138689752,0.6639384920634921,39.80135658914728,1040.7945736434103,24.78082318198596,0
4833,4,0,0,49,0.0,0.0,1.0,49,1100,900,200,0.8181818181818182,13,9,4,356.645760100772,0.3963293650793651,0.3099976047192605,0.23318819448349698,135411.82532892848,-141.18932578626954,135270.6360031422,4704,33,1253.0816326530612,43,6,16,30.516350498893036,0.6625484496124032,39.796401515151516,1040.8143939393938,24.2049859055673,0
4834,4,0,0,49,0.0,0.0,1.0,49,1400,1000,400,0.7142857142857143,18,10,8,355.6318174365732,0.3958687641723356,0.31842376819771223,0.23332502771673977,135535.05581382,-159.88435491276147,135375.17145890725,4705,34,1254.0816326530612,43,6,16,30.420152782830137,0.6637596899224807,39.678030303030305,1041.2878787878788,24.21599718111346,0
4835,4,0,1,48,0.0,0.02040816326530612,0.9795918367346939,49,1400,1100,300,0.7857142857142857,17,11,6,358.0799999999996,0.3960104875283447,0.3239183673469379,0.23557894736842114,135633.68055555577,-86.35072314047727,135547.3298324153,4706,35,1255.0816326530612,40,9,16,30.258333333333322,0.6692708333333333,39.58333333333334,1041.6666666666683,26.041666666666707,0
4836,4,0,0,48,0.0,0.0,1.0,48,1200,1000,200,0.8333333333333334,14,10,4,363.5199999999996,0.39370013297872336,0.33149999999999924,0.23915789473684215,135633.68055555577,261.11111111113007,135894.7916666669,4707,36,1279.9583333333333,39,9,16,30.116666666666656,0.6709401709401708,39.58333333333334,1041.6666666666683,26.709401709401753,0
4837,4,0,0,48,0.0,0.0,1.0,48,1400,1200,200,0.8571428571428571,16,12,4,360.6175241613858,0.39399564125295505,0.3292052509733767,0.23781737211003826,135719.35745854504,188.55573349493204,135907.91319203997,4708,37,1280.9583333333333,37,11,16,30.107049528219164,0.6753941441441441,39.501096491228076,1041.9956140350885,28.162043622569957,0
4838,4,0,0,48,0.0,0.0,1.0,48,1300,900,400,0.6923076923076923,17,9,8,357.02384285998426,0.3928782505910165,0.32281880871477053,0.23595644462727916,135796.48980034742,96.51692708335361,135893.00672743077,4709,38,1281.9583333333333,39,9,17,30.12400892797655,0.6725427350427349,39.42708333333334,1042.2916666666683,26.725427350427392,0
4839,4,0,0,48,0.0,0.0,1.0,48,1150,900,250,0.782608695652174,14,9,5,354.62928004619965,0.3926381501182033,0.3180658240916503,0.23490962700082177,135877.93104383702,37.2585720486303,135915.18961588564,4710,39,1282.9583333333333,39,9,14,30.105509208379125,0.673344017094017,39.34895833333334,1042.6041666666683,26.733440170940213,0
4840,4,0,0,48,0.0,0.0,1.0,48,1150,500,650,0.43478260869565216,18,5,13,354.5679740636624,0.3909389775413712,0.3184564384717754,0.23658599906821007,136136.98365928038,53.9628982418032,136190.94655752217,4711,40,1283.9583333333333,40,8,14,29.849952932775018,0.6742187499999999,39.10060975609757,1043.5975609756113,26.089939024390283,0
4841,4,0,1,47,0.0,0.020833333333333332,0.9791666666666666,48,1150,900,250,0.782608695652174,14,9,5,353.5542413317468,0.3905141843971631,0.310269667477697,0.2369712869982844,136296.11512864372,37.613916154416586,136333.72904479815,4712,41,1284.9583333333333,40,8,15,29.718572587185733,0.67578125,38.94817073170732,1044.2073170731712,26.10518292682928,0
4842,4,0,0,47,0.0,0.0,1.0,47,1450,1200,250,0.8275862068965517,17,12,5,361.8447002205212,0.38804733271662045,0.31597113872136595,0.2422691670213953,136258.3129882814,460.8696831597377,136719.18267144114,4713,42,1310.787234042553,39,8,16,29.5396629419003,0.6770833333333333,38.98437500000001,1044.0625000000011,26.770833333333364,0
4843,4,0,1,46,0.0,0.02127659574468085,0.9787234042553191,47,1100,600,500,0.5454545454545454,16,6,10,362.7415252392707,0.3879895158803577,0.3198811481933461,0.24324306291128367,136312.6966688369,489.255099826399,136801.9517686633,4714,43,1311.787234042553,39,8,16,29.462281795511224,0.6776175213675213,38.93229166666667,1044.2708333333342,26.776175213675234,0
4844,4,0,0,46,0.0,0.0,1.0,46,1500,1100,400,0.7333333333333333,19,11,8,367.8968284150684,0.38620169082125605,0.3173114879255974,0.24632130335365598,136258.31298828125,825.8002387152783,137084.11322699653,4715,44,1339.0869565217392,39,7,16,29.381692939572314,0.6770833333333334,38.984375,1044.0625,26.770833333333332,0
4845,4,0,0,46,0.0,0.0,1.0,46,1250,1000,250,0.8,15,10,5,368.34820692110685,0.38631239935587763,0.3136645962732918,0.24681299640221763,136285.50347222228,840.1041666666711,137125.60763888893,4716,45,1340.0869565217392,39,7,16,29.342910348496943,0.6773504273504274,38.958333333333336,1044.166666666667,26.77350427350428,0
4846,4,0,0,46,0.0,0.0,1.0,46,1000,400,600,0.4,16,4,12,372.29781342993476,0.3862117552334943,0.31660047519120327,0.2502280477932566,136394.29253472236,955.8593750000125,137350.15190972236,4717,46,1341.0869565217392,39,7,17,29.131764393032828,0.6784188034188035,38.85416666666667,1044.5833333333344,26.784188034188062,0
4847,4,0,0,46,0.0,0.0,1.0,46,1600,1300,300,0.8125,19,13,6,375.691543081178,0.38501409017713367,0.32059194007895897,0.25390034245289067,136588.0975692378,1062.9986284618858,137651.0961976997,4718,47,1342.0869565217392,40,6,17,28.850703221206818,0.6786458333333334,38.668699186991866,1045.325203252032,26.1331300813008,0
4848,4,0,0,46,0.0,0.0,1.0,46,950,500,450,0.5263157894736842,14,5,9,376.0920340008642,0.3849537037037037,0.3222112332576781,0.2543628371970342,136614.65691924447,1075.9368390177774,137690.59375826226,4719,48,1343.0869565217392,40,6,17,28.81387511746216,0.67890625,38.64329268292683,1045.4268292682925,26.135670731707314,0
4849,4,0,0,46,0.0,0.0,1.0,46,1550,1200,350,0.7741935483870968,19,12,7,371.3489857376416,0.38494363929146536,0.31765807085692876,0.2525499324672541,136809.26492370747,960.9615993411089,137770.22652304856,4720,49,1344.0869565217392,36,10,17,28.744842124147823,0.6880787037037037,38.457207207207205,1046.171171171171,29.060310310310303,0
4850,4,0,0,46,0.0,0.0,1.0,46,1250,1000,250,0.8,15,10,5,371.3688400809275,0.3843498389694042,0.3175698448701487,0.25358275732564584,136950.36573753445,971.8196945213745,137922.18543205582,4721,50,1345.0869565217392,37,9,17,28.60447656959286,0.6875,38.32236842105262,1046.710526315788,28.289473684210485,0
4851,4,0,0,46,0.0,0.0,1.0,46,1050,900,150,0.8571428571428571,12,9,3,370.67578555747036,0.38477254428341384,0.31652428917506104,0.25352524358902034,137007.75719452125,957.0916051092531,137964.8487996305,4722,51,1346.0869565217392,37,9,16,28.565755481078064,0.6880630630630631,38.267543859649116,1046.9298245614023,28.29540066382168,0
4852,4,0,0,46,0.0,0.0,1.0,46,1300,1000,300,0.7692307692307693,16,10,6,369.81321040496596,0.3843599033816425,0.32305358948432805,0.2538969688242493,137140.24490466772,943.2548487836682,138083.49975345138,4723,52,1347.0869565217392,38,8,16,28.45713484292126,0.6875000000000001,38.14102564102563,1047.4358974358954,27.564102564102512,0
4853,4,0,0,46,0.0,0.0,1.0,46,1350,700,650,0.5185185185185185,20,7,13,366.4549975164594,0.3839170692431562,0.3116399959229439,0.2530112583134399,137336.1495201438,865.5036662648716,138201.6531864087,4724,53,1348.0869565217392,38,8,16,28.351255393605808,0.6894188596491229,37.95405982905982,1048.1837606837598,27.583783175888417,0
4854,4,0,0,46,0.0,0.0,1.0,46,1400,1000,400,0.7142857142857143,18,10,8,365.0162658030456,0.3839975845410628,0.3042348437520772,0.2524245677466725,137392.14794953956,830.0737590400834,138222.22170857966,4725,54,1349.0869565217392,38,8,16,28.333588097421785,0.689967105263158,37.900641025641015,1048.3974358974342,27.589406207827217,0
4855,4,0,0,46,0.0,0.0,1.0,46,1000,700,300,0.7,13,7,6,363.5077779118312,0.38374597423510465,0.3047775555949057,0.25185359946582253,137457.26047091998,793.3566623263689,138250.61713324636,4726,55,1350.0869565217392,39,7,16,28.30876874937916,0.6888354700854702,37.83854166666666,1048.645833333332,26.888354700854663,0
4856,4,0,0,46,0.0,0.0,1.0,46,1050,900,150,0.8571428571428571,12,9,3,364.27385673937886,0.3832427536231884,0.30709470845972353,0.25264154580311743,137492.56395002958,816.9893086125838,138309.55325864218,4727,56,1351.0869565217392,40,6,16,28.253795219638242,0.6875,37.80487804878048,1048.7804878048769,26.219512195121922,0
4857,4,0,0,46,0.0,0.0,1.0,46,750,400,350,0.5333333333333333,11,4,7,361.0582866648388,0.38304146537842193,0.3037581190028895,0.2507970144653073,137545.8608054068,732.4145680481128,138278.2753734549,4728,57,1352.0869565217392,40,6,16,28.285458244526247,0.6880208333333333,37.7540650406504,1048.983739837398,26.224593495934947,0
4858,4,0,0,46,0.0,0.0,1.0,46,850,700,150,0.8235294117647058,10,7,3,361.17479799455236,0.3829911433172302,0.3049395819381795,0.25107120806045535,137572.513106038,737.5449261352342,138310.05803217326,4729,58,1353.0869565217392,40,6,17,28.25607865930446,0.68828125,37.728658536585364,1049.0853658536582,26.227134146341456,0
4859,4,0,0,46,0.0,0.0,1.0,46,950,600,350,0.631578947368421,13,6,7,354.9474429869009,0.3821960547504026,0.2987081027107652,0.24790091711184165,137734.38607213728,577.6936295351572,138312.07970167242,4730,59,1354.0869565217392,41,5,17,28.259675361497024,0.6882621951219512,37.574404761904766,1049.7023809523816,25.602497096399553,0
4860,4,0,0,46,0.0,0.0,1.0,46,1250,900,350,0.72,16,9,7,354.8015138328182,0.38131038647342996,0.2952939095050644,0.2487659686859202,137868.5954507268,583.2637080075763,138451.85915873438,4731,60,1355.0869565217392,38,8,17,28.1311461512377,0.6946271929824561,37.44658119658119,1050.2136752136746,27.637201979307225,0
4861,4,0,0,46,0.0,0.0,1.0,46,1350,1200,150,0.8888888888888888,15,12,3,352.9911296882507,0.3812600644122383,0.29270317236502197,0.24768333755369745,137894.54345703128,535.1101345486113,138429.6535915799,4732,61,1356.0869565217392,39,7,17,28.153100102482714,0.6931089743589743,37.421875,1050.3125000000002,26.931089743589748,0
4862,4,0,0,46,0.0,0.0,1.0,46,500,300,200,0.6,7,3,4,351.90672947948025,0.3814210950080515,0.2906843714642626,0.24729162900267776,137945.91642086397,508.81925854319775,138454.73567940717,4733,62,1357.0869565217392,40,6,17,28.130945470961915,0.6919270833333333,37.3729674796748,1050.5081300813013,26.26270325203253,0
4863,4,0,0,46,0.0,0.0,1.0,46,950,600,350,0.631578947368421,13,6,7,351.8987585949008,0.3811191626409018,0.2896020555347629,0.2476706102867721,137999.30106294213,512.3565462026684,138511.6576091448,4734,63,1358.0869565217392,40,6,19,28.07855369636007,0.6924479166666666,37.32215447154472,1050.7113821138219,26.267784552845548,0
4864,4,0,0,46,0.0,0.0,1.0,46,950,500,450,0.5263157894736842,14,5,9,349.4845305343615,0.38059581320450886,0.2862941287521237,0.2465006069561269,138073.03969041322,450.87829113126895,138523.91798154448,4735,64,1359.0869565217392,41,5,13,28.06934742936253,0.6915650406504065,37.25198412698413,1050.9920634920636,25.633952768099114,0
4865,4,0,0,46,0.0,0.0,1.0,46,1350,1000,350,0.7407407407407407,17,10,7,349.80789100744965,0.38002214170692433,0.2840036761839895,0.24729247638465288,138151.24957679835,465.2794509007369,138616.52902769909,4736,65,1360.0869565217392,41,5,14,27.983843697901932,0.6923272357723578,37.17757936507937,1051.2896825396829,25.641211769260558,0
4866,4,0,0,46,0.0,0.0,1.0,46,1300,1000,300,0.7692307692307693,16,10,6,352.57386970452137,0.38000201288244767,0.2886054142739951,0.24981838361416608,138229.48160745777,547.2206475182625,138776.70225497603,4737,66,1361.0869565217392,41,5,14,27.83411949685535,0.693089430894309,37.1031746031746,1051.5873015873012,25.64847077042198,0
4867,4,0,0,46,0.0,0.0,1.0,46,1150,700,450,0.6086956521739131,16,7,9,352.7573109665963,0.37981078904991944,0.28269890802028996,0.2505214848076904,138307.7357823915,557.8129920949717,138865.54877448647,4738,67,1362.0869565217392,41,5,14,27.75226744003269,0.6938516260162602,37.028769841269835,1051.8849206349194,25.6557297715834,0
4868,4,0,0,46,0.0,0.0,1.0,46,1000,800,200,0.8,12,8,4,353.5731791000884,0.37956924315619966,0.2827808867843309,0.2514851485148515,138359.91753472213,584.0711805555502,138943.9887152777,4739,68,1363.0869565217392,41,5,14,27.679455445544562,0.694359756097561,36.979166666666664,1052.0833333333328,25.660569105691042,0
4869,4,0,0,46,0.0,0.0,1.0,46,900,500,400,0.5555555555555556,13,5,8,353.95466923281697,0.37899557165861514,0.28565807593940606,0.2523354254853308,138438.20861678,600.1700680272113,139038.37868480722,4740,69,1364.0869565217392,41,5,14,27.592383107088995,0.6951219512195121,36.904761904761905,1052.380952380952,25.66782810685249,0
4870,4,0,0,46,0.0,0.0,1.0,46,1350,1000,350,0.7407407407407407,17,10,7,353.3269082630579,0.3784621578099839,0.2864685129869333,0.2524681362679666,138516.52184311216,588.3228812358192,139104.844724348,4741,70,1365.0869565217392,41,5,14,27.5318655169164,0.6958841463414634,36.83035714285714,1052.6785714285706,25.67508710801392,0
4871,4,0,0,46,0.0,0.0,1.0,46,1000,800,200,0.8,12,8,4,353.3269082630579,0.3785124798711755,0.2864685129869333,0.2524681362679666,138516.52184311216,588.3228812358192,139104.844724348,4742,71,1366.0869565217392,41,5,14,27.5318655169164,0.6958841463414634,36.83035714285714,1052.6785714285706,25.67508710801392,0
4872,4,0,0,46,0.0,0.0,1.0,46,1000,600,400,0.6,14,6,8,354.1467965274542,0.3783615136876006,0.2890902833543656,0.25324836959227365,138542.63117283938,612.8858024691242,139155.5169753085,4743,72,1367.0869565217392,41,5,14,27.48460861917326,0.6961382113821138,36.80555555555555,1052.7777777777767,25.677506775067723,0
4873,4,0,0,46,0.0,0.0,1.0,46,1150,900,250,0.782608695652174,14,9,5,327.627815512433,0.37828099838969403,0.20139761590254857,0.22815958933660035,137634.50518485962,-181.4215454299685,137453.08363942965,4744,73,1368.0869565217392,42,4,16,29.07489919044541,0.685763888888889,37.66957364341085,1049.321705426356,24.983850129198952,5
4874,4,0,0,46,0.0,0.0,1.0,46,850,600,250,0.7058823529411765,11,6,5,326.5565624709587,0.3781904186795491,0.20013248223533675,0.22758092481084163,137659.92597349908,-209.24955681750959,137450.67641668156,4745,74,1369.0869565217392,42,4,16,29.07798553401047,0.6860119047619049,37.6453488372093,1049.418604651162,24.986157253599096,0
4875,4,0,0,46,0.0,0.0,1.0,46,1050,600,450,0.5714285714285714,15,6,9,329.7882907105035,0.3781501610305958,0.2005314663371962,0.23035306884221396,137737.9362248194,-115.1282892848813,137622.8079355345,4746,75,1370.0869565217392,43,3,17,28.916422342504873,0.6853197674418604,37.571022727272734,1049.7159090909106,24.41199788583513,0
4876,4,0,1,45,0.0,0.021739130434782608,0.9782608695652174,46,1250,900,350,0.72,16,9,7,331.83259259383647,0.37776771336553944,0.20041902928665145,0.2324770109196174,137841.28439760298,-51.83278490887784,137789.4516126941,4747,76,1371.0869565217392,37,9,17,28.761072534892634,0.6962274774774775,37.47258771929824,1050.109649122806,28.38134186818395,0
4877,4,0,0,45,0.0,0.0,1.0,45,1750,1500,250,0.8571428571428571,20,15,5,337.7161176397606,0.3747474747474748,0.19974924604384836,0.238144333277586,138065.0194156805,325.3564677843574,138390.37588346485,4748,77,1397.7333333333333,38,7,16,28.386449120666878,0.696546052631579,37.25961538461539,1050.9615384615386,27.65688259109312,0
4878,4,0,0,45,0.0,0.0,1.0,45,1050,700,350,0.6666666666666666,14,7,7,338.0688213398854,0.3742845117845118,0.20196682812270672,0.23917579229373204,138177.32445987655,342.6890432098778,138520.01350308643,4749,78,1398.7333333333333,38,7,16,28.266732716864826,0.6976425438596491,37.15277777777778,1051.388888888889,27.66812865497076,0
4879,4,0,1,44,0.0,0.022222222222222223,0.9777777777777777,45,1100,900,200,0.8181818181818182,13,9,4,335.1471388791118,0.3737794612794613,0.19911322353148253,0.2381879630921993,138332.5208875869,272.3497178819503,138604.87060546884,4750,79,1399.7333333333333,39,6,16,28.191013136614178,0.6973824786324786,37.005208333333336,1051.9791666666672,26.9738247863248,0
4880,4,0,0,44,0.0,0.0,1.0,44,500,200,300,0.4,8,2,6,336.30985478243656,0.3737337033121917,0.18877230720939475,0.23910780794531789,138345.86763322743,505.41573069618556,138851.2833639236,4751,80,1387.7045454545455,38,6,17,28.147320672963005,0.6992872807017543,36.99252136752137,1052.0299145299148,27.684997750787232,0
4881,4,0,0,44,0.0,0.0,1.0,44,1100,900,200,0.8181818181818182,13,9,4,336.1853509791774,0.37279774489076817,0.18115855121132207,0.2404042415492608,138542.63117283952,515.200617283954,139057.83179012348,4752,81,1388.7045454545455,38,6,19,27.957343887423054,0.7012061403508771,36.80555555555556,1052.7777777777778,27.7046783625731,0
4882,4,0,0,44,0.0,0.0,1.0,44,800,700,100,0.875,9,7,2,336.1853509791774,0.3725004404510219,0.18115855121132207,0.2404042415492608,138542.63117283952,515.200617283954,139057.83179012348,4753,82,1389.7045454545455,38,6,19,27.957343887423054,0.7012061403508771,36.80555555555556,1052.7777777777778,27.7046783625731,0
4883,4,0,0,44,0.0,0.0,1.0,44,1300,1000,300,0.7692307692307693,16,10,6,336.88091471738517,0.37210403453136015,0.17710946723730814,0.24130074821617337,138598.87500913136,538.2631583753323,139137.1381675067,4754,83,1390.7045454545455,38,6,19,27.883818655303035,0.7017543859649122,36.75213675213675,1052.9914529914524,27.710301394511905,0
4884,4,0,0,44,0.0,0.0,1.0,44,1150,800,350,0.6956521739130435,15,8,7,337.545721233167,0.371751673713883,0.17440992070809513,0.24258023406406903,138711.396924538,564.2877036306593,139275.68462816867,4755,84,1391.7045454545455,38,6,19,27.75587390128465,0.7028508771929824,36.64529914529915,1053.418803418804,27.721547458389576,0
4885,4,0,0,44,0.0,0.0,1.0,44,1650,1200,450,0.7272727272727273,21,12,9,334.4842131575248,0.37106897463002114,0.16573841178584248,0.24178430265386808,138908.42013888902,492.8143719409949,139401.23451083002,4756,85,1392.7045454545455,36,8,20,27.643280632411074,0.7086226851851851,36.45833333333334,1054.1666666666679,29.28240740740744,0
4886,4,0,0,44,0.0,0.0,1.0,44,1050,500,550,0.47619047619047616,16,5,11,330.81946189738085,0.3708707716701903,0.16217225278360647,0.2399563789237562,139024.03263504154,398.3711334256684,139422.40376846722,4757,86,1393.7045454545455,37,7,20,27.626585568725314,0.7077702702702703,36.348684210526315,1054.6052631578946,28.502844950213365,0
4887,4,0,0,44,0.0,0.0,1.0,44,1200,800,400,0.6666666666666666,16,8,8,328.4543441846677,0.37066155743481327,0.1612500118112843,0.23885557410436023,139110.77356734753,338.3075802169795,139449.08114756452,4758,87,1394.7045454545455,37,7,20,27.604004261511278,0.7086148648648649,36.26644736842105,1054.934210526315,28.511735419630135,0
4888,4,0,0,44,0.0,0.0,1.0,44,1050,900,150,0.8571428571428571,12,9,3,328.4543441846677,0.37066155743481327,0.1612500118112843,0.23885557410436023,139110.77356734753,338.3075802169795,139449.08114756452,4759,88,1395.7045454545455,37,7,20,27.604004261511278,0.7086148648648649,36.26644736842105,1054.934210526315,28.511735419630135,0
4889,4,0,0,44,0.0,0.0,1.0,44,1000,700,300,0.7,13,7,6,327.02588958019516,0.370573467230444,0.15986564879726384,0.23802141524513132,139139.69322291468,300.4563904278165,139440.14961334248,4760,89,1396.7045454545455,37,7,20,27.613368669022382,0.7088963963963965,36.239035087719294,1055.0438596491222,28.514698909435733,0
4890,4,0,0,44,0.0,0.0,1.0,44,1250,900,350,0.72,16,9,7,325.99842408963536,0.36998986962649755,0.16317506633804602,0.23829816467053277,139284.3365867381,281.2948455293812,139565.6314322675,4761,90,1397.7045454545455,37,7,17,27.498939614279294,0.7103040540540542,36.10197368421052,1055.5921052631568,28.529516358463695,0
4891,4,0,0,44,0.0,0.0,1.0,44,1500,1200,300,0.8,18,12,6,324.8332786470153,0.3697586328400282,0.16376477697624403,0.23765158106485265,139313.2742767004,250.71752847028858,139563.9918051707,4762,91,1398.7045454545455,37,7,17,27.501384849743808,0.7105855855855856,36.07456140350877,1055.701754385964,28.532479848269297,0
4892,4,0,0,44,0.0,0.0,1.0,44,950,400,550,0.42105263157894735,15,4,11,322.31208835669474,0.3685143587033122,0.164201183431953,0.2368293170968756,139458.0078125,189.80034722222246,139647.80815972222,4763,92,1399.7045454545455,37,7,17,27.426446416831038,0.7119932432432432,35.9375,1056.25,28.5472972972973,0
4893,4,0,0,44,0.0,0.0,1.0,44,650,300,350,0.46153846153846156,10,3,7,322.9883481910707,0.3682500880902044,0.16322828702174852,0.23773817683888193,139515.92226694743,212.40345587102712,139728.32572281847,4764,93,1400.7045454545455,37,7,17,27.351993599723237,0.7125563063063063,35.882675438596486,1056.4692982456133,28.55322427690847,0
4894,4,0,0,44,0.0,0.0,1.0,44,950,700,250,0.7368421052631579,12,7,5,321.8972146717695,0.36815098661028894,0.1618482366890015,0.23742620062031844,139584.98982988155,186.40388724522097,139771.39371712678,4765,94,1401.7045454545455,38,6,17,27.313340410474172,0.7113486842105263,35.817307692307686,1056.7307692307684,27.808704453441273,0
4895,4,0,0,44,0.0,0.0,1.0,44,900,600,300,0.6666666666666666,12,6,6,319.53503988855533,0.36780963706835795,0.1580710072220075,0.23628398241086448,139669.67661078245,125.8711374096032,139795.54774819207,4766,95,1402.7045454545455,38,6,17,27.29305639781686,0.712171052631579,35.73717948717949,1057.0512820512827,27.817139001349545,0
4896,4,0,0,44,0.0,0.0,1.0,44,1450,1300,150,0.896551724137931,16,13,3,318.18030188319307,0.36780963706835795,0.11321126511092405,0.21167341534873493,136030.94765227393,-143.52640210851652,135887.4212501654,4767,96,1403.7045454545455,40,4,16,30.904164637116416,0.6731770833333333,39.20223577235773,1043.1910569105703,26.079776422764258,7
4897,4,0,0,44,0.0,0.0,1.0,44,1300,1000,300,0.7692307692307693,16,10,6,318.54165882544817,0.36684064482029594,0.11520330385361088,0.2125473875554599,136136.9836592802,-126.93987953598895,136010.0437797442,4768,97,1404.7045454545455,40,4,16,30.78987730061349,0.67421875,39.10060975609756,1043.59756097561,26.089939024390247,0
4898,4,0,0,44,0.0,0.0,1.0,44,700,600,100,0.8571428571428571,8,6,2,320.90516414191086,0.36688468992248063,0.11910188438764036,0.2144448237411561,136190.01715455425,-59.18403810561563,136130.83311644863,4769,98,1405.7045454545455,40,4,17,30.675769967221633,0.6747395833333333,39.049796747967484,1043.8008130081307,26.09502032520327,0
4899,4,0,0,44,0.0,0.0,1.0,44,850,700,150,0.8235294117647058,10,7,3,326.16799569029314,0.36658738548273434,0.12145321831453204,0.21861553527186958,136296.11512864364,91.08613837662304,136387.20126702025,4770,99,1406.7045454545455,40,4,17,30.433495539334956,0.67578125,38.948170731707314,1044.2073170731705,26.105182926829265,0
4900,4,1,0,45,0.022222222222222223,0.0,1.0,45,500,300,200,0.6,7,3,4,323.51170863580006,0.3689814814814815,0.12905593520627723,0.21849483090940935,136565.33446712003,-163.90306122450465,136401.43140589554,4771,0,1376.4222222222222,41,4,18,30.236807137433562,0.676829268292683,38.69047619047618,1045.238095238094,25.493612078977904,0
4901,4,0,0,45,0.0,0.0,1.0,45,1100,600,500,0.5454545454545454,16,6,10,322.97831753215604,0.3689183501683502,0.13172660277698722,0.21861711550875987,136643.11623086725,-173.44724348073515,136469.6689873865,4772,1,1377.4222222222222,41,4,19,30.1739372805769,0.677591463414634,38.61607142857142,1045.5357142857135,25.500871080139355,0
4902,4,0,0,45,0.0,0.0,1.0,45,1000,600,400,0.6,14,6,8,323.32820113966454,0.3689814814814815,0.12872952633908818,0.2193388607731238,136720.92013888896,-158.85416666665637,136562.0659722223,4773,2,1378.4222222222222,41,4,20,30.08798140770252,0.6783536585365852,38.54166666666667,1045.833333333334,25.508130081300827,0
4903,4,0,0,45,0.0,0.0,1.0,45,750,400,350,0.5333333333333333,11,4,7,323.83986405115576,0.3689814814814815,0.13357781149890435,0.22001079423681624,136772.80171327794,-141.50289745527405,136631.29881582267,4774,3,1379.4222222222222,41,4,21,30.023394031360663,0.678861788617886,38.492063492063494,1046.0317460317463,25.512969415408445,0
4904,4,0,0,45,0.0,0.0,1.0,45,1400,1100,300,0.7857142857142857,17,11,6,326.13786752319135,0.3682659932659933,0.12953343865192224,0.22255850597475224,136928.50548784327,-68.48584341143777,136860.01964443183,4775,4,1380.4222222222222,41,4,22,29.809636650868885,0.6803861788617886,38.34325396825397,1046.626984126984,25.52748741773132,0
4905,4,0,0,45,0.0,0.0,1.0,45,1200,900,300,0.75,15,9,6,321.32993465712036,0.3688341750841751,0.16057067130492397,0.20874775173972251,135179.84571239716,-312.53380205515947,134867.311910342,4776,5,1381.4222222222222,42,3,14,31.66542427630761,0.6617063492063492,40.01937984496124,1039.9224806201555,24.760059062384656,4
4906,4,0,0,45,0.0,0.0,1.0,45,1600,1200,400,0.75,20,12,8,317.0367680698691,0.36820286195286195,0.1585591052051416,0.20672302497232373,135313.2812948377,-420.1429242711075,134893.1383705666,4777,6,1382.4222222222222,43,2,14,31.644689936591735,0.6615794573643411,39.89109848484849,1040.4356060606071,24.1961768851304,0
4907,4,0,1,44,0.0,0.022222222222222223,0.9777777777777777,45,1300,1000,300,0.7692307692307693,16,10,6,318.71054385898833,0.36710858585858586,0.16776332413556072,0.2086709355951081,135461.11079724837,-365.4231412132379,135095.68765603512,4778,7,1383.4222222222222,43,2,15,31.45458094545014,0.663032945736434,39.749053030303045,1041.0037878787905,24.209390415785826,0
4908,4,0,0,44,0.0,0.0,1.0,44,700,400,300,0.5714285714285714,10,4,6,324.42720958216694,0.3639116455250176,0.17594379549686767,0.21194332304820424,135381.45619253675,-15.714387656969308,135365.74180487977,4779,108,1415.7045454545455,42,2,15,31.384815332091865,0.663690476190476,39.82558139534885,1040.6976744186065,24.77851605758587,0
4909,4,0,0,44,0.0,0.0,1.0,44,650,300,350,0.46153846153846156,10,3,7,324.42720958216694,0.3639116455250176,0.17594379549686767,0.21194332304820424,135381.45619253675,-15.714387656969308,135365.74180487977,4780,109,1416.7045454545455,42,2,15,31.384815332091865,0.663690476190476,39.82558139534885,1040.6976744186065,24.77851605758587,0
4910,4,0,0,44,0.0,0.0,1.0,44,850,500,350,0.5882352941176471,12,5,7,328.0881788566351,0.36351523960535587,0.1798124608588212,0.2146360059243591,135431.8822862209,86.7199236824863,135518.6022099034,4781,110,1417.7045454545455,42,2,16,31.239527089927403,0.6641865079365079,39.777131782945744,1040.891472868218,24.78313030638614,0
4911,4,0,0,44,0.0,0.0,1.0,44,850,800,50,0.9411764705882353,9,8,1,329.9084455902788,0.3632289464411558,0.1797712893730754,0.2167393626653005,135583.21690403222,146.00966738777365,135729.22657142,4782,111,1418.7045454545455,42,2,17,31.042015568788,0.6656746031746031,39.63178294573643,1041.4728682170542,24.796973052787003,0
4912,4,0,0,44,0.0,0.0,1.0,44,1300,800,500,0.6153846153846154,18,8,10,329.27999999999963,0.3630307434813249,0.17545454545454509,0.21663157894736848,135633.68055555577,132.3104455862223,135765.99100114199,4783,112,1419.7045454545455,40,4,17,31.00833333333332,0.6692708333333333,39.58333333333334,1041.6666666666683,26.041666666666707,0
4913,4,0,0,44,0.0,0.0,1.0,44,1150,1000,150,0.8695652173913043,13,10,3,328.8962025367947,0.36198467230443976,0.178860113270759,0.21750408442423663,135818.99957242745,134.0706383436102,135953.07021077105,4784,113,1420.7045454545455,40,4,17,30.834633258587633,0.6710937499999998,39.405487804878064,1042.3780487804904,26.059451219512262,0
4914,4,0,0,44,0.0,0.0,1.0,44,1000,700,300,0.7,13,7,6,327.77772245362775,0.36243613460183227,0.17635585156993328,0.21720957521990117,135892.15344702714,108.4841112371058,136000.63755826425,4785,114,1421.7045454545455,41,3,14,30.79130986362194,0.6702235772357723,39.33531746031747,1042.6587301587317,25.43070073557882,0
4915,4,0,0,44,0.0,0.0,1.0,44,850,600,250,0.7058823529411765,11,6,5,335.9811096744744,0.36243613460183227,0.13644575015510352,0.21514882884296083,134658.87586805588,253.60676099146724,134912.48262904736,4786,115,1422.7045454545455,39,5,17,31.80282349792588,0.6613247863247862,40.52083333333335,1037.9166666666692,26.613247863247928,2
4916,4,0,0,44,0.0,0.0,1.0,44,800,500,300,0.625,11,5,6,334.35388133429313,0.3624031007751938,0.1359873192537513,0.21426600819911512,134685.90630425388,206.5511067708722,134892.45741102475,4787,116,1423.7045454545455,39,5,17,31.81813430339521,0.6615918803418802,40.494791666666686,1038.0208333333364,26.615918803418882,0
4917,4,0,0,44,0.0,0.0,1.0,44,1250,1000,250,0.8,15,10,5,333.0412304101651,0.3622379316420014,0.13479922646087572,0.2135835844445119,134712.9394531254,172.99262152782038,134885.93207465322,4788,117,1424.7045454545455,39,5,17,31.82528931701118,0.6618589743589742,40.46875000000002,1038.1250000000032,26.618589743589826,0
4918,4,0,0,44,0.0,0.0,1.0,44,1350,1000,350,0.7407407407407407,17,10,7,348.40216541619003,0.3622379316420014,0.1435982889435885,0.20708823105298674,131889.27001953125,390.10145399305577,132279.3714735243,4789,118,1425.7045454545455,39,5,15,34.25626626778893,0.6338141025641025,43.203125,1027.1875,26.338141025641026,5
4919,4,0,0,44,0.0,0.0,1.0,44,900,600,300,0.6666666666666666,12,6,6,348.29562010907136,0.36176444679351655,0.14497161394971614,0.20746304328235993,131969.53125,392.88194444444383,132362.41319444444,4790,119,1426.7045454545455,39,5,16,34.17815625844823,0.6346153846153846,43.125,1027.5,26.346153846153847,0
4920,4,0,0,44,0.0,0.0,1.0,44,1250,900,350,0.72,16,9,7,348.4420218725611,0.3623700669485553,0.1533463242949411,0.20799016514316765,132049.81689453122,402.3410373263886,132452.1579318576,4791,120,1427.7045454545455,39,5,16,34.09354835985271,0.6354166666666666,43.046875,1027.8124999999998,26.35416666666666,0
4921,4,1,1,44,0.022222222222222223,0.022222222222222223,0.9777777777777777,45,900,700,200,0.7777777777777778,11,7,4,344.61405752414356,0.3674452861952862,0.150109212244943,0.20703430886153718,132293.43401951538,118.03541625354282,132411.46943576893,4792,0,1396.9555555555555,40,5,16,33.94682900325989,0.6361979166666667,42.80995934959349,1028.760162601625,25.71900406504063,0
4922,4,0,0,44,0.0,0.0,1.0,44,800,600,200,0.75,10,6,4,349.0081717673452,0.36195163847780126,0.16123130034522482,0.20951098457158246,132264.03130425338,432.24555121527254,132696.27685546866,4793,122,1429.7045454545455,39,5,16,33.863396624472585,0.6375534188034189,42.838541666666664,1028.6458333333328,26.375534188034173,0
4923,4,0,0,44,0.0,0.0,1.0,44,650,400,250,0.6153846153846154,9,4,5,348.16324213973394,0.3619075933756166,0.15772409730595394,0.20930056863141538,132317.6120334202,413.6257595486163,132731.23779296884,4794,123,1430.7045454545455,39,5,16,33.8312282744423,0.6380876068376069,42.786458333333336,1028.8541666666672,26.380876068376082,0
4924,4,0,0,44,0.0,0.0,1.0,44,1250,1000,250,0.8,15,10,5,368.8010532464418,0.3619075933756166,0.10514823471521728,0.21803518267929642,131684.26890432098,1010.1866922260824,132694.45559654708,4795,124,1431.7045454545455,35,9,20,33.9394451962111,0.6392857142857142,43.40277777777778,1026.388888888889,29.325396825396826,5
4925,4,0,0,44,0.0,0.0,1.0,44,750,500,250,0.6666666666666666,10,5,5,367.18223519228667,0.3609386011275546,0.10810187557650952,0.2174169843895582,131743.6731074245,874.7872728052075,132618.4603802297,4796,125,1432.7045454545455,35,9,20,33.92098835024427,0.6398809523809523,43.344907407407405,1026.6203703703698,29.332010582010565,0
4926,4,0,0,44,0.0,0.0,1.0,44,800,600,200,0.75,10,6,4,368.9233561419459,0.36076242071881603,0.10554636174221677,0.2188817231397791,131819.1518165125,926.2327783864978,132745.384594899,4797,126,1433.7045454545455,36,8,20,33.80007859048871,0.638599537037037,43.2713963963964,1026.9144144144148,28.52540040040041,0
4927,4,0,0,44,0.0,0.0,1.0,44,1450,1000,450,0.6896551724137931,19,10,9,368.34981119274516,0.3594300563777308,0.10641922180383734,0.21970982855849625,132021.60564280493,926.0267023780514,132947.632345183,4798,127,1434.7045454545455,36,8,20,33.61047191175397,0.640625,43.07432432432432,1027.7027027027025,28.54729729729729,0
4928,4,1,2,43,0.022222222222222223,0.044444444444444446,0.9555555555555556,45,1350,1100,250,0.8148148148148148,16,11,5,360.13381364500395,0.3643728956228956,0.10225314089917936,0.2166426457973163,132343.0323275075,532.2401882898686,132875.27251579738,4799,0,1403.8,38,7,20,33.4977330149171,0.6400767543859649,42.761752136752136,1028.9529914529917,27.077710301394518,0
4929,4,0,0,43,0.0,0.0,1.0,43,1150,700,450,0.6086956521739131,16,7,9,370.58751324098347,0.35947305278700625,0.0827787970446765,0.22225772852943892,132228.78674207447,1200.4674515235397,133429.25419359803,4800,129,1361.7209302325582,37,6,20,33.34399431414355,0.6407657657657657,42.872807017543856,1028.5087719298244,27.797534376481742,0
4930,4,0,0,43,0.0,0.0,1.0,43,800,500,300,0.625,11,5,6,370.61905532223716,0.3600498338870432,0.08916982152514863,0.22311267130398665,132370.51647308053,1211.8071535539439,133582.32362663446,4801,130,1362.7209302325582,38,5,20,33.200313192137315,0.6403508771929824,42.73504273504273,1029.0598290598286,27.080521817363913,0
4931,4,0,0,43,0.0,0.0,1.0,43,700,500,200,0.7142857142857143,9,5,4,372.7014464799013,0.35984219269102985,0.08872060753393685,0.2250783595780856,132489.9092970521,1275.8475820746776,133765.75687912677,4802,131,1363.7209302325582,34,9,20,33.02642229417206,0.6495098039215687,42.61904761904761,1029.523809523809,30.280112044817912,0
4932,4,1,1,43,0.022727272727272728,0.022727272727272728,0.9772727272727273,44,950,700,250,0.7368421052631579,12,7,5,364.2446654703181,0.36360332980972515,0.08760107816711593,0.22153241129424228,132755.59413580227,871.1033950617061,133626.69753086398,4803,0,1333.7045454545455,35,9,17,32.97675202156334,0.6500000000000001,42.3611111111111,1030.5555555555538,29.444444444444397,0
4933,4,0,1,42,0.0,0.023255813953488372,0.9767441860465116,43,1150,900,250,0.782608695652174,14,9,5,375.9030736535682,0.35813492063492064,0.09092765335511332,0.2284983852208769,132735.1473922902,1379.1099773242606,134114.25736961447,4804,133,1365.7209302325582,34,9,17,32.69697319778188,0.6519607843137255,42.38095238095238,1030.4761904761904,30.308123249299715,0
4934,4,0,0,42,0.0,0.0,1.0,42,1200,1000,200,0.8333333333333334,14,10,4,375.92082440567305,0.35887291908633373,0.0894179894179894,0.2297293926923556,132934.57031249988,1594.5746527777633,134529.14496527764,4805,134,1382.8333333333333,35,7,17,32.495791245791246,0.6517857142857144,42.18749999999999,1031.249999999999,29.464285714285687,0
4935,4,0,0,42,0.0,0.0,1.0,42,1000,600,400,0.6,14,6,8,378.72945116882994,0.3581712156407278,0.08963004542572373,0.23225697668064377,133065.2506391526,1679.1458688418068,134744.39650799442,4806,135,1383.8333333333333,36,6,17,32.29189405515536,0.6510416666666667,42.06081081081081,1031.7567567567562,28.659909909909896,0
4936,4,0,0,42,0.0,0.0,1.0,42,1050,800,250,0.7619047619047619,13,8,5,377.6587392340505,0.3579413472706156,0.08917316661102515,0.23237120072871573,133189.11227493067,1660.0064442905395,134849.1187192212,4807,136,1384.8333333333333,37,5,18,32.194957864173915,0.6503378378378379,41.940789473684205,1032.2368421052627,27.898293029871965,0
4937,4,1,1,42,0.023255813953488372,0.023255813953488372,0.9767441860465116,43,1200,1000,200,0.8333333333333334,14,10,4,363.46350146697756,0.36182631967515694,0.07525754117574501,0.22551965117355227,133500.54974848012,1104.8160251230977,134605.3657736032,4808,0,1353.6046511627908,37,6,19,32.24878426171531,0.6534346846846848,41.639254385964904,1033.442982456139,27.930891417733484,0
4938,4,0,0,42,0.0,0.0,1.0,42,650,300,350,0.46153846153846156,10,3,7,371.58064840362533,0.35737272551296945,0.07745866630273857,0.229853006474757,133387.25767784292,1512.8247393428492,134900.08241718577,4809,138,1386.8333333333333,37,5,19,32.152792520256156,0.6523085585585586,41.74890350877192,1033.0043859649104,27.91903745851109,0
4939,4,1,0,43,0.023255813953488372,0.0,1.0,43,900,700,200,0.7777777777777778,11,7,4,364.5057795960414,0.36037283130306386,0.07795013440528753,0.22703365268102157,133642.2324657585,1142.7002779701234,134784.93274372863,4810,0,1355.5581395348838,37,6,21,32.079798515376446,0.6548423423423424,41.50219298245613,1033.991228070174,27.945708866761457,0
4940,4,0,0,43,0.0,0.0,1.0,43,1100,700,400,0.6363636363636364,15,7,8,359.8340960267431,0.3605343300110742,0.09302806968560606,0.22144694495607606,133196.36774965306,1003.5248761744206,134199.8926258275,4811,1,1356.5581395348838,38,5,19,32.647657489822684,0.6485745614035088,41.93376068376069,1032.2649572649577,27.164867296446257,3
4941,4,0,0,43,0.0,0.0,1.0,43,950,700,250,0.7368421052631579,12,7,5,361.23411356683897,0.3607650424510889,0.08848471430771565,0.2226381679534396,133251.51581561842,1026.998639418512,134278.51445503693,4812,2,1357.5581395348838,38,5,20,32.55617929083884,0.6491228070175439,41.88034188034188,1032.4786324786328,27.170490328385075,0
4942,4,0,0,43,0.0,0.0,1.0,43,750,600,150,0.8,9,6,3,361.9475201718788,0.3603959025470653,0.09388939413624353,0.22340898658884917,133306.6752958579,1050.0041091387166,134356.6794049966,4813,3,1358.5581395348838,38,5,20,32.482412580177936,0.649671052631579,41.82692307692307,1032.692307692307,27.176113360323868,0
4943,4,0,0,43,0.0,0.0,1.0,43,800,500,300,0.625,11,5,6,359.0461064905547,0.36028054632705797,0.09291260547863489,0.22194742695336847,133361.8461903718,976.6103258090416,134338.45651618086,4814,4,1359.5581395348838,38,5,20,32.50198248517446,0.6502192982456141,41.77350427350427,1032.9059829059827,27.181736392262703,0
4944,4,0,0,43,0.0,0.0,1.0,43,1050,700,350,0.6666666666666666,14,7,7,349.08970070834397,0.36028054632705797,0.055379960421054975,0.20901888899461596,132166.3106307323,632.9014697236588,132799.21210045597,4815,5,1360.5581395348838,36,7,16,33.95963384806339,0.6420717592592591,42.93355855855857,1028.2657657657676,28.56293793793799,6
4945,4,0,0,43,0.0,0.0,1.0,43,1000,800,200,0.8,12,8,4,344.27013888039977,0.36074197120708745,0.059946557733016936,0.20678248674621733,132285.18029586042,508.3674784549354,132793.54777431535,4816,6,1361.5581395348838,37,6,16,33.963973566403766,0.6413288288288287,42.81798245614036,1028.72807017544,27.803461356092974,0
4946,4,0,0,43,0.0,0.0,1.0,43,1250,800,450,0.64,17,8,9,345.6995249086651,0.3599114064230344,0.05956405006567245,0.2081111139950167,132370.51647308082,552.0849313317497,132922.60140441256,4817,7,1362.5581395348838,38,5,16,33.841405384828356,0.6403508771929823,42.73504273504275,1029.059829059831,27.080521817363973,0
4947,4,0,0,43,0.0,0.0,1.0,43,600,200,400,0.3333333333333333,10,2,8,343.9101934890755,0.35968069398301955,0.06030227469339966,0.2073442723278466,132426.97934420934,508.6033250253042,132935.58266923463,4818,8,1363.5581395348838,36,7,16,33.83068927789935,0.6446759259259258,42.680180180180194,1029.2792792792814,28.591091091091148,0
4948,4,0,0,43,0.0,0.0,1.0,43,1400,1100,300,0.7857142857142857,17,11,6,347.5271996840287,0.3599806201550388,0.07064233249913499,0.2101712112374843,132542.91453615797,612.4535853421219,133155.3681215001,4819,9,1364.5581395348838,36,7,16,33.621090332458444,0.6458333333333333,42.56756756756758,1029.7297297297314,28.60360360360365,0
4949,4,0,0,43,0.0,0.0,1.0,43,1400,1200,200,0.8571428571428571,16,12,4,346.62243067087053,0.3601421188630491,0.06813772974237331,0.21010970002295928,132629.89921932083,594.4996094067275,133224.39882872754,4820,10,1365.5581395348838,36,7,14,33.55699500747059,0.6467013888888888,42.48310810810812,1030.0675675675689,28.612987987988024,0
4950,4,0,0,43,0.0,0.0,1.0,43,1300,900,400,0.6923076923076923,17,9,8,341.27076733322156,0.36046511627906974,0.11292529459945921,0.2099101200189258,133176.3793945314,523.475812304084,133699.8552068355,4821,11,1366.5581395348838,39,4,14,33.146739496081004,0.6466346153846153,41.95312500000001,1032.1875000000011,26.46634615384618,3
4951,4,0,0,43,0.0,0.0,1.0,43,1000,800,200,0.8,12,8,4,342.24663723576157,0.35986526393503143,0.11291927097997267,0.21096695698264134,133257.03125000015,521.3541666666813,133778.38541666683,4822,12,1367.5581395348838,39,4,14,33.040758676351885,0.6474358974358974,41.87500000000001,1032.5000000000011,26.474358974359003,0
4952,4,0,0,43,0.0,0.0,1.0,43,900,700,200,0.7777777777777778,11,7,4,341.44398331602963,0.35984219269102985,0.11291525725893825,0.2107768151055491,133310.81271701396,503.6349826388987,133814.44769965287,4823,13,1368.5581395348838,39,4,14,33.00761549324189,0.6479700854700854,41.82291666666667,1032.708333333334,26.47970085470087,0
4953,4,0,0,43,0.0,0.0,1.0,43,1100,800,300,0.7272727272727273,14,8,6,341.44120707596267,0.35903469915097824,0.11627906976744207,0.21169354838709672,133472.22222222213,514.5833333333285,133986.80555555545,4824,14,1369.5581395348838,39,4,15,32.84610215053763,0.6495726495726496,41.666666666666664,1033.3333333333328,26.495726495726483,0
4954,4,1,1,43,0.022727272727272728,0.022727272727272728,0.9772727272727273,44,1150,1000,150,0.8695652173913043,13,10,3,335.98305432473774,0.3621498414376321,0.11383731211317394,0.20994300245374534,133761.1656937837,188.2969999669721,133949.46269375065,4825,0,1339.409090909091,40,4,14,32.69824311490978,0.6507812499999999,41.38719512195123,1034.451219512197,25.861280487804926,0
4955,4,1,1,43,0.022727272727272728,0.022727272727272728,0.9772727272727273,44,850,600,250,0.7058823529411765,11,6,5,337.1799940110028,0.3639336680761099,0.10685590065438832,0.21129254640086437,133866.31350593248,227.40855724108084,134093.72206317357,4826,0,1340.3863636363637,40,4,14,32.56223607974075,0.6518229166666666,41.28556910569107,1034.8577235772373,25.871443089430933,0
4956,4,1,0,44,0.022727272727272728,0.0,1.0,44,1050,800,250,0.7619047619047619,13,8,5,335.39684175349385,0.36502378435517974,0.1058078329913461,0.2112295313639127,134050.4215827221,192.01760691389188,134242.439189636,4827,0,1341.3636363636363,40,4,15,32.424558390578994,0.6536458333333333,41.10772357723578,1035.5691056910584,25.88922764227646,0
4957,4,0,0,44,0.0,0.0,1.0,44,1200,800,400,0.6666666666666666,16,8,8,336.74846140284046,0.364627378435518,0.0928909001738818,0.21284256441425678,134182.0048107113,237.1167335911237,134419.12154430244,4828,1,1342.3636363636363,40,4,15,32.258255680889306,0.6549479166666666,40.98069105691057,1036.0772357723586,25.901930894308965,0
4958,4,0,0,44,0.0,0.0,1.0,44,1500,1100,400,0.7333333333333333,19,11,8,334.4817977397571,0.3649687279774489,0.08592072078495017,0.2123241330891886,134339.9898890376,186.85626528521402,134526.84615432282,4829,2,1343.3636363636363,40,4,16,32.15942881416855,0.6565104166666667,40.828252032520325,1036.6869918699185,25.917174796747965,0
4959,4,0,0,44,0.0,0.0,1.0,44,800,500,300,0.625,11,5,6,332.4786554592272,0.36527704369274133,0.08974855880177812,0.21135699200314603,134392.67223750742,136.5389938198093,134529.21123132724,4830,3,1344.3636363636363,40,4,16,32.15884217060341,0.6570312500000001,40.77743902439024,1036.8902439024387,25.922256097560968,0
4960,4,0,0,44,0.0,0.0,1.0,44,1200,1000,200,0.8333333333333334,14,10,4,332.8053886911786,0.36470445736434104,0.08234015641423076,0.21202320830100915,134471.71512492554,150.5822840240492,134622.29740894958,4831,4,1345.3636363636363,40,4,16,32.071616369455874,0.6578125000000001,40.70121951219512,1037.1951219512187,25.929878048780466,0
4961,4,0,0,44,0.0,0.0,1.0,44,1250,800,450,0.64,17,8,9,328.1270209590075,0.3645172656800564,0.08605565099739199,0.21010415454886153,134656.23889756415,36.870104600421655,134693.10900216457,4832,5,1346.3636363636363,40,4,16,32.00924475341884,0.6596354166666667,40.52337398373983,1037.9065040650396,25.94766260162599,0
4962,4,0,0,44,0.0,0.0,1.0,44,950,600,350,0.631578947368421,13,6,7,328.8582897587522,0.3645062544045102,0.08193920410052002,0.21103117388036496,134735.35924383628,61.76796219181372,134797.1272060281,4833,6,1347.3636363636363,40,4,17,31.911543983294198,0.6604166666666667,40.447154471544714,1038.2113821138207,25.95528455284552,0
4963,4,0,1,43,0.0,0.022727272727272728,0.9772727272727273,44,950,700,250,0.7368421052631579,12,7,5,350.5204560514046,0.3642419837914024,0.03962550780049856,0.2155741280519374,133172.00363559855,535.9022895258452,133707.9059251244,4834,7,1348.3636363636363,42,2,16,32.912442107898364,0.6418650793650794,41.95736434108526,1032.1705426356568,24.575489110372782,6
4964,4,0,0,43,0.0,0.0,1.0,43,800,600,200,0.75,10,6,4,357.53562224040166,0.3583656330749354,0.04491518033820552,0.21939398270928664,133088.07442247696,916.7455002834138,134004.81992276036,4835,25,1380.5581395348838,41,2,16,32.81565474473609,0.6425304878048781,42.03869047619046,1031.8452380952353,25.166957026713057,0
4965,4,0,0,43,0.0,0.0,1.0,43,1200,1000,200,0.8333333333333334,14,10,4,352.4678192244761,0.358296419342931,0.04344541834093918,0.21702840987277472,133216.06217718538,790.8749842529272,134006.9371614383,4836,26,1381.5581395348838,41,2,16,32.81800563777307,0.6438008130081303,41.914682539682524,1032.3412698412674,25.17905536198213,0
4966,4,0,0,43,0.0,0.0,1.0,43,1100,800,300,0.7272727272727273,14,8,6,356.48603690089004,0.3573966408268734,0.040632901214161965,0.22041167554703447,133369.7286785081,908.8892038296435,134278.61788233774,4837,27,1382.5581395348838,41,2,18,32.56018696375975,0.6453252032520327,41.765873015873,1032.9365079365054,25.19357336430501,0
4967,4,0,0,43,0.0,0.0,1.0,43,1150,900,250,0.782608695652174,14,9,5,355.1574384528904,0.35721207087486156,0.04394799487273393,0.21989355315388795,133420.9705294152,877.0900258251166,134298.0605552403,4838,28,1383.5581395348838,41,2,19,32.54313104154662,0.6458333333333335,41.71626984126983,1033.1349206349184,25.198412698412646,0
4968,4,0,0,43,0.0,0.0,1.0,43,1050,700,350,0.6666666666666666,14,7,7,357.0177022695698,0.35728128460686603,0.0507141672216358,0.22151585850247277,133499.8233641063,932.3895638685069,134432.21292797482,4839,29,1384.5581395348838,38,5,20,32.416046383403966,0.6515899122807017,41.63995726495727,1033.4401709401716,27.19579397210978,0
4969,4,0,1,42,0.0,0.023255813953488372,0.9767441860465116,43,1300,1100,200,0.8461538461538461,15,11,4,359.14412410637055,0.3578580657069029,0.05281828931809196,0.22333409671293347,133582.64391116967,995.0843286580531,134577.72823982773,4840,30,1385.5581395348838,38,5,20,32.2781021772082,0.6524122807017543,41.55982905982906,1033.7606837606845,27.204228520018013,0
4970,4,0,0,42,0.0,0.0,1.0,42,1050,800,250,0.7619047619047619,13,8,5,361.51569844962654,0.35663472706155636,0.06987882455389416,0.22531297136470918,133665.49014034987,1264.4346053400482,134929.9247456899,4841,31,1415.5238095238096,38,4,20,32.133786203808924,0.653234649122807,41.47970085470085,1034.0811965811963,27.21266306792622,0
4971,4,0,0,42,0.0,0.0,1.0,42,950,500,450,0.5263157894736842,14,5,9,361.0451334832636,0.35707026713124274,0.07102579225225503,0.22564752804419724,133768.3932834203,1259.285481770853,135027.67876519114,4842,32,1416.5238095238096,39,3,16,32.04286661296278,0.6525106837606837,41.38020833333334,1034.479166666668,26.525106837606874,0
4972,4,0,0,42,0.0,0.0,1.0,42,1050,700,350,0.6666666666666666,14,7,7,363.9535187070257,0.3569734804490902,0.07267476693747454,0.22813111724632842,133876.17323133702,1344.9408637153024,135221.11409505233,4843,33,1417.5238095238096,39,3,17,31.859692165744022,0.6535790598290598,41.27604166666668,1034.895833333335,26.535790598290642,0
4973,4,0,0,42,0.0,0.0,1.0,42,1050,900,150,0.8571428571428571,12,9,3,361.1431701717395,0.3573122338366241,0.07225281176171805,0.22670118016402901,133930.079481337,1273.586697048631,135203.6661783856,4844,34,1418.5238095238096,39,3,17,31.878438328133914,0.6541132478632478,41.22395833333334,1035.104166666668,26.541132478632516,0
4974,4,1,0,43,0.023255813953488372,0.0,1.0,43,1100,900,200,0.8181818181818182,13,9,4,359.567425498287,0.3601421188630491,0.07922851642687001,0.2274286271948227,134208.32920219473,1051.3886823319708,135259.7178845267,4845,0,1386.5116279069769,40,3,18,31.64088041061854,0.6552083333333332,40.95528455284554,1036.17886178862,25.9044715447155,0
4975,4,0,0,43,0.0,0.0,1.0,43,800,400,400,0.5,12,4,8,359.4019746336071,0.36074197120708745,0.0842991902990946,0.22781483774320493,134287.31786841532,1052.6254420318962,135339.9433104472,4846,1,1387.5116279069769,40,3,18,31.566207471320727,0.6559895833333332,40.879065040650424,1036.4837398374011,25.91209349593503,0
4976,4,0,0,43,0.0,0.0,1.0,43,950,600,350,0.631578947368421,13,6,7,361.2216453701319,0.36081118493909187,0.08364161019672745,0.22962893755211572,134392.67223750753,1109.1084382642682,135501.7806757718,4847,2,1388.5116279069769,40,3,18,31.413759025123333,0.65703125,40.77743902439025,1036.8902439024396,25.92225609756099,0
4977,4,1,1,43,0.022727272727272728,0.022727272727272728,0.9772727272727273,44,1800,1500,300,0.8333333333333334,21,15,6,353.3030526774271,0.36468243481324875,0.08112452912794033,0.226746395752474,134739.9753146703,720.9948205201092,135460.9701351904,4848,0,1357.9318181818182,39,5,21,31.272469984281475,0.6621260683760684,40.44270833333334,1038.229166666668,26.62126068376072,0
4978,4,0,0,43,0.0,0.0,1.0,43,900,800,100,0.8888888888888888,10,8,2,357.36143496760064,0.36081118493909187,0.08322780643694094,0.22885737249243532,134661.6480956426,1024.5759597121896,135686.22405535477,4849,4,1390.5116279069769,38,5,22,31.24528220964144,0.6631030701754386,40.5181623931624,1037.9273504273513,27.313877642825034,0
4979,4,0,1,42,0.0,0.023255813953488372,0.9767441860465116,43,750,400,350,0.5333333333333333,11,4,7,357.60916746171773,0.360718899963086,0.08348731892730243,0.22919067751042535,134689.37194097444,1033.2308331506972,135722.60277412515,4850,5,1391.5116279069769,38,5,22,31.21118944696034,0.6633771929824561,40.49145299145299,1038.0341880341875,27.316689158794407,0
4980,4,0,0,42,0.0,0.0,1.0,42,950,500,450,0.5263157894736842,14,5,9,359.1582837982017,0.3603126209833527,0.08540564373897719,0.23088746815598665,134800.29585798807,1282.928583168958,136083.224441157,4851,6,1412.095238095238,38,4,17,31.060313786008233,0.6644736842105263,40.38461538461538,1038.4615384615377,27.327935222672043,0
4981,4,0,0,42,0.0,0.0,1.0,42,700,300,400,0.42857142857142855,11,3,8,357.8161668783782,0.35962301587301587,0.08146368698667383,0.23055312064668454,134883.51875821818,1252.7007314266848,136136.21948964486,4852,7,1413.095238095238,38,4,17,31.01216188419213,0.665296052631579,40.304487179487175,1038.7820512820506,27.33636977058028,0
4982,4,0,0,42,0.0,0.0,1.0,42,1100,800,300,0.7272727272727273,14,8,6,355.5934206091687,0.3592116724738676,0.08157424409352432,0.22947219744022318,134939.01495954767,1196.6851806194582,136135.70014016712,4853,8,1414.095238095238,38,4,17,31.014567266495277,0.6658442982456141,40.25106837606837,1038.9957264957254,27.34199280251909,0
4983,4,0,0,42,0.0,0.0,1.0,42,800,600,200,0.75,10,6,4,351.77203302373977,0.35919957413859854,0.07934955715123904,0.22738437482305693,134999.2615589265,1097.7929390574295,136097.05449798392,4854,9,1415.095238095238,40,2,17,31.053808918443167,0.6630208333333334,40.193089430894304,1039.227642276422,25.98069105691055,0
4984,4,0,0,42,0.0,0.0,1.0,42,550,400,150,0.7272727272727273,7,4,3,351.77203302373977,0.3593084591560201,0.07934955715123904,0.22738437482305693,134999.2615589265,1097.7929390574295,136097.05449798392,4855,10,1416.095238095238,40,2,17,31.053808918443167,0.6630208333333334,40.193089430894304,1039.227642276422,25.98069105691055,0
4985,4,0,0,42,0.0,0.0,1.0,42,950,700,250,0.7368421052631579,12,7,5,350.7929546147311,0.35976819589624465,0.08422939068100344,0.22741520441753488,135104.89477989296,1078.7690445502058,136183.66382444315,4856,11,1417.095238095238,40,2,17,30.97405506679701,0.6640625,40.09146341463415,1039.6341463414637,25.990853658536594,0
4986,4,1,0,43,0.023255813953488372,0.0,1.0,43,1150,800,350,0.6956521739130435,15,8,7,344.3211640760287,0.3623800295311923,0.07881223141008764,0.2253875218122125,135452.89592978376,727.8597608024513,136180.7556905862,4857,0,1385.1162790697674,41,2,18,30.796225261285304,0.6659044715447155,39.756944444444436,1040.9722222222208,25.389566395663923,0
4987,4,0,1,42,0.0,0.023255813953488372,0.9767441860465116,43,1150,1000,150,0.8695652173913043,13,10,3,346.0602587280637,0.36242617201919525,0.07599794384571767,0.2270155297256098,135530.36029226508,780.3343096497879,136310.69460191487,4858,1,1386.1162790697674,41,2,19,30.673986915650406,0.6666666666666666,39.682539682539684,1041.2698412698414,25.396825396825403,0
4988,4,0,0,42,0.0,0.0,1.0,42,1200,900,300,0.75,15,9,6,353.50550651961254,0.3596351142082849,0.07997414939418457,0.23120072782719495,135422.04231112436,1174.4875322228881,136596.52984334723,4859,2,1419.8095238095239,40,2,20,30.58789787150947,0.6671875,39.78658536585366,1040.8536585365857,26.021341463414643,0
4989,4,0,0,42,0.0,0.0,1.0,42,1450,1200,250,0.8275862068965517,17,12,5,352.46513770635056,0.3594052458381727,0.08481235481997662,0.23121713033536584,135530.36029226493,1153.945420760885,136684.30571302582,4860,3,1420.8095238095239,41,1,20,30.50725673272357,0.6666666666666667,39.68253968253968,1041.2698412698403,25.396825396825374,0
4990,4,0,0,42,0.0,0.0,1.0,42,650,300,350,0.46153846153846156,10,3,7,350.99972629259787,0.3595867208672087,0.08275153445202044,0.2304217715380487,135556.18666737527,1116.036883503401,136672.22355087867,4861,4,1421.8095238095239,41,1,20,30.519731828141378,0.6669207317073171,39.657738095238095,1041.3690476190475,25.399245063879206,0
4991,4,0,0,42,0.0,0.0,1.0,42,1000,600,400,0.6,14,6,8,352.27224551153495,0.35990127758420437,0.07957913962426333,0.23193832991107188,135661.504275787,1158.022980963958,136819.52725675097,4862,5,1422.8095238095239,38,4,20,30.38192664000273,0.6729714912280702,39.556623931623925,1041.7735042735032,27.41509221772377,0
4992,4,0,0,42,0.0,0.0,1.0,42,900,500,400,0.5555555555555556,13,5,8,351.1193906074675,0.35950203252032525,0.080982649364852,0.23171979269182924,135744.99255789307,1132.5398129885184,136877.53237088158,4863,6,1423.8095238095239,38,4,21,30.32901032055225,0.6737938596491229,39.47649572649572,1042.0940170940162,27.423526765632005,0
4993,4,0,1,41,0.0,0.023809523809523808,0.9761904761904762,42,850,600,250,0.7058823529411765,11,6,5,353.82521721896205,0.35926006581494385,0.08014115855444293,0.23386983869838684,135800.66568047318,1209.9400065746004,137010.60568704776,4864,7,1424.8095238095239,38,4,21,30.20320828208281,0.674342105263158,39.42307692307691,1042.3076923076908,27.429149797570812,0
4994,4,0,0,41,0.0,0.0,1.0,41,600,400,200,0.6666666666666666,8,4,4,354.76458798276803,0.3588668699186992,0.07017903968225436,0.2345196226261606,135805.06141312688,1435.7653316404785,137240.82674476737,4865,8,1409.8292682926829,37,4,21,30.17436355985693,0.6762387387387389,39.418859649122794,1042.324561403507,28.170934091986677,0
4995,4,0,0,41,0.0,0.0,1.0,41,900,700,200,0.7777777777777778,11,7,4,358.4906611126043,0.35846036585365854,0.07404038384646139,0.23769489486813966,135912.04616845632,1544.6398568193342,137456.68602527565,4866,9,1410.8292682926829,38,3,16,29.970969945355193,0.6754385964912281,39.31623931623931,1042.735042735042,27.440395861448476,0
4996,4,0,0,41,0.0,0.0,1.0,41,850,400,450,0.47058823529411764,13,4,9,361.2312131051904,0.3586382113821138,0.0754720752821707,0.23969937940990904,135939.8984243736,1621.1468834465638,137561.04530782017,4867,10,1411.8292682926829,38,3,16,29.871853976710042,0.6757127192982456,39.289529914529915,1042.8418803418804,27.443207377417906,0
4997,4,0,1,40,0.0,0.024390243902439025,0.975609756097561,41,950,700,250,0.7368421052631579,12,7,5,353.4959913868995,0.3586382113821138,0.08916648055018594,0.23274881595058416,135662.23651748608,1393.4485560525657,137055.68507353865,4868,11,1412.8292682926829,37,4,18,30.34932726379678,0.674831081081081,39.555921052631575,1041.776315789473,28.156116642958732,1
4998,4,0,0,40,0.0,0.0,1.0,40,950,800,150,0.8421052631578947,11,8,3,358.7339394976042,0.3561565170940171,0.09011162594776745,0.2352581139136222,135519.4867651585,1723.0878731917483,137242.57463835026,4869,59,1448.875,37,3,18,30.35488626790227,0.6734234234234234,39.69298245614035,1041.2280701754385,28.14129919393077,0
4999,4,0,0,40,0.0,0.0,1.0,40,700,600,100,0.8571428571428571,8,6,2,359.22447748749744,0.3561298076923077,0.08945567487892214,0.23595533106336428,135576.57764889183,1740.4850530932463,137317.0627019851,4870,60,1449.875,37,3,18,30.285323225942303,0.6739864864864865,39.638157894736835,1041.4473684210516,28.147226173541934,0
5000,4,1,0,41,0.024390243902439025,0.0,1.0,41,600,300,300,0.5,9,3,6,351.5879715992734,0.359400406504065,0.08820088200882026,0.232391073910739,135800.66568047318,1349.176117685712,137149.8417981589,4871,0,1415.4878048780488,38,3,19,30.261505740057387,0.674342105263158,39.42307692307691,1042.3076923076908,27.429149797570812,0
