period,mktsize,entries,exits,surviv,entryrate,exitrate,survivrate,firms,totresinv,totinninv,totimiinv,costshareinn,firmsres,firmsinn,firmsimi,hindex,div,gini,pcm,cs,totprofits,ts,maxage,minage,avgage,actfirms,inactfirms,profitablefirms,wmc,avgproxopt,price,totoutput,avgoutput,magtechshock
1,4,40,26,14,1.0,0.65,0.35,40,0,0,0,0,0,0,0,412.7329911217893,0.4985977564102564,-0.04459373186302951,0.17421336200461643,117650.73508897431,2511.6679601899427,120162.40304916425,0,0,0.0,36,4,14,47.45018378796672,0.4927662037037037,57.4605855855856,970.1576576576593,26.948823823823872,0
2,4,34,29,19,0.7083333333333334,0.6041666666666666,0.39583333333333337,48,400,200,200,0.5,6,2,4,345.4536645572442,0.49857786643026003,-0.18620807846445875,0.16072579231264897,121945.9689670138,625.336371527773,122571.30533854157,1,0,0.2916666666666667,39,9,14,44.542730085073494,0.5325854700854701,53.072916666666664,987.7083333333326,25.32585470085468,0
3,4,16,13,22,0.45714285714285713,0.37142857142857144,0.6285714285714286,35,500,300,200,0.6,7,3,4,330.8611178907156,0.4942577030812325,-0.040021302090267996,0.15919909394472562,123384.88082990407,1164.651920438964,124549.53275034303,2,0,0.8857142857142857,35,0,13,43.40245417831624,0.5547619047619048,51.620370370370374,993.5185185185193,28.386243386243407,0
4,4,9,9,22,0.2903225806451613,0.2903225806451613,0.7096774193548387,31,500,300,200,0.6,7,3,4,372.5380150792663,0.492921146953405,-0.01082598914018007,0.17894962084538066,123313.02218967021,2987.7577039930597,126300.77989366328,3,0,1.6451612903225807,31,0,16,42.44231777661246,0.5631720430107527,51.692708333333336,993.2291666666673,32.03965053763443,0
5,4,7,3,26,0.2413793103448276,0.10344827586206896,0.896551724137931,29,650,400,250,0.6153846153846154,9,4,5,377.45371538231745,0.4892241379310345,-0.0005776812836078005,0.1830535520164888,123718.57880015431,3539.6074459876518,127258.18624614197,4,0,2.206896551724138,29,0,22,41.89687165526547,0.5729166666666667,51.28472222222222,994.8611111111111,34.30555555555556,0
6,4,3,2,27,0.10344827586206896,0.06896551724137931,0.9310344827586207,29,650,500,150,0.7692307692307693,8,5,3,372.99638706502134,0.4884031198686371,0.016145773267212116,0.1828293766105597,124168.05555555563,3462.847222222226,127630.90277777785,5,0,2.9655172413793105,29,0,25,41.53950668896321,0.5775862068965517,50.833333333333336,996.6666666666673,34.36781609195405,0
7,4,7,11,23,0.20588235294117646,0.3235294117647059,0.6764705882352942,34,500,300,200,0.6,7,3,4,337.0301195705805,0.4879679144385027,-0.016402042386514548,0.16972594644243058,125297.79620181448,1645.826247165584,126943.62244898007,6,0,3.088235294117647,34,0,13,41.26659730479589,0.576593137254902,49.70238095238098,1001.1904761904796,29.446778711484694,8
8,4,5,4,24,0.17857142857142858,0.14285714285714285,0.8571428571428572,28,700,500,200,0.7142857142857143,9,5,4,389.191300849157,0.4859457671957672,-0.036680926329645036,0.19227046768835293,124497.63220042262,4090.679085744465,128588.3112861671,7,0,3.7142857142857144,28,0,21,40.792662443612635,0.5840773809523809,50.50287356321838,997.9885057471251,35.6424466338259,0
9,4,5,2,27,0.1724137931034483,0.06896551724137931,0.9310344827586207,29,1050,700,350,0.6666666666666666,14,7,7,375.92925369722224,0.4847085385878489,0.005163091544481135,0.19001946089124477,125451.7963927469,3632.2000385802407,129083.99643132713,8,0,4.413793103448276,29,0,22,40.133410739867834,0.5908764367816092,49.54861111111111,1001.8055555555554,34.54501915708812,0
10,4,3,1,29,0.1,0.03333333333333333,0.9666666666666667,30,500,300,200,0.6,7,3,4,363.6439555634405,0.48453065134099615,0.0016599732262378986,0.18631140933188609,126010.09690426632,3164.5620158399684,129174.65892010629,9,0,4.966666666666667,30,0,25,39.86417893797411,0.59375,48.99193548387096,1004.0322580645156,33.46774193548386,0
11,4,3,6,26,0.09375,0.1875,0.8125,32,600,400,200,0.6666666666666666,8,4,4,343.131790263227,0.48313592069892475,-0.0161719044034625,0.17841510112121195,126615.03170913662,2289.128500918247,128904.16021005486,10,0,5.34375,32,0,12,39.756617739304986,0.5947265625,48.3901515151515,1006.4393939393923,31.45123106060601,0
12,4,3,1,28,0.10344827586206896,0.034482758620689655,0.9655172413793104,29,850,600,250,0.7058823529411765,11,6,5,373.57839814123815,0.4832204433497537,0.006006120522818126,0.19220953998248352,126183.34297839516,3627.8742283950714,129811.21720679023,11,0,6.689655172413793,29,0,25,39.435881485577355,0.5984195402298851,48.81944444444445,1004.7222222222231,34.64559386973183,0
13,4,2,3,27,0.06666666666666667,0.1,0.9,30,900,700,200,0.7777777777777778,11,7,4,378.6672360876065,0.4813697318007663,0.0058562309186787065,0.1902842470883749,125208.42013888907,3687.1141975308888,128895.53433641995,12,0,7.2,29,1,22,40.31709686372467,0.5883620689655172,49.79166666666668,1000.8333333333348,34.51149425287362,8
14,4,2,3,26,0.06896551724137931,0.10344827586206896,0.896551724137931,29,650,500,150,0.7692307692307693,8,5,3,374.350041709709,0.4813731527093596,0.006021937056419624,0.189539336907758,125521.37586805563,3597.786458333343,129119.16232638898,13,0,7.689655172413793,29,0,22,40.10091822591821,0.5915948275862069,49.47916666666667,1002.083333333334,34.55459770114945,0
15,4,3,1,28,0.10344827586206896,0.034482758620689655,0.9655172413793104,29,1050,800,250,0.7619047619047619,13,8,5,364.6919423296659,0.4826559934318555,-0.03148674694196907,0.1866850820934015,125974.1126543212,3388.348765432127,129362.46141975332,14,0,7.689655172413793,29,0,26,39.875023058476295,0.5962643678160919,49.02777777777779,1003.8888888888907,34.61685823754796,0
16,4,1,0,29,0.034482758620689655,0.0,1.0,29,550,400,150,0.7272727272727273,7,4,3,359.1397305102805,0.4814244663382594,-0.03717560708242973,0.1849377900528028,126218.23157793209,3265.9963348765405,129484.22791280864,15,0,8.310344827586206,29,0,28,39.76258350610458,0.5987787356321839,48.78472222222222,1004.8611111111111,34.650383141762454,0
17,4,4,5,28,0.12121212121212122,0.15151515151515152,0.8484848484848485,33,850,600,250,0.7058823529411765,11,6,5,322.57532921771474,0.4795217803030303,0.0002499522150178901,0.17179011718803894,127586.77551903129,1631.2692233756443,129218.04474240693,16,0,8.181818181818182,33,0,16,39.27907164806728,0.6022727272727273,47.426470588235304,1010.29411764706,30.614973262032123,0
18,4,2,1,29,0.06666666666666667,0.03333333333333333,0.9666666666666667,30,800,300,500,0.375,13,3,10,352.9749375008515,0.47804118773946364,0.03369714716713279,0.1874134774165298,127464.9909852294,2998.3894453115827,130463.38043054097,17,0,9.033333333333333,30,0,18,38.636086339234225,0.6086805555555556,47.54704301075268,1009.8118279569883,33.660394265232945,0
19,4,0,0,29,0.0,0.0,1.0,29,950,600,350,0.631578947368421,13,6,7,362.15654924549875,0.47644704433497537,0.024755879521386248,0.19234771874098028,127477.43296682098,3433.357445987651,130910.79041280864,18,1,9.96551724137931,29,0,21,38.39152684179158,0.6117097701149425,47.53472222222222,1009.8611111111111,34.8227969348659,0
20,4,1,0,30,0.03333333333333333,0.0,1.0,30,900,500,400,0.5555555555555556,13,5,8,351.01157823865077,0.4756944444444444,0.021559246954595768,0.1882652976654203,127872.49835602377,2976.9454922534337,130849.44384827721,19,0,10.6,30,0,22,38.26827242524919,0.6128472222222222,47.14381720430107,1011.4247311827953,33.714157706093175,0
21,4,5,8,27,0.14285714285714285,0.22857142857142856,0.7714285714285715,35,1000,700,300,0.7,13,7,6,305.18353195662047,0.47535014005602244,0.003981717929116391,0.16911211111514146,129171.97312510693,884.2317976251434,130056.20492273208,20,0,9.942857142857143,35,0,18,38.10640346882233,0.6139880952380952,45.862268518518505,1016.550925925924,29.044312169312114,0
22,4,1,0,28,0.03571428571428571,0.0,1.0,28,750,600,150,0.8,9,6,3,404.8373984037303,0.47365520282186946,0.0939142123915433,0.2122219366520004,126947.17969678961,4678.593192627838,131625.77288941745,21,0,11.928571428571429,28,0,18,37.860885372112904,0.609375,48.06034482758621,1007.7586206896558,35.99137931034485,8
23,4,3,4,27,0.0967741935483871,0.12903225806451613,0.8709677419354839,31,850,500,350,0.5882352941176471,12,5,7,371.8868980240769,0.47181899641577063,0.0855455145474695,0.19999536917267174,127979.78931003164,3318.801371256535,131298.5906812882,22,0,11.67741935483871,31,0,20,37.630426157079725,0.6112231182795699,47.03776041666668,1011.8489583333348,32.640288978494674,0
24,4,1,0,28,0.03571428571428571,0.0,1.0,28,950,700,250,0.7368421052631579,12,7,5,404.6539514471891,0.47158840388007056,0.05674132047326119,0.20785714728635565,126115.98553722429,4606.666377658881,130722.65191488317,23,0,12.607142857142858,28,0,22,38.72508701664045,0.6008184523809523,48.88649425287357,1004.4540229885065,35.87335796387523,8
25,4,0,1,27,0.0,0.03571428571428571,0.9642857142857143,28,850,400,450,0.47058823529411764,13,4,9,438.72053567601154,0.47156084656084657,0.10908564814814814,0.2105858571244857,123281.8073721761,5217.252113885604,128499.05948606171,24,1,13.607142857142858,28,0,20,40.83176601080248,0.5714285714285714,51.72413793103449,993.103448275863,35.467980295566534,8
26,4,4,3,28,0.12903225806451613,0.0967741935483871,0.9032258064516129,31,700,300,400,0.42857142857142855,11,3,8,403.0476931539017,0.471505376344086,0.11790104893692477,0.19936020445265618,124549.01861496927,3843.5650636826595,128392.58367865194,25,0,13.03225806451613,29,2,17,40.39338968507955,0.5815373563218391,50.4513888888889,998.1944444444457,34.42049808429123,0
27,4,4,2,30,0.125,0.0625,0.9375,32,850,600,250,0.7058823529411765,11,6,5,398.0273423717714,0.4684559811827957,0.18080037259959902,0.20214227038356777,125647.38778240191,3603.8491824290645,129251.23696483098,26,0,13.5,28,4,20,39.37703019012135,0.5959821428571428,49.35344827586207,1002.5862068965519,35.80665024630542,0
28,4,1,0,31,0.03225806451612903,0.0,1.0,31,1100,600,500,0.5454545454545454,16,6,10,384.0583380587263,0.4685483870967742,0.11959892725982701,0.19676525342498447,126008.97231867276,3478.9592978394953,129487.93161651226,27,0,13.258064516129032,29,2,21,39.35292456310233,0.5966235632183908,48.99305555555555,1004.0277777777771,34.62164750957852,0
29,4,0,1,30,0.0,0.03225806451612903,0.967741935483871,31,950,600,350,0.631578947368421,13,6,7,382.5229521890489,0.4675179211469534,0.12399402545867977,0.19697890100268797,126218.23157793198,3456.274112654305,129674.50569058629,28,1,14.258064516129032,29,2,21,39.175161253167474,0.5987787356321839,48.784722222222214,1004.8611111111102,34.65038314176242,0
30,4,0,0,30,0.0,0.0,1.0,30,500,100,400,0.2,9,1,8,394.59529426241977,0.46673850574712644,0.12772692601067925,0.2028684042266793,126152.0676443387,3955.802450786099,130107.8700951248,29,2,15.533333333333333,28,2,21,38.9403365751335,0.6011904761904762,48.85057471264368,1004.5977011494249,35.87848932676518,0
31,4,3,2,31,0.09090909090909091,0.06060606060606061,0.9393939393939394,33,1050,900,150,0.8571428571428571,12,9,3,360.72156446121244,0.46732954545454547,0.12032016524657907,0.19007817947731637,127157.6690673828,2573.702663845486,129731.37173122828,30,0,15.030303030303031,31,2,22,38.75602461485499,0.6028225806451613,47.8515625,1008.5937499999999,32.53528225806451,0
32,4,3,2,32,0.08823529411764706,0.058823529411764705,0.9411764705882353,34,1050,800,250,0.7619047619047619,13,8,5,352.3657226220036,0.46915849673202614,0.14359991187486276,0.18891897176721867,127857.05061983464,2210.4884067952185,130067.53902662986,31,0,15.0,32,2,21,38.24984394506867,0.607421875,47.15909090909091,1011.3636363636358,31.60511363636362,0
33,4,2,0,34,0.058823529411764705,0.0,1.0,34,1150,900,250,0.782608695652174,14,9,5,356.9611867427808,0.46862002376708256,0.17012731875023612,0.19419586574371422,128441.33377075207,2370.0370165051754,130811.37078725724,32,0,15.352941176470589,31,3,20,37.5359933633055,0.6159274193548387,46.58203125000001,1013.6718750000009,32.699092741935516,0
34,4,0,1,33,0.0,0.029411764705882353,0.9705882352941176,34,900,800,100,0.8888888888888888,10,8,2,359.09439210600465,0.46759878193701726,0.17271766216114193,0.196167273106997,128606.37240939673,2436.365424262156,131042.73783365889,33,1,16.352941176470587,31,3,20,37.313329054343164,0.6176075268817205,46.419270833333336,1014.322916666667,32.72009408602152,0
35,4,0,1,32,0.0,0.030303030303030304,0.9696969696969697,33,1300,900,400,0.6923076923076923,17,9,8,359.60344347827,0.4655539772727273,0.14481396831319837,0.1974273553068023,128804.55864800351,2663.7125651041706,131468.27121310768,34,2,16.87878787878788,31,2,20,37.0980844877715,0.6196236559139785,46.223958333333336,1015.104166666667,32.74529569892474,0
36,4,3,4,31,0.08571428571428572,0.11428571428571428,0.8857142857142857,35,1200,900,300,0.75,15,9,6,336.10232382830316,0.46729691876750695,0.1267128586902324,0.18831248878552762,129606.62853529911,1712.2178068531516,131318.84634215228,35,0,15.971428571428572,33,2,18,36.87906186063305,0.622790404040404,45.43504901960785,1018.2598039215701,30.856357694593033,0
37,4,1,0,32,0.03125,0.0,1.0,32,900,700,200,0.7777777777777778,11,7,4,366.70724359271327,0.46576780913978494,0.1506575469204332,0.2037082969913706,129269.7222944849,3080.8287085212146,132350.5510030061,36,0,18.125,30,2,22,36.44318882720945,0.6270833333333333,45.766129032258064,1016.9354838709677,33.89784946236559,0
38,4,1,2,31,0.030303030303030304,0.06060606060606061,0.9393939393939394,33,1200,900,300,0.75,15,9,6,357.80106150530474,0.46547506313131315,0.15449469764774748,0.20059943383749035,129631.97708129892,2676.491800944025,132308.46888224295,37,0,18.545454545454547,31,2,20,36.30090461577805,0.6280241935483871,45.41015625000001,1018.3593750000007,32.85030241935486,0
39,4,1,0,32,0.03125,0.0,1.0,32,1250,800,450,0.64,17,8,9,364.09594796655244,0.46488575268817206,0.16447346736980872,0.20563423420151167,129919.79067305468,3060.6538689443832,132980.44454199905,38,0,18.96875,30,2,21,35.84789057350033,0.6336805555555556,45.12768817204301,1019.4892473118279,33.98297491039426,0
40,4,0,1,31,0.0,0.03125,0.96875,32,1100,800,300,0.7272727272727273,14,8,6,360.90688565311075,0.46347866263440857,0.15610185672899646,0.20545179082831494,130228.28686842405,3000.0570875245603,133228.3439559486,39,1,19.96875,30,2,22,35.61583706434904,0.6368055555555556,44.8252688172043,1020.6989247311824,34.023297491039415,0
41,4,0,0,31,0.0,0.0,1.0,31,1100,800,300,0.7272727272727273,14,8,6,373.30248692499737,0.46272401433691757,0.1474353346093744,0.21230856609325666,130191.70524691338,3520.1774691357805,133711.88271604915,40,2,20.419354838709676,29,2,22,35.336712937760865,0.639367816091954,44.8611111111111,1020.5555555555538,35.19157088122599,0
42,4,0,0,31,0.0,0.0,1.0,31,1050,600,450,0.5714285714285714,15,6,9,373.30248692499737,0.46272401433691757,0.1474353346093744,0.21230856609325666,130191.70524691338,3520.1774691357805,133711.88271604915,41,3,21.419354838709676,29,2,22,35.336712937760865,0.639367816091954,44.8611111111111,1020.5555555555538,35.19157088122599,0
43,4,0,2,29,0.0,0.06451612903225806,0.935483870967742,31,950,600,350,0.631578947368421,13,6,7,373.6625010894258,0.46254480286738353,0.15087415887173572,0.21270687223130832,130227.14361496913,3532.2000385802417,133759.34365354938,42,4,22.419354838709676,29,2,22,35.29150791490905,0.6397270114942528,44.826388888888886,1020.6944444444443,35.1963601532567,0
44,4,0,1,28,0.0,0.034482758620689655,0.9655172413793104,29,1100,800,300,0.7272727272727273,14,8,6,381.42529142318017,0.4602319376026272,0.11246699285492445,0.21711901204088707,130225.92152199754,4134.292013476014,134360.21353547357,43,5,22.24137931034483,28,1,22,35.09466497747749,0.6428571428571428,44.82758620689655,1020.6896551724132,36.453201970443324,0
45,4,1,0,29,0.034482758620689655,0.0,1.0,29,1000,700,300,0.7,13,7,6,380.2203341291654,0.45874384236453203,0.10636347320783246,0.21745666575416214,130409.29954832206,4116.853489562682,134526.15303788474,44,0,22.75862068965517,28,1,23,34.9389857926572,0.6447172619047619,44.64798850574712,1021.4080459770112,36.478858784893255,0
46,4,0,0,29,0.0,0.0,1.0,29,700,300,400,0.42857142857142855,11,3,8,379.42296547858405,0.458435960591133,0.10253675187153322,0.21761742987771684,130519.38829435856,4104.410671819262,134623.79896617783,45,1,23.75862068965517,28,1,21,34.8474995313086,0.6458333333333333,44.54022988505747,1021.8390804597701,36.49425287356322,0
47,4,0,1,28,0.0,0.034482758620689655,0.9655172413793104,29,900,600,300,0.6666666666666666,12,6,6,378.52013576772316,0.45751231527093594,0.10377299052511679,0.21771792772735254,130629.52348807643,4089.1809931959388,134718.70448127238,46,2,24.75862068965517,28,1,22,34.75872569688451,0.6469494047619048,44.43247126436782,1022.2701149425293,36.50964696223319,0
48,4,0,0,28,0.0,0.0,1.0,28,950,800,150,0.8421052631578947,11,8,3,394.64400573173685,0.4560460758377425,0.12046745303626016,0.2264010348671545,130528.56445312517,4702.463107638917,135231.02756076408,47,9,26.571428571428573,27,1,22,34.44932891607206,0.6493055555555556,44.531250000000014,1021.8750000000014,37.84722222222227,0
49,4,2,0,30,0.06666666666666667,0.0,1.0,30,900,700,200,0.7777777777777778,11,7,4,369.4017297114166,0.45445402298850573,0.09895155459146743,0.21556227518602947,131185.802469136,3692.0524691358255,134877.8549382718,48,0,25.733333333333334,29,1,24,34.42810014461316,0.6494252873563218,43.8888888888889,1024.444444444446,35.32567049808434,0
50,4,1,1,30,0.03225806451612903,0.03225806451612903,0.967741935483871,31,650,400,250,0.6153846153846154,9,4,5,357.23361370121404,0.45609318996415765,0.06047252411721482,0.19977484920715954,129532.54699707031,3054.6759711371524,132587.22296820747,49,0,25.870967741935484,31,0,19,36.41649612006481,0.627016129032258,45.5078125,1017.96875,32.837701612903224,8
51,4,0,0,30,0.0,0.0,1.0,30,1050,700,350,0.6666666666666666,14,7,7,369.42881812747424,0.4556513409961686,0.0804946747645452,0.2066509504060188,129543.23657359259,3571.400956758039,133114.63753035062,50,1,27.7,30,0,19,36.09524909779069,0.6298611111111111,45.497311827957006,1018.0107526881741,33.93369175627247,0
52,4,0,0,30,0.0,0.0,1.0,30,700,400,300,0.5714285714285714,10,4,6,369.7598274678954,0.4555316091954023,0.07871067106710683,0.20701631138723647,129577.44618236228,3582.506828824165,133159.95301118644,51,2,28.7,30,0,19,36.05198019801981,0.6302083333333333,45.46370967741937,1018.1451612903238,33.938172043010795,0
53,4,0,0,30,0.0,0.0,1.0,30,1250,1000,250,0.8,15,10,5,373.0005839765284,0.45392720306513407,0.051529619805481985,0.20262423654056358,128382.79714417845,3577.371661463741,131960.1688056422,52,3,29.7,30,0,20,37.18943412908929,0.6180555555555556,46.63978494623655,1013.4408602150531,33.78136200716844,8
54,4,0,0,30,0.0,0.0,1.0,30,800,500,300,0.625,11,5,6,371.0422904606123,0.453639846743295,0.05096791302041881,0.20190483078311222,128450.91376170646,3532.14425078042,131983.05801248687,53,4,30.7,30,0,21,37.169351630867126,0.61875,46.57258064516128,1013.709677419354,33.79032258064513,0
55,4,0,0,30,0.0,0.0,1.0,30,900,600,300,0.6666666666666666,12,6,6,391.6371884333888,0.4527538314176245,0.08161906039068412,0.1985342293778232,125571.88918155269,3835.7243250664687,129407.61350661915,54,5,31.7,30,0,19,39.61546198203031,0.5892361111111111,49.42876344086021,1002.2849462365584,33.40949820788528,8
56,4,4,2,32,0.11764705882352941,0.058823529411764705,0.9411764705882353,34,700,500,200,0.7142857142857143,9,5,4,358.55292639091556,0.4558637849079026,0.11324380868972916,0.18765821991628448,126882.0312500001,2298.7847222222363,129180.81597222234,55,0,28.852941176470587,34,0,20,39.09394816652882,0.5928308823529411,48.12500000000001,1007.5000000000008,29.632352941176492,0
57,4,0,0,32,0.0,0.0,1.0,32,1100,800,300,0.7272727272727273,14,8,6,371.9260557408559,0.4553931451612903,0.0948543233082706,0.19474868273044826,126901.11340679528,3039.5661157024856,129940.67952249777,56,1,29.71875,32,0,21,38.737468671679196,0.59765625,48.10606060606061,1007.5757575757581,31.48674242424244,0
58,4,0,0,32,0.0,0.0,1.0,32,600,300,300,0.5,9,3,6,372.9867908426032,0.4546160954301075,0.09572294250281788,0.19576288963159144,126996.54571281013,3073.6068067034207,130070.15251951355,57,2,30.71875,32,0,21,38.612520355755976,0.5986328125,48.01136363636365,1007.9545454545472,31.4985795454546,0
59,4,1,1,32,0.030303030303030304,0.030303030303030304,0.9696969696969697,33,650,300,350,0.46153846153846156,10,3,7,386.6865968069369,0.45639993686868685,0.12431385581517951,0.19526319366450878,125410.69031540159,3098.9624783185527,128509.65279372015,58,0,30.757575757575758,32,1,19,39.90661372326569,0.5823567708333333,49.58964646464647,1001.641414141415,31.30129419191922,8
60,4,4,2,34,0.1111111111111111,0.05555555555555555,0.9444444444444444,36,1100,800,300,0.7272727272727273,14,8,6,349.08526160437106,0.4624669312169312,0.10125889436234226,0.18086018310036237,126468.25034493975,1629.6404512620913,128097.89079620184,59,0,27.5,36,0,17,39.757799671592764,0.5844907407407407,48.536036036036045,1005.8558558558576,27.94044044044049,0
61,4,0,0,34,0.0,0.0,1.0,34,900,600,300,0.6666666666666666,12,6,6,367.74078524741077,0.45773915626856804,0.10391692221912407,0.189251965090741,126193.31065759655,2481.285430839019,128674.59608843557,60,1,30.11764705882353,34,0,21,39.57222551342812,0.5857843137254901,48.80952380952382,1004.7619047619063,29.55182072829136,0
62,4,1,1,34,0.02857142857142857,0.02857142857142857,0.9714285714285714,35,1200,700,500,0.5833333333333334,17,7,10,361.1879285079679,0.457703081232493,0.1142200252902632,0.18825487058662774,126713.0048252102,2153.4415455675767,128866.44637077778,61,0,30.228571428571428,35,0,18,39.201464727746504,0.5889880952380953,48.29282407407408,1006.828703703705,28.766534391534428,0
63,4,1,0,35,0.02857142857142857,0.0,1.0,35,700,500,200,0.7142857142857143,9,5,4,358.90999044225947,0.4581582633053221,0.10797223908513742,0.18814143809637274,126946.1741924939,2112.4500332218695,129058.62422571577,62,0,29.771428571428572,35,0,20,39.019012480379786,0.5913690476190476,48.06134259259259,1007.7546296296288,28.792989417989393,0
64,4,1,0,36,0.027777777777777776,0.0,1.0,36,1050,800,250,0.7619047619047619,13,8,5,369.94747454215917,0.45985449735449735,0.12762710998748705,0.19323426911559854,126800.4182205934,2256.2495981224447,129056.66781871585,63,0,29.916666666666668,35,1,16,38.890963763119586,0.5898809523809524,48.206018518518526,1007.175925925927,28.776455026455057,8
65,4,4,4,36,0.1,0.1,0.9,40,1450,1000,450,0.6896551724137931,19,10,9,340.34037096945514,0.4661324786324786,0.12074745064005143,0.18176463149457942,127700.83703639597,693.0198459687622,128393.85688236474,64,0,27.825,37,3,15,38.713658060316746,0.5951576576576576,47.313596491228076,1010.745614035089,27.31744902797538,0
66,4,3,2,37,0.07692307692307693,0.05128205128205128,0.9487179487179487,39,1100,700,400,0.6363636363636364,15,7,8,345.14745094359,0.46367521367521364,0.13537570570647772,0.18479898402042336,127802.69870799867,1022.1551365554901,128824.85384455416,65,0,29.333333333333332,36,3,17,38.48795337268442,0.5980902777777778,47.212837837837846,1011.1486486486497,28.08746246246249,0
67,4,1,1,37,0.02631578947368421,0.02631578947368421,0.9736842105263158,38,1100,800,300,0.7272727272727273,14,8,6,349.9728293684338,0.4615931721194879,0.13642278773857708,0.1873383968972206,127793.2098765433,1344.8302469135924,129138.0401234569,66,0,31.026315789473685,35,3,18,38.375686813186825,0.6,47.22222222222223,1011.1111111111119,28.88888888888891,0
68,4,3,3,37,0.075,0.075,0.925,40,900,300,600,0.3333333333333333,15,3,12,339.9745861769061,0.4624732905982906,0.15166270141667537,0.1852530935991664,128505.59937913601,737.7275940674167,129243.32697320342,67,0,29.325,37,3,13,37.90091831585018,0.603322072072072,46.5186403508772,1013.9254385964922,27.403390232337628,0
69,4,2,1,38,0.05128205128205128,0.02564102564102564,0.9743589743589743,39,1350,1000,350,0.7407407407407407,17,10,7,326.0608425947873,0.45979532163742687,0.08900039174175078,0.17546446159226195,128005.79415060407,549.4140023853524,128555.20815298942,68,0,30.94871794871795,37,2,18,38.76311536099977,0.5982545045045045,47.012061403508774,1011.9517543859652,27.350047415836897,7
70,4,1,2,37,0.02564102564102564,0.05128205128205128,0.9487179487179487,39,1500,1000,500,0.6666666666666666,20,10,10,325.1138075206298,0.45937359424201535,0.10030023351495587,0.17581169398875696,128201.54772593555,536.0938055566687,128737.64153149222,69,0,31.871794871794872,36,3,21,38.587419845064694,0.6021412037037037,46.8186936936937,1012.7252252252266,28.131256256256293,0
71,4,0,2,35,0.0,0.05405405405405406,0.9459459459459459,37,1250,900,350,0.72,16,9,7,338.6896739222705,0.45777027027027023,0.10444353121842509,0.18275870313375078,128115.23604948989,1278.2615044152903,129393.49755390518,70,1,34.37837837837838,35,2,22,38.33183281887123,0.6032738095238095,46.90393518518518,1012.3842592592594,28.925264550264554,0
72,4,0,1,34,0.0,0.02857142857142857,0.9714285714285714,35,1150,800,350,0.6956521739130435,15,8,7,346.5490535581067,0.45742296918767505,0.09041123504905269,0.18699575834125243,128114.39909297049,1879.5847505668944,129993.98384353738,71,2,34.857142857142854,34,1,23,38.133770382565075,0.6053921568627452,46.904761904761905,1012.3809523809521,29.77591036414565,0
73,4,2,0,36,0.05555555555555555,0.0,1.0,36,1250,1100,150,0.88,14,11,3,335.75036388426804,0.45985449735449735,0.09736955502325673,0.18385530544493284,128701.77636584778,1442.3336494770078,130144.11001532478,72,0,33.916666666666664,35,1,18,37.80809189764647,0.6092261904761904,46.325231481481474,1014.699074074073,28.991402116402085,0
74,4,0,1,35,0.0,0.027777777777777776,0.9722222222222222,36,700,400,300,0.5714285714285714,10,4,6,337.66854397727946,0.4595238095238095,0.09944070738164945,0.1854534000766885,128819.24518014818,1499.6413912465555,130318.88657139473,73,1,34.916666666666664,35,1,18,37.63978356705811,0.6104166666666666,46.20949074074073,1015.1620370370359,29.004629629629598,0
75,4,0,2,33,0.0,0.05714285714285714,0.9428571428571428,35,750,300,450,0.4,12,3,9,350.1978033292387,0.4573879551820728,0.10627177700348511,0.19242827749946806,128838.54875283426,2023.7953514739052,130862.34410430817,74,2,36.8,34,1,18,37.302122420262684,0.6127450980392157,46.19047619047618,1015.2380952380936,29.859943977590987,0
76,4,0,0,33,0.0,0.0,1.0,33,1350,1000,350,0.7407407407407407,17,10,7,370.8557153382664,0.45411142676767674,0.12263787991943365,0.20268400115834243,128624.38303489443,2940.217516069796,131564.60055096424,75,3,39.666666666666664,32,1,20,36.99667040079663,0.615234375,46.401515151515156,1014.3939393939397,31.699810606060616,0
77,4,0,1,32,0.0,0.030303030303030304,0.9696969696969697,33,800,400,400,0.5,12,4,8,372.62971442360714,0.453125,0.11768493922562984,0.20437876124876259,128765.6865748751,2996.3842031910863,131762.07077806618,76,4,40.666666666666664,33,0,21,36.807232552523544,0.6142676767676767,46.26225490196079,1014.9509803921572,30.756090314913855,0
78,4,1,0,33,0.030303030303030304,0.0,1.0,33,900,500,400,0.5555555555555556,13,5,8,372.9742314778312,0.4541903409090909,0.10965696545520376,0.20537125955194604,128921.2100664409,3016.857849144574,131938.06791558547,77,0,41.21212121212121,33,0,23,36.63959112666426,0.6158459595959596,46.10906862745099,1015.5637254901969,30.774658348187785,0
79,4,0,1,32,0.0,0.030303030303030304,0.9696969696969697,33,800,600,200,0.75,10,6,4,375.2785412977394,0.4538352272727273,0.10912015206345704,0.207127770130377,129014.56921616697,3083.279868319888,132097.84908448686,78,1,42.21212121212121,33,0,23,36.48572577402493,0.6167929292929293,46.017156862745104,1015.9313725490206,30.78579916815214,0
80,4,2,1,33,0.058823529411764705,0.029411764705882353,0.9705882352941176,34,900,600,300,0.6666666666666666,12,6,6,362.370619854811,0.4555852644087938,0.11570573638884873,0.2022650412763003,129458.25043362923,2582.643619710443,132040.89405333967,79,0,41.23529411764706,32,2,21,36.361404052936315,0.6236979166666667,45.58080808080808,1017.6767676767678,31.802398989898993,0
81,4,0,0,33,0.0,0.0,1.0,33,1200,700,500,0.5833333333333334,17,7,10,367.62085723423536,0.45265151515151514,0.11042117258540873,0.2055836811056691,129532.54699707043,2923.7731933593886,132456.3201904298,80,1,43.484848484848484,31,2,22,36.15214888718342,0.627016129032258,45.50781250000001,1017.9687500000009,32.83770161290325,0
82,4,0,0,33,0.0,0.0,1.0,33,850,400,450,0.47058823529411764,13,4,9,367.0939404407593,0.45209911616161613,0.1083603896103893,0.2055726066468254,129586.77685950424,2914.104109274575,132500.88096877883,81,2,44.484848484848484,32,1,22,36.11033606150794,0.625,45.45454545454546,1018.1818181818192,31.81818181818185,0
83,4,0,0,33,0.0,0.0,1.0,33,1550,1100,450,0.7096774193548387,20,11,9,367.3847932487843,0.4505602904040404,0.10184340619123233,0.2072604777007294,129876.19447314063,2942.9077708907425,132819.10224403138,82,3,45.484848484848484,32,1,22,35.80840455840456,0.6279296875,45.170454545454554,1019.3181818181829,31.853693181818215,0
84,4,0,1,32,0.0,0.030303030303030304,0.9696969696969697,33,1400,1100,300,0.7857142857142857,17,11,6,372.55813751059634,0.44985006313131315,0.10175035824949186,0.21104660833173894,130037.12153096622,3089.277560963167,133126.3990919294,83,4,46.484848484848484,32,1,22,35.51286415779483,0.6295572916666667,45.01262626262626,1019.9494949494949,31.873421717171716,0
85,4,0,1,31,0.0,0.03125,0.96875,32,1200,600,600,0.5,18,6,12,382.336284028446,0.4468035954301075,0.10847889257887333,0.21581187942744803,129897.3104688857,3532.890997992626,133430.20146687832,84,5,48.75,31,1,22,35.4058894281943,0.6307123655913979,45.149739583333336,1019.4010416666672,32.88390456989249,0
86,4,2,1,32,0.06060606060606061,0.030303030303030304,0.9696969696969697,33,650,300,350,0.46153846153846156,10,3,7,362.85729944660017,0.4476404671717172,0.08992454214849666,0.20858668054335566,130606.84479827466,2878.3293985486316,133485.1741968233,85,0,45.84848484848485,33,0,22,35.18200755305121,0.6328914141414141,44.4546568627451,1022.1813725490192,30.975193107546037,0
87,4,1,1,32,0.030303030303030304,0.030303030303030304,0.9696969696969697,33,850,300,550,0.35294117647058826,14,3,11,361.41379868177125,0.4471669823232323,0.10047522063815384,0.2087696178267641,130794.81336805543,2854.210069444434,133649.02343749985,86,0,46.42424242424242,33,0,24,35.02842837746097,0.6347853535353536,44.27083333333333,1022.9166666666656,30.997474747474715,0
88,4,0,0,32,0.0,0.0,1.0,32,950,600,350,0.631578947368421,13,6,7,370.04616710868765,0.44472446236559143,0.1130276474944456,0.2138455096943358,130810.95838434855,3281.21875318845,134092.177137537,87,1,47.90625,32,0,24,34.791306673249395,0.6373697916666667,44.255050505050505,1022.9797979797981,31.968118686868692,0
89,4,1,0,33,0.030303030303030304,0.0,1.0,33,1100,900,200,0.8181818181818182,13,9,4,361.53517572833346,0.4457070707070707,0.1202554122908106,0.21140959017065195,131265.326136582,2891.406550365232,134156.73268694725,88,0,47.42424242424242,33,0,25,34.54915092083234,0.639520202020202,43.811274509803916,1024.7549019607836,31.053178847296472,0
90,4,1,0,34,0.029411764705882353,0.0,1.0,34,950,600,350,0.631578947368421,13,6,7,352.14290098477085,0.4460041592394533,0.1111884180195375,0.20727398602268146,131516.61169982684,2462.543252595134,133979.154952422,89,0,47.0,33,1,26,34.53604141776183,0.6420454545454546,43.566176470588225,1025.735294117646,31.082887700534727,0
91,4,0,1,33,0.0,0.029411764705882353,0.9705882352941176,34,1450,1300,150,0.896551724137931,16,13,3,352.2451207955038,0.44591131907308373,0.11167188768998759,0.20780292239126913,131602.82206632633,2471.290391156443,134074.11245748278,90,1,48.0,34,0,21,34.44642649959393,0.640625,43.48214285714285,1026.0714285714268,30.178571428571377,0
92,4,0,1,32,0.0,0.030303030303030304,0.9696969696969697,33,1050,600,450,0.5714285714285714,15,6,9,362.80202464820917,0.4454703282828283,0.12164667709600785,0.21319714482136337,131453.76778162242,2938.3386197616255,134392.10640138405,91,3,50.42424242424242,33,0,25,34.32620299553855,0.6414141414141414,43.627450980392155,1025.4901960784312,31.075460487225186,0
93,4,0,1,31,0.0,0.03125,0.96875,32,1000,700,300,0.7,13,7,6,366.0659124260359,0.444367439516129,0.10268076923076963,0.21568423049032184,131554.7062321445,3231.5387141618025,134786.2449463063,92,4,50.40625,32,0,24,34.14051282051283,0.6448567708333333,43.529040404040394,1025.883838383837,32.058869949494905,0
94,4,0,0,31,0.0,0.0,1.0,31,1000,800,200,0.8,12,8,4,369.35376705987426,0.4431003584229391,0.08228713690227552,0.21747152293704688,131528.39660644523,3516.1017523871406,135044.49835883235,93,5,50.58064516129032,31,0,25,34.082783278327824,0.6471774193548387,43.55468749999999,1025.7812499999993,33.08971774193546,0
95,4,0,0,31,0.0,0.0,1.0,31,1300,1000,300,0.7692307692307693,16,10,6,372.57227974792363,0.4426523297491039,0.12888339377499225,0.20540186249565706,128969.8304070365,3410.1167466905163,132379.947153727,94,6,51.58064516129032,31,0,19,36.60014207580224,0.6213037634408602,46.06119791666666,1015.7552083333319,32.76629704301071,8
96,4,0,0,31,0.0,0.0,1.0,31,1150,1000,150,0.8695652173913043,13,10,3,377.6181187751902,0.4420250896057348,0.13437209398441863,0.20888089419137884,129102.12410820839,3550.2602471245423,132652.38435533294,95,7,52.58064516129032,31,0,19,36.33688340807175,0.6226478494623655,45.93098958333332,1016.2760416666653,32.783098118279526,0
97,4,0,1,30,0.0,0.03225806451612903,0.967741935483871,31,850,500,350,0.5882352941176471,12,5,7,421.9766036009544,0.4415322580645162,0.14026402640264046,0.2243138787562967,127512.49999999988,4675.73818630641,132188.2381863063,96,8,53.58064516129032,29,2,19,36.84509075907591,0.6120689655172413,47.49999999999999,1009.9999999999991,34.82758620689652,8
98,4,1,0,31,0.03225806451612903,0.0,1.0,31,800,700,100,0.875,9,7,2,412.9916809080633,0.4425627240143369,0.12840680289594308,0.22244830881528704,128042.48504162315,4376.0962249970835,132418.58126662023,97,0,52.0,30,1,20,36.52611775121734,0.6145833333333333,46.97580645161289,1012.096774193547,33.7365591397849,0
99,4,2,1,32,0.06060606060606061,0.030303030303030304,0.9696969696969697,33,1400,1100,300,0.7857142857142857,17,11,6,388.64724883047484,0.44839015151515155,0.1258254183627323,0.21343742353804743,128816.57483930196,3412.841483011921,132229.4163223139,98,0,49.78787878787879,32,1,19,36.34872512437811,0.6171875,46.212121212121204,1015.1515151515139,31.72348484848481,0
100,4,1,0,33,0.030303030303030304,0.0,1.0,33,1300,800,500,0.6153846153846154,18,8,10,377.77842388616125,0.449258207070707,0.1020966483893877,0.20967105274534692,129234.4856262206,3164.9739793509348,132399.45960557152,99,0,48.03030303030303,31,2,21,36.19768322875315,0.623991935483871,45.80078124999999,1016.7968749999992,32.79989919354836,0
101,4,0,1,32,0.0,0.030303030303030304,0.9696969696969697,33,700,200,500,0.2857142857142857,12,2,10,378.96652408924524,0.4490609217171717,0.10161021223761368,0.21050700946920356,129267.58660210487,3197.617594401022,132465.2041965059,100,1,49.03030303030303,31,2,21,36.13369611609049,0.6243279569892473,45.76822916666666,1016.927083333332,32.80409946236555,0
102,4,1,0,33,0.030303030303030304,0.0,1.0,33,1050,700,350,0.6666666666666666,14,7,7,367.2907701493182,0.44910037878787884,0.07765057616321847,0.2063580733680151,129715.36705438205,2928.651413121085,132644.01846750313,101,0,47.45454545454545,32,1,18,35.97442571475788,0.6263020833333333,45.328282828282816,1018.6868686868675,31.833964646464608,0
103,4,0,0,33,0.0,0.0,1.0,33,900,700,200,0.7777777777777778,11,7,4,367.98858587872655,0.4490214646464647,0.07861819383127555,0.20743043751487983,129844.02101826335,2956.2235358636694,132800.244554127,102,1,48.45454545454545,32,1,18,35.82574537495871,0.6276041666666667,45.20202020202019,1019.1919191919185,31.849747474747453,0
104,4,0,0,33,0.0,0.0,1.0,33,1100,800,300,0.7272727272727273,14,8,6,366.84833605267056,0.44839015151515155,0.07760367418614078,0.20746968921298087,129972.73875114776,2936.056588613396,132908.79533976116,103,2,49.45454545454545,32,1,19,35.723904160475485,0.62890625,45.07575757575757,1019.696969696969,31.86553030303028,0
105,4,0,0,33,0.0,0.0,1.0,33,850,500,350,0.5882352941176471,12,5,7,368.55463732698627,0.44819286616161613,0.07746233219682863,0.20895108175191038,130069.31889921954,2987.5301308540006,133056.84903007353,104,3,50.45454545454545,32,1,19,35.58221933407599,0.6298828125,44.98106060606061,1020.0757575757582,31.877367424242443,0
106,4,0,0,33,0.0,0.0,1.0,33,1550,1300,250,0.8387096774193549,18,13,5,367.74065288248744,0.4477193813131313,0.08201010600812664,0.2093531998522555,130230.36552392616,2978.199928578721,133208.56545250487,105,4,51.45454545454545,32,1,19,35.439345208642585,0.6315104166666667,44.823232323232325,1020.707070707071,31.89709595959597,0
107,4,1,2,32,0.029411764705882353,0.058823529411764705,0.9411764705882353,34,1100,900,200,0.8181818181818182,13,9,4,357.5219994242475,0.4488079322638146,0.0781103373339258,0.2048564198762853,130481.60750973188,2530.0090409938516,133011.61655072574,106,0,50.911764705882355,33,1,20,35.44527907720602,0.6316287878787878,44.57720588235294,1021.6911764705885,30.960338680926924,0
108,4,0,0,32,0.0,0.0,1.0,32,950,700,250,0.7368421052631579,12,7,5,376.18392925981755,0.44665658602150543,0.08046586127757238,0.21488787743516033,130362.2966342503,3408.0401950412424,133770.33682929154,107,1,52.84375,31,1,20,35.08980938416421,0.6354166666666667,44.69401041666667,1021.223958333334,32.94270833333336,0
109,4,0,0,32,0.0,0.0,1.0,32,850,500,350,0.5882352941176471,12,5,7,376.13513253317444,0.44657258064516125,0.07637428298279181,0.21522830887839192,130428.79104614258,3411.7701212565103,133840.56116739908,108,2,53.84375,31,1,20,35.0235022307202,0.6360887096774194,44.62890625,1021.484375,32.951108870967744,0
110,4,0,0,32,0.0,0.0,1.0,32,750,700,50,0.9333333333333333,8,7,1,377.6536167795852,0.44554351478494625,0.0839888535031843,0.21702641959881017,130595.1012505427,3463.9424641927276,134059.04371473542,109,3,54.84375,31,1,15,34.81581740976646,0.637768817204301,44.46614583333334,1022.135416666668,32.9721102150538,0
111,4,0,1,31,0.0,0.03125,0.96875,32,800,700,100,0.875,9,7,2,375.8439590560722,0.44539650537634407,0.0842233859671464,0.21654457890442694,130694.93823581288,3424.1806030273633,134119.11883884025,110,4,55.84375,31,1,15,34.76073368988497,0.6387768817204301,44.36848958333334,1022.526041666668,32.98471102150542,0
112,4,0,1,30,0.0,0.03225806451612903,0.967741935483871,31,800,600,200,0.75,10,6,4,400.0360174888521,0.4437275985663083,0.09450530306486926,0.2161973667832385,128177.49235365119,4055.122714572478,132232.61506822368,111,10,58.516129032258064,31,0,20,36.715234023402346,0.613239247311828,46.842447916666664,1012.6302083333328,32.665490591397834,8
113,4,1,1,30,0.03225806451612903,0.03225806451612903,0.967741935483871,31,1150,1000,150,0.8695652173913043,13,10,3,396.1604734026733,0.44099462365591396,0.11450391163717288,0.21623643499183037,128573.35620456263,3987.136332194006,132560.49253675665,112,0,59.064516129032256,31,0,20,36.407246330294875,0.617271505376344,46.451822916666664,1014.1927083333326,32.715893817204275,0
114,4,0,0,30,0.0,0.0,1.0,30,1150,900,250,0.782608695652174,14,9,5,393.62294509049286,0.4413793103448276,-0.004695714158424957,0.20367129150532956,126415.27380332975,3951.990475777526,130367.26427910727,113,1,59.36666666666667,30,0,16,38.69258442484183,0.5979166666666667,48.588709677419345,1005.6451612903215,33.52150537634405,8
115,4,3,0,33,0.09090909090909091,0.0,1.0,33,850,500,350,0.5882352941176471,12,5,7,362.0845811599668,0.4488636363636364,-0.008010130459109588,0.1910692482121053,127215.61418685109,2612.5624759707703,129828.17666282186,114,0,54.878787878787875,33,0,19,38.66213151927439,0.5984848484848485,47.79411764705882,1008.8235294117637,30.57040998217466,0
116,4,1,3,31,0.029411764705882353,0.08823529411764706,0.9117647058823529,34,600,500,100,0.8333333333333334,7,5,2,349.27333697753124,0.4503490790255496,-0.006793195713354239,0.18594313284763642,127572.62613378656,2111.5433673469074,129684.16950113347,115,0,54.23529411764706,34,0,16,38.61924542383534,0.5998774509803921,47.440476190476176,1010.2380952380929,29.712885154061556,0
117,4,2,1,32,0.06060606060606061,0.030303030303030304,0.9696969696969697,33,1200,900,300,0.75,15,9,6,364.8628689105244,0.4442471590909091,0.02723157863797976,0.19490861028329032,127710.61610918869,2719.372356785839,130429.98846597453,116,0,56.72727272727273,33,0,18,38.08397995473649,0.6035353535353536,47.303921568627445,1010.7843137254896,30.6298276886512,0
118,4,0,0,32,0.0,0.0,1.0,32,900,600,300,0.6666666666666666,12,6,6,372.5901292232447,0.4415322580645162,0.035302661169415606,0.1988140929535233,127665.57621671256,3113.386707988985,130778.96292470155,117,1,59.375,32,0,18,37.93493878060971,0.60546875,47.34848484848485,1010.6060606060605,31.58143939393939,0
119,4,0,0,32,0.0,0.0,1.0,32,1250,800,450,0.64,17,8,9,366.6231816970357,0.4412382392473118,0.03424625468164799,0.1965630311508206,127857.0506198349,2975.0717401285797,130832.12235996348,118,2,60.375,32,0,20,37.889357053682886,0.607421875,47.15909090909092,1011.363636363638,31.605113636363686,0
120,4,0,1,31,0.0,0.03125,0.96875,32,650,300,350,0.46153846153846156,10,3,7,369.10553892215563,0.44035618279569894,0.03344872754491024,0.19884072580645176,128048.66850321404,3052.6945592286615,131101.3630624427,119,3,61.375,32,0,20,37.630208333333336,0.609375,46.969696969696976,1012.1212121212127,31.628787878787897,0
121,4,1,1,31,0.03125,0.03125,0.96875,32,1050,900,150,0.8571428571428571,12,9,3,365.8104705280398,0.44119623655913975,0.05009809417040367,0.19896520714086077,128432.33471074393,2996.3785583103954,131428.71326905434,120,0,61.28125,32,0,16,37.32093921275536,0.61328125,46.5909090909091,1013.6363636363646,31.676136363636395,0
122,4,0,1,30,0.0,0.03225806451612903,0.967741935483871,31,450,300,150,0.6666666666666666,6,3,3,373.4014696919602,0.44094982078853046,0.04959718860855977,0.20297186034093717,128408.33875868062,3389.572482638894,131797.91124131953,121,1,62.25806451612903,31,0,17,37.153134635149016,0.6155913978494624,46.614583333333336,1013.5416666666672,32.694892473118294,0
123,4,0,0,30,0.0,0.0,1.0,30,900,700,200,0.7777777777777778,11,7,4,383.56277319400976,0.4389367816091954,0.033969600565570746,0.20907496827858438,128519.04844490686,3859.0245259567478,132378.0729708636,116,2,61.3,30,0,18,36.782266260162615,0.6194444444444445,46.50537634408602,1013.9784946236554,33.799283154121845,0
124,4,0,0,30,0.0,0.0,1.0,30,1100,900,200,0.8181818181818182,13,9,4,385.09827812642305,0.4385775862068966,0.03134631518523401,0.2108126832180106,128689.46419022429,3911.6182145334697,132601.08240475776,117,3,62.3,30,0,19,36.56886121782133,0.6211805555555556,46.33736559139785,1014.6505376344085,33.821684587813614,0
125,4,1,0,31,0.03225806451612903,0.0,1.0,31,950,700,250,0.7368421052631579,12,7,5,375.6009818112124,0.4416218637992832,0.03041887954371636,0.20776510723150354,129102.12410820862,3498.1769137912365,132600.30102199985,118,0,61.25806451612903,31,0,20,36.38813260730301,0.6226478494623655,45.930989583333336,1016.2760416666672,32.78309811827959,0
126,4,1,1,31,0.03125,0.03125,0.96875,32,1000,800,200,0.8,12,8,4,404.2455815868036,0.44293934811827956,-0.0006184142893856936,0.2193751126853911,128342.36145019543,4194.774881998713,132537.13633219415,119,0,60.3125,31,1,21,36.43932579456865,0.6149193548387097,46.67968750000001,1013.2812500000009,32.6864919354839,8
127,4,1,0,32,0.03125,0.0,1.0,32,1250,1100,150,0.88,14,11,3,398.9981827304579,0.4436533938172043,0.015592915811088348,0.21832821908958777,128672.41753472229,3868.012152777788,132540.4296875001,120,0,61.25,31,1,18,36.233744010951405,0.6182795698924731,46.35416666666667,1014.5833333333339,32.72849462365593,0
128,4,0,3,29,0.0,0.09375,0.90625,32,1650,1200,450,0.7272727272727273,21,12,9,409.1104052583948,0.44151125672043007,-0.07909010315925225,0.2171561391361297,127453.3271789552,4029.5815361870837,131482.9087151423,121,1,62.25,31,1,16,37.230953148506345,0.6058467741935484,47.55859375000001,1009.7656250000009,32.57308467741938,8
129,4,0,0,29,0.0,0.0,1.0,29,700,500,200,0.7142857142857143,9,5,4,419.7753812506161,0.4362171592775041,-0.026706464535386054,0.2220257739385789,127309.42000264238,4888.272063680802,132197.6920663232,122,3,67.82758620689656,28,1,22,37.110264806378126,0.6130952380952381,47.701149425287355,1009.1954022988507,36.04269293924467,0
130,4,0,0,29,0.0,0.0,1.0,29,850,600,250,0.7058823529411765,11,6,5,421.5040804340973,0.4359605911330049,-0.023237100857653292,0.2237409877107882,127454.46062888093,4944.51504492006,132398.975673801,123,4,68.82758620689656,28,1,18,36.91691567065071,0.6145833333333333,47.55747126436781,1009.7701149425285,36.063218390804586,0
131,4,0,0,29,0.0,0.0,1.0,29,1050,900,150,0.8571428571428571,12,9,3,421.90485393525483,0.4359092775041051,-0.019215395857753004,0.22455813989544096,127563.29528752135,4963.914693156284,132527.20998067764,124,5,69.82758620689656,28,1,18,36.794493433840636,0.6156994047619048,47.449712643678154,1010.2011494252863,36.07861247947451,0
132,4,1,0,30,0.03333333333333333,0.0,1.0,30,800,600,200,0.75,10,6,4,411.9106968917673,0.43733237547892717,-0.022794016742143652,0.22184724672951273,128039.08420138877,4548.133680555537,132587.21788194432,125,0,68.46666666666667,29,1,21,36.556967888019756,0.6174568965517242,46.97916666666666,1012.0833333333323,34.89942528735629,0
133,4,1,2,29,0.03225806451612903,0.06451612903225806,0.935483870967742,31,1050,800,250,0.7619047619047619,13,8,5,398.9699471132391,0.43723118279569895,-0.012457921382564185,0.21773382315552095,128566.75347222216,4058.8975694444343,132625.6510416666,126,0,67.2258064516129,29,2,17,36.342782799233085,0.6228448275862069,46.45833333333333,1014.1666666666661,34.97126436781607,0
134,4,0,0,29,0.0,0.0,1.0,29,600,300,300,0.5,9,3,6,407.97499657753855,0.4356527093596059,-0.050337010096002666,0.2099069079119426,126183.34297839504,4495.929783950614,130679.27276234566,127,2,69.55172413793103,29,0,21,38.571905815132254,0.5984195402298851,48.81944444444444,1004.7222222222221,34.6455938697318,8
135,4,4,3,30,0.12121212121212122,0.09090909090909091,0.9090909090909091,33,700,500,200,0.7142857142857143,9,5,4,369.3487840352818,0.4422743055555556,-0.01747666069274101,0.19701140294830397,127650.6233215332,2836.0405627592113,130486.66388429241,128,0,62.0,31,2,17,38.032174762702404,0.6078629032258065,47.36328125,1010.546875,32.598286290322584,0
136,4,0,1,29,0.0,0.03333333333333333,0.9666666666666667,30,1250,900,350,0.72,16,9,7,402.39648929176406,0.436661877394636,-0.015140293405498051,0.21226339228530997,127200.6937219249,4237.022517835901,131437.7162397608,129,1,69.1,28,2,20,37.660827042681476,0.6119791666666667,47.808908045977006,1008.7643678160914,36.027298850574695,0
137,4,1,0,30,0.03333333333333333,0.0,1.0,30,1300,1000,300,0.7692307692307693,16,10,6,394.04368040081516,0.4381226053639847,0.004832509610104063,0.21166771150734062,127933.6805555556,4082.291666666672,132015.97222222228,130,0,67.53333333333333,29,1,18,37.11731191652938,0.6163793103448276,47.083333333333336,1011.6666666666671,34.88505747126438,0
138,4,1,0,31,0.03225806451612903,0.0,1.0,31,900,700,200,0.7777777777777778,11,7,4,410.1599642210743,0.4388888888888889,-0.024101471166380062,0.22499626468003317,128771.5170118543,4363.384162055116,133134.90117390943,131,0,66.3225806451613,31,0,19,35.84896835578364,0.6192876344086021,46.256510416666664,1014.9739583333327,32.74109543010751,8
139,4,0,0,31,0.0,0.0,1.0,31,1150,900,250,0.782608695652174,14,9,5,416.1091532985258,0.4381720430107527,-0.021971385909690833,0.22902154457129148,128903.70898776577,4527.602640787751,133431.31162855352,132,1,67.3225806451613,31,0,19,35.56238513484635,0.6206317204301075,46.12630208333333,1015.4947916666661,32.75789650537632,0
140,4,1,1,31,0.03125,0.03125,0.96875,32,850,500,350,0.5882352941176471,12,5,7,418.3870270971417,0.44052419354838707,-0.02352563299072452,0.2187347118074049,126837.51179726566,4213.43389705133,131050.945694317,133,0,66.1875,32,0,17,37.6329176067519,0.5970052083333333,48.169191919191924,1007.3232323232329,31.478851010101028,8
141,4,0,0,31,0.0,0.0,1.0,31,700,400,300,0.5714285714285714,10,4,6,422.830935367534,0.43884408602150543,-0.015213628875867524,0.2208370887959403,126796.77539401579,4522.719828287756,131319.49522230355,134,1,67.96774193548387,31,0,17,37.563159879336354,0.5991263440860215,48.209635416666664,1007.1614583333328,32.48907930107525,0
142,4,0,0,31,0.0,0.0,1.0,31,750,400,350,0.5333333333333333,11,4,7,423.02905286408526,0.43799283154121865,-0.010938893937751715,0.22147488572816573,126895.1500786674,4536.067030164912,131431.21710883232,135,2,68.96774193548387,31,0,17,37.456384078573265,0.6001344086021505,48.11197916666666,1007.5520833333322,32.501680107526845,0
143,4,0,0,31,0.0,0.0,1.0,31,1050,700,350,0.6666666666666666,14,7,7,421.5104594408724,0.43767921146953404,-0.009068933900141518,0.22103597263362806,126960.75439453113,4503.057183159708,131463.81157769085,136,3,69.96774193548387,31,0,17,37.426787252368655,0.6008064516129032,48.04687499999999,1007.8124999999991,32.51008064516126,0
144,4,0,1,30,0.0,0.03225806451612903,0.967741935483871,31,900,700,200,0.7777777777777778,11,7,4,423.8098490540267,0.43785842293906807,-0.006131698213809322,0.22296083363277044,127092.01388888883,4572.569444444441,131664.58333333328,137,4,70.96774193548387,31,0,17,37.23312672176309,0.6021505376344086,47.916666666666664,1008.3333333333328,32.52688172043009,0
145,4,0,0,30,0.0,0.0,1.0,30,1000,600,400,0.6,14,6,8,432.27295399176774,0.43536877394636014,-0.000413388451793395,0.22684498824242583,126990.38770739388,4978.902004566999,131969.28971196088,138,5,74.1,30,0,18,37.12494999333244,0.6038194444444445,48.01747311827957,1007.9301075268813,33.597670250896044,0
146,4,3,2,31,0.09090909090909091,0.06060606060606061,0.9393939393939394,33,1100,800,300,0.7272727272727273,14,8,6,406.4524170759861,0.445904356060606,-0.019472652377910293,0.21813122565313336,127896.48963139184,3796.7674692426076,131693.25710063445,139,0,68.27272727272727,33,0,17,36.84173330102577,0.6054292929292929,47.12009803921569,1011.5196078431378,30.652109328579932,0
147,4,1,0,32,0.03125,0.0,1.0,32,1350,1100,250,0.8148148148148148,16,11,5,413.5247453333231,0.44069220430107525,-0.011841612581128258,0.22206167959856477,127920.90730537704,4179.692123252734,132100.59942862976,140,0,71.375,32,0,18,36.637751705774676,0.6080729166666667,47.0959595959596,1011.6161616161619,31.61300505050506,0
148,4,0,0,32,0.0,0.0,1.0,32,850,700,150,0.8235294117647058,10,7,3,411.84229071548043,0.4407342069892473,-0.015184364861492439,0.22151034347609802,127984.77993317011,4141.908988878688,132126.6889220488,141,1,72.375,32,0,19,36.61457033524665,0.6087239583333333,47.032828282828284,1011.8686868686871,31.62089646464647,0
149,4,1,0,33,0.030303030303030304,0.0,1.0,33,900,600,300,0.6666666666666666,12,6,6,406.74393396268925,0.4410116792929293,-0.011929652428174675,0.2209133313350739,128375.3479851616,3843.3780907976397,132218.72607595925,142,0,71.15151515151516,31,2,16,36.34216133453253,0.615255376344086,46.647135416666664,1013.4114583333327,32.69069220430105,0
150,4,0,1,32,0.0,0.030303030303030304,0.9696969696969697,33,1200,900,300,0.75,15,9,6,404.6077775014035,0.440814393939394,-0.01049415153461375,0.2201168097727761,128441.33377075195,3793.672519259982,132235.00629001192,143,1,72.15151515151516,31,2,16,36.328543138514235,0.6159274193548387,46.58203125,1013.671875,32.69909274193548,0
151,4,0,1,31,0.0,0.03125,0.96875,32,1150,700,450,0.6086956521739131,16,7,9,409.04427278583915,0.43794102822580644,0.012820406676381069,0.2239213354068385,128689.46419022445,4127.93765897794,132817.40184920238,144,2,74.5,30,2,16,35.961440808937176,0.6211805555555556,46.33736559139786,1014.6505376344097,33.82168458781366,0
152,4,1,1,31,0.03125,0.03125,0.96875,32,750,500,250,0.6666666666666666,10,5,5,407.16220649967926,0.4386130712365592,0.017938053975393276,0.22481659013375277,129030.63441221525,4107.279562666202,133137.91397488146,145,0,73.9375,30,2,17,35.65947876703267,0.6246527777777777,46.001344086021504,1015.9946236559138,33.866487455197124,0
153,4,0,1,30,0.0,0.03225806451612903,0.967741935483871,31,1000,700,300,0.7,13,7,6,423.1503798978908,0.4352150537634409,0.024409601580274387,0.233819348892218,129060.223765432,4722.37654320986,133782.60030864188,146,1,77.16129032258064,29,2,17,35.223027155093845,0.6278735632183908,45.972222222222214,1016.1111111111104,35.03831417624519,0
154,4,1,0,31,0.03225806451612903,0.0,1.0,31,650,500,150,0.7692307692307693,8,5,3,423.9451760279492,0.4344534050179212,0.029613960867265865,0.23509687034277202,129201.38888888893,4754.938271604943,133956.32716049388,147,0,77.90322580645162,28,3,19,35.05806010928963,0.6324404761904762,45.833333333333336,1016.6666666666671,36.309523809523824,0
155,4,0,0,31,0.0,0.0,1.0,31,1250,1000,250,0.8,15,10,5,420.89418427280407,0.43413978494623656,0.027698854250638227,0.2340325065626228,129307.31336805547,4684.939236111107,133992.25260416657,148,1,78.90322580645162,29,2,20,35.027055168646754,0.6303879310344828,45.729166666666664,1017.0833333333327,35.071839080459746,0
156,4,1,2,30,0.03125,0.0625,0.9375,32,850,500,350,0.5882352941176471,12,5,7,404.19071366808123,0.43642893145161293,0.01897586388815653,0.22768008848673035,129817.039903457,4094.168400971207,133911.2083044282,149,0,77.40625,30,2,18,34.93086696562033,0.6326388888888889,45.22849462365591,1019.0860215053759,33.9695340501792,0
157,4,0,1,29,0.0,0.03333333333333333,0.9666666666666667,30,1000,900,100,0.9,11,9,2,424.99022605333255,0.4348659003831417,0.025259938837920215,0.23765238765492208,129530.26169655843,5009.819039833546,134540.08073639197,150,1,79.36666666666666,28,2,18,34.69448365090568,0.6357886904761905,45.510057471264375,1017.9597701149432,36.35570607553369,0
158,4,0,0,29,0.0,0.0,1.0,29,900,400,500,0.4444444444444444,14,4,10,437.9056313472484,0.4339593596059113,0.03012008695082069,0.24400658529104616,129390.5701929208,5532.17186614228,134922.74205906308,151,2,82.03448275862068,27,2,21,34.50907439910293,0.6377314814814814,45.64732142857142,1017.4107142857133,37.68187830687827,0
159,4,0,0,29,0.0,0.0,1.0,29,850,600,250,0.7058823529411765,11,6,5,437.9056313472484,0.4338567323481117,0.03012008695082069,0.24400658529104616,129390.5701929208,5532.17186614228,134922.74205906308,152,3,83.03448275862068,27,2,21,34.50907439910293,0.6377314814814814,45.64732142857142,1017.4107142857133,37.68187830687827,0
160,4,0,0,29,0.0,0.0,1.0,29,750,700,50,0.9333333333333333,8,7,1,438.3627946348409,0.43370279146141216,0.03176507958917174,0.24473168591899383,129466.28146701377,5550.640190972203,135016.92165798598,153,4,84.03448275862068,27,2,19,34.4197799385875,0.6385030864197531,45.57291666666666,1017.7083333333323,37.69290123456786,0
161,4,1,1,29,0.03333333333333333,0.03333333333333333,0.9666666666666667,30,1200,900,300,0.75,15,9,6,428.42026228462265,0.43433908045977015,0.03833004602235324,0.24249816759938214,130006.0381985732,5139.4441967234825,135145.48239529668,154,0,82.2,28,2,20,34.120233399079545,0.640625,45.043103448275865,1019.8275862068971,36.422413793103466,0
162,4,0,1,28,0.0,0.034482758620689655,0.9655172413793104,29,850,600,250,0.7058823529411765,11,6,5,441.2839693985315,0.43303571428571425,0.052861485194355184,0.2494783628975857,129958.94451530615,5669.759778911567,135628.70429421772,155,1,85.13793103448276,27,2,20,33.84048453006421,0.6435185185185186,45.089285714285715,1019.6428571428575,37.76455026455027,0
163,4,0,0,28,0.0,0.0,1.0,28,1150,900,250,0.782608695652174,14,9,5,454.4852137041552,0.43011463844797176,0.06787012200398013,0.2560938866298841,129829.72298430119,6201.13787913428,136030.86086343546,156,2,88.82142857142857,26,2,20,33.63649555824754,0.6458333333333333,45.21604938271605,1019.1358024691359,39.19753086419753,0
164,4,0,0,28,0.0,0.0,1.0,28,850,500,350,0.5882352941176471,12,5,7,455.53297593910474,0.4298115079365079,0.067660922398322,0.25745991206412877,129947.70530883252,6239.092983158056,136186.79829199056,157,3,89.82142857142857,26,2,21,33.48878714494728,0.6470352564102564,45.10030864197531,1019.598765432099,39.2153371320038,0
165,4,0,0,28,0.0,0.0,1.0,28,1200,900,300,0.75,15,9,6,453.46000764440237,0.4290674603174603,0.07474605575967108,0.2570643782615352,130065.74121704012,6195.922401310778,136261.6636183509,158,4,90.82142857142857,26,2,21,33.420637922339886,0.6482371794871795,44.98456790123457,1020.0617283950621,39.23314339981008,0
166,4,1,1,28,0.034482758620689655,0.034482758620689655,0.9655172413793104,29,800,500,300,0.625,11,5,6,442.72448418599714,0.4292898193760262,0.07533925577229517,0.25404865981626296,130538.42068663318,5758.659836534072,136297.08052316724,159,0,88.65517241379311,26,3,19,33.21095087083459,0.6530448717948718,44.52160493827161,1021.9135802469139,39.30436847103515,0
167,4,1,0,29,0.034482758620689655,0.0,1.0,29,1150,900,250,0.782608695652174,14,9,5,442.2486085469657,0.42887931034482757,0.08758152950653497,0.25717086044777543,131051.45759506931,5791.464953894211,136842.9225489635,160,0,87.3103448275862,26,3,21,32.699384576739504,0.6582532051282051,44.020061728395056,1023.9197530864194,39.381528964862284,0
168,4,1,0,30,0.03333333333333333,0.0,1.0,30,950,600,350,0.631578947368421,13,6,7,426.68335037314966,0.4294300766283525,0.08914122424424686,0.2517318186895361,131605.0841382792,5231.031378600821,136836.11551688003,161,0,85.36666666666666,26,4,19,32.53465433398507,0.6638621794871795,43.47993827160494,1026.0802469135801,39.46462488129154,0
169,4,0,0,30,0.0,0.0,1.0,30,1200,1000,200,0.8333333333333334,14,10,4,415.07921252908227,0.4270593869731801,0.0729542555130307,0.22935948027664396,129060.22376543209,4714.043209876541,133774.26697530862,162,1,86.36666666666666,29,1,20,35.42805722617096,0.6278735632183908,45.97222222222222,1016.1111111111111,35.03831417624521,8
170,4,1,1,30,0.03225806451612903,0.03225806451612903,0.967741935483871,31,1000,800,200,0.8,12,8,4,404.9369237314259,0.4312724014336917,0.06917411077895785,0.22596899011273103,129448.6135223766,4283.78182870372,133732.3953510803,163,0,84.54838709677419,29,2,19,35.28828874937448,0.6318247126436782,45.590277777777786,1017.6388888888894,35.09099616858239,0
171,4,0,0,30,0.0,0.0,1.0,30,1000,700,300,0.7,13,7,6,411.74191643525194,0.428544061302682,0.08358757062146926,0.22917710443094202,129347.5029726516,4651.557752014799,133999.0607246664,164,1,87.9,28,2,21,35.2186322975518,0.6339285714285714,45.689655172413794,1017.2413793103447,36.33004926108374,0
172,4,0,0,30,0.0,0.0,1.0,30,1400,1300,100,0.9285714285714286,15,13,2,419.15650629358345,0.4279693486590039,0.08625827814569509,0.21825045672527985,126672.22222222235,4619.097222222241,131291.31944444458,165,2,88.9,29,1,19,37.78456125827815,0.603448275862069,48.33333333333334,1006.6666666666678,34.71264367816096,8
173,4,2,1,31,0.0625,0.03125,0.96875,32,1200,1000,200,0.8333333333333334,14,10,4,402.3669926935264,0.4329637096774193,0.11419693456980928,0.21514995394439002,127749.32861328147,3880.422634548641,131629.7512478301,166,0,84.28125,31,1,18,37.09642795809721,0.6088709677419355,47.265625000000014,1010.9375000000017,32.61088709677425,0
174,4,2,1,32,0.06060606060606061,0.030303030303030304,0.9696969696969697,33,550,200,350,0.36363636363636365,9,2,7,385.41449309089586,0.43738162878787884,0.1217334149271323,0.20862314868928278,128240.42986685055,3285.1440541781762,131525.57392102873,167,0,82.51515151515152,32,1,20,37.02084891548243,0.611328125,46.780303030303045,1012.8787878787898,31.65246212121218,0
175,4,1,0,33,0.030303030303030304,0.0,1.0,33,950,400,550,0.42105263157894735,15,4,11,386.4950389956807,0.43974905303030304,0.16619496088095143,0.1951328611514778,125403.55098855356,3100.7440787593996,128504.29506731295,168,0,81.24242424242425,30,3,19,39.918813741277496,0.5875,49.596774193548384,1001.6129032258062,33.387096774193544,8
176,4,6,5,34,0.15384615384615385,0.1282051282051282,0.8717948717948718,39,750,500,250,0.6666666666666666,10,5,5,331.4824897094558,0.4515856950067476,0.1579138844248884,0.17402344665040143,127006.86486740141,620.1103552877458,127626.97522268916,169,0,69.58974358974359,36,3,19,39.647804714557026,0.5899884259259259,48.00112612612614,1007.9954954954974,27.999874874874926,0
177,4,3,1,36,0.08108108108108109,0.02702702702702703,0.972972972972973,37,950,700,250,0.7368421052631579,12,7,5,352.8022334497453,0.4446321321321321,0.2031449514491288,0.17677979532964871,125089.30165816315,1431.4296413415468,126520.7312995047,170,0,74.16216216216216,34,3,21,41.08750842952912,0.5744485294117647,49.91071428571428,1000.3571428571419,29.422268907562994,7
178,4,4,3,37,0.1,0.075,0.925,40,900,400,500,0.4444444444444444,14,4,10,338.5300513809215,0.4527777777777778,0.22328897338403042,0.17395514007904156,126131.01912133466,547.0843126023279,126678.10343393698,171,0,69.475,35,5,21,40.37007431731765,0.5830357142857143,48.871527777777764,1004.5138888888871,28.700396825396773,0
179,4,3,2,38,0.075,0.05,0.95,40,1700,1200,500,0.7058823529411765,22,12,10,331.4531807868041,0.4547008547008547,0.21378943835309983,0.17244054306591722,126638.21549590143,394.9278670562637,127033.1433629577,172,0,67.35,36,4,17,40.02666517490865,0.5862268518518519,48.367117117117125,1006.5315315315326,27.959209209209238,0
180,4,2,0,40,0.05,0.0,1.0,40,1550,1300,250,0.8387096774193549,18,13,5,334.41888450587766,0.45297809829059826,0.2375767899028256,0.1758104681727026,127063.62771132632,498.49532809838314,127562.12303942471,173,0,68.3,36,4,20,39.51561860084144,0.5905671296296297,47.94481981981983,1008.2207207207218,28.006131131131163,0
181,4,1,1,40,0.024390243902439025,0.024390243902439025,0.975609756097561,41,1250,900,350,0.72,16,9,7,325.67749357178116,0.4560721544715447,0.22457811923373683,0.17282302031144886,127442.37075617284,101.02871734346724,127543.3994735163,174,0,67.60975609756098,35,6,14,39.34834938101786,0.5964285714285714,47.56944444444444,1009.7222222222223,28.84920634920635,0
182,4,2,1,41,0.047619047619047616,0.023809523809523808,0.9761904761904762,42,1250,800,450,0.64,17,8,9,329.0190723296531,0.4531189508323655,0.2597058184573482,0.17716563229638058,128030.53634293073,24.89765948379909,128055.43400241453,175,0,66.95238095238095,36,6,17,38.663022514001696,0.6004050925925926,46.98761261261261,1012.0495495495493,28.11248748748748,0
183,4,1,3,39,0.023809523809523808,0.07142857142857142,0.9285714285714286,42,1100,500,600,0.45454545454545453,17,5,12,331.54627883166836,0.452852787456446,0.2728974387486569,0.1792901795269509,128201.54772593541,100.94921779888375,128302.4969437343,176,0,67.78571428571429,36,6,18,38.424561696134035,0.6021412037037037,46.818693693693696,1012.7252252252254,28.13125625625626,0
184,4,1,0,40,0.025,0.0,1.0,40,1350,1000,350,0.7407407407407407,17,10,7,342.9116950712022,0.45129540598290596,0.27065962307253,0.18612472971781593,128349.69142500413,802.522049682767,129152.2134746869,171,0,67.5,35,5,19,37.98555587283458,0.6056547619047619,46.672453703703695,1013.310185185184,28.95171957671954,0
185,4,0,1,39,0.0,0.025,0.975,40,1050,600,450,0.5714285714285714,15,6,9,343.9824105838193,0.4512152777777778,0.26889580093312637,0.18721461064543762,128458.27880245098,837.4776803830747,129295.75648283405,172,1,68.5,36,4,17,37.84760793897652,0.6047453703703703,46.56531531531531,1013.7387387387378,28.15940940940938,0
186,4,0,0,39,0.0,0.0,1.0,39,1200,1000,200,0.8333333333333334,14,10,4,355.6139085208123,0.4509390463337832,0.2787572140090131,0.19330297932444132,128408.33875868037,1332.758246527754,129741.09700520812,173,2,71.05128205128206,35,4,17,37.60384549503254,0.60625,46.61458333333332,1013.5416666666652,28.95833333333329,0
187,4,0,0,39,0.0,0.0,1.0,39,1200,900,300,0.75,15,9,6,385.5631249181217,0.4510796221322537,0.2685806776872668,0.20067280056330944,126654.74597318654,1979.9720293209707,128634.7180025075,174,3,72.05128205128206,35,4,18,38.64802518109693,0.5883928571428572,48.350694444444436,1006.5972222222207,28.75992063492059,8
188,4,4,2,41,0.09302325581395349,0.046511627906976744,0.9534883720930233,43,1600,1300,300,0.8125,19,13,6,356.653777705204,0.45544942783314873,0.264044288893321,0.19068975357115045,127745.7710032667,514.4629241783823,128260.23392744508,175,0,66.25581395348837,36,7,20,38.25540269577808,0.5975115740740741,47.269144144144136,1010.9234234234227,28.081206206206186,0
189,4,0,0,41,0.0,0.0,1.0,41,1500,900,600,0.6,21,9,12,365.7583745228019,0.4507113821138211,0.2850575637338417,0.19515542685883494,127662.84190759624,1138.7507086167607,128801.592616213,176,1,70.39024390243902,34,7,20,38.11034868653548,0.600796568627451,47.35119047619047,1010.5952380952372,29.72338935574227,0
190,4,1,1,41,0.023809523809523808,0.023809523809523808,0.9761904761904762,42,1050,700,350,0.6666666666666666,14,7,7,357.872481217274,0.45294957413859854,0.27841865328997883,0.19254640635585374,127998.08873724693,761.3987214934638,128759.48745874039,177,0,69.69047619047619,35,7,21,37.96620629837203,0.6020833333333333,47.01967592592592,1011.921296296295,28.912037037037003,0
191,4,1,1,41,0.023809523809523808,0.023809523809523808,0.9761904761904762,42,1050,800,250,0.7619047619047619,13,8,5,350.35122297742237,0.4525503290747193,0.2605069212150881,0.19016273758011976,128349.69142500425,593.5779963991744,128943.26942140343,178,0,66.92857142857143,35,7,22,37.79709213782601,0.6056547619047619,46.6724537037037,1013.3101851851849,28.95171957671957,0
192,4,0,0,41,0.0,0.0,1.0,41,1200,800,400,0.6666666666666666,16,8,8,352.87418449443913,0.4513719512195122,0.26443827356849536,0.1914156905183027,128325.39859693871,856.5440759637142,129181.94267290243,179,1,69.2439024390244,34,7,22,37.75799945168998,0.6075367647058824,46.69642857142857,1013.2142857142852,29.800420168067213,0
193,4,1,1,41,0.023809523809523808,0.023809523809523808,0.9761904761904762,42,1500,900,600,0.6,21,9,12,350.78669413713624,0.451413085559427,0.2837685003829884,0.19329786720953535,128950.68825263533,646.8371277700687,129597.5253804054,180,0,68.57142857142857,37,5,19,37.172869660657085,0.6078265765765766,46.080043859649116,1015.6798245614027,27.4508060692271,0
194,4,0,0,41,0.0,0.0,1.0,41,1200,1000,200,0.8333333333333334,14,10,4,357.07803611600116,0.44913617886178864,0.2856339110136148,0.1964473857021343,128886.73460200061,1004.5244146173219,129891.25901661793,181,1,71.17073170731707,36,5,20,37.07834275997192,0.6090856481481481,46.14301801801802,1015.4279279279276,28.206331331331324,0
195,4,0,0,41,0.0,0.0,1.0,41,1300,1200,100,0.9230769230769231,14,12,2,362.26766972978794,0.4482469512195122,0.2889459667147378,0.20032796915606652,129089.93632656203,1153.0220837180643,130242.9584102801,182,2,72.17073170731707,37,4,20,36.739318083728946,0.6092342342342343,45.94298245614035,1016.2280701754387,27.4656235182551,0
196,4,0,1,40,0.0,0.024390243902439025,0.975609756097561,41,1050,600,450,0.5714285714285714,15,6,9,359.4463853802738,0.4474339430894309,0.28708516593362643,0.19932935916542477,129201.38888888907,1088.2425361649925,130289.63142505406,183,3,73.17073170731707,36,5,20,36.69740437158469,0.6122685185185186,45.83333333333334,1016.6666666666681,28.24074074074078,0
197,4,0,1,39,0.0,0.025,0.975,40,1250,800,450,0.64,17,8,9,365.4568302354244,0.446073717948718,0.28956863191440885,0.20296483631153248,129260.23046339185,1447.806820130343,130708.0372835222,184,4,75.8,35,5,21,36.484653615600585,0.6148809523809524,45.775462962962976,1016.89814814815,29.054232804232857,0
198,4,1,1,39,0.025,0.025,0.975,40,1350,1000,350,0.7407407407407407,17,10,7,366.5367945866495,0.4485309829059829,0.2874872057318323,0.20463225617780384,129466.28146701396,1490.8311631944548,130957.11263020842,185,0,76.0,35,5,20,36.24722790856364,0.6169642857142856,45.57291666666667,1017.7083333333339,29.07738095238097,0
199,4,1,0,40,0.025,0.0,1.0,40,1600,1300,300,0.8125,19,13,6,363.1280991735535,0.4450320512820513,0.28377272727272684,0.20379638218923934,129672.4965706448,1417.5454389574836,131090.04200960227,186,0,76.975,35,5,21,36.12405303030302,0.6190476190476191,45.370370370370374,1018.5185185185192,29.10052910052912,0
200,4,0,0,40,0.0,0.0,1.0,40,1300,1000,300,0.7692307692307693,16,10,6,362.7695312993494,0.44459134615384616,0.285541860729297,0.20405496383566588,129760.9247068972,1414.661967378247,131175.58667427546,187,1,77.975,35,5,21,36.043228634177744,0.6199404761904762,45.28356481481481,1018.8657407407401,29.110449735449716,0
201,4,0,0,40,0.0,0.0,1.0,40,1350,900,450,0.6666666666666666,18,9,9,360.7916213526568,0.44356303418803417,0.28780238594940943,0.20375836232723654,129917.93894823885,1374.6607671861157,131292.59971542496,188,2,78.975,36,4,21,35.93399057402706,0.6195023148148149,45.12950450450451,1019.4819819819825,28.318943943943957,0
202,4,2,0,42,0.047619047619047616,0.0,1.0,42,1000,700,300,0.7,13,7,6,346.81958339386097,0.4460414246999613,0.2746297725351847,0.1984858322375845,130435.08193582096,648.4012306225105,131083.48316644348,189,0,76.16666666666667,36,6,23,35.76576452430823,0.6247106481481481,44.622747747747745,1021.509009009009,28.37525025025025,0
203,4,0,2,40,0.0,0.047619047619047616,0.9523809523809523,42,1000,700,300,0.7,13,7,6,345.3919510658805,0.4450493612078978,0.2718431063885609,0.19825629069720832,130550.14209733374,618.1936581852019,131168.33575551893,190,1,77.16666666666667,36,6,15,35.68572084481175,0.6258680555555556,44.51013513513513,1021.9594594594588,28.387762762762744,0
204,4,1,2,39,0.024390243902439025,0.04878048780487805,0.9512195121951219,41,1300,800,500,0.6153846153846154,18,8,10,351.7274195223995,0.44192073170731705,0.27441924702372744,0.20193453279471926,130558.1342699758,984.1751328874923,131542.3094028633,191,0,79.97560975609755,35,6,16,35.515760664401654,0.6279761904761905,44.5023148148148,1021.9907407407392,29.199735449735403,0
205,4,0,0,39,0.0,0.0,1.0,39,1300,1000,300,0.7692307692307693,16,10,6,361.9991976213129,0.44104251012145745,0.2613585769395117,0.20722582486914506,130444.94224773237,1644.192885487519,132089.13513321988,184,6,80.17948717948718,34,5,22,35.368109777415214,0.6289828431372548,44.613095238095234,1021.5476190476186,30.0455182072829,0
206,4,0,0,39,0.0,0.0,1.0,39,1200,700,500,0.5833333333333334,17,7,10,360.33176397701345,0.44084570400359874,0.26213215311747806,0.20708223062293418,130597.00255102034,1611.6496598639328,132208.65221088426,185,7,81.17948717948718,34,5,16,35.25652224551594,0.6305147058823529,44.46428571428571,1022.1428571428567,30.06302521008402,0
207,4,1,2,38,0.025,0.05,0.95,40,1150,700,450,0.6086956521739131,16,7,9,352.3195138575861,0.44055822649572646,0.25985242564740507,0.20429911219951669,130942.84664619755,1226.7440147033408,132169.5906609009,186,0,80.125,35,5,20,35.11122262429792,0.6318452380952381,44.1261574074074,1023.4953703703691,29.24272486772483,0
208,4,0,1,37,0.0,0.02631578947368421,0.9736842105263158,38,900,400,500,0.4444444444444444,14,4,10,354.6884784329932,0.4394707207207207,0.23514036311994224,0.2057767569208418,130962.30867346934,1690.1643990929633,132652.4730725623,187,1,77.73684210526316,34,4,21,35.030918042955726,0.6341911764705883,44.107142857142854,1023.5714285714282,30.105042016806713,0
209,4,0,0,37,0.0,0.0,1.0,37,800,500,300,0.625,11,5,6,358.5015542196972,0.4398460960960961,0.2229859169514341,0.20793090144742468,130951.55709342581,1989.2673490965294,132940.82444252234,188,2,78.94594594594595,33,4,21,34.94422493614305,0.6363636363636364,44.11764705882354,1023.5294117647076,31.016042780748712,0
210,4,0,0,37,0.0,0.0,1.0,37,1450,1000,450,0.6896551724137931,19,10,9,358.98693874288705,0.43956456456456455,0.22249028973930218,0.20906298585883704,131108.39468293474,2013.2402501442125,133121.63493307895,189,3,79.94594594594595,33,4,22,34.77311934107137,0.6379419191919191,43.964460784313744,1024.1421568627475,31.03461081402265,0
211,4,0,1,36,0.0,0.02702702702702703,0.972972972972973,37,900,600,300,0.6666666666666666,12,6,6,357.1724548430665,0.4388763763763764,0.22118194749773656,0.20851688006201397,131202.54229142654,1972.3868223760278,133174.92911380256,190,4,80.94594594594595,33,4,22,34.72438197767145,0.6388888888888888,43.87254901960785,1024.50980392157,31.04575163398697,0
212,4,0,0,36,0.0,0.0,1.0,36,1050,800,250,0.7619047619047619,13,8,5,366.4556856174576,0.43885582010582014,0.22812029045074667,0.21319624177601024,131069.41415416797,2406.2264054688303,133475.6405596368,191,5,83.86111111111111,32,4,22,34.621352240032884,0.6399739583333333,44.00252525252525,1023.9898989898992,31.99968434343435,0
213,4,1,0,37,0.02702702702702703,0.0,1.0,37,1400,1000,400,0.7142857142857143,18,10,8,355.90099111814874,0.43956456456456455,0.2184256684077408,0.20897007667968778,131422.35145436847,1954.6690275374826,133377.02048190596,192,0,82.56756756756756,33,4,23,34.53485418907613,0.6410984848484849,43.658088235294116,1025.3676470588234,31.071746880570405,0
214,4,0,1,36,0.0,0.02702702702702703,0.972972972972973,37,1200,900,300,0.75,15,9,6,356.95738234220545,0.4385635635635636,0.21837269663356618,0.21045402851893966,131579.47063629367,1993.652681660892,133573.12331795457,193,1,83.56756756756756,33,4,19,34.34912008281573,0.6426767676767677,43.50490196078431,1025.9803921568623,31.090314913844313,0
215,4,1,1,36,0.02702702702702703,0.02702702702702703,0.972972972972973,37,1800,1400,400,0.7777777777777778,22,14,8,349.7942919672184,0.4371246246246246,0.2061605216939404,0.20869206099191384,132030.69905045335,1836.7169784580346,133867.4160289114,194,0,80.5945945945946,34,3,20,34.078053206687514,0.6449142156862745,43.06547619047618,1027.738095238094,30.22759103641453,0
216,4,0,0,36,0.0,0.0,1.0,36,900,800,100,0.8888888888888888,10,8,2,359.8039901419058,0.43693783068783065,0.21405228758169947,0.21371490016862582,131862.52170138882,2288.9322916666624,134151.45399305547,195,1,83.77777777777777,33,3,20,33.99044962812712,0.6455176767676767,43.229166666666664,1027.0833333333328,31.123737373737356,0
217,4,0,0,36,0.0,0.0,1.0,36,1450,1100,350,0.7586206896551724,18,11,7,357.48568734769975,0.43574735449735447,0.215252115866015,0.21375248974767308,132114.37795859764,2245.7998426086133,134360.17780120627,196,2,84.77777777777777,33,3,21,33.79611693884849,0.6480429292929293,42.98406862745098,1028.063725490196,31.153446226975635,0
218,4,0,1,35,0.0,0.027777777777777776,0.9722222222222222,36,850,700,150,0.8235294117647058,10,7,3,357.30052292693034,0.4357142857142857,0.21915345807015463,0.21399776501640758,132177.37956855522,2245.409367791218,134422.78893634645,197,3,85.77777777777777,33,3,22,33.73741210821118,0.6486742424242424,42.92279411764705,1028.3088235294106,31.16087344028517,0
219,4,0,0,35,0.0,0.0,1.0,35,1300,1000,300,0.7692307692307693,16,10,6,368.0054407546162,0.43343837535014007,0.23266258486693214,0.220181359593302,132138.24043783805,2725.518282573212,134863.75872041125,198,4,88.91428571428571,32,3,22,33.501678333128645,0.6507161458333333,42.96085858585859,1028.1565656565663,32.129892676767696,0
220,4,0,0,35,0.0,0.0,1.0,35,1400,1000,400,0.7142857142857143,18,10,8,379.8481003526049,0.43263305322128853,0.18565765765765785,0.21555797105899338,130106.256082396,2884.1228433775204,132990.37892577352,199,5,89.91428571428571,33,2,16,35.25663163163162,0.6278409090909092,44.94485294117646,1020.2205882352926,30.91577540106947,8
221,4,1,0,36,0.027777777777777776,0.0,1.0,36,1200,800,400,0.6666666666666666,16,8,8,368.6777287727087,0.4341435185185185,0.1857191865056247,0.21138015671717791,130505.75573979564,2422.913123582728,132928.66886337838,200,0,88.38888888888889,34,2,15,35.13583051769,0.6295955882352942,44.55357142857141,1021.7857142857121,30.052521008403296,0
222,4,0,0,36,0.0,0.0,1.0,36,1250,900,350,0.72,16,9,7,370.6570595392477,0.43369708994708994,0.19124118294182435,0.21284888669862453,130566.58340419478,2479.0851757369364,133045.66857993172,201,1,89.38888888888889,34,2,15,35.023539118617755,0.6302083333333333,44.494047619047606,1022.0238095238076,30.059523809523753,0
223,4,1,1,36,0.02702702702702703,0.02702702702702703,0.972972972972973,37,950,600,350,0.631578947368421,13,6,7,360.43897545095354,0.4341841841841842,0.1867922220863405,0.2085262135462319,130854.01663237282,2032.9775377228777,132886.99417009568,202,0,87.94594594594595,35,2,16,34.99340120663651,0.6309523809523809,44.21296296296295,1023.1481481481458,29.232804232804163,0
224,4,0,0,36,0.0,0.0,1.0,36,1300,1000,300,0.7692307692307693,16,10,6,366.452741084116,0.4331845238095238,0.18381687482222775,0.21193101324878127,130840.48327664382,2389.3707482993022,133229.8540249431,203,1,88.94444444444444,34,2,16,34.85328911643782,0.6329656862745099,44.22619047619047,1023.0952380952368,30.09103641456579,0
225,4,1,0,37,0.02702702702702703,0.0,1.0,37,1050,800,250,0.7619047619047619,13,8,5,358.2372881355934,0.43465340340340336,0.18455336692624869,0.2088537549407114,131150.23389274674,1996.5808256172616,133146.814718364,204,0,87.51351351351352,35,2,17,34.74999999999999,0.6339285714285714,43.9236111111111,1024.305555555554,29.265873015872973,0
226,4,0,1,36,0.0,0.02702702702702703,0.972972972972973,37,1000,800,200,0.8,12,8,4,361.36078001440205,0.4339339339339339,0.18241793786560656,0.21181816205079781,131357.78523930453,2093.510347007864,133451.2955863124,205,1,88.51351351351352,35,2,18,34.46014922283691,0.6360119047619048,43.7210648148148,1025.1157407407393,29.289021164021122,0
227,4,0,0,36,0.0,0.0,1.0,36,950,700,250,0.7368421052631579,12,7,5,360.8982507223147,0.43206018518518513,0.15991499285338162,0.21236920968799128,131506.13667052455,2292.066936728376,133798.20360725292,206,2,87.08333333333333,35,1,18,34.32210561949898,0.6375,43.57638888888888,1025.6944444444432,29.30555555555552,0
228,4,0,1,35,0.0,0.027777777777777776,0.9722222222222222,36,700,600,100,0.8571428571428571,8,6,2,357.8036022572087,0.43154761904761907,0.15157924421883884,0.21103984923553895,131595.18771701367,2217.046440972198,133812.23415798586,207,3,88.08333333333333,35,1,15,34.31154822335025,0.6383928571428572,43.48958333333332,1026.041666666665,29.31547619047614,0
229,4,1,0,36,0.027777777777777776,0.0,1.0,36,850,500,350,0.5882352941176471,12,5,7,361.57563211400134,0.43381283068783066,0.1507113515679792,0.21443175187937288,131803.0907064471,2331.3571673525266,134134.44787379963,208,0,87.61111111111111,35,1,16,34.00492185151788,0.6404761904761904,43.28703703703703,1026.851851851851,29.338624338624317,0
230,4,1,2,35,0.02702702702702703,0.05405405405405406,0.9459459459459459,37,1150,800,350,0.6956521739130435,15,8,7,355.76474063213954,0.43502877877877877,0.14854946961420823,0.21269000112840897,132108.41912436092,1999.90349302006,134108.322617381,209,0,86.21621621621621,36,1,17,33.84635045824662,0.6414930555555556,42.98986486486487,1028.0405405405413,28.556681681681702,0
231,4,0,0,35,0.0,0.0,1.0,35,1350,800,550,0.5925925925925926,19,8,11,367.5293365134572,0.43350840336134455,0.15734816875289726,0.2183913991348559,131877.80612244888,2693.792517006792,134571.59863945568,210,1,91.8,34,1,18,33.77665739452943,0.6433823529411764,43.21428571428571,1027.1428571428564,30.210084033613423,0
232,4,0,0,35,0.0,0.0,1.0,35,1200,800,400,0.6666666666666666,16,8,8,367.04556108074155,0.4322829131652661,0.1506716072255676,0.21951561395382835,132122.4773242629,2698.9937641723186,134821.4710884352,211,2,92.8,34,1,18,33.542245638412844,0.6458333333333333,42.97619047619047,1028.0952380952372,30.238095238095212,0
233,4,0,0,35,0.0,0.0,1.0,35,850,700,150,0.8235294117647058,10,7,3,367.6491834542108,0.43168767507002803,0.15415605464227866,0.22023256911771633,132183.68055555542,2719.4444444444257,134903.12499999985,212,3,93.8,34,1,18,33.46501890869799,0.6464460784313726,42.91666666666666,1028.3333333333321,30.24509803921565,0
234,4,0,1,34,0.0,0.02857142857142857,0.9714285714285714,35,1400,700,700,0.5,21,7,14,373.6496248144774,0.429936974789916,0.1603330634902278,0.22546743236362787,132459.27047902497,2898.671343537417,135357.9418225624,213,4,94.8,34,1,18,33.03289194711074,0.649203431372549,42.648809523809526,1029.4047619047622,30.276610644257712,0
235,4,0,1,33,0.0,0.029411764705882353,0.9705882352941176,34,750,400,350,0.5333333333333333,11,4,7,383.0557980533097,0.4298685383244207,0.16014084013593566,0.23018993734126952,132303.42784325744,3335.919027537493,135639.34687079492,214,5,96.61764705882354,33,1,18,32.948059360730596,0.6499368686868687,42.80024509803922,1028.7990196078435,31.17572786690435,0
236,4,1,0,34,0.029411764705882353,0.0,1.0,34,1050,700,350,0.6666666666666666,14,7,7,376.64262785958374,0.430017082590612,0.1692287768374039,0.227856587610085,132555.70461180783,3185.225784554002,135740.93039636183,215,0,96.20588235294117,33,1,19,32.85867646475466,0.6524621212121212,42.55514705882352,1029.779411764705,31.205436720142576,0
237,4,0,0,34,0.0,0.0,1.0,34,1300,900,400,0.6923076923076923,17,9,8,378.2775796631266,0.4292929292929293,0.17210098027554088,0.229615856478549,132681.93310565644,3238.1201040465144,135920.05320970295,216,1,97.20588235294117,33,1,16,32.68940069783117,0.6537247474747474,42.432598039215684,1030.269607843137,31.220291146761728,0
238,4,0,1,33,0.0,0.029411764705882353,0.9705882352941176,34,1050,900,150,0.8571428571428571,12,9,3,390.6058959193889,0.42875445632798576,0.140583438712772,0.22422440578521516,130552.7576905418,3431.4086139489423,133984.16630449073,217,2,98.20588235294117,32,2,16,34.52789103039289,0.634765625,44.50757575757576,1021.969696969697,31.93655303030303,7
239,4,0,0,33,0.0,0.0,1.0,33,1050,600,450,0.5714285714285714,15,6,9,398.65780638211663,0.42803030303030304,0.1621796875904633,0.2292939514949451,130628.37600708021,3815.2043660481922,134443.5803731284,218,9,102.12121212121212,31,2,17,34.2452394599414,0.6381048387096775,44.43359375000001,1022.265625000001,32.976310483871,0
240,4,0,0,33,0.0,0.0,1.0,33,950,600,350,0.631578947368421,13,6,7,397.132439104308,0.4273595328282828,0.15934748555069422,0.22900720827644908,130728.22570800791,3783.283827039944,134511.50953504787,219,10,103.12121212121212,31,2,18,34.18268822680588,0.6391129032258065,44.33593750000001,1022.6562500000008,32.988911290322605,0
241,4,0,1,32,0.0,0.030303030303030304,0.9696969696969697,33,1150,1000,150,0.8695652173913043,13,10,3,398.1393267693135,0.42625473484848486,0.173798038920828,0.2305804693500396,130894.72664727118,3822.8676689995837,134717.59431627076,220,11,104.12121212121212,31,2,19,33.98770517877593,0.6407930107526882,44.17317708333334,1023.3072916666677,33.009912634408636,0
242,4,0,0,32,0.0,0.0,1.0,32,850,500,350,0.5882352941176471,12,5,7,393.24674088186845,0.42473118279569894,0.1572037131230919,0.22873464277330008,131061.33355034741,3907.8884548611354,134969.22200520855,221,12,106.25,31,1,19,33.94370973211259,0.6424731182795699,44.01041666666668,1023.9583333333348,33.030913978494674,0
243,4,0,1,31,0.0,0.03125,0.96875,32,1000,500,500,0.5,15,5,10,393.07200593412824,0.4240171370967742,0.1572193618103228,0.2290299554576189,131128.00598144543,3908.5496690538334,135036.55565049927,222,13,107.25,31,1,19,33.88051953555386,0.6431451612903225,43.94531250000001,1024.218750000001,33.03931451612906,0
244,4,0,1,30,0.0,0.03225806451612903,0.967741935483871,31,1100,800,300,0.7272727272727273,14,8,6,397.7247390193228,0.423073476702509,0.15550214940933582,0.232534770727248,131259.24962423384,4241.010160134097,135500.25978436793,223,14,109.06451612903226,30,1,19,33.62818074501573,0.6472222222222221,43.81720430107526,1024.7311827956976,34.15770609318992,0
245,4,1,0,31,0.03225806451612903,0.0,1.0,31,900,700,200,0.7777777777777778,11,7,4,396.56675673388406,0.4219982078853047,0.15087849772241335,0.23395599852445692,131603.8071597873,4237.938995837675,135841.74615562498,224,0,107.87096774193549,30,1,18,33.30849925770675,0.6506944444444445,43.48118279569893,1026.0752688172047,34.20250896057349,0
246,4,0,0,31,0.0,0.0,1.0,31,900,700,200,0.7777777777777778,11,7,4,399.4216977569945,0.4222222222222222,0.14908479672942576,0.23649480057890873,131741.75663371483,4324.103220025431,136065.85985374026,225,1,108.87096774193549,30,1,18,33.09548747490617,0.6520833333333333,43.346774193548384,1026.6129032258061,34.22043010752687,0
247,4,0,0,31,0.0,0.0,1.0,31,850,700,150,0.8235294117647058,10,7,3,399.4216977569945,0.42172939068100357,0.14908479672942576,0.23649480057890873,131741.75663371483,4324.103220025431,136065.85985374026,226,2,109.87096774193549,30,1,18,33.09548747490617,0.6520833333333333,43.346774193548384,1026.6129032258061,34.22043010752687,0
248,4,2,0,33,0.06060606060606061,0.0,1.0,33,900,700,200,0.7777777777777778,11,7,4,378.4319248588629,0.4276751893939394,0.13753894932487842,0.21304410664870954,129793.87622849361,3223.629283208351,133017.50551170195,227,0,104.15151515151516,33,0,17,35.61071858087792,0.6246843434343434,45.25122549019606,1018.9950980392138,30.87863933452163,8
249,4,0,0,33,0.0,0.0,1.0,33,1000,700,300,0.7,13,7,6,373.6418706529362,0.42732007575757575,0.12731716734601717,0.21102014405714692,129918.78311526799,3108.6194312283524,133027.40254649633,228,1,105.15151515151516,33,0,17,35.605616660656324,0.6259469696969697,45.128676470588225,1019.4852941176456,30.893493761140775,0
250,4,0,0,33,0.0,0.0,1.0,33,1350,900,450,0.6666666666666666,18,9,9,377.71055741463516,0.42641256313131315,0.13171241430282632,0.21400169975234912,130043.75007509124,3223.7794658304383,133267.52954092168,229,2,106.15151515151516,33,0,17,35.37473967719973,0.627209595959596,45.00612745098039,1019.9754901960779,30.908348187759938,0
251,4,0,0,33,0.0,0.0,1.0,33,900,500,400,0.5555555555555556,13,5,8,374.564158857104,0.425741792929293,0.12770510776756305,0.212729958161272,130137.51471789693,3148.969747212611,133286.48446510953,230,3,107.15151515151516,33,0,18,35.35961646248698,0.6281565656565656,44.91421568627451,1020.3431372549018,30.919489007724295,0
252,4,1,0,34,0.029411764705882353,0.0,1.0,34,950,600,350,0.631578947368421,13,6,7,398.9636980718915,0.4295157456922163,0.17355828527023465,0.2136177464497843,127803.5359747453,3417.257935649748,131220.79391039506,231,0,104.97058823529412,33,1,18,37.12668666424271,0.6044823232323233,47.21200980392157,1011.1519607843138,30.640968508615572,8
253,4,4,3,35,0.10526315789473684,0.07894736842105263,0.9210526315789473,38,1150,800,350,0.6956521739130435,15,8,7,362.9927679158449,0.4369369369369369,0.1597031039136303,0.19995364334347399,128936.76757812509,1761.531434724638,130698.29901284972,232,0,94.8157894736842,35,3,16,36.877136752136764,0.6116071428571428,46.09375000000001,1015.6250000000007,29.017857142857164,0
254,4,0,0,35,0.0,0.0,1.0,35,1500,1200,300,0.8,18,12,6,387.52151173586736,0.4309873949579832,0.18306443254448124,0.2105652366659412,128392.81316080366,2950.995410419088,131343.80857122276,233,1,103.94285714285714,33,2,16,36.81126561870215,0.610479797979798,46.62990196078432,1013.4803921568637,30.711527035056474,0
255,4,1,0,36,0.027777777777777776,0.0,1.0,36,950,300,650,0.3157894736842105,16,3,13,383.6736896653815,0.433316798941799,0.18177227890491632,0.2106623021105414,128808.33510487531,2684.073837868479,131492.4089427438,234,0,102.02777777777777,34,2,19,36.483376333997874,0.6124387254901961,46.220238095238095,1015.1190476190478,29.85644257703082,0
256,4,2,1,37,0.05263157894736842,0.02631578947368421,0.9736842105263158,38,1100,700,400,0.6363636363636364,15,7,8,364.9059652458881,0.4336178283546705,0.17263502696845,0.20360419000795382,129443.5657596372,1848.14342403628,131291.7091836735,235,0,97.60526315789474,34,4,18,36.31185657463733,0.6188725490196079,45.595238095238095,1017.6190476190478,29.929971988795526,0
257,4,0,1,36,0.0,0.02702702702702703,0.972972972972973,37,1050,600,450,0.5714285714285714,15,6,9,373.572377829212,0.4335272772772773,0.1751512901187522,0.2074902002159842,129263.6921496541,2257.8689686659145,131521.56111832,236,1,101.24324324324324,33,4,22,36.2748051739375,0.6193181818181819,45.77205882352942,1016.9117647058833,30.815508021390404,0
258,4,0,0,36,0.0,0.0,1.0,36,1300,800,500,0.6153846153846154,18,8,10,375.05545531832723,0.43381283068783066,0.15335313637336734,0.20930514119377616,129450.6920415225,2510.2376489811572,131960.92969050366,232,2,98.5,33,3,19,36.046383269107245,0.6212121212121212,45.588235294117645,1017.6470588235295,30.837789661319075,0
259,4,0,0,36,0.0,0.0,1.0,36,1400,1100,300,0.7857142857142857,17,11,6,380.9353123273982,0.4327215608465609,0.1606034639453664,0.21419477022982075,129746.60572562352,2685.012755102034,132431.61848072556,233,3,99.5,34,2,20,35.59510594375634,0.6219362745098039,45.297619047619044,1018.8095238095233,29.964985994397743,0
260,4,3,2,37,0.07692307692307693,0.05128205128205128,0.9487179487179487,39,950,600,350,0.631578947368421,13,6,7,357.6929930408518,0.4355038236617184,0.16543617998163418,0.2053171354741132,130550.14209733385,1540.398164987937,132090.5402623218,234,0,92.76923076923077,36,3,18,35.37144168962351,0.6258680555555556,44.51013513513514,1021.9594594594597,28.38776276276277,0
261,4,0,1,36,0.0,0.02702702702702703,0.972972972972973,37,1100,700,400,0.6363636363636364,15,7,8,375.79560742516287,0.4313063063063063,0.1812635671858971,0.2139580016144269,130233.84871357845,2388.2616569271977,132622.11037050566,235,1,98.64864864864865,36,1,22,35.230260738452486,0.6226851851851851,44.81981981981982,1020.7207207207208,28.353353353353356,0
262,4,0,1,35,0.0,0.027777777777777776,0.9722222222222222,36,1300,1000,300,0.7692307692307693,16,10,6,374.2848061029881,0.4308035714285714,0.18356643356643354,0.2140909090909089,130414.54081632635,2562.439394889903,132976.98021121626,236,2,101.11111111111111,34,2,22,35.08522727272727,0.6286764705882353,44.64285714285713,1021.42857142857,30.042016806722646,0
263,4,0,1,34,0.0,0.02857142857142857,0.9714285714285714,35,1050,800,250,0.7619047619047619,13,8,5,380.99081232508627,0.42860644257703084,0.20079831428914074,0.21865673668127286,130544.21864487216,2947.229581170703,133491.44822604288,237,3,104.08571428571429,33,2,19,34.78222308829997,0.632260101010101,44.51593137254902,1021.9362745098039,30.967765894236482,0
264,4,0,0,34,0.0,0.0,1.0,34,1100,800,300,0.7272727272727273,14,8,6,386.26831285444223,0.42778891859774215,0.19884910485933527,0.2221042798913044,130617.28395061736,3290.6635802469254,133907.9475308643,238,4,105.6470588235294,32,2,19,34.57314311594204,0.6354166666666667,44.44444444444445,1022.2222222222229,31.944444444444464,0
265,4,1,0,35,0.02857142857142857,0.0,1.0,35,1250,1100,150,0.88,14,11,3,379.59678527297774,0.429936974789916,0.19162078046444808,0.2205251421537175,131014.2808655326,2946.519968281442,133960.80083381402,239,0,103.6,33,2,21,34.340834729869925,0.6369949494949495,44.05637254901961,1023.7745098039225,31.023469994058257,0
266,4,0,0,35,0.0,0.0,1.0,35,1250,1000,250,0.8,15,10,5,376.5949702019135,0.4301120448179272,0.18986086897070398,0.21949656631433714,131139.77346453295,2877.3158160323023,134017.08928056524,240,1,104.6,33,2,21,34.29050011964585,0.6382575757575757,43.93382352941177,1024.2647058823536,31.038324420677384,0
267,4,0,0,35,0.0,0.0,1.0,35,1300,900,400,0.6923076923076923,17,9,8,376.41439065496047,0.4295168067226891,0.19507294905524986,0.2201102891368378,131265.32613658212,2882.031550365247,134147.35768694736,241,2,105.6,33,2,21,34.16796220999761,0.639520202020202,43.81127450980392,1024.7549019607845,31.0531788472965,0
268,4,0,0,35,0.0,0.0,1.0,35,1250,900,350,0.72,16,9,7,381.0478588699111,0.42888655462184877,0.20218440436880858,0.2235745782966975,131394.86524793843,3013.5764503699056,134408.44169830834,242,3,106.6,31,4,21,33.918063669460665,0.6458333333333333,43.684895833333336,1025.2604166666672,33.072916666666686,0
269,4,0,0,35,0.0,0.0,1.0,35,1000,700,300,0.7,13,7,6,375.44789231695404,0.42825630252100844,0.14085261206837396,0.21289020815029444,130075.00120146088,2767.27700884274,132842.27821030363,243,4,107.6,33,2,18,35.400648726573756,0.6275252525252526,44.975490196078425,1020.0980392156855,30.91206179441471,8
270,4,0,0,35,0.0,0.0,1.0,35,1100,700,400,0.6363636363636364,15,7,8,373.66430183508135,0.4283263305322129,0.13643894825309189,0.21273068831062164,130231.31315179265,2732.558541186094,132963.87169297875,244,5,108.6,33,2,19,35.287224356665476,0.6291035353535354,44.82230392156863,1020.710784313726,30.930629827688666,0
271,4,0,0,35,0.0,0.0,1.0,35,1500,900,600,0.6,21,9,12,375.20929962680646,0.42794117647058827,0.13856594461200955,0.21481763198413872,130450.30757401002,2789.233708189161,133239.54128219918,245,6,109.6,33,2,20,35.025291906589885,0.6313131313131313,44.6078431372549,1021.5686274509807,30.956625074272143,0
272,4,0,1,34,0.0,0.02857142857142857,0.9714285714285714,35,1300,900,400,0.6923076923076923,17,9,8,377.0385200733841,0.4271008403361345,0.13463027023324314,0.21691416099670147,130638.16350682436,2851.123966743571,133489.28747356794,246,7,110.6,33,2,19,34.787820666506846,0.6332070707070707,44.42401960784314,1022.303921568628,30.978906714200846,0
273,4,0,1,33,0.0,0.029411764705882353,0.9705882352941176,34,1100,800,300,0.7272727272727273,14,8,6,381.0956838953841,0.4241495840760547,0.14326656931761228,0.21931284665962533,130649.55305899921,3157.996154729127,133807.54921372834,247,8,113.58823529411765,32,2,19,34.67256391256021,0.6357421875,44.412878787878796,1022.348484848486,31.948390151515188,0
274,4,0,0,33,0.0,0.0,1.0,33,900,500,400,0.5555555555555556,13,5,8,391.8656643119646,0.42329545454545453,0.15068509016782694,0.22500026329075418,130561.83073255746,3632.539706759978,134194.37043931743,248,9,117.51515151515152,31,2,19,34.48647916932092,0.6374327956989247,44.498697916666664,1022.0052083333329,32.967909946236546,0
275,4,0,0,33,0.0,0.0,1.0,33,750,600,150,0.8,9,6,3,392.34483822783864,0.423019255050505,0.1469876448860017,0.2256629542070888,130628.37600708008,3650.2738104926225,134278.6498175727,249,10,118.51515151515152,31,2,19,34.40657771833736,0.6381048387096775,44.43359375,1022.265625,32.97631048387097,0
276,4,0,0,33,0.0,0.0,1.0,33,1050,800,250,0.7619047619047619,13,8,5,390.86448123244855,0.4228219696969697,0.13713509843856042,0.22578171798250865,130794.81336805562,3624.609375000005,134419.42274305562,250,11,119.51515151515152,31,2,19,34.27528852681601,0.6397849462365591,44.270833333333336,1022.9166666666672,32.997311827957006,0
277,4,0,0,33,0.0,0.0,1.0,33,750,400,350,0.5333333333333333,11,4,7,391.2002583924705,0.42254577020202017,0.1331914023781151,0.22617074541498464,130828.11355590829,3635.9983656141635,134464.11192152245,251,12,120.51515151515152,31,2,19,34.23287620380978,0.6401209677419355,44.23828125000001,1023.0468750000007,33.00151209677421,0
278,4,0,0,33,0.0,0.0,1.0,33,900,600,300,0.6666666666666666,12,6,6,390.19848428205916,0.4225852272727273,0.13319759056587777,0.22578642779737992,130861.41798231332,3612.385389539925,134473.80337185325,252,13,121.51515151515152,31,2,19,34.224675489946556,0.6404569892473118,44.205729166666664,1023.1770833333329,33.005712365591386,0
279,4,0,0,33,0.0,0.0,1.0,33,1050,800,250,0.7619047619047619,13,8,5,390.1148114434097,0.42199337121212116,0.13642338664600406,0.22632417215916206,130961.35669284409,3617.9929945204094,134579.3496873645,253,14,122.51515151515152,31,2,19,34.12534982826612,0.6414650537634409,44.10807291666667,1023.5677083333343,33.018313172043044,0
280,4,0,0,33,0.0,0.0,1.0,33,700,500,200,0.7142857142857143,9,5,4,392.9155770168133,0.4211253156565657,0.13200160300872343,0.22854201905770877,131061.33355034735,3699.2078993055657,134760.54144965293,254,15,123.51515151515152,31,2,19,33.9521871820956,0.6424731182795699,44.01041666666667,1023.9583333333344,33.03091397849466,0
281,4,0,0,33,0.0,0.0,1.0,33,900,700,200,0.7777777777777778,11,7,4,395.28506921403357,0.4202572601010101,0.13892323514797145,0.23051946919991106,131161.34855482308,3769.2245483398387,134930.57310316293,255,16,124.51515151515152,31,2,19,33.790014194313805,0.643481182795699,43.912760416666664,1024.348958333333,33.043514784946225,0
282,4,0,0,33,0.0,0.0,1.0,33,800,400,400,0.5,12,4,8,393.11044060252414,0.4189157196969697,0.13919143153039748,0.2300499834931202,131294.76123385952,3722.6682874891403,135017.42952134865,256,17,125.51515151515152,31,2,19,33.71037669927583,0.6448252688172043,43.78255208333333,1024.869791666666,33.060315860215034,0
283,4,0,0,33,0.0,0.0,1.0,33,1000,700,300,0.7,13,7,6,389.77902746283723,0.418560606060606,0.13896681096681096,0.2288970798858941,131428.2417297362,3645.594448513441,135073.83617824965,257,18,126.51515151515152,31,2,20,33.66044973544973,0.6461693548387097,43.65234374999999,1025.390624999999,33.07711693548384,0
284,4,0,0,33,0.0,0.0,1.0,33,1000,400,600,0.4,16,4,12,391.52444021919,0.41773200757575757,0.14147052152887518,0.23153692139894036,131695.40617201067,3712.3940361870705,135407.80020819773,258,19,127.51515151515152,31,2,17,33.345093872891034,0.6488575268817205,43.391927083333336,1026.432291666667,33.11071908602152,0
285,4,1,0,34,0.029411764705882353,0.0,1.0,34,850,500,350,0.5882352941176471,12,5,7,385.08561706819575,0.4199346405228758,0.13940157912606277,0.23040060101295512,132138.24043783802,3376.907171462099,135515.14760930013,259,0,124.73529411764706,32,2,18,33.06265094764418,0.6507161458333333,42.96085858585859,1028.156565656566,32.12989267676769,0
286,4,0,0,34,0.0,0.0,1.0,34,850,500,350,0.5882352941176471,12,5,7,385.08561706819575,0.4199346405228758,0.13940157912606277,0.23040060101295512,132138.24043783802,3376.907171462099,135515.14760930013,260,1,125.73529411764706,32,2,18,33.06265094764418,0.6507161458333333,42.96085858585859,1028.156565656566,32.12989267676769,0
287,4,0,0,34,0.0,0.0,1.0,34,950,600,350,0.631578947368421,13,6,7,416.82403677898753,0.4189505347593583,0.16541392943581745,0.23468092890880235,129797.77865939653,4088.022461809319,133885.80112120585,261,2,126.73529411764706,31,3,17,34.62869494846238,0.6297043010752688,45.24739583333332,1019.0104166666653,32.871303763440814,8
288,4,0,0,34,0.0,0.0,1.0,34,900,500,400,0.5555555555555556,13,5,8,414.70194376346683,0.41891339869281047,0.17156487115919172,0.23427966952871163,129930.49621582021,3976.485866970473,133906.9820827907,262,3,127.73529411764706,31,3,19,34.547147722435064,0.6310483870967742,45.11718749999999,1019.5312499999992,32.88810483870965,0
289,4,0,0,34,0.0,0.0,1.0,34,1400,1000,400,0.7142857142857143,18,10,8,418.6218160072172,0.41961898395721925,0.10490788818550456,0.22746402223256812,128392.81316080355,3949.606521530186,132342.41968233374,263,4,128.73529411764707,33,1,17,36.02327690447403,0.610479797979798,46.629901960784316,1013.4803921568628,30.71152703505645,8
290,4,0,0,34,0.0,0.0,1.0,34,850,600,250,0.7058823529411765,11,6,5,422.43807209403417,0.419674688057041,0.11393192596753465,0.23007440226688228,128485.98082768633,4055.474006391758,132541.4548340781,264,5,129.73529411764707,33,1,17,35.830789919013675,0.6114267676767677,46.537990196078425,1013.8480392156852,30.722667855020763,0
291,4,2,1,35,0.05555555555555555,0.027777777777777776,0.9722222222222222,36,800,700,100,0.875,9,7,2,403.7201062059866,0.4239252645502645,0.1157628920786824,0.22288396806768196,129024.94454089476,3217.9928626542883,132242.93740354906,265,0,123.47222222222223,35,1,20,35.75273410799727,0.6125,46.00694444444443,1015.9722222222198,29.027777777777708,0
292,4,1,0,36,0.027777777777777776,0.0,1.0,36,800,500,300,0.625,11,5,6,393.6787345143136,0.4268518518518518,0.14363500422599307,0.21915210335015045,129352.72285997722,2984.803811570911,132337.52667154814,266,0,123.72222222222223,34,2,21,35.67266432611663,0.617953431372549,45.6845238095238,1017.2619047619039,29.919467787114822,0
293,4,0,0,36,0.0,0.0,1.0,36,1050,600,450,0.5714285714285714,15,6,9,396.7603598425906,0.42556216931216934,0.14151427717341925,0.22154828976448745,129473.85381235812,3074.0185657596207,132547.87237811775,267,1,124.72222222222223,34,2,18,35.47052286817171,0.6191789215686274,45.56547619047618,1017.7380952380939,29.933473389355704,0
294,4,0,0,36,0.0,0.0,1.0,36,1050,600,450,0.5714285714285714,15,6,9,398.04309475034614,0.425380291005291,0.14026608460659018,0.22277909334456514,129564.7392290248,3114.4699546485076,132679.20918367332,268,2,125.72222222222223,34,2,18,35.34504599314001,0.6200980392156863,45.47619047619047,1018.0952380952369,29.94397759103638,0
295,4,0,1,35,0.0,0.027777777777777776,0.9722222222222222,36,1550,1200,350,0.7741935483870968,19,12,7,397.99581001276863,0.42508267195767196,0.1364090779257876,0.22378765716749488,129746.60572562352,3127.7210884353663,132874.32681405888,269,3,126.72222222222223,34,2,19,35.16057100568669,0.6219362745098039,45.297619047619044,1018.8095238095233,29.964985994397743,0
296,4,0,0,35,0.0,0.0,1.0,35,750,600,150,0.8,9,6,3,404.96176297242397,0.42212885154061625,0.13459859033866284,0.22707370109992192,129637.82709775085,3499.6726018838926,133137.49969963473,270,4,131.22857142857143,33,2,20,35.09426393902928,0.6231060606060606,45.404411764705884,1018.3823529411764,30.860071301247768,0
297,4,0,0,35,0.0,0.0,1.0,35,1000,600,400,0.6,14,6,8,407.8688195516079,0.42254901960784313,0.13765702600058471,0.2292504054721106,129731.44531249997,3582.682291666666,133314.12760416663,271,5,132.22857142857143,33,2,20,34.924591002045,0.6240530303030303,45.3125,1018.7499999999998,30.871212121212114,0
298,4,1,0,36,0.027777777777777776,0.0,1.0,36,1100,900,200,0.8181818181818182,13,9,4,397.380903388842,0.4249338624338624,0.1391093217152266,0.2253578399165446,130080.3589143991,3138.2901077097486,133218.64902210885,272,0,129.52777777777777,34,2,21,34.83584237756253,0.6253063725490196,44.970238095238095,1020.1190476190477,30.003501400560225,0
299,4,1,1,36,0.02702702702702703,0.02702702702702703,0.972972972972973,37,900,600,300,0.6666666666666666,12,6,6,389.65965711498933,0.42661411411411415,0.13525191057596198,0.2223728947316502,130325.14537677824,2756.7453942361317,133081.89077101438,273,0,127.0,33,4,22,34.783565370459264,0.630050505050505,44.73039215686275,1021.0784313725496,30.94177064765302,0
300,4,0,1,35,0.0,0.027777777777777776,0.9722222222222222,36,1600,1400,200,0.875,18,14,4,391.29359794952325,0.4257109788359788,0.05485923136270343,0.21003295652413756,127903.57320011329,2825.9247571577557,130729.49795727104,274,1,124.94444444444444,34,2,16,37.21779255423483,0.6032475490196079,47.113095238095234,1011.5476190476184,29.75140056022407,8
301,4,0,0,35,0.0,0.0,1.0,35,1550,1200,350,0.7741935483870968,19,12,7,400.27326097289756,0.4226890756302521,0.07058945656499249,0.21531311503929743,127989.47707912826,3246.153072135722,131235.630151264,275,2,129.45714285714286,33,2,17,36.90240099309676,0.6063762626262627,47.02818627450981,1011.8872549019611,30.663250148544275,0
302,4,4,1,38,0.10256410256410256,0.02564102564102564,0.9743589743589743,39,1150,900,250,0.782608695652174,14,9,5,367.17150009898427,0.43021817363922626,0.09375821172678456,0.2033102215554402,129142.56071030526,1683.6812768029745,130826.24198710824,276,0,117.07692307692308,35,4,18,36.56105291125789,0.6136904761904762,45.89120370370371,1016.4351851851856,29.041005291005302,0
303,4,2,1,39,0.05,0.025,0.975,40,1300,1100,200,0.8461538461538461,15,11,4,358.3308239555544,0.4344951923076923,0.0940563115388866,0.200306265784432,129516.4267941932,1281.9455857885291,130798.37237998174,277,0,115.1,36,4,15,36.404976582955335,0.6154513888888888,45.52364864864867,1017.9054054054084,28.275150150150232,0
304,4,0,0,39,0.0,0.0,1.0,39,1000,600,400,0.6,14,6,8,367.7139217507445,0.43080859199280247,0.09586727684782526,0.2049824404635889,129407.39300679453,1716.9799972136661,131124.3730040082,278,1,119.05128205128206,35,4,19,36.277276949910906,0.6163690476190475,45.630787037037045,1017.4768518518529,29.070767195767225,0
305,4,0,0,39,0.0,0.0,1.0,39,950,500,450,0.5263157894736842,14,5,9,369.62110902315254,0.43120220422852,0.09195080561921642,0.20650876955207134,129495.73072059324,1772.8711205418372,131268.6018411351,279,2,120.05128205128206,35,4,16,36.13874990523843,0.6172619047619048,45.54398148148148,1017.8240740740738,29.080687830687822,0
306,4,1,1,39,0.025,0.025,0.975,40,1050,900,150,0.8571428571428571,12,9,3,364.8005622083207,0.4321314102564102,0.1095299900585438,0.20602242605564144,129917.93894823904,1478.8274338527976,131396.76638209182,280,0,118.025,36,4,17,35.83181449979748,0.6195023148148149,45.12950450450452,1019.4819819819841,28.318943943944003,0
307,4,1,0,40,0.025,0.0,1.0,40,1350,600,750,0.4444444444444444,21,6,15,365.63612208187453,0.4312633547008547,0.11228748068006222,0.2072548181362717,130061.48674011862,1511.0355287720308,131572.52226889067,281,0,118.9,36,4,19,35.664605873261216,0.6209490740740741,44.988738738738746,1020.045045045046,28.33458458458461,0
308,4,0,0,40,0.0,0.0,1.0,40,1000,700,300,0.7,13,7,6,367.42603726906026,0.4314770299145299,0.10426277452819765,0.20873023973009142,130147.65346004804,1563.9273141384788,131711.58077418653,282,1,119.9,36,4,19,35.53139830040834,0.6218171296296297,44.90427927927929,1020.382882882884,28.343968968969,0
309,4,0,0,40,0.0,0.0,1.0,40,1150,800,350,0.6956521739130435,15,8,7,367.8784090975193,0.43084935897435894,0.10112497085567762,0.2100972698560929,130353.74858276626,1590.9673825093507,131944.71596527562,283,2,120.9,34,6,19,35.3105327582187,0.6280637254901961,44.70238095238094,1021.1904761904747,30.035014005602196,0
310,4,0,0,40,0.0,0.0,1.0,40,1350,1100,250,0.8148148148148148,16,11,5,366.9630680120191,0.4309428418803419,0.10058275058275057,0.2099028749028747,130414.54081632638,1571.4640022675515,131986.00481859394,284,3,121.9,34,6,19,35.27219308469308,0.6286764705882353,44.64285714285713,1021.4285714285702,30.042016806722653,0
311,4,1,2,39,0.024390243902439025,0.04878048780487805,0.9512195121951219,41,1350,1100,250,0.8148148148148148,16,11,5,355.6298653448961,0.4324695121951219,0.08161793477009938,0.20009687467812837,129772.26382725194,1045.1480715560544,130817.411898808,285,0,119.90243902439025,38,3,15,36.21356296529308,0.6143092105263157,45.272435897435905,1018.9102564102575,26.813427800269935,8
312,4,0,1,38,0.0,0.02564102564102564,0.9743589743589743,39,1150,900,250,0.782608695652174,14,9,5,365.9213911402385,0.4272941970310391,0.10410057972246989,0.205447484969799,129688.42734203822,1691.153949557689,131379.5812915959,286,1,126.74358974358974,36,3,16,36.03671457527177,0.6171875,45.35472972972974,1018.581081081083,28.293918918918973,0
313,4,0,0,38,0.0,0.0,1.0,38,950,700,250,0.7368421052631579,12,7,5,371.16086257306074,0.42616465149359883,0.08395278048547072,0.2084611838867587,129701.96926708252,2028.058958118996,131730.0282252015,287,2,123.57894736842105,35,3,17,35.88950592735674,0.6193452380952381,45.34143518518518,1018.6342592592596,29.10383597883599,0
314,4,0,0,38,0.0,0.0,1.0,38,1200,900,300,0.75,15,9,6,369.7936669194688,0.42650545282124225,0.08513545023526703,0.20800598401866346,129760.92470689729,1996.9536340449292,131757.87834094223,288,3,124.57894736842105,35,3,17,35.864312355636336,0.6199404761904762,45.28356481481482,1018.8657407407408,29.110449735449738,0
315,4,0,1,37,0.0,0.02631578947368421,0.9736842105263158,38,1050,600,450,0.5714285714285714,15,6,9,370.55735806190563,0.42546823138928397,0.09142406424781302,0.20922238524418357,129908.37191358021,2027.7006172839451,131936.07253086416,289,4,125.57894736842105,35,3,17,35.694822888283376,0.6214285714285714,45.138888888888886,1019.4444444444441,29.126984126984116,0
316,4,0,0,37,0.0,0.0,1.0,37,350,0,350,0.0,7,0,7,371.53887720907255,0.4261448948948949,0.10623351048386076,0.20988515464501947,129928.59977324255,2254.70521541949,132183.30498866204,290,5,128.48648648648648,34,3,17,35.649229332087806,0.6237745098039216,45.11904761904761,1019.5238095238088,29.985994397759082,0
317,4,0,1,36,0.0,0.02702702702702703,0.972972972972973,37,1050,500,550,0.47619047619047616,16,5,11,374.82582189063703,0.4256443943943944,0.10339869080651853,0.2127552878278151,130114.93866008676,2354.0877647033803,132469.02642479015,291,6,129.48648648648648,35,2,18,35.37589809037625,0.6235119047619048,44.9363425925926,1020.254629629631,29.150132275132314,0
318,4,0,0,36,0.0,0.0,1.0,36,1300,1200,100,0.9230769230769231,14,12,2,377.34512368540595,0.42546296296296293,0.09744395097293923,0.21517195245880347,130293.86421388417,2633.2345859416987,132927.09879982588,292,7,131.41666666666666,33,3,18,35.12971131916937,0.6297348484848485,44.76102941176471,1020.9558823529418,30.938057040998235,0
319,4,0,0,36,0.0,0.0,1.0,36,1550,1400,150,0.9032258064516129,17,14,3,395.0347642398459,0.4251157407407407,0.09827743554642954,0.21615947211775843,128672.41753472228,2982.8698697616405,131655.2874044839,293,8,132.41666666666666,33,3,17,36.33427446954142,0.6133207070707071,46.35416666666667,1014.5833333333338,30.74494949494951,7
320,4,0,0,36,0.0,0.0,1.0,36,950,700,250,0.7368421052631579,12,7,5,366.09521207567775,0.4257771164021164,0.006198347107438051,0.19259791591807415,127092.01388888908,2105.5555555555807,129197.56944444466,294,9,133.41666666666666,35,1,17,38.688016528925615,0.5928571428571429,47.91666666666668,1008.333333333335,28.809523809523856,8
321,4,2,1,37,0.05263157894736842,0.02631578947368421,0.9736842105263158,38,1100,800,300,0.7272727272727273,14,8,6,348.0778702834395,0.43278805120910385,0.02411083418853499,0.1858416945742935,127688.85598013575,1289.1330096989104,128977.98898983466,295,0,127.34210526315789,36,2,18,38.53040854224699,0.5969328703703703,47.32545045045046,1010.6981981981999,28.074949949949996,0
322,4,2,2,37,0.05128205128205128,0.05128205128205128,0.9487179487179487,39,1250,800,450,0.64,17,8,9,340.1315694457131,0.43668466036887094,0.0327592142230515,0.18392594703750625,128200.04712988615,920.9766466605151,129121.02377654667,296,0,124.25641025641026,37,2,20,38.20873033059045,0.6002252252252251,46.82017543859649,1012.7192982456143,27.37079184447606,0
323,4,2,2,37,0.05128205128205128,0.05128205128205128,0.9487179487179487,39,1250,900,350,0.72,16,9,7,330.8451825790716,0.4383434547908232,0.02015404607333804,0.1803590825880512,128523.41666894963,704.2706507049566,129227.6873196546,297,0,118.23076923076923,38,1,14,38.11417834439644,0.6016995614035088,46.50106837606838,1013.9957264957275,26.684098065677038,0
324,4,1,3,35,0.02631578947368421,0.07894736842105263,0.9210526315789473,38,1200,800,400,0.6666666666666666,16,8,8,336.4105653676336,0.4371443812233286,0.011538417751061347,0.18318327958711078,128477.80687326878,1044.2583294860046,129522.06520275479,298,0,122.3157894736842,37,1,14,38.01959405869205,0.6030405405405406,46.54605263157895,1013.815789473685,27.400426742532026,0
325,4,2,2,35,0.05405405405405406,0.05405405405405406,0.9459459459459459,37,700,300,400,0.42857142857142855,11,3,8,341.7848794801544,0.4336211211211211,0.03284874042836505,0.18722331604836914,128715.26668137732,1398.5863819901,130113.85306336742,299,0,124.37837837837837,36,1,15,37.64126253098065,0.607349537037037,46.31193693693694,1014.7522522522523,28.187562562562565,0
326,4,0,0,35,0.0,0.0,1.0,35,700,400,300,0.5714285714285714,10,4,6,353.93551636667326,0.42843137254901964,0.04070900340415551,0.19315673695885271,128566.75347222229,2100.86805555556,130667.62152777785,300,1,131.54285714285714,34,1,16,37.48459326211996,0.6099877450980392,46.458333333333336,1014.1666666666672,29.828431372549034,0
327,4,0,2,33,0.0,0.05714285714285714,0.9428571428571428,35,750,500,250,0.6666666666666666,10,5,5,354.522754768344,0.4281162464985995,0.04024343219273385,0.19377090400135077,128627.12762188211,2120.2487244897993,130747.37634637191,301,2,132.54285714285714,34,1,16,37.40807025779446,0.6106004901960784,46.398809523809526,1014.4047619047622,29.835434173669476,0
328,4,0,0,33,0.0,0.0,1.0,33,700,300,400,0.42857142857142855,11,3,8,367.1622415715399,0.421875,0.06042487656837414,0.19970043870842294,128432.33471074386,2831.1007805326053,131263.43549127647,302,3,140.63636363636363,32,1,18,37.28668410563029,0.61328125,46.59090909090909,1013.6363636363641,31.676136363636378,0
329,4,1,0,34,0.029411764705882353,0.0,1.0,34,850,600,250,0.7058823529411765,11,6,5,359.2594683442784,0.4225155971479501,0.06976818488409253,0.1975092697566256,128858.98940611786,2458.762405084585,131317.75181120244,303,0,137.47058823529412,33,1,19,37.05127237980287,0.6152146464646464,46.1703431372549,1015.3186274509807,30.7672311348782,0
330,4,1,0,35,0.02857142857142857,0.0,1.0,35,1000,600,400,0.6,14,6,8,352.81775691050524,0.4252801120448179,0.07962266044457822,0.19580353877664894,129231.6485969388,2119.0440759637227,131350.6926729025,304,0,134.5142857142857,34,1,20,36.83507005424815,0.6167279411764706,45.80357142857143,1016.7857142857146,29.905462184873958,0
331,4,0,1,34,0.0,0.02857142857142857,0.9714285714285714,35,850,600,250,0.7058823529411765,11,6,5,354.6464731734438,0.4246848739495798,0.08523603284226033,0.19712067796491417,129292.17864229028,2170.603032879821,131462.7816751701,305,1,135.5142857142857,34,1,20,36.72694993952163,0.6173406862745099,45.74404761904762,1017.0238095238097,29.912464985994404,0
332,4,1,0,35,0.02857142857142857,0.0,1.0,35,1050,900,150,0.8571428571428571,12,9,3,346.80700733036014,0.42661064425770306,0.08349900596421467,0.1939533498810928,129534.44054705213,1984.6903344671177,131519.13088151926,306,0,132.25714285714287,34,1,17,36.67992047713717,0.6197916666666667,45.50595238095238,1017.9761904761903,29.940476190476183,0
333,4,0,0,35,0.0,0.0,1.0,35,1150,900,250,0.782608695652174,14,9,5,367.16820061506786,0.42633053221288514,0.07359494783443754,0.20255407270889064,128995.5488709919,2472.612713263024,131468.16158425494,307,1,133.25714285714287,35,0,16,36.71112471991189,0.6122023809523809,46.035879629629626,1015.8564814814811,29.024470899470888,8
334,4,0,1,34,0.0,0.02857142857142857,0.9714285714285714,35,1100,900,200,0.8181818181818182,13,9,4,369.18800546510295,0.4266456582633053,0.07612974590883925,0.20442680100848257,129142.5607103052,2535.5768818587076,131678.1375921639,308,2,134.25714285714287,35,0,17,36.50981173612693,0.6136904761904762,45.8912037037037,1016.4351851851851,29.041005291005288,0
335,4,2,1,35,0.05555555555555555,0.027777777777777776,0.9722222222222222,36,850,500,350,0.5882352941176471,12,5,7,357.59772961904,0.4287533068783069,0.09567540545102804,0.20091685964216163,129716.28578514719,2077.276650114756,131793.56243526196,309,0,131.36111111111111,34,2,15,36.22034591562464,0.6216299019607843,45.32738095238094,1018.6904761904746,29.961484593837486,0
336,4,0,0,35,0.0,0.0,1.0,35,800,400,400,0.5,12,4,8,368.45489167220205,0.4254201680672269,0.09784519080293763,0.20611143334148013,129544.24267409153,2546.2419802479585,132090.4846543395,310,1,136.11428571428573,33,2,15,36.11901107499698,0.6221590909090908,45.496323529411754,1018.0147058823516,30.848930481283382,0
337,4,0,1,34,0.0,0.02857142857142857,0.9714285714285714,35,650,300,350,0.46153846153846156,10,3,7,368.5857661647255,0.4247549019607843,0.10293829410449962,0.20651241612020904,129606.62853529872,2554.231695741997,132160.86023104072,311,2,137.11428571428573,33,2,16,36.05214727002848,0.622790404040404,45.43504901960783,1018.259803921567,30.85635769459294,0
338,4,0,1,33,0.0,0.029411764705882353,0.9705882352941176,34,950,600,350,0.631578947368421,13,6,7,373.2698790707401,0.4238153594771242,0.09226140549214135,0.20920233319704776,129618.9184298795,2876.5676015202407,132495.48603139975,312,3,135.6764705882353,32,2,16,35.92038644348007,0.6253255208333333,45.42297979797979,1018.3080808080799,31.822127525252498,0
339,4,1,0,34,0.029411764705882353,0.0,1.0,34,750,500,250,0.6666666666666666,10,5,5,376.60666184318427,0.4251522578728461,0.09879597979694954,0.21211391261244517,129811.85154894902,2977.6016159065316,132789.45316485554,313,0,136.38235294117646,32,2,17,35.63891298063024,0.6272786458333333,45.233585858585855,1019.065656565656,31.84580176767675,0
340,4,1,0,35,0.02857142857142857,0.0,1.0,35,750,400,350,0.5333333333333333,11,4,7,367.3071226680177,0.42692577030812323,0.1017702758336767,0.2089435599439378,130200.04325259503,2564.680651672417,132764.72390426745,314,0,133.45714285714286,33,2,18,35.48120797310278,0.6287878787878788,44.85294117647058,1020.5882352941167,30.92691622103384,0
341,4,0,0,35,0.0,0.0,1.0,35,1200,1000,200,0.8333333333333334,14,10,4,364.34818825489367,0.4273809523809524,0.09912536443148667,0.20759373516848614,130262.58680555563,2492.202518262217,132754.78932381785,315,1,134.45714285714286,32,3,18,35.493197278911566,0.6318359375,44.79166666666667,1020.833333333334,31.90104166666669,0
342,4,0,0,35,0.0,0.0,1.0,35,850,600,250,0.7058823529411765,11,6,5,365.5580528693727,0.4269957983193277,0.09914179763376296,0.20914884354407545,130423.75299714321,2535.4906387103447,132959.24363585355,316,2,135.45714285714286,32,3,19,35.298722702925424,0.6334635416666667,44.63383838383839,1021.464646464647,31.92077020202022,0
343,4,0,0,35,0.0,0.0,1.0,35,950,300,650,0.3157894736842105,16,3,13,366.6632206994327,0.42650560224089634,0.10791925465838492,0.21083135190217395,130617.28395061738,2578.5108024691467,133195.79475308652,317,3,136.45714285714286,32,3,17,35.07416213768114,0.6354166666666667,44.44444444444445,1022.222222222223,31.944444444444468,0
344,4,0,0,35,0.0,0.0,1.0,35,900,400,500,0.4444444444444444,14,4,10,371.05899687075623,0.4264705882352941,0.11207027322597174,0.21389372353425298,130714.10323245075,2700.5288044587273,133414.6320369095,318,4,137.45714285714286,32,3,17,34.8636148495699,0.6363932291666667,44.349747474747474,1022.6010101010099,31.95628156565656,0
345,4,0,0,35,0.0,0.0,1.0,35,850,500,350,0.5882352941176471,12,5,7,372.0326363338465,0.42661064425770306,0.10893220832121053,0.21490355816460988,130794.81336805537,2731.9878472221976,133526.80121527758,319,5,138.45714285714286,33,2,17,34.756873727087566,0.6347853535353536,44.27083333333332,1022.9166666666652,30.9974747474747,0
346,4,0,0,35,0.0,0.0,1.0,35,1500,1000,500,0.6666666666666666,20,10,10,371.9772808777779,0.42601540616246497,0.1058586134956736,0.2160986233972848,131014.28086553246,2746.8671905036495,133761.14805603612,320,6,139.45714285714286,33,2,17,34.53585108929854,0.6369949494949495,44.056372549019606,1023.7745098039214,31.023469994058225,0
347,4,0,2,33,0.0,0.05714285714285714,0.9428571428571428,35,1100,900,200,0.8181818181818182,13,9,4,375.6020728535851,0.42573529411764705,0.10941783748675316,0.2189178608724033,131139.77346453283,2851.274149365621,133991.04761389844,321,7,140.45714285714286,33,2,17,34.315924862407265,0.6382575757575757,43.93382352941176,1024.2647058823527,31.038324420677355,0
348,4,1,1,33,0.029411764705882353,0.029411764705882353,0.9705882352941176,34,950,600,350,0.631578947368421,13,6,7,383.81531331955387,0.4263406120023767,0.10664888188133959,0.22352226992414717,131108.3946829345,3264.2819168108504,134372.67659974535,322,0,135.91176470588235,33,1,18,34.137424713812784,0.6379419191919191,43.96446078431373,1024.1421568627454,31.03461081402259,0
349,4,0,0,33,0.0,0.0,1.0,33,850,700,150,0.8235294117647058,10,7,3,393.2293632368563,0.42495265151515155,0.11438674396611992,0.22819688244532532,130972.46334876551,3700.4436728395176,134672.90702160503,323,1,139.9090909090909,32,1,18,34.034373586612396,0.6389973958333333,44.09722222222223,1023.6111111111118,31.987847222222243,0
350,4,0,0,33,0.0,0.0,1.0,33,1000,700,300,0.7,13,7,6,394.93402217657626,0.42408459595959597,0.1142323356873296,0.22976434145280017,131069.41415416796,3752.754183246608,134822.16833741457,324,2,140.9090909090909,32,1,19,33.892314015618574,0.6399739583333333,44.00252525252525,1023.9898989898991,31.999684343434346,0
351,4,1,0,34,0.029411764705882353,0.0,1.0,34,900,600,300,0.6666666666666666,12,6,6,387.79759133282937,0.42426099227569813,0.11648552754435126,0.2277334848431045,131428.24172973633,3394.0212672054254,134822.26299694175,325,0,137.73529411764707,31,3,20,33.71124338624339,0.6461693548387097,43.65234375,1025.390625,33.07711693548387,0
352,4,0,0,34,0.0,0.0,1.0,34,800,500,300,0.625,11,5,6,385.9541641705721,0.4237782234105763,0.10267427189177525,0.227444492109195,131561.79004245327,3355.3641425238666,134917.15418497715,326,1,138.73529411764707,31,3,18,33.623265431315325,0.647513440860215,43.522135416666664,1025.9114583333328,33.093918010752674,0
353,4,0,1,33,0.0,0.029411764705882353,0.9705882352941176,34,1050,700,350,0.6666666666666666,14,7,7,383.9844228700591,0.4222556446821153,0.10058606468417608,0.22720475676372484,131716.66953627174,3315.4298668503134,135032.09940312206,327,2,139.73529411764707,32,2,18,33.51706642066421,0.646484375,43.37121212121212,1026.515151515151,32.07859848484847,0
354,4,0,0,33,0.0,0.0,1.0,33,550,200,350,0.36363636363636365,9,2,7,393.9932498730115,0.4209280303030303,0.10688579331463632,0.23177631286405637,131495.0074089899,3761.6290622287383,135256.63647121866,328,6,144.9090909090909,31,2,20,33.48474990478607,0.6468413978494624,43.587239583333336,1025.6510416666674,33.0855174731183,0
355,4,0,0,33,0.0,0.0,1.0,33,1050,600,450,0.5714285714285714,15,6,9,396.26890669690033,0.42049400252525254,0.1036148284879248,0.23372746892002788,131595.18771701382,3829.4162326388805,135424.6039496527,329,7,145.9090909090909,31,2,18,33.32487309644671,0.6478494623655914,43.48958333333333,1026.041666666666,33.098118279569874,0
356,4,0,0,33,0.0,0.0,1.0,33,850,700,150,0.8235294117647058,10,7,3,400.7963260272429,0.4202967171717172,0.0985194409851946,0.23722809567558428,131728.82080078125,3959.2854817708344,135688.1062825521,330,8,146.9090909090909,31,2,18,33.07331303906646,0.6491935483870968,43.359375,1026.5625,33.11491935483871,0
357,4,0,0,33,0.0,0.0,1.0,33,1150,1000,150,0.8695652173913043,13,10,3,429.7071162349717,0.4203756313131313,0.105046020695299,0.24978458821142585,131037.09323347127,4661.514290633631,135698.6075241049,331,9,147.9090909090909,32,1,19,33.03505364409915,0.6396484375,44.03409090909092,1023.863636363638,31.995738636363686,7
358,4,0,1,32,0.0,0.030303030303030304,0.9696969696969697,33,1500,1200,300,0.8,18,12,6,433.6909947166216,0.42021780303030304,0.1062491366790983,0.2538046001524745,131295.77219480174,4788.358809050122,136084.13100385186,332,10,148.9090909090909,32,1,19,32.66960289105171,0.6422526041666667,43.78156565656567,1024.8737373737388,32.02730429292934,0
359,4,0,1,31,0.0,0.03125,0.96875,32,650,400,250,0.6153846153846154,9,4,5,443.003160099017,0.42149697580645157,0.09942892997839614,0.25879672359459277,131228.04641723633,5226.887851291233,136454.93426852755,333,11,148.03125,31,1,19,32.500026475198034,0.6441532258064516,43.84765625,1024.609375,33.05191532258065,0
360,4,0,0,31,0.0,0.0,1.0,31,850,700,150,0.8235294117647058,10,7,3,448.9777408063563,0.42172939068100357,0.09770504011102465,0.2625004828150047,131259.24962423404,5586.496271245237,136845.74589547928,334,12,148.29032258064515,30,1,19,32.31516701643932,0.6472222222222221,43.81720430107527,1024.7311827956992,34.15770609318997,0
361,4,0,0,31,0.0,0.0,1.0,31,950,600,350,0.631578947368421,13,6,7,446.2633644371868,0.42186379928315415,0.09348236318769065,0.2616432610730026,131366.2602085105,5524.844047853167,136891.10425636367,335,13,149.29032258064515,27,4,21,32.27563869937582,0.6577932098765432,43.71279761904762,1025.1488095238096,37.96847442680777,0
362,4,0,0,31,0.0,0.0,1.0,31,950,600,350,0.631578947368421,13,6,7,448.91648844340244,0.42083333333333334,0.09654494841984618,0.26478008450104856,131595.18771701382,5615.049913194435,137210.23763020826,336,14,150.29032258064515,27,4,17,31.974407783417952,0.660108024691358,43.48958333333333,1026.041666666666,38.00154320987652,0
363,4,0,0,31,0.0,0.0,1.0,31,1050,700,350,0.6666666666666666,14,7,7,449.91952024375405,0.4205645161290323,0.09561410074096233,0.26563741537679164,131633.3616780044,5644.883786848051,137278.24546485246,337,15,151.29032258064515,27,4,17,31.909802784222737,0.6604938271604939,43.45238095238094,1026.1904761904752,38.007054673721306,0
364,4,0,0,31,0.0,0.0,1.0,31,750,400,350,0.5333333333333333,11,4,7,416.827066762523,0.42025089605734767,0.126998300901638,0.23018411903382652,129035.96878051762,4557.136874728733,133593.10565524636,338,16,152.29032258064515,31,0,20,35.40852343115895,0.6219758064516129,45.99609375,1016.0156250000003,32.774697580645174,8
365,4,0,0,31,0.0,0.0,1.0,31,950,600,350,0.631578947368421,13,6,7,416.5715512959027,0.41944444444444445,0.13137829912023502,0.231395719460953,129267.58660210499,4569.839816623259,133837.42641872825,339,17,153.29032258064515,31,0,21,35.17765685019208,0.6243279569892473,45.768229166666664,1016.9270833333329,32.80409946236558,0
366,4,0,0,31,0.0,0.0,1.0,31,650,500,150,0.7692307692307693,8,5,3,427.4056757803625,0.41944444444444445,0.1107032275218498,0.22865899667282288,127770.5605416813,4759.4244046740205,132529.98494635534,340,18,154.29032258064515,30,1,15,36.44171541256759,0.6118055555555555,47.24462365591399,1011.0215053763455,33.70071684587818,8
367,4,1,0,32,0.03125,0.0,1.0,32,1200,900,300,0.75,15,9,6,430.15718317503837,0.42101394489247307,0.07599145771079652,0.21796707300186136,125553.99788750555,4409.557775029274,129963.55566253483,341,0,150.4375,31,1,17,38.66888073275303,0.5863575268817205,49.44661458333334,1002.2135416666678,32.32946908602154,8
368,4,1,0,33,0.030303030303030304,0.0,1.0,33,800,500,300,0.625,11,5,6,423.08551904057157,0.42534722222222227,0.08140009070709642,0.2166099782286921,125980.45041641174,4060.100850678525,130040.55126709027,342,0,146.84848484848484,32,1,18,38.40292625665537,0.5882161458333333,49.02146464646466,1003.9141414141427,31.37231691919196,0
369,4,4,2,35,0.10810810810810811,0.05405405405405406,0.9459459459459459,37,1150,1000,150,0.8695652173913043,13,10,3,382.71436235932345,0.4394707207207207,0.078933343545458,0.2011922988715774,127062.00573979602,2325.722785862136,129387.72852565815,343,0,131.86486486486487,34,3,19,38.29997638446097,0.5946691176470589,47.94642857142858,1008.2142857142866,29.653361344537842,0
370,4,0,0,35,0.0,0.0,1.0,35,1000,800,200,0.8,12,8,4,396.72144568107507,0.4322829131652661,0.08386588336437861,0.20708444049425773,126773.92612998684,3058.7870497908502,129832.71317977768,344,1,140.4,32,3,19,38.24415956201939,0.5963541666666667,48.23232323232324,1007.070707070708,31.470959595959624,0
371,4,1,0,36,0.027777777777777776,0.0,1.0,36,1000,600,400,0.6,14,6,8,402.62730228083035,0.4349702380952381,0.028707303981252652,0.2145070881643066,127602.694515306,3082.635036720517,130685.32955202651,345,0,137.47222222222223,34,2,16,37.24078001649581,0.6001838235294117,47.41071428571428,1010.3571428571418,29.716386554621817,8
372,4,0,1,35,0.0,0.027777777777777776,0.9722222222222222,36,1100,800,300,0.7272727272727273,14,8,6,403.57690759966306,0.43472222222222223,0.025015708451146645,0.21517341656444322,127632.76643990916,3101.9274376417065,130734.69387755086,346,1,138.47222222222223,34,2,16,37.18583097706566,0.6004901960784313,47.38095238095237,1010.4761904761893,29.71988795518204,0
373,4,0,2,33,0.0,0.05714285714285714,0.9428571428571428,35,700,400,300,0.5714285714285714,10,4,6,407.2807512546139,0.4318977591036415,0.028418936715880028,0.2169006791565268,127586.77551903109,3392.7275567089487,130979.50307574004,347,2,143.34285714285716,33,2,16,37.13963690765,0.6022727272727273,47.42647058823529,1010.2941176470584,30.614973262032073,0
374,4,2,0,35,0.05714285714285714,0.0,1.0,35,950,700,250,0.7368421052631579,12,7,5,393.1145074215232,0.4332983193277311,0.04637255262094553,0.21263175512688515,128210.45769585509,3109.2634307380317,131319.72112659313,348,0,144.02857142857144,31,4,20,36.856625524985006,0.6135752688172043,46.809895833333336,1012.7604166666671,32.66969086021507,8
375,4,0,0,35,0.0,0.0,1.0,35,950,500,450,0.5263157894736842,14,5,9,393.2928880334672,0.43298319327731094,0.04968688593833259,0.21290364481644686,128243.42727661133,3087.445576985677,131330.87285359701,349,1,145.02857142857144,31,4,20,36.81827677079317,0.6139112903225806,46.77734375,1012.890625,32.673891129032256,0
376,4,2,2,35,0.05405405405405406,0.05405405405405406,0.9459459459459459,37,900,500,400,0.5555555555555556,13,5,8,377.3127839067057,0.43690565565565564,0.04953867435760251,0.20727182373230427,128827.8847078046,2321.6815647827657,131149.56627258737,350,0,138.13513513513513,33,4,19,36.62481892805408,0.6148989898989898,46.20098039215686,1015.1960784313717,30.763517528223385,0
377,4,2,0,37,0.05405405405405406,0.0,1.0,37,1000,800,200,0.8,12,8,4,377.54949709217425,0.4325888388388388,0.06110344872559881,0.20821741725861828,128983.44574502594,2339.527014850057,131322.972759876,351,0,138.97297297297297,33,4,21,36.459841356013996,0.6164772727272727,46.04779411764706,1015.8088235294117,30.782085561497325,0
378,4,0,0,37,0.0,0.0,1.0,37,500,400,100,0.8,6,4,2,376.42568209229523,0.43333958958958957,0.05912569588401739,0.20808811706062072,129076.82742214529,2317.5665609380967,131394.3939830834,352,1,139.97297297297297,33,4,21,36.39300932625825,0.6174242424242424,45.955882352941174,1016.1764705882349,30.793226381461665,0
379,4,0,0,37,0.0,0.0,1.0,37,850,600,250,0.7058823529411765,11,6,5,374.1700372418047,0.4331206206206206,0.05093880955949892,0.20716730900424105,129139.1006463861,2263.996419646299,131403.0970660324,353,2,140.97297297297297,33,4,22,36.386745438469575,0.6180555555555556,45.89460784313726,1016.4215686274517,30.800653594771266,0
380,4,1,0,38,0.02631578947368421,0.0,1.0,38,1600,1100,500,0.6875,21,11,10,366.85731565939346,0.4350254860123281,0.049724011888718556,0.20548334124654863,129595.04145408183,1908.5778061224744,131503.61926020432,354,0,138.23684210526315,34,4,19,36.10794458084882,0.6204044117647058,45.446428571428584,1018.2142857142874,29.947478991596686,0
381,4,0,0,38,0.0,0.0,1.0,38,950,700,250,0.7368421052631579,12,7,5,366.36828323083756,0.4349217638691323,0.05306217858812534,0.2056855007429823,129685.96938775529,1902.565192743788,131588.53458049908,355,1,139.23684210526315,34,4,19,36.027836216300464,0.6213235294117647,45.35714285714287,1018.57142857143,29.957983193277354,0
382,4,0,1,37,0.0,0.02631578947368421,0.9736842105263158,38,1000,600,400,0.6,14,6,8,366.55097114169314,0.43484767662399243,0.058873814590226115,0.20610664987060548,129746.60572562384,1911.7488662131743,131658.354591837,356,2,140.23684210526315,34,4,19,35.96147853859935,0.6219362745098039,45.29761904761906,1018.8095238095259,29.96498599439782,0
383,4,1,0,38,0.02631578947368421,0.0,1.0,38,900,500,400,0.5555555555555556,13,5,8,362.04451324013223,0.4363738738738739,0.0680057503394298,0.20499903138983572,130019.64462868491,1814.5797902494492,131834.22441893435,357,0,139.6315789473684,34,4,20,35.79870433057081,0.6246936274509804,45.02976190476191,1019.8809523809533,29.996498599439803,0
384,4,0,2,36,0.0,0.05263157894736842,0.9473684210526316,38,800,700,100,0.875,9,7,2,362.8679140501517,0.43618124703651023,0.06488648090815308,0.2056251512950861,130050.0000000001,1838.19444444446,131888.19444444455,358,1,140.6315789473684,34,4,20,35.74686819172114,0.625,45.00000000000001,1020.0000000000008,30.000000000000025,0
385,4,0,1,35,0.0,0.027777777777777776,0.9722222222222222,36,900,700,200,0.7777777777777778,11,7,4,380.20204253672523,0.4322916666666667,0.06398182569186273,0.2139630741472368,129779.68606519759,2668.500344352633,132448.18640955022,359,2,149.0,32,4,20,35.58008054522923,0.626953125,45.26515151515152,1018.9393939393952,31.8418560606061,0
386,4,1,0,36,0.027777777777777776,0.0,1.0,36,900,400,500,0.4444444444444444,14,4,10,374.22699857375954,0.4331845238095238,0.07588512007922743,0.21199198418505133,130037.12153096627,2532.680338740946,132569.8018697072,360,0,148.58333333333334,32,4,22,35.47031030783195,0.6295572916666667,45.01262626262626,1019.9494949494953,31.873421717171727,0
387,4,0,0,36,0.0,0.0,1.0,36,650,200,450,0.3076923076923077,11,2,9,373.8836878737378,0.4331183862433863,0.07590759075907605,0.21214748581599743,130101.52025303547,2528.5672380369474,132630.08749107242,361,1,149.58333333333334,32,4,22,35.41357260726075,0.6302083333333333,44.949494949494955,1020.2020202020208,31.88131313131315,0
388,4,1,0,37,0.02702702702702703,0.0,1.0,37,750,500,250,0.6666666666666666,10,5,5,366.558708890698,0.4345282782782783,0.07084867977382325,0.2098649311341251,130450.30757401002,2163.5392637447167,132613.84683775474,362,0,146.51351351351352,33,4,23,35.246221209213054,0.6313131313131313,44.6078431372549,1021.5686274509807,30.956625074272143,0
389,4,0,1,36,0.0,0.02702702702702703,0.972972972972973,37,900,500,400,0.5555555555555556,13,5,8,366.6943581134943,0.43493493493493496,0.07747380429956241,0.2104517723543311,130544.21864487231,2173.9656922818285,132718.18433715415,363,1,147.51351351351352,33,4,16,35.14747471719229,0.632260101010101,44.515931372549026,1021.9362745098051,30.967765894236518,0
390,4,0,1,35,0.0,0.027777777777777776,0.9722222222222222,36,800,500,300,0.625,11,5,6,376.87266704457426,0.43310185185185185,0.08168520807581392,0.21562233920725649,130423.7529971432,2630.629527599233,133054.38252474242,364,4,152.58333333333334,32,4,23,35.00978574371653,0.6334635416666667,44.63383838383839,1021.4646464646469,31.920770202020215,0
391,4,0,0,35,0.0,0.0,1.0,35,900,700,200,0.7777777777777778,11,7,4,378.3051003928452,0.43084733893557425,0.06652546860108033,0.21716322571487165,130552.7576905419,2877.754820936654,133430.51251147856,365,5,151.74285714285713,32,3,17,34.84216703731159,0.634765625,44.507575757575765,1021.9696969696978,31.936553030303056,0
392,4,0,0,35,0.0,0.0,1.0,35,900,600,300,0.6666666666666666,12,6,6,381.42789152075727,0.43042717086834736,0.07352987879108674,0.21950402541887523,130649.5530589992,2966.6767102846816,133616.22976928388,366,6,152.74285714285713,32,3,18,34.66407311349882,0.6357421875,44.412878787878796,1022.3484848484859,31.948390151515184,0
393,4,0,1,34,0.0,0.02857142857142857,0.9714285714285714,35,900,400,500,0.4444444444444444,14,4,10,380.4136331916503,0.42885154061624653,0.069138414343894,0.22002081868322235,130843.25140610668,2954.9113292011234,133798.1627353078,367,7,153.74285714285713,32,3,19,34.49339750709614,0.6376953125,44.22348484848486,1023.1060606060619,31.972064393939434,0
394,4,0,2,32,0.0,0.058823529411764705,0.9411764705882353,34,650,400,250,0.6153846153846154,9,4,5,383.81789456195247,0.42710190136660725,0.054883752254241136,0.22267103093369048,130961.35669284384,3253.0624389648256,134214.41913180865,368,8,153.0,31,3,19,34.286482847814106,0.6414650537634409,44.10807291666666,1023.5677083333322,33.01831317204297,0
395,4,0,0,32,0.0,0.0,1.0,32,1000,700,300,0.7,13,7,6,406.5434527264042,0.4204259072580645,0.0651310429114611,0.23462272616592778,130759.29783950602,4231.867283950592,134991.16512345662,369,15,162.96875,29,3,20,33.910465326815135,0.6451149425287357,44.30555555555554,1022.7777777777766,35.26819923371643,0
396,4,0,0,32,0.0,0.0,1.0,32,1000,500,500,0.5,15,5,10,408.1343038122422,0.4194598454301075,0.05919177524429964,0.23640987032143063,130901.38888888877,4285.069444444426,135186.4583333332,370,16,163.96875,29,3,20,33.72523072747013,0.646551724137931,44.16666666666666,1023.3333333333323,35.28735632183905,0
397,4,0,0,32,0.0,0.0,1.0,32,1000,600,400,0.6,14,6,8,404.7457675283211,0.41788474462365593,0.03282823804795032,0.21896031583324144,128217.27864067252,4037.7607263178816,132255.03936699042,371,17,164.96875,28,4,22,36.55512602260367,0.6223958333333333,46.80316091954023,1012.7873563218394,36.170977011494266,8
398,4,0,0,32,0.0,0.0,1.0,32,1050,700,350,0.6666666666666666,14,7,7,405.2714324423278,0.4163306451612903,0.03957978874237922,0.22004460454316685,128362.83535225922,4004.358031113754,132367.19338337297,372,18,165.96875,28,4,22,36.39231532681128,0.6238839285714286,46.65948275862069,1013.3620689655173,36.19150246305419,0
399,4,0,0,32,0.0,0.0,1.0,32,1100,700,400,0.6363636363636364,15,7,8,403.9406887566106,0.41612063172043007,0.03319011339475564,0.2197225566058511,128435.6446731735,3976.076554036208,132411.72122720972,373,19,166.96875,28,4,20,36.351287502952985,0.6246279761904762,46.58764367816092,1013.6494252873566,36.201765188834166,0
400,4,0,0,32,0.0,0.0,1.0,32,850,600,250,0.7058823529411765,11,6,5,403.9406887566106,0.41612063172043007,0.03319011339475564,0.2197225566058511,128435.6446731735,3976.076554036208,132411.72122720972,374,20,167.96875,28,4,20,36.351287502952985,0.6246279761904762,46.58764367816092,1013.6494252873566,36.201765188834166,0
401,4,0,0,32,0.0,0.0,1.0,32,1100,700,400,0.6363636363636364,15,7,8,403.57642435835305,0.41607862903225806,0.034252338104010294,0.21992577812331254,128508.47463750171,3972.5981387898123,132481.07277629152,375,21,168.96875,28,4,20,36.28578007651977,0.6253720238095238,46.515804597701155,1013.9367816091959,36.21202791461414,0
402,4,0,1,31,0.0,0.03125,0.96875,32,650,400,250,0.6153846153846154,9,4,5,402.1516900808179,0.41574260752688175,0.038908662700099184,0.21955056305340245,128581.32524524377,3941.839452041225,132523.16469728498,376,22,169.96875,28,4,20,36.247166737498226,0.6261160714285714,46.44396551724138,1014.2241379310346,36.22229064039409,0
403,4,1,2,30,0.03125,0.0625,0.9375,32,1000,700,300,0.7,13,7,6,396.05695627438433,0.4185987903225807,0.01780582922824303,0.217296113847838,128778.12500000001,3800.6944444444457,132578.81944444447,376,0,159.1875,29,3,22,36.200054734537474,0.625,46.25,1015.0000000000001,35.00000000000001,0
404,4,0,0,30,0.0,0.0,1.0,30,800,700,100,0.875,9,7,2,417.39679076021093,0.41999521072796936,0.0221439749608765,0.2279628626459612,128596.93877551013,4735.189909297043,133332.1286848072,377,1,166.56666666666666,27,3,22,35.844581377151805,0.6296296296296297,46.42857142857142,1014.2857142857137,37.56613756613754,0
405,4,0,1,29,0.0,0.03333333333333333,0.9666666666666667,30,1000,800,200,0.8,12,8,4,414.1695504421557,0.4198515325670498,0.01355418743281489,0.22749312988054624,128823.44148596929,4670.949369331043,133494.39085530033,378,2,167.56666666666666,27,3,23,35.69395582918009,0.6319444444444444,46.20535714285713,1015.1785714285706,37.59920634920632,0
406,4,1,0,30,0.03333333333333333,0.0,1.0,30,850,700,150,0.8235294117647058,10,7,3,400.79488762037226,0.422198275862069,0.004129585157978788,0.22287721991081005,129310.9667104306,4365.434874157733,133676.40158458834,379,0,159.7,28,2,24,35.53438574186563,0.6335565476190477,45.72557471264367,1017.0977011494244,36.32491789819373,0
407,4,3,0,33,0.09090909090909091,0.0,1.0,33,950,800,150,0.8421052631578947,11,8,3,366.93721301119626,0.4284248737373737,0.012371676757041428,0.20962322890669693,130365.51371545848,2970.680392058007,133336.1941075165,380,0,146.0909090909091,30,3,24,35.322617794156365,0.6381944444444445,44.69086021505377,1021.2365591397853,34.04121863799284,0
408,4,1,2,32,0.029411764705882353,0.058823529411764705,0.9411764705882353,34,1100,800,300,0.7272727272727273,14,8,6,363.3100712604454,0.4305555555555556,0.06001569432288001,0.19946234616524183,128804.55864800357,2595.781662687709,131400.34031069127,381,0,142.76470588235293,31,3,22,37.00401915512228,0.6196236559139785,46.223958333333336,1015.1041666666674,32.74529569892476,8
409,4,1,0,33,0.030303030303030304,0.0,1.0,33,1500,900,600,0.6,21,9,12,374.5087416077014,0.43091066919191917,0.06908175918903003,0.2053678654959877,128757.66210327776,3044.1740013296267,131801.83610460738,382,0,148.0,30,3,24,36.76775702997397,0.621875,46.27016129032258,1014.9193548387091,33.8306451612903,0
410,4,0,0,33,0.0,0.0,1.0,33,950,600,350,0.631578947368421,13,6,7,377.13655999835316,0.43051609848484845,0.0727834265888534,0.2075212462336168,128894.11212640196,3122.136410278656,132016.24853668062,383,1,149.0,30,3,24,36.561603794396646,0.6232638888888888,46.13575268817205,1015.4569892473123,33.84856630824375,0
411,4,1,2,32,0.029411764705882353,0.058823529411764705,0.9411764705882353,34,1100,700,400,0.6363636363636364,15,7,8,368.03236061886275,0.43211527035056446,0.0657345754310179,0.205333308934813,129440.63484579157,2728.0343103249165,132168.6691561165,384,0,145.58823529411765,30,4,15,36.235305772024844,0.6288194444444444,45.5981182795699,1017.6075268817217,33.92025089605739,0
412,4,0,0,32,0.0,0.0,1.0,32,650,300,350,0.46153846153846156,10,3,7,390.6319265333615,0.42618027553763443,0.08029003826182013,0.21623634178299103,129130.79668209888,3688.5223765432274,132819.3190586421,385,3,155.4375,29,3,26,35.97692903343354,0.6285919540229885,45.902777777777786,1016.3888888888898,35.04789272030654,0
413,4,1,0,33,0.030303030303030304,0.0,1.0,33,650,500,150,0.7692307692307693,8,5,3,379.33842457295464,0.42885890151515155,0.09001636661211099,0.21263832790282142,129625.34722222229,3234.3942901234677,132859.74151234576,386,0,151.6969696969697,29,4,18,35.759342607746866,0.6336206896551724,45.41666666666667,1018.3333333333339,35.114942528735654,0
414,4,1,1,33,0.029411764705882353,0.029411764705882353,0.9705882352941176,34,1100,800,300,0.7272727272727273,14,8,6,368.361080628654,0.43144682115270355,0.08713448479022601,0.20859133431419605,130022.58209041516,2779.051768990644,132801.63385940582,387,0,148.2058823529412,30,4,21,35.6346643823581,0.6347222222222222,45.02688172043011,1019.8924731182802,33.99641577060934,0
415,4,0,0,33,0.0,0.0,1.0,33,1050,700,350,0.6666666666666666,14,7,7,367.3617139510036,0.4283854166666667,0.08695584901865239,0.20824252294444023,130063.28158908428,2956.0540093316085,133019.33559841587,388,1,150.87878787878788,31,2,22,35.61877712535103,0.6323924731182795,44.98697916666667,1020.0520833333339,32.90490591397852,0
416,4,0,1,32,0.0,0.030303030303030304,0.9696969696969697,33,550,300,250,0.5454545454545454,8,3,5,367.5110046926776,0.42814867424242425,0.08476804801460203,0.20868233570810316,130129.6997070314,2964.8193359375164,133094.51904296892,389,2,151.87878787878788,31,2,22,35.54747320061254,0.6330645161290323,44.92187500000001,1020.3125000000011,32.91330645161294,0
417,4,0,0,32,0.0,0.0,1.0,32,800,600,200,0.75,10,6,4,380.1958526208237,0.42378612231182794,0.09760527876631064,0.2151040964827883,129988.31376821027,3484.2035567695757,133472.51732497985,390,3,157.40625,30,2,22,35.36778920082595,0.634375,45.060483870967744,1019.7580645161296,33.99193548387099,0
418,4,0,0,32,0.0,0.0,1.0,32,1000,700,300,0.7,13,7,6,380.19095094567797,0.4236391129032258,0.09848422473982366,0.21585860199167084,130125.41415553814,3494.5009899988377,133619.91514553697,391,4,158.40625,30,2,23,35.22839546831774,0.6357638888888889,44.9260752688172,1020.2956989247306,34.00985663082435,0
419,4,0,1,31,0.0,0.03125,0.96875,32,750,400,350,0.5333333333333333,11,4,7,379.12171005862984,0.42389112903225806,0.09471305807981079,0.2156307973389645,130193.9914477107,3471.87373540294,133665.86518311364,392,5,159.40625,30,2,25,35.18591685324203,0.6364583333333333,44.858870967741936,1020.5645161290321,34.01881720430107,0
420,4,0,0,31,0.0,0.0,1.0,31,1400,1000,400,0.7142857142857143,18,10,8,378.80615169648735,0.42172939068100357,0.0748013090229076,0.2162389815346934,130335.93285523175,3674.4286962047413,134010.36155143648,393,6,154.61290322580646,28,3,25,35.0496576145584,0.6439732142857143,44.71982758620688,1021.1206896551714,36.46859605911327,0
421,4,1,0,32,0.03125,0.0,1.0,32,900,600,300,0.6666666666666666,12,6,6,366.3800670407675,0.4239751344086022,0.07173411189570889,0.21144379417619202,130759.29783950602,3181.5200617283704,133940.8179012344,394,0,150.75,29,3,21,34.93742078580482,0.6451149425287357,44.30555555555554,1022.7777777777766,35.26819923371643,0
422,4,0,0,32,0.0,0.0,1.0,32,1050,600,450,0.5714285714285714,15,6,9,367.9333688041845,0.4230090725806452,0.07119233378561751,0.21351723843203432,130972.4633487652,3237.827932098734,134210.29128086392,395,1,151.75,29,3,23,34.68170511080958,0.6472701149425287,44.09722222222221,1023.6111111111093,35.29693486590032,0
423,4,0,0,32,0.0,0.0,1.0,32,550,400,150,0.7272727272727273,7,4,3,368.3726394349105,0.4230510752688172,0.06724409849409851,0.2139696395015541,131008.0078124998,3251.9531249999723,134259.96093749977,396,2,152.75,29,3,23,34.63446275946275,0.6476293103448276,44.062499999999986,1023.7499999999984,35.30172413793098,0
424,4,0,0,32,0.0,0.0,1.0,32,1200,900,300,0.75,15,9,6,369.4017297114167,0.4229880712365592,0.07039723427331879,0.21556227518602922,131185.80246913576,3292.0524691357964,134477.85493827154,397,3,153.75,29,3,23,34.428100144613154,0.6494252873563218,43.888888888888886,1024.4444444444441,35.32567049808428,0
425,4,0,1,31,0.0,0.03125,0.96875,32,900,400,500,0.4444444444444444,14,4,10,382.78601370853875,0.42183299731182794,0.06786174217408525,0.2135646948995834,129440.63484579147,3509.6129249046194,132950.2477706961,398,4,154.75,30,2,20,35.859970061198446,0.6288194444444444,45.598118279569896,1017.6075268817208,33.92025089605736,8
426,4,0,0,31,0.0,0.0,1.0,31,1150,800,350,0.6956521739130435,15,8,7,390.8547592565503,0.41841397849462364,0.08821107965677077,0.21811064897736074,129448.61352237666,3919.1213348765596,133367.7348572532,399,12,160.61290322580646,29,2,20,35.64655270460852,0.6318247126436782,45.590277777777786,1017.6388888888898,35.09099616858241,0
427,4,0,0,31,0.0,0.0,1.0,31,1100,700,400,0.6363636363636364,15,7,8,392.8487358699585,0.41836917562724013,0.09094389270486358,0.22001329890471094,129589.99083719142,3981.852816358032,133571.84365354944,400,13,161.61290322580646,29,2,20,35.45147887964353,0.6332614942528736,45.45138888888889,1018.1944444444449,35.110153256705,0
428,4,1,1,31,0.03125,0.03125,0.96875,32,1450,1100,350,0.7586206896551724,18,11,7,377.7065714286272,0.42208501344086025,0.08803772019402611,0.2141066049617849,130063.28158908429,3425.151231553829,133488.43282063812,401,0,157.53125,31,1,21,35.35496978980512,0.6323924731182795,44.98697916666667,1020.052083333334,32.90490591397852,0
429,4,0,0,31,0.0,0.0,1.0,31,700,400,300,0.5714285714285714,10,4,6,378.99483233973774,0.42141577060931895,0.07737346612733287,0.21536891969485691,130159.70054341538,3665.9707769684314,133825.67132038382,402,1,157.93548387096774,30,1,22,35.224029680365305,0.6361111111111111,44.89247311827957,1020.4301075268813,34.01433691756271,0
430,4,1,0,32,0.03125,0.0,1.0,32,800,700,100,0.875,9,7,2,367.80738699595753,0.42405913978494625,0.07460459686965693,0.2110520425154915,130537.14889365813,3202.546175858466,133739.6950695166,403,0,153.96875,30,2,18,35.12621114472357,0.6399305555555556,44.522849462365585,1021.9086021505368,34.06362007168456,0
431,4,0,0,32,0.0,0.0,1.0,32,800,700,100,0.875,9,7,2,367.811411659083,0.42387012768817206,0.07027038132807384,0.21142900874280596,130605.83457986456,3207.663277546518,133813.49785741107,404,1,154.96875,30,2,18,35.0564321718168,0.640625,44.45564516129031,1022.1774193548374,34.072580645161246,0
432,4,0,0,32,0.0,0.0,1.0,32,700,600,100,0.8571428571428571,8,6,2,367.0703039912606,0.42376512096774194,0.07115864879074674,0.21156597520950815,130708.89698230995,3195.870909931763,133904.7678922417,405,2,155.96875,30,2,20,34.970864002804056,0.6416666666666666,44.35483870967741,1022.5806451612891,34.0860215053763,0
433,4,0,1,31,0.0,0.03125,0.96875,32,650,400,250,0.6153846153846154,9,4,5,370.28289424835225,0.42275705645161293,0.07090177398160313,0.2137976346911958,130777.62783269743,3284.943707365015,134062.57154006243,406,3,156.96875,30,2,20,34.8190429259746,0.6423611111111112,44.28763440860215,1022.8494623655914,34.09498207885305,0
434,4,0,0,31,0.0,0.0,1.0,31,800,700,100,0.875,9,7,2,382.17007325141765,0.4220430107526882,0.06968793828891973,0.21974779211956516,130617.28395061729,3783.6033950617248,134400.88734567902,407,4,157.06451612903226,29,2,20,34.677875905797094,0.6436781609195402,44.44444444444444,1022.2222222222223,35.24904214559387,0
435,4,0,0,31,0.0,0.0,1.0,31,1100,800,300,0.7272727272727273,14,8,6,381.1321437548458,0.42186379928315415,0.06834521342545319,0.21975536213523314,130723.78713348755,3764.607445987641,134488.3945794752,408,5,158.06451612903226,29,2,20,34.59626397754539,0.6447557471264368,44.34027777777777,1022.6388888888881,35.263409961685795,0
436,4,0,0,31,0.0,0.0,1.0,31,250,100,150,0.4,4,1,3,382.3126497920947,0.4216845878136201,0.0717527290567892,0.2206387424035255,130759.29783950617,3798.1867283950655,134557.48456790124,409,6,159.06451612903226,29,2,20,34.53003349628827,0.6451149425287357,44.30555555555556,1022.7777777777777,35.26819923371647,0
437,4,1,0,32,0.03125,0.0,1.0,32,700,500,200,0.7142857142857143,9,5,4,402.107342962393,0.4254662298387097,0.13006812756928787,0.21862231242100988,128416.85319473353,3927.4719259452013,132344.32512067872,410,0,155.0625,30,2,16,36.41703133978695,0.6184027777777779,46.60618279569893,1013.5752688172047,33.785842293906825,7
438,4,1,0,33,0.030303030303030304,0.0,1.0,33,1000,700,300,0.7,13,7,6,390.92866954651055,0.4279119318181818,0.1236696491412268,0.21409045128432563,128705.44645521363,3462.929789225252,132168.3762444389,411,0,151.33333333333334,31,2,18,36.40459921296891,0.6186155913978495,46.32161458333333,1014.7135416666656,32.732694892473084,0
439,4,0,0,33,0.0,0.0,1.0,33,800,700,100,0.875,9,7,2,393.2130790733148,0.4278330176767677,0.1197511724502367,0.21641981677436697,128903.70898776577,3537.324863009974,132441.03385077574,412,1,152.33333333333334,31,2,20,36.14365623797923,0.6206317204301075,46.12630208333333,1015.4947916666661,32.75789650537632,0
440,4,0,1,32,0.0,0.030303030303030304,0.9696969696969697,33,1250,1000,250,0.8,15,10,5,395.7201175123792,0.4278330176767677,0.11592987035181368,0.218345711232785,129002.8974745007,3609.808349609351,132612.70582411005,413,2,153.33333333333334,31,2,20,35.9784884217722,0.6216397849462365,46.02864583333332,1015.8854166666653,32.77049731182791,0
441,4,1,0,33,0.030303030303030304,0.0,1.0,33,950,700,250,0.7368421052631579,12,7,5,398.34602785225724,0.4276357323232323,0.138776425547934,0.22147570850536577,129303.89577190993,3701.6912412031365,133005.58701311305,414,0,154.0,30,3,23,35.603883088850715,0.6274305555555555,45.732526881720425,1017.0698924731173,33.90232974910391,0
442,4,0,0,33,0.0,0.0,1.0,33,800,600,200,0.75,10,6,4,402.2019059452161,0.4282275883838384,0.14118730234978605,0.2242023879238058,129406.44330269386,3809.503627586992,133215.94693028086,415,1,155.0,30,3,23,35.4009797446059,0.6284722222222222,45.63172043010752,1017.4731182795691,33.91577060931897,0
443,4,0,2,31,0.0,0.06060606060606061,0.9393939393939394,33,900,600,300,0.6666666666666666,12,6,6,397.89615397183286,0.4271227904040404,0.14139813981398164,0.22276891103744526,129577.44618236217,3711.673495490817,133289.11967785298,416,2,156.0,30,3,16,35.335808580858085,0.6302083333333333,45.46370967741936,1018.1451612903229,33.938172043010766,0
444,4,0,0,31,0.0,0.0,1.0,31,950,600,350,0.631578947368421,13,6,7,398.0733981704885,0.42334229390681005,0.12379707936616002,0.2236470188831827,129714.32978162228,4127.164809515563,133841.49459113783,417,3,157.58064516129033,30,1,17,35.19153802172669,0.6315972222222221,45.32930107526882,1018.6827956989257,33.95609318996419,0
445,4,1,0,32,0.03125,0.0,1.0,32,1100,500,600,0.45454545454545453,17,5,12,387.40970992013814,0.4261382728494623,0.11912641954829639,0.22016895552169147,130162.91512383372,3685.2754380968126,133848.19056193053,418,0,153.625,31,1,20,35.00608757602824,0.6334005376344086,44.88932291666668,1020.4427083333347,32.917506720430154,0
446,4,0,0,32,0.0,0.0,1.0,32,1050,700,350,0.6666666666666666,14,7,7,388.1507024231974,0.4260962701612903,0.11921562061487423,0.22096683778470927,130229.35867309582,3709.7234090169422,133939.08208211276,419,1,154.625,31,1,21,34.91955287664244,0.6340725806451613,44.82421875000001,1020.7031250000009,32.92590725806455,0
447,4,0,0,32,0.0,0.0,1.0,32,750,500,250,0.6666666666666666,10,5,5,391.64264088013033,0.4244791666666667,0.12453786333503314,0.2239099763165995,130395.54172092027,3813.690863715297,134209.23258463558,420,2,155.625,31,1,21,34.66131225565189,0.635752688172043,44.66145833333334,1021.3541666666678,32.94690860215057,0
448,4,0,0,32,0.0,0.0,1.0,32,900,700,200,0.7777777777777778,11,7,4,392.5625647785637,0.4236391129032258,0.12819430282946698,0.22482086739070178,130462.04460991772,3842.9029676649548,134304.94757758267,421,3,156.625,31,1,22,34.57016314045374,0.6364247311827957,44.59635416666668,1021.6145833333348,32.955309139784994,0
449,4,0,0,32,0.0,0.0,1.0,32,650,300,350,0.46153846153846156,10,3,7,392.4410901938045,0.42359711021505375,0.1244584607543322,0.2251372570059196,130528.5644531251,3844.954427083347,134373.51888020846,422,4,157.625,31,1,19,34.50560652395515,0.6370967741935484,44.53125000000001,1021.8750000000008,32.96370967741938,0
450,4,0,0,32,0.0,0.0,1.0,32,950,600,350,0.631578947368421,13,6,7,392.6770997096427,0.42307207661290325,0.12127834033881024,0.22585405932750216,130628.3760070801,3858.954366048178,134487.3303731283,423,5,158.625,31,1,19,34.39808623105336,0.6381048387096775,44.43359375,1022.2656250000002,32.976310483870975,0
451,4,1,0,33,0.030303030303030304,0.0,1.0,33,1150,1000,150,0.8695652173913043,13,10,3,383.0043734034985,0.425228851010101,0.126144911938475,0.22263673576551749,131037.09323347113,3437.5559573002856,134474.64919077142,424,0,154.78787878787878,32,1,20,34.23048464668888,0.6396484375,44.034090909090914,1023.8636363636367,31.995738636363647,0
452,4,0,0,33,0.0,0.0,1.0,33,750,600,150,0.8,9,6,3,379.66724454404346,0.4253866792929293,0.12433468171173079,0.2214407156711593,131166.40082963475,3359.917195949395,134526.31802558413,425,1,155.78787878787878,32,1,21,34.18484736431242,0.6409505208333333,43.907828282828284,1024.368686868687,32.01152146464647,0
453,4,0,0,33,0.0,0.0,1.0,33,1000,800,200,0.8,12,8,4,376.6769221611022,0.42550505050505055,0.10930589302309945,0.22081154736649727,131360.48179076108,3296.092394908674,134656.57418566977,426,2,156.78787878787878,32,1,21,34.064899207619995,0.6429036458333333,43.71843434343434,1025.1262626262621,32.03519570707069,0
454,4,0,0,33,0.0,0.0,1.0,33,750,500,250,0.6666666666666666,10,5,5,376.3664204603026,0.4259785353535353,0.109064046025386,0.22119016403607647,131457.5760764207,3295.2434700540693,134752.81954647476,427,3,157.78787878787878,32,1,21,33.97459574817369,0.6438802083333333,43.62373737373737,1025.50505050505,32.04703282828281,0
455,4,0,0,33,0.0,0.0,1.0,33,750,500,250,0.6666666666666666,10,5,5,382.0073256083113,0.42459753787878785,0.1017779268701775,0.22603490227042017,131716.66953627186,3463.346533516996,135180.01606978886,428,4,158.78787878787878,32,1,19,33.56780442804429,0.646484375,43.371212121212125,1026.515151515152,32.0785984848485,0
456,4,0,0,33,0.0,0.0,1.0,33,950,700,250,0.7368421052631579,12,7,5,380.5386137207519,0.4240056818181818,0.10457618595295348,0.22612721859885448,131878.7324794664,3436.9900073972094,135315.7224868636,429,5,159.78787878787878,32,1,19,33.441661544765424,0.6481119791666667,43.21338383838384,1027.1464646464647,32.09832702020202,0
457,4,1,0,34,0.029411764705882353,0.0,1.0,34,1100,900,200,0.8181818181818182,13,9,4,372.2067040295474,0.42440953654188945,0.1104640569594535,0.22348376778426438,132271.91014273337,3046.4983419838327,135318.4084847172,430,0,156.05882352941177,33,1,20,33.25887538718133,0.6496212121212122,42.83088235294117,1028.6764705882338,31.172014260249508,0
458,4,1,1,34,0.02857142857142857,0.02857142857142857,0.9714285714285714,35,1100,700,400,0.6363636363636364,15,7,8,362.66935760567554,0.426750700280112,0.10487746847489876,0.21995661039201364,132650.37035034603,2621.7049932718146,135272.07534361785,431,0,152.57142857142858,33,2,19,33.123165992545005,0.6534090909090908,42.463235294117645,1030.1470588235293,31.216577540106947,0
459,4,0,0,34,0.0,0.0,1.0,34,1000,800,200,0.8,12,8,4,372.91790862540665,0.4247994652406417,0.11295069904341459,0.2252424168097458,132495.48037190086,3081.987488521586,135577.46786042245,432,2,158.05882352941177,32,2,20,33.01523792003925,0.654296875,42.61363636363637,1029.545454545455,32.17329545454547,0
460,4,0,0,34,0.0,0.0,1.0,34,1300,1000,300,0.7692307692307693,16,10,6,368.9198414545941,0.42418672014260245,0.1069489215325703,0.22340602425724773,132592.99314164382,2983.2372015610736,135576.2303432049,433,3,159.05882352941177,32,2,21,33.019952188304515,0.6552734375,42.5189393939394,1029.9242424242432,32.1851325757576,0
461,4,0,0,34,0.0,0.0,1.0,34,850,600,250,0.7058823529411765,11,6,5,369.422464790599,0.4240938799762329,0.11050142047503031,0.223904046639057,132625.50536935005,2998.968217528823,135624.47358687888,434,4,160.05882352941177,32,2,19,32.97427882650978,0.6555989583333333,42.48737373737374,1030.0505050505049,32.18907828282828,0
462,4,0,0,34,0.0,0.0,1.0,34,1550,1300,250,0.8387096774193549,18,13,5,383.71326286724735,0.42390819964349374,0.15058793494420986,0.2175115558105657,130063.28158908429,3184.095471937464,133247.37706102175,435,5,161.05882352941177,31,3,21,35.20179133690749,0.6323924731182795,44.98697916666667,1020.052083333334,32.90490591397852,8
463,4,0,0,34,0.0,0.0,1.0,34,1050,800,250,0.7619047619047619,13,8,5,385.52188157379396,0.423852495543672,0.1569378134102033,0.2189093814501632,130129.69970703138,3233.569335937515,133363.2690429689,436,6,162.05882352941177,31,3,22,35.088055130168456,0.6330645161290323,44.92187500000001,1020.312500000001,32.91330645161294,0
464,4,1,0,35,0.02857142857142857,0.0,1.0,35,1100,500,600,0.45454545454545453,17,5,12,376.6319116257086,0.4274509803921569,0.15908385093167676,0.21656334918478273,130617.28395061751,2838.9274691358287,133456.21141975332,437,0,158.4,32,3,20,34.81940670289855,0.6354166666666667,44.44444444444446,1022.222222222224,31.9444444444445,0
465,4,0,0,35,0.0,0.0,1.0,35,1000,600,400,0.6,14,6,8,376.9209496066973,0.42731092436974794,0.14743153402578146,0.21763625180070267,130778.66934815345,2858.6440478012687,133637.31339595473,438,1,159.4,32,3,21,34.648243015265614,0.6370442708333333,44.28661616161617,1022.8535353535369,31.96417297979803,0
466,4,0,0,35,0.0,0.0,1.0,35,1100,900,200,0.8181818181818182,13,9,4,375.9558536292711,0.4264005602240896,0.14905361108173776,0.21798985332753057,130940.15438475697,2845.543503213993,133785.69788797095,439,2,160.4,32,3,21,34.509159881569204,0.638671875,44.1287878787879,1023.484848484851,31.983901515151594,0
467,4,0,0,35,0.0,0.0,1.0,35,1100,700,400,0.6363636363636364,15,7,8,377.37354625360405,0.42615546218487393,0.15476983246128628,0.21936359043515977,131037.09323347126,2889.986512855854,133927.0797463271,440,3,161.4,32,3,22,34.3746146257245,0.6396484375,44.03409090909092,1023.8636363636379,31.995738636363683,0
468,4,0,0,35,0.0,0.0,1.0,35,1100,800,300,0.7272727272727273,14,8,6,376.3899890683132,0.42608543417366945,0.15620926545710767,0.21897581143070466,131069.41415416813,2866.6430721355246,133936.05722630364,441,4,162.4,32,3,22,34.36703658035349,0.6399739583333333,44.00252525252527,1023.9898989899004,31.99968434343439,0
469,4,0,0,35,0.0,0.0,1.0,35,900,700,200,0.7777777777777778,11,7,4,376.3791752739747,0.42584033613445377,0.15257819103972925,0.2193382090389718,131134.06795224998,2871.226469237857,134005.29442148784,442,5,163.4,32,3,22,34.30180596646944,0.640625,43.93939393939395,1024.2424242424258,32.00757575757581,0
470,4,0,0,35,0.0,0.0,1.0,35,800,500,300,0.625,11,5,6,376.6578292849206,0.4258053221288515,0.14964611429979913,0.21987062063437748,131198.73769258254,2883.4063488419747,134082.1440414245,443,6,164.4,32,3,23,34.22916153150931,0.6412760416666667,43.87626262626264,1024.4949494949508,32.01546717171721,0
471,4,0,0,35,0.0,0.0,1.0,35,750,600,150,0.8,9,6,3,379.15492408613903,0.4253501400560224,0.1616437843001366,0.2222762956191378,131362.56946251012,2961.4805484699655,134324.05001098008,444,7,165.4,30,5,24,33.99927887767144,0.6482638888888889,43.71639784946237,1025.1344086021506,34.17114695340502,0
472,4,0,0,35,0.0,0.0,1.0,35,900,400,500,0.4444444444444444,14,4,10,380.21644376457556,0.4251750700280112,0.16509850925162994,0.2230993102335526,131397.01844143835,2991.8614146144137,134388.87985605278,445,8,166.4,30,5,24,33.93719410942144,0.6486111111111111,43.682795698924735,1025.2688172043013,34.17562724014338,0
473,4,0,0,35,0.0,0.0,1.0,35,1600,1400,200,0.875,18,14,4,378.66612966780883,0.425,0.1569221561366103,0.2242055735195909,131741.75663371483,2977.2282200254313,134718.98485374026,446,9,167.4,30,5,20,33.62818582525966,0.6520833333333333,43.346774193548384,1026.6129032258061,34.22043010752687,0
474,4,0,0,35,0.0,0.0,1.0,35,850,500,350,0.5882352941176471,12,5,7,377.7410625079751,0.42412464985994397,0.15727371293976922,0.22447101086204876,131879.77837033191,2963.2815209850964,134843.059891317,447,10,168.4,30,5,21,33.512442205356365,0.6534722222222222,43.212365591397855,1027.1505376344094,34.238351254480314,0
475,4,0,0,35,0.0,0.0,1.0,35,1000,800,200,0.8,12,8,4,396.46031003037433,0.42401960784313725,0.10949036176392934,0.23162529992055347,131231.07854109272,3405.582816804406,134636.66135789713,448,11,169.4,32,3,20,33.689155884165125,0.6416015625,43.84469696969697,1024.621212121212,32.019412878787875,8
476,4,0,0,35,0.0,0.0,1.0,35,1000,700,300,0.7,13,7,6,396.50150434263503,0.42331932773109243,0.11224464659616795,0.2324329035204225,131360.48179076106,3416.925728242007,134777.40751900306,449,12,170.4,32,3,20,33.55683171162295,0.6429036458333333,43.71843434343434,1025.126262626262,32.035195707070685,0
477,4,0,0,35,0.0,0.0,1.0,35,950,800,150,0.8421052631578947,11,8,3,401.32880027559787,0.4226890756302521,0.1138354935720447,0.23606037977108488,131489.94880943265,3554.140680797876,135044.08949023052,450,13,171.4,32,3,20,33.30178710656983,0.6442057291666667,43.592171717171716,1025.6313131313127,32.05097853535352,0
478,4,0,0,35,0.0,0.0,1.0,35,550,400,150,0.7272727272727273,7,4,3,402.1960545237275,0.42237394957983193,0.11375127456840528,0.2371730870144999,131587.09092184465,3584.761759004184,135171.85268084882,451,14,172.4,32,3,19,33.18104438428092,0.6451822916666667,43.49747474747475,1026.0101010101007,32.06281565656565,0
479,4,0,0,35,0.0,0.0,1.0,35,1050,600,450,0.5714285714285714,15,6,9,397.61266293106183,0.42237394957983193,0.11306990881459011,0.23546894117206554,131749.07415378516,3477.0200425976773,135226.09419638282,452,15,173.4,32,3,19,33.134505800844515,0.6468098958333333,43.33964646464646,1026.641414141413,32.082544191919155,0
480,4,0,0,35,0.0,0.0,1.0,35,750,500,250,0.6666666666666666,10,5,5,397.61266293106183,0.42237394957983193,0.11306990881459011,0.23546894117206554,131749.07415378516,3477.0200425976773,135226.09419638282,453,16,174.4,32,3,19,33.134505800844515,0.6468098958333333,43.33964646464646,1026.641414141413,32.082544191919155,0
481,4,0,0,35,0.0,0.0,1.0,35,650,400,250,0.6153846153846154,9,4,5,395.41490638115965,0.42237394957983193,0.11010470100484882,0.2343669109833519,131781.48275686143,3421.6725334149464,135203.15529027637,454,17,175.4,32,3,19,33.15809968847352,0.6471354166666667,43.3080808080808,1026.767676767676,32.086489898989875,0
482,4,0,0,35,0.0,0.0,1.0,35,1050,700,350,0.6666666666666666,14,7,7,402.05136418216176,0.42142857142857143,0.11267051738970113,0.2393190892721472,131943.5855556832,3609.6197135496536,135553.20526923286,455,18,176.4,32,3,19,32.82357338904592,0.6487630208333333,43.15025252525253,1027.398989898991,32.10621843434347,0
483,4,0,0,35,0.0,0.0,1.0,35,950,700,250,0.7368421052631579,12,7,5,400.780684096364,0.4211484593837535,0.11202471649756052,0.23876670623544735,131976.01807213554,3578.6877614529185,135554.70583358846,456,19,177.4,32,3,19,32.82338002785288,0.6490885416666667,43.11868686868687,1027.5252525252529,32.11016414141415,0
484,4,0,1,34,0.0,0.02857142857142857,0.9714285714285714,35,850,600,250,0.7058823529411765,11,6,5,413.2690424722041,0.42034313725490197,0.058055275582197474,0.2343017960795043,130069.31889921942,3885.436594480149,133954.75549369957,457,20,178.4,32,3,17,34.44191731649957,0.6298828125,44.9810606060606,1020.0757575757572,31.87736742424241,8
485,4,0,1,33,0.0,0.029411764705882353,0.9705882352941176,34,1000,700,300,0.7,13,7,6,411.88507139865493,0.4181706773618538,0.08461023315402172,0.23390325101704335,130133.72559241395,3920.0277714008666,134053.75336381482,458,21,183.5,32,2,17,34.41147960235945,0.6305338541666667,44.91792929292929,1020.328282828282,31.885258838383812,0
486,4,0,0,33,0.0,0.0,1.0,33,1000,600,400,0.6,14,6,8,415.31621603680594,0.41575915404040403,0.08559107346599393,0.23562654255238027,130096.4885287813,4206.236267089821,134302.72479587112,459,22,187.6969696969697,31,2,17,34.3619708572644,0.632728494623656,44.95442708333332,1020.1822916666653,32.909106182795654,0
487,4,1,0,34,0.029411764705882353,0.0,1.0,34,1150,900,250,0.782608695652174,14,9,5,404.3664826550583,0.417242275698158,0.09232702943110227,0.23244195771668305,130605.83457986465,3762.736316283513,134368.57089614816,460,0,183.14705882352942,30,4,17,34.122287968441825,0.640625,44.45564516129032,1022.1774193548381,34.07258064516127,0
488,4,0,0,34,0.0,0.0,1.0,34,1250,700,550,0.56,18,7,11,406.5850629311557,0.41614676173499704,0.09745933073544899,0.2343408453621387,130708.89698231005,3828.8570210428898,134537.75400335295,461,1,184.14705882352942,30,4,17,33.9606883105503,0.6416666666666666,44.354838709677416,1022.5806451612899,34.08602150537633,0
489,4,0,0,34,0.0,0.0,1.0,34,1200,1000,200,0.8333333333333334,14,10,4,391.0157923006222,0.41566399286987527,0.14265324012677283,0.22489853372543472,130628.37600708009,3444.4566640016983,134072.8326710818,462,2,185.14705882352942,31,3,16,34.44054366747336,0.6381048387096775,44.43359375,1022.2656250000001,32.97631048387097,7
490,4,0,0,34,0.0,0.0,1.0,34,850,600,250,0.7058823529411765,11,6,5,409.49598270032186,0.41566399286987527,0.1536691692903851,0.22044444753189446,128020.48040417161,3686.6436874348774,131707.1240916065,463,3,186.14705882352942,33,1,21,36.63720029062727,0.6066919191919191,46.99754901960785,1012.0098039215698,30.666963755199085,8
491,4,0,0,34,0.0,0.0,1.0,34,750,500,250,0.6666666666666666,10,5,5,415.79585622389277,0.4158125371360666,0.15406198478362798,0.2248998727197103,128210.45769585489,3861.9955529986723,132072.45324885356,464,4,187.14705882352942,31,3,21,36.28235621839376,0.6135752688172043,46.80989583333332,1012.7604166666654,32.66969086021501,0
492,4,3,0,37,0.08108108108108109,0.0,1.0,37,1150,800,350,0.6956521739130435,15,8,7,429.43178335833295,0.4280530530530531,0.303846014689388,0.22001751863420754,126010.0969042663,3487.7201104580236,129497.81701472434,465,0,172.8918918918919,30,7,19,38.21285140562248,0.59375,48.99193548387096,1004.0322580645155,33.46774193548385,7
493,4,0,0,37,0.0,0.0,1.0,37,1450,1100,350,0.7586206896551724,18,11,7,429.28939554658547,0.4285222722722723,0.3006406544761766,0.2210611229024585,126218.23157793189,3436.83418462793,129655.06576255983,466,1,173.8918918918919,29,8,21,38.000316747293255,0.5987787356321839,48.78472222222221,1004.8611111111094,34.65038314176239,0
494,4,3,0,40,0.075,0.0,1.0,40,750,400,350,0.5333333333333333,11,4,7,394.7038531002622,0.4357238247863248,0.29016716148186417,0.20815321647159485,127190.50301445842,2043.5304053035602,129234.03341976198,467,0,161.775,31,9,21,37.8653295899488,0.6031586021505376,47.81901041666666,1008.7239583333322,32.539482526881685,0
495,4,0,0,40,0.0,0.0,1.0,40,950,600,350,0.631578947368421,13,6,7,395.20899063475565,0.4356570512820513,0.2923161290322587,0.2089269902741716,127289.03028700079,2061.153835720481,129350.18412272127,468,1,162.775,31,9,22,37.75107526881721,0.6041666666666667,47.721354166666664,1009.1145833333327,32.552083333333314,0
496,4,0,0,40,0.0,0.0,1.0,40,1850,1500,350,0.8108108108108109,22,15,7,396.2958364527358,0.435403311965812,0.29425706178253686,0.21001241421859593,127387.59570651577,2096.63475884331,129484.23046535908,469,2,163.775,31,9,20,37.622130143170395,0.6051747311827957,47.623697916666664,1009.5052083333327,32.56468413978492,0
497,4,0,0,40,0.0,0.0,1.0,40,800,300,500,0.375,13,3,10,394.19457264916406,0.43525641025641026,0.2900037509377347,0.20934715750650804,127474.24529384745,2049.931129476571,129524.17642332401,470,3,164.775,32,8,20,37.585958989747425,0.603515625,47.53787878787878,1009.8484848484838,31.55776515151512,0
498,4,0,0,40,0.0,0.0,1.0,40,750,600,150,0.8,9,6,3,397.57812500000006,0.4354700854700855,0.2955250000000005,0.2114777260638298,127538.00632588509,2141.2642842567057,129679.27061014179,471,4,165.775,32,8,20,37.434895833333336,0.6041666666666667,47.474747474747474,1010.1010101010098,31.565656565656557,0
499,4,1,0,41,0.024390243902439025,0.0,1.0,41,1400,1100,300,0.7857142857142857,17,11,6,402.40231315701266,0.43915142276422764,0.30635231121651185,0.20921950525395944,126612.3086734692,2082.13078007448,128694.43945354369,472,0,162.70731707317074,34,7,15,38.26812751360303,0.5900735294117647,48.39285714285713,1006.42857142857,29.60084033613441,8
500,4,1,1,41,0.023809523809523808,0.023809523809523808,0.9761904761904762,42,1450,1100,350,0.7586206896551724,18,11,7,390.5848275146125,0.4416013356562137,0.29659645208565744,0.20489232999983387,126975.33543381329,1518.9278978051927,128494.26333161848,473,0,159.8095238095238,35,7,16,38.190935538202424,0.5916666666666667,48.0324074074074,1007.8703703703691,28.79629629629626,0
501,4,3,2,42,0.06818181818181818,0.045454545454545456,0.9545454545454546,44,1750,1500,250,0.8571428571428571,20,15,5,374.97050959421233,0.4475312720225511,0.2891346621293147,0.2003413865546218,127717.31190650095,778.0986895929843,128495.41059609393,474,0,153.3409090909091,36,8,16,37.82169117647059,0.5972222222222222,47.29729729729729,1010.8108108108097,28.078078078078047,0
502,4,1,0,43,0.023255813953488372,0.0,1.0,43,1150,900,250,0.782608695652174,14,9,5,384.1742582063562,0.4446059431524548,0.30124530129970406,0.20540394972712678,127745.77100326674,1215.3273628358056,128961.09836610254,475,0,157.86046511627907,36,7,17,37.55987523671607,0.5975115740740741,47.26914414414414,1010.9234234234231,28.081206206206197,0
503,4,0,0,43,0.0,0.0,1.0,43,950,500,450,0.5263157894736842,14,5,9,382.70362804017947,0.44414451827242524,0.30443504031266566,0.2057804965853389,127973.55791179695,1195.188981210944,129168.74689300789,476,1,158.86046511627907,36,7,18,37.36319792246337,0.5998263888888888,47.04391891891892,1011.8243243243244,28.106231231231234,0
504,4,0,0,43,0.0,0.0,1.0,43,1200,900,300,0.75,15,9,6,381.9035913415679,0.44389073458840905,0.3040826413346409,0.20564215550549242,128030.53634293069,1179.064326150465,129209.60066908115,477,2,159.86046511627907,36,7,18,37.3249786728979,0.6004050925925926,46.98761261261261,1012.0495495495489,28.11248748748747,0
505,4,0,0,43,0.0,0.0,1.0,43,1000,800,200,0.8,12,8,4,382.3425126359035,0.4433831672203765,0.3029554097471918,0.206918944222436,128232.43694540892,1205.793155028618,129438.23010043753,478,3,160.86046511627907,35,8,18,37.10683064792596,0.6044642857142857,46.78819444444444,1012.8472222222221,28.93849206349206,0
506,4,0,0,43,0.0,0.0,1.0,43,1200,1000,200,0.8333333333333334,14,10,4,379.8085944830173,0.44306016980435586,0.2940426887543801,0.20691065221836025,128496.33487654325,1160.8024691358028,129657.13734567905,479,4,161.86046511627907,35,8,15,36.90068493150685,0.6071428571428572,46.52777777777778,1013.8888888888891,28.968253968253975,0
507,4,0,0,43,0.0,0.0,1.0,43,1400,1100,300,0.7857142857142857,17,11,6,379.93484402917124,0.44222960502030273,0.2923375754938282,0.20759033497952983,128613.70991941026,1172.965963648851,129786.67588305911,480,5,162.86046511627907,35,8,15,36.77734672143619,0.6083333333333334,46.412037037037045,1014.3518518518528,28.981481481481506,0
508,4,1,0,44,0.022727272727272728,0.0,1.0,44,900,600,300,0.6666666666666666,12,6,6,378.88555120181314,0.4445912614517266,0.2977222334206815,0.20889655695845694,128972.51136271408,973.1642115088075,129945.67557422289,481,0,160.13636363636363,36,8,17,36.43708425720621,0.6099537037037037,46.05855855855856,1015.7657657657659,28.215715715715717,0
509,4,0,1,43,0.0,0.022727272727272728,0.9772727272727273,44,900,500,400,0.5555555555555556,13,5,8,382.75588378089094,0.4442719344608879,0.3052124369036704,0.21148844699050717,129058.31665702879,1079.5660102670395,130137.88266729582,482,1,161.13636363636363,36,8,17,36.25110827884297,0.6108217592592593,45.97409909909911,1016.1036036036047,28.225100100100132,0
510,4,0,0,43,0.0,0.0,1.0,43,1050,700,350,0.6666666666666666,14,7,7,383.6899375502987,0.4437523071244001,0.2993361372257948,0.21215796546898907,129086.9247626007,1305.870820144494,130392.7955827452,483,2,162.58139534883722,36,7,17,36.19814753250589,0.6111111111111112,45.94594594594596,1016.2162162162183,28.228228228228286,0
511,4,1,0,44,0.022727272727272728,0.0,1.0,44,1200,800,400,0.6666666666666666,16,8,8,378.93194172900553,0.4442499119097956,0.3108900903018541,0.21162733352157861,129480.23069598364,1012.8390466297591,130493.0697426134,484,0,159.86363636363637,37,7,17,35.917636285283336,0.6131756756756757,45.5592105263158,1017.763157894739,27.507112375533488,0
512,4,0,0,44,0.0,0.0,1.0,44,1000,600,400,0.6,14,6,8,378.2771328833944,0.44408474277660326,0.3134092377577198,0.21186257273553705,129591.85157933224,1004.3268120960474,130596.17839142829,485,1,160.86363636363637,37,7,17,35.82050039485965,0.6143018018018018,45.44956140350878,1018.201754385966,27.518966334755838,0
513,4,1,1,44,0.022222222222222223,0.022222222222222223,0.9777777777777777,45,900,700,200,0.7777777777777778,11,7,4,376.5815019895603,0.4448021885521885,0.28877369810415177,0.20707510145031624,128867.1754770697,739.3188288704007,129606.4943059401,486,0,158.26666666666668,37,8,18,36.603221742260615,0.6069819819819819,46.162280701754376,1015.3508771929811,27.4419155998103,8
514,4,2,0,46,0.043478260869565216,0.0,1.0,46,1550,1200,350,0.7741935483870968,19,12,7,358.9385482098646,0.4476247987117552,0.27593378045829486,0.20001005234655003,129391.54071015042,89.15518011255705,129480.69589026298,487,0,152.02173913043478,38,8,21,36.51663516398893,0.6104714912280702,45.646367521367516,1017.4145299145295,26.774066576698143,0
515,4,0,4,42,0.0,0.08695652173913043,0.9130434782608696,46,1300,800,500,0.6153846153846154,18,8,10,361.6628620448154,0.44728260869565223,0.27174255320119944,0.20208575288568648,129500.26167223671,167.08705438672135,129667.34872662343,488,1,153.02173913043478,38,8,17,36.33663972569189,0.6115679824561404,45.53952991452991,1017.8418803418793,26.78531264057577,0
516,4,0,1,41,0.0,0.023809523809523808,0.9761904761904762,42,1500,1100,400,0.7333333333333333,19,11,8,425.5096693133812,0.4401737320944638,0.388441000335916,0.2228369745920143,126906.7260789121,2415.0546765063727,129321.78075541848,489,3,167.61904761904762,33,9,18,37.38192248439146,0.5953282828282829,48.10049019607844,1007.5980392156875,30.533273915626896,8
517,4,1,0,42,0.023809523809523808,0.0,1.0,42,1150,700,450,0.6086956521739131,16,7,9,416.6091871500851,0.44334349593495936,0.372082283044616,0.22003463413855476,127251.20722694127,2203.0747300563453,129454.28195699761,490,0,160.5952380952381,32,10,19,37.250239853168154,0.6012369791666667,47.758838383838395,1008.9646464646477,31.53014520202024,0
518,4,1,2,41,0.023255813953488372,0.046511627906976744,0.9534883720930233,43,1150,800,350,0.6956521739130435,15,8,7,404.6256165560168,0.44398301956441494,0.3696118015924936,0.21614974646075302,127710.61610918875,1734.9973567858542,129445.6134659746,491,0,157.8372093023256,33,10,18,37.07919091496928,0.6035353535353536,47.30392156862745,1010.78431372549,30.629827688651215,0
519,4,0,0,41,0.0,0.0,1.0,41,1150,800,350,0.6956521739130435,15,8,7,365.7511717060573,0.4407520325203252,0.2405388444965071,0.1970729511133374,128056.65569540871,1167.3743730709612,129224.03006847968,492,1,163.82926829268294,35,6,20,37.7069039451115,0.6026785714285714,46.96180555555554,1012.1527777777759,28.91865079365074,8
520,4,2,1,42,0.046511627906976744,0.023255813953488372,0.9767441860465116,43,1700,1300,400,0.7647058823529411,21,13,8,346.5009954594578,0.4452750092284976,0.22614109535600257,0.18918306686674316,128584.36113522365,310.9821084104773,128895.34324363412,493,0,157.1627906976744,35,8,17,37.65512666894899,0.6080357142857142,46.440972222222214,1014.2361111111102,28.978174603174576,0
521,4,2,1,43,0.045454545454545456,0.022727272727272728,0.9772727272727273,44,1200,700,500,0.5833333333333334,17,7,10,337.54645965947367,0.44649621212121215,0.2218511498482667,0.1857020394600044,128886.73460200055,-98.94780760491466,128787.78679439564,494,0,154.54545454545453,36,8,20,37.574165465232326,0.6090856481481481,46.14301801801801,1015.4279279279272,28.20633133133131,0
522,4,1,1,43,0.022727272727272728,0.022727272727272728,0.9772727272727273,44,1500,1100,400,0.7333333333333333,19,11,8,394.55807843873157,0.44426092318534177,0.3264009962640102,0.2149458188509507,128496.3348765431,1441.918086442284,129938.25296298538,495,0,154.86363636363637,32,12,16,36.52682648401825,0.6139322916666667,46.52777777777777,1013.888888888888,31.68402777777775,6
523,4,0,1,42,0.0,0.023255813953488372,0.9767441860465116,43,1300,1000,300,0.7692307692307693,16,10,6,401.97034594167087,0.4428755998523441,0.33547119963847494,0.21863265157315243,128432.33471074361,1725.1980027547986,130157.53271349841,496,1,159.4418604651163,32,11,17,36.40461509715995,0.61328125,46.59090909090908,1013.636363636362,31.676136363636314,0
524,4,1,1,42,0.023255813953488372,0.023255813953488372,0.9767441860465116,43,1450,1100,350,0.7586206896551724,18,11,7,384.94113473935636,0.4414913252122554,0.2666379685911662,0.20451138011508008,127489.75326678042,1217.5057421448828,128707.2590089253,497,0,160.34883720930233,36,7,16,37.803625854891465,0.5949074074074074,47.52252252252253,1009.909909909911,28.053053053053084,8
525,4,1,2,41,0.023255813953488372,0.046511627906976744,0.9534883720930233,43,1200,800,400,0.6666666666666666,16,8,8,380.21026379330215,0.44425987449243265,0.27202865580117797,0.20379786846361267,127847.22792935937,1121.7656512528347,128968.99358061221,498,0,160.46511627906978,38,5,17,37.55590182407211,0.5948464912280702,47.16880341880342,1011.3247863247866,26.613810166441752,0
526,4,0,0,41,0.0,0.0,1.0,41,1450,1000,450,0.6896551724137931,19,10,9,390.30287263089826,0.44032012195121956,0.29154773899370223,0.20927224472227435,127859.63909433075,1780.7968864134327,129640.43598074418,499,1,168.78048780487805,36,5,17,37.28797832461122,0.5986689814814814,47.15653153153153,1011.3738738738733,28.093718718718705,0
527,4,2,0,43,0.046511627906976744,0.0,1.0,43,1200,800,400,0.6666666666666666,16,8,8,379.9211859635956,0.4453672942045035,0.29289582669640013,0.2069719893682273,128496.33487654311,1163.6959876543078,129660.03086419743,500,0,161.88372093023256,38,5,18,36.8978310502283,0.6014254385964912,46.52777777777777,1013.8888888888881,26.681286549707583,0
528,4,0,0,43,0.0,0.0,1.0,43,1250,800,450,0.64,17,8,9,378.79904658441217,0.44541343669250644,0.2936196592610383,0.20650096215580996,128523.41666894934,1136.9095395938168,129660.32620854316,501,1,162.88372093023256,38,5,18,36.898553015137146,0.6016995614035088,46.50106837606837,1013.9957264957251,26.684098065676977,0
529,4,0,3,40,0.0,0.06976744186046512,0.9302325581395349,43,1500,1300,200,0.8666666666666667,17,13,4,394.59917192667814,0.4456441491325212,0.24205834397605286,0.21016397515216212,127590.03371229586,1472.951290492127,129062.98500278799,502,2,163.88372093023256,37,6,15,37.45658780117213,0.5940315315315315,47.423245614035075,1010.3070175438577,27.30559506875291,8
530,4,0,0,40,0.0,0.0,1.0,40,950,700,250,0.7368421052631579,12,7,5,403.1709297873176,0.4409455128205128,0.27551874557887324,0.21399848726257967,127452.38803854852,2277.0195578231023,129729.40759637163,503,3,175.075,34,6,15,37.38185765935706,0.5986519607843137,47.559523809523796,1009.7619047619029,29.698879551820674,0
531,4,0,1,39,0.0,0.025,0.975,40,950,500,450,0.5263157894736842,14,5,9,336.39011694395094,0.4402911324786325,0.11125298848076537,0.1776958585601744,127257.91229032014,561.6607994767705,127819.5730897969,504,4,176.075,37,3,18,39.26682605230748,0.5906531531531531,47.752192982456144,1008.9912280701757,27.27003319108583,8
532,4,1,0,40,0.025,0.0,1.0,40,1400,1000,400,0.7142857142857143,18,10,8,334.4997310565934,0.4426949786324786,0.12393212095580441,0.1783370043028897,127631.22420374035,538.5220341149942,128169.74623785535,505,0,170.1,38,2,14,38.932429336716716,0.5926535087719298,47.38247863247864,1010.4700854700865,26.591318038686484,0
533,4,0,0,40,0.0,0.0,1.0,40,1400,1000,400,0.7142857142857143,18,10,8,337.548424062642,0.4423076923076923,0.12676930389774999,0.18105217737116355,127874.24123612039,632.749721491724,128506.99095761211,506,1,171.1,38,2,14,38.60691524946304,0.5951206140350878,47.142094017094024,1011.4316239316252,26.61662168241119,0
534,4,1,0,41,0.024390243902439025,0.0,1.0,41,1050,700,350,0.6666666666666666,14,7,7,333.1371168549201,0.44380081300813007,0.14060863680690772,0.18013729210883,128198.62349559877,341.8293200745194,128540.4528156733,507,0,167.90243902439025,38,3,16,38.38726834757532,0.5984100877192983,46.8215811965812,1012.7136752136762,26.65035987404411,0
535,4,1,1,41,0.023809523809523808,0.023809523809523808,0.9761904761904762,42,850,400,450,0.47058823529411764,13,4,9,326.3990358419421,0.4451824428958575,0.12808981596657465,0.1721956750925861,127205.5903031407,12.397718097623397,127217.98802123833,508,0,164.88095238095238,36,6,19,39.57240269405375,0.5920138888888888,47.80405405405404,1008.7837837837816,28.02177177177171,8
536,4,1,0,42,0.023809523809523808,0.0,1.0,42,1100,600,500,0.5454545454545454,16,6,10,324.2951432761824,0.4444081494386372,0.13579371277686536,0.1716867908555477,127347.632154959,-140.3562768849996,127207.27587807401,509,0,165.83333333333334,36,6,17,39.48013128044924,0.5934606481481481,47.663288288288285,1009.3468468468468,28.03741241241241,0
537,4,2,0,44,0.045454545454545456,0.0,1.0,44,1500,1100,400,0.7333333333333333,19,11,8,311.18054956136524,0.4458025017618041,0.1539744771745979,0.1676066572786173,128041.65556423076,-831.1854509551335,127210.47011327563,510,0,159.25,40,4,20,39.10303075944709,0.5934895833333333,46.976626016260155,1012.0934959349579,25.302337398373947,0
538,4,1,1,44,0.022222222222222223,0.022222222222222223,0.9777777777777777,45,1650,1000,650,0.6060606060606061,23,10,13,335.34589434869616,0.44648569023569024,0.10005558890890054,0.18475451312683971,128943.21852898409,-310.15712786701283,128633.06140111707,511,0,156.6888888888889,40,5,17,37.57254352611566,0.6026041666666666,46.08739837398374,1015.6504065040651,25.39126016260163,6
539,4,1,2,43,0.022222222222222223,0.044444444444444446,0.9555555555555556,45,1350,700,650,0.5185185185185185,20,7,13,336.59007734349524,0.4474537037037037,0.10097382176242276,0.1864163206735917,129150.96391565865,-305.81341332831187,128845.15050233033,512,0,157.66666666666666,41,4,19,37.32960830242697,0.603150406504065,45.8829365079365,1016.4682539682524,24.79190863337201,0
540,4,0,2,41,0.0,0.046511627906976744,0.9534883720930233,43,750,400,350,0.5333333333333333,11,4,7,346.36207443930726,0.44585179032853456,0.11544688694474448,0.19117539966081276,129016.1254882811,337.25857204859676,129353.3840603297,513,1,165.30232558139534,39,4,19,37.218569499982905,0.6049679487179487,46.01562499999999,1015.9374999999989,26.049679487179457,0
541,4,0,1,40,0.0,0.024390243902439025,0.975609756097561,41,1250,1000,250,0.8,15,10,5,354.8710409368103,0.4412855691056911,0.14326142182090962,0.19582371615720934,129006.37846500838,956.1255626731208,129962.5040276815,514,2,173.85365853658536,37,4,19,37.01238981831266,0.6083896396396397,46.02521929824561,1015.899122807017,27.456733048838295,0
542,4,0,0,40,0.0,0.0,1.0,40,1350,1100,250,0.8148148148148148,16,11,5,357.97022158553295,0.4408787393162393,0.15395524041657405,0.19822326503257806,129144.15048494453,1245.9520331142103,130390.10251805875,515,3,178.625,36,4,21,36.79324543910186,0.6116898148148149,45.88963963963965,1016.4414414414425,28.234484484484515,0
543,4,0,0,40,0.0,0.0,1.0,40,1550,1200,350,0.7741935483870968,19,12,7,361.62795472134036,0.44027777777777777,0.15221845001170697,0.20084694338294476,129261.91184807259,1348.969524198776,130610.88137227137,516,4,179.625,34,6,21,36.58027979395926,0.6170343137254901,45.773809523809526,1016.904761904762,29.90896358543418,0
544,4,0,0,40,0.0,0.0,1.0,40,1100,800,300,0.7272727272727273,14,8,6,360.1294872554839,0.43967681623931626,0.1570798725679825,0.20045459553441758,129348.51794249422,1316.4430887774597,130664.96103127168,517,5,180.625,35,5,21,36.53015606629498,0.6157738095238094,45.68865740740742,1017.2453703703721,29.06415343915349,0
545,4,0,0,40,0.0,0.0,1.0,40,900,800,100,0.8888888888888888,10,8,2,363.2529239626183,0.4399439102564102,0.16026267909938574,0.2029508394744136,129495.73072059354,1407.9405649863115,130903.67128557985,518,6,181.625,35,5,18,36.30079220680767,0.6172619047619048,45.543981481481495,1017.8240740740762,29.08068783068789,0
546,4,0,0,40,0.0,0.0,1.0,40,950,800,150,0.8421052631578947,11,8,3,364.12136068991157,0.4392094017094017,0.16078247528128187,0.20420037302170416,129643.02722318702,1441.1590952932424,131084.18631848026,519,7,182.625,35,5,19,36.128750426184794,0.61875,45.39930555555557,1018.4027777777801,29.09722222222229,0
547,4,1,0,41,0.024390243902439025,0.0,1.0,41,1150,900,250,0.782608695652174,14,9,5,358.16117470227755,0.439989837398374,0.16232887490165182,0.2026094236454492,129982.90339335197,1110.965874115131,131093.8692674671,520,0,179.14634146341464,37,4,20,35.93503584229391,0.6182432432432432,45.06578947368422,1019.7368421052645,27.560455192034176,0
548,4,1,1,41,0.023809523809523808,0.023809523809523808,0.9761904761904762,42,1000,700,300,0.7,13,7,6,350.35401915868374,0.4420973674022455,0.1586977648202137,0.19962031324157578,130262.58680555565,727.6041666666766,130990.19097222232,521,0,175.85714285714286,38,4,21,35.85034013605442,0.6192434210526316,44.79166666666667,1020.8333333333342,26.86403508771932,0
549,4,0,1,40,0.0,0.024390243902439025,0.975609756097561,41,900,600,300,0.6666666666666666,12,6,6,350.31562671321547,0.441260162601626,0.13900556646139783,0.20033812952641036,130406.32482144328,936.6746814382237,131342.99950288152,522,1,172.4390243902439,36,5,21,35.70562293274532,0.6244212962962963,44.650900900900915,1021.3963963963981,28.37212212212217,0
550,4,0,0,40,0.0,0.0,1.0,40,1400,900,500,0.6428571428571429,19,9,10,351.7203533540822,0.43856837606837606,0.08490396791895316,0.18980080116077933,128117.48940755367,1015.5522187855186,129133.0416263392,523,2,177.5,38,2,19,37.9997273814549,0.5975877192982456,46.90170940170941,1012.3931623931637,26.641925326135887,8
551,4,0,0,40,0.0,0.0,1.0,40,1250,700,550,0.56,18,7,11,363.8040946909494,0.4385016025641026,0.10767265581134189,0.18501858727715076,125704.81957886963,1155.517036423807,126860.33661529343,524,3,178.5,36,4,17,40.175463222908455,0.5766782407407407,49.29617117117118,1002.8153153153171,27.85598098098103,8
552,4,5,3,42,0.1111111111111111,0.06666666666666667,0.9333333333333333,45,950,900,50,0.9473684210526315,10,9,1,339.4576873164398,0.4481271043771044,0.15831037649219448,0.17858426158821425,127092.01388888912,-370.6147025403526,126721.39918634878,525,0,159.55555555555554,39,6,16,39.35950413223141,0.5854700854700854,47.91666666666668,1008.3333333333353,25.854700854700905,0
553,4,1,1,42,0.023255813953488372,0.023255813953488372,0.9767441860465116,43,1250,900,350,0.72,16,9,7,352.1171354111781,0.44382152085640453,0.16827188298706885,0.18449010686594794,126926.22369382886,338.5796591258834,127264.80335295474,526,0,166.7674418604651,37,6,17,39.21064562930722,0.5872747747747749,48.08114035087719,1007.6754385964912,27.23447131341868,0
554,4,2,0,44,0.045454545454545456,0.0,1.0,44,1500,1000,500,0.6666666666666666,20,10,10,344.5557075738765,0.4472890239605356,0.18708290862934418,0.18320751740176758,127523.29082657605,-12.224459419972959,127511.06636715608,527,0,163.52272727272728,38,6,15,38.788916508003666,0.5915570175438596,47.48931623931624,1010.0427350427348,26.58007197480881,0
555,4,1,1,44,0.022222222222222223,0.022222222222222223,0.9777777777777777,45,1350,900,450,0.6666666666666666,18,9,9,336.1488417047851,0.448989898989899,0.19326259400432666,0.1799777609723305,127801.98703342023,-407.9020182291564,127394.08501519107,528,0,160.86666666666667,39,6,16,38.716154149926176,0.5926816239316239,47.21354166666667,1011.1458333333342,25.92681623931626,0
556,4,2,0,46,0.043478260869565216,0.0,1.0,46,1650,1100,550,0.6666666666666666,22,11,11,327.9232614601916,0.44989935587761676,0.2133505993445024,0.17803961848597144,128360.96871804015,-780.5736150775623,127580.39510296259,529,0,157.91304347826087,38,8,19,38.353760323317516,0.6000548245614035,46.66132478632479,1013.3547008547018,26.667228969860574,0
557,4,0,1,45,0.0,0.021739130434782608,0.9782608695652174,46,1350,900,450,0.6666666666666666,18,9,9,327.12110836558185,0.4492753623188406,0.2079757466958534,0.17869319924182028,128604.67916757993,-786.138961940231,127818.5402056397,530,1,158.91304347826087,38,8,14,38.125833859981725,0.6025219298245614,46.42094017094018,1014.3162393162404,26.692532613585275,0
558,4,0,0,45,0.0,0.0,1.0,45,1650,1100,550,0.6666666666666666,22,11,11,337.1120736102296,0.4474326599326599,0.2124279123414068,0.18382148919501204,128533.39489073562,-333.968144044322,128199.4267466913,531,2,163.42222222222222,37,8,14,37.945141291810835,0.6036036036036037,46.49122807017544,1014.0350877192984,27.4063537221432,0
559,4,1,0,46,0.021739130434782608,0.0,1.0,46,1600,1100,500,0.6875,21,11,10,332.0040197544355,0.4472222222222222,0.22188187711889573,0.1824773973236785,128848.62075617288,-644.3479938271591,128204.27276234572,532,0,160.84782608695653,38,8,15,37.75364797081621,0.6049890350877193,46.18055555555556,1015.277777777778,26.717836257309948,0
560,4,0,0,46,0.0,0.0,1.0,46,1250,900,350,0.72,16,9,7,334.5483350911105,0.4468900966183575,0.21812295366830714,0.1845061235525683,128984.24373584622,-569.7072010373338,128414.53653480888,533,1,161.84782608695653,38,8,15,37.551053498808045,0.606359649122807,46.047008547008545,1015.8119658119651,26.731893837156978,0
561,4,0,2,44,0.0,0.043478260869565216,0.9565217391304348,46,1350,700,650,0.5185185185185185,20,7,13,338.9545821015853,0.44598429951690827,0.21525302922309275,0.18796572280178847,129201.38888888907,-441.3194444444264,128760.06944444464,534,2,162.84782608695653,39,7,17,37.218237704918046,0.6068376068376069,45.83333333333334,1016.6666666666681,26.068376068376104,0
562,4,0,0,44,0.0,0.0,1.0,44,1250,800,450,0.64,17,8,9,353.81595288164704,0.44311575052854124,0.21528711491466535,0.19496711311973208,128950.68825263545,324.96212777008407,129275.65038040552,535,3,170.86363636363637,37,7,17,37.095950735902704,0.6078265765765766,46.08004385964912,1015.6798245614036,27.450806069227124,0
563,4,0,0,44,0.0,0.0,1.0,44,1800,1300,500,0.7222222222222222,23,13,10,354.64343742506463,0.44252114164904865,0.2140119657466164,0.1961260684178614,129092.79348381919,356.38240558113057,129449.17588940031,536,4,171.86363636363637,38,6,18,36.93010583123073,0.6074561403508771,45.940170940170944,1016.2393162393168,26.743139901034652,0
564,4,1,1,44,0.022222222222222223,0.022222222222222223,0.9777777777777777,45,1250,1000,250,0.8,15,10,5,348.19847068858985,0.44276094276094274,0.21628055678520508,0.19421736920630256,129430.46932067219,13.635266883731504,129444.10458755592,537,0,169.0222222222222,36,9,14,36.75022133687473,0.6145833333333333,45.60810810810812,1017.567567567569,28.265765765765806,0
565,4,1,0,45,0.022222222222222223,0.0,1.0,45,1250,800,450,0.64,17,8,9,345.8081891594631,0.4436026936026936,0.2264939786412179,0.19436805114825004,129731.44531250015,-27.560763888873396,129703.88454861127,538,0,170.0,37,8,15,36.505197682344914,0.6157094594594594,45.31250000000001,1018.7500000000011,27.533783783783814,0
566,4,1,1,45,0.021739130434782608,0.021739130434782608,0.9782608695652174,46,1100,1000,100,0.9090909090909091,12,10,2,340.0417970433232,0.44443438003220614,0.2284274104010302,0.19242827705515267,129996.88042534754,-359.1254340277429,129637.7549913198,539,0,167.2826086956522,39,7,17,36.38278855975486,0.6148504273504274,45.05208333333335,1019.7916666666692,26.14850427350434,0
567,4,0,0,45,0.0,0.0,1.0,45,1300,900,400,0.6923076923076923,17,9,8,350.33842548496136,0.4422979797979798,0.23845240589426564,0.19835887364646781,130017.30974687729,110.0119165023217,130127.32166337961,540,1,171.75555555555556,38,7,17,36.099544311753604,0.6167763157894737,45.03205128205129,1019.8717948717967,26.83873144399465,0
568,4,0,0,45,0.0,0.0,1.0,45,1150,900,250,0.782608695652174,14,9,5,348.6496553117339,0.4414772727272727,0.24625907314349438,0.19823223259152914,130180.80210387928,77.49835634453325,130258.3004602238,541,2,172.75555555555556,38,7,18,35.97675879396985,0.618421052631579,44.87179487179488,1020.5128205128226,26.85560053981112,0
569,4,0,0,45,0.0,0.0,1.0,45,1150,800,350,0.6956521739130435,15,8,7,350.01708390139055,0.4415614478114478,0.24922196636661798,0.19928863048831297,130235.32238476172,116.91755241437659,130352.2399371761,542,3,173.75555555555556,38,7,18,35.88658328099923,0.6189692982456141,44.81837606837608,1020.7264957264977,26.86122357174994,0
570,4,0,0,45,0.0,0.0,1.0,45,1650,1400,250,0.8484848484848485,19,14,5,347.3337140120466,0.44027777777777777,0.2512446351931328,0.19933190976553417,130542.57079101267,68.3700434731476,130610.94083448581,543,4,174.75555555555556,37,8,15,35.64377682403433,0.6238738738738738,44.51754385964912,1021.9298245614038,27.61972498814605,0
571,4,0,0,45,0.0,0.0,1.0,45,1550,900,650,0.5806451612903226,22,9,13,348.19731588842274,0.4398358585858586,0.24769392033543025,0.20098914372569326,130766.77439212041,106.52797014463468,130873.30236226505,544,5,175.75555555555556,37,8,16,35.39477915951972,0.6261261261261262,44.298245614035075,1022.8070175438577,27.64343290659075,0
572,4,0,1,44,0.0,0.022222222222222223,0.9777777777777777,45,1850,1500,350,0.8108108108108109,22,15,7,341.0538890629195,0.43882575757575754,0.17588024457094664,0.18529422632593656,128388.03624260346,-242.55218606181273,128145.48405654164,545,6,176.75555555555556,38,7,16,37.99349040691544,0.600328947368421,46.63461538461538,1013.4615384615378,26.67004048582994,8
573,4,0,0,44,0.0,0.0,1.0,44,1350,900,450,0.6666666666666666,18,9,9,346.689614282902,0.43757707892882314,0.18657505285412257,0.18864893961421003,128450.017373134,106.45739554477714,128556.47476867877,546,8,181.63636363636363,37,7,16,37.7874301424193,0.602759009009009,46.5734649122807,1013.7061403508769,27.397463252726403,0
574,4,0,0,44,0.0,0.0,1.0,44,800,300,500,0.375,13,3,10,365.04285251387785,0.43797348484848486,0.19359243596289266,0.19191695817122373,127065.08333561619,618.3770343999289,127683.46037001612,547,9,182.63636363636363,38,6,20,38.74222916887428,0.5868969298245614,47.94337606837607,1008.2264957264957,26.532276203328834,8
575,4,2,1,45,0.043478260869565216,0.021739130434782608,0.9782608695652174,46,800,600,200,0.75,10,6,4,345.8690918122979,0.4408917069243156,0.1933028674411872,0.18427515500106503,127604.23657909645,-373.12200946013513,127231.11456963632,548,0,175.65217391304347,38,8,19,38.67285256071341,0.5923793859649122,47.40918803418804,1010.3632478632487,26.588506522717072,0
576,4,1,0,46,0.021739130434782608,0.0,1.0,46,1800,1300,500,0.7222222222222222,23,13,10,345.46726722577625,0.4384057971014493,0.19400370904595077,0.18484593691804782,127775.65646701407,-371.53862847220284,127404.11783854186,549,0,176.6304347826087,39,7,20,38.507538292465135,0.5924145299145299,47.23958333333334,1011.0416666666681,25.924145299145337,0
577,4,0,1,45,0.0,0.021739130434782608,0.9782608695652174,46,1100,700,400,0.6363636363636364,15,7,8,344.81954009212535,0.43797302737520133,0.19332378095195413,0.1849833002372676,127880.99500868093,-380.82682291662763,127500.1681857643,550,1,177.6304347826087,39,7,21,38.416151733607975,0.593482905982906,47.135416666666686,1011.4583333333363,25.934829059829138,0
578,4,2,0,47,0.0425531914893617,0.0,1.0,47,1550,1100,450,0.7096774193548387,20,11,9,329.57507379406223,0.43829016342892385,0.21016191339915768,0.172037857455635,126774.66540660127,-1043.6460586803564,125731.01934792091,551,0,173.04255319148936,42,5,15,39.93392988870714,0.5776289682539683,48.231589147286826,1007.0736434108536,23.97794389073461,8
579,4,1,0,48,0.020833333333333332,0.0,1.0,48,1800,1300,500,0.7222222222222222,23,13,10,325.87938675202645,0.43884825650118203,0.20982896050683486,0.1715518403015973,127118.27392578151,-1313.3681509172245,125804.90577486428,552,0,170.41666666666666,39,9,18,39.674900148056345,0.5857371794871795,47.890625000000014,1008.437500000002,25.85737179487185,0
580,4,1,2,47,0.02040816326530612,0.04081632653061224,0.9591836734693877,49,1400,900,500,0.6428571428571429,19,9,10,314.660494583422,0.44084821428571425,0.21535561296363892,0.16722438476845217,127502.23597891499,-1776.0166732764628,125726.21930563853,553,0,167.91836734693877,40,9,15,39.56530489031994,0.5880208333333333,47.51016260162603,1009.9593495934986,25.248983739837463,0
581,4,4,2,49,0.0784313725490196,0.0392156862745098,0.9607843137254902,51,1150,700,450,0.6086956521739131,16,7,9,321.2811956430973,0.4447549019607843,0.2666587999291987,0.17427494671173502,128324.66310562537,-1951.1123091413438,126373.55079648402,554,0,162.15686274509804,40,11,19,38.55901036442661,0.5963541666666667,46.697154471544735,1013.2113821138245,25.33028455284561,0
582,4,1,0,50,0.02,0.0,1.0,50,1450,900,550,0.6206896551724138,20,9,11,329.22833292323827,0.4441751700680272,0.2794043918580169,0.17893156208411237,128401.90120174861,-1545.291224634771,126856.60997711384,555,0,165.9,40,10,16,38.27897824125141,0.5971354166666667,46.62093495934961,1013.5162601626041,25.337906504065103,0
583,4,0,1,49,0.0,0.02,0.98,50,1500,1100,400,0.7333333333333333,19,11,8,335.0751378978126,0.4446428571428571,0.28859605170858793,0.18281655555397894,128556.44710696356,-1384.7861515962586,127171.6609553673,556,1,166.9,40,10,16,37.97328556635603,0.5986979166666666,46.46849593495936,1014.1260162601635,25.35315040650409,0
584,4,0,0,49,0.0,0.0,1.0,49,1050,500,550,0.47619047619047616,16,5,11,344.4620536853551,0.44267290249433106,0.2900248655040394,0.18773760529525466,128513.93771701399,-946.365017361101,127567.5726996529,557,2,171.26530612244898,39,10,17,37.77866242038215,0.5998931623931624,46.51041666666667,1013.9583333333343,25.998931623931647,0
585,4,0,0,49,0.0,0.0,1.0,49,2100,1300,800,0.6190476190476191,29,13,16,325.9700864741216,0.44295634920634924,0.2523455787421034,0.17209540640710044,127235.28340937769,-1505.02073289717,125730.26267648052,558,3,172.26530612244898,43,6,18,39.55282835867592,0.5809108527131783,47.774621212121204,1008.9015151515136,23.462825933756132,8
586,4,2,0,51,0.0392156862745098,0.0,1.0,51,1400,900,500,0.6428571428571429,19,9,10,318.7240657237189,0.4437581699346405,0.2734275072035981,0.1703525178868152,127732.15973534968,-2057.7373450955747,125674.4223902541,559,0,166.47058823529412,45,6,15,39.227897252090806,0.5833333333333333,47.28260869565217,1010.869565217391,22.463768115942024,0
587,4,0,0,51,0.0,0.0,1.0,51,2050,1600,450,0.7804878048780488,25,16,9,321.76851361804285,0.4437745098039216,0.27598148977459225,0.172469776982499,127846.64071525173,-1972.5952891986808,125874.04542605305,560,1,167.47058823529412,45,6,15,39.0340909090909,0.5844907407407407,47.16938405797102,1011.3224637681177,22.47383252818039,0
588,4,0,2,49,0.0,0.0392156862745098,0.9607843137254902,51,850,700,150,0.8235294117647058,10,7,3,331.5902913454562,0.44382352941176473,0.16054225940215172,0.1725571114033722,126648.92082475958,-1777.9286811600996,124870.99214359948,561,2,168.47058823529412,44,7,14,40.01222671940637,0.5736268939393939,48.35648148148147,1006.5740740740712,22.876683501683434,7
589,4,3,0,52,0.057692307692307696,0.0,1.0,52,1600,1200,400,0.75,20,12,8,323.2204484766993,0.44745317998994466,0.20410953598264858,0.1709041029485416,127297.04231112382,-2167.1298374616663,125129.91247366216,562,0,165.80769230769232,40,12,18,39.558996307485735,0.5859375,47.71341463414632,1009.1463414634105,25.228658536585264,0
590,4,1,2,51,0.018867924528301886,0.03773584905660377,0.9622641509433962,53,1600,1000,600,0.625,22,10,12,316.1145344564417,0.4466618287373005,0.13776422187544357,0.16552453969569605,126901.11340679541,-2559.992143495668,124341.12126329975,563,0,163.66037735849056,43,10,17,40.143327067669205,0.5775193798449613,48.106060606060616,1007.5757575757591,23.431994362226956,8
591,4,2,2,51,0.03773584905660377,0.03773584905660377,0.9622641509433962,53,1800,1500,300,0.8333333333333334,21,15,6,321.0590430292031,0.44737239961296565,0.08558820349245844,0.1723840092572185,127915.35391724446,-2338.9394216047576,125576.4144956397,564,0,164.52830188679246,45,8,16,38.98191260744985,0.5851851851851853,47.10144927536233,1011.5942028985521,22.47987117552338,8
592,4,1,2,50,0.019230769230769232,0.038461538461538464,0.9615384615384616,52,1750,1300,450,0.7428571428571429,22,13,9,324.0097551453692,0.44672259929612873,0.10623364012496772,0.17465851298072863,128074.22839506171,-2100.540123456795,125973.68827160491,565,0,168.3846153846154,44,8,17,38.74519758507134,0.5880681818181819,46.94444444444444,1012.2222222222222,23.005050505050505,0
593,4,3,2,51,0.05660377358490566,0.03773584905660377,0.9622641509433962,53,2050,1600,450,0.7804878048780488,25,16,9,321.82133737563174,0.4498518384131592,0.12295764799952136,0.17599142354799105,128648.39916386886,-2319.6014457230017,126328.79771814586,566,0,159.60377358490567,43,10,13,38.21573866641774,0.595203488372093,46.377840909090914,1014.4886363636368,23.592758985200856,0
594,4,6,3,54,0.10526315789473684,0.05263157894736842,0.9473684210526316,57,1400,900,500,0.6428571428571429,19,9,10,307.8244874525776,0.45112781954887216,0.17806112380514327,0.1729121677037795,129707.3282989698,-3409.8378135043577,126297.49048546545,567,0,149.2982456140351,43,14,17,37.4969980787704,0.6058624031007752,45.33617424242424,1018.655303030303,23.689658210007046,0
595,4,0,0,54,0.0,0.0,1.0,54,1800,1300,500,0.7222222222222222,23,13,10,321.0961722619671,0.44799673887724206,0.17325914215154414,0.1799242907937951,129610.88266363906,-2476.488338642119,127134.39432499695,568,1,157.5,43,11,17,37.25675392913605,0.6048934108527132,45.430871212121204,1018.2765151515136,23.680849189570086,0
596,4,0,1,53,0.0,0.018518518518518517,0.9814814814814815,54,1150,600,550,0.5217391304347826,17,6,11,323.61916910812073,0.447727405078034,0.17467531155951455,0.18184157806575788,129719.65449245514,-2404.046639231851,127315.6078532233,569,2,158.5,44,10,18,37.08227292007513,0.6046401515151515,45.32407407407406,1018.7037037037015,23.152356902356853,0
597,4,0,1,52,0.0,0.018867924528301886,0.9811320754716981,53,2200,1800,400,0.8181818181818182,26,18,8,325.0992990822021,0.4479015481373972,0.1773029462488731,0.18311376078294309,129813.99605624109,-2159.512174211279,127654.4838820298,570,3,160.56603773584905,44,9,18,36.948974801623365,0.6055871212121212,45.23148148148147,1019.0740740740713,23.160774410774348,0
598,4,0,0,52,0.0,0.0,1.0,52,1400,1200,200,0.8571428571428571,16,12,4,325.7027119176315,0.44779883107088986,0.1743918474687709,0.18374549219504094,129876.19447314035,-1939.7942493113067,127936.40022382904,571,4,162.6346153846154,43,9,18,36.87058714232628,0.6075581395348837,45.17045454545454,1019.3181818181806,23.70507399577164,0
599,4,0,1,51,0.0,0.019230769230769232,0.9807692307692307,52,1650,1200,450,0.7272727272727273,21,12,9,328.809813458622,0.4471546631473102,0.1800348611269864,0.1859571466030691,129972.73875114757,-1852.7376033058092,128120.00114784176,572,5,163.6346153846154,43,9,18,36.693598315998024,0.6085271317829457,45.075757575757564,1019.6969696969675,23.713883016208545,0
600,4,0,0,51,0.0,0.0,1.0,51,1350,1000,350,0.7407407407407407,17,10,7,338.494002371233,0.4465359477124183,0.17125542639046754,0.19143400302171382,129972.73875114758,-1401.0014921946984,128571.73725895288,573,6,167.58823529411765,43,8,19,36.44672486379397,0.6085271317829457,45.075757575757564,1019.6969696969676,23.71388301620855,0
601,4,0,1,50,0.0,0.0196078431372549,0.9803921568627451,51,1650,1100,550,0.6666666666666666,22,11,11,337.0650538258938,0.4460130718954249,0.17654702497297414,0.19133503108114733,130117.62242452917,-1428.3793187557612,128689.2431057734,574,7,168.58823529411765,43,8,19,36.33631891590865,0.6099806201550387,44.93371212121211,1020.2651515151498,23.727096546863947,0
602,4,0,0,50,0.0,0.0,1.0,50,1600,1100,500,0.6875,21,11,10,343.00784565829935,0.444030612244898,0.16936904886470594,0.19570901378843963,130317.12420784913,-1059.7179640376328,129257.4062438115,575,8,172.24,38,12,19,35.98256949530884,0.6197916666666667,44.73824786324785,1021.0470085470067,26.869658119658073,0
603,4,0,0,50,0.0,0.0,1.0,50,1450,900,550,0.6206896551724138,20,9,11,340.5884000630243,0.44339285714285714,0.1664853556485355,0.194738343576705,130398.95171305405,-1117.5259332310877,129281.42577982297,576,9,173.24,38,12,20,35.96147140864713,0.6206140350877193,44.658119658119645,1021.3675213675194,26.8780926675663,0
604,4,1,1,50,0.0196078431372549,0.0196078431372549,0.9803921568627451,51,1250,900,350,0.72,16,9,7,337.7702929720719,0.44392156862745097,0.18657401860948064,0.1951120162932789,130794.81336805531,-1364.279513888915,129430.5338541664,577,0,170.8235294117647,39,12,16,35.63306177868295,0.6228632478632479,44.27083333333332,1022.9166666666647,26.228632478632427,0
605,4,0,0,50,0.0,0.0,1.0,50,1300,1000,300,0.7692307692307693,16,10,6,343.4376982556645,0.4435204081632653,0.17269423558897268,0.19859658203479708,130835.79881656794,-1013.2108809993524,129822.58793556859,578,1,174.78,38,12,18,35.44668964076859,0.625,44.230769230769226,1023.0769230769222,26.9230769230769,0
606,4,0,2,48,0.0,0.04,0.96,50,1750,1200,550,0.6857142857142857,23,12,11,334.2414991752769,0.4431462585034014,0.17775354416575717,0.18803647530290163,129766.82098765469,-1299.010154138327,128467.81083351636,579,2,175.78,44,6,11,36.763904034896385,0.6051136363636364,45.27777777777779,1018.8888888888919,23.156565656565725,8
607,4,0,0,48,0.0,0.0,1.0,48,1500,1000,500,0.6666666666666666,20,10,10,342.02157479167795,0.4404550827423168,0.19442330860440005,0.1923002586823377,129743.78511658002,-724.9652589988086,129018.81985758121,580,3,183.60416666666666,42,6,11,36.58911134360536,0.6076388888888888,45.30038759689925,1018.798449612407,24.25710594315255,0
608,4,0,1,47,0.0,0.020833333333333332,0.9791666666666666,48,1100,700,400,0.6363636363636364,15,7,8,336.8301845370996,0.4405474290780142,0.13452753850169685,0.18303495559739402,128395.7703451751,-862.0136115059368,127533.75673366916,581,4,184.60416666666666,41,7,16,38.09261615766117,0.5955284552845528,46.62698412698413,1013.4920634920634,24.719318621757644,8
609,4,1,0,48,0.020833333333333332,0.0,1.0,48,1500,1100,400,0.7333333333333333,19,11,8,321.7083232982875,0.44164635047281325,0.12401972528350069,0.17224352763558912,127801.37466385742,-1377.0468083348337,126424.32785552258,582,0,185.27083333333334,42,6,12,39.08181600383321,0.5880456349206349,47.21414728682171,1011.1434108527138,24.074843115540805,8
610,4,2,3,47,0.04,0.06,0.94,50,1600,1000,600,0.625,22,10,12,317.51537779207774,0.44647108843537414,0.15358744394618862,0.17269738840886154,128432.33471074357,-1843.691661191317,126588.64304955225,583,0,178.82,43,7,12,38.5447807673144,0.5930232558139534,46.59090909090908,1013.6363636363617,23.572938689217715,0
611,4,1,1,47,0.020833333333333332,0.020833333333333332,0.9791666666666666,48,1450,1000,450,0.6896551724137931,19,10,9,324.49730347019886,0.4470393764775414,0.16822029751419132,0.17655556160055821,128446.0476899089,-1263.9207766440284,127182.12691326487,584,0,184.41666666666666,41,7,12,38.35388530045018,0.5960365853658536,46.577380952380935,1013.690476190473,24.724157955865195,0
612,4,0,0,47,0.0,0.0,1.0,47,1450,800,650,0.5517241379310345,21,8,13,330.0694045423861,0.44507400555041626,0.16125726853163203,0.17936111897898988,128395.77034517482,-924.096907281461,127471.67343789336,585,2,189.3404255319149,41,6,14,38.263916079352626,0.5955284552845528,46.62698412698411,1013.4920634920611,24.719318621757587,0
613,4,0,0,47,0.0,0.0,1.0,47,1200,700,500,0.5833333333333334,17,7,10,327.54881753822343,0.4452474560592044,0.15534659604964918,0.1786241988294687,128537.27357317746,-979.5536063037312,127557.71996687373,586,3,190.3404255319149,42,5,14,38.183627966236664,0.5954861111111112,46.48740310077518,1014.0503875968973,24.144056847545173,0
614,4,0,0,47,0.0,0.0,1.0,47,1650,1100,550,0.6666666666666666,22,11,11,322.2425825556876,0.44501618871415355,0.14995824333468222,0.17638275389130142,128684.70687045516,-1106.4615445286033,127578.24532592656,587,4,191.3404255319149,42,5,15,38.16811511157802,0.5969742063492063,46.34205426356588,1014.6317829457337,24.15789959394604,0
615,4,0,1,46,0.0,0.02127659574468085,0.9787234042553191,47,1550,1000,550,0.6451612903225806,21,10,11,324.7280896366646,0.444650015417823,0.15809125850485195,0.1786260184410816,128881.41605259586,-1029.716795114488,127851.69925748136,588,5,192.3404255319149,42,5,16,37.90497661990649,0.5989583333333333,46.14825581395348,1015.4069767441849,24.17635658914726,0
616,4,0,0,46,0.0,0.0,1.0,46,1300,1000,300,0.7692307692307693,16,10,6,326.26037597656244,0.445048309178744,0.16449558423913024,0.18000572467672415,128999.7480473671,-782.4987402368366,128217.24930713026,589,6,196.15217391304347,41,5,16,37.74576822916666,0.6016260162601625,46.03174603174603,1015.8730158730159,24.77739063104917,0
617,4,1,1,46,0.02127659574468085,0.02127659574468085,0.9787234042553191,47,1350,1100,250,0.8148148148148148,16,11,5,320.4556838169342,0.4449969164353993,0.16756953017210074,0.1785047820501175,129377.95380015446,-1107.8623984315832,128270.09140172288,590,0,192.95744680851064,41,6,17,37.50924345847553,0.6054369918699187,45.65972222222223,1017.3611111111122,24.813685636856395,0
618,4,0,1,45,0.0,0.021739130434782608,0.9782608695652174,46,1500,1000,500,0.6666666666666666,20,10,10,325.1954626082739,0.44476650563607084,0.17445152773193895,0.1812837957479978,129408.11107806207,-783.4138905413386,128624.69718752072,591,1,196.82608695652175,40,6,19,37.358086962311894,0.6072916666666667,45.63008130081301,1017.4796747967484,25.43699186991871,0
619,4,0,2,43,0.0,0.044444444444444446,0.9555555555555556,45,1450,1000,450,0.6896551724137931,19,10,9,327.2949631594226,0.44400252525252526,0.18188845690380373,0.18321769587171796,129572.31445312501,-518.3268229166672,129053.98763020834,592,2,198.2,39,6,14,37.138070390832816,0.6105769230769231,45.46875,1018.1250000000001,26.105769230769234,0
620,4,0,1,42,0.0,0.023255813953488372,0.9767441860465116,43,1050,900,150,0.8571428571428571,12,9,3,338.5654590441914,0.44156053894425984,0.178240294211224,0.1892175289769553,129508.13140822176,169.39599203600972,129677.52740025776,593,3,206.25581395348837,37,6,14,36.91638389170168,0.6134572072072072,45.531798245614034,1017.8728070175438,27.510075865339022,0
621,4,0,0,42,0.0,0.0,1.0,42,750,600,150,0.8,9,6,3,342.7856742750883,0.4403552071234998,0.18005458434756916,0.19147694215687602,129487.77113261938,477.3105876146697,129965.08172023405,594,4,211.23809523809524,36,6,14,36.82968208305671,0.615162037037037,45.551801801801815,1017.792792792795,28.272022022022085,0
622,4,0,0,42,0.0,0.0,1.0,42,1300,900,400,0.6923076923076923,17,9,8,339.0730579342703,0.4399196670538134,0.17486468271519162,0.19023428883111318,129659.75265806368,392.8257649541706,130052.57842301785,595,5,212.23809523809524,36,6,16,36.74950243255197,0.6168981481481481,45.382882882882896,1018.4684684684701,28.290790790790837,0
623,4,0,1,41,0.0,0.023809523809523808,0.9761904761904762,42,1150,900,250,0.782608695652174,14,9,5,337.262236245145,0.4399196670538134,0.1695458110291761,0.1896340243200641,129745.78622118759,351.67080086846363,130097.45702205606,596,6,213.23809523809524,36,6,17,36.70830109428542,0.6177662037037037,45.298423423423436,1018.8063063063078,28.300175175175216,0
624,4,0,0,41,0.0,0.0,1.0,41,900,600,300,0.6666666666666666,12,6,6,337.245527475034,0.4388719512195122,0.16922043574996826,0.1902326713232962,129871.11418898143,559.6904816866981,130430.80467066813,597,7,214.90243902439025,37,4,17,36.58159423407917,0.6171171171171171,45.17543859649124,1019.2982456140368,27.548601232811805,0
625,4,1,1,41,0.023809523809523808,0.023809523809523808,0.9761904761904762,42,1100,800,300,0.7272727272727273,14,8,6,330.9105776211111,0.4398833720480062,0.17488680890401587,0.18868146520207504,130291.32806793287,224.13397314924202,130515.46204108212,598,0,210.76190476190476,36,6,18,36.31746819619089,0.6232638888888888,44.763513513513516,1020.9459459459465,28.359609609609624,0
626,4,0,0,41,0.0,0.0,1.0,41,1300,800,500,0.6153846153846154,18,8,10,337.3169886437838,0.43696646341463413,0.17554782666393898,0.19248450671510087,130321.6695066014,591.94262259944,130913.61212920085,599,1,216.5121951219512,35,6,18,36.12323358270989,0.6255952380952381,44.73379629629629,1021.0648148148141,29.173280423280403,0
627,4,0,0,41,0.0,0.0,1.0,41,900,600,300,0.6666666666666666,12,6,6,336.6697096817721,0.4367378048780488,0.17572807701616178,0.19253431694915968,130406.32482144305,580.7719036604168,130987.09672510346,600,2,217.5121951219512,36,5,18,36.054070194781325,0.6244212962962963,44.6509009009009,1021.3963963963962,28.372122122122118,0
628,4,0,0,41,0.0,0.0,1.0,41,900,400,500,0.4444444444444444,14,4,10,336.99490884602596,0.4364329268292683,0.18035122811545623,0.19300617506636022,130463.84222059888,593.1301233666,131056.97234396548,601,3,218.5121951219512,36,5,18,35.987562463256914,0.625,44.59459459459459,1021.6216216216208,28.378378378378354,0
629,4,1,0,42,0.023809523809523808,0.0,1.0,42,1250,900,350,0.72,16,9,7,334.2770598005595,0.43670150987224154,0.19217705289248643,0.19422183617659117,131019.23338190568,359.3448224453312,131378.578204351,602,0,214.28571428571428,37,5,17,35.49576505658489,0.6286599099099099,44.05153508771928,1023.7938596491205,27.670104314841094,0
630,4,0,0,42,0.0,0.0,1.0,42,1050,900,150,0.8571428571428571,12,9,3,333.64570965442846,0.4367620015485869,0.18996114187804047,0.19399649045784856,131047.2994094334,344.67384195133525,131391.97325138474,603,1,215.28571428571428,37,5,17,35.48359748697078,0.6289414414414414,44.02412280701753,1023.9035087719277,27.673067804646696,0
631,4,0,0,42,0.0,0.0,1.0,42,1200,700,500,0.5833333333333334,17,7,10,334.3372739077789,0.43659262485482,0.1871237856844865,0.19498940281190885,131163.9135437211,370.5970578566556,131534.51060157776,604,2,216.28571428571428,38,4,17,35.34822173550269,0.6282894736842105,43.9102564102564,1024.3589743589735,26.956815114709826,0
632,4,0,0,42,0.0,0.0,1.0,42,1550,1100,450,0.7096774193548387,20,11,9,366.5997256597479,0.4363143631436314,0.20057818488923607,0.20512793809816393,129554.63927469113,1300.5436618817791,130855.1829365729,605,3,217.28571428571428,32,10,18,36.15563892678493,0.6246744791666667,45.4861111111111,1018.0555555555536,31.81423611111105,8
633,4,1,1,42,0.023255813953488372,0.023255813953488372,0.9767441860465116,43,1200,700,500,0.5833333333333334,17,7,10,361.02279742897065,0.43888427464008856,0.2113951532458389,0.20454681708654313,130043.75007509111,789.7516880526448,130833.50176314375,606,0,213.2093023255814,33,10,19,35.80026733149103,0.627209595959596,45.00612745098038,1019.9754901960769,30.908348187759906,0
634,4,1,0,43,0.023255813953488372,0.0,1.0,43,1500,1100,400,0.7333333333333333,19,11,8,353.0989162745044,0.4391611295681063,0.21524101874349189,0.20134150970546177,130292.97052154168,601.2613378684454,130894.23185941012,607,0,212.2093023255814,34,9,20,35.74947527985074,0.6274509803921569,44.761904761904745,1020.9523809523788,30.02801120448173,0
635,4,0,1,42,0.0,0.023255813953488372,0.9767441860465116,43,1300,900,400,0.6923076923076923,17,9,8,352.31959183008166,0.43895348837209297,0.21488588930449426,0.20152680652680616,130414.5408163261,589.5195578230773,131004.06037414918,608,1,213.2093023255814,34,9,20,35.646124708624704,0.6286764705882353,44.64285714285712,1021.4285714285679,30.042016806722586,0
636,4,0,0,42,0.0,0.0,1.0,42,1050,700,350,0.6666666666666666,14,7,7,352.01733622525774,0.43809281842818426,0.19925250137346628,0.20151172529345754,130444.94224773199,783.7762188208089,131228.7184665528,609,2,210.95238095238096,34,8,21,35.623033445985314,0.6289828431372548,44.61309523809521,1021.5476190476155,30.04551820728281,0
637,4,0,0,42,0.0,0.0,1.0,42,1500,1200,300,0.8,18,12,6,338.97147009079004,0.43808072009291527,0.1324563069908813,0.18743128346196636,129086.92476260055,365.8694029109179,129452.79416551147,610,3,211.95238095238096,36,6,17,37.33423832742316,0.6111111111111112,45.94594594594595,1016.216216216217,28.22822822822825,8
638,4,0,0,42,0.0,0.0,1.0,42,1400,1000,400,0.7142857142857143,18,10,8,339.2905133028753,0.4376330816879597,0.13348946135831352,0.1881520119225037,129201.38888888895,367.3611111111153,129568.75000000006,611,4,212.95238095238096,36,6,18,37.20969945355192,0.6122685185185186,45.833333333333336,1016.6666666666672,28.240740740740755,0
639,4,0,0,42,0.0,0.0,1.0,42,1400,1100,300,0.7857142857142857,17,11,6,340.48572813169125,0.4373669183120403,0.130678344821771,0.1899153728023436,129430.4693206722,413.845517815135,129844.31483848733,612,5,213.95238095238096,36,6,17,36.94642725394718,0.6145833333333333,45.60810810810812,1017.5675675675691,28.265765765765806,0
640,4,1,0,43,0.023255813953488372,0.0,1.0,43,1200,900,300,0.75,15,9,6,332.15553429067717,0.4400609080841639,0.13099816105182827,0.18722775568416283,129843.17440221999,25.625793513396275,129868.80019573338,613,0,209.95348837209303,37,6,18,36.73962255693026,0.6168355855855856,45.202850877192986,1019.1885964912286,27.54563774300618,0
641,4,0,0,43,0.0,0.0,1.0,43,1200,700,500,0.5833333333333334,17,7,10,332.40920891289835,0.439484126984127,0.13235231595295316,0.18790718745781407,129954.95158366035,39.64453004770917,129994.59611370806,614,1,210.95348837209303,37,6,18,36.61986503925154,0.6179617117117118,45.093201754385966,1019.6271929824561,27.557491702228543,0
642,4,1,0,44,0.022727272727272728,0.0,1.0,44,1100,700,400,0.6363636363636364,15,7,8,325.0222647254048,0.441783386187456,0.13515995204293274,0.18505737289550153,130235.3223847614,-334.1241142523345,129901.19827050906,615,0,207.13636363636363,38,6,19,36.52440513571975,0.6189692982456141,44.81837606837606,1020.726495726495,26.86122357174987,0
643,4,1,1,44,0.022222222222222223,0.022222222222222223,0.9777777777777777,45,1500,1000,500,0.6666666666666666,20,10,10,321.7154783778974,0.44217171717171716,0.1402322265227136,0.18558181943091648,130741.54188368065,-587.6844618055463,130153.8574218751,616,0,203.51111111111112,39,6,15,36.09738914918177,0.6223290598290598,44.32291666666667,1022.7083333333342,26.22329059829062,0
644,4,0,2,42,0.0,0.045454545454545456,0.9545454545454546,44,650,500,150,0.7692307692307693,8,5,3,320.1828431108215,0.44198158914728686,0.14372338455841516,0.18495267760872186,130794.81336805574,-424.34895833331444,130370.46440972242,617,1,206.1818181818182,39,5,15,36.08282416836388,0.6228632478632479,44.27083333333334,1022.9166666666681,26.228632478632516,0
645,4,1,0,43,0.023255813953488372,0.0,1.0,43,1150,700,450,0.6086956521739131,16,7,9,326.0303908268513,0.44109911406423036,0.1523686926953669,0.18839716307586618,130808.47447083435,-70.49238896193015,130737.98208187243,618,0,211.27906976744185,38,5,17,35.91949521322889,0.6247258771929824,44.25747863247864,1022.9700854700862,26.920265407107532,0
646,4,0,0,43,0.0,0.0,1.0,43,1250,1000,250,0.8,15,10,5,326.1346035128107,0.4394610557401255,0.1603787319951857,0.18966468689725619,131054.4963109068,-51.71876141424559,131002.77754949256,619,1,212.27906976744185,38,5,17,35.66860566221481,0.6271929824561404,44.01709401709403,1023.9316239316258,26.94556905083226,0
647,4,0,1,42,0.0,0.023255813953488372,0.9767441860465116,43,1400,1200,200,0.8571428571428571,16,12,4,324.4101278036846,0.43888427464008856,0.15790086445265894,0.1891997752665285,131163.9135437213,-89.81960880998048,131074.09393491133,620,2,213.27906976744185,38,5,17,35.60244576554026,0.6282894736842105,43.910256410256416,1024.358974358975,26.95681511470987,0
648,4,1,0,43,0.023255813953488372,0.0,1.0,43,1300,1000,300,0.7692307692307693,16,10,6,321.2267781533262,0.43920727205610927,0.1542903970362901,0.18787849122236028,131273.37643363304,-166.2952461830426,131107.08118745,621,0,214.09302325581396,38,5,18,35.57369856825133,0.6293859649122807,43.803418803418815,1024.7863247863263,26.968061178587533,0
649,4,0,1,42,0.0,0.023255813953488372,0.9767441860465116,43,1150,600,550,0.5217391304347826,17,6,11,321.8485848725196,0.4386997046880768,0.1519079363463871,0.1889162611022368,131410.26925131504,-141.15816074949083,131269.11109056554,622,1,215.09302325581396,38,5,18,35.4199228925706,0.6307565789473684,43.6698717948718,1025.3205128205138,26.982118758434574,0
650,4,0,1,41,0.0,0.023809523809523808,0.9761904761904762,42,1300,1000,300,0.7692307692307693,16,10,6,327.4287317485812,0.43759678668215257,0.16782748596070585,0.19248528774635298,131468.65051025295,209.32270025390594,131677.97321050684,623,2,220.28571428571428,37,5,18,35.21808956128158,0.6331644144144144,43.61293859649122,1025.5482456140335,27.717520151730636,0
651,4,0,0,41,0.0,0.0,1.0,41,850,600,250,0.7058823529411765,11,6,5,332.39673453977196,0.43790650406504067,0.16567685940450794,0.19513038478301895,131414.71021274655,536.3641090414739,131951.074321788,624,3,220.70731707317074,36,5,19,35.14506681310633,0.6345486111111112,43.66554054054054,1025.337837837838,28.481606606606608,0
652,4,1,0,42,0.023809523809523808,0.0,1.0,42,1100,600,500,0.5454545454545454,16,6,10,323.95004713869554,0.4376209833526907,0.16968259054128954,0.1918497337988366,131749.92696069946,136.07900988765923,131886.0059705871,625,0,216.42857142857142,37,5,15,35.02427551710635,0.6359797297297297,43.338815789473685,1026.6447368421054,27.747155049786635,0
653,4,0,0,42,0.0,0.0,1.0,42,800,400,400,0.5,12,4,8,327.14799951285016,0.43756049167634536,0.17602984831849078,0.19446208498961798,131890.67790089254,229.5542859341313,132120.23218682667,626,1,217.42857142857142,37,5,15,34.8006511528608,0.6373873873873874,43.20175438596491,1027.19298245614,27.761972498814597,0
654,4,0,1,41,0.0,0.023809523809523808,0.9761904761904762,42,1100,700,400,0.6363636363636364,15,7,8,326.9046613997756,0.4375,0.1752512083924187,0.19446157286695243,131918.83710612892,224.97655528625577,132143.8136614152,627,2,218.42857142857142,37,5,15,34.7785916319778,0.6376689189189189,43.174342105263165,1027.3026315789484,27.764935988620227,0
655,4,0,0,41,0.0,0.0,1.0,41,1200,900,300,0.75,15,9,6,335.0095731331319,0.43427337398373983,0.1789455946977494,0.19876072201698314,131819.1518165125,632.1355561642755,132451.28737267677,628,3,224.609756097561,36,5,17,34.67074240596556,0.638599537037037,43.2713963963964,1026.9144144144148,28.52540040040041,0
656,4,0,0,41,0.0,0.0,1.0,41,1100,700,400,0.6363636363636364,15,7,8,337.4547204947336,0.43409552845528454,0.1798312678435856,0.20097499150091064,131963.7458404351,706.3577936044221,132670.10363403952,629,4,225.609756097561,36,5,19,34.46245250621071,0.6400462962962963,43.130630630630634,1027.477477477478,28.541041041041055,0
657,4,0,0,41,0.0,0.0,1.0,41,850,400,450,0.47058823529411764,13,4,9,340.38733871975796,0.43351117886178864,0.18052040715432893,0.20318608505528027,132050.54029959033,789.6663978167567,132840.2066974071,630,5,226.609756097561,36,5,19,34.299788174281446,0.6409143518518519,43.04617117117118,1027.8153153153169,28.55042542542547,0
658,4,0,0,41,0.0,0.0,1.0,41,1200,900,300,0.75,15,9,6,342.3840272554604,0.4339684959349594,0.189604569865911,0.20531801187945675,132224.21481870415,854.2918340638286,133078.50665276797,631,6,227.609756097561,36,5,19,34.073780064965874,0.642650462962963,42.87725225225227,1028.4909909909934,28.56919419419426,0
659,4,0,0,41,0.0,0.0,1.0,41,1600,1300,300,0.8125,19,13,6,378.135948615327,0.43302845528455286,0.24985290362689638,0.21032017192604438,129319.08543381374,1643.7291771251084,130962.81461093885,632,7,228.609756097561,35,6,16,36.102260658473675,0.6154761904761905,45.71759259259261,1017.1296296296321,29.06084656084663,8
660,4,0,1,40,0.0,0.024390243902439025,0.975609756097561,41,1650,1300,350,0.7878787878787878,20,13,7,378.10191535653985,0.43274898373983745,0.24476757728013854,0.21156389614988091,129554.63927469151,1596.9714506173034,131151.6107253088,633,8,229.609756097561,35,6,15,35.862892223738065,0.6178571428571429,45.48611111111112,1018.0555555555568,29.087301587301624,0
661,4,2,0,42,0.047619047619047616,0.0,1.0,42,1200,600,600,0.5,18,6,12,369.4394920955946,0.43572154471544716,0.24091714552028587,0.20869066813516643,129927.00277970143,1200.0331832871643,131127.0359629886,634,0,220.42857142857142,37,5,17,35.704362945436294,0.6176801801801801,45.12061403508772,1019.5175438596491,27.554528212422948,0
662,4,1,0,43,0.023255813953488372,0.0,1.0,43,1300,1000,300,0.7692307692307693,16,10,6,365.62568147344575,0.436531007751938,0.24551728501157233,0.2086384063362703,130321.66950660155,931.0883212759692,131252.75782787753,635,0,216.27906976744185,35,8,18,35.40060832766567,0.6255952380952381,44.7337962962963,1021.0648148148152,29.173280423280435,0
663,4,0,0,43,0.0,0.0,1.0,43,1500,1000,500,0.6666666666666666,20,10,10,364.75136485067713,0.43655407899593945,0.24203126606200986,0.20829781825744484,130351.21588059409,909.1567804783856,131260.37266107247,636,1,217.27906976744185,35,8,18,35.39293607616457,0.6258928571428571,44.70486111111111,1021.1805555555552,29.17658730158729,0
664,4,0,1,42,0.0,0.023255813953488372,0.9767441860465116,43,850,500,350,0.5882352941176471,12,5,7,365.0684130673189,0.4364387227759321,0.24675509462001832,0.20895550024203335,130439.8750964505,923.8956404320861,131363.77073688258,637,2,218.27906976744185,35,8,18,35.29486743711762,0.6267857142857143,44.61805555555555,1021.5277777777768,29.18650793650791,0
665,4,1,0,43,0.023255813953488372,0.0,1.0,43,1150,900,250,0.782608695652174,14,9,5,360.5235774138781,0.4351698043558509,0.2552217001618824,0.20777728678745008,130706.03358892731,824.521363811707,131530.554952739,638,0,218.0,35,8,16,35.14112903225806,0.6294642857142857,44.35763888888888,1022.5694444444432,29.216269841269806,0
666,4,0,1,42,0.0,0.023255813953488372,0.9767441860465116,43,1550,1000,550,0.6451612903225806,21,10,11,359.1020899963621,0.43466223698781836,0.25383522545468473,0.2076666128336695,130838.01442912497,796.8408864945856,131634.85531561956,639,1,219.0,36,7,16,35.04379930288019,0.6287615740740741,44.228603603603595,1023.0855855855848,28.41904404404402,0
667,4,0,2,40,0.0,0.047619047619047616,0.9523809523809523,42,1500,1300,200,0.8666666666666667,17,13,4,358.07986367636767,0.4339551877661634,0.2330829824230618,0.20816253967682447,131039.71370018662,984.5365635906096,132024.25026377724,640,2,217.64285714285714,36,6,16,34.86581610206775,0.630787037037037,44.03153153153153,1023.8738738738734,28.44094094094093,0
668,4,0,0,40,0.0,0.0,1.0,40,950,600,350,0.631578947368421,13,6,7,374.38488682474434,0.4297809829059829,0.21893063583814998,0.20893092071187344,129450.69204152249,1739.611406184306,131190.3034477068,641,3,229.225,33,7,16,36.0634433204881,0.6212121212121212,45.588235294117645,1017.6470588235294,30.83778966131907,8
669,4,0,0,40,0.0,0.0,1.0,40,1000,800,200,0.8,12,8,4,371.707554760405,0.42903311965811963,0.21733269138180056,0.2080961162364854,129575.4337274125,1632.8335255670802,131208.26725297957,642,4,230.225,33,7,16,36.00445353875781,0.6224747474747474,45.4656862745098,1018.1372549019605,30.8526440879382,0
670,4,2,0,42,0.047619047619047616,0.0,1.0,42,1300,900,400,0.6923076923076923,17,9,8,352.52238408719154,0.4327453542392567,0.2190168343621901,0.2003990883621385,130173.98787133487,777.8489101080232,130951.8367814429,643,0,220.21428571428572,35,7,18,35.88486730180333,0.6241071428571429,44.87847222222222,1020.4861111111111,29.15674603174603,0
671,4,0,0,42,0.0,0.0,1.0,42,1200,900,300,0.75,15,9,6,356.98468007928807,0.43163230739450253,0.2253797382975855,0.20417302668177037,130410.31867551866,910.8971782836068,131321.21585380228,644,1,221.21428571428572,35,7,19,35.531279508970734,0.6264880952380952,44.64699074074074,1021.4120370370368,29.183201058201053,0
672,4,0,0,42,0.0,0.0,1.0,42,1300,1000,300,0.7692307692307693,16,10,6,357.91501645811627,0.43176538908246226,0.22317517854445734,0.2051736211228734,130498.99798525378,941.5102023319585,131440.50818758574,645,2,222.21428571428572,35,7,16,35.4176106328349,0.6273809523809524,44.56018518518518,1021.7592592592594,29.193121693121697,0
673,4,0,0,42,0.0,0.0,1.0,42,900,500,400,0.5555555555555556,13,5,8,359.1621576862877,0.4308217189314751,0.22202724631118187,0.20667617842625238,130646.86381440732,984.6819005058013,131631.5457149131,646,3,223.21428571428572,35,7,16,35.23588154269973,0.6288690476190476,44.415509259259245,1022.3379629629609,29.209656084656025,0
674,4,0,2,40,0.0,0.047619047619047616,0.9523809523809523,42,1050,1000,50,0.9523809523809523,11,10,1,360.5256163261494,0.43085801393728224,0.21943779775377825,0.20793762048680517,130735.62349965701,1026.7082475994491,131762.33174725645,647,4,224.21428571428572,35,7,16,35.11109853629094,0.6297619047619047,44.3287037037037,1022.6851851851848,29.219576719576708,0
675,4,1,0,41,0.024390243902439025,0.0,1.0,41,800,600,200,0.75,10,6,4,367.90213660204114,0.4296747967479675,0.22812886955138723,0.2117656534275022,130657.85147392306,1413.8605442177022,132071.71201814077,648,0,230.46341463414635,34,7,18,35.00135848470733,0.6311274509803921,44.40476190476191,1022.3809523809537,30.07002801120452,0
676,4,0,0,41,0.0,0.0,1.0,41,1250,1000,250,0.8,15,10,5,365.61168292473155,0.42990345528455287,0.16850232769387952,0.2062743172016726,129878.87577428407,1420.0202256506939,131298.89599993476,649,1,231.46341463414635,35,6,18,35.85086200370916,0.6211309523809524,45.16782407407407,1019.3287037037032,29.123677248677236,8
677,4,1,1,41,0.023809523809523808,0.023809523809523808,0.9761904761904762,42,600,400,200,0.6666666666666666,8,4,4,352.90463537027546,0.43203155245838176,0.162011422686696,0.20077681797619637,130205.1137920015,789.9976412223093,130995.1114332238,650,0,226.92857142857142,36,6,19,35.843539666777005,0.6223958333333333,44.847972972972975,1020.6081081081085,28.350225225225234,0
678,4,1,0,42,0.023809523809523808,0.0,1.0,42,1350,900,450,0.6666666666666666,18,9,9,352.31959183008144,0.4294788037166086,0.1683594183594188,0.20152680652680655,130414.54081632645,789.5449210241597,131204.0857373506,651,0,227.85714285714286,34,8,21,35.64612470862472,0.6286764705882353,44.64285714285714,1021.4285714285708,30.04201680672267,0
679,4,0,2,40,0.0,0.047619047619047616,0.9523809523809523,42,1550,1100,450,0.7096774193548387,20,11,9,351.38389807803486,0.42915214866434376,0.16642255177732257,0.20146479607239645,130505.75573979596,771.5242346938816,131277.27997448985,652,1,228.85714285714286,34,8,17,35.57759524641734,0.6295955882352942,44.55357142857143,1021.7857142857147,30.052521008403374,0
680,4,0,0,40,0.0,0.0,1.0,40,700,500,200,0.7142857142857143,9,5,4,359.23897826783707,0.4279113247863248,0.1602807101727448,0.20567418426103662,130450.30757401012,1372.5670415225086,131822.87461553264,653,2,231.85,33,7,21,35.43316138835573,0.6313131313131313,44.60784313725491,1021.5686274509815,30.956625074272164,0
681,4,0,0,40,0.0,0.0,1.0,40,1000,600,400,0.6,14,6,8,357.64357302819457,0.4266025641025641,0.15715325492022858,0.20569895255144702,130627.42524092959,1343.6118197278777,131971.03706065746,654,3,232.85,34,6,19,35.29438880478242,0.6308210784313726,44.4345238095238,1022.2619047619038,30.066526610644228,0
682,4,0,0,40,0.0,0.0,1.0,40,1250,900,350,0.72,16,9,7,344.9769878800453,0.4265625,0.154653139877579,0.1968555619067117,130321.66950660163,991.5954003772463,131313.26490697887,655,4,233.85,35,5,22,35.92769969016853,0.6255952380952381,44.733796296296305,1021.0648148148158,29.173280423280453,7
683,4,0,1,39,0.0,0.025,0.975,40,800,400,400,0.5,12,4,8,345.33608326846337,0.4264423076923077,0.14719830028328573,0.19751075404045323,130410.31867551884,1007.077733839177,131417.396409358,656,5,234.85,35,5,23,35.8287299338999,0.6264880952380952,44.64699074074075,1021.4120370370383,29.183201058201096,0
684,4,0,0,39,0.0,0.0,1.0,39,1050,700,350,0.6666666666666666,14,7,7,354.366645465698,0.4231612685560054,0.17325469527753312,0.20301565763595616,130475.3472222223,1447.2222222222274,131922.56944444453,657,6,241.71794871794873,34,5,23,35.53221859706361,0.6292892156862745,44.583333333333336,1021.6666666666673,30.049019607843157,0
685,4,0,0,39,0.0,0.0,1.0,39,1550,1200,350,0.7741935483870968,19,12,7,350.44948321288337,0.42338618983355825,0.17527997235844595,0.20135454692602306,130587.70743580679,1352.878916966743,131940.58635277353,658,7,242.71794871794873,35,4,21,35.51846242403655,0.6282738095238095,44.47337962962963,1022.1064814814818,29.203042328042336,0
686,4,0,1,38,0.0,0.02564102564102564,0.9743589743589743,39,1250,1000,250,0.8,15,10,5,351.22458322506947,0.4228520017993702,0.1729325708051519,0.20272838941606414,130765.21675936645,1385.5917513288755,132150.80851069532,659,8,243.71794871794873,35,4,21,35.318947795254786,0.6300595238095238,44.29976851851852,1022.8009259259262,29.222883597883605,0
687,4,0,0,38,0.0,0.0,1.0,38,800,600,200,0.75,10,6,4,353.8052046436397,0.41992650545282123,0.17023100738271002,0.20468835137760313,130854.01663237318,1659.3664266118085,132513.383058985,660,9,246.28947368421052,35,3,21,35.16308446455506,0.6309523809523809,44.21296296296297,1023.1481481481487,29.23280423280425,0
688,4,0,1,37,0.0,0.02631578947368421,0.9736842105263158,38,1150,900,250,0.782608695652174,14,9,5,356.47341422098634,0.4191708155523945,0.17970604861503636,0.20702608987423649,131002.08340031283,1739.7519879543768,132741.8353882672,661,10,247.28947368421052,35,3,21,34.94500188430374,0.6324404761904762,44.06828703703703,1023.726851851851,29.249338624338602,0
689,4,0,0,37,0.0,0.0,1.0,37,1150,800,350,0.6956521739130435,15,8,7,362.33775013520807,0.4179491991991992,0.18246385920804475,0.21054761156505353,131023.24263038566,2094.9333900226966,133118.17602040837,662,11,252.43243243243242,34,3,21,34.7734980620155,0.6348039215686274,44.04761904761906,1023.8095238095252,30.112044817927213,0
690,4,0,0,37,0.0,0.0,1.0,37,1500,1200,300,0.8,18,12,6,361.4066550582376,0.4181368868868869,0.17363131971650758,0.21086422570339228,131179.87403817297,2081.855897419406,133261.7299355924,663,12,253.43243243243242,35,2,21,34.63885907430422,0.6342261904761906,43.894675925925924,1024.421296296296,29.26917989417989,0
691,4,0,0,37,0.0,0.0,1.0,37,1100,800,300,0.7272727272727273,14,8,6,357.29321617164385,0.4179804804804805,0.16736365911879791,0.20894809352600638,131268.81456832998,1980.2913880315575,133249.10595636154,664,13,254.43243243243242,35,2,21,34.65429937504706,0.6351190476190476,43.807870370370374,1024.7685185185192,29.279100529100546,0
692,4,0,0,37,0.0,0.0,1.0,37,950,600,350,0.631578947368421,13,6,7,357.6908741052996,0.4179491991991992,0.1913825792780397,0.18981114268215543,127442.37075617292,1716.9945987654419,129159.36535493836,665,14,255.43243243243242,35,2,19,38.54023383768912,0.5964285714285714,47.56944444444445,1009.722222222223,28.84920634920637,7
693,4,0,0,37,0.0,0.0,1.0,37,850,700,150,0.8235294117647058,10,7,3,358.59283664576463,0.41747997997998,0.1922541097798829,0.19111816019032501,127617.73003472216,1752.560763888878,129370.29079861104,666,15,256.43243243243245,35,2,20,38.33762886597937,0.5982142857142857,47.39583333333333,1010.4166666666661,28.869047619047603,0
694,4,1,0,38,0.02631578947368421,0.0,1.0,38,1000,600,400,0.6,14,6,8,350.57497166083056,0.42100817923186346,0.1892322657009926,0.18810420522446739,127888.11404309726,1366.8743912831897,129254.98843438044,667,0,250.6578947368421,36,2,21,38.263332219995554,0.5989583333333333,47.128378378378386,1011.4864864864874,28.096846846846873,0
695,4,0,0,38,0.0,0.0,1.0,38,1000,700,300,0.7,13,7,6,351.3932919116167,0.4220898530109056,0.1905823030927707,0.1892133921156204,128030.53634293108,1397.8143261505086,129428.35066908158,668,1,251.6578947368421,36,2,22,38.09692704276548,0.6004050925925926,46.98761261261263,1012.049549549552,28.112487487487556,0
696,4,0,0,38,0.0,0.0,1.0,38,1300,800,500,0.6153846153846154,18,8,10,350.38696675642245,0.4222380275011854,0.18247779943686382,0.1892089620484683,128144.53125000012,1380.0347222222363,129524.56597222235,669,2,252.6578947368421,36,2,22,38.00582990397806,0.6015625,46.87500000000001,1012.5000000000009,28.125000000000025,0
697,4,0,0,38,0.0,0.0,1.0,38,1150,700,450,0.6086956521739131,16,7,9,350.2099203601107,0.4218972261735419,0.17732860110803284,0.19011395676691734,128355.55555555563,1390.2777777777867,129745.83333333342,670,3,253.6578947368421,34,4,23,37.79468201754385,0.607843137254902,46.66666666666667,1013.333333333334,29.803921568627473,0
698,4,0,0,38,0.0,0.0,1.0,38,850,600,250,0.7058823529411765,11,6,5,350.6010826921392,0.4225343764817449,0.17205716899719325,0.19061415185446193,128415.88010204078,1404.5493197278838,129820.42942176867,671,4,254.6578947368421,34,4,16,37.723161851068824,0.6084558823529411,46.607142857142854,1013.5714285714283,29.81092436974789,0
699,4,1,0,39,0.02564102564102564,0.0,1.0,39,1300,900,400,0.6923076923076923,17,9,8,338.8355123663807,0.4235548807917229,0.16919453162899778,0.1865083303326611,128907.38195516089,935.6797625171146,129843.061717678,672,0,249.10256410256412,35,4,21,37.52042018083733,0.6113095238095239,46.12268518518517,1015.5092592592569,29.014550264550195,0
700,4,0,0,39,0.0,0.0,1.0,39,750,700,50,0.9333333333333333,8,7,1,354.3996567724689,0.4238079172289699,0.08387547970403819,0.18833686997542998,127500.81045310335,1237.5835905349554,128738.3940436383,673,1,250.10256410256412,35,4,16,38.56339292535717,0.5970238095238095,47.51157407407406,1009.953703703702,28.855820105820058,8
701,4,2,0,41,0.04878048780487805,0.0,1.0,41,1050,700,350,0.6666666666666666,14,7,7,334.5371986254275,0.4280741869918699,0.08532225718747255,0.18027512437310664,128061.27997316465,368.2523709218012,128429.53234408646,674,0,238.85365853658536,37,4,18,38.492015130177286,0.5988175675675675,46.95723684210525,1012.1710526315776,27.355974395448044,0
702,4,2,0,43,0.046511627906976744,0.0,1.0,43,1150,1000,150,0.8695652173913043,13,10,3,323.6591208527039,0.43283960871170174,0.10869527953747937,0.17716372742006486,128685.967348327,-269.8955367993564,128416.07181152764,675,0,228.69767441860466,38,5,16,38.13090098627635,0.6033442982456141,46.34081196581196,1014.6367521367512,26.700967161493452,0
703,4,1,2,42,0.022727272727272728,0.045454545454545456,0.9545454545454546,44,1100,500,600,0.45454545454545453,17,5,12,322.7169181597001,0.4332496476391825,0.13080704533805543,0.1783628066089447,129069.04432508671,-469.44715711806145,128599.59716796865,676,0,224.47727272727272,39,5,17,37.76535537331285,0.6055021367521367,45.963541666666664,1016.1458333333326,26.05502136752135,0
704,4,1,1,42,0.023255813953488372,0.023255813953488372,0.9767441860465116,43,850,400,450,0.47058823529411764,13,4,9,332.67720845067635,0.43147840531561465,0.14612280830459956,0.18372591477154043,129038.51290269537,-14.365548980961478,129024.1473537144,677,0,230.58139534883722,38,5,18,37.54337539432174,0.606907894736842,45.99358974358973,1016.0256410256392,26.737516869095767,0
705,4,2,0,44,0.045454545454545456,0.0,1.0,44,850,700,150,0.8235294117647058,10,7,3,330.29498533904575,0.4335799859055673,0.18047342921451182,0.1851983411912814,129636.22708013741,-236.25812696324772,129399.96895317416,678,0,224.95454545454547,38,6,17,36.9968701916352,0.6129385964912281,45.40598290598291,1018.3760683760689,26.799370220422865,0
706,4,1,1,44,0.022222222222222223,0.022222222222222223,0.9777777777777777,45,1400,900,500,0.6428571428571429,19,9,10,322.7073542258944,0.4348274410774411,0.181446669391091,0.1823706456791603,129943.77170138899,-613.2378472222133,129330.53385416677,679,0,220.93333333333334,39,6,18,36.87849066884621,0.6143162393162394,45.10416666666667,1019.5833333333342,26.143162393162413,0
707,4,0,0,44,0.0,0.0,1.0,44,1200,800,400,0.6666666666666666,16,8,8,328.23764375709976,0.43269908386187456,0.18423334159029015,0.1853280234751625,129908.3719135803,-271.8364197530787,129636.53549382722,680,1,226.6818181818182,38,6,18,36.77338782924614,0.6156798245614035,45.13888888888889,1019.4444444444448,26.82748538011697,0
708,4,2,0,46,0.043478260869565216,0.0,1.0,46,1450,1000,450,0.6896551724137931,19,10,9,319.5713323877169,0.43598027375201287,0.19912759770196442,0.18308152033053332,130475.3472222224,-860.2816358024497,129615.06558641995,681,0,217.7826086956522,39,7,21,36.42094888526373,0.6196581196581197,44.58333333333334,1021.666666666668,26.19658119658123,0
709,4,0,0,46,0.0,0.0,1.0,46,1300,900,400,0.6923076923076923,17,9,8,354.759313665454,0.43583937198067635,0.2625678969274976,0.1891417303339343,127631.95363860458,-62.157089521980254,127569.7965490826,682,1,218.7826086956522,36,10,14,38.41988929752221,0.5963541666666667,47.381756756756744,1010.472972972971,28.06869369369364,7
710,4,4,0,50,0.08,0.0,1.0,50,1050,700,350,0.6666666666666666,14,7,7,334.36576471639705,0.4434863945578231,0.30102671996633745,0.18415301039363047,128929.9859832709,-1375.9909090817305,127553.99507418918,683,0,202.2,38,12,17,37.610894873413294,0.6058114035087719,46.10042735042733,1015.5982905982879,26.726270805218103,0
711,4,0,1,49,0.0,0.02,0.98,50,1400,1000,400,0.7142857142857143,18,10,8,335.47120102133357,0.4432227891156462,0.30299147996213405,0.18488838887593112,128957.11343277419,-1347.7204552925994,127609.39297748159,684,1,203.2,38,12,17,37.555222467655426,0.6060855263157895,46.073717948717935,1015.7051282051258,26.72908232118752,0
712,4,0,2,47,0.0,0.04081632653061224,0.9591836734693877,49,1900,1500,400,0.7894736842105263,23,15,8,340.0677246593893,0.44228316326530615,0.3029791733207048,0.1876550011297937,129006.37846500825,-1025.8188817713371,127980.55958323691,685,2,208.28571428571428,37,12,17,37.38835671883434,0.6083896396396397,46.0252192982456,1015.8991228070158,27.456733048838267,0
713,4,1,0,48,0.020833333333333332,0.0,1.0,48,1250,800,450,0.64,17,8,9,342.73575420426465,0.44207114361702127,0.2999810669030991,0.18937567116871287,129058.3166570287,-753.4201008440857,128304.89655618461,686,0,210.875,36,12,18,37.26772322583027,0.6108217592592593,45.9740990990991,1016.103603603604,28.22510010010011,0
714,4,1,0,49,0.02040816326530612,0.0,1.0,49,1600,1000,600,0.625,22,10,12,338.57904025988023,0.4432575113378685,0.311684316237532,0.18976364193684409,129619.76431450054,-1022.6929199369126,128597.07139456362,687,0,207.55102040816325,37,12,17,36.80267668066474,0.6145833333333333,45.422149122807014,1018.3114035087714,27.52192982456139,0
715,4,1,0,50,0.02,0.0,1.0,50,1250,900,350,0.72,16,9,7,330.1262639214921,0.4448894557823129,0.3117435037720033,0.18665432836888163,129962.83512309156,-1419.1709584337782,128543.66416465778,688,0,204.38,38,12,18,36.67007194747134,0.6162280701754386,45.085470085470085,1019.6581196581199,26.833108412055786,0
716,4,0,4,46,0.0,0.08,0.92,50,1400,1000,400,0.7142857142857143,18,10,8,334.9299108395189,0.4444132653061224,0.2045083979962672,0.1780637818411043,127517.5099698446,-1458.1143510644833,126059.39561878011,689,1,205.38,41,9,14,39.037893297973355,0.5866361788617886,47.49503968253969,1010.0198412698428,24.634630274874215,8
717,4,0,0,46,0.0,0.0,1.0,46,1100,700,400,0.6363636363636364,15,7,8,353.3513920486339,0.4398852657004831,0.21634485919052815,0.1867830477325435,127285.57254395602,-204.69315077713787,127080.87939317888,690,3,222.6304347826087,37,9,20,38.81060070991344,0.5909346846846847,47.7247807017544,1009.1008771929841,27.27299668089146,0
718,4,0,0,46,0.0,0.0,1.0,46,1300,900,400,0.6923076923076923,17,9,8,351.8867616275521,0.4399859098228664,0.21524667913761464,0.18613596287471235,127313.23580332432,-240.0315481686406,127073.20425515568,691,4,223.6304347826087,37,9,20,38.81917282341011,0.5912162162162162,47.697368421052644,1009.2105263157913,27.27596017069706,0
719,4,1,0,47,0.02127659574468085,0.0,1.0,47,1300,900,400,0.6923076923076923,17,9,8,345.3270343219354,0.4421446191797718,0.21338697483529523,0.18386331286870639,127577.2518080212,-588.8251972386419,126988.42661078257,692,0,219.85106382978722,38,9,18,38.71417618443316,0.5921052631578947,47.435897435897445,1010.2564102564116,26.585695006747674,0
720,4,1,0,48,0.020833333333333332,0.0,1.0,48,1550,1200,350,0.7741935483870968,19,12,7,337.8468895515068,0.443003841607565,0.21415602142783507,0.1808869143340587,127801.98703342049,-964.4992404513514,126837.48779296914,693,0,216.25,39,9,19,38.673229799800836,0.5926816239316239,47.213541666666686,1011.1458333333362,25.926816239316313,0
721,4,1,0,49,0.02040816326530612,0.0,1.0,49,1200,900,300,0.75,15,9,6,330.7101956619649,0.4454187925170068,0.21663373306986466,0.17835976937286957,128094.31295666422,-1327.5809397833145,126766.73201688091,694,0,212.81632653061226,41,8,20,38.55514177446752,0.592479674796748,46.92460317460318,1012.3015873015879,24.6902826171119,0
722,4,1,2,48,0.02,0.04,0.96,50,1300,800,500,0.6153846153846154,18,8,10,322.77383847715504,0.4466751700680272,0.21848933932498338,0.17537099099389955,128389.92478103789,-1711.818231326231,126678.10654971165,695,0,209.54,42,8,13,38.45472001784747,0.5939980158730158,46.6327519379845,1013.4689922480627,24.13021410114435,0
723,4,1,0,49,0.02040816326530612,0.0,1.0,49,1250,800,450,0.64,17,8,9,342.34296024248624,0.4449936224489796,0.25613712177622694,0.18685382181307725,128571.7841100561,-996.8709648211072,127574.913145235,696,0,214.55102040816325,41,8,15,37.77338273174867,0.5973069105691057,46.45337301587302,1014.1865079365083,24.73625629113435,0
724,4,1,1,49,0.02,0.02,0.98,50,1600,1200,400,0.75,20,12,8,346.41420854452144,0.4463010204081633,0.27485310950019004,0.19114771380951429,129004.43558079476,-1062.2061099092318,127942.22947088552,697,0,211.24,42,8,17,37.22915076942644,0.6001984126984127,46.02713178294575,1015.8914728682198,24.18789221114809,0
725,4,2,4,47,0.0392156862745098,0.0784313725490196,0.9215686274509804,51,1250,700,550,0.56,18,7,11,343.1562707464459,0.447875816993464,0.2868780045663677,0.19102738329175115,129352.72285997731,-1322.0599397817518,128030.66292019555,698,0,208.0,41,10,19,36.95752876926079,0.6051829268292683,45.68452380952381,1017.2619047619046,24.81126596980255,0
726,4,0,0,47,0.0,0.0,1.0,47,1200,900,300,0.75,15,9,6,354.2405006793794,0.4460376194881283,0.27508622139536487,0.19631705843491606,129176.17517203632,-248.11340624213216,128928.06176579419,699,1,208.53191489361703,41,6,20,36.85540076770438,0.6034044715447154,45.85813492063492,1016.5674603174597,24.794328300425846,0
727,4,0,1,46,0.0,0.02127659574468085,0.9787234042553191,47,1150,1000,150,0.8695652173913043,13,10,3,338.4257760917833,0.4459412580943571,0.12207209078130798,0.18432557799112054,128487.53390842004,-694.2024874909556,127793.33142092908,700,2,209.53191489361703,39,8,18,37.958598753381956,0.5996260683760684,46.53645833333333,1013.8541666666658,25.996260683760664,8
728,4,0,1,45,0.0,0.021739130434782608,0.9782608695652174,46,1750,1400,350,0.8,21,14,7,345.54579736404077,0.4428240740740741,0.14081324266776618,0.18888643327412566,128631.77237426015,-310.3663297173102,128321.40604454285,701,3,215.04347826086956,38,8,19,37.630989994734065,0.602796052631579,46.39423076923076,1014.4230769230753,26.695344129554613,0
729,4,2,0,47,0.0425531914893617,0.0,1.0,47,1200,800,400,0.6666666666666666,16,8,8,335.60214424806844,0.441354455750848,0.17869031676797809,0.18623472925999213,129228.54487407766,-724.8662247059813,128503.67864937168,702,0,211.04255319148936,38,9,21,37.275839725403635,0.6088267543859649,45.806623931623925,1016.7735042735038,26.75719748088168,0
730,4,0,0,47,0.0,0.0,1.0,47,1500,1200,300,0.8,18,12,6,335.7886011552274,0.4412966389145853,0.17706381235454605,0.18671070055123218,129307.31336805539,-716.0156250000188,128591.29774305537,703,1,212.04255319148936,39,8,21,37.191041922709275,0.607905982905983,45.72916666666666,1017.083333333332,26.079059829059794,0
731,4,0,1,46,0.0,0.02127659574468085,0.9787234042553191,47,1200,700,500,0.5833333333333334,17,7,10,343.6959471693169,0.4409497378970089,0.07181277277686893,0.18812830792425794,128685.30636525893,-550.7607234037087,128134.54564185522,704,2,213.04255319148936,40,7,16,37.623322315705146,0.6,46.341463414634156,1014.6341463414647,25.365853658536615,8
732,4,0,1,45,0.0,0.021739130434782608,0.9782608695652174,46,1300,900,400,0.6923076923076923,17,9,8,351.4371608431115,0.4390499194847021,0.07726988661726608,0.19230325542763546,128672.41753472247,-155.94618055553093,128516.47135416693,705,3,218.6304347826087,39,7,16,37.44010951403149,0.6014957264957265,46.35416666666668,1014.5833333333353,26.014957264957314,0
733,4,1,1,45,0.021739130434782608,0.021739130434782608,0.9782608695652174,46,1700,1400,300,0.8235294117647058,20,14,6,352.6454517009635,0.4396839774557166,0.10833909032157396,0.19490404426871968,129069.0443250869,-96.8777126736021,128972.1666124133,706,0,219.0,39,7,17,37.00506150691953,0.6055021367521367,45.96354166666667,1016.1458333333342,26.055021367521388,0
734,4,0,0,45,0.0,0.0,1.0,45,1500,1200,300,0.8,18,12,6,354.3750336127694,0.4378156565656566,0.11968794525027437,0.19624703549428893,129147.08547921675,153.3005515377161,129300.38603075447,707,1,224.44444444444446,38,7,17,36.881613061453294,0.6080043859649122,45.88675213675213,1016.4529914529903,26.74876293297343,0
735,4,1,2,44,0.021739130434782608,0.043478260869565216,0.9565217391304348,46,1600,1200,400,0.75,20,12,8,352.61365253073757,0.43766103059581324,0.1238425344900762,0.1970293412117496,129500.26167223658,-67.2765313390602,129432.98514089752,708,0,220.54347826086956,38,8,15,36.56690633637729,0.6115679824561404,45.5395299145299,1017.8418803418783,26.785312640575746,0
736,4,0,0,44,0.0,0.0,1.0,44,950,700,250,0.7368421052631579,12,7,5,368.3984712946892,0.43759910147991543,0.12060884624291446,0.20444190518252892,129230.01284646119,721.6278356058614,129951.64068206705,709,3,230.8409090909091,36,8,18,36.44068187691512,0.6125578703703703,45.80518018018017,1016.7792792792782,28.243868868868837,0
737,4,0,0,44,0.0,0.0,1.0,44,1900,1300,600,0.6842105263157895,25,13,12,376.37271834557964,0.43732381959126143,0.1549829452765834,0.19787004832404814,127064.37467538078,807.1835004304498,127871.55817581122,710,4,231.8409090909091,37,7,17,38.45738172920067,0.5886824324324325,47.94407894736842,1008.2236842105254,27.249288762446632,8
738,4,0,0,44,0.0,0.0,1.0,44,1350,700,650,0.5185185185185185,20,7,13,380.4408366974914,0.43773123678646936,0.15973540247850848,0.20056554292521672,127177.19144397782,876.6824300893309,128053.87387406715,711,5,232.8409090909091,36,8,17,38.23871459938225,0.591724537037037,47.83220720720721,1008.6711711711716,28.018643643643657,0
739,4,3,0,47,0.06382978723404255,0.0,1.0,47,1250,900,350,0.72,16,9,7,361.7461304006793,0.4451703669441875,0.17862525850888566,0.19431849659576345,127933.68055555574,-144.09722222220284,127789.58333333353,712,0,218.91489361702128,39,8,18,37.93417078528281,0.594017094017094,47.08333333333334,1011.6666666666681,25.940170940170976,0
740,4,1,0,48,0.020833333333333332,0.0,1.0,48,1550,1200,350,0.7741935483870968,19,12,7,354.04040404040427,0.4462082594562648,0.19065656565656575,0.19197965571205003,128311.1149584486,-514.0153701138979,127797.0995883347,713,0,215.33333333333334,37,11,19,37.743055555555564,0.6013513513513513,46.710526315789465,1013.157894736841,27.382645803698402,0
741,4,0,0,48,0.0,0.0,1.0,48,1700,1300,400,0.7647058823529411,21,13,8,350.1970350910117,0.44523862293144206,0.1872146118721465,0.1907789818033121,128496.33487654295,-600.192901234594,127896.14197530836,714,1,216.33333333333334,38,10,18,37.651255707762566,0.6014254385964912,46.527777777777764,1013.8888888888869,26.68128654970755,0
742,4,0,2,46,0.0,0.041666666666666664,0.9583333333333334,48,1100,600,500,0.5454545454545454,16,6,10,354.58806468463064,0.4451462765957446,0.19535227711647174,0.1935655260523974,128577.58881446748,-481.5843240923778,128096.00449037511,715,2,217.33333333333334,38,10,18,37.45698584922222,0.6022478070175439,46.44764957264955,1014.2094017093989,26.68972109761576,0
743,4,1,1,46,0.02127659574468085,0.02127659574468085,0.9787234042553191,47,1500,1000,500,0.6666666666666666,20,10,10,350.2716423916915,0.44623034227567066,0.1988375543260088,0.19320413216084695,128989.67013888885,-363.7152777777818,128625.95486111107,716,0,218.14893617021278,39,8,19,37.14622641509432,0.6047008547008548,46.041666666666664,1015.8333333333329,26.047008547008538,0
744,4,0,0,46,0.0,0.0,1.0,46,900,600,300,0.6666666666666666,12,6,6,357.72218714927084,0.44295491143317234,0.1965716952129999,0.19674720293209874,128875.73964497026,20.342291255738303,128896.08193622601,717,1,223.80434782608697,38,8,19,37.073206018518526,0.6052631578947368,46.153846153846146,1015.3846153846141,26.720647773279318,0
745,4,0,0,46,0.0,0.0,1.0,46,850,600,250,0.7058823529411765,11,6,5,359.36749600027343,0.44250201288244767,0.20022088987062148,0.19805836431736792,128957.11343277436,68.59898915185991,129025.71242192622,718,2,224.80434782608697,38,8,19,36.94843273377511,0.6060855263157895,46.07371794871794,1015.7051282051273,26.72908232118756,0
746,4,1,1,46,0.02127659574468085,0.02127659574468085,0.9787234042553191,47,1150,700,450,0.6086956521739131,16,7,9,358.97745205566423,0.44391766882516187,0.21548114276279295,0.19991553422403677,129368.6579043552,-111.45148382023478,129257.20642053497,719,0,221.0,37,10,20,36.53894517496589,0.6120495495495495,45.66885964912281,1017.3245614035088,27.49525841631105,0
747,4,1,0,47,0.02127659574468085,0.0,1.0,47,1000,400,600,0.4,16,4,12,351.95291049534865,0.444650015417823,0.21696995392116358,0.19775315271497654,129717.84056770043,-269.0856938052344,129448.7548738952,720,0,219.7872340425532,38,9,19,36.36252403425973,0.6137609649122807,45.325854700854705,1018.696581196582,26.807804768331106,0
748,4,0,3,44,0.0,0.06382978723404255,0.9361702127659575,47,1300,800,500,0.6153846153846154,18,8,10,348.0247245364151,0.44424529756398395,0.0927799093128705,0.19299552906110268,129201.38888888869,-369.6054998539221,128831.78338903477,721,1,220.7872340425532,39,8,19,36.98770491803277,0.6068376068376069,45.83333333333332,1016.666666666665,26.068376068376026,8
749,4,0,1,43,0.0,0.022727272727272728,0.9772727272727273,44,1550,1200,350,0.7741935483870968,19,12,7,360.98570977712745,0.44069326990838614,0.10834583878953596,0.19949651863394835,129065.65176647279,518.1711821535228,129583.82294862632,722,2,233.04545454545453,38,6,19,36.79664774121192,0.6071820175438596,45.96688034188033,1016.1324786324762,26.740328385065165,0
750,4,0,0,43,0.0,0.0,1.0,43,1250,800,450,0.64,17,8,9,366.3662617283226,0.44031469176818017,0.10666718829849398,0.20247004737350804,129065.65176647296,857.0600710424269,129922.7118375154,723,4,239.41860465116278,38,5,20,36.659963901447426,0.6071820175438596,45.966880341880334,1016.1324786324777,26.740328385065204,0
751,4,0,0,43,0.0,0.0,1.0,43,1300,900,400,0.6923076923076923,17,9,8,367.96491527977395,0.4400609080841639,0.10679035445035323,0.20364343042454613,129121.97401258656,902.4712456596982,130024.44525824627,724,5,240.41860465116278,39,4,20,36.56189146253971,0.6060363247863247,45.91145833333332,1016.3541666666647,26.060363247863197,0
752,4,1,0,44,0.022727272727272728,0.0,1.0,44,1300,800,500,0.6153846153846154,18,8,10,358.6927187998473,0.442752378435518,0.06298248646157378,0.19252282662114295,127901.25739645005,385.5058317667639,128286.7632282168,725,0,235.9318181818182,38,6,17,38.044597591888476,0.5953947368421053,47.115384615384635,1011.5384615384644,26.61943319838064,8
753,4,0,0,44,0.0,0.0,1.0,44,1600,1300,300,0.8125,19,13,6,355.11448140784046,0.441860465116279,0.07297241663235843,0.19125788810191718,128039.08420138927,293.7065972222616,128332.79079861153,726,1,236.9318181818182,39,5,17,37.99403046521201,0.5950854700854701,46.979166666666686,1012.0833333333364,25.95085470085478,0
754,4,0,0,44,0.0,0.0,1.0,44,900,400,500,0.4444444444444444,14,4,10,354.9695993808689,0.4418714763918252,0.07665718722520531,0.19143144099796294,128091.80230034754,293.73914930559073,128385.54144965313,727,2,237.9318181818182,39,5,17,37.94376414900187,0.5956196581196581,46.92708333333335,1012.2916666666692,25.956196581196647,0
755,4,0,0,44,0.0,0.0,1.0,44,750,300,450,0.4,12,3,9,355.4924037237677,0.4416072057787174,0.16026588587564183,0.17708173007922268,124843.79882812501,76.20442708333371,124920.00325520834,728,3,238.9318181818182,39,5,16,41.274494475713986,0.5625,50.15625,999.3750000000001,25.625000000000004,8
756,4,5,1,48,0.10204081632653061,0.02040816326530612,0.9795918367346939,49,750,500,250,0.6666666666666666,10,5,5,325.63663469052676,0.45266439909297057,0.19712361671617895,0.16667259010791308,125969.13309594675,-1595.6741160005654,124373.45897994618,729,0,215.44897959183675,41,8,19,40.860324636821794,0.5708841463414633,49.032738095238095,1003.8690476190479,24.484610917537754,0
757,4,7,7,48,0.12727272727272726,0.12727272727272726,0.8727272727272728,55,1450,1100,350,0.7586206896551724,18,11,7,291.76578394586403,0.4600589225589226,0.22488141709916265,0.154731651027465,127417.32927256526,-3554.7431067334646,123862.58616583179,730,0,192.63636363636363,41,14,11,40.22990976384656,0.5856199186991871,47.59424603174602,1009.6230158730139,24.624951606658875,0
758,4,1,2,47,0.02040816326530612,0.04081632653061224,0.9591836734693877,49,1300,800,500,0.6153846153846154,18,8,10,326.2724789165327,0.45328443877551017,0.21039437308815523,0.17040280657873422,126795.93474915993,-1525.995210570531,125269.9395385894,731,0,202.3673469387755,38,11,18,39.995270676425854,0.5841557017543859,48.210470085470085,1007.1581196581199,26.504161043634735,0
759,4,1,0,48,0.020833333333333332,0.0,1.0,48,1450,1200,250,0.8275862068965517,17,12,5,325.1570097747189,0.4489232417257683,0.22041309290069222,0.17072948364568405,127013.25005425356,-1340.150282118047,125673.09977213551,732,0,206.39583333333334,39,9,20,39.8006656677345,0.5846688034188035,47.99479166666667,1008.020833333334,25.846688034188052,0
760,4,1,0,49,0.02040816326530612,0.0,1.0,49,1000,900,100,0.9,11,9,2,319.96735155566734,0.44995393990929705,0.2230941074291244,0.16922797328078595,127307.56104353876,-1653.09854385248,125654.46249968628,733,0,203.16326530612244,38,11,22,39.63031088997107,0.5893640350877193,47.70299145299146,1009.1880341880354,26.557579847053564,0
761,4,1,1,49,0.02,0.02,0.98,50,1150,800,350,0.6956521739130435,15,8,7,314.25249948196023,0.451156462585034,0.23172008657116328,0.1678146396518142,127696.68104383699,-1974.1997612847022,125722.48128255228,734,0,200.08,39,11,16,39.377104160225365,0.5916132478632479,47.31770833333334,1010.7291666666681,25.916132478632516,0
762,4,1,2,48,0.02,0.04,0.96,50,1800,1300,500,0.7222222222222222,23,13,10,314.53025756313434,0.45166666666666666,0.2315050442660067,0.16917757043013826,127986.3769531255,-1948.8823784721767,126037.49457465332,735,0,201.02,39,11,17,39.07461739070754,0.594551282051282,47.03125000000002,1011.875000000004,25.945512820512924,0
763,4,1,2,47,0.02040816326530612,0.04081632653061224,0.9591836734693877,49,1500,1100,400,0.7333333333333333,19,11,8,322.17712131853426,0.44876700680272114,0.2377686309557976,0.1731962969679986,127964.5259105033,-1554.5514822525947,126409.97442825072,736,0,205.89795918367346,40,9,18,38.90346692111958,0.5927083333333334,47.0528455284553,1011.7886178861812,25.29471544715453,0
764,4,0,0,47,0.0,0.0,1.0,47,1450,1100,350,0.7586206896551724,18,11,7,327.55033209020235,0.4459219858156029,0.2316357371568789,0.17585954722901184,127913.11905116029,-1020.403075219752,126892.71597594053,737,1,210.4255319148936,40,7,18,38.820030473511494,0.5921875,47.10365853658538,1011.5853658536607,25.28963414634152,0
765,4,1,1,47,0.020833333333333332,0.020833333333333332,0.9791666666666666,48,1350,1000,350,0.7407407407407407,17,10,7,325.8703405838963,0.4474549349881796,0.24888404934530906,0.17682723531038078,128338.88942992064,-1234.7959226409027,127104.09350727974,738,0,207.02083333333334,37,11,19,38.4282680445839,0.6016328828828829,46.68311403508771,1013.2675438596483,27.385609293504007,0
766,4,0,0,47,0.0,0.0,1.0,47,1400,1200,200,0.8571428571428571,16,12,4,331.00014402971976,0.44684705519580636,0.24426127593387958,0.18002007833302178,128429.74044568226,-897.9474829559199,127531.79296272634,739,1,210.5744680851064,36,11,16,38.2057086249676,0.6044560185185186,46.59346846846847,1013.6261261261268,28.1562812812813,0
767,4,1,0,48,0.020833333333333332,0.0,1.0,48,1200,800,400,0.6666666666666666,16,8,8,323.1122486659469,0.4472794769503546,0.2459569915105595,0.1774689356545567,128821.50472094398,-1275.2387866169684,127546.265934327,740,0,207.16666666666666,38,10,18,38.00691082579109,0.6047149122807017,46.20726495726497,1015.1709401709414,26.715024741340564,0
768,4,0,1,47,0.0,0.020833333333333332,0.9791666666666666,48,1150,700,450,0.6086956521739131,16,7,9,321.8844164776246,0.44703014184397166,0.24373952669197374,0.1769547325102883,128857.4340820315,-1304.5600043402478,127552.87407769125,741,1,208.16666666666666,39,9,18,38.00154320987656,0.6033653846153846,46.171875000000014,1015.3125000000019,26.033653846153896,0
769,4,0,1,46,0.0,0.02127659574468085,0.9787234042553191,47,1350,900,450,0.6666666666666666,18,9,9,323.58789610679605,0.44607616404563677,0.23944528799323606,0.1779288205835445,128865.81776926781,-1060.116229592159,127805.70153967566,742,2,213.48936170212767,40,7,18,37.949779801821634,0.6018229166666667,46.16361788617887,1015.3455284552861,25.383638211382152,0
770,4,0,0,46,0.0,0.0,1.0,46,1900,1500,400,0.7894736842105263,23,15,8,319.94076350777254,0.44551127214170694,0.23868251911251792,0.1767275001961719,129046.45568940455,-942.5556877519869,128103.90000165257,743,3,217.7608695652174,40,6,19,37.858821764352875,0.6036458333333333,45.98577235772358,1016.0569105691065,25.401422764227664,0
771,4,0,1,45,0.0,0.021739130434782608,0.9782608695652174,46,1450,1100,350,0.7586206896551724,18,11,7,318.2045054696319,0.44512882447665053,0.2328621232275283,0.17622820950760015,129149.73416121355,-980.7945419393232,128168.93961927423,744,4,218.7608695652174,40,6,19,37.7980653869226,0.6046875,45.88414634146341,1016.4634146341461,25.411585365853654,0
772,4,0,0,45,0.0,0.0,1.0,45,1950,1600,350,0.8205128205128205,23,16,7,315.649240133517,0.4438762626262626,0.2171787518776458,0.1755124818145594,129307.31336805565,-836.8386304861428,128470.4747375695,745,5,208.33333333333334,39,6,19,37.70312713368837,0.607905982905983,45.72916666666667,1017.0833333333342,26.07905982905985,0
773,4,0,1,44,0.0,0.022222222222222223,0.9777777777777777,45,1400,1000,400,0.7142857142857143,18,10,8,316.0528947523916,0.4435816498316498,0.2155207515838078,0.17632899650691697,129439.78000217032,-818.036566840259,128621.74343533006,746,6,209.33333333333334,39,6,16,37.558539768655955,0.6092414529914529,45.59895833333334,1017.6041666666681,26.092414529914567,0
774,4,1,0,45,0.022222222222222223,0.0,1.0,45,850,500,350,0.5882352941176471,12,5,7,322.4615115137691,0.44273989898989896,0.22324944358842647,0.17586346300204728,128540.34423828128,-663.0398220486098,127877.30441623267,747,0,209.95555555555555,39,6,18,38.309471837014215,0.6001602564102564,46.484375,1014.0625000000002,26.00160256410257,7
775,4,2,0,47,0.0425531914893617,0.0,1.0,47,1300,900,400,0.6923076923076923,17,9,8,312.24090427550107,0.4470783225408572,0.2308511676484457,0.1730412410011388,129176.17517203632,-1333.1828506865768,127842.99232134975,748,0,201.9787234042553,41,6,20,37.92278634397061,0.6034044715447154,45.85813492063492,1016.5674603174597,24.794328300425846,0
776,4,0,1,46,0.0,0.02127659574468085,0.9787234042553191,47,1700,1500,200,0.8823529411764706,19,15,4,312.1609450796345,0.4455943570767808,0.2292468628797799,0.17366175637012976,129327.49438027518,-1325.8014258944427,128001.69295438073,749,1,202.9787234042553,41,6,20,37.77136366591891,0.6049288617886179,45.70932539682539,1017.1626984126978,24.808846302748726,0
777,4,0,0,46,0.0,0.0,1.0,46,1200,1000,200,0.8333333333333334,14,10,4,318.82296577706427,0.44486714975845415,0.23799701228091497,0.17773137713585563,129408.11107806193,-948.3444460969085,128459.76663196503,750,2,207.95652173913044,40,6,21,37.520184112398454,0.6072916666666667,45.630081300813,1017.4796747967474,25.436991869918685,0
778,4,0,0,46,0.0,0.0,1.0,46,950,600,350,0.631578947368421,13,6,7,317.5717765848804,0.4450281803542673,0.23491025607627591,0.17726665388634286,129459.8174449732,-977.4431555291167,128482.37428944408,751,3,208.95652173913044,40,6,16,37.499583915851154,0.6078125,45.579268292682926,1017.682926829268,25.4420731707317,0
779,4,0,1,45,0.0,0.021739130434782608,0.9782608695652174,46,1200,1000,200,0.8333333333333334,14,10,4,317.6518242408226,0.4443739935587762,0.23229925264957818,0.17777854610304797,129563.26116233708,-968.7987474387096,128594.46241489837,752,4,209.95652173913044,40,6,16,37.39269315232582,0.6088541666666667,45.477642276422756,1018.0894308943077,25.452235772357692,0
780,4,0,1,44,0.0,0.022222222222222223,0.9777777777777777,45,1350,1000,350,0.7407407407407407,17,10,7,318.98115668348663,0.44309764309764305,0.22908570259766758,0.1790469431717069,129678.39084201398,-727.0073784722176,128951.38346354176,753,5,213.9777777777778,39,6,17,37.242193359241824,0.6116452991452992,45.364583333333336,1018.5416666666674,26.11645299145301,0
781,4,0,1,43,0.0,0.022727272727272728,0.9772727272727273,44,1550,1200,350,0.7741935483870968,19,12,7,323.9411192114484,0.4414640591966173,0.22519533672330372,0.18125865678014644,129554.63927469142,-406.3850308641918,129148.25424382724,754,6,219.72727272727272,38,6,17,37.24135970895862,0.6121162280701755,45.486111111111114,1018.0555555555561,26.790935672514635,0
782,4,0,0,43,0.0,0.0,1.0,43,1300,800,500,0.6153846153846154,18,8,10,334.7098976868822,0.44068383167220376,0.23220759970354332,0.18772859478959913,129647.68005540161,78.87234533701996,129726.55240073863,755,7,225.27906976744185,37,6,18,36.87284668389319,0.6148648648648649,45.39473684210526,1018.4210526315785,27.524893314366988,0
783,4,1,0,44,0.022727272727272728,0.0,1.0,44,1600,1400,200,0.875,18,14,4,326.1800906066228,0.44064922480620156,0.2274655128095282,0.18506795515167193,130099.04308431942,-312.85646778436086,129786.18661653505,756,0,221.13636363636363,38,6,19,36.632762592941695,0.6175986842105263,44.95192307692307,1020.1923076923068,26.847165991902813,0
784,4,1,1,44,0.022222222222222223,0.022222222222222223,0.9777777777777777,45,950,800,150,0.8421052631578947,11,8,3,326.8449884921931,0.44097222222222227,0.24272467405703124,0.18714322035702707,130453.51765103373,-472.28157644823284,129981.2360745855,757,0,217.2,38,7,20,36.257233493690315,0.6211622807017544,44.60470085470086,1021.5811965811971,26.88371569950519,0
785,4,0,1,43,0.0,0.022727272727272728,0.9772727272727273,44,1200,900,300,0.75,15,9,6,332.64150593093314,0.43951506342494717,0.2465072489219302,0.19062444970875977,130486.54994806091,-118.95150430902072,130367.5984437519,758,1,221.27272727272728,37,7,20,36.07578521857337,0.6233108108108107,44.57236842105263,1021.7105263157893,27.613798008534843,0
786,4,1,0,44,0.022727272727272728,0.0,1.0,44,1450,1100,350,0.7586206896551724,18,11,7,330.1524656101645,0.4416182170542636,0.2430943399904475,0.19043488229721744,130738.73842191833,-167.2566318482583,130571.48179007007,759,0,218.70454545454547,37,7,17,35.8845064508059,0.6258445945945945,44.32565789473684,1022.697368421053,27.64046941678522,0
787,4,0,1,43,0.0,0.022727272727272728,0.9772727272727273,44,1050,900,150,0.8571428571428571,12,9,3,330.8223308967715,0.44125484496124034,0.24590762934814325,0.19123744406858,130822.8553497231,-144.1756117266776,130678.67973799643,760,1,219.70454545454547,37,7,18,35.782422293676305,0.6266891891891893,44.24342105263158,1023.0263157894746,27.649359886202014,0
788,4,0,0,43,0.0,0.0,1.0,43,1150,700,450,0.6086956521739131,16,7,9,339.1983435352958,0.4416989664082687,0.24087750060795354,0.19615639408135974,130838.01442912503,276.00755316126686,131114.0219822863,761,2,222.97674418604652,36,7,18,35.55288020546689,0.6287615740740741,44.2286036036036,1023.0855855855852,28.419044044044036,0
789,4,0,0,43,0.0,0.0,1.0,43,1200,600,600,0.5,18,6,12,339.22772641154904,0.44199889258028796,0.24118921601481658,0.19705554382155852,131010.89000740604,288.50527047317274,131299.3952778792,762,3,223.97674418604652,36,7,18,35.37747955853774,0.6304976851851851,44.05968468468468,1023.7612612612611,28.43781281281281,0
790,4,1,0,44,0.022727272727272728,0.0,1.0,44,1700,1000,700,0.5882352941176471,24,10,14,347.90605586227036,0.44407373150105706,0.2679799721726852,0.19374984311465485,129368.6579043554,202.0115231556507,129570.66942751105,763,0,219.86363636363637,37,7,16,36.82052525688008,0.6120495495495495,45.668859649122815,1017.3245614035104,27.495258416311092,8
791,4,0,0,44,0.0,0.0,1.0,44,1500,1100,400,0.7333333333333333,19,11,8,350.1040745802905,0.44378743833685697,0.2679820179820185,0.1955274380417724,129480.23069598345,266.3112688519661,129746.54196483541,764,1,220.86363636363637,37,7,13,36.651134812899535,0.6131756756756757,45.559210526315795,1017.7631578947373,27.507112375533442,0
792,4,0,2,42,0.0,0.045454545454545456,0.9545454545454546,44,1550,1000,550,0.6451612903225806,21,10,11,348.5726185740943,0.44384249471458775,0.2652428581215318,0.19564296398397346,129675.5988020352,240.27260791781748,129915.87140995302,765,2,221.86363636363637,37,7,15,36.491526716187614,0.6151463963963963,45.36732456140351,1018.5307017543856,27.527856804172586,0
793,4,0,0,42,0.0,0.0,1.0,42,1600,1300,300,0.8125,19,13,6,351.9502771350956,0.44282326751838946,0.2540877796901895,0.19852729224804894,129871.11418898107,741.6349261310982,130612.74911511216,766,3,229.73809523809524,37,5,16,36.20688109581181,0.6171171171171171,45.17543859649122,1019.2982456140339,27.548601232811727,0
794,4,0,0,42,0.0,0.0,1.0,42,1450,1100,350,0.7586206896551724,18,11,7,370.48270251832724,0.44244821912504845,0.27736274069137257,0.19772663978641716,127673.13169677218,1060.1373739997016,128733.26907077189,767,4,230.73809523809524,37,5,16,37.98043018335685,0.5948761261261262,47.34100877192983,1010.6359649122815,27.31448553816977,8
795,4,1,0,43,0.023255813953488372,0.0,1.0,43,1500,1100,400,0.7333333333333333,19,11,8,367.2408724226816,0.44379844961240306,0.2814704626124862,0.19790898892676284,128063.41428336644,806.0239973701791,128869.43828073662,768,0,226.34883720930233,38,5,18,37.66228625712478,0.5970394736842105,46.95512820512822,1012.1794871794891,26.636302294197083,0
796,4,1,2,42,0.022727272727272728,0.045454545454545456,0.9545454545454546,44,900,500,400,0.5555555555555556,13,5,8,359.5778944183623,0.4443049682875264,0.27512049982272413,0.19549085870183394,128415.10662073559,435.07241215574595,128850.17903289133,769,0,222.1818181818182,38,6,18,37.49648642001336,0.6006030701754386,46.60790598290598,1013.5683760683758,26.672852001799363,0
797,4,0,0,42,0.0,0.0,1.0,42,1400,900,500,0.6428571428571429,19,9,10,370.5112650310028,0.44192799070847855,0.27511194933551786,0.2010507692396654,128338.889429921,1110.2008550708206,129449.09028499182,770,2,228.66666666666666,37,5,19,37.29743804783034,0.6016328828828829,46.68311403508773,1013.2675438596511,27.385609293504086,0
798,4,2,0,44,0.045454545454545456,0.0,1.0,44,1400,1000,400,0.7142857142857143,18,10,8,356.53004399854774,0.44556025369978863,0.27165279085594896,0.19652484222893407,128963.21750217034,395.85232204863,129359.06982421897,771,0,219.22727272727272,39,5,20,37.014259221276454,0.6044337606837606,46.06770833333334,1015.7291666666683,26.04433760683765,0
799,4,1,1,44,0.022222222222222223,0.022222222222222223,0.9777777777777777,45,950,500,450,0.5263157894736842,14,5,9,350.71217414673436,0.4477483164983165,0.27231329690346073,0.19448584202682567,129201.3888888891,62.50000000001921,129263.88888888911,772,0,215.33333333333334,40,5,22,36.919398907103826,0.6052083333333333,45.83333333333334,1016.6666666666683,25.416666666666707,0
800,4,0,1,43,0.0,0.022727272727272728,0.9772727272727273,44,1450,900,550,0.6206896551724138,20,9,11,349.30000285385125,0.4473000352360817,0.26443221204800915,0.1943708548902113,129337.19735051862,235.49668072905098,129572.69403124767,773,1,218.95454545454547,38,6,23,36.81707978853763,0.6099232456140351,45.699786324786324,1017.2008547008543,26.76844354475932,0
801,4,1,0,44,0.022727272727272728,0.0,1.0,44,1250,900,350,0.72,16,9,7,344.553594205444,0.4485002642706131,0.2852295965792899,0.19366288226030126,129731.44531250001,139.88715277777794,129871.3324652778,774,0,219.0681818181818,39,5,22,36.53715064758007,0.6121794871794872,45.3125,1018.7500000000001,26.121794871794876,0
802,4,0,0,44,0.0,0.0,1.0,44,1150,900,250,0.782608695652174,14,9,5,345.05582227796583,0.4484672304439747,0.28252062736935946,0.19447155329306576,129837.58680555577,160.24305555557453,129997.82986111134,775,1,220.0681818181818,39,5,23,36.41659852820931,0.6132478632478633,45.20833333333334,1019.1666666666683,26.132478632478676,0
803,4,0,1,43,0.0,0.022727272727272728,0.9772727272727273,44,850,500,350,0.5882352941176471,12,5,7,347.09022949796827,0.4478285764622974,0.28947319537838534,0.19615006733984497,129943.77170138896,220.4427083333427,130164.2144097223,776,2,221.0681818181818,39,5,23,36.256981337692416,0.6143162393162394,45.10416666666667,1019.5833333333339,26.14316239316241,0
804,4,1,1,43,0.022727272727272728,0.022727272727272728,0.9772727272727273,44,1800,1300,500,0.7222222222222222,23,13,10,346.23414372012894,0.4474101479915433,0.29629183964061534,0.19741878911740202,130291.32806793293,223.43315655183963,130514.76122448477,777,0,221.0909090909091,36,8,24,35.926354879035244,0.6232638888888888,44.76351351351352,1020.945945945947,28.359609609609638,0
805,4,1,0,44,0.022727272727272728,0.0,1.0,44,1050,700,350,0.6666666666666666,14,7,7,340.0251367233942,0.44624295278365045,0.27829271004141076,0.195469634836946,130608.41064453122,82.02853732638721,130690.43918185761,778,0,212.22727272727272,39,5,17,35.763888888888914,0.6209935897435898,44.453125,1022.1874999999998,26.20993589743589,0
806,4,0,0,44,0.0,0.0,1.0,44,1350,800,550,0.5925925925925926,19,8,11,342.3919829238515,0.44582452431289643,0.2854301906710992,0.19737299450167078,130714.91021050363,151.147460937517,130866.05767144114,779,1,213.22727272727272,39,5,19,35.59567162405353,0.6220619658119658,44.34895833333334,1022.6041666666679,26.220619658119688,0
807,4,0,0,44,0.0,0.0,1.0,44,1000,800,200,0.8,12,8,4,343.1909807043073,0.4456923890063425,0.28353424251682746,0.1981065396552379,130768.17626953137,175.69173177084664,130943.86800130221,780,2,214.22727272727272,39,5,19,35.521374376209394,0.6225961538461539,44.29687500000001,1022.8125000000009,26.22596153846156,0
808,4,0,0,44,0.0,0.0,1.0,44,1850,1300,550,0.7027027027027027,24,13,11,340.75966743224427,0.44473440803382663,0.2778595287532726,0.197436700290144,130911.78882444324,121.89152455550362,131033.68034899875,781,3,215.22727272727272,40,4,19,35.4383896060907,0.6223958333333333,44.15650406504066,1023.3739837398383,25.584349593495958,0
809,4,0,1,43,0.0,0.022727272727272728,0.9772727272727273,44,1550,1000,550,0.6451612903225806,21,10,11,342.99894834972633,0.44350114517265676,0.2785274856122244,0.19981175731032075,131119.87428944436,194.79579780556728,131314.67008724992,782,4,216.22727272727272,40,4,21,35.17087550439902,0.6244791666666667,43.95325203252034,1024.1869918699208,25.60467479674802,0
810,4,0,0,43,0.0,0.0,1.0,43,1200,700,500,0.5833333333333334,17,7,10,351.8933923910147,0.4403839055001846,0.28992295373202337,0.20482320548230176,131088.00048828172,625.800238715322,131713.80072699703,783,5,222.0,39,4,22,34.97535432136438,0.625801282051282,43.98437500000002,1024.0625000000036,26.258012820512914,0
811,4,0,0,43,0.0,0.0,1.0,43,1150,900,250,0.782608695652174,14,9,5,352.4637728966084,0.4396686969361388,0.28709830705617856,0.2060122480085527,131248.05908203148,652.0372178819739,131900.09629991345,784,6,223.0,39,4,23,34.798994442750185,0.6274038461538461,43.828125000000014,1024.6875000000018,26.27403846153851,0
812,4,0,0,43,0.0,0.0,1.0,43,1050,500,550,0.47619047619047616,16,5,11,354.48535091742207,0.4392764857881137,0.29316172281563113,0.207783654179092,131356.9835671823,712.8985252408496,132069.88209242315,785,7,224.0,36,7,23,34.6371617415504,0.6339699074074074,43.72184684684686,1025.1126126126146,28.475350350350407,0
813,4,0,0,43,0.0,0.0,1.0,43,1350,900,450,0.6666666666666666,18,9,9,355.1622901014296,0.43923034330011074,0.22451413349936855,0.1957090001909304,128950.68825263536,602.1550301318916,129552.84328276725,786,8,225.0,37,6,20,37.06176454712295,0.6078265765765766,46.080043859649116,1015.6798245614029,27.450806069227106,8
814,4,1,0,44,0.022727272727272728,0.0,1.0,44,1350,900,450,0.6666666666666666,18,9,9,344.0231308281186,0.4387773079633545,0.22358785258432556,0.19148950581686724,129348.51794249396,100.5068151163041,129449.02475761026,787,0,220.86363636363637,35,9,23,36.93975897902683,0.6157738095238094,45.688657407407405,1017.24537037037,29.06415343915343,0
815,4,0,3,41,0.0,0.06818181818181818,0.9318181818181819,44,1650,1400,250,0.8484848484848485,19,14,5,382.0122903080759,0.43860112755461594,0.1558675811922563,0.2038659648277753,127670.36132812516,954.3294270833483,128624.6907552085,788,1,221.86363636363637,39,5,16,37.69197072768503,0.5913461538461539,47.34375000000001,1010.6250000000013,25.913461538461572,8
816,4,0,0,41,0.0,0.0,1.0,41,1400,1100,300,0.7857142857142857,17,11,6,400.60143469773794,0.43544207317073175,0.1912980570483671,0.21283137833941446,127489.75326678036,2014.5156135865723,129504.26888036693,789,12,238.41463414634146,36,5,17,37.4082385518882,0.5949074074074074,47.52252252252253,1009.9099099099105,28.05305305305307,0
817,4,5,2,44,0.10869565217391304,0.043478260869565216,0.9565217391304348,46,1250,800,450,0.64,17,8,9,370.61225083594195,0.446688808373591,0.23014561602809036,0.20407911220228878,128922.84765504782,362.78591739809673,129285.63357244592,790,0,213.3913043478261,37,9,18,36.6978874253221,0.607545045045045,46.107456140350884,1015.5701754385974,27.44784257942155,0
818,4,0,1,43,0.0,0.022727272727272728,0.9772727272727273,44,1000,800,200,0.8,12,8,4,382.8168617933698,0.44382047216349546,0.25733305003057594,0.21024963649277714,128819.24518014853,1062.8358356910442,129882.08101583958,791,1,223.79545454545453,35,9,18,36.49396210998366,0.6104166666666666,46.209490740740755,1015.1620370370388,29.00462962962968,0
819,4,2,1,44,0.044444444444444446,0.022222222222222223,0.9777777777777777,45,1850,1600,250,0.8648648648648649,21,16,5,374.34040300961647,0.44724326599326597,0.25498542688561887,0.20881300853106008,129433.1550598145,693.2417734823782,130126.39683329688,792,0,217.8,31,14,16,36.08245361484324,0.626008064516129,45.60546875,1017.5781250000003,32.82510080645162,0
820,4,0,0,44,0.0,0.0,1.0,44,1200,600,600,0.5,18,6,12,384.5069376095787,0.44382047216349546,0.26152221226475514,0.21376396367746747,129300.69181654179,1143.40260823567,130444.09442477746,793,1,223.75,31,13,21,35.95903746852729,0.6246639784946236,45.73567708333333,1017.0572916666658,32.80829973118277,0
821,4,0,0,44,0.0,0.0,1.0,44,1250,700,550,0.56,18,7,11,384.6844771771182,0.44313777307963353,0.26157086307812016,0.21489546573283083,129490.37606175386,1162.5875229568387,130652.9635847107,794,2,224.75,32,12,17,35.76091675970725,0.6240234375,45.54924242424242,1017.80303030303,31.80634469696969,0
822,4,0,0,44,0.0,0.0,1.0,44,2150,1800,350,0.8372093023255814,25,18,7,377.6151963357,0.4418054087385483,0.25721028766817833,0.21282183646016636,129837.58680555549,1005.729166666659,130843.31597222215,795,3,225.75,34,10,19,35.587012810029975,0.6228553921568627,45.20833333333333,1019.1666666666661,29.975490196078415,0
823,4,0,1,43,0.0,0.022727272727272728,0.9772727272727273,44,1400,1100,300,0.7857142857142857,17,11,6,377.49248225060376,0.44155214940098664,0.25650867469367844,0.21291769651051815,129867.92091836725,1004.8327664399001,130872.75368480715,796,4,226.75,34,10,20,35.559254068364105,0.6231617647058824,45.17857142857142,1019.2857142857134,29.97899159663863,0
824,4,0,1,42,0.0,0.023255813953488372,0.9767441860465116,43,1200,1000,200,0.8333333333333334,14,10,4,377.87163091472064,0.441952750092285,0.24573256341774985,0.21399773853602294,130026.38996056237,1226.6568072702296,131253.0467678326,797,5,225.53488372093022,35,8,20,35.38829626267211,0.6226190476190476,45.023148148148145,1019.907407407407,29.14021164021163,0
825,4,0,0,42,0.0,0.0,1.0,42,800,500,300,0.625,11,5,6,389.088761502047,0.43886711188540456,0.24964556750896505,0.2199699829877908,129958.94451530604,1713.1129535147286,131672.05746882077,798,6,231.73809523809524,34,8,20,35.17099630278265,0.6240808823529411,45.08928571428571,1019.6428571428565,29.98949579831931,0
826,4,0,0,42,0.0,0.0,1.0,42,1150,900,250,0.782608695652174,14,9,5,390.3082585829867,0.4383710801393728,0.2552919057343839,0.22137561075614168,130085.41907793199,1754.6826774691235,131840.10175540112,799,7,232.73809523809524,35,7,21,35.01106194690266,0.6232142857142857,44.96527777777777,1020.138888888888,29.14682539682537,0
827,4,0,0,42,0.0,0.0,1.0,42,1800,1300,500,0.7222222222222222,23,13,10,390.90557498445077,0.4386251451800232,0.2547957945177408,0.2223965615871989,130205.11379200152,1779.5809745556428,131984.69476655716,800,8,233.73809523809524,36,6,21,34.87393798962815,0.6223958333333333,44.847972972972975,1020.6081081081086,28.350225225225238,0
828,4,0,0,42,0.0,0.0,1.0,42,1150,800,350,0.6956521739130435,15,8,7,391.84593437472483,0.4386614401858304,0.2609209223799205,0.22345192519507018,130295.81917656783,1811.2408100750704,132107.0599866429,801,9,234.73809523809524,31,11,21,34.757604259660766,0.634744623655914,44.75911458333333,1020.9635416666658,32.9343077956989,0
829,4,0,0,42,0.0,0.0,1.0,42,750,500,250,0.6666666666666666,10,5,5,389.6455122725894,0.43828639179248935,0.25874796629513597,0.22276817771619456,130395.54172092007,1761.6075303819355,132157.149251302,802,10,235.73809523809524,31,11,21,34.712306646268914,0.635752688172043,44.66145833333333,1021.3541666666661,32.946908602150515,0
830,4,0,0,42,0.0,0.0,1.0,42,1450,900,550,0.6206896551724138,20,9,11,389.94098805308914,0.43742740998838564,0.2595749938225844,0.22384272037600744,130552.75769054181,1781.5742653810837,132334.33195592288,803,11,236.73809523809524,32,10,21,34.54487892265875,0.634765625,44.50757575757576,1021.9696969696971,31.936553030303035,0
831,4,0,1,41,0.0,0.023809523809523808,0.9761904761904762,42,1400,1100,300,0.7857142857142857,17,11,6,387.5410981050084,0.43704026325977546,0.2622280612034964,0.22376838458650558,130778.6693481532,1736.4218255790174,132515.09117373222,804,12,237.73809523809524,32,10,21,34.37667160432868,0.6370442708333333,44.28661616161616,1022.853535353535,31.96417297979797,0
832,4,0,0,41,0.0,0.0,1.0,41,1150,800,350,0.6956521739130435,15,8,7,387.2165096930207,0.435645325203252,0.2692068424695746,0.2244028502738663,130920.20083922037,1938.8926434544271,132859.0934826748,805,13,242.8048780487805,33,8,21,34.24128347902447,0.6360479797979798,44.14828431372548,1023.406862745097,31.01232917409385,0
833,4,1,0,42,0.023809523809523808,0.0,1.0,42,1150,700,450,0.6086956521739131,16,7,9,376.97276457526505,0.43567315137437085,0.2668748285488376,0.2202864610419022,131239.1643759644,1494.718123070978,132733.8824990354,806,0,238.0,35,7,22,34.180150796340214,0.6348214285714286,43.83680555555555,1024.652777777777,29.275793650793627,0
834,4,0,0,42,0.0,0.0,1.0,42,1300,800,500,0.6153846153846154,18,8,10,376.62486363390616,0.43478997289972904,0.26116952469402,0.22129922069184627,131450.17715419494,1501.511149888194,132951.68830408313,807,1,239.0,34,8,22,33.97545662100457,0.639093137254902,43.63095238095238,1025.4761904761901,30.1610644257703,0
835,4,0,0,42,0.0,0.0,1.0,42,1450,1100,350,0.7586206896551724,18,11,7,376.32061346374496,0.4341366627951994,0.26484400466300917,0.22200597997563432,131602.82206632654,1504.9709467120124,133107.79301303855,808,2,240.0,34,8,19,33.82884712070232,0.640625,43.482142857142854,1026.0714285714284,30.178571428571423,0
836,4,0,1,41,0.0,0.023809523809523808,0.9761904761904762,42,1050,800,250,0.7619047619047619,13,8,5,375.603789480375,0.43378581107239644,0.2620594230036293,0.22193833235848612,131663.90483276636,1490.6923185940968,133154.59715136045,809,3,241.0,34,8,19,33.78547538955264,0.6412377450980392,43.422619047619044,1026.3095238095232,30.18557422969186,0
837,4,1,1,41,0.023809523809523808,0.023809523809523808,0.9761904761904762,42,950,500,450,0.5263157894736842,14,5,9,371.7797920893156,0.4348262679055362,0.27996771408191656,0.22169461208603292,132011.15779588892,1415.8161597650756,133426.973955654,810,0,241.14285714285714,35,7,21,33.53289127904794,0.6425595238095239,43.08449074074073,1027.662037037036,29.36177248677246,0
838,4,0,0,41,0.0,0.0,1.0,41,850,600,250,0.7058823529411765,11,6,5,379.92380328559517,0.43442581300813005,0.28396586666063706,0.22593814600629883,131908.37762188184,1823.0265022675462,133731.40412414938,811,1,247.9268292682927,34,7,21,33.42749256383512,0.6436887254901961,43.184523809523796,1027.2619047619028,30.21358543417361,0
839,4,0,1,40,0.0,0.024390243902439025,0.975609756097561,41,1200,900,300,0.75,15,9,6,383.40696446521423,0.4344512195121952,0.2864531984511409,0.2118044298841814,129050.14349489793,1697.5588151927377,130747.70231009067,812,2,248.9268292682927,34,7,18,36.24292130443272,0.6148897058823529,45.982142857142854,1016.0714285714283,29.884453781512597,8
840,4,2,1,41,0.047619047619047616,0.023809523809523808,0.9761904761904762,42,900,600,300,0.6666666666666666,12,6,6,346.35805251430696,0.4390122919086334,0.16465733763903856,0.19453847084993436,129703.52055440146,604.7901807306616,130308.31073513212,813,0,238.02380952380952,37,5,16,36.51955507714389,0.615427927927928,45.33991228070176,1018.6403508771938,27.53082029397821,8
841,4,0,0,41,0.0,0.0,1.0,41,1200,800,400,0.6666666666666666,16,8,8,350.0389900363945,0.4364075203252033,0.1675759405602666,0.1966059381764273,129703.52055440146,880.2578678054913,130583.77842220695,814,1,244.82926829268294,37,4,17,36.425816289917485,0.615427927927928,45.33991228070176,1018.6403508771938,27.53082029397821,0
842,4,1,1,41,0.023809523809523808,0.023809523809523808,0.9761904761904762,42,1300,800,500,0.6153846153846154,18,8,10,346.0735934019306,0.4374879016647309,0.17242265084519226,0.19608098493817414,130044.55133912279,600.9970368544249,130645.54837597722,815,0,239.97619047619048,38,4,18,36.18065011696519,0.6170504385964912,45.00534188034189,1019.9786324786336,26.84154295996404,0
843,4,0,0,41,0.0,0.0,1.0,41,1100,800,300,0.7272727272727273,14,8,6,354.20837073693525,0.43628048780487805,0.17741457646759629,0.20080441639035412,130066.77685682142,1014.1482234918547,131080.9250803133,816,1,243.97560975609755,37,4,18,35.95065659822996,0.6190878378378378,44.98355263157895,1020.065789473685,27.569345661450946,0
844,4,0,1,40,0.0,0.024390243902439025,0.975609756097561,41,1050,600,450,0.5714285714285714,15,6,9,353.84781876407055,0.43572154471544716,0.17854727870296117,0.20103222230881806,130150.67737188366,1010.7066597414625,131161.38403162512,817,2,244.97560975609755,37,4,18,35.874704491725765,0.6199324324324325,44.901315789473685,1020.3947368421053,27.57823613086771,0
845,4,0,1,39,0.0,0.025,0.975,40,1100,700,400,0.6363636363636364,15,7,8,361.0162432319868,0.433840811965812,0.20030612244897994,0.20569530137636446,130262.58680555539,1405.4781278854844,131668.06493344088,818,3,251.475,34,6,19,35.578231292516996,0.6271446078431373,44.79166666666666,1020.833333333332,30.02450980392153,0
846,4,3,1,41,0.07142857142857142,0.023809523809523808,0.9761904761904762,42,1800,1500,300,0.8333333333333334,21,15,6,339.78036207517937,0.43883081687959735,0.18199336035271862,0.19782090990471693,131097.37059694823,508.862409707001,131606.23300665524,729,0,220.95238095238096,36,6,19,35.27600615790634,0.6313657407407407,43.97522522522522,1024.0990990990986,28.447197197197184,0
847,4,0,1,40,0.0,0.024390243902439025,0.975609756097561,41,1350,1200,150,0.8888888888888888,15,12,3,349.38147420903914,0.43709349593495933,0.18711881862605684,0.20341069951709373,131097.37059694843,960.5985208181263,132057.96911776657,730,1,227.34146341463415,36,5,20,35.0301939007404,0.6313657407407407,43.97522522522523,1024.0990990991002,28.447197197197227,0
848,4,0,1,39,0.0,0.025,0.975,40,1150,900,250,0.782608695652174,14,9,5,354.0639864470124,0.437366452991453,0.1811023844502202,0.20626150204539911,131120.5970963006,1285.0162626457504,132405.61335894634,731,2,220.975,35,5,20,34.88682807850228,0.6336309523809525,43.9525462962963,1024.189814814815,29.262566137566143,0
849,4,0,1,38,0.0,0.02564102564102564,0.9743589743589743,39,1300,900,400,0.6923076923076923,17,9,8,358.1565617754872,0.43634727845254156,0.18614086335605307,0.20848481964404691,131090.96364883415,1590.2177640603702,132681.1814128945,732,3,226.15384615384616,35,4,20,34.812010247136826,0.6333333333333333,43.98148148148149,1024.074074074075,29.259259259259288,0
850,4,0,0,38,0.0,0.0,1.0,38,1150,900,250,0.782608695652174,14,9,5,368.75141019394425,0.43570708866761493,0.18418673265442043,0.21465213667079086,131090.96364883418,2067.9955418381473,133158.95919067232,733,4,222.78947368421052,35,3,20,34.54076250753464,0.6333333333333333,43.98148148148149,1024.0740740740753,29.259259259259295,0
851,4,0,0,38,0.0,0.0,1.0,38,1100,700,400,0.6363636363636364,15,7,8,367.7127408349703,0.43474395448079656,0.17946637179189873,0.21487530657504933,131239.16437596473,2051.6625675154505,133290.82694348018,734,5,223.78947368421052,35,3,20,34.41735852253473,0.6348214285714286,43.836805555555564,1024.6527777777794,29.275793650793698,0
852,4,1,0,39,0.02564102564102564,0.0,1.0,39,1000,600,400,0.6,14,6,8,360.12048887955103,0.4341824111560954,0.19300999752127623,0.21354915614449804,131799.59518274217,1692.8373527209058,133492.43253546307,735,0,219.02564102564102,33,6,17,34.045803994112276,0.6448863636363636,43.29044117647059,1026.8382352941173,31.116310160427798,0
853,4,0,0,39,0.0,0.0,1.0,39,950,500,450,0.5263157894736842,14,5,9,356.889061694108,0.4336763382816014,0.19095413506681091,0.21214939199833988,131892.2422223296,1614.1797142918654,133506.42193662145,736,1,220.02564102564102,35,4,17,34.03532863849765,0.6413690476190477,43.200231481481495,1027.199074074076,29.348544973545028,0
854,4,0,1,38,0.0,0.02564102564102564,0.9743589743589743,39,1200,800,400,0.6666666666666666,16,8,8,357.88897005113233,0.43266419253261357,0.19383229383229383,0.21357890148212733,132040.8950617284,1651.195987654324,133692.09104938273,737,2,221.02564102564102,35,4,18,33.859797297297305,0.6428571428571428,43.05555555555556,1027.7777777777778,29.365079365079367,0
855,4,0,0,38,0.0,0.0,1.0,38,1650,1200,450,0.7272727272727273,21,12,9,363.2723232257585,0.43032835467045993,0.19175806422113473,0.21673323886717127,132030.69905045332,1992.6197562358116,134023.31880668912,738,3,227.6315789473684,34,4,19,33.73175605235724,0.6449142156862745,43.06547619047618,1027.7380952380938,30.227591036414523,0
856,4,0,0,38,0.0,0.0,1.0,38,1150,800,350,0.6956521739130435,15,8,7,363.7233755619174,0.4289651493598862,0.19176934930776746,0.21841095818141262,132275.51197562355,2022.339143990923,134297.85111961447,739,4,228.6315789473684,34,4,21,33.473411642171044,0.6473651960784313,42.82738095238095,1028.690476190476,30.25560224089635,0
857,4,0,0,38,0.0,0.0,1.0,38,1250,1000,250,0.8,15,10,5,362.4055467226148,0.4288910621147463,0.19252077562326853,0.21832724400118475,132398.00347222204,1996.3541666666424,134394.3576388887,740,5,229.6315789473684,34,4,21,33.383940620782724,0.6485906862745099,42.70833333333332,1029.1666666666652,30.26960784313721,0
858,4,0,0,38,0.0,0.0,1.0,38,1500,1000,500,0.6666666666666666,20,10,10,364.88934971355576,0.4278390232337601,0.189362970533129,0.22108001776762468,132612.49999999977,2077.7777777777496,134690.27777777752,741,6,230.6315789473684,34,4,21,33.10409924487593,0.6507352941176471,42.499999999999986,1029.9999999999982,30.29411764705877,0
859,4,0,1,37,0.0,0.02631578947368421,0.9736842105263158,38,1300,1000,300,0.7692307692307693,16,10,6,365.8380587780899,0.4275426742532005,0.18675878510697808,0.22201700986434664,132673.81660997702,2107.4263038548306,134781.24291383184,742,7,231.6315789473684,34,4,17,33.01796856944763,0.6513480392156863,42.44047619047617,1030.2380952380927,30.301120448179198,0
860,4,0,0,37,0.0,0.0,1.0,37,1150,900,250,0.782608695652174,14,9,5,373.37079505856235,0.42605105105105107,0.20647529889827987,0.22663742050955468,132681.93310565644,2507.9117707131827,135189.84487636964,743,8,237.75675675675674,33,4,17,32.815783474089045,0.6537247474747474,42.432598039215684,1030.269607843137,31.220291146761728,0
861,4,0,1,36,0.0,0.02702702702702703,0.972972972972973,37,1050,800,250,0.7619047619047619,13,8,5,373.0234517822476,0.425487987987988,0.19842529806857945,0.22699907593984814,132776.64389898116,2505.7604046520482,135282.4043036332,744,9,238.75675675675674,33,4,18,32.72938961553704,0.6546717171717171,42.3406862745098,1030.6372549019607,31.23143196672608,0
862,4,0,0,36,0.0,0.0,1.0,36,700,400,300,0.5714285714285714,10,4,6,373.954818128398,0.424239417989418,0.1866537388582703,0.22803144809696568,132853.20255905017,2736.219040148973,135589.42159919915,745,10,237.66666666666666,32,4,19,32.628342518881404,0.6578776041666667,42.266414141414145,1030.934343434344,32.21669823232325,0
863,4,0,0,36,0.0,0.0,1.0,36,850,300,550,0.35294117647058826,14,3,11,390.79694293649266,0.424537037037037,0.1614741844198837,0.22159357990486123,130075.00120146088,2966.582564398297,133041.5837658592,746,11,238.66666666666666,33,3,19,35.00921031555342,0.6275252525252526,44.975490196078425,1020.0980392156855,30.91206179441471,8
864,4,0,2,34,0.0,0.05555555555555555,0.9444444444444444,36,1050,800,250,0.7619047619047619,13,8,5,388.3283805117384,0.423859126984127,0.16147396646256085,0.22107908962968334,130231.31315179255,2914.502985630524,133145.81613742307,747,12,239.66666666666666,33,3,19,34.91302977548326,0.6291035353535354,44.822303921568626,1020.7107843137252,30.93062982768864,0
865,4,0,0,34,0.0,0.0,1.0,34,1350,1100,250,0.8148148148148148,16,11,5,389.7437901187826,0.41900623885918004,0.14943707453307775,0.2226163682542876,130359.27456381997,3361.3435491276373,133720.61811294762,748,13,245.08823529411765,32,2,19,34.74669263105838,0.6328125,44.696969696969695,1021.2121212121208,31.912878787878775,0
866,4,0,0,34,0.0,0.0,1.0,34,1500,1100,400,0.7333333333333333,19,11,8,387.5885790913147,0.41904337492572785,0.14860719374254905,0.22212229334326644,130488.24737271722,3315.150877461503,133803.39825017872,749,14,246.08823529411765,32,2,16,34.67055940023069,0.6341145833333333,44.57070707070708,1021.7171717171728,31.92866161616165,0
867,4,0,0,34,0.0,0.0,1.0,34,650,300,350,0.46153846153846156,10,3,7,386.44251860885277,0.41902480689245397,0.1506785093871974,0.2216498443020161,130520.50053884815,3287.7341916641262,133808.23473051228,750,15,247.08823529411765,32,2,16,34.6670476543515,0.6344401041666667,44.53914141414142,1021.843434343435,31.932607323232343,0
868,4,0,0,34,0.0,0.0,1.0,34,1000,800,200,0.8,12,8,4,382.88986587555087,0.41800356506238856,0.14760362035651475,0.22052931250783878,130681.82615294366,3207.349377614537,133889.1755305582,751,16,248.08823529411765,32,2,17,34.59393265826953,0.6360677083333333,44.381313131313135,1022.4747474747481,31.95233585858588,0
869,4,0,0,34,0.0,0.0,1.0,34,1600,1400,200,0.875,18,14,4,385.1278395663872,0.4175579322638146,0.14755966552464983,0.22293400084614295,130875.54841342718,3280.763442505864,134156.31185593305,752,17,249.08823529411765,32,2,17,34.340037841395194,0.6380208333333333,44.19191919191919,1023.2323232323231,31.976010101010097,0
870,4,0,0,34,0.0,0.0,1.0,34,850,600,250,0.7058823529411765,11,6,5,367.52372439775723,0.4172794117647059,0.050914930272458525,0.20396952115907627,129232.53864198856,2699.2047830161364,131931.7434250047,753,18,250.08823529411765,33,1,17,36.460342091519024,0.6190025252525253,45.80269607843137,1016.7892156862738,30.81179441473557,8
871,4,1,0,35,0.02857142857142857,0.0,1.0,35,1300,1000,300,0.7692307692307693,16,10,6,362.12803458685704,0.4205532212885154,0.05167173252279644,0.20299103590143983,129625.34722222207,2388.1944444444266,132013.5416666665,754,0,243.9142857142857,34,1,17,36.197490452809596,0.6207107843137255,45.41666666666666,1018.3333333333321,29.950980392156826,0
872,4,0,0,35,0.0,0.0,1.0,35,900,600,300,0.6666666666666666,12,6,6,360.52961901744544,0.42051820728291317,0.04834240309818738,0.20272092506907338,129746.60572562352,2355.4988662131445,132102.10459183666,755,1,244.9142857142857,34,1,18,36.11484381085924,0.6219362745098039,45.297619047619044,1018.8095238095233,29.964985994397743,0
873,4,1,0,36,0.027777777777777776,0.0,1.0,36,1100,800,300,0.7272727272727273,14,8,6,355.00541829572387,0.42126322751322753,0.055505142165759525,0.2016577169906635,130144.4615912207,2040.3978052126015,132184.85939643328,756,0,239.08333333333334,35,1,19,35.85148215366002,0.6238095238095238,44.9074074074074,1020.3703703703691,29.153439153439116,0
874,4,2,1,37,0.05263157894736842,0.02631578947368421,0.9736842105263158,38,1100,800,300,0.7272727272727273,14,8,6,346.9205416461738,0.4270092460881934,0.07283371308683217,0.2008351423475243,130878.94833025541,1480.9191289627556,132359.86745921816,757,0,227.44736842105263,37,1,18,35.31397342477496,0.6272522522522522,44.18859649122807,1023.2456140350873,27.65528686581317,0
875,4,0,0,37,0.0,0.0,1.0,37,1050,700,350,0.6666666666666666,14,7,7,355.7512824674096,0.42251626626626626,0.07867709188713157,0.20557535941055655,130809.21292914539,1907.1090516191898,132716.32198076457,758,1,234.51351351351352,36,1,19,35.15865808014091,0.6284722222222222,44.25675675675676,1022.9729729729733,28.415915915915924,0
876,4,0,0,37,0.0,0.0,1.0,37,1450,1100,350,0.7586206896551724,18,11,7,362.3440995462061,0.4214527027027027,0.08482913794692126,0.21079941760547974,131068.54056336729,2098.3824618537337,133166.92302522104,759,2,235.51351351351352,36,1,19,34.72749184354265,0.6310763888888888,44.00337837837837,1023.9864864864855,28.444069069069045,0
877,4,0,0,37,0.0,0.0,1.0,37,850,400,450,0.47058823529411764,13,4,9,361.9622418327185,0.4215152652652652,0.08123562313137844,0.21073525142296687,131097.37059694828,2090.459631929224,133187.83022887752,760,3,236.51351351351352,36,1,19,34.708095081005794,0.6313657407407407,43.97522522522522,1024.099099099099,28.447197197197195,0
878,4,1,0,38,0.02631578947368421,0.0,1.0,38,800,300,500,0.375,13,3,10,355.3251992010743,0.4242383831199621,0.08844707434010024,0.2086034419961773,131417.11576485334,1739.5683787320518,133156.6841435854,761,0,231.26315789473685,35,3,20,34.55490179478496,0.6366071428571429,43.66319444444444,1025.347222222222,29.295634920634914,0
879,4,0,0,38,0.0,0.0,1.0,38,1050,800,250,0.7619047619047619,13,8,5,352.51442559376017,0.42400130393551444,0.09082110810014399,0.20756650954968064,131530.201548677,1673.2586894326714,133203.46023810966,762,1,232.26315789473685,36,2,20,34.51279869725912,0.6357060185185186,43.552927927927925,1025.788288288288,28.49411911911911,0
880,4,0,0,38,0.0,0.0,1.0,38,900,700,200,0.7777777777777778,11,7,4,350.5828067995509,0.4235419630156472,0.08909592902361263,0.2068983507485431,131616.85333982625,1628.5211732002233,133245.37451302647,763,2,233.26315789473685,36,2,18,34.474914032777285,0.6365740740740741,43.468468468468465,1026.1261261261257,28.50350350350349,0
881,4,0,0,38,0.0,0.0,1.0,38,1350,900,450,0.6666666666666666,18,9,9,349.5407240689445,0.4216453295400664,0.08101338873499575,0.2075398049159358,131848.06428049668,1617.253571138704,133465.3178516354,764,3,234.26315789473685,36,2,18,34.26854897660819,0.6388888888888888,43.24324324324324,1027.0270270270266,28.52852852852852,0
882,4,1,1,38,0.02564102564102564,0.02564102564102564,0.9743589743589743,39,1150,700,450,0.6086956521739131,16,7,9,338.76283582131805,0.42262708052181736,0.07619313195600652,0.20301959342927414,132200.59447378034,1156.9296562403729,133357.5241300207,765,0,229.23076923076923,37,2,19,34.1906342182891,0.6404842342342343,42.90021929824561,1028.399122807017,27.794570886676134,0
883,4,1,0,39,0.02564102564102564,0.0,1.0,39,1300,1100,200,0.8461538461538461,15,11,4,358.16290085234624,0.4229644624381466,0.09818062374461856,0.2042246249785745,130292.12648158865,1554.0149680878762,131846.14144967654,766,0,230.0,35,4,21,35.621079431659304,0.625297619047619,44.76273148148148,1020.949074074074,29.169973544973544,8
884,4,0,0,39,0.0,0.0,1.0,39,550,200,350,0.36363636363636365,9,2,7,356.09482872678177,0.4229644624381466,0.09660843916937445,0.20319142933075743,130320.07250071042,1481.2607793604698,131801.3332800709,767,1,231.0,36,3,21,35.64551854711224,0.6235532407407407,44.735360360360374,1021.0585585585605,28.362737737737792,0
885,4,0,1,38,0.0,0.02564102564102564,0.9743589743589743,39,800,500,300,0.625,11,5,6,355.80393777619366,0.4228238866396761,0.10143907465040769,0.20362760375822428,130435.08193582103,1481.8631553851233,131916.94509120614,768,2,232.0,36,3,22,35.536324550766174,0.6247106481481481,44.62274774774775,1021.5090090090096,28.375250250250264,0
886,4,0,0,38,0.0,0.0,1.0,38,1150,800,350,0.6956521739130435,15,8,7,371.694663067438,0.4215564248458985,0.10508993428861912,0.20539621005640724,129062.08070031171,1994.3373201369736,131056.41802044868,769,3,238.78947368421052,37,1,16,36.528249883097736,0.6089527027027026,45.97039473684211,1016.1184210526321,27.462660028449516,8
887,4,1,2,37,0.02564102564102564,0.05128205128205128,0.9487179487179487,39,1350,1000,350,0.7407407407407407,17,10,7,364.2946290682037,0.4253823661718399,0.1066276205718435,0.20319544865804268,129430.46932067213,1630.3152488862195,131060.78456955835,770,0,233.64102564102564,36,3,16,36.34074811863654,0.6145833333333333,45.60810810810811,1017.5675675675685,28.265765765765792,0
888,4,0,0,37,0.0,0.0,1.0,37,1300,900,400,0.6923076923076923,17,9,8,379.602257457673,0.4169169169169169,0.1225077536552952,0.21050670640834576,129201.38888888876,2409.0277777777674,131610.41666666654,771,5,247.02702702702703,34,3,17,36.18510928961751,0.616421568627451,45.83333333333333,1016.6666666666656,29.901960784313694,0
889,4,1,0,38,0.02631578947368421,0.0,1.0,38,850,700,150,0.8235294117647058,10,7,3,373.076686848233,0.4223713845424372,0.12554749766640327,0.20875206981660635,129554.63927469116,2066.763117283927,131621.40239197508,772,0,241.5,35,3,17,35.990791268758535,0.6178571428571429,45.4861111111111,1018.0555555555538,29.08730158730154,0
890,4,0,0,38,0.0,0.0,1.0,38,950,400,550,0.42105263157894735,15,4,11,371.7744879518787,0.422475106685633,0.12671484896166718,0.20817951435472135,129584.09857520991,2035.2123789008715,131619.31095411078,773,1,242.5,35,3,17,35.993923117729516,0.6181547619047619,45.45717592592592,1018.1712962962952,29.090608465608433,0
891,4,0,0,38,0.0,0.0,1.0,38,1600,1000,600,0.625,22,10,12,369.4876033057855,0.42281590801327645,0.1252631578947372,0.20736549165120585,129672.4965706445,1982.4759945130088,131654.9725651575,774,2,243.5,35,3,17,35.962121212121225,0.6190476190476191,45.37037037037036,1018.5185185185167,29.100529100529048,0
892,4,0,1,37,0.0,0.02631578947368421,0.9736842105263158,38,1400,1100,300,0.7857142857142857,17,11,6,372.95915148183775,0.4223862019914652,0.10654220867577413,0.19494675647726312,126829.5627170138,1870.9516192986866,128700.5143363125,775,3,244.5,35,3,19,38.785117200965175,0.5901785714285714,48.17708333333333,1007.291666666666,28.779761904761884,8
893,4,5,3,39,0.11904761904761904,0.07142857142857142,0.9285714285714286,42,1400,1100,300,0.7857142857142857,17,11,6,340.4159024349723,0.4381775067750677,0.10564109524312193,0.18332915541594622,128036.38100162544,317.39530399636703,128353.77630562181,776,0,218.88095238095238,38,4,18,38.36869699848691,0.596765350877193,46.98183760683761,1012.07264957265,26.633490778227632,0
894,4,3,1,41,0.07142857142857142,0.023809523809523808,0.9761904761904762,42,900,800,100,0.8888888888888888,10,8,2,340.67753226704014,0.43545538133952766,0.11608882565799661,0.18447708341634925,128255.57503270244,338.8042174232006,128594.37925012564,777,0,219.8095238095238,37,5,21,38.13821534242621,0.6007882882882882,46.765350877192986,1012.9385964912286,27.37671882408726,0
895,4,1,0,42,0.023809523809523808,0.0,1.0,42,1400,1100,300,0.7857142857142857,17,11,6,339.8177372758385,0.4333986643437863,0.12142631317465336,0.1849988817561925,128469.25593770553,331.22637245234023,128800.48231015787,778,0,220.66666666666666,38,4,17,37.94195911054906,0.6011513157894737,46.55448717948718,1013.7820512820518,26.678475033738206,0
896,4,0,2,40,0.0,0.047619047619047616,0.9523809523809523,42,1300,900,400,0.6923076923076923,17,9,8,337.49027060115276,0.4338342044134727,0.11937872494130408,0.18410676141069793,128550.50131492448,276.90869493754855,128827.41000986203,779,1,221.66666666666666,38,4,17,37.91811525495153,0.6019736842105263,46.47435897435898,1014.1025641025648,26.686909581646443,0
897,4,1,1,40,0.024390243902439025,0.024390243902439025,0.975609756097561,41,1250,1000,250,0.8,15,10,5,345.8916769435235,0.43351117886178864,0.12264748080006749,0.18860885780505324,128533.39489073545,691.7263004001081,129225.12119113556,780,0,227.9512195121951,37,4,18,37.72257064590543,0.6036036036036037,46.49122807017543,1014.0350877192969,27.40635372214316,0
898,4,0,1,39,0.0,0.025,0.975,40,900,600,300,0.6666666666666666,12,6,6,351.09928748942923,0.4337606837606838,0.1266657412548584,0.19149903596864376,128543.91289515857,1026.3352457186795,129570.24814087726,781,1,232.65,36,4,18,37.57981676846196,0.6056134259259259,46.48085585585585,1014.0765765765758,28.16879379379377,0
899,4,1,0,40,0.025,0.0,1.0,40,1100,700,400,0.6363636363636364,15,7,8,357.07579251810876,0.43074252136752134,0.141777592900721,0.19616320960089864,128829.56594685887,1200.3838720477052,130029.94981890658,782,0,233.5,36,4,19,37.13671658347198,0.6085069444444444,46.199324324324316,1015.2027027027015,28.20007507507504,0
900,4,1,0,41,0.024390243902439025,0.0,1.0,41,950,600,350,0.631578947368421,13,6,7,347.47393540342574,0.4325711382113821,0.13766750528964078,0.19214728122428062,129089.93632656173,771.077639273589,129861.01396583531,783,0,228.78048780487805,37,4,20,37.11516328585815,0.6092342342342343,45.942982456140335,1016.2280701754362,27.465623518255033,0
901,4,0,2,39,0.0,0.04878048780487805,0.9512195121951219,41,1350,1000,350,0.7407407407407407,17,10,7,331.7990053493032,0.43285060975609757,0.10757729084488088,0.17571956292265814,127361.47636788676,270.9189239484891,127632.39529183524,784,1,229.78048780487805,38,3,18,39.276610570138274,0.5899122807017544,47.649572649572654,1009.4017094017105,26.56320287899238,8
902,4,2,1,40,0.04878048780487805,0.024390243902439025,0.975609756097561,41,1000,700,300,0.7,13,7,6,329.59376920619195,0.431859756097561,0.14590320726164663,0.1760749096815237,127712.2041990833,218.62935112134872,127930.83355020464,785,0,230.5609756097561,38,3,20,38.973593348130926,0.5934758771929824,47.30235042735043,1010.7905982905991,26.59975258659471,0
903,4,1,1,40,0.024390243902439025,0.024390243902439025,0.975609756097561,41,800,400,400,0.5,12,4,8,329.4357010064265,0.43038617886178865,0.16608852182915235,0.1771769179007307,127982.32299884954,232.38925871138537,128214.71225756092,786,0,231.0731707317073,38,3,21,38.70169464681661,0.596217105263158,47.035256410256416,1011.8589743589752,26.62786774628882,0
904,4,1,0,41,0.024390243902439025,0.0,1.0,41,1350,1100,250,0.8148148148148148,16,11,5,321.4738859034994,0.4320630081300813,0.16761463361847118,0.17444158424158776,128338.88942992086,51.62302798336219,128390.51245790423,787,0,229.9512195121951,37,4,22,38.53963766547631,0.6016328828828829,46.683114035087726,1013.2675438596501,27.385609293504057,0
905,4,2,2,41,0.046511627906976744,0.046511627906976744,0.9534883720930233,43,750,500,250,0.6666666666666666,10,5,5,307.73764505032614,0.43625415282392027,0.1750091262427793,0.16917759877639768,128857.4340820314,-669.1433376735972,128188.2907443578,788,0,220.2093023255814,39,4,18,38.36062805649602,0.6033653846153846,46.17187500000001,1015.3125000000011,26.033653846153875,0
906,4,4,1,44,0.08888888888888889,0.022222222222222223,0.9777777777777777,45,1350,1000,350,0.7407407407407407,17,10,7,298.3022740513354,0.44137205387205386,0.18605755890742381,0.1661827526726722,129382.26176754912,-1280.5369767267107,128101.72479082241,789,0,211.26666666666668,40,5,22,38.06833316684979,0.60703125,45.65548780487805,1017.3780487804881,25.434451219512205,0
907,4,1,4,41,0.022222222222222223,0.08888888888888889,0.9111111111111111,45,1000,700,300,0.7,13,7,6,296.8223650545151,0.4397937710437711,0.184727353414323,0.1657934180714428,129485.67450137156,-1313.151170764753,128172.5233306068,790,0,212.15555555555557,40,5,12,38.001331336328825,0.6080729166666667,45.55386178861789,1017.7845528455287,25.444613821138216,0
908,4,0,0,41,0.0,0.0,1.0,41,1000,600,400,0.6,14,6,8,326.0611375711974,0.4320630081300813,0.19119211926460533,0.17929490106349677,128867.1754770697,203.71556632808128,129070.89104339779,791,2,233.78048780487805,37,4,19,37.88561915046796,0.6069819819819819,46.162280701754376,1015.3508771929811,27.4419155998103,0
909,4,1,0,42,0.023809523809523808,0.0,1.0,42,1100,500,600,0.45454545454545453,17,5,12,317.11905401773737,0.4324186991869919,0.18911007025761184,0.17585692995529045,129201.38888888866,-205.12273007081453,128996.26615881785,792,0,229.1904761904762,37,5,21,37.77322404371586,0.6103603603603603,45.83333333333332,1016.6666666666648,27.47747747747743,0
910,4,2,2,42,0.045454545454545456,0.045454545454545456,0.9545454545454546,44,1250,800,450,0.64,17,8,9,305.3244605203302,0.4363217935165609,0.19247812273563336,0.17231287027981249,129890.6738281249,-868.2400173611263,129022.43381076377,793,0,219.72727272727272,39,5,16,37.37524695142719,0.6137820512820513,45.15624999999999,1019.3749999999992,26.137820512820493,0
911,4,0,0,42,0.0,0.0,1.0,42,1150,800,350,0.6956521739130435,15,8,7,321.0508487334863,0.43304781262098335,0.20055506865322825,0.18045271842606295,129731.44531249988,-69.9218750000149,129661.52343749987,794,1,231.16666666666666,37,5,16,37.135736196318994,0.6157094594594594,45.31249999999999,1018.7499999999991,27.533783783783758,0
912,4,0,0,42,0.0,0.0,1.0,42,600,400,200,0.6666666666666666,8,4,4,321.0508487334863,0.43304781262098335,0.20055506865322825,0.18045271842606295,129731.44531249988,-69.9218750000149,129661.52343749987,795,2,232.16666666666666,37,5,16,37.135736196318994,0.6157094594594594,45.31249999999999,1018.7499999999991,27.533783783783758,0
913,4,0,1,41,0.0,0.023809523809523808,0.9761904761904762,42,1450,1200,250,0.8275862068965517,17,12,5,322.5407778149726,0.43253968253968256,0.20820014752889104,0.18193805039854277,129871.11418898121,-22.25396275777598,129848.86022622343,796,3,233.16666666666666,37,5,16,36.95630737234651,0.6171171171171171,45.175438596491226,1019.2982456140351,27.54860123281176,0
914,4,0,0,41,0.0,0.0,1.0,41,1750,1100,650,0.6285714285714286,24,11,13,329.22475493318234,0.42957317073170737,0.21380294697955549,0.18570833263706704,129871.11418898133,351.35714835335006,130222.47133733467,797,4,239.65853658536585,37,4,17,36.78598321858863,0.6171171171171171,45.17543859649123,1019.298245614036,27.548601232811784,0
915,4,1,0,42,0.023809523809523808,0.0,1.0,42,1300,1100,200,0.8461538461538461,15,11,4,337.29747255243046,0.43066444057297715,0.11850239993768952,0.18984141982208688,129784.51063368036,355.19748263886936,130139.70811631923,798,0,234.92857142857142,39,3,16,36.66811490492741,0.6127136752136753,45.26041666666666,1018.9583333333318,26.127136752136714,8
916,4,0,0,42,0.0,0.0,1.0,42,1100,600,500,0.5454545454545454,16,6,10,334.7295311992186,0.4309789972899729,0.11799655484511407,0.18890791189824405,129890.67382812499,295.6488715277776,130186.32269965277,799,1,235.92857142857142,39,3,16,36.625877103344926,0.6137820512820513,45.15625,1019.3749999999999,26.13782051282051,0
917,4,1,1,42,0.023255813953488372,0.023255813953488372,0.9767441860465116,43,1200,800,400,0.6666666666666666,16,8,8,331.6647654041435,0.43341638981173863,0.12685789451744522,0.18859442662448533,130184.79100568441,35.54163361755468,130220.33263930197,800,0,231.41860465116278,40,3,17,36.4060529111067,0.6151041666666667,44.86788617886179,1020.5284552845526,25.513211382113816,0
918,4,0,0,42,0.0,0.0,1.0,42,1400,900,500,0.6428571428571429,19,9,10,340.2470388752249,0.4319831591173055,0.13003735942804018,0.19373249764528155,130236.65229030361,462.5270589596342,130699.17934926324,801,1,237.35714285714286,40,2,19,36.134549648214524,0.615625,44.81707317073172,1020.7317073170749,25.518292682926873,0
919,4,0,0,42,0.0,0.0,1.0,42,1200,900,300,0.75,15,9,6,339.41000858414947,0.43164440572977153,0.12995029661696322,0.19351701536551802,130289.17236328153,444.2924040104347,130733.46476729197,802,2,238.35714285714286,39,3,19,36.10271485902799,0.6177884615384616,44.765625000000014,1020.9375000000022,26.17788461538467,0
920,4,1,0,43,0.023255813953488372,0.0,1.0,43,1100,600,500,0.5454545454545454,16,6,10,335.375816670553,0.43203211517165,0.13570206666974882,0.19301377092138255,130651.91436975366,163.4984962654715,130815.41286601913,803,0,233.7906976744186,40,3,18,35.838717693836976,0.6197916666666667,44.41056910569107,1022.3577235772375,25.558943089430937,0
921,4,1,0,44,0.022727272727272728,0.0,1.0,44,1300,800,500,0.6153846153846154,18,8,10,339.419488110322,0.43188424947145876,0.15120472378536887,0.19762139739215234,131099.43000637786,99.54028486397112,131198.97029124183,804,0,229.45454545454547,41,3,20,35.283166230746886,0.6227134146341464,43.9732142857143,1024.1071428571452,24.978222996515736,0
922,4,0,2,42,0.0,0.045454545454545456,0.9545454545454546,44,1350,1100,250,0.8148148148148148,16,11,5,336.9496666439016,0.43132267441860467,0.14355514295016758,0.1972253261245413,131302.70460325363,48.48050910182059,131351.18511235545,805,1,230.45454545454547,41,3,20,35.14130206820897,0.6247459349593496,43.7748015873016,1024.900793650796,24.997580332946242,0
923,4,0,1,41,0.0,0.023809523809523808,0.9761904761904762,42,1500,1100,400,0.7333333333333333,19,11,8,341.6183812236785,0.4305313588850174,0.15986117968228108,0.19981222559325532,131274.7450086807,569.173177083352,131843.91818576405,806,2,239.45238095238096,39,3,20,35.04989157687877,0.6276709401709402,43.80208333333334,1024.791666666668,26.27670940170944,0
924,4,0,0,41,0.0,0.0,1.0,41,650,600,50,0.9230769230769231,7,6,1,348.16476752420533,0.42802337398373985,0.16858699236580654,0.20349951385238335,131248.0590820314,939.1899956597367,132187.24907769114,807,3,245.8780487804878,39,2,20,34.90912286943853,0.6274038461538461,43.82812500000001,1024.6875000000011,26.274038461538492,0
925,4,1,0,42,0.023809523809523808,0.0,1.0,42,1300,800,500,0.6153846153846154,18,8,10,339.63497658964445,0.4295030003871467,0.17420123433520396,0.20074525640898405,131675.35942925338,544.3359374999894,132219.69536675338,808,0,241.0,39,3,18,34.696813999120415,0.6316773504273504,43.41145833333333,1026.3541666666658,26.31677350427348,0
926,4,0,1,41,0.0,0.023809523809523808,0.9761904761904762,42,1350,1000,350,0.7407407407407407,17,10,7,335.8969361787294,0.4293215253581107,0.17489050178432564,0.1996551951572304,131889.27001953128,460.240342881945,132349.51036241322,809,1,242.0,39,3,19,34.577396646722775,0.6338141025641026,43.203125,1027.1875000000002,26.338141025641033,0
927,4,0,1,40,0.0,0.024390243902439025,0.975609756097561,41,1150,900,250,0.782608695652174,14,9,5,342.4908938732953,0.4297256097560975,0.1714016016564659,0.20321126369815512,131821.37573964492,829.5241617356955,132650.89990138062,810,2,241.7560975609756,38,3,19,34.476435705368296,0.6348684210526316,43.26923076923077,1026.9230769230765,27.024291497975696,0
928,4,0,0,40,0.0,0.0,1.0,40,900,600,300,0.6666666666666666,12,6,6,348.8054844988564,0.4284722222222222,0.1710757780784844,0.206213802435724,131684.268904321,1186.4390432098794,132870.7079475309,811,3,248.625,38,2,19,34.45252593594948,0.6334978070175439,43.40277777777778,1026.3888888888891,27.010233918128662,0
929,4,0,0,40,0.0,0.0,1.0,40,1150,800,350,0.6956521739130435,15,8,7,353.1887348455267,0.4278979700854701,0.17257049214441866,0.20940758362741232,131793.94866544288,1309.6275978888016,133103.5762633317,812,4,249.625,38,2,20,34.22944195886658,0.6345942982456141,43.29594017094016,1026.816239316238,27.02147998200626,0
930,4,0,0,40,0.0,0.0,1.0,40,950,500,450,0.5263157894736842,14,5,9,350.5611164967122,0.4270032051282051,0.17036805988771064,0.2089031486038028,131985.99810979614,1253.8317718606168,133239.82988165677,813,5,250.625,38,2,20,34.10337388230403,0.6365131578947368,43.10897435897436,1027.5641025641023,27.041160593792167,0
931,4,0,1,39,0.0,0.025,0.975,40,950,700,250,0.7368421052631579,12,7,5,350.7460308082664,0.42606837606837605,0.1735193266832924,0.20992411694643992,132150.72320841547,1270.2683267587133,133420.9915351742,814,6,251.625,38,2,20,33.93274625935163,0.638157894736842,42.94871794871795,1028.205128205128,27.05802968960863,0
932,4,0,1,38,0.0,0.02564102564102564,0.9743589743589743,39,900,700,200,0.7777777777777778,11,7,4,353.5190329194719,0.42479194781826357,0.17158165217866683,0.21202100567676763,132228.78674207447,1549.0785626346517,133777.86530470912,815,7,255.35897435897436,37,2,20,33.78287135749821,0.6407657657657657,42.872807017543856,1028.5087719298244,27.797534376481742,0
933,4,0,0,38,0.0,0.0,1.0,38,1050,800,250,0.7619047619047619,13,8,5,355.13326617892716,0.4219861308677098,0.17640639815079728,0.21314812348205484,132256.98201610113,1793.7707996691254,134050.75281577025,816,8,262.1578947368421,37,1,20,33.71297924883629,0.6410472972972974,42.8453947368421,1028.6184210526317,27.800497866287344,0
934,4,0,1,37,0.0,0.02631578947368421,0.9736842105263158,38,1100,700,400,0.6363636363636364,15,7,8,342.35930819688076,0.42068219535324797,0.1741048589311993,0.1955366768474715,130356.43029423786,1519.8366257690745,131876.26692000692,817,9,263.1578947368421,33,5,20,35.959313372534886,0.6303661616161615,44.69975490196079,1021.2009803921574,30.9454842543078,8
935,4,0,0,37,0.0,0.0,1.0,37,1000,600,400,0.6,14,6,8,360.86343211650353,0.4211711711711712,0.13648537972862318,0.20119372174166697,129413.28124999997,1955.9672061226443,131369.24845612262,818,10,256.2162162162162,34,3,20,36.44553644553645,0.6185661764705883,45.625,1017.4999999999998,29.926470588235286,8
936,4,0,0,37,0.0,0.0,1.0,37,1250,800,450,0.64,17,8,9,363.5082077544316,0.4206393893893894,0.13328024622307355,0.20360744603298309,129595.0414540816,2021.7722505668887,131616.8137046485,819,11,257.2162162162162,34,3,17,36.19319731867961,0.6204044117647058,45.44642857142857,1018.2142857142853,29.947478991596626,0
937,4,1,0,38,0.02631578947368421,0.0,1.0,38,1000,600,400,0.6,14,6,8,355.862642201674,0.4227270033191086,0.11610930758660398,0.19544591325929145,128819.24518014844,1598.380053378104,130417.62523352655,820,0,251.42105263157896,35,3,17,37.17803462166988,0.6104166666666666,46.20949074074075,1015.1620370370381,29.004629629629658,8
938,4,0,0,38,0.0,0.0,1.0,38,1100,700,400,0.6363636363636364,15,7,8,361.22438839460136,0.4228603603603604,-0.025683296925969046,0.19450710476346794,128030.53634293069,1698.5828500273537,129729.11919295804,821,1,252.42105263157896,36,2,17,37.84818812358592,0.6004050925925926,46.98761261261261,1012.0495495495489,28.11248748748747,8
939,4,0,0,38,0.0,0.0,1.0,38,900,500,400,0.5555555555555556,13,5,8,360.0374895808023,0.42228247984826933,-0.01875402301616491,0.19456256926142285,128173.82979948971,1629.5275085951266,129803.35730808484,822,2,253.42105263157896,35,3,19,37.73157408465728,0.6038690476190476,46.8460648148148,1012.6157407407394,28.931878306878268,0
940,4,0,1,37,0.0,0.02631578947368421,0.9736842105263158,38,1000,500,500,0.5,15,5,10,363.877637352369,0.4222232100521574,-0.008912200547055882,0.19750457005703587,128349.69142500425,1740.716494127228,130090.40791913148,823,3,254.42105263157896,35,3,19,37.4544308014468,0.6056547619047619,46.6724537037037,1013.3101851851849,28.95171957671957,0
941,4,0,0,37,0.0,0.0,1.0,37,1000,600,400,0.6,14,6,8,371.4765251368834,0.42004504504504503,-0.001873569021965782,0.2015064821822828,128325.39859693892,2133.974631519287,130459.37322845821,824,4,261.05405405405406,34,3,19,37.286795519523736,0.6075367647058824,46.69642857142858,1013.2142857142869,29.800420168067262,0
942,4,1,0,38,0.02631578947368421,0.0,1.0,38,950,700,250,0.7368421052631579,12,7,5,363.07443215597334,0.42180832147937414,0.001891278504268623,0.1986710656853471,128672.41753472218,1743.5329861111081,130415.95052083328,825,0,255.1578947368421,35,3,20,37.14493497604381,0.6089285714285715,46.354166666666664,1014.5833333333329,28.988095238095227,0
943,4,1,2,37,0.02564102564102564,0.05128205128205128,0.9487179487179487,39,950,700,250,0.7368421052631579,12,7,5,359.0664896678201,0.42437022042285205,0.014268058810995132,0.19868639296456642,129115.53603857243,1472.2124573898295,130587.74849596227,826,0,249.5897435897436,36,3,21,36.79455216989843,0.611400462962963,45.917792792792795,1016.3288288288295,28.231356356356375,0
944,4,0,0,37,0.0,0.0,1.0,37,650,300,350,0.46153846153846156,10,3,7,376.2188470464686,0.42001376376376376,0.02651385562777997,0.2073578296511931,128959.43877551016,2303.394274376414,131262.83304988657,827,1,263.2162162162162,34,3,21,36.518157133927176,0.6139705882352942,46.07142857142857,1015.7142857142853,29.873949579831923,0
945,4,0,0,37,0.0,0.0,1.0,37,1250,1000,250,0.8,15,10,5,373.4519503482245,0.42004504504504503,0.023778464500114005,0.20646281400080607,129080.38548752842,2241.064342403636,131321.44982993204,828,2,264.2162162162162,34,3,21,36.46492307091533,0.6151960784313726,45.952380952380956,1016.1904761904768,29.887955182072847,0
946,4,0,1,36,0.0,0.02702702702702703,0.972972972972973,37,800,500,300,0.625,11,5,6,371.08173618586903,0.4197947947947948,0.005079404505021534,0.19424332612735945,126887.8617567943,2059.248988143338,128947.11074493764,829,3,265.2162162162162,35,2,15,38.77237698640628,0.5907738095238095,48.119212962962955,1007.5231481481472,28.786375661375637,8
947,4,3,1,38,0.07692307692307693,0.02564102564102564,0.9743589743589743,39,1000,500,500,0.5,15,5,10,357.18634864319324,0.42720985155195684,0.04394015240002269,0.19102425374073306,127756.25673284075,1326.5581717451394,129082.81490458589,830,0,251.4102564102564,37,2,14,38.23120028922632,0.5957207207207207,47.258771929824555,1010.9649122807007,27.323376007586504,0
948,4,1,0,39,0.02564102564102564,0.0,1.0,39,900,400,500,0.4444444444444444,14,4,10,357.1201564003256,0.42619770580296895,0.052227188827362436,0.1915160652695697,127867.1321945212,1332.786049553689,129199.91824407488,831,0,252.3846153846154,37,2,15,38.11930832610582,0.5968468468468469,47.149122807017534,1011.4035087719283,27.33522996680887,0
949,4,1,1,39,0.025,0.025,0.975,40,1100,800,300,0.7272727272727273,14,8,6,348.6490186313047,0.4310096153846154,0.05652680021656753,0.1884010349362256,128172.28768707668,937.7290368190088,129110.0167238957,832,0,247.05,37,3,16,38.021453708716834,0.5999436936936937,46.84758771929824,1012.6096491228061,27.367828354670436,0
950,4,0,0,39,0.0,0.0,1.0,39,1000,800,200,0.8,12,8,4,356.4835983674575,0.4282782276203329,0.05592487073968555,0.1925011431184271,128144.53124999999,1336.2847222222213,129480.8159722222,833,1,254.2051282051282,36,3,16,37.85150891632374,0.6015625,46.875,1012.4999999999999,28.124999999999996,0
951,4,1,1,39,0.025,0.025,0.975,40,1100,700,400,0.6363636363636364,15,7,8,347.4103228520766,0.4313167735042735,0.05244281648571758,0.188875744005596,128415.1066207356,922.5467300387168,129337.65335077432,834,0,248.825,38,2,12,37.80480306384176,0.6006030701754386,46.60790598290598,1013.5683760683759,26.672852001799367,0
952,4,0,2,37,0.0,0.05128205128205128,0.9487179487179487,39,950,600,350,0.631578947368421,13,6,7,358.56855929179505,0.42841880341880345,0.027367803733750584,0.18939158131721018,127253.65713346507,1328.2319517496087,128581.88908521467,835,3,256.20512820512823,38,1,16,38.711748199915306,0.5888157894736843,47.75641025641027,1008.9743589743609,26.55195681511476,8
953,4,2,0,39,0.05128205128205128,0.0,1.0,39,950,700,250,0.7368421052631579,12,7,5,356.2638236217758,0.4279689608636977,0.06472881457021828,0.18994043088020088,127631.22420374058,1294.0775896705777,128925.30179341116,836,0,256.97435897435895,38,1,17,38.38263022485374,0.5926535087719298,47.38247863247865,1010.4700854700883,26.591318038686534,0
954,4,2,1,40,0.04878048780487805,0.024390243902439025,0.975609756097561,41,1400,800,600,0.5714285714285714,20,8,12,348.87122946909597,0.4334857723577236,0.09533767958660389,0.18878286740515782,128227.80957842816,750.0891307001515,128977.89870912832,837,0,245.390243902439,37,4,19,37.95909115513696,0.6005067567567568,46.79276315789475,1012.8289473684225,27.37375533428169,0
955,4,1,3,38,0.024390243902439025,0.07317073170731707,0.926829268292683,41,1900,1600,300,0.8421052631578947,22,16,6,346.56703104608414,0.4351626016260162,0.09227571946999724,0.1889771169289025,128533.39489073561,709.087411511234,129242.48230224685,838,0,245.5609756097561,37,4,15,37.705449826989614,0.6036036036036037,46.49122807017544,1014.0350877192983,27.406353722143198,0
956,4,0,0,38,0.0,0.0,1.0,38,850,400,450,0.47058823529411764,13,4,9,368.5965375990528,0.4258534850640114,0.09034698843371891,0.1986395675320493,128063.4142833663,1840.7462195923863,129904.1605029587,839,2,265.7105263157895,38,0,18,37.62798184504962,0.5970394736842105,46.95512820512821,1012.179487179488,26.63630229419705,0
957,4,0,0,38,0.0,0.0,1.0,38,1350,1000,350,0.7407407407407407,17,10,7,367.7121541550693,0.42549786628733993,0.08909125893678538,0.19929315698571629,128291.05748724697,1834.9132678445585,130125.97075509153,840,3,266.7105263157895,35,3,19,37.417290262386246,0.6050595238095238,46.73032407407407,1013.0787037037028,28.945105820105795,0
958,4,0,0,38,0.0,0.0,1.0,38,1000,700,300,0.7,13,7,6,367.35653014856234,0.4251570649596965,0.08344353345675737,0.19953931625191143,128379.01341735256,1832.1737825788764,130211.18719993143,841,4,267.7105263157895,35,3,15,37.33630272574996,0.605952380952381,46.64351851851852,1013.4259259259261,28.95502645502646,0
959,4,0,1,37,0.0,0.02631578947368421,0.9736842105263158,38,750,300,450,0.4,12,3,9,365.8089515193051,0.42494962067330483,0.08451400136826881,0.1989514424546987,128429.74044568211,1796.1497392662875,130225.8901849484,842,5,268.7105263157895,36,2,16,37.323630707699145,0.6044560185185186,46.593468468468465,1013.6261261261257,28.156281281281267,0
960,4,0,1,36,0.0,0.02702702702702703,0.972972972972973,37,1300,1000,300,0.7692307692307693,16,10,6,367.78606143842654,0.42558183183183185,0.07060826230155293,0.20095243406772906,128613.7099194104,2060.465963648866,130674.17588305926,843,6,268.18918918918916,35,2,16,37.085425224402876,0.6083333333333334,46.41203703703705,1014.3518518518539,28.98148148148154,0
961,4,0,0,36,0.0,0.0,1.0,36,900,600,300,0.6666666666666666,12,6,6,376.2309840290086,0.4258267195767196,0.07426950624326545,0.205718314099455,128643.06205257647,2479.9011649091435,131122.9632174856,844,7,255.02777777777777,35,1,18,36.84124833618559,0.6086309523809523,46.38310185185186,1014.4675925925939,28.984788359788396,0
962,4,2,2,36,0.05263157894736842,0.05263157894736842,0.9473684210526316,38,850,400,450,0.47058823529411764,13,4,9,364.5706625406275,0.4309358700806069,0.11055217594758981,0.2034171033549142,129443.56575963722,1841.8922512098984,131285.45801084713,845,0,242.55263157894737,34,4,17,36.320386835127124,0.6188725490196079,45.595238095238095,1017.6190476190479,29.92997198879553,0
963,4,2,0,38,0.05263157894736842,0.0,1.0,38,1000,800,200,0.8,12,8,4,353.5181046707602,0.4324027975343765,0.12010612361967588,0.199601760637183,129908.3719135802,1584.9922839506114,131493.3641975308,846,0,241.76315789473685,35,3,19,36.1290871934605,0.6214285714285714,45.138888888888886,1019.444444444444,29.126984126984116,0
964,4,0,0,38,0.0,0.0,1.0,38,1300,900,400,0.6923076923076923,17,9,8,358.06565167615395,0.4315582029397819,0.12892139005177738,0.20293457158983566,130055.90284475738,1713.7103212877214,131769.6131660451,847,1,242.76315789473685,35,3,20,35.863331631302245,0.6229166666666667,44.99421296296296,1020.0231481481482,29.14351851851852,0
965,4,0,0,38,0.0,0.0,1.0,38,1250,900,350,0.72,16,9,7,358.27802263340254,0.4316322901849217,0.12939342911396956,0.20320865453608813,130085.41907793212,1721.3493441358048,131806.76842206792,848,2,243.76315789473685,35,3,20,35.827944179714095,0.6232142857142857,44.96527777777778,1020.138888888889,29.146825396825403,0
966,4,2,1,39,0.05,0.025,0.975,40,1050,600,450,0.5714285714285714,15,6,9,344.3496815440187,0.43409455128205127,0.14453024453024454,0.1981923722664463,130654.64854570634,998.1773237919308,131652.82586949828,849,0,232.525,37,3,18,35.60658873158873,0.625,44.4078947368421,1022.3684210526313,27.631578947368414,0
967,4,0,1,38,0.0,0.02564102564102564,0.9743589743589743,39,1200,900,300,0.75,15,9,6,352.3658585277017,0.43328272604588397,0.14014156512504172,0.202710853213845,130636.47050766974,1406.3664170927573,132042.8369247625,850,1,239.48717948717947,36,3,18,35.420109054857896,0.6267361111111112,44.42567567567567,1022.2972972972966,28.397147147147127,0
968,4,0,0,38,0.0,0.0,1.0,38,1300,900,400,0.6923076923076923,17,9,8,353.55023189717554,0.4319582740635372,0.14176570458404036,0.2037584017489592,130706.03358892743,1642.2296971450555,132348.26328607247,851,2,243.60526315789474,35,3,19,35.31939728353139,0.6294642857142857,44.357638888888886,1022.5694444444441,29.21626984126983,0
969,4,1,0,39,0.02564102564102564,0.0,1.0,39,1000,700,300,0.7,13,7,6,345.19097114605825,0.4336763382816014,0.14114833210642286,0.2005195602996046,131010.89000740601,1244.755270473173,132255.64527787917,852,0,238.33333333333334,36,3,20,35.22485608477249,0.6304976851851851,44.05968468468468,1023.7612612612609,28.4378128128128,0
970,4,1,3,37,0.025,0.075,0.925,40,1500,900,600,0.6,21,9,12,341.62465934957885,0.43456196581196577,0.1504998396236501,0.20083063726565736,131468.650510253,982.5865891427943,132451.2370993958,853,0,233.35,37,3,22,34.85412434512989,0.6331644144144144,43.61293859649122,1025.548245614034,27.717520151730646,0
971,4,0,0,37,0.0,0.0,1.0,37,800,500,300,0.625,11,5,6,350.1746087364627,0.43152527527527523,0.1519373693286734,0.20494356644820735,131298.46810967507,1795.4779396004762,133093.94604927555,854,1,247.2972972972973,35,2,22,34.80672407302842,0.6354166666666667,43.77893518518518,1024.8842592592591,29.282407407407405,0
972,4,1,1,37,0.02631578947368421,0.02631578947368421,0.9736842105263158,38,900,900,0,1.0,9,9,0,344.52884479268585,0.4317360123281176,0.15727951752941816,0.20317167022046345,131587.96623904316,1467.1699993912978,133055.13623843447,855,0,241.76315789473685,36,2,18,34.65934035780925,0.6362847222222222,43.49662162162163,1026.013513513514,28.500375375375388,0
973,4,0,0,37,0.0,0.0,1.0,37,1100,900,200,0.8181818181818182,13,9,4,352.55851380869177,0.43099349349349353,0.1642789386836332,0.2073006629634253,131476.45968632124,1870.629045567564,133347.0887318888,856,3,249.2972972972973,35,2,22,34.565911484783506,0.637202380952381,43.605324074074076,1025.5787037037044,29.302248677248695,0
974,4,0,0,37,0.0,0.0,1.0,37,850,400,450,0.47058823529411764,13,4,9,354.7061466413745,0.43108733733733734,0.17021873503877405,0.20888774602541535,131535.81700370795,1931.312558942043,133467.12956265,857,4,250.2972972972973,35,2,22,34.45092425439092,0.6377976190476191,43.5474537037037,1025.8101851851848,29.308862433862423,0
975,4,0,0,37,0.0,0.0,1.0,37,750,400,350,0.5333333333333333,11,4,7,354.7061466413745,0.43108733733733734,0.17021873503877405,0.20888774602541535,131535.81700370795,1931.312558942043,133467.12956265,858,5,251.2972972972973,35,2,22,34.45092425439092,0.6377976190476191,43.5474537037037,1025.8101851851848,29.308862433862423,0
976,4,0,0,37,0.0,0.0,1.0,37,1400,900,500,0.6428571428571429,19,9,10,351.3323970328921,0.43108733733733734,0.1648685221080355,0.20770771312584577,131684.26890432098,1852.9899691358055,133537.2588734568,859,6,252.2972972972973,35,2,19,34.38768606224628,0.6392857142857142,43.40277777777778,1026.388888888889,29.325396825396826,0
977,4,0,0,37,0.0,0.0,1.0,37,1500,1200,300,0.8,18,12,6,349.2258340613366,0.43096221221221226,0.15823461176621012,0.20791936478621648,131951.69331114978,1816.1880304784024,133767.88134162818,860,7,253.2972972972973,35,2,19,34.17222879351132,0.6419642857142858,43.142361111111114,1027.430555555556,29.355158730158745,0
978,4,0,0,37,0.0,0.0,1.0,37,1550,1300,250,0.8387096774193549,18,13,5,351.9722425127833,0.4299612112112112,0.16581446311176107,0.21004795117698347,132040.89506172825,1894.9459876543099,133935.84104938255,861,8,254.2972972972973,35,2,19,34.01182432432432,0.6428571428571428,43.05555555555555,1027.7777777777767,29.365079365079335,0
979,4,0,1,36,0.0,0.02702702702702703,0.972972972972973,37,1250,900,350,0.72,16,9,7,351.9484480666886,0.42986736736736736,0.16343960435790295,0.2110265795897837,132219.38898533946,1906.8817515432083,134126.27073688267,862,9,255.2972972972973,35,2,20,33.83271438217421,0.6446428571428571,42.88194444444444,1028.472222222222,29.384920634920626,0
980,4,0,0,36,0.0,0.0,1.0,36,1000,800,200,0.8,12,8,4,356.0215051471581,0.4273974867724868,0.16535126651486554,0.21309478447373542,132153.0771683672,2209.8674886621134,134362.9446570293,863,10,263.1111111111111,34,2,20,33.79476863108332,0.6461397058823529,42.94642857142856,1028.2142857142844,30.241596638655423,0
981,4,0,0,36,0.0,0.0,1.0,36,1000,600,400,0.6,14,6,8,356.1765222254295,0.4275793650793651,0.16336522264655584,0.21387917502084328,132275.51197562355,2222.6863662131464,134498.1983418367,864,11,264.1111111111111,34,2,21,33.66749604598234,0.6473651960784313,42.82738095238095,1028.690476190476,30.25560224089635,0
982,4,0,0,36,0.0,0.0,1.0,36,900,600,300,0.6666666666666666,12,6,6,353.55439361405723,0.4275793650793651,0.16655420602789084,0.2129949639577366,132398.00347222202,2161.9791666666424,134559.98263888864,865,12,265.1111111111111,34,2,21,33.61167341430501,0.6485906862745099,42.70833333333332,1029.166666666665,30.269607843137205,0
983,4,0,0,36,0.0,0.0,1.0,36,950,400,550,0.42105263157894735,15,4,11,354.0887715880647,0.4265046296296296,0.17201546206400575,0.21453613807982716,132612.4999999998,2191.3194444444157,134803.8194444442,866,13,266.1111111111111,34,2,21,33.38221413160732,0.6507352941176471,42.499999999999986,1029.9999999999984,30.294117647058776,0
984,4,0,0,36,0.0,0.0,1.0,36,1000,600,400,0.6,14,6,8,356.56270219775394,0.42595899470899473,0.18037105489456184,0.2169194176335877,132765.81809807243,2267.8677721088256,135033.68587018125,867,14,267.1111111111111,34,2,19,33.164394902006066,0.6522671568627452,42.35119047619047,1030.5952380952372,30.311624649859915,0
985,4,0,1,35,0.0,0.027777777777777776,0.9722222222222222,36,1350,1100,250,0.8148148148148148,16,11,5,355.6212669014715,0.42595899470899473,0.18309728155588934,0.21705678595022157,132888.53635204077,2251.597930838996,135140.13428287976,868,15,268.1111111111111,34,2,20,33.06536966478081,0.6534926470588236,42.232142857142854,1031.0714285714282,30.32563025210083,0
986,4,0,1,34,0.0,0.02857142857142857,0.9714285714285714,35,1200,900,300,0.75,15,9,6,363.2784256196547,0.42471988795518206,0.1868858025739415,0.2218160140176906,132902.9775206652,2656.1568867743335,135559.13440743956,869,16,272.6857142857143,33,2,20,32.85347832976787,0.6559343434343434,42.21813725490197,1031.127450980393,31.24628639334524,0
987,4,0,0,34,0.0,0.0,1.0,34,900,700,200,0.7777777777777778,11,7,4,372.8721066255431,0.42388963161021986,0.18633455341960392,0.22717372227544316,132820.66243240514,3105.0240409142243,135925.68647331937,870,17,279.47058823529414,32,2,20,32.68899028254123,0.6575520833333333,42.297979797979814,1030.8080808080829,32.21275252525259,0
988,4,0,1,33,0.0,0.029411764705882353,0.9705882352941176,34,1150,900,250,0.782608695652174,14,9,5,376.87284322866043,0.4222556446821153,0.19045818841675555,0.23061230384531275,132983.402921258,3223.566632231406,136206.9695534894,871,18,280.47058823529414,32,2,20,32.42211408985189,0.6591796875,42.140151515151516,1031.4393939393938,32.232481060606055,0
989,4,0,1,32,0.0,0.030303030303030304,0.9696969696969697,33,1500,1100,400,0.7333333333333333,19,11,8,378.9024506155269,0.4205334595959596,0.1682651859330302,0.23238568256017306,133068.8815646702,3484.025065104176,136552.9066297744,872,19,265.3333333333333,31,2,20,32.28377923607605,0.6626344086021505,42.05729166666667,1031.770833333334,33.2829301075269,0
990,4,0,0,32,0.0,0.0,1.0,32,1200,1000,200,0.8333333333333334,14,10,4,388.54677891928833,0.41887180779569894,0.16073346569457114,0.23932861338244205,133229.27731890965,3953.161312001381,137182.43863091103,873,20,262.59375,30,2,21,31.87356247016448,0.6670138888888889,41.901881720430104,1032.392473118279,34.41308243727597,0
991,4,0,0,32,0.0,0.0,1.0,32,900,400,500,0.4444444444444444,14,4,10,389.7770447757862,0.4182627688172043,0.1612529285435378,0.24053470160741877,133298.66756633704,3991.352143311353,137290.0197096484,874,21,263.59375,30,2,21,31.7719857694477,0.6677083333333333,41.83467741935483,1032.6612903225798,34.42204301075266,0
992,4,1,0,33,0.030303030303030304,0.0,1.0,33,800,500,300,0.625,11,5,6,379.3463571242759,0.4199810606060606,0.15788107778032212,0.23605094636103055,133606.8047417534,3536.6509331597117,137143.45567491313,875,0,256.57575757575756,31,2,22,31.731738035264474,0.668010752688172,41.53645833333333,1033.854166666666,33.35013440860213,0
993,4,0,0,33,0.0,0.0,1.0,33,1200,900,300,0.75,15,9,6,377.4747803990697,0.4194286616161616,0.1528920418788262,0.23595886154764836,133775.12825859923,3499.347432454437,137274.47569105367,876,1,257.57575757575756,31,2,19,31.611207258233684,0.6696908602150538,41.37369791666667,1034.505208333334,33.37113575268819,0
994,4,0,0,33,0.0,0.0,1.0,33,950,600,350,0.631578947368421,13,6,7,423.3441649514268,0.419073547979798,0.1907400079145234,0.23826073604281886,129782.79867976079,4401.379727793525,134184.1784075543,877,2,258.57575757575756,30,3,17,34.477916281932906,0.6322916666666667,45.26209677419356,1018.9516129032269,33.9650537634409,8
995,4,1,0,34,0.029411764705882353,0.0,1.0,34,450,200,250,0.4444444444444444,7,2,5,412.49944239256286,0.4213458110516934,0.1834658796494466,0.23363037832689437,130030.07888793967,3927.467007107232,133957.5458950469,878,0,251.94117647058823,31,3,18,34.50160113196308,0.6320564516129032,45.019531250000014,1019.9218750000017,32.900705645161345,0
996,4,0,0,34,0.0,0.0,1.0,34,1050,600,450,0.5714285714285714,15,6,9,410.53698835312235,0.421438651218063,0.17804702279073936,0.23311361164746877,130129.69970703138,3884.61100260418,134014.31070963555,879,1,252.94117647058823,31,3,18,34.44997447677386,0.6330645161290323,44.92187500000001,1020.312500000001,32.91330645161294,0
997,4,1,1,34,0.02857142857142857,0.02857142857142857,0.9714285714285714,35,850,600,250,0.7058823529411765,11,6,5,399.74396247356094,0.42412464985994397,0.17067306843656782,0.22927908492548055,130520.50053884815,3434.956413886347,133955.4569527345,880,0,246.68571428571428,32,3,15,34.3272478273405,0.6344401041666667,44.53914141414142,1021.843434343435,31.932607323232343,0
998,4,0,0,34,0.0,0.0,1.0,34,750,500,250,0.6666666666666666,10,5,5,411.6316953737166,0.4212344028520499,0.18076222460438252,0.23594404043809733,130495.30241224494,3943.20051405164,134438.50292629658,881,3,254.94117647058823,31,3,16,34.04923856250796,0.636760752688172,44.56380208333333,1021.7447916666661,32.95950940860213,0
999,4,0,1,33,0.0,0.029411764705882353,0.9705882352941176,34,700,400,300,0.5714285714285714,10,4,6,411.8115141216307,0.42155005941770646,0.18075363665659916,0.23645271209514854,130561.83073255757,3953.3730400933255,134515.2037726509,882,4,255.94117647058823,31,3,16,33.976860109568086,0.6374327956989247,44.49869791666667,1022.0052083333339,32.96790994623658,0
1000,4,0,0,33,0.0,0.0,1.0,33,800,700,100,0.875,9,7,2,420.00272012764407,0.4194286616161616,0.19639583632219115,0.2412160637349399,130571.48947855236,4368.076150422006,134939.56562897438,883,5,263.6060606060606,30,3,16,33.75772619673855,0.6402777777777777,44.48924731182795,1022.0430107526877,34.068100358422925,0
1001,4,0,0,33,0.0,0.0,1.0,33,800,500,300,0.625,11,5,6,418.6282208387044,0.4188368055555556,0.194415891760094,0.24085372524199564,130640.1841975949,4337.933576135941,134978.11777373086,884,6,264.6060606060606,30,3,16,33.72282846875273,0.6409722222222223,44.422043010752674,1022.3118279569877,34.07706093189959,0
1002,4,1,1,33,0.029411764705882353,0.029411764705882353,0.9705882352941176,34,1100,700,400,0.6363636363636364,15,7,8,403.91808279679003,0.41854203802733214,0.1835663681726032,0.2347382028847862,131028.00369262684,3784.9160088433014,134812.91970147015,885,0,257.79411764705884,31,3,17,33.7044014159142,0.6421370967741935,44.04296874999999,1023.8281249999991,33.02671370967739,0
1003,4,0,1,32,0.0,0.030303030303030304,0.9696969696969697,33,1000,700,300,0.7,13,7,6,402.3417583998998,0.415206755050505,0.1618756275833082,0.21906523992318988,128474.33302137563,3738.117811414898,132212.45083279052,886,1,266.3939393939394,31,2,18,36.352106344721285,0.616263440860215,46.54947916666665,1013.8020833333314,32.703293010752624,8
1004,4,0,0,32,0.0,0.0,1.0,32,600,300,300,0.5,9,3,6,411.5708810225798,0.41368447580645157,0.176779439066437,0.22376755687031546,128416.85319473351,4170.527481500758,132587.38067623426,887,12,275.6875,30,2,18,36.17723113645406,0.6184027777777779,46.60618279569893,1013.5752688172046,33.78584229390682,0
1005,4,0,0,32,0.0,0.0,1.0,32,1050,500,550,0.47619047619047616,16,5,11,407.4964070423307,0.41315944220430106,0.1702878194426607,0.2220555998347535,128507.33651055224,4073.2555813259455,132580.59209187818,888,13,276.6875,31,1,18,36.18758293737426,0.6165994623655914,46.51692708333333,1013.9322916666661,32.707493279569874,0
1006,4,1,0,33,0.030303030303030304,0.0,1.0,33,800,700,100,0.875,9,7,2,401.2170994098937,0.4157986111111111,0.16999389568402257,0.22069684770549686,128880.6706586062,3741.825770329552,132622.49642893576,889,0,269.27272727272725,32,1,19,35.96405330349002,0.6178385416666667,46.148989898989896,1015.40404040404,31.73137626262625,0
1007,4,0,0,33,0.0,0.0,1.0,33,850,700,150,0.8235294117647058,10,7,3,404.61974180833244,0.41599589646464646,0.17334101929402235,0.22274856833432,128912.72454660227,3832.126664370968,132744.85121097323,890,1,270.27272727272725,32,1,19,35.84483401715778,0.6181640625,46.117424242424235,1015.5303030303021,31.73532196969694,0
1008,4,0,0,33,0.0,0.0,1.0,33,950,800,150,0.8421052631578947,11,8,3,404.32155823307454,0.4156407828282828,0.16984010396067584,0.2229449579153586,128976.8442792826,3829.623730996819,132806.4680102794,891,2,271.27272727272725,32,1,19,35.78672053035012,0.6188151041666667,46.05429292929292,1015.7828282828273,31.743213383838352,0
1009,4,1,0,34,0.029411764705882353,0.0,1.0,34,950,800,150,0.8421052631578947,11,8,3,391.02134654276756,0.4207144979203803,0.15788223953275704,0.2173533928304372,129294.84941188479,3311.409223615904,132606.25863550068,892,0,264.2647058823529,33,1,20,35.79936839779893,0.6196338383838385,45.741421568627445,1017.0343137254897,30.819221628045142,0
1010,4,0,2,32,0.0,0.058823529411764705,0.9411764705882353,34,750,500,250,0.6666666666666666,10,5,5,420.7203687570135,0.4215686274509804,0.1485922911008719,0.21817394233267995,126505.73284614093,3848.3158520761262,130354.04869821706,893,1,265.2647058823529,33,1,15,37.9176056766963,0.5912247474747474,48.49877450980392,1006.0049019607845,30.484997029114684,8
1011,4,2,1,33,0.058823529411764705,0.029411764705882353,0.9705882352941176,34,950,700,250,0.7368421052631579,12,7,5,418.5541523082754,0.42498514557338085,0.17841230109064954,0.21969418651790423,126999.35308835522,3831.2213151191545,130830.57440347437,894,0,264.0,33,1,17,37.461372847011134,0.5962752525252526,48.008578431372534,1007.965686274508,30.54441473559115,0
1012,4,1,0,34,0.029411764705882353,0.0,1.0,34,550,400,150,0.7272727272727273,7,4,3,420.08431860874316,0.4266377005347594,0.18870405304979165,0.22167526351199818,127215.61418685113,3888.256920415217,131103.87110726634,895,0,264.8235294117647,33,1,18,37.19934402332362,0.5984848484848485,47.79411764705882,1008.8235294117641,30.57040998217467,0
1013,4,0,0,34,0.0,0.0,1.0,34,950,800,150,0.8421052631578947,11,8,3,396.5683555058787,0.4271390374331551,0.1841355171242487,0.2054007490220956,126456.23692735436,3233.0874933450777,129689.32442069944,896,1,265.8235294117647,32,2,16,38.576188383965196,0.5930989583333333,48.5479797979798,1005.8080808080808,31.431502525252526,8
1014,4,2,1,35,0.05555555555555555,0.027777777777777776,0.9722222222222222,36,950,700,250,0.7368421052631579,12,7,5,379.75548118297957,0.4320767195767196,0.18709825528007373,0.19978440531800212,127092.01388888882,2452.7777777777733,129544.79166666658,897,0,252.0,34,2,18,38.34366391184573,0.5949754901960784,47.916666666666664,1008.3333333333327,29.65686274509802,0
1015,4,1,2,34,0.027777777777777776,0.05555555555555555,0.9444444444444444,36,1100,800,300,0.7272727272727273,14,8,6,361.331403707229,0.4333664021164021,0.15629685157421314,0.18462608141104186,125898.59992551857,1898.2235671724818,127796.82349269105,898,0,252.91666666666666,35,1,19,40.03731307423211,0.580654761904762,49.10300925925925,1003.5879629629619,28.67394179894177,8
1016,4,1,0,35,0.02857142857142857,0.0,1.0,35,450,300,150,0.6666666666666666,6,3,3,371.9881679010168,0.42997198879551823,0.17745609871855783,0.18977701447153555,125834.72222222213,2361.80555555555,128196.52777777768,899,0,261.0571428571429,34,1,20,39.83596345514952,0.5821078431372548,49.166666666666664,1003.3333333333326,29.509803921568604,0
1017,4,2,0,37,0.05405405405405406,0.0,1.0,37,700,700,0,1.0,7,7,0,354.61082483408927,0.4375,0.18544813367043278,0.18377594982904394,126480.04979263108,1570.4125675154205,128050.4623601465,900,0,247.8918918918919,35,2,19,39.60670521228857,0.5866071428571429,48.52430555555555,1005.9027777777769,28.74007936507934,0
1018,4,2,1,38,0.05128205128205128,0.02564102564102564,0.9743589743589743,39,1050,700,350,0.6666666666666666,14,7,7,340.795664637078,0.4425607287449393,0.19673956791860703,0.17968647582264857,127182.05959467117,873.0496061271665,128055.10920079834,901,0,236.12820512820514,34,5,21,39.23344742122034,0.5958946078431373,47.82738095238095,1008.6904761904759,29.667366946778703,0
1019,4,2,1,39,0.05,0.025,0.975,40,1400,1100,300,0.7857142857142857,17,11,6,350.7429400511992,0.4422275641025641,0.1998689384010479,0.1796086330597752,125988.78981994465,853.8406146161162,126842.63043456076,902,0,230.95,37,3,20,40.209971603320206,0.5777027027027026,49.01315789473684,1003.947368421053,27.13371266002846,8
1020,4,3,4,38,0.07142857142857142,0.09523809523809523,0.9047619047619048,42,1350,1100,250,0.8148148148148148,16,11,5,338.5808576629895,0.44802555168408825,0.20916008713566114,0.1760693351313136,126619.79709201398,174.20789930556595,126794.00499131954,903,0,220.83333333333334,39,3,13,39.866228524115094,0.5806623931623931,48.38541666666667,1006.4583333333342,25.806623931623953,0
1021,4,4,3,39,0.09523809523809523,0.07142857142857142,0.9285714285714286,42,950,800,150,0.8421052631578947,11,8,3,349.35959016353763,0.44575106465350367,0.24305681611907803,0.18452751507295556,127253.65713346469,492.33600684170057,127745.99314030638,904,0,221.52380952380952,38,4,17,38.94403854299026,0.5888157894736843,47.75641025641025,1008.9743589743579,26.551956815114682,0
1022,4,0,0,39,0.0,0.0,1.0,39,1050,900,150,0.8571428571428571,12,9,3,371.36698712905206,0.4387932973459289,0.25593430759482394,0.1938782817218397,126779.9403077064,1616.3768920948035,128396.31719980121,905,1,239.48717948717947,36,3,18,38.87630921763764,0.5876736111111112,48.226351351351354,1007.094594594595,27.97484984984986,0
1023,4,3,2,40,0.07142857142857142,0.047619047619047616,0.9523809523809523,42,1050,700,350,0.6666666666666666,14,7,7,350.57816975091157,0.44635598141695704,0.1318321159968856,0.18230819570146967,126619.79709201382,756.7213671653028,127376.51845917912,906,0,223.3095238095238,39,3,18,39.56435865590286,0.5806623931623931,48.385416666666664,1006.4583333333327,25.806623931623914,8
1024,4,2,1,41,0.047619047619047616,0.023809523809523808,0.9761904761904762,42,900,700,200,0.7777777777777778,11,7,4,350.74965053593746,0.444008904374758,0.19001632136610302,0.18491257326959387,127177.19144397811,524.9867160234942,127702.17816000161,907,0,224.04761904761904,36,6,20,38.98743068735811,0.591724537037037,47.832207207207226,1008.671171171174,28.018643643643724,0
1025,4,3,0,44,0.06818181818181818,0.0,1.0,44,1350,900,450,0.6666666666666666,18,9,9,335.20092861703057,0.4470027307963354,0.20087395974313949,0.18027756927495167,127982.32299884953,-220.04129684417018,127762.28170200536,908,0,214.72727272727272,38,6,20,38.555854714391316,0.596217105263158,47.035256410256416,1011.858974358975,26.627867746288818,0
1026,4,0,2,42,0.0,0.045454545454545456,0.9545454545454546,44,1250,900,350,0.72,16,9,7,333.89180003916215,0.4470027307963354,0.19640297948863017,0.1798392880795036,128041.65556423123,-249.58822873286852,127792.06733549836,909,1,215.72727272727272,40,4,20,38.52838303711886,0.5934895833333333,46.97662601626018,1012.0934959349617,25.302337398374043,0
1027,4,1,0,43,0.023255813953488372,0.0,1.0,43,1050,700,350,0.6666666666666666,14,7,7,344.96523242411615,0.4432447397563677,0.22538022764530252,0.18667974130099296,128230.06071950334,247.1064741385759,128477.16719364192,910,0,221.58139534883722,36,7,21,38.05569453709879,0.6024305555555556,46.79054054054054,1012.8378378378383,28.134384384384397,0
1028,4,1,0,44,0.022727272727272728,0.0,1.0,44,1200,800,400,0.6666666666666666,16,8,8,339.20959315930844,0.44320384073291047,0.23973305954825475,0.18561244030177865,128672.41753472206,-70.61631944446248,128601.80121527759,911,0,217.52272727272728,37,7,21,37.75025667351129,0.6050112612612613,46.35416666666666,1014.583333333332,27.421171171171135,0
1029,4,2,1,45,0.043478260869565216,0.021739130434782608,0.9782608695652174,46,1600,1000,600,0.625,22,10,12,325.6807751247422,0.44728260869565223,0.24762496764694641,0.18048950257994745,129176.17517203621,-785.9606284643687,128390.21454357184,912,0,209.02173913043478,41,5,23,37.5812229595654,0.6034044715447154,45.85813492063491,1016.5674603174587,24.79432830042582,0
1030,4,2,0,47,0.0425531914893617,0.0,1.0,47,1100,800,300,0.7272727272727273,14,8,6,323.9576185236224,0.44763721862473016,0.2729399576251397,0.18178629635183335,129666.74619108996,-998.6890194956441,128668.05717159431,913,0,205.4468085106383,40,7,21,37.127278321027056,0.6098958333333333,45.3760162601626,1018.4959349593496,25.46239837398374,0
1031,4,0,1,46,0.0,0.02127659574468085,0.9787234042553191,47,2300,1900,400,0.8260869565217391,27,19,8,319.09877311182305,0.4472903176071539,0.26642293198402744,0.1803672107397701,129951.5430320081,-1106.524410899585,128845.01862110852,914,1,206.4468085106383,40,7,22,36.96260673112066,0.6127604166666667,45.09654471544716,1019.6138211382117,25.490345528455293,0
1032,4,0,0,46,0.0,0.0,1.0,46,1550,1000,550,0.6451612903225806,21,10,11,325.0344441248166,0.44403180354267313,0.2673151750972764,0.1839952690310084,130009.52695893167,-748.4851347946636,129261.041824137,915,2,211.8913043478261,41,5,22,36.75259403372245,0.6117886178861789,45.03968253968254,1019.8412698412694,24.87417731320169,0
1033,4,1,1,46,0.02127659574468085,0.02127659574468085,0.9787234042553191,47,950,600,350,0.631578947368421,13,6,7,320.7008156716609,0.44588344125809437,0.26485754744707557,0.18285304263474933,130289.85407991846,-1042.2033145933888,129247.65076532507,916,0,208.36170212765958,38,9,23,36.57954862564533,0.6195175438596492,44.76495726495728,1020.9401709401732,26.866846603688767,0
1034,4,1,0,47,0.02127659574468085,0.0,1.0,47,1550,1200,350,0.7741935483870968,19,12,7,322.38995354284975,0.4447849213691027,0.2715101844683525,0.18485236904579244,130508.09500328741,-985.1002629848649,129522.99474030254,917,0,209.12765957446808,38,9,19,36.315872020075304,0.6217105263157895,44.55128205128206,1021.7948717948725,26.889338731444013,0
1035,4,0,0,47,0.0,0.0,1.0,47,1300,900,400,0.6923076923076923,17,9,8,324.2383362051674,0.44399475794017884,0.2740365052930227,0.18656864937746526,130644.58832137122,-928.0032096939083,129716.58511167731,918,1,210.12765957446808,38,9,19,36.130778207405854,0.6230811403508771,44.417735042735046,1022.3290598290603,26.90339631129106,0
1036,4,0,1,46,0.0,0.02127659574468085,0.9787234042553191,47,1400,1000,400,0.7142857142857143,18,10,8,325.4578652849226,0.4443609312365094,0.2782710842459559,0.18761126620681684,130714.91021050366,-891.5608723958162,129823.34933810784,919,2,211.12765957446808,39,8,19,36.02859410546332,0.6220619658119658,44.34895833333334,1022.6041666666681,26.220619658119695,0
1037,4,0,0,46,0.0,0.0,1.0,46,1650,1000,650,0.6060606060606061,23,10,13,335.2468969361614,0.442139694041868,0.28274158896099544,0.19298816970254715,130661.65500217036,-439.21712239581063,130222.43787977454,920,3,216.65217391304347,39,7,20,35.832165902530136,0.6215277777777778,44.40104166666668,1022.3958333333351,26.21527777777782,0
1038,4,0,1,45,0.0,0.021739130434782608,0.9782608695652174,46,1100,800,300,0.7272727272727273,14,8,6,330.80168076289686,0.4418377616747182,0.2702116355264321,0.19108661794656778,130794.81336805575,-546.5711805555356,130248.24218750022,921,4,217.65217391304347,39,7,21,35.81126951799049,0.6228632478632479,44.27083333333334,1022.9166666666682,26.22863247863252,0
1039,4,0,1,44,0.0,0.022222222222222223,0.9777777777777777,45,1500,900,600,0.6,21,9,12,334.11135675578663,0.44166666666666665,0.27074160758906873,0.19393457193379324,130981.34901258702,-247.52875434025316,130733.82025824676,922,5,219.0888888888889,39,6,22,35.53824921135647,0.624732905982906,44.08854166666668,1023.6458333333351,26.247329059829106,0
1040,4,0,0,44,0.0,0.0,1.0,44,1500,1100,400,0.7333333333333333,19,11,8,341.06554917802714,0.43892045454545453,0.2720154141118849,0.19750458464493015,130890.45606874135,128.44505624954277,131018.9011249909,923,6,224.86363636363637,38,6,22,35.45212118048305,0.6255482456140351,44.177350427350426,1023.2905982905985,26.928699955015748,0
1041,4,0,1,43,0.0,0.022727272727272728,0.9772727272727273,44,1400,1100,300,0.7857142857142857,17,11,6,341.4168444844912,0.43772022551092316,0.27093350099859403,0.1988631762423888,131114.67013888908,152.9513888889105,131267.62152777798,924,7,225.86363636363637,39,5,22,35.216639544345,0.6260683760683761,43.95833333333334,1024.1666666666683,26.260683760683804,0
1042,4,0,0,43,0.0,0.0,1.0,43,1450,1100,350,0.7586206896551724,18,11,7,347.80035336496604,0.43528516057585825,0.26733268962974166,0.20255250226953603,131109.19922017664,519.965163635026,131629.16438381167,925,8,231.8372093023256,38,5,22,35.05872279018014,0.6277412280701755,43.96367521367521,1024.1452991452982,26.951192082771005,0
1043,4,0,0,43,0.0,0.0,1.0,43,1050,700,350,0.6666666666666666,14,7,7,346.68520681329534,0.4346160944998154,0.26219039121748744,0.20276856730201986,131273.3764336327,502.1075315946912,131775.48396522738,926,9,232.8372093023256,38,5,22,34.92146232971921,0.6293859649122807,43.80341880341879,1024.7863247863236,26.96806117858746,0
1044,4,0,0,43,0.0,0.0,1.0,43,1000,500,500,0.5,15,5,10,339.4790543796196,0.4339470284237726,0.256140924510565,0.19913771334227162,131385.84530476414,320.57133313412623,131706.41663789828,927,10,233.8372093023256,36,7,22,34.99263144405388,0.6342592592592593,43.69369369369369,1025.2252252252247,28.478478478478465,0
1045,4,0,0,43,0.0,0.0,1.0,43,1200,800,400,0.6666666666666666,16,8,8,339.7390363650544,0.4339931709117755,0.2549165351198839,0.20001627974795988,131524.881754482,336.82731705908014,131861.70907154106,928,11,234.8372093023256,37,6,22,34.84578211295206,0.6337274774774775,43.55811403508771,1025.767543859648,27.723447131341835,0
1046,4,0,0,43,0.0,0.0,1.0,43,1050,600,450,0.5714285714285714,15,6,9,339.49253233336066,0.43369324473975635,0.24811833901952451,0.20046123723078346,131637.3803117303,337.9815183517793,131975.36183008208,929,12,235.8372093023256,37,6,21,34.73873188018664,0.6348536036036037,43.44846491228069,1026.2061403508753,27.7353010905642,0
1047,4,0,0,43,0.0,0.0,1.0,43,1300,1100,200,0.8461538461538461,15,11,4,342.1173618058941,0.4335548172757475,0.25104652404955785,0.20230957826057938,131693.64762474975,410.9366583948745,132104.58428314462,930,13,236.8372093023256,37,6,21,34.614691272299964,0.6354166666666667,43.393640350877185,1026.4254385964898,27.7412280701754,0
1048,4,0,0,43,0.0,0.0,1.0,43,1250,900,350,0.72,16,9,7,341.9848015851184,0.4326781100036914,0.2523696594196603,0.20283012456267482,131806.21831957914,415.14468394122,132221.36300352035,931,14,237.8372093023256,37,6,21,34.504693895710986,0.6365427927927928,43.28399122807018,1026.8640350877197,27.75308202939783,0
1049,4,0,1,42,0.0,0.023255813953488372,0.9767441860465116,43,1400,1100,300,0.7857142857142857,17,11,6,342.8907749839744,0.43210132890365444,0.25298514129172545,0.20442572157441524,132003.33275623262,452.5450138504075,132455.87777008303,932,15,238.8372093023256,37,6,21,34.28297055057618,0.6385135135135135,43.09210526315789,1027.6315789473679,27.773826458036968,0
1050,4,0,0,42,0.0,0.0,1.0,42,1800,1400,400,0.7777777777777778,22,14,8,348.27573254460293,0.4309789972899729,0.2473117438056629,0.20789487318081026,132050.54029959007,797.9997311500615,132848.5400307401,933,16,238.76190476190476,36,6,23,34.09709287462109,0.6409143518518519,43.04617117117117,1027.8153153153148,28.550425425425413,0
1051,4,0,1,41,0.0,0.023809523809523808,0.9761904761904762,42,1550,1100,450,0.7096774193548387,20,11,9,350.91856250507067,0.4304708672086721,0.25374492291168105,0.21043593114634346,132224.21481870385,879.986278508246,133104.2010972121,934,17,239.76190476190476,36,6,24,33.854337749552926,0.642650462962963,42.877252252252255,1028.4909909909911,28.569194194194196,0
1052,4,0,0,41,0.0,0.0,1.0,41,1300,900,400,0.6923076923076923,17,9,8,352.8223213985294,0.4292682926829268,0.24925724139587824,0.2122276201855408,132340.06123944907,1138.5055241052025,133478.56676355426,935,18,239.8780487804878,36,5,24,33.68880194082667,0.6438078703703703,42.76463963963965,1028.9414414414427,28.581706706706743,0
1053,4,0,0,41,0.0,0.0,1.0,41,1650,1500,150,0.9090909090909091,18,15,3,355.0322162841458,0.42870934959349594,0.25609901225752685,0.21478298872827067,132555.70461180806,1212.3471626889236,133768.051774497,936,19,240.8780487804878,33,8,25,33.41502538775835,0.6524621212121212,42.555147058823536,1029.7794117647068,31.20543672014263,0
1054,4,0,1,40,0.0,0.024390243902439025,0.975609756097561,41,1000,600,400,0.6,14,6,8,354.3978945875802,0.42797256097560976,0.2523912999329825,0.21512080142944326,132681.93310565667,1204.439548490989,133886.37265414765,937,20,241.8780487804878,33,8,20,33.30446354228619,0.6537247474747474,42.4325980392157,1030.2696078431388,31.22029114676178,0
1055,4,1,0,41,0.024390243902439025,0.0,1.0,41,1450,1300,150,0.896551724137931,16,13,3,344.48539721320594,0.4275660569105691,0.23654595612383367,0.2108553475250064,132994.25582990408,962.9158093278527,133957.17163923194,938,0,227.21951219512195,35,6,22,33.24637193297426,0.6523809523809524,42.12962962962963,1031.4814814814822,29.470899470899493,0
1056,4,1,0,42,0.023809523809523808,0.0,1.0,42,1500,1300,200,0.8666666666666667,17,13,4,352.40972988177975,0.4294667053813395,0.240648222337434,0.20501994074312357,131068.5405633673,890.3170469017414,131958.85761026904,939,0,222.78571428571428,36,6,18,34.98180835074599,0.6310763888888888,44.00337837837837,1023.9864864864857,28.444069069069045,8
1057,4,1,0,43,0.023255813953488372,0.0,1.0,43,1000,500,500,0.5,15,5,10,345.75562683584525,0.43110926541159095,0.248360035966813,0.20281953780370698,131385.84530476408,485.73586255172916,131871.5811673158,940,0,218.58139534883722,36,7,20,34.83175893380199,0.6342592592592593,43.69369369369369,1025.2252252252242,28.47847847847845,0
1058,4,0,0,43,0.0,0.0,1.0,43,1350,1100,250,0.8148148148148148,16,11,5,350.13609934118904,0.43030177187153934,0.2557297210374374,0.20647831722314394,131587.9662390431,614.7394438357267,132202.70568287882,941,1,219.58139534883722,36,7,17,34.51551238429736,0.6362847222222222,43.49662162162162,1026.0135135135135,28.500375375375377,0
1059,4,0,0,43,0.0,0.0,1.0,43,1050,600,450,0.5714285714285714,15,6,9,349.23042527537876,0.42967884828349945,0.2529232417813718,0.206569456611621,131703.53366457685,598.976214390074,132302.50987896693,942,2,220.58139534883722,36,7,18,34.42219784238435,0.6374421296296297,43.38400900900901,1026.4639639639647,28.51288788788791,0
1060,4,0,0,43,0.0,0.0,1.0,43,750,400,350,0.5333333333333333,11,4,7,348.7854712369289,0.42924049464747144,0.2521411774307909,0.20677671825346686,131790.2425229284,593.3043685577541,132383.54689148616,943,3,221.58139534883722,36,7,18,34.34621079184031,0.6383101851851851,43.29954954954955,1026.8018018018024,28.52227227227229,0
1061,4,1,0,44,0.022727272727272728,0.0,1.0,44,1000,800,200,0.8,12,8,4,340.0792253864515,0.43060694150810425,0.24877844241713287,0.20350497105607915,132144.21895438991,187.90072426132798,132332.11967865124,944,0,217.52272727272728,37,7,19,34.213478902278645,0.6399211711711712,42.95504385964913,1028.1798245614045,27.788643907064987,0
1062,4,0,0,44,0.0,0.0,1.0,44,1350,1200,150,0.8888888888888888,15,12,3,333.5573439984264,0.4303977272727273,0.23785425101214575,0.20094796089661307,132398.0034722223,32.465277777782774,132430.4687500001,945,1,218.52272727272728,37,7,19,34.12618083670714,0.642454954954955,42.708333333333336,1029.1666666666672,27.81531531531533,0
1063,4,0,0,44,0.0,0.0,1.0,44,1050,700,350,0.6666666666666666,14,7,7,334.13735514241495,0.42986918604651164,0.23909517030322402,0.20144812798470457,132426.2167806441,49.70916532010614,132475.92594596423,946,2,219.52272727272728,37,7,19,34.08292940591597,0.6427364864864865,42.68092105263158,1029.2763157894742,27.818278805120926,0
1064,4,0,0,44,0.0,0.0,1.0,44,1250,800,450,0.64,17,8,9,333.39753820023157,0.43005637773079636,0.23481620637564404,0.20115270492440723,132454.4330947985,31.99638350262552,132486.4294783011,947,3,220.52272727272728,37,7,19,34.07364010793922,0.6430180180180181,42.65350877192983,1029.3859649122815,27.821242294926527,0
1065,4,0,0,44,0.0,0.0,1.0,44,950,600,350,0.631578947368421,13,6,7,328.024982995944,0.42908738548273434,0.20213642043088154,0.19351056122193158,131602.03904594926,-112.0853756979592,131489.9536702513,948,4,221.52272727272728,38,6,15,35.06850444259339,0.6326754385964912,43.48290598290598,1026.0683760683758,27.001799370220414,8
1066,4,1,0,45,0.022222222222222223,0.0,1.0,45,1200,800,400,0.6666666666666666,16,8,8,325.68832712856545,0.4294191919191919,0.21947521097046474,0.19418398372193682,132006.0810364199,-401.432059290127,131604.64897712978,949,0,217.57777777777778,40,5,16,34.722153546940916,0.6333333333333333,43.08943089430893,1027.6422764227625,25.691056910569063,0
1067,4,0,1,44,0.0,0.022222222222222223,0.9777777777777777,45,1750,1100,650,0.6285714285714286,24,11,13,337.2317682123218,0.42996632996632994,0.1477201022882002,0.19112339116584282,130055.18297846861,-129.9103749421539,129925.27260352646,950,1,218.57777777777778,40,5,17,36.39533725216698,0.6138020833333333,44.994918699187,1020.0203252032529,25.50050813008132,8
1068,4,0,0,44,0.0,0.0,1.0,44,900,600,300,0.6666666666666666,12,6,6,340.5763192851101,0.429274577167019,0.12574925074925036,0.18230850032320634,127793.20987654348,-88.96725429819324,127704.24262224529,951,2,224.3181818181818,38,6,17,38.61320970695971,0.5942982456140351,47.222222222222236,1011.1111111111132,26.60818713450298,8
1069,4,2,0,46,0.043478260869565216,0.0,1.0,46,1300,800,500,0.6153846153846154,18,8,10,332.33891746911115,0.4328200483091787,0.14004794595183556,0.1808554665441564,128453.40617563964,-661.9868092735674,127791.41936636607,952,0,215.52173913043478,40,6,15,38.147660818713454,0.59765625,46.57012195121952,1013.719512195123,25.342987804878074,0
1070,4,0,0,46,0.0,0.0,1.0,46,1100,700,400,0.6363636363636364,15,7,8,332.04037055504824,0.4327697262479871,0.1424699556415412,0.18104365122394955,128530.68300119003,-664.5248777182643,127866.15812347176,953,1,216.52173913043478,40,6,15,38.07647658181332,0.5984375,46.4939024390244,1014.0243902439046,25.350609756097615,0
1071,4,0,1,45,0.0,0.021739130434782608,0.9782608695652174,46,1350,1200,150,0.8888888888888888,15,12,3,336.9973169554019,0.43302133655394526,0.14239642174304956,0.1843421487762073,128659.52934967642,-528.4167616828315,128131.11258799359,954,2,217.52173913043478,40,6,15,37.81950148585929,0.5997395833333333,46.3668699186992,1014.5325203252056,25.36331300813014,0
1072,4,0,0,45,0.0,0.0,1.0,45,1500,1100,400,0.7333333333333333,19,11,8,337.689568691881,0.43223905723905726,0.15881724736350278,0.1853210665985999,128788.4402472078,-301.89743208402933,128486.54281512377,955,3,222.44444444444446,40,5,15,37.670621412361534,0.6010416666666667,46.23983739837401,1015.0406504065077,25.376016260162693,0
1073,4,1,1,45,0.021739130434782608,0.021739130434782608,0.9782608695652174,46,1350,900,450,0.6666666666666666,18,9,9,330.3529129304227,0.43404790660225445,0.16723534279712227,0.18284525083588238,129125.75511975637,-668.5861323696006,128457.16898738677,956,0,218.58695652173913,41,5,16,37.51372620790629,0.6028963414634146,45.9077380952381,1016.3690476190487,24.789488966318263,0
1074,4,0,0,45,0.0,0.0,1.0,45,1100,800,300,0.7272727272727273,14,8,6,335.0758169237367,0.43251262626262627,0.16554866528861334,0.18508773577920007,129046.45568940455,-351.93068775198725,128694.52500165257,957,1,224.2888888888889,40,5,16,37.4743698739748,0.6036458333333333,45.98577235772358,1016.0569105691065,25.401422764227664,0
1075,4,0,1,44,0.0,0.022222222222222223,0.9777777777777777,45,1400,1000,400,0.7142857142857143,18,10,8,336.43267180413505,0.4324074074074074,0.16052828470121394,0.1864481118429946,129176.1751720363,-308.18285068657724,128867.99232134972,958,2,225.2888888888889,41,4,18,37.30797225204126,0.6034044715447154,45.85813492063492,1016.5674603174594,24.79432830042584,0
1076,4,1,1,44,0.022222222222222223,0.022222222222222223,0.9777777777777777,45,1450,900,550,0.6206896551724138,20,9,11,337.8482080286367,0.4354166666666666,0.17091707328169603,0.18848881463345243,129439.78000217021,-253.79553477930017,129185.98446739091,959,0,219.77777777777777,39,6,16,37.004064728563115,0.6092414529914529,45.598958333333336,1017.6041666666673,26.092414529914546,0
1077,4,0,0,44,0.0,0.0,1.0,44,1400,1000,400,0.7142857142857143,18,10,8,340.02380544735007,0.43514358703312195,0.17759082538088067,0.1903432230493928,129572.314453125,11.534288194444002,129583.84874131944,960,1,224.5909090909091,39,5,17,36.81408157697292,0.6105769230769231,45.46875,1018.125,26.10576923076923,0
1078,4,0,0,44,0.0,0.0,1.0,44,1100,800,300,0.7272727272727273,14,8,6,340.06697508580834,0.4350444855532065,0.18124639729262304,0.19088259944827984,129678.39084201396,19.867621527782035,129698.25846354174,961,2,225.5909090909091,39,5,18,36.70527374377855,0.6116452991452992,45.364583333333336,1018.5416666666673,26.11645299145301,0
1079,4,0,0,44,0.0,0.0,1.0,44,1100,900,200,0.8181818181818182,13,9,4,339.63842559036203,0.434802237491191,0.17077284808832527,0.19115898038693466,129784.51063368065,15.961371527787378,129800.47200520843,962,3,226.5909090909091,39,5,18,36.608481564778856,0.6127136752136753,45.26041666666667,1018.9583333333342,26.127136752136774,0
1080,4,0,0,44,0.0,0.0,1.0,44,1300,900,400,0.6923076923076923,17,9,8,339.7419657173432,0.4349343727977449,0.17226102463127413,0.19199736492155642,129943.77170138899,29.470486111120806,129973.24218750012,963,4,227.5909090909091,39,5,18,36.44428551968396,0.6143162393162394,45.10416666666667,1019.5833333333342,26.143162393162413,0
1081,4,0,2,42,0.0,0.045454545454545456,0.9545454545454546,44,1350,1000,350,0.7407407407407407,17,10,7,340.6408859840233,0.4346370683579986,0.17145721925133706,0.19302983539094648,130050.0,60.069444444444116,130110.06944444444,964,5,228.5909090909091,39,5,19,36.31365740740742,0.6153846153846154,45.0,1020.0,26.153846153846153,0
1082,4,1,0,43,0.023255813953488372,0.0,1.0,43,1200,1000,200,0.8333333333333334,14,10,4,339.67121276793364,0.4322397563676634,0.1823657002913972,0.19326260247600177,130208.06081753604,245.5859860106696,130453.64680354671,965,0,232.7674418604651,38,5,20,36.17820754387801,0.6186951754385965,44.84508547008547,1020.6196581196587,26.85841205578049,0
1083,4,1,2,42,0.022727272727272728,0.045454545454545456,0.9545454545454546,44,1900,1400,500,0.7368421052631579,24,14,10,340.8660206361167,0.4331725687103594,0.13797122623512204,0.19017248175866516,129439.78000217034,64.73392863055818,129504.51393080091,966,0,228.45454545454547,39,5,15,36.92729126147336,0.6092414529914529,45.59895833333334,1017.6041666666683,26.092414529914574,8
1084,4,0,0,42,0.0,0.0,1.0,42,1250,1000,250,0.8,15,10,5,354.1953505193228,0.43163230739450253,0.16158390308264292,0.19805007627629756,129527.44904667996,775.6040433925164,130303.05309007248,967,1,238.92857142857142,38,4,15,36.49900293870696,0.611842105263158,45.51282051282052,1017.9487179487191,26.78812415654524,0
1085,4,1,1,42,0.023255813953488372,0.023255813953488372,0.9767441860465116,43,1450,1200,250,0.8275862068965517,17,12,5,355.44052924867765,0.4327473237356958,0.18422178082321894,0.20086904736062744,129943.7717013893,637.4565972222628,130581.22829861156,968,0,234.34883720930233,39,4,16,36.04413567633837,0.6143162393162394,45.104166666666686,1019.5833333333367,26.143162393162477,0
1086,4,1,1,42,0.023255813953488372,0.023255813953488372,0.9767441860465116,43,1650,1100,550,0.6666666666666666,22,11,11,357.3292132896763,0.4342469545957918,0.2020776199595573,0.20388031590504133,130317.12420784961,713.6137192728045,131030.73792712242,969,0,233.90697674418604,38,5,18,35.61699975585087,0.6197916666666667,44.73824786324788,1021.0470085470105,26.86965811965817,0
1087,4,0,0,42,0.0,0.0,1.0,42,1750,1300,450,0.7428571428571429,22,13,9,360.60144626156585,0.4325154858691444,0.1964316849242047,0.2060364151114353,130371.67302441763,1002.4427688290077,131374.11579324663,970,1,237.16666666666666,38,4,18,35.478127070474606,0.6203399122807017,44.68482905982907,1021.2606837606854,26.875281151596983,0
1088,4,0,0,42,0.0,0.0,1.0,42,950,600,350,0.631578947368421,13,6,7,358.6895519168435,0.4322009291521487,0.19112651175431417,0.20605748731897391,130581.79253472244,967.6649305555786,131549.457465278,971,2,238.16666666666666,39,3,17,35.313901345291484,0.6207264957264957,44.47916666666668,1022.0833333333351,26.207264957265004,0
1089,4,0,0,42,0.0,0.0,1.0,42,1300,1100,200,0.8461538461538461,15,11,4,362.2162925231054,0.43207994579945797,0.19227560651475906,0.20894474500539675,130741.54188368075,1071.343315972246,131812.88519965298,972,3,239.16666666666666,39,3,17,35.06187614585457,0.6223290598290598,44.32291666666668,1022.708333333335,26.22329059829064,0
1090,4,1,0,43,0.023255813953488372,0.0,1.0,43,850,600,250,0.7058823529411765,11,6,5,358.1061078266661,0.4333471760797342,0.19652455806564806,0.2077675528819229,130963.79469892266,779.7869571683593,131743.58165609103,973,0,234.58139534883722,40,3,18,34.94195955785013,0.6229166666666667,44.10569105691057,1023.5772357723583,25.589430894308958,0
1091,4,1,0,44,0.022727272727272728,0.0,1.0,44,1300,800,500,0.6153846153846154,18,8,10,348.17706362152967,0.4341305496828753,0.268482544782114,0.18976234811265202,128513.93771701369,213.2028035457364,128727.14052055942,974,0,230.22727272727272,39,5,17,37.684490788302185,0.5998931623931624,46.51041666666666,1013.9583333333317,25.998931623931583,8
1092,4,0,0,44,0.0,0.0,1.0,44,1200,900,300,0.75,15,9,6,345.8638720326426,0.4335469520789288,0.263203680087448,0.18882502422788677,128582.21379469881,94.3884675127118,128676.60226221151,975,1,231.22727272727272,40,4,18,37.67347194388777,0.5989583333333333,46.443089430894304,1014.2276422764219,25.355691056910548,0
1093,4,0,0,44,0.0,0.0,1.0,44,1500,900,600,0.6,21,9,12,350.1553595600434,0.43359099718111344,0.2724228796914301,0.19184462629564436,128722.74900990477,214.5920926240767,128937.34110252885,976,2,232.22727272727272,41,3,18,37.42128181314564,0.5988313008130082,46.30456349206349,1014.7817460317451,24.750774293457198,0
1094,4,1,1,44,0.022222222222222223,0.022222222222222223,0.9777777777777777,45,1500,1100,400,0.7333333333333333,19,11,8,350.1417260276687,0.43566919191919196,0.27756589541486676,0.19368599275201384,129102.89345592183,40.86198996451725,129143.75544588635,977,0,228.04444444444445,42,3,19,37.03418986778541,0.6011904761904762,45.93023255813952,1016.2790697674395,24.19712070874856,0
1095,4,0,1,43,0.0,0.022727272727272728,0.9772727272727273,44,1400,1000,400,0.7142857142857143,18,10,8,325.6896491830742,0.4360575229034531,0.19428469369530266,0.17304387414841793,127492.46110481196,-476.3913578271473,127016.06974698481,978,1,231.04545454545453,41,3,14,39.29682383759002,0.5863821138211383,47.51984126984125,1009.9206349206322,24.632210607820298,8
1096,4,1,0,44,0.022727272727272728,0.0,1.0,44,1000,600,400,0.6,14,6,8,322.46667897005847,0.43424066243833687,0.2058841904217923,0.17197097340256556,127642.7912021285,-567.8906053162439,127074.90059681225,979,0,232.0,41,3,15,39.224589305582846,0.5879065040650406,47.371031746031726,1010.5158730158689,24.646728610143143,0
1097,4,3,1,46,0.06382978723404255,0.02127659574468085,0.9787234042553191,47,1350,900,450,0.6666666666666666,18,9,9,312.02234257699604,0.4396584952204749,0.22493156591026575,0.16984275484081818,128463.58861396517,-1381.3296490200628,127082.25896494511,980,0,218.12765957446808,42,5,13,38.65218568788635,0.5947420634920635,46.56007751937983,1013.759689922478,24.137135474344714,0
1098,4,0,0,46,0.0,0.0,1.0,46,1350,900,450,0.6666666666666666,18,9,9,317.2239225524294,0.43748993558776167,0.21767219366041335,0.17238082940402188,128395.77034517482,-1053.9580183925727,127341.81232678225,981,1,223.8695652173913,41,5,14,38.58938593056641,0.5955284552845528,46.62698412698411,1013.4920634920611,24.719318621757587,0
1099,4,4,2,48,0.08,0.04,0.96,50,950,600,350,0.631578947368421,13,6,7,297.62561162954404,0.4444642857142857,0.23622346368715075,0.16545026236549187,129297.68207644636,-2298.50060528496,126999.1814711614,982,0,206.88,43,7,18,38.171166977032904,0.6017441860465116,45.73863636363637,1017.0454545454552,23.65221987315012,0
1100,4,2,1,49,0.04,0.02,0.98,50,1300,900,400,0.6923076923076923,17,9,8,300.31358327652043,0.44587585034013605,0.25318475393432127,0.16783666603755937,129507.51135973948,-2221.427040466381,127286.0843192731,983,0,207.6,44,6,16,37.89039995148428,0.6025094696969697,45.53240740740741,1017.8703703703713,23.13341750841753,0
1101,4,0,2,47,0.0,0.04081632653061224,0.9591836734693877,49,1550,1000,550,0.6451612903225806,21,10,11,309.7704672811936,0.4450999149659864,0.25287063946590527,0.17336503351067767,129562.67329724839,-1773.0620301021327,127789.61126714626,984,1,212.83673469387756,43,6,16,37.593886615198564,0.6044089147286822,45.47821969696971,1018.087121212124,23.67644467935172,0
1102,4,0,0,47,0.0,0.0,1.0,47,1100,700,400,0.6363636363636364,15,7,8,321.12662931426127,0.44098828245451743,0.25194974947353166,0.1788785216522405,129377.95380015428,-1090.6587577160506,128287.29504243823,985,2,222.80851063829786,41,6,18,37.49217861205915,0.6054369918699187,45.65972222222222,1017.3611111111109,24.813685636856363,0
1103,4,1,0,48,0.020833333333333332,0.0,1.0,48,1350,800,550,0.5925925925925926,19,8,11,310.39919808826795,0.44192338947990545,0.2461959216561298,0.17425124084746416,129683.21352731877,-1549.2869031221153,128133.92662419665,986,0,219.14583333333334,43,5,17,37.45583860171068,0.6056201550387597,45.35984848484849,1018.5606060606071,23.68745595489784,0
1104,4,0,1,47,0.0,0.020833333333333332,0.9791666666666666,48,950,600,350,0.631578947368421,13,6,7,312.433493180028,0.44268062943262415,0.24741325898389133,0.17582554323311195,129779.68606519741,-1490.4958677685966,128289.19019742882,987,1,220.14583333333334,43,5,18,37.3063816604709,0.6065891472868217,45.265151515151516,1018.9393939393938,23.69626497533474,0
1105,4,1,0,48,0.020833333333333332,0.0,1.0,48,1700,1200,500,0.7058823529411765,22,12,10,315.45065458729675,0.4437703161938534,0.2711622210125202,0.17940645587519033,130191.70524691379,-1386.1882716049172,128805.51697530887,988,0,220.10416666666666,44,4,19,36.81273816004355,0.609375,44.86111111111112,1020.5555555555571,23.194444444444482,0
1106,4,0,1,47,0.0,0.020833333333333332,0.9791666666666666,48,1400,1000,400,0.7142857142857143,18,10,8,302.7754133405239,0.44309618794326244,0.129965192465193,0.1688076619583469,129413.28124999999,-1646.9907407407404,127766.29050925924,989,1,221.10416666666666,44,4,15,37.92315042315044,0.6015625,45.625,1017.4999999999999,23.124999999999996,8
1107,4,2,2,47,0.04081632653061224,0.04081632653061224,0.9591836734693877,49,1150,700,450,0.6086956521739131,16,7,9,296.5759334104178,0.44490504535147396,0.16480280811685044,0.16758326839697102,129939.15406427221,-2092.6348193656763,127846.51924490654,990,0,217.48979591836735,45,4,14,37.54923300165838,0.6055555555555556,45.108695652173914,1019.5652173913043,22.657004830917874,0
1108,4,0,0,47,0.0,0.0,1.0,47,1600,1000,600,0.625,22,10,12,304.9359238974725,0.44143154486586494,0.1675698545819153,0.17248378684555032,129979.17631172838,-1472.935956790127,128506.24035493826,991,1,227.36170212765958,44,3,16,37.29569599564148,0.6072443181818181,45.06944444444444,1019.7222222222222,23.17550505050505,0
1109,4,0,2,45,0.0,0.0425531914893617,0.9574468085106383,47,1200,800,400,0.6666666666666666,16,8,8,305.02910548463893,0.44158572309589883,0.16441796003515474,0.17274527490556824,130026.38996056265,-1467.6333161865346,128558.75664437612,992,2,228.36170212765958,44,3,16,37.24561204418218,0.607717803030303,45.02314814814816,1019.9074074074093,23.17971380471385,0
1110,4,0,2,43,0.0,0.044444444444444446,0.9555555555555556,45,1800,1200,600,0.6666666666666666,24,12,12,314.30453191824114,0.44050925925925927,0.1583156472066478,0.17772308379235102,129966.00193986247,-830.2193190012563,129135.78262086121,993,3,232.55555555555554,42,3,18,37.070187525737275,0.6098710317460317,45.082364341085274,1019.6705426356596,24.2778700627538,0
1111,4,0,0,43,0.0,0.0,1.0,43,1750,1300,450,0.7428571428571429,22,13,9,321.17454380520167,0.4391842008121078,0.17454722425000857,0.18178153113847736,130003.35784131486,-249.2461704342494,129754.11167088062,994,4,241.65116279069767,40,3,18,36.85724962630793,0.61328125,45.04573170731708,1019.8170731707331,25.49542682926833,0
1112,4,1,0,44,0.022727272727272728,0.0,1.0,44,1250,800,450,0.64,17,8,9,313.0859405887963,0.4402087737843552,0.1679656048996283,0.17886302541084795,130366.35068618222,-636.5674986780268,129729.7831875042,995,0,237.13636363636363,40,4,20,36.69664477394103,0.6169270833333333,44.69004065040651,1021.2398373983744,25.53099593495936,0
1113,4,0,1,43,0.0,0.022727272727272728,0.9772727272727273,44,1300,800,500,0.6153846153846154,18,8,10,311.77496655320175,0.439922480620155,0.10147774036662915,0.1683584819387288,128144.53124999984,-793.8399555489606,127350.69129445088,996,1,238.13636363636363,40,4,20,38.98319615912209,0.59453125,46.87499999999999,1012.4999999999987,25.312499999999968,8
1114,4,0,0,43,0.0,0.0,1.0,43,1150,900,250,0.782608695652174,14,9,5,314.22082965895464,0.438030638612034,0.11293698849051292,0.16979103308030574,128170.89979383687,-545.2067057291628,127625.69308810771,997,2,244.34883720930233,39,4,20,38.89442529918047,0.5964209401709402,46.848958333333336,1012.6041666666672,25.964209401709414,0
1115,4,0,0,43,0.0,0.0,1.0,43,1300,1000,300,0.7692307692307693,16,10,6,331.1699045929394,0.437938353636028,0.08803336307843668,0.17241280006734308,126666.55411746184,-150.8999279843789,126515.65418947746,998,3,245.34883720930233,36,7,17,40.00470783458256,0.5865162037037037,48.338963963963955,1006.6441441441424,27.96233733733729,8
1116,4,5,2,46,0.10416666666666667,0.041666666666666664,0.9583333333333334,48,1700,1100,600,0.6470588235294118,23,11,12,305.5614366699168,0.4476765661938534,0.14407714173691444,0.164590167735295,128044.10450522784,-1774.9318940539356,126269.1726111739,999,0,220.6875,41,7,18,39.2427138469581,0.5919715447154472,46.97420634920634,1012.1031746031731,24.685443283004222,0
1117,4,3,2,47,0.061224489795918366,0.04081632653061224,0.9591836734693877,49,1150,800,350,0.6956521739130435,15,8,7,314.7211524223377,0.44947562358276644,0.16940899658502273,0.17316595567202686,128891.61544054499,-1643.7022495146848,127247.91319103031,1000,0,216.0,40,9,17,38.148643915132105,0.6020833333333333,46.13821138211384,1015.4471544715475,25.386178861788686,8
1118,4,0,1,46,0.0,0.02127659574468085,0.9787234042553191,47,1200,900,300,0.75,15,9,6,324.14681408888345,0.4457678075855689,0.16508182616644906,0.17730980107073946,128658.8684345095,-1059.127538534584,127599.74089597492,1001,1,225.9787234042553,38,9,17,38.1461053777029,0.6030701754385965,46.36752136752137,1014.5299145299148,26.69815564552407,0
1119,4,1,1,46,0.02127659574468085,0.02127659574468085,0.9787234042553191,47,1400,900,500,0.6428571428571429,19,9,10,327.279122846721,0.4445536540240518,0.18287964068327844,0.1801605967607386,128910.3203667534,-962.0686848958378,127948.25168185755,1002,0,226.91489361702128,39,8,19,37.81082247751907,0.6038995726495726,46.119791666666664,1015.5208333333327,26.03899572649571,0
1120,4,1,0,47,0.02127659574468085,0.0,1.0,47,1400,1000,400,0.7142857142857143,18,10,8,336.673946084228,0.44623034227567066,0.20005697131713251,0.18061348157336243,127880.9950086808,-766.3682725694199,127114.62673611137,1003,0,224.5531914893617,39,8,15,38.622124957088914,0.593482905982906,47.13541666666668,1011.4583333333353,25.93482905982911,8
1121,4,0,0,47,0.0,0.0,1.0,47,1600,1100,500,0.6875,21,11,10,340.7642780648373,0.44596053037311134,0.20851720852815903,0.18340858511910796,128012.72922092033,-675.566948784703,127337.16227213563,1004,1,225.5531914893617,39,8,15,38.384049579687776,0.5948183760683761,47.00520833333334,1011.9791666666682,25.9481837606838,0
1122,4,1,2,46,0.020833333333333332,0.041666666666666664,0.9583333333333334,48,1700,1200,500,0.7058823529411765,22,12,10,336.8396060800249,0.44689162234042556,0.2159353059177529,0.18271441091500848,128324.66310562521,-955.0342058298369,127369.62889979537,1005,0,221.83333333333334,40,8,16,38.16491140086927,0.5963541666666667,46.69715447154473,1013.2113821138232,25.33028455284558,0
1123,4,1,0,47,0.02127659574468085,0.0,1.0,47,950,700,250,0.7368421052631579,12,7,5,341.89155557479205,0.445613629355535,0.21346584546472558,0.18559827302631585,128355.55555555565,-623.2638888888795,127732.29166666677,1006,0,227.25531914893617,39,8,17,38.005413925438596,0.5982905982905983,46.66666666666667,1013.3333333333342,25.982905982906004,0
1124,4,1,3,45,0.020833333333333332,0.0625,0.9375,48,1150,800,350,0.6956521739130435,15,8,7,335.647932949502,0.44611591312056736,0.2203808975257937,0.18360401724026731,128659.52934967614,-963.138983905082,127696.39036577106,1007,0,223.5,40,8,16,37.85372633476911,0.5997395833333333,46.36686991869919,1014.5325203252034,25.363313008130085,0
1125,4,0,0,45,0.0,0.0,1.0,45,1600,1000,600,0.625,22,10,12,332.76342097650394,0.44076178451178455,0.22102823430257068,0.18152818344304453,128550.50131492435,-433.5553765476939,128116.94593837665,1008,1,238.48888888888888,38,7,16,38.03795301306362,0.6019736842105263,46.47435897435897,1014.1025641025637,26.686909581646415,8
1126,4,0,1,44,0.0,0.022222222222222223,0.9777777777777777,45,1100,700,400,0.6363636363636364,15,7,8,334.3579059505305,0.4396675084175084,0.2313921394192382,0.18320105285545935,128725.26584201393,-391.9379340277736,128333.32790798617,1009,2,239.48888888888888,39,6,17,37.81949291726546,0.6020299145299146,46.302083333333336,1014.7916666666671,26.020299145299155,0
1127,4,0,1,43,0.0,0.022727272727272728,0.9772727272727273,44,1600,1300,300,0.8125,19,13,6,339.51446465721926,0.4390525898520084,0.22475810850902977,0.18609624349561008,128740.17373666805,-58.169766783557066,128682.00396988449,1010,3,245.13636363636363,38,6,17,37.67348317366741,0.6038925438596492,46.28739316239316,1014.8504273504267,26.70659019343228,0
1128,4,1,0,44,0.022727272727272728,0.0,1.0,44,1300,1100,200,0.8461538461538461,15,11,4,330.4512582883413,0.43957011980267796,0.21102231955640516,0.18263750847607754,129069.04432508672,-269.79437934028266,128799.24994574644,1011,0,236.63636363636363,39,5,18,37.5688749359303,0.6055021367521367,45.963541666666664,1016.1458333333327,26.055021367521352,0
1129,4,1,0,45,0.022222222222222223,0.0,1.0,45,1300,800,500,0.6153846153846154,18,8,10,321.9709778558128,0.4410353535353535,0.21166073930380436,0.17943355576721232,129396.54659366336,-667.4100218937654,128729.13657176959,1012,0,232.35555555555555,37,8,19,37.45184017674316,0.6123310810810811,45.64144736842105,1017.4342105263152,27.498221906116626,0
1130,4,0,1,44,0.0,0.022222222222222223,0.9777777777777777,45,1300,900,400,0.6923076923076923,17,9,8,320.920462451809,0.4400042087542087,0.20446682519699744,0.17994199106415543,129636.22708013727,-679.4164109869293,128956.81066915033,1013,1,233.35555555555555,38,7,14,37.235539935655346,0.6129385964912281,45.4059829059829,1018.3760683760678,26.799370220422837,0
1131,4,0,0,44,0.0,0.0,1.0,44,1150,1000,150,0.8695652173913043,13,10,3,328.87561915516216,0.4377422480620155,0.1968840260439615,0.18406329860492357,129563.94184989616,-277.91568078639386,129286.02616910977,1014,3,239.63636363636363,37,7,16,37.10633189732544,0.6140202702702703,45.47697368421053,1018.0921052631581,27.51600284495022,0
1132,4,0,1,43,0.0,0.022727272727272728,0.9772727272727273,44,1650,1200,450,0.7272727272727273,21,12,9,326.5324175906272,0.43767618040873857,0.19801109554176577,0.18372505407444317,129772.26382725182,-325.029791255753,129447.23403599607,1015,4,240.63636363636363,38,6,16,36.95475516409772,0.6143092105263157,45.2724358974359,1018.9102564102566,26.81342780026991,0
1133,4,2,1,44,0.044444444444444446,0.022222222222222223,0.9777777777777777,45,1750,1500,250,0.8571428571428571,20,15,5,319.1887863881179,0.43817340067340066,0.21027564762252493,0.18137943430238224,130158.86423631782,-690.9500173507739,129467.91421896705,1016,0,236.15555555555557,40,5,18,36.750572652126266,0.61484375,44.893292682926834,1020.4268292682939,25.510670731707346,0
1134,4,1,0,45,0.022222222222222223,0.0,1.0,45,1600,1200,400,0.75,20,12,8,313.0083275493127,0.4396254208754209,0.20364764119997658,0.17898542486935837,130402.54122662742,-836.4597983284377,129566.08142829899,1017,0,234.55555555555554,37,8,19,36.6620817677581,0.6224662162162162,44.6546052631579,1021.3815789473684,27.604907539118066,0
1135,4,0,0,45,0.0,0.0,1.0,45,1100,800,300,0.7272727272727273,14,8,6,311.02103580065153,0.4391203703703704,0.20186496863895464,0.1782345640584546,130486.549948061,-883.1876154201179,129603.36233264089,1018,1,235.55555555555554,37,8,19,36.628031766473505,0.6233108108108107,44.57236842105264,1021.7105263157899,27.613798008534864,0
1136,4,0,1,44,0.0,0.022222222222222223,0.9777777777777777,45,1800,1500,300,0.8333333333333334,21,15,6,313.0148739735621,0.4388888888888889,0.2035353535353539,0.18068086289761037,130766.77439212041,-813.6109187442555,129953.16347337616,1019,2,236.55555555555554,37,8,16,36.29440037164095,0.6261261261261262,44.298245614035075,1022.8070175438577,27.64343290659075,0
1137,4,1,1,44,0.022222222222222223,0.022222222222222223,0.9777777777777777,45,1200,800,400,0.6666666666666666,16,8,8,317.766244223851,0.4367845117845118,0.21880877016012223,0.18466670214658348,131027.14913662417,-672.7989854993184,130354.35015112485,1020,0,237.48888888888888,38,7,17,35.91037949146058,0.6269188596491229,44.043803418803414,1023.8247863247852,26.942757534862768,0
1138,4,0,0,44,0.0,0.0,1.0,44,1950,1300,650,0.6666666666666666,26,13,13,317.5827457014208,0.43514358703312195,0.21933944818403694,0.18498066088485612,131114.67013888896,-472.04861111110597,130642.62152777785,1021,1,243.79545454545453,39,5,17,35.82689178193653,0.6260683760683761,43.958333333333336,1024.1666666666672,26.260683760683776,0
1139,4,0,2,42,0.0,0.045454545454545456,0.9545454545454546,44,1200,700,500,0.5833333333333334,17,7,10,317.31753670184713,0.4352647110641297,0.22091738734432909,0.18522745150499823,131197.94894118907,-473.71800432943724,130724.23093685963,1022,2,244.79545454545453,40,4,17,35.74980160698344,0.6252604166666667,43.8770325203252,1024.491869918699,25.612296747967473,0
1140,4,0,1,41,0.0,0.023809523809523808,0.9761904761904762,42,1900,1500,400,0.7894736842105263,23,15,8,332.7248396965965,0.43240660085172283,0.23003292463090186,0.1941873699239599,131191.27498584607,330.1191878515378,131521.3941736976,1023,3,254.88095238095238,38,4,18,35.36191643202281,0.6285635964912281,43.883547008547,1024.4658119658102,26.959626630679214,0
1141,4,0,1,40,0.0,0.024390243902439025,0.975609756097561,41,1450,1100,350,0.7586206896551724,18,11,7,333.4133869766091,0.4309451219512195,0.22381314777676753,0.19514897765989603,131301.43364800335,555.5311414930503,131856.96478949641,1024,4,257.9512195121951,39,2,19,35.23319188941968,0.6279380341880342,43.776041666666664,1024.8958333333326,26.279380341880323,0
1142,4,0,0,40,0.0,0.0,1.0,40,1250,1000,250,0.8,15,10,5,334.4588202795509,0.4280048076923077,0.2213775669759206,0.19575738028930606,131300.74929003188,782.9387418730125,132083.6880319049,1025,5,264.375,38,2,19,35.20709545154454,0.6296600877192983,43.77670940170939,1024.8931623931603,26.97087269455685,0
1143,4,0,0,40,0.0,0.0,1.0,40,900,600,300,0.6666666666666666,12,6,6,334.4570031066164,0.4277777777777778,0.22134146341463423,0.19589624467673233,131328.12499999988,784.725075790767,132112.85007579066,1026,6,265.375,37,3,20,35.17953929539295,0.6317567567567568,43.74999999999999,1024.999999999999,27.702702702702677,0
1144,4,0,0,40,0.0,0.0,1.0,40,1200,900,300,0.75,15,9,6,336.01231587941703,0.42736378205128206,0.21944028653907877,0.1975313130370952,131468.65051025298,835.0171446983495,132303.66765495134,1027,7,266.375,37,3,20,34.998017570120105,0.6331644144144144,43.61293859649122,1025.5482456140337,27.71752015173064,0
1145,4,0,0,40,0.0,0.0,1.0,40,1050,900,150,0.8571428571428571,12,9,3,337.429059420832,0.42704326923076924,0.22310796365579955,0.19865631534813585,131524.88175448187,876.0634281701775,132400.94518265204,1028,8,267.375,37,3,20,34.905019597363264,0.6337274774774775,43.558114035087705,1025.767543859647,27.72344713134181,0
1146,4,0,0,40,0.0,0.0,1.0,40,950,700,250,0.7368421052631579,12,7,5,332.875061547471,0.4265090811965812,0.21688443519000544,0.19651290511146002,131629.44614517112,763.2319974066589,132392.6781425778,1029,9,268.375,38,2,17,34.916493145930936,0.6329495614035088,43.45619658119657,1026.1752136752123,27.004610886189795,0
1147,4,0,1,39,0.0,0.025,0.975,40,1400,1200,200,0.8571428571428571,16,12,4,332.4008702815202,0.42545405982905987,0.2086247268186081,0.1967985189485596,131739.1030777447,758.0385026298278,132497.1415803745,1030,10,269.375,38,2,17,34.81826933083568,0.634046052631579,43.349358974358964,1026.6025641025624,27.01585695006743,0
1148,4,0,0,39,0.0,0.0,1.0,39,600,400,200,0.6666666666666666,8,4,4,341.6286481169978,0.4266194331983806,0.2143236830135744,0.20157382654973888,131609.2511638193,1192.2981109571806,132801.54927477648,1031,11,268.2564102564103,37,2,17,34.71227826458643,0.634572072072072,43.47587719298244,1026.0964912280676,27.732337600758584,0
1149,4,0,0,39,0.0,0.0,1.0,39,1200,800,400,0.6666666666666666,16,8,8,344.1721327793229,0.42676000899685107,0.21596074436740853,0.20397644628769473,131778.0711372729,1270.8679593721045,133048.93909664502,1032,12,269.2564102564103,37,2,17,34.47689733732024,0.6362612612612613,43.311403508771924,1026.7543859649115,27.750118539592204,0
1150,4,0,0,39,0.0,0.0,1.0,39,1300,1100,200,0.8461538461538461,15,11,4,346.8928875376395,0.42571974808816915,0.2212113249687977,0.20619876716069815,131890.67790089242,1350.3876192674497,133241.06552015987,1033,13,270.2564102564103,37,2,18,34.29360589239965,0.6373873873873874,43.201754385964904,1027.1929824561391,27.761972498814572,0
1151,4,0,1,38,0.0,0.02564102564102564,0.9743589743589743,39,1300,900,400,0.6923076923076923,17,9,8,343.5949333119371,0.425410481331534,0.22194683583779962,0.204997791848045,132031.50398439908,1273.071161318875,133304.57514571794,1034,14,271.2564102564103,37,2,18,34.23652601443863,0.638795045045045,43.064692982456144,1027.7412280701758,27.776789947842587,0
1152,4,0,0,38,0.0,0.0,1.0,38,1350,1000,350,0.7407407407407407,17,10,7,343.03750886728403,0.42569049312470364,0.20252887497053584,0.20542820933316686,132172.40521121895,1468.018524930766,133640.4237361497,1035,15,253.89473684210526,37,1,18,34.10908509277032,0.6402027027027026,42.92763157894738,1028.2894736842115,27.79160739687058,0
1153,4,0,0,38,0.0,0.0,1.0,38,850,600,250,0.7058823529411765,11,6,5,341.6453382682251,0.4251866998577525,0.2004005430331317,0.20520592596878928,132285.18029586034,1438.9230340104764,133724.10332987082,1036,16,254.89473684210526,37,1,18,34.031478718112695,0.6413288288288288,42.817982456140356,1028.7280701754394,27.803461356092956,0
1154,4,0,0,38,0.0,0.0,1.0,38,1200,900,300,0.75,15,9,6,340.5689901150422,0.42474217638691325,0.20136178041010444,0.2048653463615102,132341.58587257628,1414.288050169299,133755.87392274558,1037,17,255.89473684210526,37,1,18,34.00246874111965,0.6418918918918919,42.76315789473685,1028.9473684210536,27.809388335704153,0
1155,4,0,0,38,0.0,0.0,1.0,38,1100,600,500,0.5454545454545454,16,6,10,337.3297080881247,0.4235864153627311,0.19092682708048292,0.20352514778478914,132454.4330947986,1336.1630501693064,133790.5961449679,1038,18,256.89473684210526,37,1,19,33.97244709558303,0.6430180180180181,42.653508771929836,1029.3859649122824,27.82124229492655,0
1156,4,0,0,38,0.0,0.0,1.0,38,1100,700,400,0.6363636363636364,15,7,8,336.1170952920184,0.42306780464675203,0.19013879316624305,0.20355563353178166,132595.55975155847,1313.5268784626373,133909.0866300211,1039,19,257.89473684210526,37,1,19,33.86198498882148,0.6444256756756757,42.51644736842107,1029.934210526318,27.836059743954543,0
1157,4,0,0,38,0.0,0.0,1.0,38,1100,800,300,0.7272727272727273,14,8,6,336.4941743207796,0.42274182076813654,0.18972180371115033,0.2043979157137926,132708.51518015185,1331.1284481763887,134039.64362832825,1040,20,258.89473684210526,37,1,18,33.738937072115206,0.6455518018018018,42.40679824561405,1030.372807017546,27.847913703176918,0
1158,4,0,0,38,0.0,0.0,1.0,38,1350,1000,350,0.7407407407407407,17,10,7,336.1390796577464,0.4221194879089616,0.1900454135658325,0.20449004593547973,132765.01092884364,1325.5017168744394,134090.5126457181,1041,21,259.89473684210526,37,1,18,33.69141664006809,0.6461148648648649,42.351973684210535,1030.592105263159,27.853840682788082,0
1159,4,0,0,38,0.0,0.0,1.0,38,1050,900,150,0.8571428571428571,12,9,3,338.48111991813704,0.421274893314367,0.195742227297663,0.20638128984891874,132849.77709487555,1393.4282663896806,134243.20536126522,1042,22,260.89473684210526,37,1,18,33.54605403105723,0.6469594594594594,42.269736842105274,1030.9210526315806,27.86273115220488,0
1160,4,0,0,38,0.0,0.0,1.0,38,1000,600,400,0.6,14,6,8,339.3435483891392,0.4214230678046467,0.1922362264657813,0.20721991747087465,132906.30290089283,1420.17928593416,134326.482186827,1043,23,261.89473684210526,37,1,19,33.467141641854525,0.6475225225225225,42.21491228070177,1031.1403508771948,27.868658131816076,0
1161,4,0,0,38,0.0,0.0,1.0,38,1250,1000,250,0.8,15,10,5,339.91693385666235,0.4208303698435278,0.19027543878298858,0.20804154826217483,132991.1141529126,1441.1863506078976,134432.3005035205,1044,24,262.89473684210526,37,1,19,33.36732840792318,0.6483671171171171,42.1326754385965,1031.4692982456154,27.87754860123285,0
1162,4,1,0,39,0.02564102564102564,0.0,1.0,39,1100,900,200,0.8181818181818182,13,9,4,356.9923223196069,0.423301844354476,0.19114419157328366,0.20517154307419086,130598.60365689448,1542.724444059717,132141.3281009542,1045,0,257.12820512820514,37,2,16,35.34023457054995,0.6244369369369369,44.46271929824562,1022.149122807018,27.625651967757243,8
1163,4,1,0,40,0.025,0.0,1.0,40,1000,800,200,0.8,12,8,4,353.200700806264,0.42520032051282053,0.1969118721937977,0.20438689496202986,130863.12601587057,1244.1895637007976,132107.31557957135,1046,0,251.675,38,2,17,35.16932929588249,0.6252741228070176,44.20405982905984,1023.183760683762,26.925888439046368,0
1164,4,0,0,40,0.0,0.0,1.0,40,1250,700,550,0.56,18,7,11,355.1173688842717,0.42482638888888885,0.19989821484497394,0.20578761503584023,130917.78897518084,1298.236152202506,132216.02512738336,1047,1,252.675,38,2,17,35.064985906670856,0.6258223684210527,44.15064102564103,1023.3974358974361,26.93151147098516,0
1165,4,0,1,39,0.0,0.025,0.975,40,1700,1500,200,0.8823529411764706,19,15,4,358.82423429787883,0.424866452991453,0.20508448060075124,0.20927048409051455,131163.91354372105,1412.9581689677661,132576.87171268882,1048,2,253.675,38,2,18,34.72113579474342,0.6282894736842105,43.9102564102564,1024.358974358973,26.956815114709816,0
1166,4,0,0,39,0.0,0.0,1.0,39,1600,1200,400,0.75,20,12,8,364.92709686625693,0.42338618983355825,0.2165236069162466,0.21358632275572306,131300.02891514672,1782.987674091996,133083.01658923872,1049,3,259.12820512820514,37,2,18,34.427155771905404,0.6314752252252251,43.77741228070174,1024.890350877191,27.699739212897054,0
1167,4,1,2,38,0.025,0.05,0.95,40,1600,1300,300,0.8125,19,13,6,359.5921955735571,0.42533386752136754,0.21884395917919508,0.21237612950497886,131645.74361100953,1467.7624080643568,133113.5060190739,1050,0,253.625,36,4,17,34.21462928417279,0.6368634259259259,43.44031531531531,1026.2387387387378,28.506631631631606,0
1168,4,1,0,39,0.02564102564102564,0.0,1.0,39,1250,800,450,0.64,17,8,9,357.14493064356486,0.42276765632028795,0.21617062906395224,0.21221621579152813,131876.97991488117,1619.8389690366112,133496.8188839178,1051,0,256.15384615384613,36,3,18,34.044147206081206,0.6391782407407407,43.215090090090094,1027.13963963964,28.53165665665667,0
1169,4,0,0,39,0.0,0.0,1.0,39,650,300,350,0.46153846153846156,10,3,7,353.8996832765034,0.4222053531264058,0.21169302712485538,0.2107689758625861,131963.7458404351,1540.3855713822,133504.1314118173,1052,1,257.15384615384613,36,3,18,34.040031784305114,0.6400462962962963,43.130630630630634,1027.477477477478,28.541041041041055,0
1170,4,0,0,39,0.0,0.0,1.0,39,950,500,450,0.5263157894736842,14,5,9,357.0295920313738,0.42153058929374715,0.21147527171623604,0.213609447919164,132137.36329234642,1635.3897816735735,133772.75307402,1053,2,258.15384615384613,36,3,20,33.7846841913107,0.6417824074074074,42.961711711711715,1028.1531531531532,28.55980980980981,0
1171,4,0,0,39,0.0,0.0,1.0,39,900,500,400,0.5555555555555556,13,5,8,356.5753577884034,0.42102451641925326,0.20925570268540072,0.21366444667478335,132195.26113951782,1627.5145077509926,133822.7756472688,1054,3,259.15384615384613,36,3,20,33.73804570010221,0.6423611111111112,42.9054054054054,1028.3783783783779,28.566066066066053,0
1172,4,0,0,39,0.0,0.0,1.0,39,1000,700,300,0.7,13,7,6,360.35207892299024,0.4211932073774179,0.17024326867075823,0.20693127742835263,130566.58340419496,1637.0821930245083,132203.66559721946,1055,4,260.15384615384613,34,5,15,35.28683750728014,0.6302083333333333,44.49404761904761,1022.0238095238091,30.059523809523796,8
1173,4,0,1,38,0.0,0.02564102564102564,0.9743589743589743,39,1200,1000,200,0.8333333333333334,14,10,4,362.1451155403108,0.4209964012595591,0.1745619533745264,0.20878030486518578,130718.71456916087,1667.8287981859244,132386.5433673468,1056,5,261.15384615384613,34,5,16,35.08682576639504,0.6317401960784313,44.34523809523809,1022.6190476190466,30.0770308123249,0
1174,4,1,0,39,0.02564102564102564,0.0,1.0,39,1500,1100,400,0.7333333333333333,19,11,8,364.76918343621765,0.42029352226720645,0.18139303215492575,0.21145790087667982,130931.84700963716,1751.9805839002215,132683.82759353737,1057,0,261.97435897435895,34,5,17,34.80380752975843,0.6338848039215687,44.13690476190476,1023.4523809523807,30.101540616246492,0
1175,4,0,0,39,0.0,0.0,1.0,39,850,400,450,0.47058823529411764,13,4,9,361.6632955108337,0.41970310391363025,0.1756836513869766,0.2104890167783619,131084.1907596371,1681.668083900217,132765.8588435373,1058,1,262.97435897435895,34,5,17,34.72908432147563,0.6354166666666667,43.988095238095234,1024.0476190476184,30.1190476190476,0
1176,4,0,3,36,0.0,0.07692307692307693,0.9230769230769231,39,1600,1300,300,0.8125,19,13,6,361.28147720206687,0.41930949167791276,0.1738189750742054,0.21060066597876587,131145.1530612245,1676.062925170073,132821.21598639456,1059,2,263.97435897435895,34,5,17,34.67718503021851,0.6360294117647058,43.92857142857143,1024.2857142857144,30.12605042016807,0
1177,4,1,0,37,0.02702702702702703,0.0,1.0,37,550,400,150,0.7272727272727273,7,4,3,375.40506965546604,0.4191691691691692,0.184516412964689,0.21773494040017025,130951.5570934256,2431.9756824298343,133383.53277585542,1060,0,258.7837837837838,33,4,18,34.51169380587484,0.6363636363636364,44.11764705882353,1023.5294117647059,31.016042780748663,0
1178,4,0,0,37,0.0,0.0,1.0,37,1300,900,400,0.6923076923076923,17,9,8,375.4662378168622,0.41920045045045046,0.18900806023831374,0.2184816074650211,131077.01965590165,2442.999086889668,133520.01874279132,1061,1,259.7837837837838,33,4,18,34.38297829902664,0.6376262626262627,43.99509803921569,1024.019607843138,31.030897207367815,0
1179,4,0,1,36,0.0,0.02702702702702703,0.972972972972973,37,1000,600,400,0.6,14,6,8,377.26506465844864,0.41816816816816815,0.19432583140761617,0.22061804868070148,131267.12018140592,2504.49971655329,133771.6198979592,1062,2,260.7837837837838,34,3,19,34.14435215303594,0.6372549019607843,43.80952380952381,1024.7619047619048,30.140056022408967,0
1180,4,0,0,36,0.0,0.0,1.0,36,750,500,250,0.6666666666666666,10,5,5,384.25794980458875,0.416005291005291,0.1979204051521315,0.22414600156430967,131171.15600069688,2880.711895665134,134051.867896362,1063,3,267.02777777777777,33,3,20,34.06246261514535,0.6385732323232323,43.90318627450981,1024.3872549019611,31.042038027332154,0
1181,4,0,0,36,0.0,0.0,1.0,36,850,500,350,0.5882352941176471,12,5,7,383.6286264832563,0.4150958994708995,0.19703217563015407,0.2245179364646061,131297.62081916112,2873.905187074845,134171.52600623597,1064,4,268.02777777777777,34,2,20,33.95042010299299,0.6375612745098039,43.77976190476191,1024.8809523809534,30.14355742296922,0
1182,4,0,0,36,0.0,0.0,1.0,36,800,300,500,0.375,13,3,10,383.70017846519914,0.4145337301587302,0.1957994579945801,0.2247386759581882,131328.12500000012,2878.1250000000146,134206.25000000012,1065,5,269.02777777777777,34,2,20,33.917682926829265,0.6378676470588236,43.75000000000001,1025.000000000001,30.147058823529438,0
1183,4,1,0,37,0.02702702702702703,0.0,1.0,37,700,600,100,0.8571428571428571,8,6,2,356.8906800736983,0.4193255755755756,0.18029150624161105,0.2038221207504784,130353.74858276652,2012.9145408163358,132366.66312358287,1066,0,262.72972972972974,34,3,19,35.591046864070876,0.6280637254901961,44.702380952380956,1021.1904761904768,30.03501400560226,7
1184,4,0,0,37,0.0,0.0,1.0,37,750,400,350,0.5333333333333333,11,4,7,357.2725702429459,0.4187937937937938,0.18081865523292295,0.20419995870181437,130384.14292800457,1916.5355725623663,132300.67850056692,1067,1,263.72972972972974,34,3,19,35.550472082993366,0.6283700980392157,44.67261904761905,1021.3095238095241,30.038515406162475,0
1185,4,0,0,37,0.0,0.0,1.0,37,550,300,250,0.5454545454545454,8,3,5,357.340995636487,0.4189189189189189,0.18341590629202775,0.20455924506715767,130444.94224773237,1922.6651077097433,132367.6073554421,1068,2,264.72972972972974,34,3,20,35.48707415608127,0.6289828431372548,44.613095238095234,1021.5476190476186,30.0455182072829,0
1186,4,0,0,37,0.0,0.0,1.0,37,1150,800,350,0.6956521739130435,15,8,7,357.2721677695439,0.41844969969969975,0.18731983031004917,0.20564700916922535,130657.85147392284,1936.082766439898,132593.93424036275,1069,3,265.72972972972974,34,3,18,35.27305542617606,0.6311274509803921,44.4047619047619,1022.3809523809518,30.070028011204467,0
1187,4,0,0,37,0.0,0.0,1.0,37,1350,1000,350,0.7407407407407407,17,10,7,356.8327784851224,0.4183871371371371,0.18364792532816776,0.20636748979146305,130840.48327664395,1937.634637188207,132778.11791383216,1070,4,266.72972972972974,34,3,18,35.09934256457994,0.6329656862745099,44.226190476190474,1023.0952380952378,30.09103641456582,0
1188,4,0,0,37,0.0,0.0,1.0,37,700,400,300,0.5714285714285714,10,4,6,356.39387457228713,0.41804304304304307,0.18263289467477972,0.2062764546766874,130870.93431122445,1928.3198696145105,132799.25418083897,1071,5,267.72972972972974,34,3,18,35.07974597634284,0.6332720588235294,44.19642857142857,1023.2142857142853,30.09453781512604,0
1189,4,0,0,37,0.0,0.0,1.0,37,900,600,300,0.6666666666666666,12,6,6,355.0198927018572,0.4174486986986987,0.18244972117965808,0.20596903086710988,130962.30867346938,1898.844954648521,132861.1536281179,1072,6,268.72972972972974,34,3,18,35.02243738853997,0.6341911764705883,44.107142857142854,1023.5714285714286,30.10504201680672,0
1190,4,1,0,38,0.02631578947368421,0.0,1.0,38,1700,1200,500,0.7058823529411765,22,12,10,345.58754440439037,0.4184595779990517,0.17863820219226967,0.2030621492155132,131450.1771541952,1486.018990929733,132936.19614512494,1073,0,262.63157894736844,34,4,22,34.7711574181565,0.639093137254902,43.630952380952394,1025.4761904761922,30.16106442577036,0
1191,4,0,0,38,0.0,0.0,1.0,38,750,600,150,0.8,9,6,3,345.58754440439037,0.41834103840682785,0.17863820219226967,0.2030621492155132,131450.1771541952,1485.5087868481005,132935.6859410433,1074,1,263.63157894736844,34,4,22,34.7711574181565,0.639093137254902,43.630952380952394,1025.4761904761922,30.16106442577036,0
1192,4,0,0,38,0.0,0.0,1.0,38,1400,1000,400,0.7142857142857143,18,10,8,343.9836671852539,0.4181484115694642,0.17563194529246506,0.20309172679019816,131633.36167800476,1455.9452947846032,133089.30697278937,1075,2,264.63157894736844,34,4,19,34.6275618716164,0.6409313725490196,43.45238095238096,1026.190476190478,30.182072829131705,0
1193,4,0,0,38,0.0,0.0,1.0,38,1100,800,300,0.7272727272727273,14,8,6,344.91455164290016,0.4173630867709815,0.18191662650308404,0.20478856414475563,131847.2381660998,1495.2062074829967,133342.44437358278,1076,3,265.63157894736844,34,4,21,34.38816119933543,0.6430759803921569,43.24404761904762,1027.0238095238096,30.206582633053223,0
1194,4,0,1,37,0.0,0.02631578947368421,0.9736842105263158,38,650,400,250,0.6153846153846154,9,4,5,344.6208238970788,0.4174223565670934,0.18357019619003578,0.20517766959989087,131951.69331114984,1494.6602527006394,133446.35356385048,1077,4,266.63157894736844,35,3,21,34.2905119972964,0.6419642857142858,43.14236111111112,1027.4305555555568,29.355158730158767,0
1195,4,0,0,37,0.0,0.0,1.0,37,1650,1000,650,0.6060606060606061,23,10,13,351.7666867855411,0.41688563563563563,0.18423334721261275,0.20986881872975646,132030.6990504535,1888.8003117913831,133919.49936224488,1078,5,270.1081081081081,34,3,22,34.0273755743465,0.6449142156862745,43.06547619047619,1027.7380952380952,30.227591036414566,0
1196,4,0,0,37,0.0,0.0,1.0,37,1150,900,250,0.782608695652174,14,9,5,352.4087965687018,0.4167292292292292,0.1873836323297946,0.2109324169067135,132153.0771683673,1914.3813775510168,134067.4585459183,1079,6,271.1081081081081,34,3,22,33.8876345953456,0.6461397058823529,42.94642857142857,1028.2142857142853,30.24159663865545,0
1197,4,0,0,37,0.0,0.0,1.0,37,1000,800,200,0.8,12,8,4,355.2976732426693,0.4166353853853854,0.19235209280353405,0.21300600965603184,132214.2874858276,1995.08574263038,134209.373228458,1080,7,272.1081081081081,34,3,22,33.75173631207316,0.6467524509803921,42.88690476190476,1028.4523809523805,30.248599439775898,0
1198,4,0,0,37,0.0,0.0,1.0,37,1000,600,400,0.6,14,6,8,355.70407744031866,0.4161036036036036,0.19352639692799412,0.21394226453143156,132336.75063775503,2014.5443594104213,134351.29499716545,1081,8,273.1081081081081,34,3,23,33.618004936557526,0.6479779411764706,42.76785714285714,1028.9285714285706,30.262605042016784,0
1199,4,0,0,37,0.0,0.0,1.0,37,600,300,300,0.5,9,3,6,356.17695749807416,0.41541541541541543,0.19564503775030095,0.21457489878542507,132398.00347222216,2031.4377834467027,134429.44125566888,1082,9,274.1081081081081,33,4,23,33.54419703103914,0.6508838383838385,42.70833333333333,1029.166666666666,31.186868686868667,0
1200,4,0,0,37,0.0,0.0,1.0,37,400,200,200,0.5,6,2,4,359.4183673469387,0.41550925925925924,0.19957528957528958,0.21689039408867003,132461.07266436,2121.7884948097058,134582.8611591697,1083,10,275.1081081081081,33,4,23,33.39732142857144,0.6515151515151515,42.64705882352942,1029.4117647058833,31.194295900178282,0
1201,4,0,0,37,0.0,0.0,1.0,37,800,600,200,0.75,10,6,4,359.4183673469387,0.41550925925925924,0.19957528957528958,0.21689039408867003,132461.07266436,2121.7884948097058,134582.8611591697,1084,11,276.1081081081081,33,4,23,33.39732142857144,0.6515151515151515,42.64705882352942,1029.4117647058833,31.194295900178282,0
1202,4,0,0,37,0.0,0.0,1.0,37,1550,1100,450,0.7096774193548387,20,11,9,357.5165769504214,0.41566566566566565,0.19736643246458785,0.2166493748571229,132618.8113496013,2082.6846945886446,134701.49604418996,1085,12,277.1081081081081,33,4,24,33.28760162601626,0.6530934343434344,42.49387254901962,1030.0245098039231,31.212863933452216,0
1203,4,0,0,37,0.0,0.0,1.0,37,1300,1000,300,0.7692307692307693,16,10,6,360.2749119515441,0.41519644644644643,0.19931227303403287,0.21924110054359536,132776.64389898127,2167.2187379854095,134943.8626369667,1086,13,278.1081081081081,33,4,21,33.057867617915186,0.6546717171717171,42.340686274509814,1030.6372549019618,31.231431966726117,0
1204,4,0,1,36,0.0,0.02702702702702703,0.972972972972973,37,850,500,350,0.5882352941176471,12,5,7,359.01109601564826,0.414695945945946,0.19528844323949923,0.2194857533368782,132949.91673752852,2146.099064625871,135096.01580215438,1087,14,279.1081081081081,34,3,22,32.91632998576321,0.6541053921568627,42.17261904761906,1031.3095238095252,30.33263305322133,0
1205,4,0,0,36,0.0,0.0,1.0,36,1000,800,200,0.8,12,8,4,372.05512758743725,0.4162037037037037,0.14284685352101056,0.21446793440075865,130714.10323245091,2553.388073166226,133267.49130561715,1088,15,280.1111111111111,32,4,20,34.83814874264311,0.6363932291666667,44.34974747474748,1022.6010101010113,31.956281565656603,8
1206,4,0,0,36,0.0,0.0,1.0,36,850,600,250,0.7058823529411765,11,6,5,358.48454589698827,0.41610449735449734,0.10026696285903602,0.200793603212635,129595.0414540815,2102.340878768079,131697.38233284958,1089,16,281.1111111111111,34,2,16,36.32107642542576,0.6204044117647058,45.44642857142856,1018.2142857142845,29.947478991596604,8
1207,4,0,0,36,0.0,0.0,1.0,36,1250,900,350,0.72,16,9,7,359.4370032598209,0.4156746031746032,0.10222832366190238,0.20226307106514155,129776.92920918352,2129.3261054421546,131906.25531462568,1090,17,282.1111111111111,34,2,16,36.11184133660473,0.6222426470588236,45.26785714285713,1018.9285714285702,29.968487394957947,0
1208,4,0,0,36,0.0,0.0,1.0,36,1100,800,300,0.7272727272727273,14,8,6,359.1789904668117,0.41549272486772487,0.09667081841299452,0.20290296004998506,129928.59977324259,2133.524659863934,132062.1244331065,1091,18,283.1111111111111,34,2,17,35.964259302506605,0.6237745098039216,45.11904761904761,1019.5238095238092,29.985994397759093,0
1209,4,1,0,37,0.02702702702702703,0.0,1.0,37,500,300,200,0.6,7,3,4,351.36433286807244,0.41619744744744747,0.10321639398527549,0.1998923024019782,130203.51750042863,1749.7744127228962,131953.29191315154,1092,0,276.43243243243245,35,2,18,35.88445981704089,0.6244047619047619,44.84953703703703,1020.6018518518515,29.1600529100529,0
1210,4,1,0,38,0.02631578947368421,0.0,1.0,38,900,700,200,0.7777777777777778,11,7,4,356.00841348825685,0.420074679943101,0.0873265543594568,0.19362125255636234,128429.74044568201,1549.2495549384257,129978.99000062043,1093,0,270.13157894736844,36,2,15,37.57198274265821,0.6044560185185186,46.59346846846846,1013.6261261261249,28.156281281281245,8
1211,4,0,0,38,0.0,0.0,1.0,38,1450,1100,350,0.7586206896551724,18,11,7,374.05564768748843,0.42057847321005215,0.007331762241424622,0.19278252611585958,126253.1250000001,1992.2517957146465,128245.37679571475,1094,1,271.13157894736844,34,4,18,39.35185185185186,0.5863970588235294,48.75000000000001,1005.0000000000008,29.55882352941179,8
1212,4,4,1,41,0.09523809523809523,0.023809523809523808,0.9761904761904762,42,1050,800,250,0.7619047619047619,13,8,5,347.6228736147898,0.4310757839721255,0.04927525271622679,0.18373240298218735,127280.60766171737,449.13011816056024,127729.73777987793,1095,0,246.21428571428572,38,4,18,38.96020822304569,0.5890899122807017,47.72970085470085,1009.0811965811961,26.55476833108411,0
1213,4,0,4,37,0.0,0.0975609756097561,0.9024390243902439,41,1500,800,700,0.5333333333333333,22,8,14,349.95406985280874,0.43089430894308944,0.04152117124038912,0.18536692560787998,127368.57133925815,714.6299823022331,128083.20132156038,1096,1,252.6829268292683,37,4,14,38.811191976247365,0.5917792792792793,47.642543859649116,1009.4298245614028,27.281887150308183,0
1214,4,1,0,38,0.02631578947368421,0.0,1.0,38,950,700,250,0.7368421052631579,12,7,5,373.08200503782734,0.42549786628733993,0.05400612655505155,0.1961326098904355,127062.83925165041,1880.9717667609805,128943.81101841139,1097,0,273.36842105263156,35,3,18,38.54190582788046,0.5925595238095238,47.945601851851855,1008.2175925925928,28.806216931216937,0
1215,4,1,1,38,0.02564102564102564,0.02564102564102564,0.9743589743589743,39,1400,1000,400,0.7142857142857143,18,10,8,362.2259698808127,0.429880791722897,0.05289498218340438,0.19217266544090963,127432.89531085163,1431.9008197386802,128864.79613059032,1098,0,267.3333333333333,36,3,16,38.43547847423598,0.5943287037037037,47.57882882882884,1009.6846846846867,28.04679679679685,0
1216,4,0,0,38,0.0,0.0,1.0,38,1050,500,550,0.47619047619047616,16,5,11,369.96044104031625,0.4268610715979137,0.05468372766779339,0.19575576734657524,127325.5315500687,1821.0819615912324,129146.61351165993,1099,2,275.36842105263156,35,3,16,38.35053516819572,0.5952380952380952,47.68518518518519,1009.2592592592601,28.83597883597886,0
1217,4,0,0,38,0.0,0.0,1.0,38,1000,800,200,0.8,12,8,4,371.9269137242726,0.4270240635372214,0.059470727719217686,0.19722300719859143,127413.15593117708,1877.6763706704319,129290.83230184752,1100,3,276.36842105263156,35,3,16,38.210884061293896,0.5961309523809524,47.598379629629626,1009.6064814814811,28.845899470899457,0
1218,4,1,1,38,0.02564102564102564,0.02564102564102564,0.9743589743589743,39,1550,1400,150,0.9032258064516129,17,14,3,368.7450800758442,0.4284750337381917,0.09146992187277081,0.19841576584200848,128002.04554216402,1640.0249066634444,129642.07044882746,1101,0,270.2564102564103,36,3,19,37.68709659470287,0.6001157407407407,47.01576576576578,1011.9369369369388,28.10935935935941,0
1219,4,1,0,39,0.02564102564102564,0.0,1.0,39,700,400,300,0.5714285714285714,10,4,6,350.88657688985927,0.43041497975708504,0.08724791003271992,0.19242804207299413,128760.50407503855,1241.7383485329285,130002.24242357149,1102,0,268.61538461538464,35,4,19,37.3642234006158,0.6098214285714285,46.26736111111111,1014.9305555555553,28.998015873015866,8
1220,4,1,0,40,0.025,0.0,1.0,40,1350,1100,250,0.8148148148148148,16,11,5,373.8061387284618,0.43341346153846155,0.1853892482712467,0.19831632188398787,127432.89531085161,1561.0988328559647,128993.99414370758,1103,0,262.875,36,4,16,38.14317049594763,0.5943287037037037,47.57882882882884,1009.6846846846865,28.046796796796848,8
1221,4,1,0,41,0.024390243902439025,0.0,1.0,41,600,300,300,0.5,9,3,6,375.39913163223724,0.4369156504065041,0.20208757004625189,0.20117990651040848,127839.4088205027,1398.1606119190747,129237.56943242176,1104,0,257.4390243902439,37,4,17,37.68556416928691,0.5965653153153153,47.17653508771931,1011.2938596491247,27.33226647700337,0
1222,4,1,0,42,0.023809523809523808,0.0,1.0,42,1350,1100,250,0.8148148148148148,16,11,5,373.4186861758867,0.44006484707704224,0.2084068195179296,0.20164609053497956,128144.5312500006,1170.3125000000591,129314.84375000065,1105,0,252.28571428571428,39,3,20,37.42283950617283,0.5961538461538461,46.87500000000003,1012.5000000000048,25.961538461538584,0
1223,4,1,0,43,0.023255813953488372,0.0,1.0,43,1450,1100,350,0.7586206896551724,18,11,7,365.4769459177931,0.4422065337763012,0.20234167538424375,0.19928837239668354,128533.39489073571,795.1985226223615,129328.59341335807,1106,0,247.3953488372093,37,6,17,37.22606689734719,0.6036036036036037,46.491228070175445,1014.0350877192991,27.40635372214322,0
1224,4,1,2,42,0.022727272727272728,0.045454545454545456,0.9545454545454546,44,1700,1100,600,0.6470588235294118,23,11,12,359.6013345580278,0.44202563424947144,0.20320732196309144,0.19795332640351318,128910.3203667537,471.2646484375266,129381.58501519123,1107,0,242.75,39,5,20,36.990225493212996,0.6038995726495726,46.11979166666668,1015.5208333333352,26.038995726495774,0
1225,4,0,0,42,0.0,0.0,1.0,42,1200,900,300,0.75,15,9,6,376.4683425624254,0.4355400696864111,0.22307992964627732,0.20691605895724252,128848.62075617262,1301.4853395061484,130150.10609567877,1108,1,254.97619047619048,38,4,21,36.625056999544,0.6049890350877193,46.18055555555554,1015.277777777776,26.717836257309894,0
1226,4,1,1,42,0.023255813953488372,0.023255813953488372,0.9767441860465116,43,1550,1200,350,0.7741935483870968,19,12,7,367.9649152797737,0.4379614248800295,0.22151776542065238,0.20364343042454613,129121.97401258671,902.4712456597135,130024.44525824643,1109,0,250.02325581395348,39,4,22,36.56189146253973,0.6060363247863247,45.91145833333333,1016.3541666666658,26.060363247863226,0
1227,4,0,0,42,0.0,0.0,1.0,42,850,600,250,0.7058823529411765,11,6,5,371.75703923272255,0.43832268679829656,0.21842581312068532,0.20630573492515378,129230.01284646132,1208.4822192864326,130438.49506574776,1110,1,245.38095238095238,36,6,22,36.35530881972902,0.6125578703703703,45.80518018018018,1016.7792792792792,28.243868868868866,0
1228,4,1,0,43,0.023255813953488372,0.0,1.0,43,1000,600,400,0.6,14,6,8,384.5212552660593,0.4402224067921742,0.2562097374071943,0.21139738552616455,128858.98940611775,1493.4019432714072,130352.39134938916,1111,0,240.65116279069767,33,10,21,36.41005330919332,0.6152146464646464,46.170343137254896,1015.3186274509796,30.76723113487817,8
1229,4,0,0,43,0.0,0.0,1.0,43,1600,1200,400,0.75,20,12,8,386.3803236419247,0.44013012181616834,0.2580413499032175,0.21325518528572265,129014.56921616675,1369.7382016531944,130384.30741781995,1112,1,241.65116279069767,33,10,21,36.203759549658216,0.6167929292929293,46.01715686274509,1015.9313725490188,30.785799168152085,0
1230,4,3,3,43,0.06521739130434782,0.06521739130434782,0.9347826086956522,46,1150,600,550,0.5217391304347826,17,6,11,364.33101148335425,0.4418478260869565,0.2711639297317048,0.20539685576968084,129849.38298396756,261.7665729675158,130111.14955693508,1113,0,226.82608695652175,35,11,17,35.913487016428185,0.6208333333333333,45.196759259259245,1019.2129629629612,29.12037037037032,0
1231,4,1,0,44,0.022727272727272728,0.0,1.0,44,1300,800,500,0.6153846153846154,18,8,10,375.72195169883884,0.44113372093023256,0.2648417587085816,0.21159078332513512,129807.25623582734,954.2871315192366,130761.54336734657,1114,0,226.5909090909091,34,10,18,35.66613123052959,0.6225490196078431,45.23809523809522,1019.0476190476164,29.97198879551813,0
1232,4,3,1,46,0.06382978723404255,0.02127659574468085,0.9787234042553191,47,1000,600,400,0.6,14,6,8,339.4228572750899,0.4455750847980265,0.1892173260451253,0.191871924000064,129954.95158366003,-517.3884914942728,129437.56309216576,1115,0,213.06382978723406,37,10,18,36.44108237444887,0.6179617117117118,45.09320175438595,1019.6271929824535,27.55749170222847,8
1233,4,1,1,46,0.02127659574468085,0.02127659574468085,0.9787234042553191,47,1050,800,250,0.7619047619047619,13,8,5,332.74415165610486,0.4455943570767808,0.20912729159381382,0.1894504775392463,130234.60493853856,-733.0393726916207,129501.56556584693,1116,0,214.0212765957447,37,10,19,36.3280830379203,0.620777027027027,44.81907894736841,1020.7236842105245,27.587126600284446,0
1234,4,0,2,44,0.0,0.043478260869565216,0.9565217391304348,46,1450,1200,250,0.8275862068965517,17,12,5,346.7343466539496,0.4446658615136876,0.1360145003918405,0.1885082376335826,128415.1066207355,-294.81438107240854,128120.29223966309,1117,1,219.3695652173913,38,8,16,37.821931766276656,0.6006030701754386,46.607905982905976,1013.5683760683751,26.672852001799345,8
1235,4,1,0,45,0.022222222222222223,0.0,1.0,45,1550,1000,550,0.6451612903225806,21,10,11,347.7428382508391,0.44396043771043775,0.1525059178352144,0.18948603566915176,128505.59937913569,-62.619628154833805,128442.97975098086,1118,0,225.13333333333333,37,8,17,37.70400760607045,0.603322072072072,46.518640350877185,1013.9254385964896,27.403390232337557,0
1236,4,1,1,45,0.021739130434782608,0.021739130434782608,0.9782608695652174,46,1400,1200,200,0.8571428571428571,16,12,4,344.07763463034394,0.4448772141706924,0.1660721531347953,0.1896608827179471,128963.21750217018,-325.3282335069405,128637.88926866325,1119,0,221.2173913043478,39,7,19,37.3304661060404,0.6044337606837606,46.067708333333336,1015.7291666666671,26.04433760683762,0
1237,4,0,0,45,0.0,0.0,1.0,45,800,700,100,0.875,9,7,2,352.1204308539511,0.4450126262626262,0.16843458244236476,0.19433042234417988,129011.37689248659,85.50832328876339,129096.88521577536,1120,1,224.46666666666667,38,7,19,37.07715497598766,0.6066337719298245,46.02029914529914,1015.9188034188028,26.73470535312639,0
1238,4,0,0,45,0.0,0.0,1.0,45,1500,1000,500,0.6666666666666666,20,10,10,349.9756992398294,0.44417087542087547,0.1621920880199026,0.19367765135942375,129119.93805473362,37.76812130176401,129157.70617603538,1121,2,225.46666666666667,38,7,20,37.02105014191108,0.6077302631578947,45.91346153846153,1016.346153846153,26.745951417004026,0
1239,4,2,4,43,0.0425531914893617,0.0851063829787234,0.9148936170212766,47,1300,900,400,0.6923076923076923,17,9,8,336.89619207132705,0.4484851988899168,0.17275658548014539,0.18929317568651166,129717.84056770033,-659.659329571193,129058.18123812914,1122,0,216.82978723404256,38,9,17,36.745979723824505,0.6137609649122807,45.3258547008547,1018.6965811965812,26.807804768331085,0
1240,4,0,0,43,0.0,0.0,1.0,43,1000,700,300,0.7,13,7,6,352.7112496181075,0.443936877076412,0.17142433925132794,0.19676632656360418,129436.83556241432,530.7656035665354,129967.60116598086,1123,1,229.2093023255814,35,8,17,36.628942978465275,0.6166666666666667,45.601851851851855,1017.592592592593,29.074074074074083,0
1241,4,0,0,43,0.0,0.0,1.0,43,1300,900,400,0.6923076923076923,17,9,8,351.91877652847467,0.44345238095238093,0.1725398944960801,0.19676577492485314,129525.18332315267,516.4688089420758,130041.65213209475,1124,2,230.2093023255814,35,8,18,36.55924294106501,0.6175595238095238,45.51504629629631,1017.9398148148167,29.083994708994762,0
1242,4,0,0,43,0.0,0.0,1.0,43,1100,900,200,0.8181818181818182,13,9,4,351.6781436063937,0.44356773717238834,0.17112599168321152,0.1969263290455409,129584.09857521013,514.3790455675692,130098.47762077769,1125,3,231.2093023255814,35,8,19,36.505461142056014,0.6181547619047619,45.45717592592593,1018.1712962962969,29.090608465608483,0
1243,4,0,1,42,0.0,0.023255813953488372,0.9767441860465116,43,1400,1100,300,0.7857142857142857,17,11,6,353.7429690407044,0.4433370247323736,0.17370895741323666,0.19838013923449066,129643.02722318676,572.0618730709906,130215.08909625775,1126,4,232.2093023255814,35,8,19,36.392984998295255,0.61875,45.39930555555556,1018.4027777777779,29.09722222222223,0
1244,4,0,1,41,0.0,0.023809523809523808,0.9761904761904762,42,1150,800,350,0.6956521739130435,15,8,7,358.4448771968359,0.4436701509872241,0.1735250565037798,0.20092644033694212,129625.34722222229,892.7083333333426,130518.05555555563,1127,5,226.38095238095238,34,8,19,36.29125750136388,0.6207107843137255,45.41666666666667,1018.3333333333339,29.95098039215688,0
1245,4,0,1,40,0.0,0.024390243902439025,0.975609756097561,41,1150,800,350,0.6956521739130435,15,8,7,359.35781466286943,0.4428861788617886,0.17337523068482197,0.20198387513809557,129731.4453125,1124.0017361111106,130855.44704861111,1128,6,231.26829268292684,33,8,20,36.16010565780503,0.6240530303030303,45.3125,1018.75,30.87121212121212,0
1246,4,0,1,39,0.0,0.025,0.975,40,1200,800,400,0.6666666666666666,16,8,8,361.06462647929004,0.44085202991452993,0.17951923076923104,0.20408000627090297,129950.01922337555,1384.0710303729254,131334.09025374847,1129,7,236.5,33,7,20,35.89443108974359,0.6262626262626263,45.09803921568627,1019.6078431372543,30.897207367795588,0
1247,4,0,0,39,0.0,0.0,1.0,39,1200,900,300,0.75,15,9,6,369.99419741651195,0.4373875393612236,0.18530024649945354,0.20856097496830206,129844.02101826342,1808.3068691970175,131652.32788746044,1130,8,243.28205128205127,32,7,20,35.77464279815,0.6276041666666667,45.2020202020202,1019.191919191919,31.84974747474747,0
1248,4,0,1,38,0.0,0.02564102564102564,0.9743589743589743,39,900,700,200,0.7777777777777778,11,7,4,371.8573992833312,0.43747188484030586,0.18834533470491865,0.21030254598124537,129972.7387511479,1866.2649219467444,131839.00367309464,1131,9,244.28205128205127,32,7,20,35.59621099554233,0.62890625,45.07575757575758,1019.6969696969701,31.865530303030315,0
1249,4,0,0,38,0.0,0.0,1.0,38,1400,1000,400,0.7142857142857143,18,10,8,383.3386784033822,0.43711474632527264,0.20181040799725736,0.2163776866056297,129897.31046888586,2358.9326646593217,132256.24313354518,1132,10,242.94736842105263,31,7,21,35.380343381445066,0.6307123655913979,45.14973958333335,1019.4010416666684,32.88390456989253,0
1250,4,0,0,38,0.0,0.0,1.0,38,1450,1200,250,0.8275862068965517,17,12,5,383.71326286724747,0.43671467520151735,0.19917901723929443,0.21751155581056572,130063.28158908428,2381.40123155383,132444.68282063812,1133,11,243.94736842105263,31,7,22,35.2017913369075,0.6323924731182795,44.98697916666667,1020.0520833333339,32.90490591397852,0
1251,4,0,0,38,0.0,0.0,1.0,38,550,200,350,0.36363636363636365,9,2,7,385.5192129066002,0.4366998577524894,0.19705073494547154,0.2187762404531322,130106.25608239631,2431.692287822008,132537.94837021834,1134,12,244.94736842105263,33,5,22,35.111986986987,0.6278409090909092,44.94485294117648,1020.220588235295,30.915775401069546,0
1252,4,1,0,39,0.02564102564102564,0.0,1.0,39,1100,900,200,0.8181818181818182,13,9,4,372.71745933510545,0.4381747638326586,0.1863916636441163,0.21363870733400828,130495.30241224509,1927.8571064680325,132423.15951871313,1135,0,239.64102564102564,31,8,17,35.04324901236141,0.636760752688172,44.563802083333336,1021.7447916666673,32.95950940860217,0
1253,4,0,0,39,0.0,0.0,1.0,39,1200,700,500,0.5833333333333334,17,7,10,374.79670387133973,0.4376124606387764,0.18738978800109773,0.21575540460394127,130661.6550021701,1994.311523437496,132655.9665256076,1136,1,240.64102564102564,31,8,17,34.82127695703855,0.6384408602150538,44.401041666666664,1022.3958333333329,32.98051075268816,0
1254,4,0,0,39,0.0,0.0,1.0,39,1600,1400,200,0.875,18,14,4,364.76243113403643,0.4373875393612236,0.09145920090377557,0.20135074950180248,129019.90504535145,1612.3228458049841,130632.22789115644,1137,2,241.64102564102564,34,5,18,36.74737325208965,0.6145833333333333,46.01190476190476,1015.9523809523807,29.880952380952376,8
1255,4,0,0,39,0.0,0.0,1.0,39,1200,900,300,0.75,15,9,6,365.664918212394,0.4362910481331534,0.09789307432481764,0.2026268124075367,129171.97312510715,1646.7317976251722,130818.70492273232,1138,3,242.64102564102564,35,4,18,36.569343238832595,0.6139880952380952,45.86226851851852,1016.5509259259259,29.044312169312168,0
1256,4,0,1,38,0.0,0.02564102564102564,0.9743589743589743,39,500,400,100,0.8,6,4,2,364.31414601510926,0.43617858749437693,0.0961763593465772,0.20233884494545282,129261.9118480726,1618.3919544219475,130880.30380249456,1139,4,243.64102564102564,34,5,19,36.51198977600874,0.6170343137254901,45.773809523809526,1016.9047619047622,29.90896358543418,0
1257,4,2,0,40,0.05,0.0,1.0,40,1000,800,200,0.8,12,8,4,353.20394526354767,0.43814102564102564,0.101987285793256,0.19830724301109803,129688.42734203806,1161.2928384465617,130849.72018048463,1140,0,237.55,36,4,17,36.36055831951355,0.6171875,45.35472972972973,1018.5810810810817,28.293918918918937,0
1258,4,0,0,40,0.0,0.0,1.0,40,900,400,500,0.4444444444444444,14,4,10,355.70410018754427,0.4377403846153846,0.10261383731211282,0.20014991906075286,129774.47041636256,1232.2622453534836,131006.73266171604,1141,1,238.55,36,4,17,36.209429339817255,0.6180555555555556,45.27027027027028,1018.9189189189209,28.30330330330336,0
1259,4,0,0,40,0.0,0.0,1.0,40,1100,600,500,0.5454545454545454,16,6,10,351.7597993025085,0.43716613247863245,0.0969184890656063,0.19880357196535053,129946.64216581461,1142.0009536563803,131088.643119471,1142,2,239.55,36,4,18,36.135041602238424,0.6197916666666667,45.10135135135136,1019.5945945945958,28.322072072072107,0
1260,4,0,1,39,0.0,0.025,0.975,40,950,500,450,0.5263157894736842,14,5,9,352.8293106052858,0.43651175213675214,0.09449779249448209,0.20029032293758683,130118.92804967114,1181.9543360928403,131300.88238576398,1143,3,240.55,36,4,18,35.932901030169255,0.6215277777777778,44.93243243243243,1020.2702702702691,28.34084084084081,0
1261,4,0,1,38,0.0,0.02564102564102564,0.9743589743589743,39,1050,700,350,0.6666666666666666,14,7,7,360.1802436284941,0.43488529014844807,0.09716354155754958,0.2039786829597871,130026.38996056227,1566.5873628257684,131592.97732338804,1144,4,247.51282051282053,35,4,18,35.83938568618549,0.6226190476190476,45.02314814814814,1019.9074074074063,29.140211640211607,0
1262,4,0,1,37,0.0,0.02631578947368421,0.9736842105263158,38,900,700,200,0.7777777777777778,11,7,4,362.73778785450384,0.43515884305357994,0.09174544781333793,0.20558251603612457,130055.90284475709,1835.2380990654694,131891.14094382257,1145,5,247.26315789473685,35,3,18,35.74418945497184,0.6229166666666667,44.99421296296295,1020.0231481481458,29.14351851851845,0
1263,4,0,0,37,0.0,0.0,1.0,37,900,600,300,0.6666666666666666,12,6,6,368.0532206337815,0.43321446446446443,0.10476403799620826,0.20840131798873784,130019.64462868468,2170.8297902494182,132190.47441893409,1146,6,254.16216216216216,34,3,19,35.64550017509047,0.6246936274509804,45.0297619047619,1019.8809523809514,29.996498599439747,0
1264,4,0,0,37,0.0,0.0,1.0,37,1050,700,350,0.6666666666666666,14,7,7,368.3523728852363,0.4327452452452452,0.10615259909226538,0.20889553165146174,130080.35891439897,2183.081774376401,132263.44068877536,1147,7,255.16216216216216,34,3,19,35.576156299840505,0.6253063725490196,44.97023809523809,1020.1190476190466,30.003501400560193,0
1265,4,2,2,37,0.05128205128205128,0.05128205128205128,0.9487179487179487,39,550,300,250,0.5454545454545454,8,3,5,351.6249968272799,0.43747188484030586,0.1034000931532375,0.20239647940701608,130657.85147392287,1388.768424036282,132046.61989795914,1148,0,243.02564102564102,34,5,15,35.417394426331335,0.6311274509803921,44.404761904761905,1022.3809523809521,30.07002801120447,0
1266,4,0,0,37,0.0,0.0,1.0,37,1250,1000,250,0.8,15,10,5,368.8858805679613,0.4352477477477477,0.10997227140614019,0.21105281285677577,130423.75299714333,2222.2961942659135,132646.04919140923,1149,1,256.05405405405406,32,5,22,35.21374124433458,0.6334635416666667,44.633838383838395,1021.4646464646479,31.920770202020247,0
1267,4,0,0,37,0.0,0.0,1.0,37,1250,1100,150,0.88,14,11,3,370.96507095335863,0.43455955955955955,0.10064558236331811,0.20495294889235557,129054.34355977773,2174.930743098395,131229.27430287612,1150,2,257.05405405405406,35,2,18,36.55468067737402,0.612797619047619,45.978009259259245,1016.0879629629611,29.0310846560846,8
1268,4,1,0,38,0.02631578947368421,0.0,1.0,38,1100,800,300,0.7272727272727273,14,8,6,364.4768285665197,0.43505512091038406,0.10198060175341461,0.20314917619361533,129401.82317029868,1832.7932239672095,131234.6163942659,1151,0,251.26315789473685,36,2,19,36.365292381479414,0.6142939814814814,45.63626126126126,1017.454954954955,28.26263763763764,0
1269,4,1,1,38,0.02564102564102564,0.02564102564102564,0.9743589743589743,39,900,600,300,0.6666666666666666,12,6,6,356.6220665937904,0.4362629329734593,0.10367892976588688,0.20058911881292338,129759.37307633091,1455.0111572791366,131214.38423361006,1152,0,245.7948717948718,37,2,13,36.20139187831827,0.615990990990991,45.28508771929823,1018.859649122805,27.536747273589324,0
1270,4,0,0,38,0.0,0.0,1.0,38,750,400,350,0.5333333333333333,11,4,7,362.09137981557365,0.4344327880512091,0.10706449303619547,0.2030001455469455,129631.08114448901,1787.659407718518,131418.74055220754,1153,1,253.23684210526315,36,2,13,36.19258911128311,0.6166087962962963,45.41103603603603,1018.3558558558552,28.287662662662644,0
1271,4,1,0,39,0.02564102564102564,0.0,1.0,39,1250,900,350,0.72,16,9,7,366.0707608152149,0.4357849752586595,0.13745727184335021,0.20842524235038734,130234.6049385387,1735.0161828639525,131969.62112140266,1154,0,247.71794871794873,37,2,16,35.477651555842016,0.620777027027027,44.81907894736842,1020.7236842105257,27.587126600284478,0
1272,4,0,0,39,0.0,0.0,1.0,39,1300,1100,200,0.8461538461538461,15,11,4,364.94299114138164,0.4355038236617184,0.14031873140827744,0.2083943982159981,130348.82010388775,1713.9806658250686,132062.8007697128,1155,1,248.71794871794873,36,3,17,35.390475665343324,0.6238425925925926,44.70720720720721,1021.1711711711717,28.36586586586588,0
1273,4,0,1,38,0.0,0.02564102564102564,0.9743589743589743,39,1100,700,400,0.6363636363636364,15,7,8,365.1225851921388,0.4354757085020243,0.14320409623089092,0.208651337435886,130377.57087746548,1720.7591459703149,132098.3300234358,1156,2,249.71794871794873,36,3,17,35.356709670305435,0.6241319444444444,44.67905405405406,1021.2837837837852,28.368993993994035,0
1274,4,0,0,38,0.0,0.0,1.0,38,1550,1100,450,0.7096774193548387,20,11,9,368.6818718745552,0.43452169274537694,0.160988257733802,0.21166846090067098,130558.1342699758,2026.8834662208255,132585.01773619663,1157,3,256.1578947368421,35,3,15,35.082578331445816,0.6279761904761905,44.5023148148148,1021.9907407407392,29.199735449735403,0
1275,4,0,0,38,0.0,0.0,1.0,38,650,400,250,0.6153846153846154,9,4,5,368.10314272211764,0.4339586296823139,0.15532036613272338,0.21165930706521735,130617.28395061711,2016.1265432098594,132633.410493827,1158,4,257.1578947368421,35,3,16,35.03736413043478,0.6285714285714286,44.444444444444436,1022.2222222222208,29.206349206349167,0
1276,4,0,0,38,0.0,0.0,1.0,38,1200,1000,200,0.8333333333333334,14,10,4,369.7927252666121,0.433291844476055,0.15483974702540504,0.21360968012459566,130794.81336805543,2073.3940972222126,132868.20746527764,1159,5,258.1578947368421,35,3,16,34.814154786150716,0.6303571428571428,44.27083333333333,1022.9166666666656,29.226190476190446,0
1277,4,0,1,37,0.0,0.02631578947368421,0.9736842105263158,38,1350,1000,350,0.7407407407407407,17,10,7,372.3764691897168,0.43243243243243246,0.15785010859540072,0.2162619743915324,131002.0834003127,2156.4186546210303,133158.50205493372,1160,6,259.1578947368421,35,3,18,34.53799227435462,0.6324404761904762,44.068287037037024,1023.7268518518499,29.24933862433857,0
1278,4,0,0,37,0.0,0.0,1.0,37,950,700,250,0.7368421052631579,12,7,5,374.494587023137,0.43180680680680683,0.13389788567815009,0.21782732487795475,131061.33355034719,2416.3519965277733,133477.68554687497,1108,7,235.8108108108108,35,2,19,34.4237453374025,0.6330357142857144,44.010416666666664,1023.958333333333,29.255952380952372,0
1279,4,0,0,37,0.0,0.0,1.0,37,850,600,250,0.7058823529411765,11,6,5,375.63383326014184,0.4308058058058058,0.1411903373263672,0.21916513237874208,131179.8740381731,2455.11978630831,133634.9938244814,1109,8,236.8108108108108,35,2,19,34.274493465898395,0.6342261904761906,43.89467592592593,1024.421296296297,29.269179894179914,0
1280,4,1,0,38,0.02631578947368421,0.0,1.0,38,700,500,200,0.7142857142857143,9,5,4,369.0569263816267,0.43271396396396394,0.14859333475883552,0.2170256259916528,131480.6990504535,2104.939983001943,133585.63903345543,1110,0,231.55263157894737,34,4,20,34.138614819113954,0.6393995098039216,43.601190476190474,1025.5952380952378,30.164565826330524,0
1281,4,0,0,38,0.0,0.0,1.0,38,900,600,300,0.6666666666666666,12,6,6,367.09826174051284,0.4322842579421527,0.1429321737855891,0.21639212172912034,131572.2859977324,2059.9914965986336,133632.27749433104,1111,1,232.55263157894737,34,4,17,34.09627137000076,0.6403186274509804,43.51190476190476,1025.9523809523807,30.1750700280112,0
1282,4,0,0,38,0.0,0.0,1.0,38,900,600,300,0.6666666666666666,12,6,6,365.52474796927976,0.4319138217164533,0.14189874844965633,0.21626677716741446,131713.96933138292,2028.943088777441,133742.91242016037,1112,2,233.55263157894737,35,3,17,33.99352144172586,0.6395833333333334,43.373842592592595,1026.50462962963,29.328703703703713,0
1283,4,0,0,38,0.0,0.0,1.0,38,1350,800,550,0.5925925925925926,19,8,11,365.1160007934936,0.43120258416311047,0.1531712379540402,0.21703981962774638,131892.24222232925,2031.193603180712,133923.43582550995,1113,3,234.55263157894737,35,3,18,33.82406103286385,0.6413690476190477,43.200231481481474,1027.199074074073,29.348544973544943,0
1284,4,0,0,38,0.0,0.0,1.0,38,1150,700,450,0.6086956521739131,16,7,9,362.9027015496515,0.4306987908961593,0.1571211788904634,0.21640114755267656,132011.157795889,1981.4411597650892,133992.5989556541,1114,4,235.55263157894737,35,3,18,33.76095750272179,0.6425595238095239,43.08449074074074,1027.6620370370367,29.361772486772477,0
1285,4,0,0,38,0.0,0.0,1.0,38,800,500,300,0.625,11,5,6,360.3253566323627,0.43077287814129916,0.15922800696855788,0.21537078180408115,132100.3796403464,1919.8232810356621,134020.20292138206,1115,5,236.55263157894737,35,3,18,33.73724011108608,0.6434523809523809,42.99768518518518,1028.0092592592594,29.371693121693124,0
1286,4,0,0,38,0.0,0.0,1.0,38,1300,900,400,0.6923076923076923,17,9,8,364.2756102403261,0.4299282835467046,0.1546174751762972,0.21893481402476384,132308.68115837182,2039.3651138117225,134348.04627218354,1116,6,237.55263157894737,35,3,19,33.42579311508607,0.6455357142857143,42.795138888888886,1028.819444444444,29.394841269841255,0
1287,4,0,1,37,0.0,0.02631578947368421,0.9736842105263158,38,1200,700,500,0.5833333333333334,17,7,10,368.6341359471552,0.4295282124229493,0.15821436181546966,0.22207958921694487,132398.0034722223,2161.314863040129,134559.31833526245,1117,7,238.55263157894737,34,4,19,33.22368421052631,0.6485906862745099,42.708333333333336,1029.1666666666672,30.26960784313727,0
1288,4,0,0,37,0.0,0.0,1.0,37,1550,1200,350,0.7741935483870968,19,12,7,374.53490468619395,0.4276463963963964,0.16194331983805688,0.22563444257924378,132398.00347222234,2517.5347222222404,134915.53819444458,1118,8,244.27027027027026,34,3,19,33.07186234817815,0.6485906862745099,42.70833333333334,1029.1666666666677,30.269607843137283,0
1289,4,0,0,37,0.0,0.0,1.0,37,950,700,250,0.7368421052631579,12,7,5,373.4713053939636,0.4274587087087087,0.16411817126017825,0.2255594850190287,132492.61289227713,2496.437818387174,134989.0507106643,1119,9,245.27027027027026,33,4,19,33.003883466254024,0.6518308080808081,42.61642156862746,1029.534313725491,31.198009506833063,0
1290,4,0,0,37,0.0,0.0,1.0,37,1200,900,300,0.75,15,9,6,373.2257611312493,0.42623873873873874,0.17146164606009928,0.22616889129835252,132618.81134960108,2499.3513612552833,135118.16271085636,1120,10,246.27027027027026,33,4,19,32.88308050763433,0.6530934343434344,42.493872549019606,1030.0245098039213,31.212863933452162,0
1291,4,0,0,37,0.0,0.0,1.0,37,800,200,600,0.25,14,2,12,376.0917582584877,0.42520645645645644,0.17945380271459443,0.22867357882831685,132745.069879974,2584.865346261045,135329.93522623504,1121,11,247.27027027027026,33,4,17,32.6821213382487,0.6543560606060606,42.37132352941176,1030.5147058823527,31.227718360071293,0
1292,4,0,0,37,0.0,0.0,1.0,37,1150,600,550,0.5217391304347826,17,6,11,377.97033380070474,0.42464339339339335,0.18074565292824984,0.23039756869069047,132839.80320069203,2641.9009515570965,135481.70415224912,1122,12,248.27027027027026,33,4,17,32.53833808844509,0.6553030303030303,42.279411764705884,1030.8823529411764,31.238859180035647,0
1293,4,1,0,38,0.02631578947368421,0.0,1.0,38,1100,800,300,0.7272727272727273,14,8,6,348.407275950687,0.4269351588430536,0.12332176361855862,0.2011813914469225,130780.41459956583,1523.9179128160304,132304.33251238186,1123,0,242.71052631578948,36,2,16,35.37561011413263,0.6281828703703703,44.28490990990991,1022.8603603603608,28.4127877877878,8
1294,4,0,0,38,0.0,0.0,1.0,38,1350,800,550,0.5925925925925926,19,8,11,349.8628143752478,0.4263720957799905,0.1248552168272794,0.20277763118891942,130924.4379514652,1561.1184664394384,132485.55641790462,1124,1,243.71052631578948,36,2,16,35.192699163732414,0.6296296296296297,44.14414414414416,1023.4234234234251,28.428428428428475,0
1295,4,0,0,38,0.0,0.0,1.0,38,650,300,350,0.46153846153846156,10,3,7,349.42941898245164,0.4255867709815078,0.12467369347155399,0.20328609768441686,131068.54056336755,1559.8407951870943,132628.38135855464,1125,2,244.71052631578948,36,2,18,35.05810330290699,0.6310763888888888,44.003378378378386,1023.9864864864876,28.4440690690691,0
1296,4,0,1,37,0.0,0.02631578947368421,0.9736842105263158,38,1000,600,400,0.6,14,6,8,370.49407455510004,0.4252311522048364,0.12488357789297977,0.19921539556418752,127973.55791179692,1882.9457836214594,129856.50369541837,1126,3,245.71052631578948,36,2,17,37.672046002596936,0.5998263888888888,47.04391891891892,1011.8243243243242,28.106231231231227,8
1297,4,3,0,40,0.075,0.0,1.0,40,1550,1200,350,0.7741935483870968,19,12,7,350.12033240997266,0.4333733974358975,0.13603157894736917,0.19204059803087398,128767.28121119131,1016.808660238134,129784.08987142945,1127,0,228.85,38,2,16,37.376754385964915,0.6041666666666667,46.260683760683754,1014.9572649572636,26.709401709401675,0
1298,4,0,0,40,0.0,0.0,1.0,40,1300,500,800,0.38461538461538464,21,5,16,352.8808739795553,0.43253205128205124,0.14522406900904716,0.19435026581979456,128929.98598327125,1099.38522718972,130029.37121046097,1128,1,229.85,38,2,17,37.140797040465685,0.6058114035087719,46.10042735042735,1015.5982905982908,26.726270805218178,0
1299,4,1,0,41,0.024390243902439025,0.0,1.0,41,1350,1000,350,0.7407407407407407,17,10,7,360.67975543074346,0.4326727642276423,0.17521050341668176,0.20195523321122125,129581.83235627146,1147.7940773613882,130729.62643363286,1129,0,225.21951219512195,38,3,13,36.2786376355369,0.612390350877193,45.45940170940171,1018.1623931623932,26.79374718848403,0
1300,4,0,0,41,0.0,0.0,1.0,41,1350,900,450,0.6666666666666666,18,9,9,363.30066315545,0.4327235772357723,0.16918381079331635,0.20384609899122455,129663.42872242314,1221.3619283731505,130884.79065079629,1130,1,226.21951219512195,38,3,14,36.128885625371524,0.6132127192982456,45.379273504273506,1018.4829059829061,26.802181736392267,0
1301,4,0,1,40,0.0,0.024390243902439025,0.975609756097561,41,750,400,350,0.5333333333333333,11,4,7,408.69329246222014,0.43249491869918694,0.24681294108599605,0.2179873796664594,127648.68830497863,2304.8407403836736,129953.5290453623,1131,2,227.21951219512195,33,8,18,37.04018109790606,0.6029040404040404,47.36519607843136,1010.5392156862727,30.622400475341596,8
1302,4,2,1,41,0.047619047619047616,0.023809523809523808,0.9761904761904762,42,1200,900,300,0.75,15,9,6,396.9217412027172,0.43468108788230736,0.26455817929265946,0.21485197084535743,128240.42986685033,1782.2052806295114,130022.63514747984,1132,0,222.66666666666666,32,10,20,36.729462727499374,0.611328125,46.78030303030303,1012.878787878788,31.652462121212125,0
1303,4,1,1,41,0.023809523809523808,0.023809523809523808,0.9761904761904762,42,1650,1400,250,0.8484848484848485,19,14,5,391.0058366639104,0.43518921796360815,0.26471095623371954,0.21428983013989675,128734.59314025847,1667.195459678963,130401.78859993743,1133,0,222.07142857142858,33,9,20,36.37279615988409,0.6139520202020202,46.29289215686274,1014.8284313725483,30.75237670825904,0
1304,4,0,0,41,0.0,0.0,1.0,41,1450,1400,50,0.9655172413793104,15,14,1,397.37648927745585,0.4320376016260163,0.2703965239394206,0.21719339737865295,128627.127621882,2022.6792800453413,130649.80690192734,1134,1,228.46341463414635,34,7,20,36.32129444900832,0.6106004901960784,46.39880952380952,1014.4047619047612,29.835434173669448,0
1305,4,0,0,41,0.0,0.0,1.0,41,1100,500,600,0.45454545454545453,17,5,12,398.2813894483674,0.43122459349593495,0.2680924346189275,0.2185165461027531,128778.12500000012,2057.986111111127,130836.11111111124,1135,2,229.46341463414635,34,7,20,36.14360974274767,0.6121323529411764,46.25000000000001,1015.0000000000009,29.852941176470615,0
1306,4,1,0,42,0.023809523809523808,0.0,1.0,42,1400,900,500,0.6428571428571429,19,9,10,391.54807585069693,0.4324670925280681,0.25795937532395485,0.21731335638366006,129234.48562622094,1723.0806138780674,130957.566240099,1136,0,224.97619047619048,31,11,21,35.8476597515687,0.623991935483871,45.800781250000014,1016.7968750000018,32.79989919354845,0
1307,4,2,1,43,0.045454545454545456,0.022727272727272728,0.9772727272727273,44,900,600,300,0.6666666666666666,12,6,6,370.2232550542362,0.434802237491191,0.25730740648996786,0.20903374554600704,129908.37191358021,819.0200617283897,130727.3919753086,1137,0,215.70454545454547,35,9,21,35.703337874659404,0.6214285714285714,45.138888888888886,1019.4444444444441,29.126984126984116,0
1308,4,0,1,42,0.0,0.023255813953488372,0.9767441860465116,43,1500,1200,300,0.8,18,12,6,381.071763909512,0.4328626799557032,0.26477939578352583,0.21460357230693552,129807.25623582758,1293.1760204081552,131100.43225623574,1138,1,221.69767441860466,34,9,21,35.52983839563864,0.6225490196078431,45.238095238095234,1019.0476190476184,29.971988795518186,0
1309,4,0,1,41,0.0,0.023809523809523808,0.9761904761904762,42,950,500,450,0.5263157894736842,14,5,9,381.292333036265,0.4322009291521487,0.25575283261301207,0.21489425037020846,129837.58680555563,1501.215277777783,131338.80208333343,1139,2,222.61904761904762,34,8,21,35.493322431180154,0.6228553921568627,45.208333333333336,1019.1666666666673,29.97549019607845,0
1310,4,0,1,40,0.0,0.024390243902439025,0.975609756097561,41,1450,1000,450,0.6896551724137931,19,10,9,376.87023163436805,0.4316819105691057,0.22842465374267906,0.21343062218265105,130026.38996056237,1600.6151406035608,131627.00510116594,1140,3,215.0,35,6,22,35.41382962626721,0.6226190476190476,45.023148148148145,1019.9074074074072,29.140211640211632,0
1311,4,0,1,39,0.0,0.025,0.975,40,900,700,200,0.7777777777777778,11,7,4,380.6324581398833,0.4302884615384615,0.22571477195371004,0.21588767606466716,130085.41907793198,1902.946566358011,131988.36564429,1141,4,216.95,35,5,22,35.25782845473111,0.6232142857142857,44.96527777777777,1020.1388888888879,29.146825396825367,0
1312,4,1,0,40,0.025,0.0,1.0,40,1200,800,400,0.6666666666666666,16,8,8,376.18672991560516,0.43114316239316236,0.2191387411895631,0.2146945719708892,130327.04132550256,1805.8223889781707,132132.86371448074,1142,0,216.575,32,8,23,35.125561600923284,0.6324869791666667,44.72853535353536,1021.0858585858591,31.908933080808097,0
1313,4,0,0,40,0.0,0.0,1.0,40,1150,800,350,0.6956521739130435,15,8,7,376.9447937937643,0.4316773504273504,0.21612086010874965,0.21602246964441518,130488.24737271717,1837.3730996837237,132325.6204724009,1143,1,217.575,32,8,18,34.94243285549515,0.6341145833333333,44.57070707070708,1021.7171717171725,31.92866161616164,0
1314,4,0,0,40,0.0,0.0,1.0,40,1050,800,250,0.7619047619047619,13,8,5,376.47637821560744,0.43114316239316236,0.22079369981470087,0.21629356150854112,130585.0188277982,1832.434987501281,132417.45381529946,1144,2,218.575,32,8,18,34.856135474572795,0.6350911458333333,44.476010101010104,1022.0959595959597,31.94049873737374,0
1315,4,1,1,40,0.024390243902439025,0.024390243902439025,0.975609756097561,41,1750,1000,750,0.5714285714285714,25,10,15,363.1323567090671,0.43325711382113824,0.20714838556034065,0.21151169023480715,131114.67013888882,1322.3958333333226,132437.06597222213,1145,0,214.21951219512195,34,7,20,34.660631950094924,0.6357230392156863,43.95833333333333,1024.166666666666,30.122549019607824,0
1316,4,0,0,40,0.0,0.0,1.0,40,1600,1300,300,0.8125,19,13,6,374.5764341854824,0.4330261752136752,0.22520344106021906,0.21800449843460903,131084.19075963722,1820.209750566899,132904.4005102041,1146,1,220.375,34,6,20,34.39849259862048,0.6354166666666667,43.98809523809524,1024.0476190476193,30.119047619047624,0
1317,4,0,0,40,0.0,0.0,1.0,40,1050,700,350,0.6666666666666666,14,7,7,372.86480442966956,0.4327056623931624,0.22581357508135746,0.21735289819192943,131145.15306122453,1779.8823696145173,132925.03543083905,1147,2,221.375,34,6,20,34.380569115140254,0.6360294117647058,43.92857142857143,1024.2857142857147,30.126050420168077,0
1318,4,0,1,39,0.0,0.025,0.975,40,850,700,150,0.8235294117647058,10,7,3,371.8809803650083,0.432411858974359,0.22357673986290272,0.21729664616440103,131236.6230867347,1760.8808106575984,132997.5038973923,1148,3,222.375,34,6,20,34.313155958328494,0.6369485294117647,43.839285714285715,1024.6428571428573,30.136554621848745,0
1319,4,0,0,39,0.0,0.0,1.0,39,1000,700,300,0.7,13,7,6,380.36059714828934,0.4309772829509672,0.22419107026211438,0.22223584575519562,131233.93233672157,2183.2433739427315,133417.1757106643,1149,4,227.51282051282053,33,6,21,34.09866742415183,0.6392045454545454,43.84191176470589,1024.6323529411775,31.04946524064174,0
1320,4,0,0,39,0.0,0.0,1.0,39,1250,1000,250,0.8,15,10,5,380.0568891460362,0.4303587494376968,0.23229974665077502,0.22299314047212307,131394.8652479384,2187.5723293587544,133582.43757729715,1150,5,228.51282051282053,31,8,22,33.94346372026078,0.6458333333333333,43.684895833333336,1025.260416666667,33.07291666666668,0
1321,4,0,0,39,0.0,0.0,1.0,39,1300,800,500,0.6153846153846154,18,8,10,380.0158898452687,0.4299370220422852,0.23081153732251547,0.22394504084449324,131561.79004245345,2199.11414252388,133760.90418497732,1151,6,229.51282051282053,31,8,19,33.77556902314167,0.647513440860215,43.52213541666667,1025.9114583333342,33.093918010752716,0
1322,4,0,0,39,0.0,0.0,1.0,39,1000,700,300,0.7,13,7,6,378.4586049627662,0.4295996401259559,0.2312638292333724,0.22322259035229047,131595.187717014,2160.6662326389073,133755.8539496529,1152,7,230.51282051282053,31,8,19,33.78172588832489,0.6478494623655914,43.48958333333334,1026.0416666666677,33.098118279569924,0
1323,4,0,0,39,0.0,0.0,1.0,39,1250,800,450,0.64,17,8,9,391.8642554756565,0.4295152946468736,0.2848808178497282,0.21682167784068923,129113.15164448298,2318.9658082561673,131432.11745273916,1153,8,231.51282051282053,35,4,19,35.96365732832251,0.6133928571428571,45.920138888888886,1016.319444444444,29.0376984126984,8
1324,4,0,0,39,0.0,0.0,1.0,39,450,200,250,0.4444444444444444,7,2,5,395.72695511959193,0.4294309491677913,0.2915090374106777,0.2194485842026826,129201.38888888876,2425.815007716041,131627.2038966048,1154,9,232.51282051282053,31,8,19,35.775273224043744,0.6236559139784946,45.83333333333333,1016.6666666666656,32.79569892473115,0
1325,4,1,1,39,0.025,0.025,0.975,40,800,600,200,0.75,10,6,4,388.7591166417203,0.4301014957264957,0.3034863434003132,0.21816185134431704,129669.02941476816,2082.00346621489,131751.03288098305,1155,0,227.675,33,7,16,35.4749478602655,0.6234217171717171,45.37377450980391,1018.5049019607827,30.863784907902506,0
1326,4,0,0,39,0.0,0.0,1.0,39,1150,800,350,0.6956521739130435,15,8,7,389.4680935593278,0.43041497975708504,0.2932200723611771,0.21890792844886342,129731.44531249988,2305.2517361110968,132036.69704861098,1156,1,210.28205128205127,33,6,16,35.393234492160865,0.6240530303030303,45.31249999999999,1018.7499999999991,30.871212121212093,0
1327,4,0,0,39,0.0,0.0,1.0,39,1050,700,350,0.6666666666666666,14,7,7,389.2224448455224,0.4300775978407558,0.2925382704175681,0.21964398210482053,129887.55076172622,2311.03001249519,132198.5807742214,1157,2,211.28205128205127,33,6,16,35.240342229702655,0.6256313131313131,45.15931372549019,1019.3627450980389,30.889780154486026,0
1328,4,1,0,40,0.025,0.0,1.0,40,1250,900,350,0.72,16,9,7,376.5927215848156,0.43341346153846155,0.27919874037788706,0.2144027885038649,130232.2066326529,1808.9002267573512,132041.10685941024,1158,0,206.975,34,6,19,35.211589300987484,0.6268382352941176,44.82142857142856,1020.7142857142844,30.021008403361307,0
1329,4,1,0,41,0.024390243902439025,0.0,1.0,41,1550,1400,150,0.9032258064516129,17,14,3,367.9021366020417,0.4328760162601626,0.2854919513331138,0.21176565342750214,130657.85147392278,1413.8640873015743,132071.71556122435,1159,0,202.90243902439025,34,7,18,35.00135848470735,0.6311274509803921,44.4047619047619,1022.3809523809514,30.070028011204453,0
1330,4,0,2,39,0.0,0.04878048780487805,0.9512195121951219,41,1550,1300,250,0.8387096774193549,18,13,5,368.68398602663586,0.43145325203252033,0.28725367674443625,0.21346006027907566,130883.62328800144,1450.9391878857916,132334.56247588724,1160,1,203.90243902439025,35,6,18,34.75250254496097,0.63125,44.18402777777777,1023.2638888888881,29.23611111111109,0
1331,4,0,0,39,0.0,0.0,1.0,39,900,800,100,0.8888888888888888,10,8,2,386.4517536804634,0.42692869995501576,0.2975232017313303,0.22214983304264288,130606.8447982748,2294.648842993093,132901.4936412679,1161,2,214.35897435897436,33,6,18,34.5790622627183,0.6328914141414141,44.454656862745104,1022.1813725490205,30.975193107546076,0
1332,4,1,0,40,0.025,0.0,1.0,40,1100,700,400,0.6363636363636364,15,7,8,382.5229810621894,0.4284054487179487,0.3050220878865382,0.2226294102230687,131084.19075963725,2028.5430839002333,133112.73384353748,1162,0,209.975,34,6,19,34.19505153840193,0.6354166666666667,43.98809523809524,1024.0476190476195,30.11904761904763,0
1333,4,0,0,40,0.0,0.0,1.0,40,1050,700,350,0.6666666666666666,14,7,7,387.51505040698737,0.4277911324786325,0.31182620817843887,0.2266120620858251,131267.1201814058,2173.596938775498,133440.7171201813,1163,1,210.975,34,6,19,33.881757280049555,0.6372549019607843,43.8095238095238,1024.761904761904,30.140056022408938,0
1334,4,0,0,40,0.0,0.0,1.0,40,1250,700,550,0.56,18,7,11,385.02214290435603,0.42783119658119656,0.3071138211382112,0.22551296941540835,131328.12499999988,2112.861394557808,133440.9863945577,1164,2,211.975,33,7,19,33.883807588075875,0.6401515151515151,43.74999999999999,1024.999999999999,31.060606060606034,0
1335,4,0,0,40,0.0,0.0,1.0,40,950,600,350,0.631578947368421,13,6,7,385.4746641658427,0.4270833333333333,0.30888291517323796,0.22689331498369195,131516.61169982678,2139.2643454440386,133655.87604527082,1165,3,212.975,33,7,20,33.68130227001195,0.6420454545454546,43.566176470588225,1025.7352941176455,31.082887700534712,0
1336,4,0,0,40,0.0,0.0,1.0,40,1050,700,350,0.6666666666666666,14,7,7,388.1034756264759,0.42694978632478636,0.3129030331979945,0.22919453490099473,131642.34459102247,2218.1702950787894,133860.51488610127,1166,4,213.975,33,7,17,33.48658546294085,0.6433080808080809,43.44362745098038,1026.2254901960766,31.097742127153836,0
1337,4,0,0,40,0.0,0.0,1.0,40,1600,1000,600,0.625,22,10,12,402.9754940454969,0.4270299145299145,0.30456494717215676,0.2222027312951353,128976.8442792828,2420.162225806536,131397.00650508935,1167,5,214.975,32,8,18,35.820903252537796,0.6188151041666667,46.054292929292934,1015.7828282828289,31.743213383838402,7
1338,4,1,1,40,0.024390243902439025,0.024390243902439025,0.975609756097561,41,1250,900,350,0.72,16,9,7,390.0230659465175,0.42855691056910566,0.29195025068423486,0.21699073337466465,129329.78777675744,1888.515361952859,131218.3031387103,1168,0,210.70731707317074,32,9,19,35.789059913935795,0.6223958333333333,45.707070707070706,1017.1717171717169,31.786616161616152,0
1339,4,1,1,40,0.024390243902439025,0.024390243902439025,0.975609756097561,41,1650,1400,250,0.8484848484848485,19,14,5,390.6879021874455,0.43107215447154473,0.30471219864443166,0.21889587183246684,129606.62853529886,1927.1483624086793,131533.77689770755,1169,0,210.9268292682927,33,8,18,35.489504352709915,0.622790404040404,45.43504901960784,1018.2598039215682,30.856357694592976,0
1340,4,0,0,40,0.0,0.0,1.0,40,1150,700,450,0.6086956521739131,16,7,9,398.03253926430335,0.4289797008547009,0.3014989164459425,0.22248036817828415,129513.05537533638,2310.082059784693,131823.13743512108,1170,1,217.175,33,7,18,35.39810578698129,0.6218434343434344,45.52696078431372,1017.8921568627449,30.845216874628633,0
1341,4,0,0,40,0.0,0.0,1.0,40,1050,900,150,0.8571428571428571,12,9,3,393.93712113703765,0.4289797008547009,0.3006546644844519,0.22082163395846774,129625.34722222219,2212.847222222218,131838.1944444444,1171,2,218.175,34,6,18,35.387684124386254,0.6207107843137255,45.416666666666664,1018.333333333333,29.950980392156854,0
1342,4,1,0,41,0.024390243902439025,0.0,1.0,41,1550,900,650,0.5806451612903226,22,9,13,387.63907225385435,0.42990345528455287,0.3003868568297663,0.2198616977378039,130085.41907793214,1885.2382330246937,131970.65731095683,1172,0,213.82926829268294,35,6,19,35.07913546630361,0.6232142857142857,44.96527777777778,1020.1388888888891,29.146825396825403,0
1343,4,0,0,41,0.0,0.0,1.0,41,800,500,300,0.625,11,5,6,407.52730979828203,0.4296493902439025,0.273755482034316,0.21669936047467334,127524.87775134546,2205.9098363609937,129730.78758770645,1173,1,214.82926829268294,33,8,18,37.19718110490982,0.6016414141414141,47.487745098039206,1010.0490196078416,30.607546048722472,8
1344,4,0,0,41,0.0,0.0,1.0,41,1250,800,450,0.64,17,8,9,409.3733273040047,0.42848069105691056,0.2756576728997946,0.218350094239898,127648.68830497889,2251.1936514802032,129899.8819564591,1174,2,215.82926829268294,33,8,19,37.02300105101463,0.6029040404040404,47.365196078431374,1010.5392156862748,30.62240047534166,0
1345,4,0,0,41,0.0,0.0,1.0,41,1350,1000,350,0.7407407407407407,17,10,7,409.05534836734904,0.42721036585365857,0.27143981117230576,0.21907415693772114,127813.27239229005,2256.5405328797974,130069.81292516984,1175,3,216.82926829268294,34,7,19,36.86155913978495,0.602328431372549,47.20238095238094,1011.1904761904746,29.74089635854337,0
1346,4,0,0,41,0.0,0.0,1.0,41,1050,900,150,0.8571428571428571,12,9,3,409.2786093504412,0.427489837398374,0.2712291569190841,0.21968669258690462,127903.57320011343,2269.639314058963,130173.2125141724,1176,4,217.82926829268294,34,7,19,36.76297516770626,0.6032475490196079,47.11309523809524,1011.5476190476195,29.751400560224102,0
1347,4,0,1,40,0.0,0.024390243902439025,0.975609756097561,41,1250,900,350,0.72,16,9,7,406.24976475502297,0.42779471544715447,0.24631175946400852,0.20148897728453805,124662.3904309714,1957.1473992262954,126619.53783019769,1177,5,218.82926829268294,36,5,16,40.19531837317696,0.5659722222222222,50.33783783783783,998.6486486486477,27.740240240240215,8
1348,4,5,0,45,0.1111111111111111,0.0,1.0,45,850,600,250,0.7058823529411765,11,6,5,367.82451572138706,0.4367213804713805,0.23224541122994058,0.18753403445805591,125808.59510633674,256.0101889526683,126064.60529528941,1042,0,174.11111111111111,39,6,18,39.96740127366488,0.5723824786324787,49.19270833333333,1003.2291666666661,25.72382478632477,0
1349,4,3,2,46,0.0625,0.041666666666666664,0.9583333333333334,48,1500,1200,300,0.8,18,12,6,353.25020998846315,0.4424220596926714,0.2518498899510533,0.18391123041318255,126667.22888518807,-650.735232967636,126016.49365222044,1043,0,164.16666666666666,41,7,15,39.44833858940246,0.5779979674796748,48.33829365079364,1006.6468253968233,24.55236159504447,0
1350,4,0,4,42,0.0,0.08695652173913043,0.9130434782608696,46,1200,700,500,0.5833333333333334,17,7,10,363.33652374187596,0.44049919484702094,0.25671623647635644,0.1883382077174069,126488.78173828099,-8.401150173639962,126480.38058810735,1044,1,172.15217391304347,39,7,15,39.378279141210164,0.5793269230769231,48.515624999999986,1005.937499999998,25.793269230769177,0
1351,4,3,0,45,0.06666666666666667,0.0,1.0,45,1450,1300,150,0.896551724137931,16,13,3,376.0502436132197,0.4420454545454546,0.2807298116500965,0.1956250328592016,126634.58256857688,524.1931249543396,127158.77569353122,1045,0,176.73333333333332,38,7,18,38.90820153557657,0.5825109649122807,48.370726495726494,1006.5170940170934,26.48729194781825,0
1352,4,0,2,43,0.0,0.044444444444444446,0.9555555555555556,45,1450,1000,450,0.6896551724137931,19,10,9,365.92116343603857,0.44246632996633,0.22221761514806015,0.18846991263574275,126226.95448133672,272.5250554020298,126499.47953673876,1046,1,177.73333333333332,39,6,16,39.58322535503266,0.576655982905983,48.776041666666664,1004.8958333333327,25.766559829059812,8
1353,4,2,2,43,0.044444444444444446,0.044444444444444446,0.9555555555555556,45,1800,1200,600,0.6666666666666666,24,12,12,355.2538649149838,0.44490740740740736,0.2282523729759911,0.1851808667191664,126717.16668438206,3.3526431405858546,126720.51932752265,1047,0,174.7111111111111,41,4,16,39.346548921075964,0.5785060975609756,48.288690476190474,1006.8452380952378,24.557200929152142,0
1354,4,0,0,43,0.0,0.0,1.0,43,800,700,100,0.875,9,7,2,365.76224240871176,0.4395302694721299,0.2515123139546911,0.19008224980691593,126593.58859592024,660.6309678819507,127254.2195638022,1048,1,183.69767441860466,39,4,16,39.20929941689954,0.5803952991452992,48.411458333333336,1006.3541666666675,25.803952991453013,0
1355,4,1,1,43,0.022727272727272728,0.022727272727272728,0.9772727272727273,44,1500,1000,500,0.6666666666666666,20,10,10,363.41069398564593,0.4400325933756166,0.26542535526384814,0.1907264399010436,126994.32594946197,430.2192251066439,127424.54517456862,1049,0,180.5,42,2,18,38.85610940203807,0.5798611111111112,48.01356589147286,1007.945736434107,23.99870801033588,0
1356,4,1,0,44,0.022727272727272728,0.0,1.0,44,1050,800,250,0.7619047619047619,13,8,5,371.5852574691184,0.44082540521494007,0.27570781972265035,0.19574580527391036,127145.88355613983,649.2574068256295,127795.14096296547,1050,0,181.3181818181818,38,6,19,38.49421786723164,0.5877192982456141,47.86324786324786,1008.5470085470075,26.54071075123704,0
1357,4,2,0,46,0.043478260869565216,0.0,1.0,46,1150,900,250,0.782608695652174,14,9,5,359.88456725541334,0.44596417069243155,0.2765767262141523,0.19235743097740962,127733.276375256,-6.153021514986278,127727.12335374102,1051,0,174.3913043478261,40,6,17,38.18655541034146,0.5903645833333333,47.28150406504064,1010.8739837398364,25.271849593495908,0
1358,4,1,0,47,0.02127659574468085,0.0,1.0,47,1300,700,600,0.5384615384615384,19,7,12,366.2878225017181,0.4463074313906876,0.2961875609898499,0.19754761843591567,128094.3129566639,-16.122606450011517,128078.19035021389,1052,0,171.6595744680851,41,6,18,37.6547595714099,0.592479674796748,46.92460317460316,1012.3015873015853,24.690282617111837,0
1359,4,2,2,47,0.04081632653061224,0.04081632653061224,0.9591836734693877,49,1450,900,550,0.6206896551724138,20,9,11,355.1634137055185,0.4491744614512472,0.3055582810047097,0.1944052369756523,128685.30636525879,-659.107933815669,128026.19843144312,1053,0,165.6122448979592,40,9,15,37.33244023771367,0.6,46.34146341463415,1014.6341463414635,25.365853658536587,0
1360,4,0,2,45,0.0,0.0425531914893617,0.9574468085106383,47,1700,1300,400,0.7647058823529411,21,13,8,341.1909751313223,0.44507400555041626,0.26665577983386135,0.17725461887462501,126580.1657826029,-723.8621810760847,125856.30360152682,1054,1,173.53191489361703,40,7,14,39.84127785632532,0.5786458333333333,48.42479674796748,1006.3008130081297,25.157520325203244,8
1361,4,1,1,45,0.021739130434782608,0.021739130434782608,0.9782608695652174,46,1300,900,400,0.6923076923076923,17,9,8,334.24332229235483,0.44381038647342996,0.2665004743001267,0.17482245375280467,126855.79562716994,-719.8594835069639,126135.93614366297,1055,0,173.91304347826087,39,7,16,39.73315841174646,0.5830662393162394,48.15104166666666,1007.3958333333317,25.83066239316235,0
1362,4,6,4,47,0.11764705882352941,0.0784313725490196,0.9215686274509804,51,1500,900,600,0.6,21,9,12,311.4555099190183,0.4517647058823529,0.29992432312233475,0.1680875886206587,128121.09482167345,-2219.195816186563,125901.89900548689,1056,0,157.64705882352942,44,7,16,39.0151515151515,0.5885416666666667,46.898148148148145,1012.4074074074068,23.009259259259245,0
1363,4,1,1,47,0.020833333333333332,0.020833333333333332,0.9791666666666666,48,1400,1000,400,0.7142857142857143,18,10,8,328.1730103806231,0.44874778368794327,0.30502450980392193,0.17654877140729708,127993.90589569147,-1199.1709183673572,126794.73497732411,624,0,146.45833333333334,41,7,17,38.7218137254902,0.5914634146341464,47.02380952380952,1011.9047619047608,24.680603948896604,0
1364,4,1,0,48,0.020833333333333332,0.0,1.0,48,1350,900,450,0.6666666666666666,18,9,9,327.85083639385755,0.44784278959810875,0.30633880450759454,0.1769284920888055,128119.42087309448,-1199.188141691874,126920.2327314026,625,0,147.14583333333334,41,7,18,38.60189041319616,0.5927337398373984,46.89980158730158,1012.4007936507926,24.692702284165673,0
1365,4,1,1,48,0.02040816326530612,0.02040816326530612,0.9795918367346939,49,900,700,200,0.7777777777777778,11,7,4,320.05238414049506,0.44883786848072565,0.30069500724477516,0.17383237334689644,128376.15258774544,-1582.576338551754,126793.57624919369,626,0,145.12244897959184,40,9,14,38.537697218879515,0.596875,46.646341463414636,1013.4146341463419,25.335365853658548,0
1366,4,0,0,48,0.0,0.0,1.0,48,1600,900,700,0.5625,23,9,14,328.7039040858724,0.44830452127659576,0.29995888157894735,0.17843926221804515,128355.55555555565,-1161.8055555555454,127193.7500000001,627,2,149.14583333333334,39,9,18,38.339501096491226,0.5982905982905983,46.66666666666667,1013.3333333333342,25.982905982906004,0
1367,4,1,1,48,0.02040816326530612,0.02040816326530612,0.9795918367346939,49,1200,1100,100,0.9166666666666666,13,11,2,325.48291208240875,0.44871386054421764,0.3083913854003142,0.1781590676661608,128685.3063652589,-1423.0263484037107,127262.28001685519,628,0,147.08163265306123,40,9,16,38.08531149839743,0.6,46.341463414634156,1014.6341463414644,25.36585365853661,0
1368,4,0,0,48,0.0,0.0,1.0,48,1100,700,400,0.6363636363636364,15,7,8,331.198428125092,0.4478520242316785,0.31147330595482536,0.18122880280552822,128672.41753472244,-1076.7795138888641,127595.63802083358,629,1,151.08333333333334,39,9,16,37.953456536618766,0.6014957264957265,46.35416666666668,1014.5833333333351,26.01495726495731,0
1369,4,2,2,48,0.04,0.04,0.96,50,1050,700,350,0.6666666666666666,14,7,7,319.02152033667693,0.45093537414965984,0.3152068636796943,0.1766914333860479,129152.13647767589,-1759.5378132323524,127392.59866444353,630,0,146.0,42,8,18,37.77486495074675,0.6016865079365079,45.88178294573645,1016.4728682170564,24.20173495754896,0
1370,4,2,0,50,0.04,0.0,1.0,50,1100,700,400,0.6363636363636364,15,7,8,352.1038482834171,0.44980442176870744,0.35809435325694206,0.1860791041091906,127275.89111328137,-908.4019482776763,126367.48916500369,631,0,146.7,39,11,19,38.85200526478788,0.5873397435897436,47.73437500000001,1009.0625000000009,25.87339743589746,8
1371,4,1,1,50,0.0196078431372549,0.0196078431372549,0.9803921568627451,51,1100,700,400,0.6363636363636364,15,7,8,346.5810815584945,0.4505718954248366,0.3655476272182572,0.18465750872746822,127604.89477989318,-1354.91151100533,126249.98326888785,632,0,144.80392156862746,40,11,17,38.654194327097166,0.5890625,47.408536585365866,1010.3658536585388,25.25914634146347,0
1372,4,0,1,49,0.0,0.02,0.98,50,1850,1100,750,0.5945945945945946,26,11,15,353.0887221930398,0.4507142857142857,0.36220971147079517,0.18872506822429708,127733.27637525625,-979.7641326260672,126753.51224263018,633,1,147.78,40,10,19,38.3582989846185,0.5903645833333333,47.28150406504066,1010.8739837398383,25.271849593495958,0
1373,4,0,1,48,0.0,0.02040816326530612,0.9795918367346939,49,1750,1100,650,0.6285714285714286,24,11,13,358.5830660841895,0.45153061224489793,0.35904420059481046,0.1920291446468078,127810.33631601572,-633.8755453103224,127176.4607707054,634,2,148.69387755102042,40,9,20,38.14049413735342,0.5911458333333333,47.205284552845534,1011.1788617886189,25.27947154471547,0
1374,4,1,0,49,0.02040816326530612,0.0,1.0,49,900,500,400,0.5555555555555556,13,5,8,362.5449825600117,0.45310728458049887,0.3690684548573395,0.195147185747708,128015.94309769326,-517.6924284486654,127498.2506692446,635,0,149.3877551020408,40,9,21,37.82971814956151,0.5932291666666667,47.00203252032521,1011.9918699186999,25.2997967479675,0
1375,4,0,0,49,0.0,0.0,1.0,49,1550,1100,450,0.7096774193548387,20,11,9,364.798354611514,0.45277069160997735,0.37141561691092395,0.19728795948379826,128204.80619331049,-445.8322352091891,127758.9739581013,636,1,150.3877551020408,34,15,21,37.57934642059483,0.6063112745098039,46.81547619047618,1012.7380952380938,29.786414565826288,0
1376,4,1,0,50,0.02,0.0,1.0,50,1700,1200,500,0.7058823529411765,22,12,10,350.6989741110329,0.45375000000000004,0.3594493783303734,0.19169274021797256,128629.57552146754,-977.9479648567299,127651.62755661081,637,0,148.36,36,14,19,37.50254403493191,0.6064814814814814,46.396396396396405,1014.4144144144154,28.178178178178207,0
1377,4,4,1,53,0.07407407407407407,0.018518518518518517,0.9814814814814815,54,1300,800,500,0.6153846153846154,18,8,10,327.6165502284065,0.45879192872117397,0.3690920253026837,0.18369652686924545,129636.22708013743,-2303.268979771913,127332.95810036552,638,0,138.2962962962963,38,16,19,37.065061547069526,0.6129385964912281,45.40598290598291,1018.376068376069,26.79937022042287,0
1378,4,1,1,53,0.018518518518518517,0.018518518518518517,0.9814814814814815,54,1700,1200,500,0.7058823529411765,22,12,10,330.65741070369046,0.4578529000698812,0.3751921733053807,0.1864344975244212,129853.92011834323,-2212.567800788951,127641.35231755428,639,0,139.27777777777777,38,16,20,36.766902515723274,0.6151315789473684,45.19230769230769,1019.2307692307695,26.821862348178144,0
1379,4,0,0,53,0.0,0.0,1.0,53,1400,1100,300,0.7857142857142857,17,11,6,328.7904119377564,0.45719944363812287,0.35730835534327565,0.18589903385864626,129962.83512309153,-2053.893180656003,127908.94194243553,640,1,137.9811320754717,38,15,20,36.704124755518286,0.6162280701754386,45.085470085470085,1019.6581196581196,26.83310841205578,0
1380,4,0,1,52,0.0,0.018867924528301886,0.9811320754716981,53,1300,600,700,0.46153846153846156,20,6,14,325.62262377717974,0.45701802128688923,0.3510913799482063,0.18451948680706853,130049.99999999999,-2130.5555555555566,127919.44444444442,641,2,138.9811320754717,39,14,20,36.696623093681914,0.6153846153846154,45.0,1019.9999999999999,26.15384615384615,0
1381,4,2,0,54,0.037037037037037035,0.0,1.0,54,1550,1100,450,0.7096774193548387,20,11,9,315.7121337429111,0.4580130444910319,0.3529086151368759,0.18153447690217403,130617.28395061739,-2552.16049382715,128065.12345679024,642,0,137.03703703703704,38,16,16,36.376245471014485,0.6228070175438596,44.44444444444445,1022.2222222222231,26.90058479532166,0
1382,4,0,0,54,0.0,0.0,1.0,54,1850,1300,550,0.7027027027027027,24,13,11,316.1446919743319,0.457998485907291,0.35245559038662444,0.18203999411518415,130671.89554569377,-2537.7547666009054,128134.14077909286,643,1,138.03703703703704,38,16,18,36.31008359456637,0.6233552631578947,44.39102564102565,1022.4358974358986,26.906207827260488,0
1383,4,0,1,53,0.0,0.018518518518518517,0.9814814814814815,54,1150,600,550,0.5217391304347826,17,6,11,317.3912133987779,0.45788201723736316,0.35034297851596485,0.18314563507332726,130753.83434007234,-2499.976372452331,128253.85796762,644,2,139.03703703703704,38,16,18,36.195549984330945,0.6241776315789473,44.31089743589744,1022.7564102564104,26.914642375168693,0
1384,4,0,1,52,0.0,0.018867924528301886,0.9811320754716981,53,1750,1300,450,0.7428571428571429,22,13,9,322.1645658088955,0.4575774068698597,0.3466986056883494,0.18655938399743663,130890.45606874135,-2166.3466104171266,128724.10945832422,645,3,139.81132075471697,38,15,19,35.93565114498503,0.6255482456140351,44.177350427350426,1023.2905982905985,26.928699955015748,0
1385,4,0,0,52,0.0,0.0,1.0,52,1400,1000,400,0.7142857142857143,18,10,8,331.86816150264696,0.4564165409753645,0.3545609987227558,0.19254128574438842,130963.11034404818,-1707.502669090488,129255.60767495769,646,4,143.07692307692307,37,15,20,35.614064452776304,0.6280968468468469,44.10635964912281,1023.5745614035088,27.66417733522997,0
1386,4,1,3,50,0.018867924528301886,0.05660377358490566,0.9433962264150944,53,1450,800,650,0.5517241379310345,21,8,13,322.7727279095567,0.45733551040154813,0.3453301982685544,0.1887894231375877,131274.74500868074,-2125.6184895833144,129149.12651909742,647,0,141.35849056603774,39,14,21,35.53271328860881,0.6276709401709402,43.80208333333334,1024.7916666666683,26.276709401709443,0
1387,4,0,0,50,0.0,0.0,1.0,50,1750,1300,450,0.7428571428571429,22,13,9,344.22633087858816,0.45306972789115646,0.35443503135658516,0.19966005879741455,130953.25213304511,-984.4885003246566,129968.76363272045,648,1,150.16,36,14,21,35.30778963582351,0.6299189814814814,44.11599099099099,1023.5360360360353,28.431556556556536,0
1388,4,0,1,49,0.0,0.02,0.98,50,1300,900,400,0.6923076923076923,17,9,8,346.7328915514231,0.4528401360544218,0.35998240598196674,0.20186868858954157,131097.37059694823,-908.8459236263334,130188.5246733219,649,2,151.16,36,14,21,35.0980041785793,0.6313657407407407,43.97522522522522,1024.0990990990986,28.447197197197184,0
1389,4,0,0,49,0.0,0.0,1.0,49,1250,900,350,0.72,16,9,7,350.84626902229235,0.45220379818594103,0.3675682404442633,0.20501927522470978,131239.16437596444,-591.045765817913,130648.11861014653,650,3,154.10204081632654,35,14,21,34.849415452389,0.6348214285714286,43.83680555555555,1024.6527777777771,29.275793650793634,0
1390,4,0,2,47,0.0,0.04081632653061224,0.9591836734693877,49,1550,1200,350,0.7741935483870968,19,12,7,353.7533041852402,0.4511940192743764,0.3696787586376862,0.20752884575226754,131389.1439909297,-504.10109500976637,130885.04289591993,651,4,155.10204081632654,34,15,22,34.62344209629973,0.6384803921568627,43.69047619047619,1025.2380952380952,30.15406162464986,0
1391,4,0,0,47,0.0,0.0,1.0,47,1800,1400,400,0.7777777777777778,22,14,8,359.181739532692,0.4515302189330867,0.35971446843078625,0.21155632601183938,131541.75347222242,49.47916666669215,131591.2326388891,652,5,153.53191489361703,34,13,22,34.33015163823449,0.6400122549019608,43.54166666666668,1025.833333333335,30.17156862745103,0
1392,4,0,1,46,0.0,0.02127659574468085,0.9787234042553191,47,1300,900,400,0.6923076923076923,17,9,8,356.1834830777179,0.4506629663891459,0.3550130818976154,0.21029463178972135,131633.36167800473,-22.874149659842402,131610.48752834488,653,6,154.53191489361703,34,13,20,34.31457849961332,0.6409313725490196,43.45238095238096,1026.1904761904777,30.182072829131698,0
1393,4,0,0,46,0.0,0.0,1.0,46,1100,600,500,0.5454545454545454,16,6,10,360.2559803353339,0.45038244766505636,0.3501007499117137,0.21239880756108565,131579.47063629376,280.4582372164609,131859.92887351022,654,7,157.2173913043478,33,13,20,34.2645126612518,0.6426767676767677,43.504901960784316,1025.980392156863,31.090314913844335,0
1394,4,0,0,46,0.0,0.0,1.0,46,800,500,300,0.625,11,5,6,358.9061121613104,0.44935587761674717,0.34761184625078734,0.21275362318840577,131786.11288265313,259.76828231292916,132045.88116496606,655,8,158.2173913043478,34,12,20,34.090579710144915,0.6424632352941176,43.30357142857143,1026.785714285715,30.19957983193279,0
1395,4,0,0,46,0.0,0.0,1.0,46,950,400,550,0.42105263157894735,15,4,11,359.81594206505775,0.4491747181964573,0.3490206554501556,0.21346439589086574,131816.6737528345,285.9481292517056,132102.6218820862,656,9,159.2173913043478,34,12,20,34.03639191591313,0.6427696078431373,43.273809523809526,1026.9047619047622,30.203081232493005,0
1396,4,0,0,46,0.0,0.0,1.0,46,1350,1000,350,0.7407407407407407,17,10,7,357.4329758623145,0.4487419484702093,0.34548339966749,0.21273424701322582,131938.95266439905,231.86649659864153,132170.8191609977,657,10,160.2173913043478,34,12,20,33.97426612591736,0.6439950980392157,43.154761904761905,1027.380952380952,30.217086834733884,0
1397,4,0,1,45,0.0,0.021739130434782608,0.9782608695652174,46,1350,900,450,0.6666666666666666,18,9,9,357.8889700511322,0.44798711755233495,0.34435957696827235,0.21357890148212733,132040.89506172843,251.19598765432585,132292.09104938275,658,11,161.2173913043478,35,11,20,33.859797297297305,0.6428571428571428,43.05555555555556,1027.777777777778,29.365079365079374,0
1398,4,0,0,45,0.0,0.0,1.0,45,1350,900,450,0.6666666666666666,18,9,9,368.9466129766407,0.44572811447811445,0.35892880133899796,0.21958684620609747,131938.95266439926,735.6859410430993,132674.63860544236,659,17,165.55555555555554,34,11,20,33.6785438393202,0.6439950980392157,43.15476190476191,1027.3809523809537,30.21708683473393,0
1399,4,0,1,44,0.0,0.022222222222222223,0.9777777777777777,45,1450,800,650,0.5517241379310345,21,8,13,377.9678718253656,0.44482323232323234,0.34973154973154985,0.210730032647841,129413.2812500001,784.4068877551174,130197.68813775522,660,18,166.55555555555554,34,11,18,36.010442260442275,0.6185661764705883,45.62500000000001,1017.5000000000008,29.92647058823532,7
1400,4,1,0,45,0.022222222222222223,0.0,1.0,45,850,600,250,0.7058823529411765,11,6,5,369.82232382849025,0.44555976430976435,0.3353154313272477,0.20770939834170657,129701.96926708247,593.3367358967733,130295.30600297924,661,0,161.42222222222222,35,10,17,35.92359296292088,0.6193452380952381,45.34143518518518,1018.6342592592592,29.103835978835978,0
1401,4,0,0,45,0.0,0.0,1.0,45,1500,1200,300,0.8,18,12,6,371.8162087057337,0.44486531986531985,0.34706727051805975,0.20998453758035016,129917.93894823904,661.1191005194637,130579.05804875851,662,1,162.42222222222222,36,9,18,35.65300636989579,0.6195023148148149,45.12950450450452,1019.4819819819841,28.318943943944003,0
1402,4,0,1,44,0.0,0.022222222222222223,0.9777777777777777,45,1700,1300,400,0.7647058823529411,21,13,8,372.0738607986116,0.44452861952861955,0.34206419316843384,0.21059380521201423,130004.0581121663,674.2223642561603,130678.28047642246,663,2,163.42222222222222,36,9,18,35.55883760306243,0.6203703703703703,45.04504504504505,1019.8198198198204,28.328328328328343,0
1403,4,0,1,43,0.0,0.022727272727272728,0.9772727272727273,44,1250,900,350,0.72,16,9,7,370.2223324651089,0.4446022727272727,0.32464042835925877,0.21003345007654717,130094.74068944289,832.7956678978121,130927.5363573407,664,3,159.25,37,7,18,35.51384709085698,0.6193693693693694,44.95614035087719,1020.1754385964912,27.57230915125652,0
1404,4,1,1,43,0.022727272727272728,0.022727272727272728,0.9772727272727273,44,1100,800,300,0.7272727272727273,14,8,6,369.9376022636595,0.4439746300211416,0.3246531258772105,0.2112464847183163,130348.82010388763,844.2941997970455,131193.11430368468,665,0,159.0909090909091,36,8,19,35.2629668431113,0.6238425925925926,44.707207207207205,1021.1711711711708,28.365865865865857,0
1405,4,0,0,43,0.0,0.0,1.0,43,1100,800,300,0.7272727272727273,14,8,6,374.2119700282229,0.44372923588039864,0.32324211546769765,0.21451579684475022,130498.99798525387,1166.8574245541956,131665.85540980805,666,1,162.04651162790697,35,8,17,35.00132155263555,0.6273809523809524,44.56018518518519,1021.75925925926,29.193121693121714,0
1406,4,1,1,43,0.022727272727272728,0.022727272727272728,0.9772727272727273,44,1500,1100,400,0.7333333333333333,19,11,8,374.06305405053536,0.4445251937984496,0.33055077624839924,0.21680389255173907,130924.43795146511,994.7990219949797,131919.2369734601,667,0,159.3409090909091,36,8,18,34.57352186032864,0.6296296296296297,44.14414414414415,1023.4234234234244,28.428428428428457,0
1407,4,0,1,42,0.0,0.023255813953488372,0.9767441860465116,43,1150,1000,150,0.8695652173913043,13,10,3,378.8365960133152,0.44432908822443706,0.32243608793185596,0.2196755421997208,130942.8466461975,1321.188459147786,132264.03510534528,668,1,160.90697674418604,35,8,18,34.43271985374496,0.6318452380952381,44.1261574074074,1023.4953703703687,29.24272486772482,0
1408,4,1,1,42,0.023255813953488372,0.023255813953488372,0.9767441860465116,43,1500,1000,500,0.6666666666666666,20,10,10,376.4389543234702,0.4440983757844223,0.3258336618052815,0.2194653982715883,131150.23389274688,1274.011381172833,132424.24527391972,669,0,161.72093023255815,35,8,20,34.28389830508474,0.6339285714285714,43.92361111111111,1024.3055555555552,29.265873015873005,0
1409,4,0,0,42,0.0,0.0,1.0,42,600,200,400,0.3333333333333333,10,2,8,379.4506805592963,0.4427990708478513,0.31557033116002864,0.22156315463792145,131209.51753257873,1557.5081447187786,132767.0256772975,670,1,157.52380952380952,35,7,20,34.14670884169303,0.6345238095238095,43.86574074074073,1024.537037037036,29.272486772486744,0
1410,4,0,0,42,0.0,0.0,1.0,42,1250,900,350,0.72,16,9,7,381.51618564659327,0.4425329074719319,0.3167228503685542,0.22363261788695388,131357.78523930453,1623.0242358967514,132980.80947520127,671,2,158.52380952380952,35,7,20,33.943608633472564,0.6360119047619048,43.7210648148148,1025.1157407407393,29.289021164021122,0
1411,4,0,0,42,0.0,0.0,1.0,42,1300,900,400,0.6923076923076923,17,9,8,382.75353476081824,0.4415892373209446,0.3123015425283284,0.22540495538771604,131535.81700370775,1669.1597811642355,133204.97678487198,672,3,159.52380952380952,35,7,21,33.73164184437174,0.6377976190476191,43.54745370370369,1025.8101851851832,29.308862433862377,0
1412,4,1,0,43,0.023255813953488372,0.0,1.0,43,1450,1000,450,0.6896551724137931,19,10,9,377.52168936595933,0.4420681063122924,0.31665136678906647,0.22415350306103787,131848.06428049642,1355.1007933608971,133203.16507385732,673,0,156.7906976744186,36,7,19,33.5501187865497,0.6388888888888888,43.24324324324323,1027.0270270270246,28.52852852852846,0
1413,4,0,1,42,0.0,0.023255813953488372,0.9767441860465116,43,1350,1100,250,0.8148148148148148,16,11,5,385.7738321400891,0.44119139904023624,0.326631296219847,0.2301027445823827,132021.60564280505,1586.0961468225078,133607.70178962755,674,1,157.7906976744186,36,7,19,33.16280407626562,0.640625,43.07432432432433,1027.7027027027034,28.547297297297316,0
1414,4,0,0,42,0.0,0.0,1.0,42,1300,800,500,0.6153846153846154,18,8,10,377.6302070694474,0.43947202864885787,0.23740733895973198,0.21000586335588714,129312.88954293642,1374.4166512941908,130687.30619423061,675,2,162.38095238095238,37,5,17,36.12144243208279,0.6114864864864865,45.72368421052632,1017.1052631578958,27.48933143669989,8
1415,4,0,0,42,0.0,0.0,1.0,42,800,500,300,0.625,11,5,6,376.64517870596313,0.43933894696089815,0.23952447667287657,0.20990334013289078,129396.54659366344,1347.3170831409705,130743.86367680441,676,3,163.38095238095238,37,5,17,36.06115511728995,0.6123310810810811,45.641447368421055,1017.4342105263158,27.498221906116644,0
1416,4,1,0,43,0.023255813953488372,0.0,1.0,43,1400,1300,100,0.9285714285714286,15,13,2,367.6263678857739,0.44033776301218164,0.24251481677422193,0.20713454951343166,129826.69850107754,945.543524910518,130772.24202598806,677,0,160.5581395348837,38,5,17,35.85259635880771,0.6148574561403508,45.2190170940171,1019.1239316239319,26.819050832208735,0
1417,4,1,1,43,0.022727272727272728,0.022727272727272728,0.9772727272727273,44,1200,1000,200,0.8333333333333334,14,10,4,360.5378291599796,0.4426312544045102,0.24095979212501417,0.20487608050907516,130158.86423631781,585.4388715381153,130744.30310785593,678,0,157.88636363636363,40,4,18,35.69573083690204,0.61484375,44.893292682926834,1020.4268292682938,25.510670731707343,0
1418,4,0,1,42,0.0,0.023255813953488372,0.9767441860465116,43,1450,1200,250,0.8275862068965517,17,12,5,364.74417021072225,0.4422526762643042,0.23584377106934928,0.2072525459039582,130156.27170138908,894.748263888908,131051.01996527798,679,1,159.7674418604651,39,4,18,35.591057574520214,0.6164529914529915,44.89583333333334,1020.4166666666682,26.164529914529954,0
1419,4,0,1,41,0.0,0.023809523809523808,0.9761904761904762,42,1200,800,400,0.6666666666666666,16,8,8,366.29339579339296,0.4420489740611692,0.2287145200452707,0.2081182762178883,130153.54624379087,1134.876885638131,131288.423129429,680,2,162.04761904761904,38,4,18,35.55430495934111,0.6181469298245614,44.89850427350429,1020.4059829059847,26.852789023841705,0
1420,4,0,0,41,0.0,0.0,1.0,41,1100,700,400,0.6363636363636364,15,7,8,365.61545656280526,0.4407012195121951,0.21432294872836,0.2084657388889331,130290.57167830481,1327.2493699984586,131617.82104830327,681,3,159.34146341463415,37,4,18,35.43244101958258,0.6213400900900901,44.76425438596491,1020.9429824561399,27.593053579895674,0
1421,4,0,0,41,0.0,0.0,1.0,41,1650,1400,250,0.8484848484848485,19,14,5,364.70142226349026,0.4399136178861789,0.2144467103144787,0.20884592201775876,130458.54403518373,1315.6833112111228,131774.22734639485,682,4,160.34146341463415,37,4,19,35.28529837930664,0.6230292792792793,44.599780701754376,1021.6008771929811,27.61083451872922,0
1422,4,0,0,41,0.0,0.0,1.0,41,950,700,250,0.7368421052631579,12,7,5,366.9500267089099,0.4395071138211382,0.2208730241808856,0.21058954734772406,130542.5707910125,1380.5199676823509,131923.09075869486,683,5,161.34146341463415,37,4,15,35.14261444921316,0.6238738738738738,44.517543859649116,1021.9298245614026,27.619724988146015,0
1423,4,0,1,40,0.0,0.024390243902439025,0.975609756097561,41,1150,900,250,0.782608695652174,14,9,5,374.30593927927237,0.4396849593495935,0.2266433407338262,0.2159029991130344,130738.73842191801,1587.2572570405998,132325.9956789586,684,6,162.34146341463415,37,4,15,34.7556154176048,0.6258445945945945,44.32565789473683,1022.6973684210504,27.640469416785148,0
1424,4,0,0,40,0.0,0.0,1.0,40,1150,800,350,0.6956521739130435,15,8,7,381.8804529297557,0.43855502136752134,0.23357190046245324,0.2203455065761141,130751.61944038606,1986.2975306387154,132737.91697102477,685,7,166.25,36,4,15,34.548878734493115,0.6278935185185186,44.31306306306305,1022.7477477477456,28.4096596596596,0
1425,4,1,0,41,0.024390243902439025,0.0,1.0,41,1500,1000,500,0.6666666666666666,20,10,10,371.0743684607761,0.43973577235772354,0.23367848322028562,0.2163905586866769,131159.59357686955,1533.992670821765,132693.5862476913,686,0,163.17073170731706,37,4,16,34.411796189252826,0.6300675675675675,43.91447368421051,1024.3421052631559,27.684921763869077,0
1426,4,1,1,41,0.023809523809523808,0.023809523809523808,0.9761904761904762,42,1200,900,300,0.75,15,9,6,361.6304424223106,0.44030681378242353,0.21952035811029869,0.21245205217403615,131443.57829112894,1107.0162869408991,132550.59457806984,687,0,160.26190476190476,36,6,17,34.36653488542351,0.634837962962963,43.637387387387385,1025.4504504504503,28.48473473473473,0
1427,4,0,0,41,0.0,0.0,1.0,41,850,600,250,0.7058823529411765,11,6,5,368.16709630510945,0.4383384146341463,0.22724568709101756,0.21564072783584964,131328.12499999988,1470.1388888888744,132798.26388888876,688,1,164.9512195121951,35,6,18,34.31571815718158,0.6357142857142857,43.74999999999999,1024.999999999999,29.28571428571426,0
1428,4,1,0,42,0.023809523809523808,0.0,1.0,42,950,500,450,0.5263157894736842,14,5,9,362.65528743298825,0.4401011420828494,0.22456294345695293,0.21434761930377783,131674.63705259308,1150.5006695885054,132825.1377221816,689,0,162.0,36,6,17,34.10686855387317,0.6371527777777778,43.41216216216216,1026.351351351351,28.50975975975975,0
1429,4,0,3,39,0.0,0.07142857142857142,0.9285714285714286,42,1200,700,500,0.5833333333333334,17,7,10,365.2520839947841,0.43978658536585363,0.22650121684997737,0.21653891429547747,131790.2425229284,1227.332146335531,133017.57466926394,690,1,163.0,36,6,17,33.92351210060686,0.6383101851851851,43.29954954954955,1026.8018018018024,28.52227227227229,0
1430,4,0,0,39,0.0,0.0,1.0,39,1250,900,350,0.72,16,9,7,388.55569244942933,0.4394680611785875,0.2406481345295879,0.22833104174275473,131453.76778162253,2415.421953094974,133869.1897347175,691,2,173.53846153846155,33,6,19,33.66594964945825,0.6414141414141414,43.62745098039216,1025.490196078432,31.075460487225214,0
1431,4,0,0,39,0.0,0.0,1.0,39,1150,900,250,0.782608695652174,14,9,5,386.454964354794,0.43828722447143503,0.23702179517799293,0.2282210064532471,131642.34459102264,2374.767517301029,134017.11210832366,692,3,174.53846153846155,33,6,19,33.52887907013773,0.6433080808080809,43.44362745098039,1026.225490196078,31.09774212715388,0
1432,4,0,0,39,0.0,0.0,1.0,39,1050,800,250,0.7619047619047619,13,8,5,382.0337535840785,0.4381747638326586,0.2323926073926077,0.22628153096903109,131755.55555555545,2267.0138888888805,134022.56944444432,693,4,175.53846153846155,34,5,19,33.52780032467533,0.642156862745098,43.33333333333333,1026.6666666666658,30.196078431372523,0
1433,4,0,0,39,0.0,0.0,1.0,39,1300,700,600,0.5384615384615384,19,7,12,378.68457905043044,0.4369939271255061,0.22342836941377087,0.22556429273873463,131969.53125000003,2194.9652777777783,134164.4965277778,694,5,176.53846153846155,34,5,19,33.39753987564206,0.6443014705882353,43.125,1027.5000000000002,30.220588235294123,0
1434,4,0,0,39,0.0,0.0,1.0,39,1000,700,300,0.7,13,7,6,379.7103417161358,0.4369376968061178,0.2186964127968407,0.226957419591031,132100.37964034645,2231.9760588134545,134332.3556991599,695,6,177.53846153846155,35,4,19,33.23904150716806,0.6434523809523809,42.99768518518519,1028.00925925926,29.371693121693145,0
1435,4,0,0,39,0.0,0.0,1.0,39,1300,900,400,0.6923076923076923,17,9,8,372.29783847322807,0.4352226720647773,0.20410141040062313,0.2239328676608252,132338.45191400888,2053.8639188957454,134392.31583290463,696,7,178.53846153846155,35,4,22,33.18944506936633,0.6458333333333333,42.7662037037037,1028.935185185185,29.39814814814814,0
1436,4,0,0,39,0.0,0.0,1.0,39,750,600,150,0.8,9,6,3,373.74920273441023,0.4354757085020243,0.2056530804703116,0.22498335555258225,132368.22601862557,2094.503788365899,134462.72980699147,697,8,179.53846153846155,35,4,22,33.12209444007048,0.6461309523809524,42.73726851851851,1029.0509259259252,29.401455026455004,0
1437,4,0,0,39,0.0,0.0,1.0,39,1000,800,200,0.8,12,8,4,377.90931995752544,0.43536324786324787,0.21231611378483195,0.22803781505043377,132459.2704790247,2211.521914739379,134670.79239376407,698,9,180.53846153846155,34,5,22,32.92326818549786,0.649203431372549,42.64880952380951,1029.40476190476,30.27661064425765,0
1438,4,0,0,39,0.0,0.0,1.0,39,1550,1300,250,0.8387096774193549,18,13,5,375.0342477196034,0.435138326585695,0.20524677634504274,0.22685638061360588,132551.19756235805,2142.2477324262763,134693.44529478432,699,10,181.53846153846155,34,5,22,32.90462427745664,0.6501225490196079,42.559523809523796,1029.761904761903,30.287114845938323,0
1439,4,0,0,39,0.0,0.0,1.0,39,1050,700,350,0.6666666666666666,14,7,7,378.23546628727314,0.43409806567701303,0.20577997007806403,0.22972827794500683,132704.48022959172,2238.7081916099605,134943.1884212017,700,11,182.53846153846155,34,5,16,32.66777392643942,0.6516544117647058,42.41071428571428,1030.357142857142,30.30462184873947,0
1440,4,0,0,39,0.0,0.0,1.0,39,1200,800,400,0.6666666666666666,16,8,8,375.461553562732,0.4336763382816014,0.2051459743767441,0.22860380666287838,132796.4923469386,2171.995464852589,134968.4878117912,701,12,183.53846153846155,34,5,16,32.646588896588895,0.6525735294117647,42.32142857142856,1030.7142857142844,30.31512605042013,0
1441,4,0,0,39,0.0,0.0,1.0,39,1150,700,450,0.6086956521739131,16,7,9,374.0598023854607,0.43342330184435446,0.2044257112750265,0.2278643365283797,132815.23946544912,2136.1684456447047,134951.40791109382,702,13,184.53846153846155,35,4,16,32.66384085635151,0.6505952380952381,42.30324074074073,1030.7870370370363,29.451058201058178,0
1442,4,0,0,39,0.0,0.0,1.0,39,800,500,300,0.625,11,5,6,375.98933285801945,0.43302968960863697,0.20482884874443053,0.22940499843145454,132874.89819101503,2191.908864883395,135066.80705589842,703,14,185.53846153846155,35,4,16,32.55407124681934,0.6511904761904762,42.24537037037037,1031.018518518518,29.457671957671945,0
1443,4,0,1,38,0.0,0.02564102564102564,0.9743589743589743,39,900,700,200,0.7777777777777778,11,7,4,375.54617621020975,0.4322705802968961,0.20222197284255428,0.22968373206651874,132964.41139671206,2186.8552544152844,135151.26665112734,704,15,186.53846153846155,35,4,18,32.475428309579925,0.6520833333333333,42.15856481481481,1031.3657407407402,29.467592592592577,0
1444,4,0,0,38,0.0,0.0,1.0,38,1100,600,500,0.5454545454545454,16,6,10,382.7299299543339,0.4292022285443338,0.21164749421180207,0.23360281348375528,132888.5363520408,2572.084041950108,135460.62039399092,705,19,192.05263157894737,34,4,19,32.366595466266396,0.6534926470588236,42.232142857142854,1031.0714285714284,30.325630252100837,0
1445,4,0,0,38,0.0,0.0,1.0,38,850,400,450,0.47058823529411764,13,4,9,382.6278373824826,0.42936522048364156,0.21249498717933113,0.23373218105832616,132919.22477324272,2571.719104308397,135490.94387755112,706,20,193.05263157894737,34,4,20,32.33832640652658,0.6537990196078431,42.202380952380956,1031.1904761904768,30.329131652661083,0
1446,4,1,0,39,0.02564102564102564,0.0,1.0,39,700,600,100,0.8571428571428571,8,6,2,375.67214301514196,0.4288686459739091,0.21862711279751634,0.2314223422441346,133233.13185871064,2210.3952331961673,135443.5270919068,707,0,189.07692307692307,35,4,21,32.201980568011955,0.6547619047619048,41.89814814814815,1032.407407407408,29.497354497354518,0
1447,4,0,2,37,0.0,0.05128205128205128,0.9487179487179487,39,1250,800,450,0.64,17,8,9,370.78286881822487,0.42794084570400365,0.21775625226218986,0.22951511006043526,133412.42953746574,2093.40867198217,135505.83820944792,708,1,190.07692307692307,35,4,22,32.14812532676077,0.656547619047619,41.72453703703704,1033.1018518518522,29.517195767195776,0
1448,4,0,0,37,0.0,0.0,1.0,37,900,700,200,0.7777777777777778,11,7,4,384.05779636166574,0.4277715215215215,0.20928949832604338,0.2373049199220028,133345.6182718185,2842.4848615916953,136188.1031334102,709,2,186.78378378378378,33,4,22,31.87242920423984,0.6603535353535354,41.78921568627451,1032.8431372549019,31.298276886512177,0
1449,4,0,0,37,0.0,0.0,1.0,37,850,700,150,0.8235294117647058,10,7,3,380.48994651367985,0.4275838338338338,0.20861145843352258,0.2355014867188194,133408.91273788924,2752.1500144175297,136161.06275230678,710,3,187.78378378378378,33,4,22,31.900948991696318,0.6609848484848485,41.72794117647059,1033.0882352941176,31.305704099821746,0
1450,4,0,2,35,0.0,0.05405405405405406,0.9459459459459459,37,1050,900,150,0.8571428571428571,12,9,3,385.1223767656092,0.42648898898898896,0.21408997563407617,0.23919664462847304,133537.4658835832,2885.6682679306,136423.1341515138,711,4,188.78378378378378,32,5,22,31.652109292287665,0.6647135416666667,41.60353535353535,1033.5858585858577,32.299558080808055,0
1451,4,0,0,35,0.0,0.0,1.0,35,1300,1100,200,0.8461538461538461,15,11,4,390.9727948099437,0.42514005602240895,0.2085511849499153,0.24283029577497695,133537.46588358318,3441.9032496683926,136979.36913325157,712,5,194.25714285714287,32,3,22,31.50093655835168,0.6647135416666667,41.60353535353535,1033.5858585858575,32.29955808080805,0
1452,4,0,0,35,0.0,0.0,1.0,35,1150,900,250,0.782608695652174,14,9,5,387.13761055832765,0.42471988795518206,0.20443157233582254,0.24087254979115408,133602.72548719522,3344.5279818385907,136947.2534690338,713,6,195.25714285714287,32,3,22,31.53446099983716,0.6653645833333333,41.54040404040404,1033.838383838384,32.3074494949495,0
1453,4,0,0,35,0.0,0.0,1.0,35,800,600,200,0.75,10,6,4,388.2916542405535,0.4246848739495798,0.20479039826945544,0.24180382939740636,133635.36126734517,3377.899098306288,137013.26036565145,714,7,196.25714285714287,32,3,22,31.471842308788208,0.6656901041666667,41.50883838383838,1033.9646464646464,32.3113952020202,0
1454,4,0,0,35,0.0,0.0,1.0,35,1050,600,450,0.5714285714285714,15,6,9,390.8539691227068,0.4236344537815126,0.2055343411623165,0.24426137063480813,133765.94424357198,3456.5900482093525,137222.53429178134,715,8,197.25714285714287,32,3,17,31.274411082631513,0.6669921875,41.38257575757575,1034.469696969696,32.327178030303,0
1455,4,0,0,35,0.0,0.0,1.0,35,750,500,250,0.6666666666666666,10,5,5,389.68350567114027,0.42240896358543417,0.2046672127433382,0.24439446794080613,133896.59098880214,3435.4585947862392,137332.04958358838,716,9,198.25714285714287,32,3,17,31.17349843438657,0.6682942708333333,41.25631313131313,1034.9747474747471,32.34296085858585,0
1456,4,0,0,35,0.0,0.0,1.0,35,1500,1100,400,0.7333333333333333,19,11,8,386.45809976941064,0.42146358543417367,0.19979099174417425,0.24345079372570713,134059.98909550047,3361.7137281910063,137421.70282369148,717,10,199.25714285714287,32,3,19,31.09302609119728,0.669921875,41.09848484848485,1035.6060606060607,32.3626893939394,0
1457,4,0,0,35,0.0,0.0,1.0,35,900,600,300,0.6666666666666666,12,6,6,385.57741376707935,0.42065826330532213,0.19823822290310233,0.24376334802562816,134190.77932098764,3348.18672839506,137538.9660493827,718,11,200.25714285714287,32,3,21,30.984696157283285,0.6712239583333333,40.97222222222222,1036.111111111111,32.37847222222222,0
1458,4,0,0,35,0.0,0.0,1.0,35,1350,1100,250,0.8148148148148148,16,11,5,388.57584711595325,0.4193627450980392,0.193630307352455,0.2472016601365861,134419.81565975418,3446.4587478318604,137866.27440758605,719,12,201.25714285714287,32,3,21,30.677482852388486,0.6735026041666667,40.75126262626263,1036.99494949495,32.40609217171719,0
1459,4,0,0,35,0.0,0.0,1.0,35,1050,800,250,0.7619047619047619,13,8,5,388.17903051018584,0.41911764705882354,0.1933006365438803,0.24717074082253218,134452.55107897148,3438.332185491274,137890.88326446275,720,13,202.25714285714287,32,3,22,30.654979303627957,0.673828125,40.71969696969697,1037.1212121212118,32.41003787878787,0
1460,4,0,0,35,0.0,0.0,1.0,35,1350,1100,250,0.8148148148148148,16,11,5,383.65656135116427,0.4179621848739496,0.1855891553701774,0.24561191077153965,134649.04729109266,3331.7980945821732,137980.84538567482,721,14,203.25714285714287,32,3,22,30.57557785888077,0.67578125,40.530303030303024,1037.878787878787,32.433712121212096,0
1461,4,0,0,35,0.0,0.0,1.0,35,1200,900,300,0.75,15,9,6,384.6339460097808,0.4170168067226891,0.18129516397998913,0.24712731031128388,134780.124477094,3368.20222426281,138148.32670135683,722,15,204.25714285714287,32,3,18,30.41909857328146,0.6770833333333333,40.404040404040394,1038.3838383838372,32.44949494949491,0
1462,4,0,0,35,0.0,0.0,1.0,35,1650,1400,250,0.8484848484848485,19,14,5,383.93822262454705,0.4161764705882353,0.18240716629342257,0.24779824580214888,134944.06063475672,3362.0365587695205,138306.09719352625,723,16,205.25714285714287,32,3,19,30.273271357394577,0.6787109375,40.246212121212125,1039.015151515152,32.4692234848485,0
1463,4,0,0,35,0.0,0.0,1.0,35,800,400,400,0.5,12,4,8,383.529609261447,0.4152310924369748,0.18256976259891733,0.24820878486165354,135042.47015610663,3358.5571625344446,138401.02731864108,724,17,206.25714285714287,32,3,19,30.1855563654033,0.6796875,40.151515151515156,1039.3939393939402,32.48106060606063,0
1464,4,0,0,35,0.0,0.0,1.0,35,850,500,350,0.5882352941176471,12,5,7,383.3803595298574,0.41432072829131655,0.17828349406785526,0.24901582342964576,135173.73864911756,3364.5913044587455,138538.3299535763,725,18,207.25714285714287,32,3,19,30.058331309697262,0.6809895833333333,40.02525252525253,1039.898989898991,32.49684343434347,0
1465,4,0,0,35,0.0,0.0,1.0,35,850,600,250,0.7058823529411765,11,6,5,381.46709162032226,0.4137605042016807,0.17331484049930634,0.24867791415755186,135305.07091113148,3322.8863763901586,138627.95728752163,726,19,208.25714285714287,32,3,19,29.976992313915854,0.6822916666666667,39.898989898989896,1040.4040404040402,32.512626262626256,0
1466,4,0,1,34,0.0,0.02857142857142857,0.9714285714285714,35,1050,800,250,0.7619047619047619,13,8,5,381.0512800931207,0.4125700280112045,0.17919966725013414,0.2490884775422358,135403.6119560504,3319.1439330170347,138722.75588906743,727,20,209.25714285714287,32,3,19,29.88950220389017,0.6832682291666667,39.80429292929293,1040.7828282828282,32.52446338383838,0
1467,4,0,0,34,0.0,0.0,1.0,34,800,600,200,0.75,10,6,4,397.0010983120806,0.41263740344622696,0.142615369614576,0.2491137649586799,133915.80912389458,3832.9446607074137,137748.75378460198,728,21,206.73529411764707,33,1,16,30.96485515826032,0.6660353535353536,41.23774509803921,1035.0490196078426,31.365121806298262,8
1468,4,0,0,34,0.0,0.0,1.0,34,1400,1000,400,0.7142857142857143,18,10,8,398.2073456811737,0.4119318181818182,0.14033414549251666,0.2507341334579669,134042.68340301796,3875.3562331795356,137918.0396361975,729,22,207.73529411764707,33,1,16,30.80621301775148,0.6672979797979798,41.11519607843137,1035.5392156862738,31.379976232917386,0
1469,4,0,1,33,0.0,0.029411764705882353,0.9705882352941176,34,1100,700,400,0.6363636363636364,15,7,8,397.2279257604794,0.41128193701723115,0.13330109045866134,0.25076681526910605,134137.8785352988,3856.6622512975628,137994.54078659636,730,23,208.73529411764707,33,1,16,30.736005954493475,0.6682449494949495,41.02328431372548,1035.906862745097,31.391117052881725,0
1470,4,0,0,33,0.0,0.0,1.0,33,550,300,250,0.5454545454545454,8,3,5,405.84047903485066,0.4103535353535353,0.13518676584156442,0.2554334434815663,134027.30150303527,4278.740849148032,138306.0423521833,731,24,212.96969696969697,32,1,16,30.62406007397473,0.6695963541666667,41.1300505050505,1035.479797979797,32.35874368686866,0
1471,4,0,0,33,0.0,0.0,1.0,33,950,600,350,0.631578947368421,13,6,7,407.2400192003996,0.4090909090909091,0.13874334917346975,0.25768842232672906,134223.4868412661,4332.235071676348,138555.72191294245,732,25,213.96969696969697,32,1,16,30.39072336623209,0.6715494791666667,40.94065656565656,1036.237373737373,32.382417929292906,0
1472,4,1,0,34,0.029411764705882353,0.0,1.0,34,650,400,250,0.6153846153846154,9,4,5,399.7152668868018,0.40974079025549615,0.13992956637510234,0.2554323532873823,134583.5326114681,3959.4170875420787,138542.94969901018,733,0,208.64705882352942,32,2,17,30.224557881074066,0.6751302083333333,40.59343434343434,1037.626262626262,32.425820707070685,0
1473,4,0,0,34,0.0,0.0,1.0,34,800,500,300,0.625,11,5,6,401.70760296233163,0.4089609328579917,0.14291541434091926,0.2571679514291561,134649.04729109266,4017.909205693283,138666.95649678595,734,1,209.64705882352942,32,2,17,30.10720802919708,0.67578125,40.530303030303024,1037.878787878787,32.433712121212096,0
1474,4,0,0,34,0.0,0.0,1.0,34,1050,800,250,0.7619047619047619,13,8,5,399.4471670653606,0.4075497623291741,0.1373168917372396,0.2566448048394941,134780.12447709413,3967.50777981838,138747.6322569125,735,2,210.64705882352942,32,2,17,30.034553339818405,0.6770833333333333,40.4040404040404,1038.383838383838,32.44949494949494,0
1475,4,0,1,33,0.0,0.029411764705882353,0.9705882352941176,34,700,400,300,0.5714285714285714,10,4,6,399.06290616133595,0.4071041295306001,0.13912129403183582,0.25686161706440935,134845.68698347113,3962.3823461891698,138808.0693296603,736,3,211.64705882352942,32,2,17,29.978877947969842,0.677734375,40.34090909090909,1038.6363636363642,32.45738636363638,0
1476,4,0,0,33,0.0,0.0,1.0,33,1150,600,550,0.5217391304347826,17,6,11,406.06385454206907,0.40542140151515155,0.15405654894184395,0.2614343315320488,134854.90798950198,4351.94074842665,139206.84873792864,737,4,218.1818181818182,31,2,17,29.787853620826542,0.6804435483870968,40.33203125,1038.6718750000002,33.50554435483872,0
1477,4,0,0,33,0.0,0.0,1.0,33,900,600,300,0.6666666666666666,12,6,6,405.8039836433189,0.40431660353535354,0.15380876433508006,0.2619996593425311,134956.35986328125,4353.165690104167,139309.5255533854,738,5,219.1818181818182,31,2,17,29.69298245614035,0.6814516129032258,40.234375,1039.0625,33.51814516129032,0
1478,4,0,1,32,0.0,0.030303030303030304,0.9696969696969697,33,1150,1000,150,0.8695652173913043,13,10,3,403.287867076182,0.40376420454545453,0.15460579569370214,0.26194628337850445,135173.73864911756,4302.7857489031885,139476.52439802076,739,6,220.1818181818182,32,1,17,29.54078638497652,0.6809895833333333,40.02525252525253,1039.898989898991,32.49684343434347,0
1479,4,0,0,32,0.0,0.0,1.0,32,950,700,250,0.7368421052631579,12,7,5,413.7298762669044,0.40486391129032256,0.1511388541014398,0.2683698669367371,135125.5310906305,4781.093851725265,139906.6249423558,740,7,222.46875,31,1,17,29.317600709663946,0.6831317204301075,40.071614583333336,1039.7135416666672,33.53914650537636,0
1480,4,0,0,32,0.0,0.0,1.0,32,850,600,250,0.7058823529411765,11,6,5,414.5748673320697,0.40419186827956993,0.15268952673093694,0.26942306471775784,135193.22925143785,4809.543016221797,140002.77226765966,741,8,223.46875,31,1,17,29.22783377154541,0.6838037634408602,40.00651041666667,1039.9739583333344,33.54754704301079,0
1481,4,0,0,32,0.0,0.0,1.0,32,750,500,250,0.6666666666666666,10,5,5,415.9235339543638,0.40341481854838707,0.154263141426783,0.27106272726715896,135294.80828179262,4854.458957248275,140149.2672390409,742,9,224.46875,31,1,17,29.091051314142664,0.6848118279569892,39.90885416666667,1040.3645833333342,33.56014784946239,0
1482,4,0,0,32,0.0,0.0,1.0,32,800,400,400,0.5,12,4,8,420.73737893802337,0.4021757392473118,0.15711426491994174,0.275282456505164,135436.46694214878,4996.636822773188,140433.10376492198,743,10,225.46875,32,0,17,28.82399320718098,0.68359375,39.77272727272727,1040.909090909091,32.52840909090909,0
1483,4,0,2,30,0.0,0.0625,0.9375,32,600,300,300,0.5,9,3,6,420.73737893802337,0.4021757392473118,0.15711426491994174,0.275282456505164,135436.46694214878,4996.636822773188,140433.10376492198,744,11,226.46875,32,0,17,28.82399320718098,0.68359375,39.77272727272727,1040.909090909091,32.52840909090909,0
1484,4,0,0,30,0.0,0.0,1.0,30,650,400,250,0.6153846153846154,9,4,5,431.1856926333216,0.3998563218390805,0.14124892334194628,0.2809240118671642,135283.88397502608,5666.495042779517,140950.3790178056,745,12,231.96666666666667,30,0,18,28.70504952627045,0.6875,39.91935483870968,1040.322580645162,34.67741935483873,0
1485,4,0,0,30,0.0,0.0,1.0,30,500,200,300,0.4,8,2,6,431.1856926333216,0.3998563218390805,0.14124892334194628,0.2809240118671642,135283.88397502608,5666.495042779517,140950.3790178056,746,13,232.96666666666667,30,0,18,28.70504952627045,0.6875,39.91935483870968,1040.322580645162,34.67741935483873,0
1486,4,0,0,30,0.0,0.0,1.0,30,750,600,150,0.8,9,6,3,428.2278100623165,0.39913793103448275,0.14201326100060285,0.27953960417390006,135353.80715978725,5592.4528847265565,140946.2600445138,747,14,233.96666666666667,30,0,18,28.711896150865403,0.6881944444444444,39.85215053763441,1040.5913978494623,34.68637992831541,0
1487,4,0,0,30,0.0,0.0,1.0,30,600,200,400,0.3333333333333333,10,2,8,423.1390852707265,0.3986111111111111,0.020520860552216913,0.25421558545228706,132294.27715631845,5195.775884495293,137490.05304081374,748,15,234.96666666666667,30,0,17,31.926389251807333,0.6576388888888889,42.809139784946225,1028.7634408602134,34.29211469534045,8
1488,4,0,0,30,0.0,0.0,1.0,30,1000,600,400,0.6,14,6,8,402.6811112557731,0.39774904214559387,0.032334122184240366,0.23167870894186185,130640.18419759521,4521.266909469318,135161.45110706452,749,16,235.96666666666667,30,0,19,34.13040143746165,0.6409722222222223,44.422043010752695,1022.3118279569902,34.07706093189967,8
1489,4,0,0,30,0.0,0.0,1.0,30,650,500,150,0.7692307692307693,8,5,3,401.87950711887225,0.3979166666666667,0.040605423402111374,0.2318348119535633,130743.26014929482,4508.607389582624,135251.86753887744,750,17,236.96666666666667,30,0,19,34.046031015902216,0.6420138888888889,44.32123655913979,1022.7150537634416,34.09050179211472,0
1490,4,0,0,30,0.0,0.0,1.0,30,800,300,500,0.375,13,3,10,400.31621669908054,0.3978927203065134,0.04534069013837838,0.2315506870450913,130846.37674875715,4475.985301769001,135322.36205052614,751,18,237.96666666666667,30,0,19,33.9811591346996,0.6430555555555555,44.22043010752689,1023.1182795698929,34.10394265232976,0
1491,4,0,0,30,0.0,0.0,1.0,30,400,300,100,0.75,5,3,2,401.5421987689004,0.3980603448275862,0.044656070756162736,0.23246697788803328,130880.757981414,4510.8294672794555,135391.58744869346,752,19,238.96666666666667,30,0,19,33.91484959936951,0.6434027777777778,44.18682795698925,1023.2526881720428,34.10842293906809,0
1492,4,0,0,30,0.0,0.0,1.0,30,900,500,400,0.5555555555555556,13,5,8,401.97040002517747,0.3973419540229885,0.05007222586999349,0.2331305861532161,130949.53399598224,4527.56731269512,135477.10130867737,753,20,239.96666666666667,30,0,20,33.83398993215146,0.6440972222222222,44.11962365591398,1023.5215053763445,34.11738351254482,0
1493,4,0,0,30,0.0,0.0,1.0,30,650,400,250,0.6153846153846154,9,4,5,399.8795601000545,0.3973659003831418,0.049374288964732393,0.23254064800322258,131052.73189097013,4481.061755694308,135533.79364666445,754,21,240.96666666666667,30,0,20,33.78265292727749,0.6451388888888889,44.01881720430108,1023.9247311827963,34.130824372759875,0
1494,4,0,0,30,0.0,0.0,1.0,30,400,300,100,0.75,5,3,2,399.8795601000545,0.3973659003831418,0.049374288964732393,0.23254064800322258,131052.73189097013,4481.061755694308,135533.79364666445,755,22,241.96666666666667,30,0,20,33.78265292727749,0.6451388888888889,44.01881720430108,1023.9247311827963,34.130824372759875,0
1495,4,0,0,30,0.0,0.0,1.0,30,1100,1000,100,0.9090909090909091,12,10,2,401.2531102796207,0.3980124521072797,0.052188552188551895,0.23438716165988896,131224.81871097826,4530.873330731893,135755.69204171016,756,23,242.96666666666667,30,0,20,33.5727403909222,0.646875,43.85080645161291,1024.5967741935494,34.15322580645165,0
1496,4,0,0,30,0.0,0.0,1.0,30,1250,1100,150,0.88,14,11,3,403.33869174616507,0.39794061302681993,0.05364446775039333,0.23666673389536533,131397.0184414384,4599.500303503304,135996.5187449417,757,24,243.96666666666667,30,0,20,33.3445311134417,0.6486111111111111,43.682795698924735,1025.2688172043017,34.17562724014339,0
1497,4,0,0,30,0.0,0.0,1.0,30,350,300,50,0.8571428571428571,4,3,1,401.4531862740888,0.398132183908046,0.04902577544779363,0.23598519347236502,131465.929948549,4555.483292866231,136021.41324141523,758,25,244.96666666666667,30,0,20,33.32295762341634,0.6493055555555556,43.615591397849464,1025.5376344086023,34.18458781362008,0
1498,4,0,0,30,0.0,0.0,1.0,30,950,600,350,0.631578947368421,13,6,7,401.83108757492835,0.39772509578544063,0.040196463654224024,0.23727612943809573,131638.287753642,4579.271266909467,136217.55902055147,759,26,245.96666666666667,30,0,19,33.13850687622789,0.6510416666666667,43.44758064516129,1026.2096774193546,34.206989247311824,0
1499,4,0,0,30,0.0,0.0,1.0,30,700,500,200,0.7142857142857143,9,5,4,403.4209448981256,0.39810823754789276,0.04641002138710659,0.238646456714716,131707.2624906058,4626.693656781122,136333.95614738693,760,27,246.96666666666667,30,0,19,33.027803238619,0.6517361111111111,43.38037634408602,1026.4784946236555,34.215949820788516,0
1500,4,0,0,30,0.0,0.0,1.0,30,700,500,200,0.7142857142857143,9,5,4,404.6358452187285,0.3975814176245211,0.05180870096434931,0.2397993189779572,131776.2552932421,4664.279288067999,136440.53458131012,761,28,247.96666666666667,30,0,19,32.92670288432167,0.6524305555555556,43.31317204301076,1026.747311827958,34.224910394265265,0
1501,4,1,0,31,0.03225806451612903,0.0,1.0,31,800,500,300,0.625,11,5,6,392.8480606063159,0.40026881720430113,0.05045607355998771,0.2352025121006883,132163.59668307845,4184.042527940548,136347.639211019,762,0,240.93548387096774,31,0,20,32.83749630661433,0.6535618279569892,42.93619791666667,1028.2552083333342,33.16952284946239,0
1502,4,0,0,31,0.0,0.0,1.0,31,600,500,100,0.8333333333333334,7,5,2,424.67442532164796,0.39982078853046593,0.06770474916330804,0.23207949948605924,128621.28434284312,4769.400806142524,133390.68514898565,763,1,241.93548387096774,30,1,17,35.63502053796211,0.6204861111111111,46.40456989247312,1014.3817204301076,33.81272401433692,8
1503,4,0,0,31,0.0,0.0,1.0,31,650,600,50,0.9230769230769231,7,6,1,424.5585791848972,0.39932795698924733,0.07228472901772931,0.23241426499396606,128689.46419022439,4727.243214533483,133416.70740475788,764,2,242.93548387096774,30,1,17,35.567900825716436,0.6211805555555556,46.337365591397855,1014.6505376344093,33.82168458781364,0
1504,4,0,0,31,0.0,0.0,1.0,31,1000,700,300,0.7,13,7,6,422.72568054531234,0.39928315412186377,0.06572036178226481,0.23240682611639682,128859.99284599387,4694.485634177381,133554.47848017124,765,3,243.93548387096774,30,1,17,35.43928161680346,0.6229166666666667,46.16935483870969,1015.3225806451622,33.84408602150541,0
1505,4,0,0,31,0.0,0.0,1.0,31,800,600,200,0.75,10,6,4,424.8104360566213,0.39856630824372763,0.07188476579176561,0.2339553684288508,128928.23592322822,4754.012024511518,133682.24794773973,766,4,244.93548387096774,30,1,18,35.316304923239805,0.6236111111111111,46.102150537634415,1015.5913978494632,33.853046594982104,0
1506,4,2,0,33,0.06060606060606061,0.0,1.0,33,450,200,250,0.4444444444444444,7,2,5,412.8805944281226,0.40818339646464646,0.036432588886617046,0.22797402580585682,129030.63441221528,4062.296580529539,133092.9309927448,767,0,231.03030303030303,30,3,20,35.51423248225073,0.6246527777777777,46.001344086021504,1015.994623655914,33.86648745519713,8
1507,4,0,0,33,0.0,0.0,1.0,33,700,600,100,0.8571428571428571,8,6,2,410.2284996928246,0.40845959595959597,0.03065633917651822,0.2269194500427001,129102.12410820863,3992.274136013461,133094.3982442221,768,1,232.03030303030303,31,2,20,35.50835468716633,0.6226478494623655,45.930989583333336,1016.2760416666673,32.78309811827959,0
1508,4,1,0,34,0.029411764705882353,0.0,1.0,34,750,300,450,0.4,12,3,9,403.231415496499,0.41174613784907904,0.0415786694825766,0.2259527517604644,129611.66030755012,3652.7749440782904,133264.4352516284,769,0,226.1764705882353,30,4,18,35.165049718409016,0.6305555555555555,45.43010752688173,1018.279569892474,33.94265232974913,0
1509,4,0,0,34,0.0,0.0,1.0,34,950,600,350,0.631578947368421,13,6,7,401.8571098196306,0.411300505050505,0.03968278614072007,0.22537907632149068,129645.87894915587,3619.8236429066847,133265.70259206256,770,1,227.1764705882353,30,4,18,35.165082926400075,0.6309027777777778,45.39650537634408,1018.4139784946228,33.94713261648743,0
1510,4,0,1,33,0.0,0.029411764705882353,0.9705882352941176,34,1000,700,300,0.7,13,7,6,400.9376046006476,0.41078060011883544,0.04389068646849337,0.22565018414829313,129782.79867976061,3606.9608842062607,133389.7595639669,771,2,228.1764705882353,30,4,18,35.0486963021589,0.6322916666666667,45.262096774193544,1018.9516129032254,33.96505376344085,0
1511,4,0,1,32,0.0,0.030303030303030304,0.9696969696969697,33,1300,900,400,0.6923076923076923,17,9,8,410.17841300131147,0.4065656565656566,0.0468021465646169,0.23024681583140275,129680.10210717998,4038.395696034219,133718.4978032142,772,3,235.96969696969697,30,3,19,34.918239201196435,0.63125,45.36290322580645,1018.5483870967739,33.9516129032258,0
1512,4,0,0,32,0.0,0.0,1.0,32,1300,1000,300,0.7692307692307693,16,10,6,419.22011874460304,0.40391885080645157,0.05551440539436059,0.23691261675936323,129943.77170138883,4495.008680555551,134438.78038194438,773,4,243.125,29,3,20,34.41842051491624,0.6368534482758621,45.104166666666664,1019.5833333333328,35.158045977011476,0
1513,4,0,0,32,0.0,0.0,1.0,32,750,500,250,0.6666666666666666,10,5,5,419.1966397909882,0.4028687836021505,0.05754339686861809,0.23776056519419336,130085.41907793192,4506.274112654295,134591.6931905862,774,5,244.125,29,3,20,34.274307919219424,0.6382902298850575,44.965277777777764,1020.1388888888874,35.17720306513405,0
1514,4,0,0,32,0.0,0.0,1.0,32,800,600,200,0.75,10,6,4,423.230668293704,0.40225974462365593,0.062022649460100165,0.24093056184575595,130228.28686842394,4623.320976413435,134851.60784483736,775,6,245.125,30,2,20,34.025491616188205,0.6368055555555556,44.82526881720429,1020.6989247311815,34.02329749103938,0
1515,4,0,0,32,0.0,0.0,1.0,32,750,400,350,0.5333333333333333,11,4,7,417.5495795687418,0.40242775537634407,0.04601476476476507,0.21485829359265718,126188.15491230677,4137.971238873953,130326.12615118072,776,7,246.125,28,4,21,38.326421659755,0.6015625,48.814655172413794,1004.7413793103447,35.88362068965517,8
1516,4,0,0,32,0.0,0.0,1.0,32,1100,800,300,0.7272727272727273,14,8,6,418.06949298122004,0.4037718413978495,0.05480473774474781,0.21588429833133554,126332.55559271366,4163.157492733516,130495.71308544718,777,8,247.125,28,4,18,38.163677290267266,0.6030505952380952,48.67097701149425,1005.3160919540227,35.904146141215094,0
1517,4,3,2,33,0.08571428571428572,0.05714285714285714,0.9428571428571428,35,1350,1000,350,0.7407407407407407,17,10,7,385.05226396262833,0.41593137254901963,0.0647049068563319,0.2040540124745219,127387.59570651573,2810.1764255099647,130197.7721320257,778,0,226.85714285714286,31,4,19,37.90589126789629,0.6051747311827957,47.62369791666666,1009.5052083333323,32.564684139784916,0
1518,4,0,0,33,0.0,0.0,1.0,33,900,800,100,0.8888888888888888,10,8,2,410.14957994672517,0.406289457070707,0.0676183320811421,0.21577434423284217,127092.01388888876,3825.347222222204,130917.36111111096,779,1,241.6060606060606,29,4,21,37.57747933884298,0.6077586206896552,47.91666666666666,1008.3333333333322,34.7701149425287,0
1519,4,1,0,34,0.029411764705882353,0.0,1.0,34,1150,900,250,0.782608695652174,14,9,5,403.1207559981893,0.4081439393939394,0.09520494367959964,0.21530313104448745,127702.6245808764,3495.915712799169,131198.54029367559,780,0,235.47058823529412,30,4,20,37.12544326241136,0.6111111111111112,47.31182795698925,1010.752688172043,33.691756272401435,0
1520,4,1,0,35,0.02857142857142857,0.0,1.0,35,1000,700,300,0.7,13,7,6,394.66286101799585,0.4120448179271709,0.10133411738762965,0.21276762008002076,128078.62175835494,3109.5750596788143,131188.19681803376,781,0,229.71428571428572,31,4,21,36.952769916816756,0.612231182795699,46.940104166666664,1012.2395833333326,32.65288978494621,0
1521,4,2,0,37,0.05405405405405406,0.0,1.0,37,1450,1200,250,0.8275862068965517,17,12,5,375.3282837311925,0.42038913913913917,0.12002379104206784,0.2066232297091022,128912.72454660248,2276.9352852477323,131189.6598318502,782,0,218.24324324324326,32,5,23,36.588493099589705,0.6181640625,46.11742424242425,1015.5303030303038,31.735321969696994,0
1522,4,0,0,37,0.0,0.0,1.0,37,1000,600,400,0.6,14,6,8,370.9600709849154,0.41954454454454454,0.12604331039113603,0.20538023187266652,129137.21335833088,2180.9499668401254,131318.163325171,783,1,219.24324324324326,32,5,23,36.47023809523808,0.6204427083333333,45.89646464646465,1016.4141414141423,31.762941919191945,0
1523,4,0,0,37,0.0,0.0,1.0,37,1100,600,500,0.5454545454545454,16,6,10,371.06989948466173,0.41898148148148145,0.12251760078926743,0.2061101358930667,129265.58036169788,2193.3131823283493,131458.89354402624,784,2,220.24324324324326,32,5,24,36.33649946196509,0.6217447916666667,45.77020202020203,1016.9191919191927,31.778724747474772,0
1524,4,0,0,37,0.0,0.0,1.0,37,1400,1000,400,0.7142857142857143,18,10,8,375.7285380309312,0.418480980980981,0.11185698852251647,0.20789365421862677,129113.15164448309,2306.129267341988,131419.28091182507,785,3,221.24324324324326,35,2,16,36.373633413050904,0.6133928571428571,45.92013888888889,1016.3194444444449,29.037698412698425,8
1525,4,1,0,38,0.02631578947368421,0.0,1.0,38,1000,500,500,0.5,15,5,10,365.5784744219542,0.42123044096728307,0.11937899628469228,0.2042087918310028,129487.77113261925,1867.5883653924327,131355.35949801168,786,0,216.39473684210526,36,2,15,36.24972339013056,0.615162037037037,45.55180180180181,1017.792792792794,28.272022022022057,0
1526,4,0,0,38,0.0,0.0,1.0,38,1150,700,450,0.6086956521739131,16,7,9,362.76101517454094,0.4206377430061641,0.11555026568965765,0.2033755647999614,129631.08114448926,1805.0205188296584,131436.10166331893,787,1,217.39473684210526,36,2,16,36.1755409340558,0.6166087962962963,45.411036036036045,1018.3558558558573,28.2876626626627,0
1527,4,0,0,38,0.0,0.0,1.0,38,1600,1100,500,0.6875,21,11,10,362.8009542352534,0.41847439544807963,0.11288578272902727,0.20474278290134165,129889.2389010635,1824.787963639347,131714.02686470284,788,2,218.39473684210526,36,2,16,35.911953159522774,0.619212962962963,45.15765765765767,1019.3693693693715,28.315815815815874,0
1528,4,0,0,38,0.0,0.0,1.0,38,1150,800,350,0.6956521739130435,15,8,7,362.0906778350962,0.4187855618776672,0.10353977157139105,0.20479269755133034,129975.34855379042,1812.572411938983,131787.9209657294,789,3,219.39473684210526,36,2,17,35.84253635192343,0.6200810185185186,45.073198198198206,1019.7072072072084,28.325200200200232,0
1529,4,1,2,37,0.02564102564102564,0.05128205128205128,0.9487179487179487,39,1700,1200,500,0.7058823529411765,22,12,10,352.9487557368412,0.4204059829059829,0.12112253464910472,0.20182428850145342,130402.54122662745,1405.0829341720587,131807.62416079952,790,0,214.74358974358975,37,2,19,35.6422213276078,0.6224662162162162,44.6546052631579,1021.3815789473687,27.604907539118074,0
1530,4,1,1,37,0.02631578947368421,0.02631578947368421,0.9736842105263158,38,1600,1000,600,0.625,22,10,12,355.81493799677196,0.420059862494073,0.12169167961773075,0.2043909099530825,130578.91506371238,1692.3857134161183,132271.3007771285,791,0,213.18421052631578,36,2,17,35.39026920816806,0.6261574074074074,44.48198198198198,1022.0720720720723,28.390890890890898,0
1531,4,0,0,37,0.0,0.0,1.0,37,850,600,250,0.7058823529411765,11,6,5,364.9722893209963,0.4171046046046046,0.12876196309624088,0.20874144220724494,130410.31867551855,2119.230511616926,132529.54918713548,792,2,219.94594594594594,35,2,19,35.327313503305,0.6264880952380952,44.64699074074073,1021.4120370370359,29.183201058201025,0
1532,4,0,0,37,0.0,0.0,1.0,37,1200,900,300,0.75,15,9,6,364.4896539704997,0.41704204204204204,0.13132924473130703,0.2087832690199608,130469.4348663621,2110.951833633381,132580.3866999955,793,3,220.94594594594594,35,2,19,35.2796580567199,0.6270833333333333,44.58912037037036,1021.6435185185169,29.189814814814767,0
1533,4,0,1,36,0.0,0.02702702702702703,0.972972972972973,37,1150,1000,150,0.8695652173913043,13,10,3,367.7708530245747,0.41660410410410414,0.1270564042303175,0.21146824048913043,130617.28395061726,2207.445987654318,132824.72993827157,794,4,221.94594594594594,35,2,18,35.045855978260875,0.6285714285714286,44.44444444444444,1022.2222222222221,29.206349206349202,0
1534,4,0,0,36,0.0,0.0,1.0,36,950,600,350,0.631578947368421,13,6,7,371.99263375584064,0.41681547619047615,0.06486042692939242,0.2040932558173937,128778.12500000003,2380.9027777777787,131159.0277777778,795,5,224.36111111111111,34,2,18,36.81068691844552,0.6121323529411764,46.25,1015.0000000000002,29.852941176470594,8
1535,4,2,0,38,0.05263157894736842,0.0,1.0,38,750,500,250,0.6666666666666666,10,5,5,356.72045895729315,0.42315670934091987,0.06417952199733068,0.19824876706728112,129287.27027280678,1623.882877810263,130911.15315061704,796,0,213.5,36,2,20,36.679216033661824,0.6131365740740741,45.74887387387388,1017.004504504506,28.250125125125166,0
1536,4,1,1,38,0.02564102564102564,0.02564102564102564,0.9743589743589743,39,850,600,250,0.7058823529411765,11,6,5,347.464581732282,0.42571974808816915,0.07285298519414418,0.19460531399071004,129591.85157933214,1205.7157009849236,130797.56728031706,797,0,209.0,37,2,17,36.604835235838905,0.6143018018018018,45.449561403508774,1018.2017543859652,27.518966334755817,0
1537,4,0,0,38,0.0,0.0,1.0,38,1000,800,200,0.8,12,8,4,353.56385681512756,0.42337897107633954,0.06961627175508434,0.19721006235688257,129430.46932067226,1552.3871844818034,130982.85650515406,798,1,215.47368421052633,36,2,17,36.613730264128655,0.6145833333333333,45.60810810810812,1017.5675675675695,28.26576576576582,0
1538,4,0,1,37,0.0,0.02631578947368421,0.9736842105263158,38,1150,800,350,0.6956521739130435,15,8,7,352.96097383485187,0.422445471787577,0.07070513044389326,0.1977368727022759,129602.4128013149,1548.9187667397207,131151.33156805462,799,2,216.47368421052633,36,2,17,36.454186020791866,0.6163194444444444,45.43918918918919,1018.2432432432438,28.28453453453455,0
1539,4,1,0,38,0.02631578947368421,0.0,1.0,38,950,700,250,0.7368421052631579,12,7,5,358.053351736448,0.4246829065908013,0.09203932382208357,0.1979665257081872,129083.74592764051,1645.4507184862434,130729.19664612676,800,0,216.47368421052633,35,3,17,36.852695520121486,0.6130952380952381,45.94907407407407,1016.203703703703,29.034391534391514,8
1540,4,1,0,39,0.02564102564102564,0.0,1.0,39,1400,900,500,0.6428571428571429,19,9,10,345.0463524943222,0.42645074224021595,0.08737803494440666,0.1930209793656355,129545.0856261666,1139.8118557746823,130684.89748194128,801,0,211.89743589743588,36,3,15,36.713910398230084,0.6157407407407407,45.49549549549549,1018.0180180180173,28.278278278278258,0
1541,4,0,0,39,0.0,0.0,1.0,39,1500,1200,300,0.8,18,12,6,349.7451237752206,0.4258040935672514,0.09757189403598288,0.19708551495428056,129831.84831791245,1281.61117198279,131113.45948989523,802,1,212.89743589743588,36,3,16,36.302946593001835,0.6186342592592593,45.21396396396396,1019.1441441441438,28.30955955955955,0
1542,4,0,1,38,0.0,0.02564102564102564,0.9743589743589743,39,1400,1100,300,0.7857142857142857,17,11,6,349.37157802569646,0.4256354026090868,0.08863368669022398,0.19774431316254396,130004.05811216607,1283.944586478351,131288.0026986444,803,2,213.89743589743588,36,3,16,36.13764355123675,0.6203703703703703,45.045045045045036,1019.8198198198186,28.328328328328293,0
1543,4,0,0,38,0.0,0.0,1.0,38,1200,900,300,0.75,15,9,6,360.1259926724596,0.42201576576576577,0.10359321507310093,0.20348620073455392,129937.87140185611,1758.8009848679665,131696.6723867241,804,3,220.3421052631579,35,3,16,35.93070060922542,0.6217261904761905,45.1099537037037,1019.560185185185,29.130291005291,0
1544,4,1,1,38,0.02564102564102564,0.02564102564102564,0.9743589743589743,39,1050,900,150,0.8571428571428571,12,9,3,353.9548466723704,0.4232174988753936,0.1080384106409693,0.20211980791089773,130348.82010388775,1427.5193267592012,131776.33943064694,805,0,215.66666666666666,36,3,17,35.67099507425378,0.6238425925925926,44.70720720720721,1021.1711711711717,28.36586586586588,0
1545,4,0,0,38,0.0,0.0,1.0,38,1100,700,400,0.6363636363636364,15,7,8,360.0166597251145,0.4202524893314367,0.10472610096670243,0.20512577123872802,130262.58680555552,1779.3402777777728,132041.92708333328,806,1,221.71052631578948,35,3,17,35.60374149659863,0.625,44.791666666666664,1020.833333333333,29.166666666666657,0
1546,4,0,1,37,0.0,0.02631578947368421,0.9736842105263158,38,1050,800,250,0.7619047619047619,13,8,5,358.3159482862395,0.41974869606448556,0.10920232592813495,0.20493442926934952,130410.31867551865,1745.6194005058287,132155.93807602447,807,2,222.71052631578948,35,3,20,35.49728517469312,0.6264880952380952,44.64699074074074,1021.4120370370367,29.18320105820105,0
1547,4,0,0,37,0.0,0.0,1.0,37,1150,800,350,0.6956521739130435,15,8,7,360.03081342537143,0.41694819819819817,0.1285381851617431,0.2064224763947873,130505.75573979598,1997.2186791383253,132502.9744189343,808,3,228.94594594594594,34,3,16,35.356712882053664,0.6295955882352942,44.55357142857143,1021.7857142857148,30.052521008403374,0
1548,4,0,0,37,0.0,0.0,1.0,37,1550,1300,250,0.8387096774193549,18,13,5,361.81308368151497,0.4164476976976977,0.12138564641474958,0.20858888515598745,130718.71456916102,2059.1482426303846,132777.86281179142,809,4,229.94594594594594,34,3,16,35.09531431897555,0.6317401960784313,44.345238095238095,1022.6190476190478,30.077030812324935,0
1549,4,1,1,37,0.02631578947368421,0.02631578947368421,0.9736842105263158,38,1250,1000,250,0.8,15,10,5,353.79676904326567,0.4171111901375059,0.12456219636199295,0.20642420585378649,131179.87403817283,1682.203119641613,132862.07715781443,810,0,224.8684210526316,35,3,18,34.833752306707346,0.6342261904761906,43.89467592592592,1024.421296296295,29.269179894179857,0
1550,4,0,1,36,0.0,0.02702702702702703,0.972972972972973,37,900,600,300,0.6666666666666666,12,6,6,363.2671904410848,0.413475975975976,0.12778468845414492,0.21175819150102243,131145.15306122435,2128.1462585033905,133273.29931972775,811,1,231.7027027027027,34,3,19,34.62633658763367,0.6360294117647058,43.92857142857142,1024.2857142857133,30.12605042016804,0
1551,4,0,0,36,0.0,0.0,1.0,36,1150,900,250,0.782608695652174,14,9,5,368.2561985848429,0.4111276455026455,0.13569795115206174,0.21446111857655273,131108.3946829345,2456.295805699738,133564.69048863425,812,2,238.44444444444446,33,3,19,34.53579334689483,0.6379419191919191,43.96446078431373,1024.1421568627454,31.03461081402259,0
1552,4,0,0,36,0.0,0.0,1.0,36,1100,700,400,0.6363636363636364,15,7,8,391.6436818130194,0.41031746031746036,0.14968463421718758,0.21387312685275198,128592.36501696237,2923.3968756696586,131515.76189263203,813,3,239.44444444444446,32,4,17,36.50229262625005,0.6149088541666667,46.433080808080796,1014.2676767676753,31.695864898989853,8
1553,4,0,0,36,0.0,0.0,1.0,36,1500,1000,500,0.6666666666666666,20,10,10,393.3643350412118,0.41162367724867727,0.14788557213930353,0.2160279544898457,128816.574839302,2934.3692607896965,131750.9441000917,814,4,240.44444444444446,32,4,18,36.22901119402985,0.6171875,46.212121212121204,1015.1515151515142,31.72348484848482,0
1554,4,2,0,38,0.05263157894736842,0.0,1.0,38,1250,1000,250,0.8,15,10,5,374.2175198181524,0.41928935514461835,0.13847741061254704,0.208318482530691,129352.72285997706,2081.211026077068,131433.93388605412,815,0,228.73684210526315,34,4,20,36.167593134386586,0.617953431372549,45.684523809523796,1017.2619047619027,29.919467787114783,0
1555,4,0,0,38,0.0,0.0,1.0,38,1100,900,200,0.8181818181818182,13,9,4,376.97686263526793,0.4189781887150308,0.1409317045538505,0.21033930951738045,129443.56575963707,2159.4458616779884,131603.01162131506,816,1,229.73684210526315,34,4,17,36.004767197005144,0.6188725490196079,45.59523809523809,1017.6190476190467,29.92997198879549,0
1556,4,1,2,37,0.02564102564102564,0.05128205128205128,0.9487179487179487,39,950,600,350,0.631578947368421,13,6,7,372.06713314314436,0.421221322537112,0.14823745249639697,0.2096001988052067,129819.89354263099,1860.3431230709687,131680.23666570196,817,0,224.82051282051282,35,4,19,35.74637989778535,0.6205357142857143,45.225694444444436,1019.0972222222207,29.117063492063448,0
1557,4,2,0,39,0.05128205128205128,0.0,1.0,39,950,600,350,0.631578947368421,13,6,7,371.77467229682026,0.4220928924876293,0.16093672570757045,0.21026980997174935,129975.34855379029,1864.308523050077,131839.65707684038,818,0,225.66666666666666,36,3,21,35.59566537824407,0.6200810185185186,45.0731981981982,1019.7072072072074,28.325200200200204,0
1558,4,1,0,40,0.025,0.0,1.0,40,1100,700,400,0.6363636363636364,15,7,8,364.6271982339975,0.42614850427350426,0.1689140022050717,0.2085226158879168,130406.3248214432,1510.2556103400834,131916.58043178328,819,0,221.0,36,4,22,35.3401782432929,0.6244212962962963,44.65090090090091,1021.3963963963974,28.37212212212215,0
1559,4,0,0,40,0.0,0.0,1.0,40,1450,1100,350,0.7586206896551724,18,11,7,366.3369684827237,0.425400641025641,0.16079614325068858,0.21027881018220845,130550.14209733382,1565.0686581852149,132115.21075551905,820,1,222.0,36,4,16,35.15059687786962,0.6258680555555556,44.51013513513514,1021.9594594594595,28.387762762762762,0
1560,4,1,0,41,0.024390243902439025,0.0,1.0,41,1300,1100,200,0.8461538461538461,15,11,4,358.8168587431645,0.42815040650406505,0.17111304974690356,0.20863211873870932,131047.29940943373,1204.3960641736003,132251.69547360734,821,0,217.5609756097561,37,4,17,34.839276790176356,0.6289414414414414,44.02412280701755,1023.9035087719303,27.673067804646767,0
1561,4,0,2,39,0.0,0.04878048780487805,0.9512195121951219,41,1300,800,500,0.6153846153846154,18,8,10,348.91811863521184,0.42848069105691056,0.19165633399308502,0.19151190324397116,128794.39153928302,787.7393573306733,129582.1308966137,822,1,218.5609756097561,38,3,16,37.379617934954226,0.6044407894736843,46.23397435897434,1015.0641025640998,26.71221322537105,8
1562,4,0,1,38,0.0,0.02564102564102564,0.9743589743589743,39,1250,900,350,0.72,16,9,7,357.65105433102167,0.4259165542060279,0.1838285611381234,0.1959775315472824,128728.04763244436,1407.9443915435218,130135.99202398788,823,2,223.17948717948718,37,2,16,37.22571132721048,0.6055743243243243,46.29934210526314,1014.8026315789455,27.42709815078231,0
1563,4,0,1,37,0.0,0.02631578947368421,0.9736842105263158,38,1000,600,400,0.6,14,6,8,364.81106307575993,0.4226825509720247,0.19409573412119152,0.20026838748872705,128800.9863748883,1797.6049529258858,130598.5913278142,824,3,229.92105263157896,36,2,16,36.96957510539162,0.6082175925925926,46.22747747747747,1015.0900900900892,28.196946946946923,0
1564,4,0,1,36,0.0,0.02702702702702703,0.972972972972973,37,1300,1100,200,0.8461538461538461,15,11,4,368.46488181376367,0.4227352352352352,0.19007017046679664,0.20281749517151587,128907.38195516118,2099.5686514060308,131006.95060656722,825,4,216.48648648648648,35,2,16,36.768197705341535,0.6113095238095239,46.12268518518518,1015.5092592592592,29.014550264550262,0
1565,4,0,0,36,0.0,0.0,1.0,36,1650,1100,550,0.6666666666666666,22,11,11,372.51667091970455,0.4227017195767196,0.17659660363598473,0.20531732792551163,128959.4387755103,2407.908163265316,131367.34693877562,826,5,218.08333333333334,34,2,16,36.612165963431785,0.6139705882352942,46.07142857142858,1015.7142857142865,29.873949579831955,0
1566,4,1,1,36,0.02702702702702703,0.02702702702702703,0.972972972972973,37,850,400,450,0.47058823529411764,13,4,9,365.5587685071711,0.4247372372372373,0.17832082696947515,0.20381153257865603,129413.28125000026,2061.858701814087,131475.13995181434,827,0,213.16216216216216,34,3,17,36.32609882609882,0.6185661764705883,45.625000000000014,1017.500000000002,29.926470588235354,0
1567,4,0,0,36,0.0,0.0,1.0,36,1450,1200,250,0.8275862068965517,17,12,5,376.45491591077655,0.4224702380952381,0.19205574959519311,0.20991975599779558,129419.51600646383,2544.122603085348,131963.63860954918,828,1,219.47222222222223,33,3,19,36.04256995463486,0.6208964646464646,45.618872549019606,1017.5245098039214,30.834076054664287,0
1568,4,0,1,35,0.0,0.027777777777777776,0.9722222222222222,36,1300,900,400,0.6923076923076923,17,9,8,388.12082768197865,0.42260251322751324,0.0928816466552318,0.20912610216136174,128056.65569540886,2740.2910397376427,130796.9467351465,829,2,220.47222222222223,35,1,14,37.14086620926242,0.6026785714285714,46.96180555555555,1012.152777777777,28.918650793650773,8
1569,4,1,1,35,0.027777777777777776,0.027777777777777776,0.9722222222222222,36,1150,1000,150,0.8695652173913043,13,10,3,388.5687167629395,0.4241402116402116,0.09077730763203284,0.21030169479765193,128234.9489795918,2765.6480546500984,131000.5970342419,830,0,220.55555555555554,34,2,15,36.94659927910987,0.6066176470588236,46.785714285714285,1012.8571428571425,29.789915966386545,0
1570,4,1,0,36,0.027777777777777776,0.0,1.0,36,800,600,200,0.75,10,6,4,389.4024170286945,0.42273478835978834,0.09364678390057302,0.21123033596757285,128325.39859693874,2794.044075963714,131119.44267290246,831,0,221.44444444444446,34,2,16,36.83272627579995,0.6075367647058824,46.69642857142857,1013.2142857142854,29.80042016806722,0
1571,4,0,1,35,0.0,0.027777777777777776,0.9722222222222222,36,1000,700,300,0.7,13,7,6,386.765591462643,0.4232142857142857,0.09057630569258457,0.21027600547336794,128415.88010204078,2733.368764172329,131149.2488662131,832,1,222.44444444444446,34,2,14,36.80677903061623,0.6084558823529411,46.607142857142854,1013.5714285714283,29.81092436974789,0
1572,4,1,1,35,0.027777777777777776,0.027777777777777776,0.9722222222222222,36,600,400,200,0.6666666666666666,8,4,4,390.0575860059723,0.42359457671957673,0.10981009769013039,0.21286999200415632,128566.75347222229,2829.6875000000045,131396.4409722223,833,0,223.38888888888889,34,2,15,36.56874828814022,0.6099877450980392,46.458333333333336,1014.1666666666672,29.828431372549034,0
1573,4,0,0,35,0.0,0.0,1.0,35,1200,800,400,0.6666666666666666,16,8,8,398.3517195305143,0.42034313725490197,0.11717150796527376,0.2176341374623145,128610.25694744798,3246.423400855423,131856.6803483034,834,1,230.68571428571428,33,2,16,36.31385667109661,0.6126893939393939,46.41544117647058,1014.3382352941167,30.737522281639897,0
1574,4,0,0,35,0.0,0.0,1.0,35,750,400,350,0.5333333333333333,11,4,7,410.4910866744078,0.42041316526610645,0.12373081463990543,0.21595400646784038,127092.01388888874,3472.992659073415,130565.00654796216,835,2,231.68571428571428,33,2,14,37.568870523415974,0.5972222222222222,47.91666666666666,1008.3333333333321,30.555555555555518,8
1575,4,1,1,35,0.027777777777777776,0.027777777777777776,0.9722222222222222,36,1100,800,300,0.7272727272727273,14,8,6,403.1816209689662,0.42337962962962966,0.12100577762056375,0.21384511115933716,127422.3373724489,3074.8689058956793,130497.20627834459,836,0,226.22222222222223,34,2,13,37.412549620720824,0.5983455882352942,47.58928571428571,1009.6428571428565,29.695378151260485,0
1576,4,1,0,36,0.027777777777777776,0.0,1.0,36,1100,800,300,0.7272727272727273,14,8,6,405.16093941251404,0.42233796296296294,0.1365984628696495,0.21625093661063977,127676.20991940991,3145.8826303154697,130822.09254972538,837,0,227.19444444444446,35,1,14,37.101084134982436,0.5988095238095238,47.33796296296295,1010.6481481481461,28.875661375661316,0
1577,4,3,4,35,0.07692307692307693,0.10256410256410256,0.8974358974358975,39,1000,800,200,0.8,12,8,4,382.44555687108874,0.4330015744489429,0.13044937679796487,0.20781565444794076,128394.44739006223,2021.634525069905,130416.08191513213,838,0,210.64102564102564,37,2,13,36.938200980922495,0.6021959459459459,46.628289473684205,1013.4868421052624,27.3915362731152,0
1578,4,0,0,35,0.0,0.0,1.0,35,800,600,200,0.75,10,6,4,409.2529587566835,0.41775210084033615,0.14270579332380473,0.219344093668014,127843.36911848052,3464.0554138321772,131307.4245323127,839,2,235.17142857142858,34,1,15,36.82558367667256,0.6026348039215687,47.17261904761904,1011.3095238095221,29.74439775910359,0
1579,4,0,0,35,0.0,0.0,1.0,35,650,400,250,0.6153846153846154,9,4,5,409.41176470588266,0.4169467787114846,0.14272268907563035,0.22025316455696176,127993.9058956913,3480.4421768707075,131474.34807256202,840,3,236.17142857142858,34,1,15,36.66666666666666,0.6041666666666667,47.023809523809504,1011.9047619047595,29.76190476190469,0
1580,4,2,1,36,0.05405405405405406,0.02702702702702703,0.972972972972973,37,1100,700,400,0.6363636363636364,15,7,8,392.3494563965319,0.42038913913913917,0.14664498992772046,0.21390003655818365,128525.67361379009,2685.484212171212,131211.1578259613,841,0,224.35135135135135,35,2,15,36.552738462123806,0.6074404761904761,46.49884259259258,1014.004629629628,28.9715608465608,0
1581,4,1,0,37,0.02702702702702703,0.0,1.0,37,850,600,250,0.7058823529411765,11,6,5,392.74312382562124,0.4214527027027027,0.15638496943390323,0.2150642702422995,128701.77636584765,2709.3475383658824,131411.12390421354,842,0,225.32432432432432,35,2,17,36.36232937911106,0.6092261904761904,46.32523148148147,1014.699074074072,28.991402116402057,0
1582,4,2,0,39,0.05128205128205128,0.0,1.0,39,1250,1000,250,0.8,15,10,5,380.9203517138143,0.42861560953666217,0.16971389804335657,0.21200576321816925,129344.54038075247,2054.961417972192,131399.50179872467,843,0,214.71794871794873,36,3,19,36.00547990700765,0.6137152777777778,45.69256756756757,1017.2297297297306,28.256381381381406,0
1583,4,0,0,39,0.0,0.0,1.0,39,800,300,500,0.375,13,3,10,382.00269805719546,0.4286437246963563,0.16729932308600115,0.213383212919712,129487.77113261938,2092.9355876146706,131580.70672023404,844,1,215.71794871794873,36,3,17,35.831811979051416,0.615162037037037,45.551801801801815,1017.792792792795,28.272022022022085,0
1584,4,0,0,39,0.0,0.0,1.0,39,800,500,300,0.625,11,5,6,386.1273017232362,0.4285874943769681,0.16931304580706952,0.21641305076063325,129619.76431450056,2209.945968951978,131829.71028345253,845,2,216.71794871794873,37,2,18,35.59220325903592,0.6145833333333333,45.422149122807014,1018.3114035087715,27.52192982456139,0
1585,4,1,1,39,0.025,0.025,0.975,40,900,500,400,0.5555555555555556,13,5,8,376.2993029352019,0.4305555555555556,0.17107124148769004,0.2129091195326913,129990.07100820007,1783.0346217766194,131773.1056299767,846,0,212.275,38,2,19,35.465339619346956,0.6165021929824561,45.05876068376069,1019.7649572649577,26.835919928025202,0
1586,4,1,0,40,0.025,0.0,1.0,40,950,600,350,0.631578947368421,13,6,7,371.67127974155596,0.43154380341880344,0.1576913011619383,0.21146966857481153,130208.06081753605,1678.919319344003,131886.98013688007,847,0,207.1,38,2,20,35.36171010851739,0.6186951754385965,44.84508547008547,1020.6196581196588,26.858412055780494,0
1587,4,0,1,39,0.0,0.025,0.975,40,1000,800,200,0.8,12,8,4,374.21630790094395,0.4313969017094017,0.15410324288550625,0.21337390235408546,130291.32806793285,1751.4507767669638,132042.77884469982,848,1,208.1,36,4,20,35.21214795205529,0.6232638888888888,44.763513513513516,1020.9459459459463,28.35960960960962,0
1588,4,0,0,39,0.0,0.0,1.0,39,1400,1100,300,0.7857142857142857,17,11,6,380.98982664579205,0.42976833108412055,0.15347571189279763,0.21661993000717883,130180.80210387894,2119.5122452333935,132300.31434911233,849,2,214.25641025641025,38,1,20,35.15166980737019,0.618421052631579,44.87179487179487,1020.5128205128199,26.85560053981105,0
1589,4,0,0,39,0.0,0.0,1.0,39,800,600,200,0.75,10,6,4,383.6100275064076,0.4290092217723797,0.15955449371908226,0.21890088374266023,130321.66950660142,2198.616891172747,132520.28639777418,850,3,215.25641025641025,35,4,20,34.94152875387289,0.6255952380952381,44.73379629629629,1021.0648148148142,29.173280423280406,0
1590,4,0,0,39,0.0,0.0,1.0,39,1000,700,300,0.7,13,7,6,378.464009987757,0.42881241565452094,0.15709394369763663,0.21657068286522982,130430.54112803932,2072.6531240381596,132503.1942520775,851,4,216.25641025641025,37,2,20,34.96225132388722,0.6227477477477478,44.62719298245614,1021.4912280701748,27.607871028923643,0
1591,4,0,0,39,0.0,0.0,1.0,39,1150,900,250,0.782608695652174,14,9,5,373.9778111906906,0.42841880341880345,0.15239887111947348,0.21488562880848866,130589.98243343196,1967.5511587771223,132557.53359220907,852,5,217.25641025641025,38,1,16,34.91494198808403,0.622532894736842,44.47115384615385,1022.1153846153846,26.897773279352226,0
1592,4,0,0,39,0.0,0.0,1.0,39,800,500,300,0.625,11,5,6,379.956234657813,0.4281376518218623,0.1504387797743416,0.21909283603280658,130726.5185550444,2134.071152019892,132860.5897070643,853,6,218.25641025641025,38,1,16,34.62355481264802,0.6239035087719298,44.33760683760685,1022.6495726495742,26.911830859199323,0
1593,4,0,1,38,0.0,0.02564102564102564,0.9743589743589743,39,650,500,150,0.7692307692307693,8,5,3,379.9598426715271,0.4278565002249213,0.14581157301023606,0.21940503822299198,130781.15297866927,2138.3172620352393,132919.4702407045,854,7,219.25641025641025,38,1,17,34.56801406587285,0.6244517543859649,44.28418803418805,1022.86324786325,26.917453891138155,0
1594,4,0,0,38,0.0,0.0,1.0,38,1050,700,350,0.6666666666666666,14,7,7,387.46674936391497,0.427305595068753,0.14791132882603208,0.22333219434906523,130710.70545744868,2529.2104301323766,133239.91588758107,855,8,223.73684210526315,37,1,17,34.447601687039835,0.6255630630630631,44.35307017543861,1022.5877192982475,27.637505926979664,0
1595,4,1,2,37,0.02564102564102564,0.05128205128205128,0.9487179487179487,39,1100,700,400,0.6363636363636364,15,7,8,391.58381644138996,0.42855937921727394,0.16562369628702545,0.22837625499027084,131163.91354372143,2472.3331689678107,133636.24671268923,856,0,218.97435897435898,38,1,19,33.88219649561955,0.6282894736842105,43.91025641025642,1024.358974358976,26.956815114709894,0
1596,4,0,0,37,0.0,0.0,1.0,37,1400,900,500,0.6428571428571429,19,9,10,409.8264391895733,0.4236736736736737,0.17616626527517631,0.23788776067900544,130982.0694850257,3335.98302694588,134318.0525119716,857,1,231.21621621621622,36,1,19,33.599880821415475,0.6302083333333333,44.087837837837846,1023.6486486486497,28.43468468468471,0
1597,4,1,1,37,0.02631578947368421,0.02631578947368421,0.9736842105263158,38,900,700,200,0.7777777777777778,11,7,4,398.90276951549987,0.4245199146514936,0.1803594351732989,0.2336430507162215,131328.12500000012,2877.4305555555698,134205.55555555568,858,0,226.10526315789474,37,1,21,33.52811653116531,0.6317567567567568,43.75000000000001,1025.000000000001,27.702702702702727,0
1598,4,0,1,36,0.0,0.02702702702702703,0.972972972972973,37,1200,900,300,0.75,15,9,6,376.9680804381959,0.42354854854854856,0.16058040547836505,0.2074332378454026,128895.01006319224,2317.8609043166816,131212.87096750893,859,1,217.75675675675674,37,0,18,36.56496328690204,0.6072635135135135,46.134868421052616,1015.4605263157871,27.444879089615867,8
1599,4,1,0,37,0.02702702702702703,0.0,1.0,37,1250,1100,150,0.88,14,11,3,376.914807847353,0.4256443943943944,0.1719096145325656,0.20901639344262288,129201.38888888882,2340.310720606331,131541.69960949515,860,0,217.40540540540542,35,2,19,36.25341530054644,0.6142857142857143,45.83333333333333,1016.6666666666661,29.04761904761903,0
1600,4,1,0,38,0.02631578947368421,0.0,1.0,38,1200,700,500,0.5833333333333334,17,7,10,374.54810037086753,0.4287873399715505,0.17510993245387385,0.21007263020800826,129647.6800554016,2111.858456448132,131759.53851184974,861,0,212.6578947368421,37,1,17,35.85854507608383,0.6148648648648649,45.39473684210526,1018.4210526315784,27.524893314366984,0
1601,4,0,1,37,0.0,0.02631578947368421,0.9736842105263158,38,1100,800,300,0.7272727272727273,14,8,6,379.6790193613681,0.42846135609293506,0.16341385378339401,0.2019401343162196,127534.65008464149,2095.266812865497,129629.91689750698,862,1,213.6578947368421,37,1,14,37.8903423071356,0.5934684684684685,47.478070175438596,1010.087719298246,27.299668089141786,8
1602,4,3,1,39,0.075,0.025,0.975,40,1250,1000,250,0.8,15,10,5,365.2418106418785,0.43398771367521366,0.17023010286951812,0.19736735642350775,128172.28768707681,1365.685234879966,129537.97292195678,863,0,203.8,37,3,18,37.60140317632196,0.5999436936936937,46.84758771929825,1012.6096491228071,27.36782835467046,0
1603,4,0,0,39,0.0,0.0,1.0,39,1050,900,150,0.8571428571428571,12,9,3,372.74128266355035,0.43182073774179036,0.17980373535929073,0.20128029263831734,128144.53125000013,1752.9513888889028,129897.48263888904,864,1,209.94871794871796,38,1,18,37.439986282578886,0.5978618421052632,46.87500000000001,1012.500000000001,26.64473684210529,0
1604,4,4,7,36,0.09302325581395349,0.16279069767441862,0.8372093023255813,43,750,400,350,0.5333333333333333,11,4,7,344.2010893495167,0.43814599483204136,0.17634637130284347,0.19014603867949045,129050.14349489803,283.8399943310743,129333.98348922911,865,0,191.32558139534885,41,2,15,37.238820542862726,0.6021341463414633,45.98214285714286,1016.0714285714291,24.78222996515681,0
1605,4,1,0,37,0.02702702702702703,0.0,1.0,37,850,500,350,0.5882352941176471,12,5,7,387.27836734693904,0.4263013013013013,0.19586718146718152,0.20943669433162618,128203.13169795937,2530.0599065500483,130733.19160450941,866,0,218.32432432432432,35,2,18,37.01190476190475,0.6041666666666667,46.81712962962962,1012.7314814814802,28.935185185185148,0
1606,4,1,0,38,0.02631578947368421,0.0,1.0,38,1000,700,300,0.7,13,7,6,379.6955043032359,0.42815018966334756,0.19484322757137185,0.2069478402388822,128515.36502718931,2159.341266942612,130674.70629413193,867,0,213.55263157894737,36,2,18,36.884070042943875,0.6053240740740741,46.509009009009006,1013.9639639639636,28.165665665665657,0
1607,4,0,0,38,0.0,0.0,1.0,38,800,600,200,0.75,10,6,4,374.4444759245185,0.4281798245614035,0.18996436707751618,0.2049662653754503,128686.69979100717,2037.2047723399005,130723.90456334707,868,1,214.55263157894737,36,2,18,36.841934887162395,0.6070601851851851,46.34009009009009,1014.6396396396392,28.184434434434422,0
1608,4,0,1,37,0.0,0.02631578947368421,0.9736842105263158,38,1000,700,300,0.7,13,7,6,375.93125483033145,0.4279723802750119,0.19125220417362487,0.2063729799659319,128800.98637488816,2084.0632862592047,130885.04966114736,869,2,215.55263157894737,36,2,18,36.68737519414244,0.6082175925925926,46.227477477477464,1015.0900900900881,28.19694694694689,0
1609,4,1,0,38,0.02631578947368421,0.0,1.0,38,1100,600,500,0.5454545454545454,16,6,10,376.484602353098,0.43112849691797056,0.18802618451682984,0.20772278885793827,129001.10995708527,2113.386317060286,131114.49627414555,870,0,207.5,36,2,19,36.46884122233309,0.6102430555555556,46.030405405405396,1015.8783783783767,28.2188438438438,0
1610,4,1,0,39,0.02564102564102564,0.0,1.0,39,1250,700,550,0.56,18,7,11,364.2883152549027,0.43406995051731895,0.18054046582348526,0.20244302720127116,129285.00987082534,1619.4036867112625,130904.4135575366,871,0,203.15384615384616,37,2,20,36.48910601976639,0.611204954954955,45.751096491228054,1016.9956140350853,27.486367946894198,0
1611,4,0,0,39,0.0,0.0,1.0,39,1550,1000,550,0.6451612903225806,21,10,11,366.22516888213806,0.43362010796221323,0.18243683646527287,0.20482135348805805,129536.03512619244,1687.8712680824594,131223.9063942749,872,1,204.15384615384616,37,2,16,36.18411604193593,0.6137387387387387,45.50438596491227,1017.982456140349,27.513039355144567,0
1612,4,1,2,38,0.025,0.05,0.95,40,950,600,350,0.631578947368421,13,6,7,362.20062991729156,0.4361778846153846,0.1880489466512949,0.20436169190070225,129881.14458917729,1408.6064769157558,131289.75106609304,873,0,200.025,38,2,18,35.935480208224156,0.6154057017543859,45.16559829059828,1019.3376068376056,26.824673864147513,0
1613,4,0,1,37,0.0,0.02631578947368421,0.9736842105263158,38,1350,800,550,0.5925925925925926,19,8,11,374.0596205348853,0.4318249170222854,0.19122651882275576,0.2103242627084594,129745.78622118762,2106.531911979573,131852.3181331672,874,1,211.3421052631579,36,2,18,35.7710659150363,0.6177662037037037,45.298423423423436,1018.806306306308,28.300175175175223,0
1614,4,0,0,37,0.0,0.0,1.0,37,950,600,350,0.631578947368421,13,6,7,378.1767389731557,0.42858483483483484,0.19001823909799365,0.21256140845732557,129731.44531250012,2412.282986111125,132143.72829861124,875,2,217.94594594594594,35,2,18,35.68081117927744,0.6196428571428572,45.31250000000001,1018.7500000000009,29.107142857142883,0
1615,4,1,0,38,0.02631578947368421,0.0,1.0,38,1250,1100,150,0.88,14,11,3,369.69337607857386,0.43029871977240397,0.19205557783162752,0.20940043196645702,130032.77084094245,2014.450810607925,132047.22165155038,876,0,213.18421052631578,36,2,19,35.59033528394244,0.6206597222222222,45.0168918918919,1019.9324324324338,28.331456456456493,0
1616,4,1,0,39,0.02564102564102564,0.0,1.0,39,950,500,450,0.5263157894736842,14,5,9,364.2406545828829,0.4313427800269905,0.20037314048904475,0.20873274412074458,130486.54994806116,1705.701273468786,132192.25122152994,877,0,208.69230769230768,37,2,21,35.268655648565506,0.6233108108108107,44.572368421052644,1021.7105263157913,27.6137980085349,0
1617,4,1,1,39,0.025,0.025,0.975,40,1400,900,500,0.6428571428571429,19,9,10,366.37260925600555,0.4303819444444445,0.2204132748904195,0.2127625661752151,130999.80481591076,1598.9480604865453,132598.7528763973,878,0,204.45,38,2,16,34.69395742016281,0.6266447368421053,44.07051282051283,1023.7179487179501,26.939946018893423,0
1618,4,0,1,38,0.0,0.02564102564102564,0.9743589743589743,39,1250,600,650,0.48,19,6,13,376.9800622517691,0.42841880341880345,0.22539713927888694,0.2188734988297587,130991.17036011098,2076.21191135736,133067.38227146835,879,1,210.64102564102564,37,2,16,34.431233933161955,0.6283783783783784,44.07894736842106,1023.6842105263172,27.6671408250356,0
1619,4,0,0,38,0.0,0.0,1.0,38,1150,1000,150,0.8695652173913043,13,10,3,384.00835802668087,0.42828354670459934,0.22649879540400275,0.2225681095501582,130924.4379514652,2455.2156886616613,133379.65364012687,880,2,216.81578947368422,36,2,16,34.31906543427231,0.6296296296296297,44.14414414414416,1023.4234234234251,28.428428428428475,0
1620,4,1,1,38,0.02564102564102564,0.02564102564102564,0.9743589743589743,39,800,500,300,0.625,11,5,6,375.37627345852485,0.43120220422852,0.224747349988198,0.21889919766851068,131159.59357686993,2046.83989304403,133206.43346991396,881,0,212.23076923076923,37,2,17,34.30163062870192,0.6300675675675675,43.914473684210535,1024.3421052631588,27.68492176386916,0
1621,4,1,0,39,0.02564102564102564,0.0,1.0,39,1350,1000,350,0.7407407407407407,17,10,7,378.2754830834957,0.4278565002249213,0.23398316136973696,0.2217283787835841,131356.98356718203,2137.933489424509,133494.91705660653,882,0,213.0,36,3,18,34.027472628071315,0.6339699074074074,43.721846846846844,1025.1126126126126,28.47535035035035,0
1622,4,0,2,37,0.0,0.05128205128205128,0.9487179487179487,39,1300,900,400,0.6923076923076923,17,9,8,322.69936222430795,0.4279970760233918,0.12373544732199182,0.18150215422173427,129757.97661675357,574.5632595486157,130332.53987630218,883,1,214.0,39,0,18,37.0668685887605,0.6124465811965811,45.286458333333336,1018.8541666666674,26.12446581196583,8
1623,4,3,0,40,0.075,0.0,1.0,40,1100,700,400,0.6363636363636364,15,7,8,318.1371069643749,0.430088141025641,0.16374719445011254,0.181512219002608,130315.76063368072,292.63509114585145,130608.39572482658,884,0,209.5,39,1,22,36.61880228524792,0.6180555555555556,44.73958333333334,1021.041666666668,26.18055555555559,0
1624,4,0,0,40,0.0,0.0,1.0,40,1250,900,350,0.72,16,9,7,318.90603003440924,0.42851228632478633,0.15856443719412683,0.18270037047765714,130475.34722222241,321.87500000001916,130797.22222222242,885,1,210.5,39,1,22,36.437941816204464,0.6196581196581197,44.58333333333334,1021.6666666666681,26.196581196581235,0
1625,4,0,2,38,0.0,0.05,0.95,40,1400,1000,400,0.7142857142857143,18,10,8,329.1470973682252,0.4284855769230769,0.10084722969338378,0.18553197513872985,129843.17440221999,684.3063490689532,130527.48075128894,886,2,211.5,37,3,20,36.8162766720459,0.6168355855855856,45.202850877192986,1019.1885964912286,27.54563774300618,8
1626,4,0,0,38,0.0,0.0,1.0,38,1350,800,550,0.5925925925925926,19,8,11,344.36925294232765,0.42364568515884304,0.1330504679202702,0.1939139620332997,129803.15778193748,1340.043294984189,131143.20107692166,887,3,223.52631578947367,36,2,21,36.46903893616238,0.6183449074074074,45.242117117117125,1019.0315315315327,28.306431431431463,0
1627,4,1,0,39,0.02564102564102564,0.0,1.0,39,1150,900,250,0.782608695652174,14,9,5,338.3378766440327,0.4249325236167341,0.14543424404201089,0.19250397472188477,130208.06081753602,1010.863763788446,131218.92458132448,888,0,218.76923076923077,38,1,23,36.212228270351375,0.6186951754385965,44.84508547008547,1020.6196581196585,26.858412055780487,0
1628,4,0,0,39,0.0,0.0,1.0,39,1150,900,250,0.782608695652174,14,9,5,335.89939744452715,0.42504498425551057,0.14446206714247967,0.19166024442423013,130318.55955678667,954.7965404669071,131273.35609725356,889,1,219.76923076923077,37,2,23,36.16256801260025,0.6216216216216216,44.73684210526316,1021.0526315789471,27.596017069701272,0
1629,4,1,1,39,0.025,0.025,0.975,40,1450,1200,250,0.8275862068965517,17,12,5,325.8721685201678,0.4268696581196581,0.15160961695191522,0.18772072806302642,130688.28125000015,517.5347222222363,131205.8159722224,890,0,215.25,39,1,21,36.04489269220321,0.6217948717948718,44.37500000000001,1022.5000000000011,26.217948717948747,0
1630,4,0,0,39,0.0,0.0,1.0,39,550,400,150,0.7272727272727273,7,4,3,333.54050320184643,0.425691632928475,0.1618420594280141,0.19192117108469445,130644.58832137122,915.0523458616469,131559.64066723286,891,1,221.15384615384616,38,1,21,35.89303131640366,0.6230811403508771,44.417735042735046,1022.3290598290603,26.90339631129106,0
1631,4,0,0,39,0.0,0.0,1.0,39,1350,1000,350,0.7407407407407407,17,10,7,333.6618833041332,0.42462325686009894,0.1573542210617931,0.1928070327481638,130808.4744708342,929.160388815832,131737.63485965005,892,2,222.15384615384616,38,1,21,35.72432550043516,0.6247258771929824,44.25747863247863,1022.9700854700851,26.920265407107504,0
1632,4,0,0,39,0.0,0.0,1.0,39,1650,1200,450,0.7272727272727273,21,12,9,336.67173696070034,0.4250168690958165,0.16443980514961765,0.1952370000050549,130945.1247351887,1017.1045182263011,131962.229253415,893,3,223.15384615384616,38,1,21,35.50930758524705,0.6260964912280702,44.12393162393162,1023.5042735042724,26.934322986954538,0
1633,4,0,0,39,0.0,0.0,1.0,39,950,700,250,0.7368421052631579,12,7,5,336.64750928712186,0.4246513720197931,0.1664753556645453,0.19563936212847102,131027.1491366242,1021.9926811673503,132049.14181779153,894,4,224.15384615384616,38,1,22,35.42710181223695,0.6269188596491229,44.043803418803414,1023.8247863247855,26.942757534862775,0
1634,4,0,0,39,0.0,0.0,1.0,39,1100,800,300,0.7272727272727273,14,8,6,336.87593558813717,0.42448268106162845,0.16913554489185656,0.19619032311955537,131109.19922017658,1033.5068303016783,132142.70605047827,895,5,225.15384615384616,38,1,22,35.33842756798108,0.6277412280701755,43.9636752136752,1024.1452991452975,26.951192082770987,0
1635,4,0,0,39,0.0,0.0,1.0,39,1200,800,400,0.6666666666666666,16,8,8,339.4172205185974,0.4234424201529465,0.1626880711630012,0.1986595116799815,131300.7492900318,1113.1470752063296,132413.89636523812,896,6,226.15384615384616,38,1,23,35.08004968900934,0.6296600877192983,43.77670940170938,1024.8931623931594,26.970872694556828,0
1636,4,1,0,40,0.025,0.0,1.0,40,1450,1100,350,0.7586206896551724,18,11,7,329.83913517552924,0.4246661324786325,0.16095938001068943,0.1941878608915717,131524.88175448202,676.4163575295296,132201.29811201154,897,0,221.475,37,3,24,35.09965704614287,0.6337274774774775,43.55811403508771,1025.7675438596482,27.723447131341842,0
1637,4,0,1,39,0.0,0.025,0.975,40,1450,1100,350,0.7586206896551724,18,11,7,332.1101232404327,0.42454594017094016,0.163210493441599,0.19620232741990123,131656.85609796178,744.9149408283927,132401.77103879018,898,1,222.475,38,2,17,34.908520716219016,0.6332236842105263,43.429487179487175,1026.2820512820506,27.007422402159225,0
1638,4,0,0,39,0.0,0.0,1.0,39,1250,900,350,0.72,16,9,7,329.06937635947395,0.4229644624381466,0.13315465407088167,0.18601921767579035,129954.9515836605,765.2691191338498,130720.22070279435,899,9,229.15384615384616,37,2,19,36.70499964153852,0.6179617117117118,45.09320175438597,1019.6271929824572,27.557491702228575,8
1639,4,0,0,39,0.0,0.0,1.0,39,1150,800,350,0.6956521739130435,15,8,7,330.84964287525463,0.4223740440845704,0.13141060093656032,0.18756211015652013,130066.77685682141,806.5093346029639,130873.28619142437,900,10,230.15384615384616,37,2,19,36.54634257766311,0.6190878378378378,44.98355263157895,1020.0657894736848,27.569345661450942,0
1640,4,0,0,39,0.0,0.0,1.0,39,950,500,450,0.5263157894736842,14,5,9,369.4536856045481,0.42203666216824115,0.21571829810976362,0.19816532813701143,127874.24123611998,1648.7219437139013,129522.96317983388,901,11,231.15384615384616,38,1,14,37.80016548713074,0.5951206140350878,47.142094017094,1011.4316239316217,26.616621682411097,8
1641,4,0,0,39,0.0,0.0,1.0,39,1000,800,200,0.8,12,8,4,366.4639502916138,0.4220647773279352,0.21200407137907162,0.19722423506603173,128009.35057345282,1582.162457082292,129591.5130305351,902,12,232.15384615384616,38,1,15,37.7373222832207,0.5964912280701755,47.00854700854699,1011.9658119658094,26.63067926225814,0
1642,4,0,0,39,0.0,0.0,1.0,39,900,400,500,0.4444444444444444,14,4,10,364.1346825346817,0.4220647773279352,0.09737808420697136,0.19223822161627693,127233.9923327046,1505.4496879536143,128739.44202065821,903,13,233.15384615384616,36,3,16,38.59154667559623,0.5923032407407407,47.775900900900915,1008.8963963963986,28.02489989989996,8
1643,4,1,2,38,0.025,0.05,0.95,40,1400,1100,300,0.7857142857142857,17,11,6,356.1968389133166,0.4258947649572649,0.09808944854537494,0.18945065127421906,127534.65008464147,1085.4878424130497,128620.13792705451,904,0,228.3,37,3,14,38.48331885945868,0.5934684684684685,47.478070175438596,1010.0877192982459,27.299668089141782,0
1644,4,0,0,38,0.0,0.0,1.0,38,1550,1200,350,0.7741935483870968,19,12,7,367.7152767675759,0.4251570649596965,0.10476560945161117,0.19555461428096496,127530.03532503855,1778.9484471450567,129308.98377218361,905,1,232.78947368421052,35,3,14,38.19718975592988,0.5973214285714286,47.482638888888886,1010.0694444444442,28.859126984126977,0
1645,4,1,0,39,0.02564102564102564,0.0,1.0,39,1350,800,550,0.5925925925925926,19,8,11,366.1570962970141,0.4279689608636977,0.12550952588776565,0.19744367958091547,128087.52745566523,1580.0314250060983,129667.55888067133,906,0,227.7948717948718,36,3,15,37.66501650165016,0.6009837962962963,46.93130630630631,1012.2747747747757,28.118743743743767,0
1646,4,2,1,40,0.04878048780487805,0.024390243902439025,0.975609756097561,41,1250,800,450,0.64,17,8,9,351.3158098539546,0.4349085365853658,0.13497972402067915,0.19230237730161417,128685.9673483271,841.882967163416,129527.85031549052,907,0,217.6341463414634,38,3,15,37.42936365869922,0.6033442982456141,46.340811965811966,1014.636752136752,26.700967161493473,0
1647,4,2,0,42,0.047619047619047616,0.0,1.0,42,1000,600,400,0.6,14,6,8,347.7033130314902,0.436048199767712,0.15727562037525167,0.1923012200643548,129095.50781250001,577.3871527777778,129672.8949652778,908,0,213.4047619047619,39,3,17,37.1036627032937,0.6057692307692308,45.9375,1016.2500000000001,26.05769230769231,0
1648,4,1,0,43,0.023255813953488372,0.0,1.0,43,1100,800,300,0.7272727272727273,14,8,6,342.1103669484782,0.43692321889996305,0.16356719377240325,0.19076458634761728,129418.7166703191,255.18373557234156,129673.90040589144,909,0,209.41860465116278,38,5,18,36.917042909141806,0.6107456140350878,45.61965811965811,1017.5213675213664,26.776878092667538,0
1649,4,0,2,41,0.0,0.046511627906976744,0.9534883720930233,43,1850,1500,350,0.8108108108108109,22,15,7,335.6100496464568,0.43648486526393504,0.15697377029679394,0.18799932580482057,129598.829481337,98.93391927085304,129697.76340060786,910,1,210.41860465116278,39,4,13,36.899509803921575,0.610844017094017,45.44270833333334,1018.2291666666682,26.10844017094021,0
1650,4,0,0,41,0.0,0.0,1.0,41,1250,900,350,0.72,16,9,7,348.0044189628243,0.4323678861788618,0.1583775242732488,0.19366748618585,129340.77222077936,802.2320569790562,130143.00427775842,911,3,221.5121951219512,37,4,18,36.84638981711041,0.6117680180180181,45.696271929824555,1017.2149122807008,27.492294926505426,0
1651,4,0,0,41,0.0,0.0,1.0,41,1550,1300,250,0.8387096774193549,18,13,5,346.6645249799556,0.4320376016260163,0.1618471653958613,0.19357129337391907,129473.07715136248,776.7445576740498,130249.82170903652,912,4,222.5121951219512,38,3,13,36.74592343760935,0.6112938596491229,45.56623931623932,1017.7350427350433,26.7825011246064,0
1652,4,0,2,39,0.0,0.04878048780487805,0.9512195121951219,41,1550,800,750,0.5161290322580645,23,8,15,345.749431368348,0.4313008130081301,0.16572779321248232,0.19413280793084972,129690.6332182774,768.0925378040752,130458.72575608148,913,5,223.5121951219512,38,3,13,36.54814348646949,0.6134868421052632,45.3525641025641,1018.5897435897432,26.804993252361662,0
1653,4,0,0,39,0.0,0.0,1.0,39,1350,1100,250,0.8148148148148148,16,11,5,354.0557555079613,0.4252699055330634,0.18454846786152723,0.19849511451075627,129631.08114448928,1379.3260743852138,131010.40721887449,914,6,235.25641025641025,36,3,13,36.39716723801098,0.6166087962962963,45.411036036036045,1018.3558558558574,28.287662662662704,0
1654,4,0,0,39,0.0,0.0,1.0,39,1300,900,400,0.6923076923076923,17,9,8,353.75672293275517,0.42496063877642826,0.17935684941209784,0.1993460985393174,129831.84831791262,1385.7778386494724,131217.6261565621,915,7,236.25641025641025,36,3,13,36.20073664825045,0.6186342592592593,45.21396396396397,1019.1441441441451,28.309559559559588,0
1655,4,0,0,39,0.0,0.0,1.0,39,1400,1100,300,0.7857142857142857,17,11,6,355.3810058185269,0.42414529914529914,0.1715309866811634,0.20114564929328613,130004.0581121662,1440.1945864783665,131444.25269864456,916,8,237.25641025641025,36,3,14,35.984430212014125,0.6203703703703703,45.04504504504504,1019.8198198198196,28.328328328328322,0
1656,4,1,0,40,0.025,0.0,1.0,40,1250,1000,250,0.8,15,10,5,350.9580473763797,0.42574786324786323,0.1786891848351413,0.2001084126834947,130290.57167830471,1145.3049255539995,131435.87660385872,917,0,232.3,37,3,15,35.8065504958293,0.6213400900900901,44.764254385964904,1020.9429824561391,27.593053579895653,0
1657,4,0,0,40,0.0,0.0,1.0,40,1200,700,500,0.5833333333333334,17,7,10,349.51341579402543,0.4258814102564103,0.18264276513525135,0.20000411434503299,130430.54112803924,1117.444790704811,131547.98591874406,918,1,233.3,37,3,16,35.701570774295114,0.6227477477477478,44.62719298245613,1021.4912280701742,27.607871028923626,0
1658,4,0,0,40,0.0,0.0,1.0,40,1450,1100,350,0.7586206896551724,18,11,7,370.71648155058597,0.42554754273504275,0.1805969734060311,0.1996182755958726,128030.53634293069,1527.66485708306,129558.20120001375,919,2,234.3,36,4,14,37.608026408516,0.6004050925925926,46.98761261261261,1012.0495495495489,28.11248748748747,8
1659,4,2,0,42,0.047619047619047616,0.0,1.0,42,1150,900,250,0.782608695652174,14,9,5,358.21681489237625,0.4297570654277971,0.18565459466691414,0.19615020148012102,128700.23108071688,820.568097131501,129520.79917784838,920,0,224.0952380952381,37,5,14,37.2397521792378,0.6052927927927928,46.3267543859649,1014.6929824561382,27.42413466097671,0
1660,4,1,0,43,0.023255813953488372,0.0,1.0,43,1550,1200,350,0.7741935483870968,19,12,7,347.4104672559709,0.43037098560354375,0.17918887125293792,0.19173105822037298,129011.37689248662,363.98054551098556,129375.3574379976,921,0,219.86046511627907,38,5,15,37.196778490552816,0.6066337719298245,46.02029914529914,1015.918803418803,26.734705353126394,0
1661,4,1,0,44,0.022727272727272728,0.0,1.0,44,1200,900,300,0.75,15,9,6,341.3746667493338,0.4335249295278365,0.18689334287759518,0.19048586413517282,129445.89548405634,38.04971144712613,129483.94519550346,922,0,215.8409090909091,38,6,13,36.90813648293963,0.6110197368421053,45.59294871794871,1017.6282051282035,26.779689608636932,0
1662,4,1,3,42,0.022222222222222223,0.06666666666666667,0.9333333333333333,45,1100,600,500,0.5454545454545454,16,6,10,333.4030501601261,0.43543771043771046,0.1871565052425903,0.18752244011593988,129757.97661675354,-347.6589626736064,129410.31765407993,923,0,212.0222222222222,39,6,14,36.79423116245783,0.6124465811965811,45.286458333333336,1018.8541666666672,26.124465811965827,0
1663,4,1,1,42,0.023255813953488372,0.023255813953488372,0.9767441860465116,43,950,900,50,0.9473684210526315,10,9,1,340.17803275054894,0.435077519379845,0.20082815216983363,0.19174983713865087,129843.17440221999,233.95912684673044,130077.13352906672,924,0,220.6046511627907,37,6,15,36.535211583288515,0.6168355855855856,45.202850877192986,1019.1885964912286,27.54563774300618,0
1664,4,0,0,42,0.0,0.0,1.0,42,1050,600,450,0.5714285714285714,15,6,9,347.37861732663816,0.4337616144018583,0.19959321998221324,0.19560853193458316,129803.15778193748,618.1682949841895,130421.32607692167,925,1,226.78571428571428,36,6,16,36.392373006225355,0.6183449074074074,45.242117117117125,1019.0315315315327,28.306431431431463,0
1665,4,1,0,43,0.023255813953488372,0.0,1.0,43,1150,700,450,0.6086956521739131,16,7,9,340.50857884486163,0.43540051679586567,0.205848689767542,0.19345377501405886,130150.67737188375,263.4844375192531,130414.161809403,926,0,222.48837209302326,37,6,18,36.21498674690165,0.6199324324324325,44.90131578947369,1020.3947368421061,27.578236130867733,0
1666,4,0,0,43,0.0,0.0,1.0,43,1300,1100,200,0.8461538461538461,15,11,4,342.06151160045044,0.4347083794758213,0.20402394994282136,0.19545772509488332,130374.54433094813,319.222741612822,130693.76707256095,927,1,223.48837209302326,37,6,18,35.948572042087186,0.6221846846846847,44.68201754385966,1021.2719298245627,27.601944049312504,0
1667,4,1,0,44,0.022727272727272728,0.0,1.0,44,1450,1100,350,0.7586206896551724,18,11,7,335.4666216358514,0.4357822410147991,0.20865307905633834,0.19343894592158853,130726.51855504417,-29.12329242458088,130697.39526261958,928,0,219.38636363636363,38,6,16,35.76098690625436,0.6239035087719298,44.337606837606835,1022.6495726495724,26.911830859199274,0
1668,4,0,0,44,0.0,0.0,1.0,44,1150,700,450,0.6086956521739131,16,7,9,337.9440900362021,0.4360575229034531,0.21228653877186843,0.19555834140644737,130863.12601587028,44.88400814521239,130908.01002401549,929,1,220.38636363636363,38,6,16,35.559587205457525,0.6252741228070176,44.20405982905982,1023.1837606837596,26.925888439046304,0
1669,4,0,0,44,0.0,0.0,1.0,44,1350,800,550,0.5925925925925926,19,8,11,339.6287616655329,0.43548493657505283,0.21334892280838225,0.19737188738876893,131027.14913662423,100.11768116734947,131127.26681779156,930,2,221.38636363636363,38,6,17,35.350794810254264,0.6269188596491229,44.043803418803414,1023.8247863247857,26.942757534862782,0
1670,4,0,1,43,0.0,0.022727272727272728,0.9772727272727273,44,1450,1100,350,0.7586206896551724,18,11,7,343.6735128810969,0.4359033650458069,0.21572660915726605,0.20072040125028726,131218.63928153983,219.2741434728502,131437.91342501267,931,3,222.38636363636363,38,6,17,35.05387556482447,0.6288377192982456,43.8568376068376,1024.5726495726487,26.96243814664865,0
1671,4,0,1,42,0.0,0.023255813953488372,0.9767441860465116,43,1600,1300,300,0.8125,19,13,6,341.0549343242383,0.43512366186784796,0.21602336488238794,0.19990360994752976,131355.50356353621,359.8885281978044,131715.39209173401,932,4,226.37209302325581,38,5,17,34.98284696890741,0.6302083333333333,43.72329059829059,1025.106837606836,26.976495726495685,0
1672,4,0,0,42,0.0,0.0,1.0,42,1100,1000,100,0.9090909090909091,12,10,2,349.15642307926856,0.4316081107239644,0.22082346047033052,0.20405670879773355,131243.84576263823,764.9263475299749,132008.7721101682,933,5,232.57142857142858,37,5,17,34.887974852862484,0.6309121621621622,43.832236842105246,1024.6710526315767,27.693812233285858,0
1673,4,0,0,42,0.0,0.0,1.0,42,1500,1200,300,0.8,18,12,6,346.72985903374104,0.4312693573364305,0.15782650995240743,0.19610486405687222,129975.34855379027,623.3721291596514,130598.72068294992,934,6,233.57142857142858,36,6,15,36.234124792932086,0.6200810185185186,45.0731981981982,1019.7072072072073,28.3252002002002,7
1674,4,1,1,42,0.023255813953488372,0.023255813953488372,0.9767441860465116,43,1300,800,500,0.6153846153846154,18,8,10,336.3072207069888,0.43235511258767073,0.15314779290323233,0.19204243560270634,130348.82010388776,167.76692232774408,130516.58702621551,935,0,229.11627906976744,36,7,17,36.12152624614026,0.6238425925925926,44.70720720720721,1021.1711711711719,28.365865865865885,0
1675,4,0,0,42,0.0,0.0,1.0,42,1250,800,450,0.64,17,8,9,343.9656244278148,0.4301079171506001,0.14932152834667178,0.1964156349062611,130348.82010388775,567.1026600925358,130915.92276398028,936,1,235.28571428571428,36,6,19,35.92601271871783,0.6238425925925926,44.70720720720721,1021.1711711711717,28.36586586586588,0
1676,4,1,0,43,0.023255813953488372,0.0,1.0,43,1300,900,400,0.6923076923076923,17,9,8,340.7758577711526,0.4319629014396456,0.15963656401395254,0.19656254950102311,130738.73842191846,310.5211459295336,131049.259567848,937,0,230.7906976744186,37,6,15,35.612893570637205,0.6258445945945945,44.32565789473685,1022.6973684210541,27.640469416785244,0
1677,4,0,1,42,0.0,0.023255813953488372,0.9767441860465116,43,1000,700,300,0.7,13,7,6,340.20443044223975,0.4314091915836102,0.14633891030897206,0.1968039392719493,130850.9003371231,303.2112044090592,131154.11154153215,938,1,231.7906976744186,37,6,16,35.51412406673097,0.6269707207207207,44.21600877192983,1023.1359649122818,27.652323376007615,0
1678,4,0,0,42,0.0,0.0,1.0,42,900,400,500,0.4444444444444444,14,4,10,350.3966161548281,0.42899487030584593,0.15523401214719557,0.2025526907512109,130822.85534972293,767.9771660510858,131590.832515774,939,2,238.23809523809524,37,5,16,35.281797070382275,0.6266891891891893,44.243421052631575,1023.0263157894731,27.649359886201974,0
1679,4,1,1,42,0.023255813953488372,0.023255813953488372,0.9767441860465116,43,1400,1000,400,0.7142857142857143,18,10,8,338.5481919043654,0.42870985603543743,0.1555180822053881,0.19732924546506397,131141.34250217036,279.53287760419164,131420.87537977454,940,0,233.67441860465115,39,4,17,35.26316570053223,0.6263354700854701,43.93229166666668,1024.270833333335,26.263354700854745,0
1680,4,0,0,42,0.0,0.0,1.0,42,850,600,250,0.7058823529411765,11,6,5,346.00547204439215,0.4261517615176152,0.1597106288258212,0.20122065801416628,131054.49631090682,669.1145719190885,131723.61088282592,941,1,239.76190476190476,38,4,17,35.159945395102945,0.6271929824561404,44.01709401709403,1023.931623931626,26.945569050832262,0
1681,4,0,0,42,0.0,0.0,1.0,42,1400,1000,400,0.7142857142857143,18,10,8,347.94328907894436,0.42489353464963225,0.1620284154959306,0.20306927565295174,131191.27498584634,729.4247434071226,131920.69972925345,942,2,240.76190476190476,38,4,17,34.97214690443913,0.6285635964912281,43.88354700854701,1024.4658119658122,26.95962663067927,0
1682,4,0,0,42,0.0,0.0,1.0,42,900,700,200,0.7777777777777778,11,7,4,346.689540869198,0.42463946960898186,0.15938953502802145,0.20291597105297265,131300.74929003234,704.1192974286128,132004.86858746095,943,3,241.76190476190476,38,4,17,34.89371590395775,0.6296600877192983,43.77670940170941,1024.893162393164,26.970872694556945,0
1683,4,0,1,41,0.0,0.023809523809523808,0.9761904761904762,42,1500,1000,500,0.6666666666666666,20,10,10,346.5553068620646,0.4242886178861789,0.15860548327866808,0.20313541264426094,131356.983567182,704.4976568571037,132061.4812240391,944,4,242.76190476190476,36,6,17,34.84039144604342,0.6339699074074074,43.721846846846844,1025.1126126126123,28.475350350350343,0
1684,4,0,1,40,0.0,0.024390243902439025,0.975609756097561,41,1000,400,600,0.4,16,4,12,359.27006617294006,0.4248983739837398,0.07152153180637422,0.1972789011049274,128811.51532202197,1055.6243267158898,129867.13964873785,945,5,245.41463414634146,37,4,18,37.099445524591346,0.6064189189189189,46.21710526315788,1015.1315789473668,27.435988620199105,7
1685,4,1,1,40,0.024390243902439025,0.024390243902439025,0.975609756097561,41,1300,1000,300,0.7692307692307693,16,10,6,361.23937417168287,0.4264989837398374,0.10288688494825449,0.19990016472819838,129117.79495854466,1128.4862890504469,130246.2812475951,946,0,246.26829268292684,37,4,20,36.73704013377927,0.6095157657657657,45.91557017543858,1016.3377192982433,27.46858700806063,0
1686,4,2,2,40,0.047619047619047616,0.047619047619047616,0.9523809523809523,42,1300,1000,300,0.7692307692307693,16,10,6,352.823286280302,0.4299990321331785,0.11268884034337434,0.19760657638111445,129591.85157933175,744.6316414665661,130336.48322079831,947,0,241.14285714285714,37,5,16,36.46842917653816,0.6143018018018018,45.44956140350875,1018.2017543859621,27.51896633475573,0
1687,4,0,0,40,0.0,0.0,1.0,40,1000,700,300,0.7,13,7,6,361.50813647359087,0.42664262820512816,0.12720061412487205,0.20182482819125588,129466.28146701364,1360.622829861078,130826.90429687472,948,1,253.45,35,5,16,36.37517059024222,0.6169642857142856,45.57291666666665,1017.7083333333313,29.077380952380896,0
1688,4,0,0,40,0.0,0.0,1.0,40,1100,1000,100,0.9090909090909091,12,10,2,366.8099173553718,0.42652243589743594,0.13284090909090862,0.2058627087198514,129672.49657064468,1513.03155006858,131185.52812071325,949,2,254.45,35,5,16,36.03030303030301,0.6190476190476191,45.37037037037037,1018.5185185185182,29.100529100529094,0
1689,4,0,0,40,0.0,0.0,1.0,40,1250,800,450,0.64,17,8,9,368.0078141341181,0.4264957264957265,0.12578355666590935,0.20746970622695554,129849.3829839678,1557.117519718793,131406.50050368658,950,3,255.45,35,5,17,35.819800893330296,0.6208333333333333,45.19675925925926,1019.2129629629633,29.12037037037038,0
1690,4,0,1,39,0.0,0.025,0.975,40,1250,800,450,0.64,17,8,9,371.5294354724884,0.4260817307692308,0.1236382206082618,0.2104060016313347,130026.38996056248,1661.726251714687,131688.11621227715,951,4,256.45,35,5,17,35.55000756544107,0.6226190476190476,45.02314814814815,1019.907407407408,29.140211640211657,0
1691,4,1,1,39,0.025,0.025,0.975,40,1150,600,550,0.5217391304347826,17,6,11,365.15783220561536,0.4267761752136752,0.10929520811472582,0.2083804874802105,130323.35778061228,1518.1476319951935,131841.50541260748,952,0,240.85,34,6,20,35.410837122537025,0.6277573529411764,44.73214285714286,1021.0714285714289,30.031512605042025,0
1692,4,0,0,39,0.0,0.0,1.0,39,1150,900,250,0.782608695652174,14,9,5,372.3448563098707,0.4251855600539811,0.11575091575091556,0.21214997626957768,130262.58680555565,1900.5208333333426,132163.107638889,953,1,247.2051282051282,35,4,20,35.2891156462585,0.625,44.79166666666667,1020.8333333333342,29.16666666666669,0
1693,4,1,0,40,0.025,0.0,1.0,40,1050,800,250,0.7619047619047619,13,8,5,368.8470962698164,0.4257879273504273,0.11933577832110864,0.21247670756951387,130688.28124999997,1640.7986111111118,132329.0798611111,954,0,242.0,34,6,20,34.94634610160283,0.6314338235294117,44.375,1022.4999999999998,30.0735294117647,0
1694,4,1,1,40,0.024390243902439025,0.024390243902439025,0.975609756097561,41,1150,800,350,0.6956521739130435,15,8,7,360.0260799578398,0.4250762195121951,0.12998473765668006,0.20945087300426346,131068.54056336742,1237.6185729648573,132306.15913633228,955,0,237.0731707317073,36,5,21,34.7868323618901,0.6310763888888888,44.00337837837838,1023.9864864864866,28.444069069069073,0
1695,4,0,0,40,0.0,0.0,1.0,40,850,700,150,0.8235294117647058,10,7,3,368.22976315102346,0.42322382478632475,0.1319376908289045,0.2135249701996391,130942.84664619755,1643.4106813700078,132586.25732756755,956,1,243.925,35,5,21,34.70412096196614,0.6318452380952381,44.1261574074074,1023.4953703703691,29.24272486772483,0
1696,4,0,0,40,0.0,0.0,1.0,40,1200,1000,200,0.8333333333333334,14,10,4,366.74413722162444,0.42282318376068373,0.13637931034482698,0.21299093195832342,131002.08340031285,1608.8492101765996,132610.93261048946,957,2,244.925,35,5,21,34.682141511211604,0.6324404761904762,44.06828703703703,1023.7268518518513,29.24933862433861,0
1697,4,0,0,40,0.0,0.0,1.0,40,1550,1300,250,0.8387096774193549,18,13,5,366.6425255330133,0.42279647435897433,0.1395609673409428,0.21358918422920545,131120.59709630033,1614.877373756833,132735.47447005718,958,3,245.925,35,5,21,34.56475778807398,0.6336309523809525,43.95254629629628,1024.189814814813,29.262566137566086,0
1698,4,1,0,41,0.024390243902439025,0.0,1.0,41,1050,700,350,0.6666666666666666,14,7,7,360.7719858795643,0.424364837398374,0.14054723288349624,0.21279066233016186,131595.1877170137,1295.3355409807725,132890.52325799447,959,0,240.90243902439025,35,6,18,34.23540609137055,0.6383928571428572,43.48958333333332,1026.0416666666652,29.315476190476147,0
1699,4,0,0,41,0.0,0.0,1.0,41,1250,700,550,0.56,18,7,11,360.5877316585917,0.4236280487804878,0.13536695330884818,0.21384587936330351,131803.09070644696,1305.315500685845,133108.40620713282,960,1,241.90243902439025,35,6,19,34.03028253681996,0.6404761904761904,43.287037037037024,1026.85185185185,29.33862433862428,0
1700,4,0,0,41,0.0,0.0,1.0,41,1250,900,350,0.72,16,9,7,356.2019780659516,0.42284044715447155,0.1321628297387758,0.21214013367322054,131963.74584043483,1201.1494602710604,133164.8953007059,961,2,242.90243902439025,36,5,20,33.98089288323834,0.6400462962962963,43.13063063063062,1027.4774774774758,28.541041041040994,0
1701,4,0,0,41,0.0,0.0,1.0,41,1450,1000,450,0.6896551724137931,19,10,9,354.8493940653066,0.42284044715447155,0.13179871033946444,0.2118188632854187,132050.54029959007,1171.6108422611721,133222.15114185124,962,3,243.90243902439025,36,5,20,33.928180124904124,0.6409143518518519,43.04617117117117,1027.8153153153148,28.550425425425413,0
1702,4,0,0,41,0.0,0.0,1.0,41,1000,800,200,0.8,12,8,4,373.0378607007415,0.4223069105691057,0.14798610150288605,0.21769473657258118,131187.6746330601,1635.5588826489711,132823.23351570906,963,4,244.90243902439025,37,4,20,34.33307913232723,0.6303490990990991,43.88706140350877,1024.4517543859643,27.68788525367471,8
1703,4,0,0,41,0.0,0.0,1.0,41,1400,1000,400,0.7142857142857143,18,10,8,370.2160861390107,0.4220528455284553,0.1393325626847799,0.2166818883620117,131300.0289151467,1521.8765629808877,132821.90547812756,964,5,245.90243902439025,37,4,20,34.291639920116964,0.6314752252252251,43.77741228070174,1024.8903508771907,27.699739212897047,0
1704,4,2,2,41,0.046511627906976744,0.046511627906976744,0.9534883720930233,43,1050,800,250,0.7619047619047619,13,8,5,355.5641184375528,0.42513381321520854,0.14258722404508206,0.21104796169029674,131835.77609592,775.214301215269,132610.9903971353,965,0,235.41860465116278,39,4,19,34.126284782094196,0.6332799145299146,43.25520833333333,1026.9791666666656,26.332799145299116,0
1705,4,1,0,42,0.023809523809523808,0.0,1.0,42,1200,700,500,0.5833333333333334,17,7,10,356.02529741988263,0.4249903213317847,0.13936958463060867,0.21221689178532532,131996.29041883643,998.8037109374625,132995.0941297739,966,0,230.5,39,3,21,33.95263135664807,0.6348824786324787,43.098958333333314,1027.6041666666638,26.348824786324712,0
1706,4,1,1,42,0.023255813953488372,0.023255813953488372,0.9767441860465116,43,1200,1100,100,0.9166666666666666,13,11,2,351.3802231233805,0.42582595053525285,0.1433671992390515,0.21095318021677625,132267.29811124288,695.2225444510126,132962.5206556939,967,0,226.11627906976744,40,3,22,33.79910920108014,0.6359375,42.835365853658516,1028.6585365853625,25.716463414634063,0
1707,4,0,0,42,0.0,0.0,1.0,42,1150,1000,150,0.8695652173913043,13,10,3,351.0504742402393,0.42221980255516844,0.147399178383383,0.2108865257662163,132290.8203124996,888.151041666625,133178.97135416622,968,1,232.02380952380952,39,3,22,33.783920615633846,0.6378205128205128,42.81249999999998,1028.7499999999968,26.378205128205046,0
1708,4,0,0,42,0.0,0.0,1.0,42,850,600,250,0.7058823529411765,11,6,5,352.24311167204854,0.4219415408439799,0.1508579140158084,0.21220499654389233,132398.00347222204,927.3003472221983,133325.30381944423,969,2,233.02380952380952,38,4,22,33.645411605937916,0.640625,42.70833333333332,1029.1666666666652,27.083333333333293,0
1709,4,0,0,42,0.0,0.0,1.0,42,1000,800,200,0.8,12,8,4,349.52792222192954,0.42174796747967475,0.1501956947162426,0.21103076807835275,132480.4815910583,861.1254930966254,133341.60708415494,970,3,234.02380952380952,38,4,22,33.63234225819843,0.6414473684210527,42.62820512820512,1029.4871794871779,27.091767881241523,0
1710,4,0,1,41,0.0,0.023809523809523808,0.9761904761904762,42,1100,900,200,0.8181818181818182,13,9,4,350.746520066805,0.4209252806813782,0.14617595638130787,0.2126979840556056,132645.51487508204,904.9905489809146,133550.50542406295,971,4,235.02380952380952,38,4,17,33.435101638664165,0.643092105263158,42.46794871794871,1030.128205128204,27.108636977057998,0
1711,4,0,0,41,0.0,0.0,1.0,41,1300,1100,200,0.8461538461538461,15,11,4,352.74126427671274,0.42065548780487805,0.13483775727024327,0.2149138448130508,132821.51870046536,1170.326085911027,133991.84478637637,972,5,238.0,37,4,17,33.20690618019358,0.646677927927928,42.29714912280701,1030.8114035087706,27.859767662399204,0
1712,4,0,0,41,0.0,0.0,1.0,41,1250,900,350,0.72,16,9,7,354.45362718089996,0.42070630081300814,0.13461443705346166,0.21661054994388326,132934.57031249988,1223.8281249999854,134158.39843749988,973,6,239.0,37,4,18,33.049242424242415,0.6478040540540541,42.18749999999999,1031.249999999999,27.871621621621596,0
1713,4,0,1,40,0.0,0.024390243902439025,0.975609756097561,41,1250,1100,150,0.88,14,11,3,350.7383819987391,0.4202489837398374,0.13222518346364165,0.21473551542154873,133003.43940618364,1129.8822275184275,134133.32163370206,974,7,240.0,38,3,18,33.075910581736586,0.6466557017543859,42.12072649572649,1031.5170940170929,27.145186684660338,0
1714,4,0,1,39,0.0,0.025,0.975,40,1500,1100,400,0.7333333333333333,19,11,8,357.1039602037999,0.42099358974358975,0.1228750531236722,0.21939050087716455,133132.52635426272,1508.4304786087882,134640.9568328715,975,8,232.1,37,3,19,32.782175237285735,0.6497747747747749,41.99561403508771,1032.0175438596482,27.89236605026076,0
1715,4,0,1,38,0.0,0.02564102564102564,0.9743589743589743,39,1450,1100,350,0.7586206896551724,18,11,7,365.21529054759617,0.4191408007197481,0.0961248529631038,0.2045469956589255,129591.85157933242,1665.785145429396,131257.6367247618,976,10,238.84615384615384,37,2,16,36.1529901644052,0.6143018018018018,45.44956140350879,1018.2017543859675,27.51896633475588,8
1716,4,1,0,39,0.02564102564102564,0.0,1.0,39,1450,1200,250,0.8275862068965517,17,12,5,363.07485901231706,0.4209682860998651,0.10507495302502301,0.20436430434896816,129787.30384589505,1624.5014090874304,131411.80525498246,977,0,239.56410256410257,37,2,17,36.00862208113634,0.6162725225225225,45.2576754385965,1018.9692982456153,27.539710763395007,0
1717,4,0,0,39,0.0,0.0,1.0,39,1050,700,350,0.6666666666666666,14,7,7,361.9430436486093,0.4209682860998651,0.1068273027597908,0.2039323504645059,129826.69850107755,1597.9740804660744,131424.67258154362,978,1,240.56410256410257,38,1,17,35.99739665233953,0.6148574561403508,45.2190170940171,1019.123931623932,26.819050832208735,0
1718,4,0,1,38,0.0,0.02564102564102564,0.9743589743589743,39,1250,800,450,0.64,17,8,9,358.6029727125873,0.4204059829059829,0.09823373762608978,0.20289658414591846,129990.07100819997,1522.96517733216,131513.03618553214,979,2,241.56410256410257,38,1,17,35.916492055177216,0.6165021929824561,45.05876068376068,1019.7649572649569,26.83591992802518,0
1719,4,0,0,38,0.0,0.0,1.0,38,1000,800,200,0.8,12,8,4,365.8075344471405,0.4192449027975344,0.10001924372173576,0.2067868852780522,129954.95158366038,1907.7000856032641,131862.65166926364,980,3,247.52631578947367,37,1,17,35.76851901638169,0.6179617117117118,45.093201754385966,1019.6271929824563,27.55749170222855,0
1720,4,0,0,38,0.0,0.0,1.0,38,750,400,350,0.5333333333333333,11,4,7,367.2163034414009,0.4187855618776672,0.09819620002489549,0.20802960137709572,130038.81602993223,1950.4746652816193,131989.29069521386,981,4,248.52631578947367,37,1,17,35.64735182398051,0.6188063063063063,45.0109649122807,1019.9561403508768,27.56638217164532,0
1721,4,0,0,38,0.0,0.0,1.0,38,1150,800,350,0.6956521739130435,15,8,7,370.18838766510135,0.4183706733048838,0.10780254957186619,0.21031582024489828,130150.67737188366,2036.0538819636834,132186.73125384733,982,5,249.52631578947367,37,1,19,35.457858729135324,0.6199324324324325,44.901315789473685,1020.3947368421054,27.578236130867715,0
1722,4,0,0,38,0.0,0.0,1.0,38,900,600,300,0.6666666666666666,12,6,6,373.0112453144521,0.4180150545282124,0.11825993555316816,0.21252966302800194,130262.58680555565,2117.8819444444543,132380.46875000012,983,6,250.52631578947367,37,1,20,35.27210884353742,0.6210585585585586,44.79166666666667,1020.8333333333342,27.59009009009011,0
1723,4,0,0,38,0.0,0.0,1.0,38,1400,900,500,0.6428571428571429,19,9,10,377.37985369535005,0.4175408961593172,0.11583598697627795,0.21600224310733845,130439.87509645066,2245.0761959876572,132684.95129243832,984,7,251.52631578947367,35,3,20,34.9804554724677,0.6267857142857143,44.61805555555556,1021.527777777778,29.186507936507944,0
1724,4,0,0,38,0.0,0.0,1.0,38,1100,800,300,0.7272727272727273,14,8,6,378.8682424768248,0.4170074679943101,0.11703193189135042,0.21718498990814358,130498.99798525385,2288.3852023319723,132787.38318758583,985,8,252.52631578947367,35,3,17,34.88238181543574,0.6273809523809524,44.56018518518519,1021.7592592592599,29.19312169312171,0
1725,4,1,0,39,0.02564102564102564,0.0,1.0,39,1250,1000,250,0.8,15,10,5,374.3945641830739,0.419365721997301,0.12323943661971826,0.21699603311835294,130924.43795146495,2003.4795775505206,132927.91752901548,986,0,247.02564102564102,36,3,18,34.565039979460096,0.6296296296296297,44.14414414414414,1023.4234234234232,28.428428428428422,0
1726,4,0,1,38,0.0,0.02564102564102564,0.9743589743589743,39,1800,1700,100,0.9444444444444444,19,17,2,369.98023188155696,0.41897210976158344,0.1170991884532464,0.21546965387707218,131109.19922017684,1901.5623858572637,133010.7616060341,987,1,248.02564102564102,38,1,18,34.49083733222059,0.6277412280701755,43.96367521367522,1024.1452991452998,26.951192082771048,0
1727,4,0,0,38,0.0,0.0,1.0,38,1150,1000,150,0.8695652173913043,13,10,3,374.6920336346238,0.414681128496918,0.11856902081701004,0.2177037659020836,131019.23338190601,2218.372600223152,133237.60598212917,988,2,255.28947368421052,37,1,19,34.461350005355044,0.6286599099099099,44.0515350877193,1023.7938596491231,27.670104314841165,0
1728,4,0,0,38,0.0,0.0,1.0,38,1200,800,400,0.6666666666666666,16,8,8,378.02359961098625,0.4148293029871977,0.11810273918579361,0.22044297550348513,131159.5935768697,2316.284337488446,133475.87791435813,989,3,256.2894736842105,37,1,19,34.233836437593666,0.6300675675675675,43.91447368421052,1024.342105263157,27.68492176386911,0
1729,4,1,1,38,0.02564102564102564,0.02564102564102564,0.9743589743589743,39,1100,700,400,0.6363636363636364,15,7,8,367.02210533475034,0.4165823211875843,0.12210586307615645,0.2165569269686374,131609.2511638194,1860.8090951061636,133470.06025892557,990,0,250.69230769230768,37,2,16,34.06087483080429,0.634572072072072,43.475877192982445,1026.0964912280683,27.732337600758605,0
1730,4,1,1,38,0.02564102564102564,0.02564102564102564,0.9743589743589743,39,1050,800,250,0.7619047619047619,13,8,5,364.962413575503,0.4178756185335133,0.1342918968012321,0.2177461936628381,132031.503984399,1837.3072724299714,133868.81125682898,991,0,247.97435897435898,37,2,17,33.687520004267576,0.638795045045045,43.06469298245614,1027.7412280701749,27.776789947842566,0
1731,4,0,0,38,0.0,0.0,1.0,38,1350,900,450,0.6666666666666666,18,9,9,365.66298110195925,0.4160887861545756,0.1402336362378338,0.21844055572635376,132079.47812677556,2059.315142845564,134138.79326962112,992,1,253.8421052631579,36,2,18,33.621138255915874,0.6412037037037037,43.018018018018026,1027.927927927929,28.553553553553584,0
1732,4,0,0,38,0.0,0.0,1.0,38,1100,900,200,0.8181818181818182,13,9,4,365.8982039879123,0.4154960881934566,0.1398800945408425,0.2189155047450615,132137.36329234645,2069.7647816735716,134207.12807402003,993,2,254.8421052631579,36,2,19,33.55672690763053,0.6417824074074074,42.961711711711715,1028.1531531531534,28.559809809809817,0
1733,4,0,1,37,0.0,0.02631578947368421,0.9736842105263158,38,1250,900,350,0.72,16,9,7,366.82303977799796,0.4151849217638692,0.14364887687403782,0.21963679844019035,132166.31063073222,2096.3295643616743,134262.6401950939,994,3,255.8421052631579,36,2,19,33.50376921111233,0.6420717592592593,42.933558558558566,1028.265765765767,28.56293793793797,0
1734,4,0,0,37,0.0,0.0,1.0,37,1700,1300,400,0.7647058823529411,21,13,8,368.8305107879747,0.4142892892892893,0.13584389116184314,0.22097498909987542,132189.63162562152,2351.113870670433,134540.74549629196,995,4,258.5135135135135,35,2,19,33.428648471206145,0.6443452380952381,42.910879629629626,1028.356481481481,29.381613756613746,0
1735,4,0,0,37,0.0,0.0,1.0,37,1450,1100,350,0.7586206896551724,18,11,7,368.3614516846319,0.4135072572572573,0.13916762008365113,0.22209575392366268,132428.63520408142,2356.4849616865545,134785.120165768,996,5,259.5135135135135,34,3,20,33.199841930757955,0.6488970588235294,42.678571428571416,1029.2857142857126,30.27310924369743,0
1736,4,0,1,36,0.0,0.02702702702702703,0.972972972972973,37,1150,700,450,0.6086956521739131,16,7,9,369.3919259478124,0.41260010010010006,0.14062798895963735,0.2241279845168012,132666.15125868042,2401.161024305537,135067.31228298595,997,6,260.5135135135135,35,2,18,32.93415065722952,0.6491071428571429,42.44791666666666,1030.2083333333321,29.434523809523775,0
1737,4,0,0,36,0.0,0.0,1.0,36,950,600,350,0.631578947368421,13,6,7,374.3807668541384,0.41081349206349205,0.13749550521395193,0.22683069991750734,132612.50000000003,2729.51388888889,135342.0138888889,998,7,263.8611111111111,34,2,23,32.859695253505926,0.6507352941176471,42.5,1030.0000000000002,30.29411764705883,0
1738,4,0,0,36,0.0,0.0,1.0,36,1300,900,400,0.6923076923076923,17,9,8,376.4420638987511,0.4111276455026455,0.144259644259644,0.2292008009307588,132796.4923469389,2798.037131519285,135594.5294784582,999,8,264.8611111111111,34,2,19,32.62132324632323,0.6525735294117647,42.32142857142858,1030.7142857142867,30.315126050420197,0
1739,4,0,0,36,0.0,0.0,1.0,36,1450,1200,250,0.8275862068965517,17,12,5,374.32688439140065,0.41026785714285713,0.14461967298986056,0.2285728727239883,132904.73257726768,2749.9628933041804,135654.69547057187,1000,9,265.8611111111111,35,1,19,32.566903318741346,0.6514880952380953,42.21643518518518,1031.1342592592594,29.46097883597884,0
1740,4,0,1,35,0.0,0.027777777777777776,0.9722222222222222,36,550,300,250,0.5454545454545454,8,3,5,374.1833172709665,0.40992063492063496,0.1484141232794738,0.22903308540651457,132994.2558299039,2752.8463648833954,135747.1021947873,1001,10,266.8611111111111,35,1,19,32.480550568521856,0.6523809523809524,42.129629629629626,1031.4814814814808,29.470899470899454,0
1741,4,0,0,35,0.0,0.0,1.0,35,950,400,550,0.42105263157894735,15,4,11,377.8256083909049,0.4100840336134454,0.13465242052499682,0.23117804174426546,132980.6122448979,3048.696145124708,136029.3083900226,1002,11,269.1714285714286,34,1,19,32.400353955063096,0.6544117647058824,42.14285714285714,1031.4285714285709,30.336134453781497,0
1742,4,0,0,35,0.0,0.0,1.0,35,1000,700,300,0.7,13,7,6,377.73409386003704,0.4092086834733894,0.13913530798265983,0.2316929505651056,133072.72002551027,3053.22066326531,136125.94068877556,1003,12,270.1714285714286,34,1,19,32.31005538248529,0.6553308823529411,42.05357142857143,1031.785714285715,30.346638655462204,0
1743,4,0,0,35,0.0,0.0,1.0,35,1300,900,400,0.6923076923076923,17,9,8,375.6008136343621,0.4089285714285715,0.1383094414236281,0.23095454285176734,133164.85969387757,3003.365929705218,136168.22562358278,1004,13,271.1714285714286,34,1,19,32.272443291041924,0.65625,41.964285714285715,1032.1428571428573,30.35714285714286,0
1744,4,0,0,35,0.0,0.0,1.0,35,750,500,250,0.6666666666666666,10,5,5,376.5214168516225,0.4092086834733894,0.13921982076963624,0.23190296356088552,133226.30385487518,3032.5113378684678,136258.81519274364,1005,14,272.1714285714286,34,1,19,32.18692343173433,0.6568627450980392,41.9047619047619,1032.3809523809516,30.364145658263283,0
1745,4,0,0,35,0.0,0.0,1.0,35,1050,600,450,0.5714285714285714,15,6,9,370.2149882127717,0.40917366946778716,0.1098462099971802,0.21701301997958986,131358.63272392275,2747.743055555541,134106.3757794783,1006,15,273.1714285714286,34,1,18,34.23237719196378,0.6381740196078431,43.72023809523809,1025.1190476190463,30.1505602240896,8
1746,4,0,0,35,0.0,0.0,1.0,35,600,300,300,0.5,9,3,6,369.9398478106248,0.4092787114845939,0.10958795036825708,0.21702465731233642,131389.1439909296,2721.215986394543,134110.35997732414,1007,16,274.1714285714286,34,1,19,34.20856556742529,0.6384803921568627,43.69047619047618,1025.2380952380943,30.15406162464983,0
1747,4,0,0,35,0.0,0.0,1.0,35,1000,700,300,0.7,13,7,6,369.36081019721087,0.40857843137254907,0.1100003316859599,0.21703096992078938,131450.17715419488,2710.5087868480564,134160.68594104293,1008,17,275.1714285714286,34,1,19,34.1616844671465,0.639093137254902,43.63095238095237,1025.4761904761895,30.161064425770277,0
1748,4,0,0,35,0.0,0.0,1.0,35,450,300,150,0.6666666666666666,6,3,3,368.0905078063908,0.4085084033613446,0.10226296855053962,0.21680354789936207,131541.75347222207,2683.8541666666483,134225.60763888873,1009,18,276.1714285714286,34,1,19,34.10167885188193,0.6400122549019608,43.54166666666666,1025.8333333333321,30.171568627450945,0
1749,4,0,0,35,0.0,0.0,1.0,35,800,600,200,0.75,10,6,4,369.3724732317336,0.4083333333333334,0.1112363274776269,0.21808155611353006,131633.36167800435,2724.3480725623376,134357.7097505667,1010,19,277.1714285714286,34,1,16,33.9762180974478,0.6409313725490196,43.45238095238094,1026.1904761904748,30.182072829131613,0
1750,4,0,0,35,0.0,0.0,1.0,35,800,500,300,0.625,11,5,6,368.6396475900823,0.40780812324929977,0.1065447194883522,0.21799801382178927,131694.4515306122,2709.5592403628034,134404.010770975,1011,20,278.1714285714286,34,1,16,33.93330047166164,0.6415441176470589,43.39285714285714,1026.4285714285709,30.189075630252084,0
1751,4,0,0,35,0.0,0.0,1.0,35,900,600,300,0.6666666666666666,12,6,6,372.06489226452254,0.40745798319327736,0.10709939148073011,0.22099758058603583,131862.521701389,2812.282986111121,134674.80468750012,1012,21,279.1714285714286,35,0,16,33.67562542258283,0.6410714285714285,43.22916666666667,1027.0833333333342,29.34523809523812,0
1752,4,0,1,34,0.0,0.02857142857142857,0.9714285714285714,35,1000,600,400,0.6,14,6,8,371.3659605551498,0.4061274509803921,0.11003861003861015,0.2216216216216216,132040.8950617283,2807.0987654320884,134847.9938271604,1013,22,280.1714285714286,35,0,19,33.513513513513516,0.6428571428571428,43.05555555555555,1027.7777777777771,29.365079365079346,0
1753,4,0,0,34,0.0,0.0,1.0,34,750,500,250,0.6666666666666666,10,5,5,377.0793175858476,0.40509878193701726,0.11194182363159522,0.22533424964386095,132091.88102324252,3161.8232709750405,135253.70429421755,1014,23,279.29411764705884,34,0,20,33.31523837097085,0.6455269607843137,43.00595238095237,1027.9761904761895,30.234593837534984,0
1754,4,0,0,34,0.0,0.0,1.0,34,1050,700,350,0.6666666666666666,14,7,7,375.0703321972004,0.4042446524064171,0.11215427470050243,0.2244963589180329,132153.07716836708,3113.3397108843214,135266.4168792514,1015,24,280.29411764705884,34,0,21,33.30511172860946,0.6461397058823529,42.946428571428555,1028.2142857142835,30.2415966386554,0
1755,4,0,0,34,0.0,0.0,1.0,34,800,400,400,0.5,12,4,8,372.2546010727302,0.4051730540701129,0.11043452214817218,0.22353384349336047,132275.5119756234,3048.033588435354,135323.54556405876,1016,25,281.29411764705884,34,0,22,33.254011881340894,0.6473651960784313,42.82738095238094,1028.6904761904748,30.255602240896316,0
1756,4,0,0,34,0.0,0.0,1.0,34,700,400,300,0.5714285714285714,10,4,6,373.5514432296876,0.40509878193701726,0.113955703738986,0.22504196701886034,132398.00347222204,3091.549744897936,135489.55321711997,1017,26,282.29411764705884,33,1,22,33.09716599190284,0.6508838383838385,42.70833333333332,1029.1666666666652,31.186868686868642,0
1757,4,0,0,34,0.0,0.0,1.0,34,700,400,300,0.5714285714285714,10,4,6,371.56819691241424,0.404708853238265,0.11332231428111239,0.2240345503135221,132429.53619100805,3041.3207960880186,135470.85698709608,1018,27,283.29411764705884,33,1,22,33.116417629082825,0.651199494949495,42.67769607843136,1029.2892156862729,31.19058229352342,0
1758,4,0,0,34,0.0,0.0,1.0,34,1100,600,500,0.5454545454545454,16,6,10,375.2661013850527,0.40357620320855614,0.11848699498838133,0.22721443199135302,132587.25610342165,3151.100538254502,135738.35664167616,1019,28,284.29411764705884,33,1,22,32.8623274631128,0.6527777777777778,42.52450980392156,1029.9019607843127,31.209150326797353,0
1759,4,0,0,34,0.0,0.0,1.0,34,1050,600,450,0.5714285714285714,15,6,9,373.1396554662899,0.4036876114081997,0.11912359519111027,0.22630677805552887,132650.37035034588,3099.422698000752,135749.79304834665,1020,29,285.29411764705884,33,1,16,32.85351732889205,0.6534090909090908,42.46323529411764,1030.1470588235281,31.216577540106915,0
1760,4,0,0,34,0.0,0.0,1.0,34,900,600,300,0.6666666666666666,12,6,6,371.4080812167369,0.40348336304218657,0.11682491481188695,0.22544604612195684,132681.9331056563,3055.8284373798356,135737.76154303612,1021,30,286.29411764705884,33,1,16,32.86633658459221,0.6537247474747474,42.43259803921568,1030.2696078431359,31.220291146761692,0
1761,4,0,0,34,0.0,0.0,1.0,34,1000,600,400,0.6,14,6,8,371.9075465502321,0.40322341057635175,0.1173847972193276,0.22651081636741516,132808.2216725539,3078.47597678778,135886.69764934166,1022,31,287.29411764705884,33,1,17,32.72636527563111,0.6549873737373737,42.310049019607845,1030.759803921569,31.23514557338088,0
1762,4,0,0,34,0.0,0.0,1.0,34,1050,600,450,0.5714285714285714,15,6,9,373.24080400664775,0.4027035056446821,0.1196852210514543,0.22770666309702164,132871.38848339583,3118.6047734044623,135989.99325680028,1023,32,288.29411764705884,33,1,17,32.62844704623796,0.6556186868686869,42.24877450980392,1031.0049019607845,31.24257278669044,0
1763,4,0,0,34,0.0,0.0,1.0,34,1400,1100,300,0.7857142857142857,17,11,6,370.99319716609773,0.40225787284610814,0.12032593586062879,0.22787262679326822,133124.20590938575,3077.634954104185,136201.84086348992,1024,33,289.29411764705884,33,1,19,32.432188378260705,0.6581439393939394,42.00367647058823,1031.9852941176466,31.272281639928686,0
1764,4,0,0,34,0.0,0.0,1.0,34,700,400,300,0.5714285714285714,10,4,6,370.4967976838012,0.4022207367795603,0.1202484793038674,0.227954311679376,133187.44781153888,3069.104581170709,136256.5523927096,1025,34,290.29411764705884,33,1,19,32.38145059163402,0.6587752525252526,41.942401960784316,1032.230392156863,31.279708853238272,0
1765,4,0,0,34,0.0,0.0,1.0,34,1050,700,350,0.6666666666666666,14,7,7,376.8750670023231,0.401849376114082,0.11985634410403567,0.23266858532077475,133313.97667063147,3248.542778018071,136562.51944864955,1026,35,291.29411764705884,33,1,19,32.089686919030115,0.6600378787878788,41.81985294117647,1032.720588235294,31.294563279857393,0
1766,4,0,0,34,0.0,0.0,1.0,34,950,700,250,0.7368421052631579,12,7,5,377.4838967561931,0.4009024064171123,0.1175420047037139,0.23384601998194132,133441.47002551015,3274.4012188208576,136715.871244331,1027,36,292.29411764705884,34,0,19,31.9458847025387,0.6590073529411764,41.69642857142857,1033.2142857142853,30.38865546218486,0
1767,4,0,0,34,0.0,0.0,1.0,34,1350,800,550,0.5925925925925926,19,8,11,376.77444835133497,0.4004567736185383,0.12073294047909644,0.23419988738714137,133567.2146079632,3264.946263431834,136832.16087139503,1028,37,293.29411764705884,33,1,20,31.837951985773564,0.6625631313131313,41.57475490196078,1033.7009803921562,31.324272133095644,0
1768,4,0,0,34,0.0,0.0,1.0,34,900,700,200,0.7777777777777778,11,7,4,376.77444835133497,0.4004567736185383,0.12073294047909644,0.23419988738714137,133567.2146079632,3264.9427203479336,136832.15732831112,1029,38,294.29411764705884,33,1,20,31.837951985773564,0.6625631313131313,41.57475490196078,1033.7009803921562,31.324272133095644,0
1769,4,0,0,34,0.0,0.0,1.0,34,1300,1000,300,0.7692307692307693,16,10,6,377.30050287731063,0.39982546048722517,0.11757385187096081,0.23492873378419674,133630.56163795156,3283.7756211552996,136914.33725910686,1030,39,295.29411764705884,33,1,20,31.760771008652352,0.6631944444444444,41.51348039215685,1033.946078431371,31.33169934640518,0
1770,4,0,0,34,0.0,0.0,1.0,34,850,600,250,0.7058823529411765,11,6,5,376.8991403969933,0.39943553178847296,0.11765403008797781,0.23487998129023832,133662.24078479418,3275.4367310649623,136937.67751585913,1031,40,296.29411764705884,33,1,21,31.73935371731059,0.663510101010101,41.482843137254896,1034.0686274509794,31.335412953059983,0
1771,4,1,0,35,0.02857142857142857,0.0,1.0,35,950,700,250,0.7368421052631579,12,7,5,362.7593035580031,0.4014005602240896,0.07273454157782555,0.2068499858586058,130292.97052154188,2452.997448979585,132745.96797052145,1032,0,288.8,34,1,19,35.502905394900516,0.6274509803921569,44.76190476190476,1020.9523809523804,30.028011204481775,8
1772,4,1,0,36,0.027777777777777776,0.0,1.0,36,1100,800,300,0.7272727272727273,14,8,6,356.3815829131873,0.40512566137566136,0.07457531143827856,0.20460659149047075,130558.13426997578,2105.702910665269,132663.83718064104,1033,0,281.75,35,1,16,35.39684786711966,0.6279761904761905,44.5023148148148,1021.990740740739,29.199735449735403,0
1773,4,0,0,36,0.0,0.0,1.0,36,1350,900,450,0.6666666666666666,18,9,9,354.5498158588647,0.40429894179894177,0.07186509732910817,0.20449100345489074,130735.62349965691,2070.458247599435,132806.08174725634,1034,1,282.75,35,1,16,35.2638826014788,0.6297619047619047,44.328703703703695,1022.685185185184,29.219576719576686,0
1774,4,0,0,36,0.0,0.0,1.0,36,950,700,250,0.7368421052631579,12,7,5,359.7755983702219,0.4035714285714285,0.0780542986425341,0.20814242732936888,130854.01663237286,2215.6164266117644,133069.63305898462,1035,2,283.75,35,1,17,35.01036953242836,0.6309523809523809,44.21296296296295,1023.1481481481461,29.232804232804174,0
1775,4,1,0,37,0.02702702702702703,0.0,1.0,37,550,300,250,0.5454545454545454,8,3,5,351.7442589548234,0.4061561561561562,0.08475281172577254,0.20540239203921573,131212.72243527306,1830.6643636880021,133043.38679896106,1036,0,277.05405405405406,36,1,19,34.8531270608925,0.6325231481481481,43.86261261261261,1024.549549549549,28.459709709709696,0
1776,4,0,0,37,0.0,0.0,1.0,37,950,800,150,0.8421052631578947,11,8,3,353.62548747438694,0.40537412412412416,0.08261920457042393,0.20712349980642647,131328.12499999988,1888.194444444429,133216.31944444432,1037,1,278.05405405405406,36,1,19,34.68834688346883,0.6336805555555556,43.74999999999999,1024.999999999999,28.472222222222197,0
1777,4,0,0,37,0.0,0.0,1.0,37,1150,700,450,0.6086956521739131,16,7,9,354.34462072331166,0.40499874874874875,0.08385978245380743,0.20785782390882904,131385.84530476408,1911.1735045856553,133297.01880934974,1038,2,279.05405405405406,36,1,20,34.6116176039836,0.6342592592592593,43.69369369369369,1025.2252252252242,28.47847847847845,0
1778,4,1,0,38,0.02631578947368421,0.0,1.0,38,1000,700,300,0.7,13,7,6,350.49989820535177,0.4071390469416785,0.08843701863074682,0.20741972484187765,131721.78578985843,1633.694502154508,133355.48029201294,1039,0,272.6842105263158,37,1,17,34.371216976429515,0.6356981981981982,43.36622807017544,1026.5350877192984,27.74419155998104,0
1779,4,0,0,38,0.0,0.0,1.0,38,850,600,250,0.7058823529411765,11,6,5,351.2049870458013,0.4072724039829303,0.08842273864051475,0.20829858794705067,131806.21831957914,1658.2002394967728,133464.41855907592,1040,1,273.6842105263158,37,1,17,34.26799697455064,0.6365427927927928,43.28399122807018,1026.8640350877197,27.75308202939783,0
1780,4,0,1,37,0.0,0.02631578947368421,0.9736842105263158,38,1250,1000,250,0.8,15,10,5,350.5127836755173,0.40702050734945466,0.08755449683131844,0.20835049222539637,131890.67790089265,1645.873730378589,133536.55163127123,1041,2,274.6842105263158,37,1,18,34.200647594648466,0.6373873873873874,43.20175438596492,1027.192982456141,27.76197249881462,0
1781,4,0,0,37,0.0,0.0,1.0,37,900,700,200,0.7777777777777778,11,7,4,352.7547936124879,0.4063438438438438,0.08284597016991402,0.21030648382546036,132003.3327562327,1912.9616805170867,133916.2944367498,1042,3,273.1621621621622,37,0,19,34.02955612462656,0.6385135135135135,43.0921052631579,1027.6315789473686,27.77382645803699,0
1782,4,0,1,36,0.0,0.02702702702702703,0.972972972972973,37,1050,800,250,0.7619047619047619,13,8,5,353.4923961336615,0.4059684684684685,0.08830635628160688,0.21105972747496474,132059.67821829816,1936.4184172053178,133996.09663550346,1043,4,274.1621621621622,37,0,19,33.95384396557854,0.6390765765765766,43.0372807017544,1027.8508771929842,27.77975343764822,0
1783,4,0,1,35,0.0,0.027777777777777776,0.9722222222222222,36,850,700,150,0.8235294117647058,10,7,3,356.1858720408252,0.40267857142857144,0.09189860471911726,0.2124543966172928,132021.60564280534,2204.8461468225387,134226.45178962787,1044,5,282.5,36,0,19,33.92299474030244,0.640625,43.074324324324344,1027.7027027027057,28.54729729729738,0
1784,4,0,0,35,0.0,0.0,1.0,35,950,600,350,0.631578947368421,13,6,7,359.76939949699073,0.4012955182072829,0.0984445123618638,0.2148696729611823,132070.6356765478,2502.994657707511,134573.63033425531,1045,6,287.62857142857143,35,0,19,33.781504522763946,0.643154761904762,43.02662037037039,1027.893518518521,29.368386243386315,0
1785,4,0,0,35,0.0,0.0,1.0,35,1250,1000,250,0.8,15,10,5,360.7515425694843,0.4004551820728291,0.09632726571042594,0.2159647374789289,132159.8776148837,2535.375943072733,134695.25355795643,1046,7,288.62857142857143,35,0,19,33.66632898093952,0.644047619047619,42.93981481481483,1028.2407407407431,29.378306878306947,0
1786,4,1,0,36,0.027777777777777776,0.0,1.0,36,700,400,300,0.5714285714285714,10,4,6,355.2151555934151,0.4028108465608466,0.1066131025957977,0.21518445674784206,132606.53941883144,2220.9848411779863,134827.52426000944,1047,0,281.5833333333333,35,1,21,33.35920234483276,0.6485119047619048,42.50578703703704,1029.976851851852,29.427910052910057,0
1787,4,0,0,36,0.0,0.0,1.0,36,1400,1100,300,0.7857142857142857,17,11,6,355.1028527778241,0.4023148148148148,0.10311622683885457,0.21614428598677546,132785.41512613595,2230.495943715703,135015.91106985166,1048,1,282.5833333333333,35,1,19,33.182317986150096,0.6502976190476191,42.332175925925924,1030.671296296296,29.447751322751316,0
1788,4,0,0,36,0.0,0.0,1.0,36,750,600,150,0.8,9,6,3,352.81428401821523,0.40257936507936504,0.08583583583583598,0.19670604602111455,129413.28125,2019.4672175068586,131432.74846750687,1049,2,283.5833333333333,34,2,19,36.65028665028665,0.6185661764705883,45.625,1017.5,29.926470588235293,8
1789,4,1,0,37,0.02702702702702703,0.0,1.0,37,1050,800,250,0.7619047619047619,13,8,5,345.3533264484095,0.40621871871871873,0.09280793742402094,0.1944047753230047,129790.40745027427,1564.7097908093197,131355.1172410836,1050,0,276.8918918918919,35,2,19,36.45691352415569,0.6202380952380953,45.254629629629626,1018.9814814814808,29.113756613756596,0
1790,4,0,0,37,0.0,0.0,1.0,37,1150,900,250,0.782608695652174,14,9,5,345.0947706051103,0.4056243743743744,0.09203118432315871,0.19499293356384956,129937.87140185609,1568.175984867966,131506.04738672407,1051,1,277.8918918918919,35,2,19,36.31383149808909,0.6217261904761905,45.1099537037037,1019.5601851851848,29.130291005290992,0
1791,4,0,0,37,0.0,0.0,1.0,37,1350,1000,350,0.7407407407407407,17,10,7,345.7178632048023,0.4058746246246246,0.09149873804361541,0.19593643269607183,130055.90284475709,1592.5297657321355,131648.43261048922,1052,2,278.8918918918919,35,2,19,36.17820738303266,0.6229166666666667,44.99421296296295,1020.0231481481458,29.14351851851845,0
1792,4,0,1,36,0.0,0.02702702702702703,0.972972972972973,37,850,500,350,0.5882352941176471,12,5,7,346.3556851311957,0.40443568568568566,0.10369553226696127,0.19734219269102982,130262.58680555536,1623.6016000085529,131886.1884055639,1053,3,279.8918918918919,34,3,21,35.95238095238095,0.6271446078431373,44.79166666666666,1020.8333333333318,30.02450980392152,0
1793,4,0,0,36,0.0,0.0,1.0,36,750,600,150,0.8,9,6,3,350.93075996025567,0.40224867724867724,0.11249125262421278,0.19979285098932462,130232.2066326529,1940.4974489795713,132172.7040816325,1054,4,286.94444444444446,34,2,22,35.86642757172848,0.6268382352941176,44.82142857142856,1020.7142857142844,30.021008403361307,0
1794,4,0,0,36,0.0,0.0,1.0,36,1000,600,400,0.6,14,6,8,349.6966186902518,0.40140542328042333,0.10873377879139512,0.19940605956936935,130293.86421388401,1912.6682934203013,132206.5325073043,1055,5,287.94444444444446,33,3,22,35.835408914496064,0.6297348484848485,44.7610294117647,1020.9558823529405,30.9380570409982,0
1795,4,0,0,36,0.0,0.0,1.0,36,1150,900,250,0.782608695652174,14,9,5,349.3301529398161,0.4017526455026455,0.10058528651041176,0.1996788405075741,130387.71896626307,1909.6723615916985,132297.39132785477,1056,6,288.94444444444446,33,3,23,35.74964002879767,0.6306818181818181,44.669117647058826,1021.3235294117655,30.94919786096259,0
1796,4,0,0,36,0.0,0.0,1.0,36,950,600,350,0.631578947368421,13,6,7,349.3301529398161,0.4017526455026455,0.10058528651041176,0.1996788405075741,130387.71896626307,1909.6723615916985,132297.39132785477,1057,7,289.94444444444446,33,3,23,35.74964002879767,0.6306818181818181,44.669117647058826,1021.3235294117655,30.94919786096259,0
1797,4,0,0,36,0.0,0.0,1.0,36,1200,900,300,0.75,15,9,6,347.5939522769224,0.4018187830687831,0.09968809980806204,0.1990070869629411,130450.30757400986,1868.747597078033,132319.05517108788,1058,8,290.94444444444446,33,3,23,35.73056621880998,0.6313131313131313,44.607843137254896,1021.5686274509793,30.9566250742721,0
1798,4,0,0,36,0.0,0.0,1.0,36,950,500,450,0.5263157894736842,14,5,9,348.8734837923563,0.4018683862433863,0.09969280183385987,0.19990090957916662,130481.60750973184,1904.3145965494048,132385.92210628124,1059,9,291.94444444444446,33,3,23,35.666181879972825,0.6316287878787878,44.57720588235294,1021.6911764705882,30.960338680926913,0
1799,4,0,0,36,0.0,0.0,1.0,36,1000,800,200,0.8,12,8,4,347.06044040436626,0.40145502645502645,0.10126930495682607,0.1989859559112009,130505.755739796,1858.6770124716584,132364.43275226766,1060,10,292.94444444444446,34,2,19,35.68803642859915,0.6295955882352942,44.55357142857143,1021.785714285715,30.05252100840338,0
1800,4,0,0,36,0.0,0.0,1.0,36,1300,900,400,0.6923076923076923,17,9,8,349.299691145171,0.4009755291005291,0.10077368938570652,0.20105802597551795,130657.85147392288,1927.7494331065755,132585.60090702947,1061,11,293.94444444444446,34,2,20,35.47682813227762,0.6311274509803921,44.404761904761905,1022.3809523809522,30.070028011204474,0
1801,4,0,0,36,0.0,0.0,1.0,36,1250,900,350,0.72,16,9,7,348.87143012733435,0.40011574074074074,0.10090373128539265,0.20176319451644076,130840.48327664388,1929.3013038548563,132769.78458049873,1062,12,294.94444444444446,34,2,20,35.302973004421666,0.6329656862745099,44.22619047619047,1023.0952380952373,30.091036414565803,0
1802,4,0,1,35,0.0,0.027777777777777776,0.9722222222222222,36,1250,900,350,0.72,16,9,7,345.20875028480253,0.3983630952380952,0.10146033540606703,0.2004840050078185,131002.08340031284,1844.6130990654874,132846.69649937833,1063,13,295.94444444444446,35,1,20,35.23330035801771,0.6324404761904762,44.06828703703703,1023.7268518518512,29.249338624338606,0
1803,4,1,0,36,0.027777777777777776,0.0,1.0,36,1050,800,250,0.7619047619047619,13,8,5,344.3366927371571,0.40006613756613757,0.11075010958974763,0.20297493967228572,131572.28599773237,1861.8436163688666,133434.12961410123,1064,0,284.5833333333333,34,2,17,34.680078517830886,0.6403186274509804,43.51190476190476,1025.9523809523805,30.17507002801119,0
1804,4,0,0,36,0.0,0.0,1.0,36,950,800,150,0.8421052631578947,11,8,3,344.6168525799905,0.39952050264550265,0.10463789970227722,0.2036286419528514,131663.90483276665,1874.7200963719038,133538.62492913855,1065,1,285.5833333333333,34,2,17,34.58053010091636,0.6412377450980392,43.42261904761906,1026.3095238095254,30.185574229691923,0
1805,4,0,0,36,0.0,0.0,1.0,36,850,600,250,0.7058823529411765,11,6,5,346.3910943079186,0.39813161375661377,0.11573268921095026,0.20533492703819917,131786.11288265308,1929.907171201818,133716.02005385488,1066,2,286.5833333333333,34,2,18,34.411835748792264,0.6424632352941176,43.30357142857143,1026.7857142857144,30.199579831932777,0
1806,4,0,0,36,0.0,0.0,1.0,36,1150,800,350,0.6956521739130435,15,8,7,347.45340772536235,0.39804894179894185,0.1148070880337917,0.2064619835987898,131877.8061224491,1964.2786281179303,133842.08475056704,1067,3,287.5833333333333,34,2,19,34.292178565909424,0.6433823529411764,43.21428571428572,1027.1428571428582,30.210084033613477,0
1807,4,0,0,36,0.0,0.0,1.0,36,950,800,150,0.8421052631578947,11,8,3,346.64966274164874,0.3981150793650794,0.11552620739367714,0.20664916359018737,132000.11337868482,1951.5589569160989,133951.67233560092,1068,4,288.5833333333333,34,2,20,34.189643188137154,0.6446078431372548,43.095238095238095,1027.6190476190477,30.224089635854344,0
1808,4,0,0,36,0.0,0.0,1.0,36,1100,900,200,0.8181818181818182,13,9,4,347.07530212930175,0.39790013227513227,0.12200270178993566,0.2076141352737098,132130.12695312515,1971.8207465277928,134101.94769965293,1069,5,289.5833333333333,35,1,20,34.04783012495779,0.64375,42.96875000000001,1028.1250000000011,29.375000000000032,0
1809,4,0,0,36,0.0,0.0,1.0,36,1100,700,400,0.6363636363636364,15,7,8,346.0397080097622,0.3970899470899471,0.12313376847475466,0.2074837277580802,132219.38898533958,1950.6317515432215,134170.0207368828,1070,6,290.5833333333333,35,1,20,33.98463875759623,0.6446428571428571,42.88194444444445,1028.4722222222229,29.384920634920654,0
1810,4,0,0,36,0.0,0.0,1.0,36,1350,1100,250,0.8148148148148148,16,11,5,343.91082764564834,0.3969742063492063,0.11984341218960526,0.2070217446579186,132368.22601862554,1904.5732328103436,134272.79925143588,1071,7,291.5833333333333,35,1,21,33.889724627900875,0.6461309523809524,42.73726851851851,1029.050925925925,29.401455026455,0
1811,4,0,0,36,0.0,0.0,1.0,36,900,600,300,0.6666666666666666,12,6,6,346.1414248277206,0.3970899470899471,0.12442058048152771,0.20869394515206194,132427.78427479832,1967.748387131325,134395.53266192964,1072,8,292.5833333333333,35,1,21,33.7724661718955,0.6467261904761905,42.67939814814814,1029.2824074074058,29.40806878306874,0
1812,4,1,1,36,0.02702702702702703,0.02702702702702703,0.972972972972973,37,800,400,400,0.5,12,4,8,337.70810457983964,0.4013388388388388,0.13701016650869158,0.20565816907646534,132803.95418645005,1569.7943298027847,134373.74851625285,1073,0,285.64864864864865,36,1,18,33.61193051458537,0.6484375,42.31418918918919,1030.7432432432438,28.631756756756772,0
1813,4,0,0,36,0.0,0.0,1.0,36,650,400,250,0.6153846153846154,9,4,5,338.19957015154625,0.40049603174603177,0.14682539682539697,0.20643701762050398,132891.02447041642,1788.7374705786951,134679.76194099511,1074,1,291.4166666666667,36,0,19,33.51195026940441,0.6493055555555556,42.22972972972973,1031.0810810810815,28.64114114114115,0
1814,4,0,0,36,0.0,0.0,1.0,36,600,300,300,0.5,9,3,6,336.9768296578833,0.4007771164021164,0.14486964855454865,0.20617039297505385,132978.123287984,1762.1092798880045,134740.232567872,1075,2,292.4166666666667,36,0,20,33.4561633366088,0.6501736111111112,42.145270270270274,1031.4189189189194,28.650525525525538,0
1815,4,0,0,36,0.0,0.0,1.0,36,1100,600,500,0.5454545454545454,16,6,10,338.4842207078888,0.40009920634920637,0.14352558973985974,0.20822458838983288,133181.46482631282,1815.9648668939233,134997.42969320674,1076,3,293.4166666666667,36,0,21,33.213551894683256,0.6521990740740741,41.9481981981982,1032.2072072072074,28.67242242242243,0
1816,4,0,1,35,0.0,0.027777777777777776,0.9722222222222222,36,850,400,450,0.47058823529411764,13,4,9,336.1709368162489,0.40021494708994704,0.13705945068391934,0.20761102097924694,133326.8038942658,1764.119313570319,135090.9232078361,1077,4,294.4166666666667,36,0,21,33.12774870061426,0.6536458333333333,41.80743243243243,1032.7702702702695,28.68806306306304,0
1817,4,0,0,35,0.0,0.0,1.0,35,800,500,300,0.625,11,5,6,343.61312813173697,0.3999299719887955,0.129594696302465,0.21184331140727158,133263.00643272005,2158.183700917322,135421.19013363737,1078,5,300.0857142857143,35,0,22,32.99950024287264,0.6550595238095238,41.86921296296295,1032.5231481481458,29.50066137566131,0
1818,4,0,0,35,0.0,0.0,1.0,35,800,600,200,0.75,10,6,4,344.9372219476026,0.39936974789915963,0.12953661464585808,0.21334474746239437,133382.53821855696,2201.720437885787,135584.25865644275,1079,6,301.0857142857143,35,0,22,32.845588235294116,0.65625,41.753472222222214,1032.9861111111102,29.51388888888886,0
1819,4,0,0,35,0.0,0.0,1.0,35,950,800,150,0.8421052631578947,11,8,3,347.49414205402445,0.3997549019607843,0.1336555233721135,0.2152727415764244,133442.32420535403,2274.085192686892,135716.4093980409,1080,7,302.0857142857143,35,0,22,32.71967532952465,0.6568452380952381,41.69560185185185,1033.2175925925922,29.52050264550263,0
1820,4,0,0,35,0.0,0.0,1.0,35,800,400,400,0.5,12,4,8,348.270031217482,0.3995098039215686,0.13294930875576072,0.21592741935483875,133472.22222222213,2296.8749999999955,135769.09722222213,1081,8,303.0857142857143,35,0,22,32.66969086021506,0.6571428571428571,41.666666666666664,1033.3333333333328,29.523809523809508,0
1821,4,0,0,35,0.0,0.0,1.0,35,600,400,200,0.6666666666666666,8,4,4,350.05612700260536,0.39912464985994395,0.1363291807263598,0.21791298832852068,133621.76254125932,2355.023335691001,135976.7858769503,1082,9,304.0857142857143,35,0,22,32.47380965707676,0.6586309523809524,41.52199074074073,1033.9120370370363,29.540343915343893,0
1822,4,0,0,35,0.0,0.0,1.0,35,700,400,300,0.5714285714285714,10,4,6,351.4242118495113,0.39929971988795515,0.13930730116089474,0.21894169516482095,133651.68065200606,2393.687307098755,136045.36795910483,1083,10,305.0857142857143,35,0,22,32.40849563465413,0.6589285714285714,41.49305555555555,1034.027777777777,29.54365079365077,0
1823,4,0,0,35,0.0,0.0,1.0,35,1000,600,400,0.6,14,6,8,348.0744110625649,0.398844537815126,0.1382933844678813,0.21791213129547124,133831.25964506168,2316.6473765432074,136147.9070216049,1084,11,306.0857142857143,35,0,17,32.31543624161074,0.6607142857142857,41.31944444444444,1034.722222222222,29.563492063492056,0
1824,4,0,0,35,0.0,0.0,1.0,35,900,600,300,0.6666666666666666,12,6,6,352.769146134329,0.3983893557422969,0.14048444011560157,0.22211298736550616,134040.9208488727,2457.1002389832056,136498.0210878559,1085,12,307.0857142857143,35,0,17,31.98430106925971,0.662797619047619,41.11689814814815,1035.532407407408,29.58664021164023,0
1825,4,0,0,35,0.0,0.0,1.0,35,300,200,100,0.6666666666666666,4,2,2,354.25574512133744,0.39800420168067224,0.14482065035199487,0.22341329549618386,134100.8541907793,2501.199604552471,136602.05379533177,1086,13,308.0857142857143,35,0,18,31.8858950720751,0.6633928571428571,41.05902777777778,1035.7638888888887,29.59325396825396,0
1826,4,0,0,35,0.0,0.0,1.0,35,550,400,150,0.7272727272727273,7,4,3,355.1464685871225,0.39775910364145656,0.1448044692737427,0.2241580320066818,134130.82588520242,2527.2178283607745,136658.04371356318,1087,14,309.0857142857143,35,0,18,31.83286778398508,0.6636904761904762,41.030092592592595,1035.8796296296302,29.596560846560863,0
1827,4,0,0,35,0.0,0.0,1.0,35,800,500,300,0.625,11,5,6,354.9583480079637,0.39681372549019606,0.1505170432784373,0.22440587085927216,134190.77932098776,2526.4274691358164,136717.20679012357,1088,15,310.0857142857143,35,0,18,31.777815013404837,0.6642857142857144,40.97222222222223,1036.111111111112,29.60317460317463,0
1828,4,0,0,35,0.0,0.0,1.0,35,650,400,250,0.6153846153846154,9,4,5,354.7334404036335,0.39653361344537813,0.14933469478924066,0.2246310626148611,134250.74615269207,2524.645811899869,136775.39196459192,1089,16,311.0857142857143,35,0,18,31.723717519172066,0.6648809523809525,40.914351851851855,1036.3425925925928,29.609788359788368,0
1829,4,0,0,35,0.0,0.0,1.0,35,650,400,250,0.6153846153846154,9,4,5,359.94955703779056,0.3964985994397759,0.1204133513816894,0.21844344085589315,132673.8166099772,2573.6948438068484,135247.51145378404,1090,17,312.0857142857143,34,1,20,33.16963253986595,0.6513480392156863,42.44047619047618,1030.2380952380943,30.301120448179244,8
1830,4,1,0,36,0.027777777777777776,0.0,1.0,36,1100,900,200,0.8181818181818182,13,9,4,350.22818446795145,0.4000496031746032,0.11569192032508191,0.21471348255483605,133053.95474322682,2119.849001200246,135173.80374442707,1091,0,304.3888888888889,35,1,21,33.03838531149503,0.6529761904761905,42.071759259259245,1031.7129629629612,29.477513227513178,0
1831,4,0,0,36,0.0,0.0,1.0,36,800,400,400,0.5,12,4,8,346.7014008257205,0.3997354497354497,0.11605485153203055,0.2130624666549239,133143.52823055966,2032.209549682768,135175.73778024243,1092,1,305.3888888888889,35,1,21,33.03953590519981,0.6538690476190476,41.984953703703695,1032.0601851851839,29.487433862433825,0
1832,4,0,0,36,0.0,0.0,1.0,36,1250,700,550,0.56,18,7,11,346.8896264388109,0.39917328042328043,0.1118674136321196,0.21455231572878614,133382.53821855696,2053.80377121912,135436.3419897761,1093,2,306.3888888888889,35,1,21,32.79516806722689,0.65625,41.753472222222214,1032.9861111111102,29.51388888888886,0
1833,4,0,0,36,0.0,0.0,1.0,36,900,500,400,0.5555555555555556,13,5,8,338.74799532358736,0.39857804232804234,0.1290334684076242,0.2027922635077325,132159.87761488333,1753.8088616683706,133913.6864765517,1094,3,307.3888888888889,35,1,18,34.23195257391565,0.644047619047619,42.93981481481481,1028.24074074074,29.378306878306855,8
1834,4,0,0,36,0.0,0.0,1.0,36,1150,900,250,0.782608695652174,14,9,5,330.21314629938547,0.39877645502645503,0.13200864944387436,0.18002472773670897,128525.67361379016,1288.3877475565741,129814.06136134673,1095,4,308.3888888888889,35,1,14,38.12790111478904,0.6074404761904761,46.49884259259259,1014.0046296296285,28.971560846560816,8
1835,4,1,0,37,0.02702702702702703,0.0,1.0,37,1050,700,350,0.6666666666666666,14,7,7,322.6891246114751,0.4016516516516517,0.13864319167181383,0.17714493113567825,128800.98637488841,912.5355084814558,129713.52188336986,1096,0,301.02702702702703,36,1,16,38.03851416315362,0.6082175925925926,46.22747747747748,1015.0900900900901,28.196946946946948,0
1836,4,0,0,37,0.0,0.0,1.0,37,700,500,200,0.7142857142857143,9,5,4,322.0558990215384,0.40168293293293295,0.13377134481714759,0.17717986830245336,128886.73460200062,901.7466368395428,129788.48123884016,1097,1,302.02702702702703,36,1,16,37.96740416250786,0.6090856481481481,46.14301801801802,1015.4279279279277,28.206331331331327,0
1837,4,0,0,37,0.0,0.0,1.0,37,950,700,250,0.7368421052631579,12,7,5,322.9886156211814,0.40158908908908914,0.13511416304898183,0.17820674627025546,129001.10995708546,933.1779837269657,129934.28794081243,1098,2,303.02702702702703,36,1,17,37.82747662860732,0.6102430555555556,46.0304054054054,1015.8783783783783,28.218843843843842,0
1838,4,3,1,39,0.075,0.025,0.975,40,950,800,150,0.8421052631578947,11,8,3,306.40896412594896,0.40769230769230774,0.1556501073290404,0.17257333886264586,129811.04736328125,-44.9462890625006,129766.10107421875,1099,0,281.225,39,1,14,37.42812787488499,0.6129807692307692,45.234375,1019.0625,26.129807692307693,0
1839,4,1,0,40,0.025,0.0,1.0,40,1050,600,450,0.5714285714285714,15,6,9,305.3387307444178,0.4078926282051282,0.15714139762975132,0.17255516723593298,129943.7717013888,-64.62673611111563,129879.1449652777,1100,0,282.2,39,1,15,37.321209644462606,0.6143162393162394,45.104166666666664,1019.5833333333326,26.143162393162374,0
1840,4,0,1,39,0.0,0.025,0.975,40,800,500,300,0.625,11,5,6,303.52363406464633,0.4080662393162393,0.03843337089009524,0.1686568719051305,129280.82817925354,-152.0426432291622,129128.78553602438,1101,1,283.2,39,1,19,38.038278022465775,0.6076388888888888,45.755208333333336,1016.9791666666672,26.076388888888903,8
1841,4,2,0,41,0.04878048780487805,0.0,1.0,41,900,700,200,0.7777777777777778,11,7,4,297.206712310437,0.414380081300813,0.06840845632229708,0.16743757927241915,129822.05119307285,-483.2029959019187,129338.84819717094,1102,0,271.9512195121951,40,1,13,37.65145093737534,0.6114583333333333,45.22357723577235,1019.1056910569101,25.477642276422753,0
1842,4,2,1,42,0.046511627906976744,0.023255813953488372,0.9767441860465116,43,1050,600,450,0.5714285714285714,15,6,9,291.20641493959255,0.41761258767072723,0.10582648575047959,0.1668967650229748,130490.55103812325,-999.3167027804395,129491.2343353428,1103,0,260.25581395348837,41,2,13,37.130121856490945,0.6166158536585367,44.568452380952365,1021.7261904761878,24.92015098722409,0
1843,4,0,0,42,0.0,0.0,1.0,42,1800,1500,300,0.8333333333333334,21,15,6,296.1462745775607,0.4160859465737514,0.1221066787892564,0.16997984801095578,130548.03688280765,-667.7370447485189,129880.29983805913,1104,1,267.2857142857143,40,2,13,36.94601896048792,0.61875,44.51219512195121,1021.9512195121935,25.548780487804837,0
1844,4,1,0,43,0.023255813953488372,0.0,1.0,43,1050,800,250,0.7619047619047619,13,8,5,295.85968925791025,0.415813030638612,0.1406439135227251,0.17157866296086885,130947.07739866766,-851.6076743197414,130095.46972434792,1105,0,262.04651162790697,41,2,14,36.55162595715809,0.6211890243902439,44.1220238095238,1023.5119047619037,24.963704994192774,0
1845,4,0,1,42,0.0,0.023255813953488372,0.9767441860465116,43,950,700,250,0.7368421052631579,12,7,5,295.13834552413766,0.4154900332225913,0.14250102552775323,0.17127319736321958,130972.46334876506,-869.0007716049688,130103.46257716008,1106,1,263.04651162790697,41,2,14,36.54454997738581,0.6214430894308943,44.09722222222221,1023.6111111111081,24.96612466124654,0
1846,4,0,0,42,0.0,0.0,1.0,42,1950,1500,450,0.7692307692307693,24,15,9,298.31178683624347,0.41481562137049943,0.13176745196987327,0.17377954842402657,131119.87428944398,-577.0792021944756,130542.7950872495,1107,2,260.0952380952381,40,2,16,36.31507574254151,0.6244791666666667,43.95325203252032,1024.1869918699176,25.60467479674794,0
1847,4,1,1,42,0.023255813953488372,0.023255813953488372,0.9767441860465116,43,1300,1100,200,0.8461538461538461,15,11,4,292.25502979644887,0.4175664451827243,0.13505248590812435,0.17151934883283917,131404.40095308947,-919.2805768140677,130485.1203762754,1108,0,255.02325581395348,41,2,17,36.18438558297047,0.6257621951219512,43.675595238095234,1025.2976190476184,25.007259001161422,0
1848,4,0,1,41,0.0,0.023809523809523808,0.9761904761904762,42,1150,900,250,0.782608695652174,14,9,5,323.9946471993767,0.4160859465737514,0.15147081911993476,0.18025916752743543,129330.57089240871,17.707062902752853,129348.27795531147,1109,1,261.8809523809524,40,2,16,37.46732107769675,0.6065104166666666,45.706300813008134,1017.1747967479682,25.429369918699205,7
1849,4,0,0,41,0.0,0.0,1.0,41,750,600,150,0.8,9,6,3,329.6649145378089,0.4129573170731707,0.16143233343826968,0.18305966414778674,129254.345703125,322.1245659722222,129576.47026909722,1110,5,269.2439024390244,39,2,17,37.40054975073414,0.6073717948717949,45.78125,1016.875,26.07371794871795,0
1850,4,1,0,42,0.023809523809523808,0.0,1.0,42,1600,1200,400,0.75,20,12,8,326.56246144566137,0.4151301780874952,0.17255701345503627,0.18331420402747994,129680.91699932294,69.7838915658927,129750.70089088884,1111,0,263.8095238095238,41,1,12,37.046585338138364,0.6084857723577235,45.36210317460318,1018.5515873015879,24.842721641502145,0
1851,4,0,0,42,0.0,0.0,1.0,42,1100,800,300,0.7272727272727273,14,8,6,325.48749992526155,0.41500919473480447,0.17260919748021886,0.18341925873462486,129832.53146455342,51.77321507307016,129884.3046796265,1112,1,264.8095238095238,41,1,13,36.920304844414176,0.610010162601626,45.21329365079365,1019.1468253968254,24.85723964382501,0
1852,4,1,0,43,0.023255813953488372,0.0,1.0,43,1500,1000,500,0.6666666666666666,20,10,10,319.0441328033031,0.41788944259874494,0.17454225880815044,0.181434816775615,130188.40889970561,-292.83039631031284,129895.5785033953,1113,0,259.6279069767442,42,1,17,36.72438758070642,0.6121031746031746,44.86434108527132,1020.5426356589153,24.298634182355126,0
1853,4,0,1,42,0.0,0.023255813953488372,0.9767441860465116,43,1200,1000,200,0.8333333333333334,14,10,4,322.07503166814206,0.4176356589147287,0.18137174357277241,0.18399840780177124,130366.35068618198,-202.4084422886218,130163.94224389335,1114,1,260.6279069767442,40,3,17,36.46714432613527,0.6169270833333333,44.690040650406495,1021.2398373983725,25.530995934959314,0
1854,4,0,1,41,0.0,0.023809523809523808,0.9761904761904762,42,1300,1100,200,0.8461538461538461,15,11,4,325.5015366527592,0.41648519163763065,0.18505268066626845,0.18584109282510178,130342.35161675343,85.32714843749534,130427.67876519093,1115,2,267.54761904761904,39,3,17,36.40392821925263,0.6183226495726496,44.713541666666664,1021.1458333333329,26.183226495726483,0
1855,4,0,0,41,0.0,0.0,1.0,41,1150,800,350,0.6956521739130435,15,8,7,330.66629782133,0.41468495934959354,0.18957940991839317,0.18879978940121092,130344.39718934908,420.09985207100436,130764.49704142008,1116,3,273.4878048780488,38,3,18,36.27000941619586,0.6200657894736843,44.71153846153846,1021.1538461538458,26.87246963562752,0
1856,4,0,0,41,0.0,0.0,1.0,41,1350,1000,350,0.7407407407407407,17,10,7,333.2657866633987,0.4145071138211382,0.19331564445351557,0.19055149046065142,130398.95171305431,491.501844546719,130890.45355760102,1117,4,274.4878048780488,38,3,18,36.148448396094835,0.6206140350877193,44.65811965811966,1021.3675213675216,26.878092667566357,0
1857,4,0,0,41,0.0,0.0,1.0,41,950,600,350,0.631578947368421,13,6,7,331.8355911098107,0.41445630081300816,0.1912805260660846,0.19000071390371323,130453.51765103373,457.8240284169868,130911.34167945072,1118,5,275.4878048780488,38,3,18,36.12977584884613,0.6211622807017544,44.60470085470086,1021.5811965811971,26.88371569950519,0
1858,4,0,0,41,0.0,0.0,1.0,41,950,500,450,0.5263157894736842,14,5,9,329.2944059805946,0.41394817073170737,0.19051674677750396,0.18894427073811587,130535.3879597671,396.91460753160544,130932.30256729871,1119,6,276.4878048780488,38,3,15,36.11190974037289,0.621984649122807,44.524572649572654,1021.9017094017105,26.892150247413433,0
1859,4,0,0,41,0.0,0.0,1.0,41,1150,1100,50,0.9565217391304348,12,11,1,329.0037216446124,0.41392276422764224,0.19651378579003187,0.18917713994565225,130617.28395061738,394.71450617285177,131011.99845679023,1120,7,277.4878048780488,38,3,15,36.03657155797103,0.6228070175438596,44.44444444444445,1022.222222222223,26.900584795321656,0
1860,4,0,0,41,0.0,0.0,1.0,41,1400,1100,300,0.7857142857142857,17,11,6,328.01337905761875,0.4128810975609756,0.1986837981823879,0.18927498961534564,130753.83434007235,377.8014053254482,131131.6357453978,1121,8,278.4878048780488,38,3,15,35.923952783871314,0.6241776315789473,44.31089743589744,1022.7564102564105,26.914642375168697,0
1861,4,0,0,41,0.0,0.0,1.0,41,700,600,100,0.8571428571428571,8,6,2,325.7078821172897,0.41252540650406505,0.19854418481054759,0.18827410890370244,130821.45317925356,321.91569010417743,131143.36886935774,1122,9,279.4878048780488,39,2,15,35.91464294199504,0.6231303418803419,44.24479166666667,1023.020833333334,26.23130341880344,0
1862,4,0,0,41,0.0,0.0,1.0,41,750,500,250,0.6666666666666666,10,5,5,324.3648479800086,0.4120680894308943,0.08382279741164766,0.18481252966302789,130262.58680555537,390.0661892360914,130652.65299479147,1123,10,280.4878048780488,38,3,17,36.51360544217686,0.6192434210526316,44.79166666666666,1020.8333333333319,26.86403508771926,8
1863,4,0,0,41,0.0,0.0,1.0,41,900,600,300,0.6666666666666666,12,6,6,325.64529696207,0.41199186991869924,0.09083509602749551,0.18606356208370725,130371.6730244172,290.9844354956307,130662.65745991284,1124,11,281.4878048780488,38,3,18,36.37061059385569,0.6203399122807017,44.68482905982905,1021.260683760682,26.875281151596894,0
1864,4,0,1,40,0.0,0.024390243902439025,0.975609756097561,41,1100,900,200,0.8181818181818182,13,9,4,326.17957480984467,0.41209349593495936,0.09066885690818904,0.18676222121746877,130453.51765103343,310.2545839725108,130763.77223500593,1125,12,282.4878048780488,38,3,18,36.27422784633621,0.6211622807017544,44.604700854700845,1021.5811965811946,26.88371569950512,0
1865,4,1,1,40,0.024390243902439025,0.024390243902439025,0.975609756097561,41,950,700,250,0.7368421052631579,12,7,5,323.83306855372285,0.413744918699187,0.11852366996175046,0.18706121959985617,130794.81336805546,271.13715277776737,131065.95052083323,1126,0,282.8292682926829,39,2,16,35.98947725729803,0.6228632478632479,44.27083333333333,1022.9166666666658,26.228632478632456,0
1866,4,0,0,40,0.0,0.0,1.0,40,1700,900,800,0.5294117647058824,25,9,16,325.33143664964774,0.41163194444444445,0.13797577854671284,0.18870759719713306,130954.69292534703,520.7356770833093,131475.42860243033,1127,1,290.525,39,1,16,35.789826311147294,0.624465811965812,44.11458333333332,1023.541666666665,26.244658119658077,0
1867,4,0,0,40,0.0,0.0,1.0,40,1050,700,350,0.6666666666666666,14,7,7,321.9637189288095,0.4114449786324786,0.12850966429298127,0.18727238799231904,131061.333550347,439.3988715277579,131500.73242187477,1128,2,291.525,39,1,16,35.76848084096304,0.625534188034188,44.01041666666666,1023.9583333333316,26.255341880341835,0
1868,4,0,0,40,0.0,0.0,1.0,40,1000,700,300,0.7,13,7,6,345.6625097887184,0.41008279914529916,0.15716324486730016,0.18932749096217022,128711.08596280363,898.1194023068653,129609.2053651105,1129,3,292.525,40,0,14,37.54715406442997,0.6002604166666667,46.316056910569124,1014.7357723577269,25.368394308943174,8
1869,4,0,0,40,0.0,0.0,1.0,40,1000,800,200,0.8,12,8,4,346.7887937290866,0.41017628205128204,0.15434521425710845,0.19031464130583087,128788.44024720755,932.4775679159424,129720.91781512348,1130,4,293.525,40,0,14,37.439719329862506,0.6010416666666667,46.23983739837399,1015.0406504065056,25.37601626016264,0
1870,4,1,1,40,0.024390243902439025,0.024390243902439025,0.975609756097561,41,950,600,350,0.631578947368421,13,6,7,350.03257175836313,0.4132367886178862,0.18276257718657596,0.1938612827154698,129150.96391565894,841.4088088939386,129992.37272455287,1131,0,287.3414634146341,41,0,15,36.9880115817555,0.603150406504065,45.88293650793651,1016.4682539682547,24.791908633372064,0
1871,4,0,0,40,0.0,0.0,1.0,40,1100,700,400,0.6363636363636364,15,7,8,350.5574659044809,0.4136752136752137,0.16711388775092129,0.19492272762479254,129307.3133680558,1065.9386613441911,130373.25202939998,1132,1,279.125,39,1,17,36.81551276799127,0.607905982905983,45.72916666666668,1017.0833333333353,26.07905982905988,0
1872,4,0,2,38,0.0,0.05,0.95,40,1800,1300,500,0.7222222222222222,23,13,10,347.91925541789993,0.4134748931623931,0.16340483259956962,0.19384639861190156,129386.78521050372,1003.2307942708574,130390.01600477457,1133,2,280.125,39,1,17,36.80175164670148,0.6087072649572649,45.65104166666668,1017.3958333333353,26.0870726495727,0
1873,4,0,0,38,0.0,0.0,1.0,38,950,500,450,0.5263157894736842,14,5,9,357.0565396034914,0.4130215742057847,0.17388974220139874,0.19937400915960485,129473.07715136246,1645.8417798962719,131118.91893125873,1134,3,291.05263157894734,38,0,14,36.48151550143468,0.6112938596491229,45.56623931623932,1017.7350427350432,26.782501124606398,0
1874,4,1,0,39,0.02564102564102564,0.0,1.0,39,1150,900,250,0.782608695652174,14,9,5,347.3958183601438,0.4149797570850202,0.18009518418349124,0.1957903621449108,129837.58680555575,1221.0069444444637,131058.59375000022,1135,0,284.56410256410254,39,0,17,36.35697737803216,0.6132478632478633,45.20833333333334,1019.1666666666682,26.132478632478673,0
1875,4,0,0,39,0.0,0.0,1.0,39,1400,1100,300,0.7857142857142857,17,11,6,348.0922654680539,0.4142206477732793,0.18526086364255634,0.1967163449423389,129943.7717013888,1246.484374999995,131190.2560763888,1136,1,285.56410256410254,39,0,17,36.231439858329935,0.6143162393162394,45.104166666666664,1019.5833333333326,26.143162393162374,0
1876,4,2,1,40,0.04878048780487805,0.024390243902439025,0.975609756097561,41,900,600,300,0.6666666666666666,12,6,6,334.8572891581846,0.42014735772357725,0.19824998943230288,0.19197049382540243,130501.95448133691,540.6873914930657,131042.64187282998,1137,0,272.5853658536585,39,2,11,36.00360638189417,0.6199252136752137,44.55729166666667,1021.7708333333343,26.19925213675216,0
1877,4,0,0,40,0.0,0.0,1.0,40,850,600,250,0.7058823529411765,11,6,5,340.2555539994048,0.4168803418803419,0.19524581589958157,0.19454803207143,130398.9517130543,873.793511213386,131272.74522426768,1138,1,280.4,38,2,19,35.96997036262204,0.6206140350877193,44.65811965811966,1021.3675213675215,26.878092667566353,0
1878,4,0,0,40,0.0,0.0,1.0,40,1100,800,300,0.7272727272727273,14,8,6,342.75011345150415,0.41673344017094016,0.19384345916553358,0.196388216592974,130480.80490037626,944.4621365695118,131425.26703694576,1139,2,281.4,38,2,19,35.823399212241625,0.6214364035087719,44.577991452991455,1021.6880341880345,26.886527215474594,0
1879,4,0,0,40,0.0,0.0,1.0,40,1250,1000,250,0.8,15,10,5,344.73020449626915,0.4163595085470086,0.19346973973032355,0.19808011209704524,130589.98243343181,1003.662269888217,131593.64470332002,1140,3,282.4,38,2,13,35.66230270722276,0.622532894736842,44.47115384615384,1022.1153846153835,26.897773279352197,0
1880,4,1,0,41,0.024390243902439025,0.0,1.0,41,850,700,150,0.8235294117647058,10,7,3,337.38896890932,0.41852134146341463,0.1943422976935656,0.19529592466683876,130874.74093967023,631.1387803819487,131505.87972005218,1141,0,276.4878048780488,39,2,14,35.56205249584308,0.6236645299145299,44.192708333333336,1023.2291666666674,26.23664529914532,0
1881,4,0,1,40,0.0,0.024390243902439025,0.975609756097561,41,1350,1000,350,0.7407407407407407,17,10,7,350.28440450343277,0.41875,0.17620076743262958,0.18806531620426992,127913.1190511598,761.9781096760369,128675.09716083584,1142,1,277.4878048780488,40,1,16,38.245094099524486,0.5921875,47.10365853658536,1011.5853658536568,25.28963414634142,8
1882,4,2,0,42,0.047619047619047616,0.0,1.0,42,1000,600,400,0.6,14,6,8,337.5160587077184,0.42212301587301587,0.17737498208912528,0.18308134414123756,128324.66310562474,262.53604418664213,128587.19914981138,1143,0,271.6666666666667,40,2,19,38.14777666332331,0.5963541666666667,46.69715447154471,1013.2113821138194,25.330284552845484,0
1883,4,1,2,41,0.023255813953488372,0.046511627906976744,0.9534883720930233,43,1150,800,350,0.6956521739130435,15,8,7,328.2469462703813,0.42400332225913623,0.18031612625949078,0.17961377846480375,128672.41753472193,-152.7343750000338,128519.6831597219,1144,0,266.3255813953488,41,2,12,38.02831964407938,0.5983231707317074,46.35416666666665,1014.583333333331,24.745934959349537,0
1884,4,0,1,40,0.0,0.024390243902439025,0.975609756097561,41,1000,800,200,0.8,12,8,4,329.45408717790673,0.41803861788617885,0.10691288066414395,0.16553386992489927,125203.33465529777,102.91846887599874,125306.25312417377,1145,1,280.2682926829268,40,1,15,41.55369956674791,0.5645833333333333,49.796747967479675,1000.8130081300814,25.020325203252035,8
1885,4,1,0,41,0.024390243902439025,0.0,1.0,41,1100,800,300,0.7272727272727273,14,8,6,333.35323512142304,0.41958841463414637,0.12512588552891768,0.16841941766232,125432.28366258496,162.65150951813337,125594.9351721031,1146,0,281.1463414634146,40,1,14,41.2198606743093,0.5669270833333333,49.568089430894304,1001.7276422764216,25.04319105691054,0
1886,4,1,0,42,0.023809523809523808,0.0,1.0,42,1150,800,350,0.6956521739130435,15,8,7,325.5233071864906,0.4213850174216028,0.13523611758556875,0.16601196195547033,125819.79210955207,-208.54503259638426,125611.24707695568,1147,0,275.42857142857144,41,1,16,41.016822406803094,0.569359756097561,49.18154761904761,1003.2738095238088,24.47009291521485,0
1887,4,1,0,43,0.023255813953488372,0.0,1.0,43,1000,600,400,0.6,14,6,8,323.69507812274156,0.4231958287190845,0.14596228723341742,0.16639239975264164,126145.90691924436,-433.0395640434547,125712.8673552009,1148,0,270.0,40,3,18,40.727322542572935,0.57421875,48.856707317073166,1004.5731707317061,25.114329268292654,0
1888,4,2,0,45,0.044444444444444446,0.0,1.0,45,1000,700,300,0.7,13,7,6,316.18584627587813,0.4284301346801347,0.1735434165082872,0.16482286157257425,126718.83144718793,-986.6598079561043,125732.17163923182,1149,0,258.9555555555556,44,1,19,40.32822941573171,0.5743371212121212,48.28703703703704,1006.8518518518518,22.882996632996633,0
1889,4,1,1,45,0.021739130434782608,0.021739130434782608,0.9782608695652174,46,1050,600,450,0.5714285714285714,15,6,9,312.9992232080423,0.43221618357487923,0.1759369237020596,0.16429506395561755,127000.69575719371,-1249.7761762235,125750.9195809702,1150,0,254.30434782608697,45,1,20,40.11989276300023,0.575925925925926,48.00724637681159,1007.9710144927524,22.39935587761672,0
1890,4,1,0,46,0.021739130434782608,0.0,1.0,46,800,200,600,0.25,14,2,12,313.1915077213168,0.4338566827697263,0.16968682201965124,0.16487532857677076,127118.94729572984,-1237.25531615186,125881.69197957798,1151,0,253.6086956521739,38,8,21,39.99408482536994,0.5874451754385965,47.88995726495725,1008.4401709401684,26.537899235267588,0
1891,4,3,2,47,0.061224489795918366,0.04081632653061224,0.9591836734693877,49,1200,600,600,0.5,18,6,12,298.91468421688216,0.44079506802721086,0.18215967705763614,0.1600072721396249,127793.20987654304,-2160.1466049382893,125633.06327160475,1152,0,239.0204081632653,41,8,19,39.66632326007326,0.589430894308943,47.222222222222214,1011.1111111111098,24.661246612466094,0
1892,4,2,0,49,0.04081632653061224,0.0,1.0,49,700,500,200,0.7142857142857143,9,5,4,300.9116131589376,0.4389880952380953,0.1984517945109079,0.1616006811409111,127923.87777176866,-2101.243915630055,125822.63385613861,1153,0,239.9591836734694,42,7,21,39.482758620689665,0.5892857142857143,47.09302325581396,1011.6279069767453,24.086378737541555,0
1893,4,1,1,49,0.02,0.02,0.98,50,950,700,250,0.7368421052631579,12,7,5,291.56142098157176,0.44006802721088434,0.19026504640704278,0.1576362343858461,128193.59117728804,-2524.548742563541,125669.0424347245,1154,0,236.14,42,8,22,39.444989315217086,0.5920138888888888,46.8265503875969,1012.6937984496126,24.111757105943155,0
1894,4,1,0,50,0.02,0.0,1.0,50,1550,1100,450,0.7096774193548387,20,11,9,295.7294872311838,0.4400255102040816,0.20036906013959266,0.16067712763381586,128389.92478103803,-2406.2626757706603,125983.66210526737,1155,0,236.96,42,8,15,39.1399353029289,0.5939980158730158,46.63275193798451,1013.4689922480638,24.13021410114438,0
1895,4,0,0,50,0.0,0.0,1.0,50,1000,500,500,0.5,15,5,10,295.70256607187946,0.43977040816326535,0.1932798165137617,0.16115789850917447,128512.70957274208,-2399.6924012979907,126113.0171714441,1156,1,237.96,42,8,15,39.01591169724773,0.5952380952380952,46.51162790697675,1013.9534883720935,24.141749723145082,0
1896,4,1,2,49,0.0196078431372549,0.0392156862745098,0.9607843137254902,51,1150,700,450,0.6086956521739131,16,7,9,288.85927950198624,0.4411274509803922,0.19152961202719254,0.15885811730284805,128872.12362825827,-2754.818244170057,126117.3053840882,1157,0,234.27450980392157,44,7,17,38.824928567086154,0.5961174242424243,46.157407407407426,1015.3703703703734,23.076599326599396,0
1897,4,1,0,50,0.02,0.0,1.0,50,1350,900,450,0.6666666666666666,18,9,9,295.45916981040557,0.4406887755102041,0.1864956627180303,0.16235867552728653,128840.60890330873,-2386.572131112245,126454.03677219649,1158,0,239.8,43,7,19,38.68935189503468,0.5971414728682171,46.188446969696976,1015.2462121212127,23.610377026074715,0
1898,4,2,3,49,0.038461538461538464,0.057692307692307696,0.9423076923076923,52,1350,900,450,0.6666666666666666,18,9,9,288.3831800730545,0.4444680115635998,0.20252245559532578,0.1602285083430291,129277.04480229606,-2941.7172507777086,126335.32755151835,1159,0,231.53846153846155,41,11,21,38.42704370305335,0.6044207317073171,45.75892857142858,1016.9642857142869,24.804006968641144,0
1899,4,0,0,49,0.0,0.0,1.0,49,1200,800,400,0.6666666666666666,16,8,8,305.45781483606345,0.44026360544217685,0.19899614110097308,0.16833905442227243,128955.22072742035,-1921.92401297998,127033.29671444037,1160,1,245.28571428571428,42,7,22,38.31926159129936,0.5997023809523809,46.07558139534884,1015.6976744186057,24.183277962347756,0
1900,4,0,0,49,0.0,0.0,1.0,49,1150,700,450,0.6086956521739131,16,7,9,310.135414648451,0.4396967120181406,0.20837419636046683,0.1715559192422443,129102.89345592198,-1792.124121146576,127310.7693347754,1161,2,246.28571428571428,42,7,22,38.050629290617856,0.6011904761904762,45.93023255813953,1016.2790697674407,24.19712070874859,0
1901,4,0,0,49,0.0,0.0,1.0,49,1550,1300,250,0.8387096774193549,18,13,5,308.1158382189152,0.44003330498866217,0.20150578415978648,0.17097889123677246,129227.86593966998,-1836.4568794341915,127391.40906023579,1162,3,247.28571428571428,39,10,22,37.97521172694054,0.6071047008547008,45.80729166666666,1016.770833333332,26.071047008546973,0
1902,4,0,0,49,0.0,0.0,1.0,49,1600,1000,600,0.625,22,10,12,306.6434057246763,0.43978528911564624,0.19498719004292275,0.17073429306198315,129360.29188368034,-1866.5039062500223,127493.78797743031,1163,4,248.28571428571428,39,10,22,37.878438801283345,0.608440170940171,45.67708333333332,1017.2916666666649,26.084401709401664,0
1903,4,0,0,49,0.0,0.0,1.0,49,2050,1500,550,0.7317073170731707,26,15,11,307.239646597393,0.4399270124716553,0.1902588511442913,0.17172501675889998,129511.53413973158,-1841.7844041245366,127669.74973560704,1164,5,249.28571428571428,40,9,15,37.71008053780618,0.6083333333333334,45.52845528455284,1017.8861788617882,25.447154471544703,0
1904,4,0,0,49,0.0,0.0,1.0,49,850,300,550,0.35294117647058826,14,3,11,303.9123350106174,0.43973214285714285,0.186382337366084,0.17031328841199025,129614.99851278996,-1921.6806299160642,127693.31788287389,1165,6,250.28571428571428,40,9,15,37.69003659347969,0.609375,45.42682926829268,1018.2926829268289,25.45731707317072,0
1905,4,1,0,50,0.02,0.0,1.0,50,1350,900,450,0.6666666666666666,18,9,9,296.943328705388,0.4410884353741497,0.18272479564032706,0.16765877174596508,129908.37191358006,-2284.915123456812,127623.45679012325,1166,0,246.26,41,9,16,37.57095821980017,0.6107723577235773,45.13888888888888,1019.444444444443,24.864498644986416,0
1906,4,0,1,49,0.0,0.02,0.98,50,1000,600,400,0.6,14,6,8,297.48943009806544,0.440969387755102,0.1821242637279119,0.16853464699742923,130040.11646685879,-2262.8879724776343,127777.22849438115,1167,1,247.26,42,8,17,37.4239977199316,0.6106150793650793,45.00968992248061,1019.9612403100762,24.284791435954194,0
1907,4,0,2,47,0.0,0.04081632653061224,0.9591836734693877,49,1600,1100,500,0.6875,21,11,10,307.88515072697646,0.4386515022675737,0.18551359736293582,0.17431367463159905,130015.40927716179,-1794.037223574305,128221.37205358749,1168,2,253.14285714285714,42,7,17,37.1838875692795,0.6103670634920635,45.03391472868217,1019.864341085271,24.28248431155407,0
1908,4,0,3,44,0.0,0.06382978723404255,0.9361702127659575,47,1600,1400,200,0.875,18,14,4,312.7176955328118,0.4365556583410422,0.11024694952279646,0.17415895298646977,129369.92550684427,-1209.3595732048766,128160.5659336394,1169,3,257.5744680851064,43,4,17,37.714189860063904,0.6024709302325582,45.66761363636365,1017.3295454545477,23.65882663847785,8
1909,4,1,2,43,0.022222222222222223,0.044444444444444446,0.9555555555555556,45,1450,1100,350,0.7586206896551724,18,11,7,328.0570524476992,0.4339436026936027,0.13192900331577895,0.1826219878283776,129352.72285997764,-512.9854024943011,128839.73745748334,1170,0,257.5777777777778,41,4,18,37.34152525843573,0.6051829268292683,45.684523809523824,1017.2619047619073,24.81126596980262,0
1910,4,2,3,42,0.044444444444444446,0.06666666666666667,0.9333333333333333,45,1400,1100,300,0.7857142857142857,17,11,6,324.99953526415123,0.4324915824915825,0.1535826434484726,0.18215573952485176,129620.41348364006,-574.6851714139561,129045.7283122261,1171,0,258.0,42,3,15,37.14772258698893,0.6063988095238095,45.42151162790699,1018.3139534883742,24.245570321151767,0
1911,4,0,0,42,0.0,0.0,1.0,42,950,500,450,0.5263157894736842,14,5,9,341.30610051061507,0.4300111304684475,0.1532006245120996,0.18926974664679586,129201.38888888911,419.44444444446395,129620.83333333358,1172,1,276.5952380952381,41,1,18,37.15846994535518,0.6036585365853658,45.83333333333334,1016.6666666666684,24.796747967479718,0
1912,4,1,0,43,0.023255813953488372,0.0,1.0,43,1250,900,350,0.72,16,9,7,338.4213865232237,0.4316168327796235,0.17001026060068591,0.18940253911674082,129563.26116233748,169.395697005778,129732.65685934326,1173,0,271.13953488372096,40,3,17,36.86406135622546,0.6088541666666667,45.47764227642278,1018.089430894311,25.452235772357774,0
1913,4,0,0,43,0.0,0.0,1.0,43,1550,1100,450,0.7096774193548387,20,11,9,337.9460607809435,0.43133997785160577,0.17548865744043396,0.18994899278377178,129731.44531250013,168.44618055557106,129899.89149305571,1174,1,272.13953488372096,41,2,17,36.70543626448535,0.6089939024390244,45.31250000000001,1018.750000000001,24.84756097560978,0
1914,4,0,0,43,0.0,0.0,1.0,43,1300,900,400,0.6923076923076923,17,9,8,341.3790287254342,0.43127076411960136,0.185602940244598,0.1927478516034375,129908.37191358031,269.5987654321071,130177.97067901242,1175,2,273.13953488372096,41,2,17,36.43846503178929,0.6107723577235773,45.13888888888889,1019.4444444444449,24.864498644986462,0
1915,4,0,0,43,0.0,0.0,1.0,43,900,500,400,0.5555555555555556,13,5,8,342.96127092488655,0.43127076411960136,0.18584292994754392,0.19426913643960092,130034.82187145685,319.38155470520815,130354.20342616206,1176,3,274.13953488372096,41,2,17,36.269878902830456,0.6120426829268293,45.01488095238095,1019.9404761904757,24.876596980255506,0
1916,4,1,0,44,0.022727272727272728,0.0,1.0,44,1250,900,350,0.72,16,9,7,333.25910857283174,0.43273211768851305,0.18173428475546283,0.19037565281069527,130363.8796375031,-110.81063791257489,130253.06899959051,1177,0,268.8863636363636,41,3,18,36.18410400880772,0.6153455284552846,44.692460317460316,1021.2301587301582,24.908052651955078,0
1917,4,0,0,44,0.0,0.0,1.0,44,1000,600,400,0.6,14,6,8,333.52813648788765,0.43202739605355883,0.18767872903795269,0.1912772720392675,130515.89269967253,-93.85550516502045,130422.03719450752,1178,1,269.8863636363636,41,3,13,36.02346278317154,0.6168699186991871,44.5436507936508,1021.8253968253973,24.922570654277983,0
1918,4,0,0,44,0.0,0.0,1.0,44,1100,700,400,0.6363636363636364,15,7,8,327.5723218464472,0.43230267794221283,0.18821168564495072,0.17924463004406715,128672.41753472215,-365.05643345301604,128307.36110126913,1179,2,270.8863636363636,41,3,14,38.04543121149898,0.5983231707317074,46.354166666666664,1014.5833333333327,24.74593495934958,8
1919,4,1,1,44,0.022222222222222223,0.022222222222222223,0.9777777777777777,45,1350,1000,350,0.7407407407407407,17,10,7,322.1301452741831,0.43440656565656566,0.19065967254808425,0.17785858731963172,129029.04652852881,-687.1708994351461,128341.87562909366,1180,0,265.84444444444443,42,3,15,37.82089492926402,0.6004464285714286,46.00290697674418,1015.9883720930222,24.190199335548147,0
1920,4,1,2,43,0.022222222222222223,0.044444444444444446,0.9555555555555556,45,1550,1100,450,0.7096774193548387,20,11,9,314.962212866676,0.4362373737373737,0.19960352279743843,0.17566978887294737,129428.42306193337,-846.8724720316533,128581.55058990172,1181,0,266.0888888888889,41,4,13,37.5977990640538,0.6059451219512195,45.61011904761906,1017.5595238095259,24.818524970964045,0
1921,4,1,1,43,0.022727272727272728,0.022727272727272728,0.9772727272727273,44,1250,700,550,0.56,18,7,11,322.63227724563933,0.4338002114164905,0.2016679526165297,0.18020983026297138,129485.67450137154,-444.74839298697765,129040.92610838456,1182,0,272.3636363636364,40,4,15,37.34460808786819,0.6080729166666667,45.55386178861789,1017.7845528455285,25.444613821138212,0
1922,4,0,0,43,0.0,0.0,1.0,43,1300,900,400,0.6923076923076923,17,9,8,328.1094655060247,0.43193983019564414,0.20485111042346094,0.1831788273139348,129466.2814670138,-104.17751736111586,129362.1039496527,1183,1,278.93023255813955,39,4,15,37.224923234391,0.6095085470085471,45.572916666666664,1017.7083333333326,26.09508547008545,0
1923,4,0,0,43,0.0,0.0,1.0,43,1050,800,250,0.7619047619047619,13,8,5,330.09724764447986,0.4319629014396456,0.20762436540974338,0.18441281913860574,129492.78564453125,-50.957573784722285,129441.82807074653,1184,2,279.93023255813955,39,4,15,37.14744737829631,0.609775641025641,45.546875,1017.8125,26.09775641025641,0
1924,4,0,0,43,0.0,0.0,1.0,43,850,500,350,0.5882352941176471,12,5,7,330.9377136548171,0.43203211517165,0.20486709774386114,0.185883969088481,129704.91672092004,-15.150282118059835,129689.76643880198,1185,3,280.93023255813955,39,4,16,36.91083358898322,0.6119123931623931,45.338541666666664,1018.6458333333325,26.11912393162391,0
1925,4,0,0,43,0.0,0.0,1.0,43,1350,900,450,0.6666666666666666,18,9,9,332.48853697765276,0.4317783314876338,0.20529680104785464,0.1872616785982946,129811.04736328126,32.137044270833485,129843.1844075521,1186,4,281.93023255813955,39,4,17,36.763710007155275,0.6129807692307692,45.234375,1019.0625000000001,26.129807692307697,0
1926,4,1,0,44,0.022727272727272728,0.0,1.0,44,1300,900,400,0.6923076923076923,17,9,8,331.89288738756005,0.4332276250880902,0.20690443633465838,0.18834780647166252,130107.01844346926,-163.6811958821079,129943.33724758716,1187,0,276.5,40,4,18,36.47898197031575,0.6143229166666666,44.9441056910569,1020.2235772357706,25.505589430894265,0
1927,4,1,2,43,0.022222222222222223,0.044444444444444446,0.9555555555555556,45,1150,900,250,0.782608695652174,14,9,5,306.2060028153683,0.43497474747474746,0.1905991877935771,0.1684374122573355,128881.41605259587,-1032.5286547879623,127848.8873978079,1188,0,271.3333333333333,42,3,18,38.375163024461614,0.5989583333333333,46.14825581395348,1015.406976744185,24.176356589147264,8
1928,4,0,1,42,0.0,0.023255813953488372,0.9767441860465116,43,1400,900,500,0.6428571428571429,19,9,10,313.5707055519008,0.43431616832779624,0.20128237450514086,0.17289447787538567,128974.55401431395,-511.47161989797036,128463.08239441598,1189,1,282.2093023255814,41,2,18,38.09362486570952,0.6013719512195121,46.05654761904761,1015.7738095238087,24.774970963995333,0
1929,4,3,1,44,0.06666666666666667,0.022222222222222223,0.9777777777777777,45,750,400,350,0.5333333333333333,11,4,7,305.8824368070549,0.436763468013468,0.21802257256258462,0.1716435488062879,129666.7461910898,-1066.8460450373552,128599.90014605245,1190,0,270.44444444444446,40,5,18,37.58751579857644,0.6098958333333333,45.376016260162594,1018.4959349593483,25.46239837398371,0
1930,4,0,0,44,0.0,0.0,1.0,44,1100,700,400,0.6363636363636364,15,7,8,312.9619230802804,0.43462605708245244,0.22481805477413408,0.17515377348705283,129563.26116233706,-690.3265252164886,128872.93463712058,1191,1,277.59090909090907,40,4,18,37.512061622412986,0.6088541666666667,45.477642276422756,1018.0894308943076,25.45223577235769,0
1931,4,1,1,44,0.022222222222222223,0.022222222222222223,0.9777777777777777,45,1250,800,450,0.64,17,8,9,347.36702439997794,0.4368055555555555,0.25256686940030115,0.18617557553803218,127843.36911848064,-104.46461451922414,127738.90450396141,1192,0,272.4,41,4,18,38.39022954679224,0.5899390243902439,47.172619047619044,1011.3095238095231,24.666085946573734,8
1932,4,0,1,43,0.0,0.022727272727272728,0.9772727272727273,44,1200,1000,200,0.8333333333333334,14,10,4,348.3052197417545,0.4357602184637068,0.2513967755482116,0.1874823447669401,128015.94309769313,117.72423821798841,128133.66733591112,1193,1,277.79545454545456,40,4,18,38.189981254602664,0.5932291666666667,47.0020325203252,1011.9918699186989,25.29979674796747,0
1933,4,2,2,43,0.044444444444444446,0.044444444444444446,0.9555555555555556,45,1050,700,350,0.6666666666666666,14,7,7,342.44761263986595,0.4369949494949495,0.26801684379386437,0.18623623165049205,128427.65239771307,-203.9868588472351,128223.66553886584,1194,0,272.5111111111111,40,5,16,37.917752824009106,0.5973958333333333,46.59552845528456,1013.6178861788624,25.34044715447156,0
1934,4,1,0,44,0.022727272727272728,0.0,1.0,44,1200,700,500,0.5833333333333334,17,7,10,345.69833413116936,0.4353528012684989,0.27883394337790324,0.1886613778644096,128566.7534722223,89.06250000000563,128655.8159722223,1195,0,279.29545454545456,39,5,17,37.69344015338263,0.6004273504273504,46.458333333333336,1014.1666666666674,26.004273504273524,0
1935,4,2,0,46,0.043478260869565216,0.0,1.0,46,1250,1000,250,0.8,15,10,5,343.44174758741485,0.43979468599033816,0.30285379186300476,0.19033530765660678,129176.76150959972,-327.06145589207836,128849.70005370764,1196,0,268.10869565217394,42,4,19,37.12924570266578,0.6019345238095238,45.85755813953488,1016.56976744186,24.204042081949048,0
1936,4,0,0,46,0.0,0.0,1.0,46,1150,800,350,0.6956521739130435,15,8,7,340.8443704148001,0.4394021739130434,0.30018242626938285,0.18975818397397914,129356.4150389978,-381.9141366535704,128974.50090234423,1197,1,269.10869565217394,40,6,19,37.01257076257074,0.6067708333333333,45.68089430894308,1017.2764227642265,25.43191056910566,0
1937,4,0,0,46,0.0,0.0,1.0,46,1150,700,450,0.6086956521739131,16,7,9,342.9713748216484,0.4392411433172303,0.30081293751845606,0.1911931739818676,129408.1110780619,-323.344446096909,129084.766631965,1198,2,270.10869565217394,40,6,20,36.905921227859906,0.6072916666666667,45.630081300813,1017.4796747967472,25.43699186991868,0
1938,4,0,0,46,0.0,0.0,1.0,46,1300,900,400,0.6923076923076923,17,9,8,346.4452556808378,0.43903985507246374,0.304324521298458,0.193726145424582,129529.39111118992,-225.0313956601052,129304.35971552982,1199,3,271.10869565217394,41,5,18,36.69425900659456,0.6069613821138211,45.5109126984127,1017.9563492063498,24.828203639179264,0
1939,4,0,1,45,0.0,0.021739130434782608,0.9782608695652174,46,1050,500,550,0.47619047619047616,16,5,11,320.13962484852146,0.43853663446054747,0.22232529375386512,0.17084678989440902,127670.36132812497,-880.4300959388403,126789.93123218614,1200,4,272.10869565217394,39,7,19,39.25522229093659,0.5913461538461539,47.34375,1010.6249999999998,25.913461538461533,8
1940,4,1,1,45,0.021739130434782608,0.021739130434782608,0.9782608695652174,46,2150,1800,350,0.8372093023255814,25,18,7,323.62952801910257,0.4370772946859904,0.2675791733762747,0.1747599451303157,128144.53125000026,-905.7291666666385,127238.80208333362,1201,0,273.0,39,7,20,38.68312757201648,0.5961538461538461,46.875000000000014,1012.500000000002,25.961538461538513,0
1941,4,2,0,47,0.0425531914893617,0.0,1.0,47,1050,800,250,0.7619047619047619,13,8,5,324.7968578417128,0.43927304964539005,0.3048809433176445,0.17839420480993984,128821.504720944,-1031.836008839192,127789.6687121048,1202,0,268.0,38,9,16,37.96415666877151,0.6047149122807017,46.20726495726497,1015.1709401709415,26.715024741340567,0
1942,4,1,1,47,0.020833333333333332,0.020833333333333332,0.9791666666666666,48,1350,1100,250,0.8148148148148148,16,11,5,318.5191852053481,0.44076906028368795,0.30561318298675544,0.17607080486013946,129075.34490937597,-1377.4052618732476,127697.93964750272,1203,0,263.3958333333333,41,7,18,37.86559520322823,0.6023882113821138,45.95734126984128,1016.1706349206363,24.78464963221064,0
1943,4,0,0,47,0.0,0.0,1.0,47,1800,1500,300,0.8333333333333334,21,15,6,323.0613257913801,0.4406799259944496,0.2993406411885895,0.17940543325684194,129257.13320444763,-1048.2193001758174,128208.91390427182,1204,1,264.02127659574467,37,10,18,37.56559557184961,0.6109234234234234,45.77850877192983,1016.8859649122816,27.483404457088692,0
1944,4,0,0,47,0.0,0.0,1.0,47,1350,900,450,0.6666666666666666,18,9,9,320.3115064116188,0.44064138143694115,0.29435602777306147,0.1786092966665258,129418.71667031935,-1109.1391810942948,128309.57748922506,1205,2,265.02127659574467,38,9,18,37.47156306873862,0.6107456140350878,45.619658119658126,1017.5213675213686,26.776878092667594,0
1945,4,0,0,47,0.0,0.0,1.0,47,1450,1100,350,0.7586206896551724,18,11,7,319.92563341378053,0.4405642923219242,0.2916465307437448,0.1790923906635905,129572.314453125,-1109.299045138891,128463.01540798611,1206,3,266.02127659574467,39,8,15,37.32564286201487,0.6105769230769231,45.46875,1018.125,26.10576923076923,0
1946,4,0,1,46,0.0,0.02127659574468085,0.9787234042553191,47,1050,700,350,0.6666666666666666,14,7,7,316.3845144910914,0.44048720320690715,0.2831395437403028,0.17746938601144008,129651.86767578125,-1196.0313585069446,128455.83631727431,1207,4,267.02127659574467,39,8,15,37.33517865057448,0.6113782051282051,45.390625,1018.4375,26.11378205128205,0
1947,4,0,1,45,0.0,0.021739130434782608,0.9782608695652174,46,1400,600,800,0.42857142857142855,22,6,16,367.58809997920645,0.4392210144927536,0.3035224593691419,0.19836694856734652,128118.16541883691,274.41406250000875,128392.57948133693,1208,5,273.5652173913044,39,7,18,37.59742514662002,0.5958867521367521,46.90104166666667,1012.3958333333343,25.958867521367544,8
1948,4,2,3,44,0.0425531914893617,0.06382978723404255,0.9361702127659575,47,1950,1600,350,0.8205128205128205,23,16,7,353.65791183695063,0.44195189639222937,0.3331586486392064,0.19403393541324582,128778.12499999996,-291.31673177083456,128486.80826822913,1209,0,268.59574468085106,39,8,15,37.275930487137394,0.6025641025641026,46.25,1014.9999999999997,26.02564102564102,0
1949,4,0,0,44,0.0,0.0,1.0,44,1600,1200,400,0.75,20,12,8,369.23038002437124,0.4397683227625088,0.3351222699271985,0.2020395450245714,128672.41753472203,701.9531249999795,129374.37065972202,1210,1,283.5681818181818,37,7,15,36.98879192334017,0.6050112612612613,46.35416666666666,1014.5833333333318,27.421171171171128,0
1950,4,0,0,44,0.0,0.0,1.0,44,1350,1000,350,0.7407407407407407,17,10,7,370.05240100858526,0.44010967230443976,0.3405752273218252,0.20319959243994534,128811.51532202198,733.4021044936646,129544.91742651565,1211,2,284.5681818181818,37,7,17,36.82580830993013,0.6064189189189189,46.21710526315788,1015.131578947367,27.435988620199108,0
1951,4,0,0,44,0.0,0.0,1.0,44,1300,1000,300,0.7692307692307693,16,10,6,369.6354152140932,0.44007663847780126,0.3434117162121051,0.20368428620631424,128950.68825263533,732.9482388811796,129683.6364915165,1212,3,285.5681818181818,37,7,17,36.694263017740816,0.6078265765765766,46.080043859649116,1015.6798245614027,27.4508060692271,0
1952,4,0,0,44,0.0,0.0,1.0,44,950,500,450,0.5263157894736842,14,5,9,370.3472352268418,0.43997753699788583,0.3424201540499441,0.2043637364131438,129006.37846500825,755.4311182286626,129761.80958323691,1213,4,286.5681818181818,37,7,17,36.619333513221804,0.6083896396396397,46.0252192982456,1015.8991228070158,27.456733048838267,0
1953,4,0,0,44,0.0,0.0,1.0,44,1200,800,400,0.6666666666666666,16,8,8,368.33086208440716,0.43970225510923183,0.33974763406940034,0.20341617296299147,129038.51290269563,705.7733399079575,129744.28624260359,1214,5,287.5681818181818,38,6,17,36.63774973711882,0.606907894736842,45.993589743589745,1016.0256410256413,26.737516869095824,0
1954,4,0,0,44,0.0,0.0,1.0,44,1350,900,450,0.6666666666666666,18,9,9,365.82907820478397,0.4393939393939394,0.3355067064083461,0.20286885245901626,129201.38888888867,653.2277284680888,129854.61661735676,1215,6,288.5681818181818,37,7,17,36.53517759562841,0.6103603603603603,45.83333333333332,1016.6666666666649,27.47747747747743,0
1955,4,0,0,44,0.0,0.0,1.0,44,1300,1000,300,0.7692307692307693,16,10,6,343.8524950908559,0.4382267441860465,0.26615111659659796,0.1797029558601213,126822.836766747,-34.9274508729693,126787.90931587403,1216,7,289.5681818181818,38,6,16,39.524996464432185,0.5844298245614035,48.18376068376068,1007.264957264957,26.506972559604133,8
1956,4,3,1,46,0.06382978723404255,0.02127659574468085,0.9787234042553191,47,1300,800,500,0.6153846153846154,18,8,10,327.0576405524499,0.4444765649090348,0.2800723126129885,0.1745887404881438,127681.91599122567,-1047.8454060828371,126634.07058514284,1217,0,272.02127659574467,40,7,15,39.06862745098039,0.58984375,47.33231707317074,1010.6707317073187,25.26676829268297,0
1957,4,0,0,46,0.0,0.0,1.0,46,1400,1000,400,0.7142857142857143,18,10,8,334.98576696238575,0.44202898550724634,0.29656224654857954,0.17888645552207103,127696.68104383686,-644.6858723958294,127051.99517144103,1218,1,278.9347826086956,39,7,16,38.853211206156175,0.5916132478632479,47.317708333333336,1010.7291666666671,25.916132478632488,0
1958,4,1,0,47,0.02127659574468085,0.0,1.0,47,1300,900,400,0.6923076923076923,17,9,8,328.09787304107135,0.4432624113475177,0.29807739545931233,0.17694547446465134,128093.08824319181,-994.586039229305,127098.5022039625,1219,0,273.97872340425533,40,7,18,38.62250276076697,0.5940104166666667,46.92581300813008,1012.2967479674792,25.30741869918698,0
1959,4,0,0,47,0.0,0.0,1.0,47,1300,1000,300,0.7692307692307693,16,10,6,334.81064195426796,0.442240980573543,0.30649314050751286,0.18114673494659267,128221.71512492573,-814.0010493092632,127407.71407561647,1220,1,274.97872340425533,40,7,19,38.32133420295672,0.5953125,46.79878048780488,1012.8048780487812,25.32012195121953,0
1960,4,0,0,47,0.0,0.0,1.0,47,1350,900,450,0.6666666666666666,18,9,9,334.87355030521167,0.44181699044094974,0.3094762043970063,0.18176506097404857,128350.40655570458,-803.7687347147555,127546.63782098982,1221,2,275.97872340425533,40,7,19,38.188454852405314,0.5966145833333334,46.67174796747969,1013.3130081300837,25.332825203252092,0
1961,4,2,0,49,0.04081632653061224,0.0,1.0,49,1150,700,450,0.6086956521739131,16,7,9,327.57334044093403,0.44472789115646255,0.32137601320573994,0.1807515211148819,129004.4355807946,-1348.3172210203566,127656.11835977423,1222,0,265.6734693877551,42,7,20,37.70765770062318,0.6001984126984127,46.027131782945744,1015.8914728682184,24.187892211148057,0
1962,4,1,0,50,0.02,0.0,1.0,50,2100,1800,300,0.8571428571428571,24,18,6,320.30309498352295,0.4460289115646259,0.3213647717054655,0.17820531838188317,129330.57089240855,-1714.5528793662625,127616.01801304228,1223,0,261.34,40,10,21,37.56119492456789,0.6065104166666666,45.70630081300813,1017.1747967479669,25.429369918699173,0
1963,4,1,0,51,0.0196078431372549,0.0,1.0,51,1650,1300,350,0.7878787878787878,20,13,7,321.8872453694991,0.44733660130718955,0.3387465415614097,0.1809228310180288,129731.44531250001,-1848.22048611111,127883.2248263889,1224,0,257.19607843137254,41,10,20,37.11443421949556,0.6089939024390244,45.3125,1018.7500000000001,24.84756097560976,0
1964,4,0,0,51,0.0,0.0,1.0,51,1850,1600,250,0.8648648648648649,21,16,5,322.7253449837497,0.4464705882352941,0.33183912981250896,0.18209790882526244,129883.08930342969,-1816.687039399097,128066.40226403059,1225,1,258.19607843137254,41,10,21,36.93947688564475,0.6105182926829269,45.163690476190474,1019.345238095238,24.862078977932633,0
1965,4,0,1,50,0.0,0.0196078431372549,0.9803921568627451,51,1600,1200,400,0.75,20,12,8,327.27369950211727,0.4463398692810458,0.3355132540322814,0.185382969949381,130034.82187145686,-1688.6045564059036,128346.21731505096,1226,2,259.19607843137254,41,10,22,36.669888629510744,0.6120426829268293,45.01488095238095,1019.9404761904758,24.876596980255506,0
1966,4,0,1,49,0.0,0.02,0.98,50,1150,600,550,0.5217391304347826,17,6,11,333.13732011616634,0.44534863945578235,0.33994941142134416,0.18846001725228786,129984.23450688136,-1339.480091805256,128644.75441507611,1227,3,264.88,41,9,22,36.57163067094722,0.6115345528455285,45.06448412698412,1019.7420634920627,24.87175764614787,0
1967,4,0,1,48,0.0,0.02040816326530612,0.9795918367346939,49,1550,1200,350,0.7741935483870968,19,12,7,340.7386658730298,0.4443027210884354,0.34176659306878787,0.19323925017138274,130081.0994199882,-935.2679456672486,129145.83147432095,1228,4,270.57142857142856,40,9,22,36.27963737796374,0.6140625,44.96951219512196,1020.1219512195129,25.503048780487823,0
1968,4,1,0,49,0.02040816326530612,0.0,1.0,49,1450,1100,350,0.7586206896551724,18,11,7,318.2458602353667,0.4447101757369614,0.22501879332906394,0.17807192026910204,129554.63927469132,-1510.1928048413351,128044.44646984998,1229,0,269.9591836734694,38,11,17,37.38631195998179,0.6121162280701755,45.48611111111111,1018.0555555555553,26.790935672514614,8
1969,4,1,1,49,0.02,0.02,0.98,50,1450,900,550,0.6206896551724138,20,9,11,347.56871639238983,0.4459608843537415,0.27949738640932886,0.1858932037995424,127758.96044021391,-1105.0110829275902,126653.94935728631,1230,0,265.54,40,10,17,38.4715101863021,0.590625,47.2560975609756,1010.9756097560955,25.27439024390239,8
1970,4,3,2,50,0.057692307692307696,0.038461538461538464,0.9615384615384616,52,1550,1100,450,0.7096774193548387,20,11,9,338.41585858135954,0.4496134992458522,0.3030161152343296,0.1848784173235114,128607.98306439638,-1694.241915361205,126913.74114903518,1231,0,256.11538461538464,40,12,16,37.83605517149251,0.59921875,46.41768292682928,1014.3292682926844,25.35823170731711,0
1971,4,0,0,50,0.0,0.0,1.0,50,950,500,450,0.5263157894736842,14,5,9,343.1839483624844,0.4461139455782313,0.32253758268189947,0.1871196413530533,128530.68300119003,-1178.0665443849298,127352.6164568051,1232,1,267.2,40,10,16,37.7939800895303,0.5984375,46.4939024390244,1014.0243902439046,25.350609756097615,0
1972,4,2,0,52,0.038461538461538464,0.0,1.0,52,1550,1200,350,0.7741935483870968,19,12,7,329.2078325070441,0.4494878079436903,0.31979238972676205,0.18158567774936069,128989.67013888898,-1907.1180555555463,127082.55208333343,1233,0,257.88461538461536,44,8,18,37.68115942028985,0.5973011363636364,46.04166666666667,1015.833333333334,23.08712121212123,0
1973,4,1,2,51,0.018867924528301886,0.03773584905660377,0.9622641509433962,53,1600,1100,500,0.6875,21,11,10,322.65883815370177,0.4519230769230769,0.31781839737701034,0.17904333688344837,129226.60506621636,-2260.084305713023,126966.52076050334,1234,0,254.0,41,12,19,37.606819364490846,0.6039126016260163,45.80853174603175,1016.7658730158735,24.7991676345335,0
1974,4,1,0,52,0.019230769230769232,0.0,1.0,52,1700,1300,400,0.7647058823529411,21,13,8,326.5092682926829,0.45302287581699346,0.32045403377110726,0.18129577464788754,129251.82370401875,-1959.6163233811887,127292.20738063757,1235,0,255.07692307692307,41,11,20,37.48333333333335,0.6041666666666667,45.783730158730165,1016.8650793650803,24.801587301587325,0
1975,4,1,1,52,0.018867924528301886,0.018867924528301886,0.9811320754716981,53,1650,1300,350,0.7878787878787878,20,13,7,322.12933465799995,0.45355587808417996,0.32386915414758644,0.18077423580300253,129669.75509472091,-2245.9136132143485,127423.84148150656,1236,0,251.24528301886792,42,11,15,37.17078140360891,0.6068948412698413,45.373062015503876,1018.5077519379848,24.25018456995202,0
1976,4,0,1,51,0.0,0.019230769230769232,0.9807692307692307,52,1400,700,700,0.5,21,7,14,326.82315476259197,0.4522294494720965,0.3226137658132986,0.18310659718794994,129605.14298311916,-1928.4076593600396,127676.73532375913,1237,1,257.0576923076923,41,11,15,37.11678358015069,0.6077235772357723,45.43650793650794,1018.2539682539682,24.835462640340687,0
1977,4,0,0,51,0.0,0.0,1.0,51,950,700,250,0.7368421052631579,12,7,5,335.4433089082411,0.4497875816993464,0.33009656795869735,0.18769461483186312,129554.63927469132,-1508.3526234567971,128046.28665123452,1238,2,263.03921568627453,41,10,16,36.94861300591175,0.6072154471544715,45.48611111111111,1018.0555555555553,24.830623306233058,0
1978,4,0,3,48,0.0,0.058823529411764705,0.9411764705882353,51,1550,1200,350,0.7741935483870968,19,12,7,335.2599577711433,0.4489705882352941,0.3287549878763585,0.18856077581104275,129756.71315980091,-1499.5539651045624,128257.15919469635,1239,3,264.03921568627453,41,10,17,36.748214865303474,0.6092479674796748,45.28769841269841,1018.8492063492059,24.84998064266356,0
1979,4,0,0,48,0.0,0.0,1.0,48,1650,1100,550,0.6666666666666666,22,11,11,352.6019585540954,0.44333628841607564,0.3266305831371348,0.196720076134492,129439.78000217004,-471.8560112847307,128967.9239908853,1240,4,281.125,39,9,17,36.62872777834648,0.6092414529914529,45.59895833333333,1017.6041666666658,26.09241452991451,0
1980,4,0,0,48,0.0,0.0,1.0,48,1600,1200,400,0.75,20,12,8,351.46657530736445,0.44283761820330975,0.32503879736689534,0.19661607558551053,129545.80213758661,-493.7961154514072,129052.0060221352,1241,5,282.125,39,9,17,36.54978426958627,0.610309829059829,45.49479166666666,1018.0208333333318,26.10309829059825,0
1981,4,1,2,47,0.02040816326530612,0.04081632653061224,0.9591836734693877,49,1600,1100,500,0.6875,21,11,10,350.0709522244435,0.44361181972789115,0.3329198558658222,0.19826817587610113,130029.2691189106,-696.105988498918,129333.16313041167,1242,0,277.3469387755102,40,9,19,36.0942274478544,0.6135416666666667,45.02032520325203,1019.918699186991,25.497967479674777,0
1982,4,0,0,47,0.0,0.0,1.0,47,1850,1200,650,0.6486486486486487,25,12,13,354.9552917844535,0.4428576934936787,0.3160858727057654,0.20167626364267194,130153.54624379064,-160.2620032507854,129993.28424053986,1243,1,273.0851063829787,38,9,19,35.8435416884794,0.6181469298245614,44.89850427350427,1020.4059829059829,26.852789023841655,0
1983,4,0,0,47,0.0,0.0,1.0,47,1800,1200,600,0.6666666666666666,24,12,12,357.12131103907285,0.44245297563983965,0.3130699088145896,0.20447868120692309,130453.51765103362,-82.4537493608072,130371.06390167281,1244,2,274.0851063829787,38,9,20,35.483990448302315,0.6211622807017544,44.60470085470085,1021.5811965811962,26.883715699505164,0
1984,4,0,1,46,0.0,0.02127659574468085,0.9787234042553191,47,1000,700,300,0.7,13,7,6,357.3861530105822,0.4425107924761024,0.3139004274008206,0.20477434279449955,130480.80490037623,-73.5934189860426,130407.21148139019,1245,3,275.0851063829787,38,9,20,35.449562550106315,0.6214364035087719,44.577991452991455,1021.6880341880343,26.886527215474587,0
1985,4,0,2,44,0.0,0.043478260869565216,0.9565217391304348,46,1450,1000,450,0.6896551724137931,19,10,9,316.4067460111388,0.44231078904991944,0.1486222777300754,0.1780187449779842,129770.27253123143,-987.9620678828758,128782.31046334855,1246,4,279.9782608695652,40,6,16,37.21470011303941,0.6109375,45.27439024390244,1018.9024390243904,25.47256097560976,8
1986,4,0,0,44,0.0,0.0,1.0,44,1500,1100,400,0.7333333333333333,19,11,8,331.8356529261966,0.44140900281888656,0.15384120233066012,0.1861912465771295,129663.42872242302,-194.61029384908585,129468.81842857394,1247,11,286.97727272727275,38,6,18,36.930050001748306,0.6132127192982456,45.3792735042735,1018.4829059829052,26.802181736392242,0
1987,4,0,1,43,0.0,0.022727272727272728,0.9772727272727273,44,1150,900,250,0.782608695652174,14,9,5,350.4129391288018,0.441442036645525,0.18969060814034533,0.18273112636253527,126733.6117720934,262.6444099210541,126996.25618201445,1248,12,287.97727272727275,40,4,18,39.45149542457271,0.5802083333333333,48.27235772357724,1006.9105691056916,25.17276422764229,8
1988,4,3,2,44,0.06521739130434782,0.043478260869565216,0.9565217391304348,46,1400,1000,400,0.7142857142857143,18,10,8,338.9415899055607,0.44847020933977455,0.19852502879577583,0.18076263681549468,127644.04432508693,-545.7067413602297,127098.3375837267,1249,0,269.0,39,7,18,38.80710321959935,0.5910790598290598,47.36979166666667,1010.5208333333344,25.910790598290625,0
1989,4,0,0,44,0.0,0.0,1.0,44,1050,700,350,0.6666666666666666,14,7,7,349.8837536603237,0.44521890415785764,0.21333626195717614,0.18571063328287718,127451.5971861534,118.6486466989773,127570.24583285238,1250,1,281.9318181818182,37,7,19,38.727852282187705,0.5926238738738738,47.560307017543856,1009.7587719298243,27.29077761972498,0
1990,4,0,0,44,0.0,0.0,1.0,44,1700,1200,500,0.7058823529411765,22,12,10,319.001841285485,0.4443380021141649,0.12150473389098293,0.1644905219141527,126273.55265549615,-741.8222566142294,125531.73039888192,1251,2,282.9318181818182,40,4,15,40.71410515672395,0.5755208333333333,48.72967479674797,1005.0813008130089,25.127032520325223,7
1991,4,0,1,43,0.0,0.022727272727272728,0.9772727272727273,44,950,800,150,0.8421052631578947,11,8,3,320.50287872467845,0.4447784531360113,0.12741701282946738,0.16547048415159304,126324.62902372943,-702.5185488135207,125622.11047491591,1252,3,283.9318181818182,40,4,15,40.623946960506814,0.5760416666666667,48.678861788617894,1005.2845528455298,25.132113821138244,0
1992,4,3,0,46,0.06521739130434782,0.0,1.0,46,950,500,450,0.5263157894736842,14,5,9,311.3866186438336,0.45131843800322063,0.15623210695911238,0.16352120109802115,127018.74441327137,-1289.6125345532214,125729.13187871815,1253,0,270.95652173913044,42,4,19,40.14206639110512,0.580109126984127,47.98934108527131,1008.0426356589143,24.001015134736054,0
1993,4,1,0,47,0.02127659574468085,0.0,1.0,47,1100,600,500,0.5454545454545454,16,6,10,305.8924060233972,0.45422833795868023,0.1590850143489433,0.16172232609511417,127292.1587616528,-1612.4168051281977,125679.7419565246,1254,0,266.17021276595744,41,6,20,40.00114693931053,0.584349593495935,47.71825396825397,1009.1269841269841,24.612853271389856,0
1994,4,1,0,48,0.020833333333333332,0.0,1.0,48,1300,800,500,0.6153846153846154,18,8,10,301.5664475613755,0.4560062056737589,0.16322342126298972,0.1604813790621408,127556.54450040552,-1906.645202361647,125649.89929804388,1255,0,261.6041666666667,42,6,14,39.84052757793766,0.5855654761904762,47.456395348837205,1010.1744186046503,24.051771871539295,0
1995,4,1,1,48,0.02040816326530612,0.02040816326530612,0.9795918367346939,49,1050,900,150,0.8571428571428571,12,9,3,301.44159523273356,0.45758928571428575,0.18379489095409252,0.1618304387183105,127910.26341735275,-2088.5052297667894,125821.75818758596,1256,0,257.2448979591837,44,5,16,39.48321891685734,0.5864109848484849,47.10648148148149,1011.5740740740758,22.990319865319904,0
1996,4,1,0,49,0.02040816326530612,0.0,1.0,49,1850,1500,350,0.8108108108108109,22,15,7,312.0835978482409,0.45615433673469385,0.2495772875624238,0.1616480911010349,126457.71362898858,-1878.5785862543185,124579.13504273427,1257,0,258.16326530612247,42,7,16,40.699060693641606,0.5744047619047619,48.54651162790697,1005.8139534883716,23.947951273532656,8
1997,4,8,2,55,0.14035087719298245,0.03508771929824561,0.9649122807017544,57,1300,700,600,0.5384615384615384,19,7,12,287.9290863617114,0.46211883876357557,0.3030682107957525,0.1558464263092904,128238.29839677634,-3977.0049116380064,124261.29348513833,1258,0,222.78947368421052,44,13,16,39.491536398817686,0.5897253787878788,46.782407407407405,1012.8703703703698,23.01978114478113,0
1998,4,0,0,55,0.0,0.0,1.0,55,1850,1400,450,0.7567567567567568,23,14,9,297.0986927954943,0.45996071829405166,0.29743018703784196,0.16053161011959238,128169.06003996158,-3384.227961060036,124784.83207890154,1259,1,231.83636363636364,42,13,17,39.32974481658692,0.591765873015873,46.85077519379845,1012.5968992248065,24.109449981543012,0
1999,4,2,1,56,0.03508771929824561,0.017543859649122806,0.9824561403508771,57,1150,300,850,0.2608695652173913,20,3,17,292.0544070136966,0.461296470342523,0.30423127918372095,0.15966806802605096,128637.19135802475,-3886.188271604932,124751.00308641982,1260,0,224.66666666666666,44,13,13,38.98206462212488,0.59375,46.38888888888889,1014.4444444444449,23.055555555555568,0
2000,4,0,6,50,0.0,0.10714285714285714,0.8928571428571429,56,1500,800,700,0.5333333333333333,22,8,14,294.4254175068884,0.45990936147186146,0.2997274315970677,0.1607744777353168,128590.23062414268,-3627.9535322359393,124962.27709190674,1261,1,229.67857142857142,44,12,13,38.969592538494275,0.5932765151515151,46.43518518518518,1014.2592592592595,23.051346801346806,0
2001,4,3,2,51,0.05660377358490566,0.03773584905660377,0.9622641509433962,53,1250,900,350,0.72,16,9,7,316.30281403862136,0.45745645863570394,0.31184060601919494,0.17198860303526303,128420.9077873047,-2476.0210970962494,125944.88669020846,1262,0,243.0188679245283,41,12,15,38.58713826628821,0.5957825203252032,46.60218253968254,1013.5912698412695,24.72173828881145,0
2002,4,3,3,51,0.05555555555555555,0.05555555555555555,0.9444444444444444,54,1100,500,600,0.45454545454545453,17,5,12,319.62944910623344,0.4572851153039832,0.3312148614600665,0.17603974020401664,128930.61682178068,-2557.9955944654653,126372.62122731522,1263,0,239.22222222222223,42,12,16,37.984408294373964,0.5994543650793651,46.09980620155039,1015.6007751937996,24.18097083794761,0
2003,4,0,1,50,0.0,0.0196078431372549,0.9803921568627451,51,1450,1000,450,0.6896551724137931,19,10,9,328.76963983665985,0.45307189542483656,0.3053532700059487,0.16956078509360092,126281.67775051658,-1896.199626440721,124385.47812407586,1264,1,253.4313725490196,43,8,16,40.46031970353624,0.5712209302325582,48.721590909090914,1005.1136363636367,23.3747357293869,7
2004,4,0,0,50,0.0,0.0,1.0,50,1300,600,700,0.46153846153846156,20,6,14,328.16595202882667,0.45355442176870747,0.29826741996233497,0.16984027341842786,126424.48992768594,-1702.3573806244292,124722.13254706151,1265,2,256.28,43,7,17,40.3287821720025,0.5726744186046512,48.57954545454545,1005.681818181818,23.38794926004228,0
2005,4,2,1,51,0.038461538461538464,0.019230769230769232,0.9807692307692307,52,1800,1100,700,0.6111111111111112,25,11,14,317.2426107814672,0.4558195072900955,0.30673638720829777,0.16624230075100416,126932.22869571763,-2346.3376752520653,124585.89102046555,1266,0,247.3846153846154,45,7,19,40.083052434456945,0.5752314814814814,48.07518115942028,1007.6992753623173,22.393317230273716,0
2006,4,1,1,51,0.019230769230769232,0.019230769230769232,0.9807692307692307,52,1750,1200,550,0.6857142857142857,23,12,11,315.44384171503384,0.4558902086475616,0.3101296464657666,0.16605078708792895,127116.44174215783,-2380.07873220874,124736.36300994908,1267,0,248.25,42,10,20,39.939864193972014,0.5811011904761905,47.89244186046511,1008.4302325581388,24.010243632336635,0
2007,4,2,1,52,0.03773584905660377,0.018867924528301886,0.9811320754716981,53,1500,1200,300,0.8,18,12,6,314.3625688293285,0.4581519109820997,0.32160551586536523,0.16724715818964822,127545.9775758292,-2580.8637690828873,124965.1138067463,1268,0,243.43396226415095,43,10,16,39.5281592762726,0.5840600775193798,47.466856060606055,1010.1325757575748,23.49145525017616,0
2008,4,2,2,52,0.037037037037037035,0.037037037037037035,0.962962962962963,54,1350,1000,350,0.7407407407407407,17,10,7,311.6212579004975,0.4572996738877242,0.32195101279769545,0.1672954418949841,127910.2634173522,-2828.088563100164,125082.17485425204,1269,0,239.88888888888889,44,10,19,39.225781845919144,0.5864109848484849,47.10648148148147,1011.5740740740713,22.9903198653198,0
2009,4,2,0,54,0.037037037037037035,0.0,1.0,54,1950,1300,650,0.6666666666666666,26,13,13,313.48527598692044,0.45665181691125084,0.3265064181178967,0.16960880892973135,128221.71512492574,-2760.018710488962,125461.69641443678,1270,0,240.74074074074073,40,14,21,38.861295069904344,0.5953125,46.79878048780488,1012.8048780487813,25.320121951219534,0
2010,4,1,1,54,0.01818181818181818,0.01818181818181818,0.9818181818181818,55,1750,1100,650,0.6285714285714286,24,11,13,310.10050259918546,0.4572250280583614,0.344456116894279,0.16973666297522605,128684.70687045566,-3018.9615445285594,125665.7453259271,1271,0,237.34545454545454,42,13,18,38.47610861745138,0.5969742063492063,46.3420542635659,1014.6317829457377,24.157899593946134,0
2011,4,0,2,52,0.0,0.037037037037037035,0.962962962962963,54,1350,900,450,0.6666666666666666,18,9,9,311.93720339849136,0.45691387141858836,0.33244594346159806,0.1712711814886058,128807.63250405638,-2764.0214680607965,126043.6110359956,1272,1,240.59259259259258,42,12,19,38.30461690212549,0.5982142857142857,46.220930232558146,1015.1162790697686,24.16943521594687,0
2012,4,0,0,52,0.0,0.0,1.0,52,1150,800,350,0.6956521739130435,15,8,7,332.17407483282994,0.4555288461538462,0.3471996456222797,0.18193955771836579,128711.08596280332,-1849.1028199153843,126861.98314288794,1273,2,250.42307692307693,40,12,19,37.889334001001494,0.6002604166666667,46.31605691056911,1014.7357723577243,25.368394308943106,0
2013,4,0,0,52,0.0,0.0,1.0,52,1100,600,500,0.5454545454545454,16,6,10,333.4637071193446,0.4548375439919558,0.3450752393980854,0.18327967661973,128848.62075617285,-1806.732253086416,127041.88850308643,1274,3,251.42307692307693,41,11,20,37.71659826721387,0.6001016260162602,46.18055555555556,1015.2777777777778,24.76287262872629,0
2014,4,0,2,50,0.0,0.038461538461538464,0.9615384615384616,52,1800,1500,300,0.8333333333333334,21,15,6,337.5913218702014,0.4546018728004022,0.34845417740154705,0.18637588826268073,129024.94454089484,-1688.4596836419917,127336.48485725284,1275,4,252.42307692307693,41,11,21,37.432359307359306,0.6018800813008129,46.006944444444436,1015.9722222222204,24.779810298102934,0
2015,4,0,1,49,0.0,0.02,0.98,50,1300,800,500,0.6153846153846154,18,8,10,328.21370864131745,0.454328231292517,0.24697062002554793,0.1740610168234853,127417.32927256536,-1635.8565995842937,125781.47267298106,1276,5,262.92,41,9,15,39.309943172513194,0.5856199186991871,47.594246031746025,1009.6230158730147,24.624951606658893,8
2016,4,2,1,50,0.0392156862745098,0.0196078431372549,0.9803921568627451,51,1350,1100,250,0.8148148148148148,16,11,5,331.2144169241847,0.45441176470588235,0.276146919893963,0.17830945208021584,128021.92251066642,-1719.4587164232883,126302.46379424313,1277,0,258.29411764705884,42,9,17,38.6162709051449,0.5902777777777778,46.99612403100775,1012.015503875969,24.09560723514212,0
2017,4,1,1,50,0.0196078431372549,0.0196078431372549,0.9803921568627451,51,1350,700,650,0.5185185185185185,20,7,13,325.26622478524854,0.4555065359477124,0.2876485733223977,0.17632294697575535,128298.92223750736,-1853.6214157108693,126445.3008217965,1278,0,259.11764705882354,40,11,19,38.48430133413582,0.59609375,46.72256097560975,1013.1097560975603,25.327743902439007,0
2018,4,0,1,49,0.0,0.02,0.98,50,1500,1000,500,0.6666666666666666,20,10,10,328.64916651389615,0.4541156462585034,0.2975764871100417,0.17815679940059986,128298.92223750746,-1566.9332284023988,126731.98900910506,1279,1,265.14,40,10,19,38.39861905239577,0.59609375,46.72256097560976,1013.1097560975611,25.32774390243903,0
2019,4,0,1,48,0.0,0.02040816326530612,0.9795918367346939,49,1550,1100,450,0.7096774193548387,20,11,9,327.29312177614406,0.4544359410430839,0.2844418440993075,0.1782246824693675,128479.16253552784,-1389.9307621124938,127089.23177341535,1235,2,245.44897959183675,40,9,16,38.2492983159583,0.5979166666666667,46.54471544715447,1013.8211382113825,25.345528455284562,0
2020,4,0,1,47,0.0,0.020833333333333332,0.9791666666666666,48,1450,1000,450,0.6896551724137931,19,10,9,337.1467162674967,0.4538822399527187,0.24256583821647526,0.17471613600082078,126477.92009551174,-1028.1424540617568,125449.77764144998,1236,3,250.39583333333334,40,8,18,40.048073684919515,0.5776041666666667,48.52642276422763,1005.8943089430878,25.147357723577194,8
2021,4,0,1,46,0.0,0.02127659574468085,0.9787234042553191,47,1350,1200,150,0.8888888888888888,15,12,3,346.5228895058249,0.4523781991982732,0.2543893857173387,0.17962273451195643,126488.78173828115,-633.748372395848,125855.0333658853,1237,5,256.6595744680851,39,8,18,39.80111577094333,0.5793269230769231,48.51562499999999,1005.9374999999992,25.79326923076921,0
2022,4,2,0,48,0.041666666666666664,0.0,1.0,48,1200,900,300,0.75,15,9,6,345.5595279309791,0.45248781028368795,0.3038046325400394,0.1761009310531557,125789.53108513921,-782.6502309953465,125006.88085414386,1238,0,251.85416666666666,36,12,19,40.545483460559794,0.5775462962962963,49.211711711711715,1003.1531531531533,27.86536536536537,8
2023,4,2,1,49,0.04,0.02,0.98,50,2000,1400,600,0.7,26,14,12,328.3844101495757,0.45562074829931976,0.2977225130890051,0.16951735767180784,126319.2520775622,-1703.4885807843252,124615.76349677787,1239,0,242.74,37,13,14,40.431391797556714,0.5810810810810811,48.68421052631578,1005.2631578947357,27.16927453769556,0
2024,4,1,0,50,0.02,0.0,1.0,50,1250,900,350,0.72,16,9,7,333.5623844560432,0.4540561224489796,0.30487847411444124,0.1730036674609493,126512.22160905265,-1560.0563394506185,124952.16526960203,1240,0,243.72,37,13,18,40.10297456857401,0.5830518018018018,48.4923245614035,1006.0307017543848,27.190018966334726,0
2025,4,0,0,50,0.0,0.0,1.0,50,1950,1300,650,0.6666666666666666,26,13,13,332.567246215843,0.45416666666666666,0.30208278867102356,0.17307070976538735,126650.14716066465,-1576.0618651893133,125074.08529547534,1241,1,244.72,37,13,18,39.98638344226577,0.5844594594594594,48.355263157894726,1006.5789473684197,27.204836415362696,0
2026,4,4,3,51,0.07407407407407407,0.05555555555555555,0.9444444444444444,54,2250,1400,850,0.6222222222222222,31,14,17,310.401122715913,0.45887928022361985,0.31333258849598766,0.16569721768168294,127681.91599122537,-2872.708517632486,124809.20747359288,1242,0,227.5185185185185,40,14,14,39.48948382771912,0.58984375,47.33231707317073,1010.6707317073162,25.266768292682904,0
2027,4,0,0,51,0.0,0.0,1.0,51,1150,700,450,0.6086956521739131,16,7,9,331.9839333408164,0.45511437908496727,0.3221973741312687,0.17523333049398154,127226.7094587808,-1752.555313572939,125474.15414520785,1243,1,241.90196078431373,38,13,20,39.40992445903491,0.5885416666666667,47.78311965811966,1008.8675213675216,26.549145299145305,0
2028,4,1,0,52,0.019230769230769232,0.0,1.0,52,1800,1500,300,0.8333333333333334,21,15,6,328.6386173567019,0.4561258798391152,0.32165850022992903,0.17538239084679452,127670.36132812512,-2008.5177951388755,125661.84353298624,1244,0,238.23076923076923,39,13,16,39.04048993334709,0.5913461538461539,47.34375000000001,1010.6250000000009,25.91346153846156,0
2029,4,3,2,53,0.05454545454545454,0.03636363636363636,0.9636363636363636,55,1600,1100,500,0.6875,21,11,10,317.1722201918867,0.45925925925925926,0.3476334487156134,0.1731607635402097,128582.21379469907,-2841.700942209479,125740.51285248958,1245,0,226.1818181818182,40,15,17,38.40096860387443,0.5989583333333333,46.44308943089432,1014.2276422764239,25.355691056910597,0
2030,4,1,1,53,0.018518518518518517,0.018518518518518517,0.9814814814814815,54,1850,1100,750,0.5945945945945946,26,11,15,315.697433061814,0.4576781970649895,0.3374065330854814,0.173091732713633,128751.69406467037,-2670.684136284695,126081.00992838568,1246,0,229.72222222222223,39,15,18,38.26604143145507,0.6022970085470085,46.27604166666668,1014.8958333333353,26.022970085470135,0
2031,4,1,0,54,0.018518518518518517,0.0,1.0,54,1350,1000,350,0.7407407407407407,17,10,7,320.8820184455242,0.4574670976007454,0.3460772804808083,0.1766391190189396,128910.32036675373,-2526.999240451364,126383.32112630237,1247,0,230.44444444444446,39,15,19,37.97323229732962,0.6038995726495726,46.11979166666668,1015.5208333333354,26.03899572649578,0
2032,4,0,0,54,0.0,0.0,1.0,54,1800,1300,500,0.7222222222222222,23,13,10,321.2092591498804,0.45777282785930584,0.34838787826193873,0.17755782198986664,129075.34490937596,-2507.9608174288014,126567.38409194715,1248,1,231.44444444444446,41,13,19,37.79725584952325,0.6023882113821138,45.95734126984128,1016.1706349206362,24.784649632210638,0
2033,4,1,1,54,0.01818181818181818,0.01818181818181818,0.9818181818181818,55,1800,1300,500,0.7222222222222222,23,13,10,310.31126715442394,0.45871212121212124,0.3435328308055583,0.17275949856595035,129356.4150389982,-2971.7263631924275,126384.68867580577,1249,0,228.21818181818182,40,15,20,37.789085914085945,0.6067708333333333,45.6808943089431,1017.2764227642296,25.43191056910574,0
2034,4,2,2,54,0.03571428571428571,0.03571428571428571,0.9642857142857143,56,1350,1000,350,0.7407407407407407,17,10,7,302.30765352182175,0.46095779220779226,0.3403554109672775,0.17029296154734888,129817.8362647229,-3351.0149067062994,126466.82135801659,1250,0,213.0,42,14,16,37.52575195714876,0.6083829365079365,45.227713178294586,1019.0891472868235,24.26402731635294,0
2035,4,1,2,53,0.01818181818181818,0.03636363636363636,0.9636363636363636,55,850,400,450,0.47058823529411764,13,4,9,301.9883895088149,0.4607323232323232,0.3403858948769134,0.1705432016115,129916.6039920228,-3153.3387979989075,126763.2651940239,1251,0,216.5090909090909,42,13,17,37.43406045052753,0.609375,45.13081395348838,1019.4767441860472,24.273255813953504,0
2036,4,0,1,52,0.0,0.018867924528301886,0.9811320754716981,53,1600,1100,500,0.6875,21,11,10,307.8379031403343,0.4600266086115143,0.33089911773452685,0.17403509177537715,129958.94451530617,-2598.7422052154184,127360.20231009075,1252,1,212.60377358490567,41,12,17,37.242167736913785,0.6112804878048781,45.089285714285715,1019.6428571428576,24.869337979094087,0
2037,4,0,1,51,0.0,0.019230769230769232,0.9807692307692307,52,1850,1200,650,0.6486486486486487,25,12,13,309.67766355281697,0.45887537707390647,0.32757407961688134,0.1753021135089734,130009.52695893166,-2347.79069035022,127661.73626858144,1253,2,217.59615384615384,41,11,18,37.144130998703,0.6117886178861789,45.03968253968254,1019.8412698412693,24.87417731320169,0
2038,4,1,1,51,0.019230769230769232,0.019230769230769232,0.9807692307692307,52,1400,1000,400,0.7142857142857143,18,10,8,318.13710696437505,0.45830976621417796,0.34831588529813406,0.1815122190026078,130315.76063368046,-2107.852089041647,128207.90854463882,1254,0,218.44230769230768,39,13,20,36.618802285247924,0.6180555555555556,44.73958333333333,1021.0416666666658,26.180555555555536,0
2039,4,0,2,49,0.0,0.0392156862745098,0.9607843137254902,51,1850,1400,450,0.7567567567567568,23,14,9,321.9832241783133,0.45790849673202616,0.34137626177157854,0.18397116795699292,130371.67302441719,-1804.5016756154812,128567.17134880171,1255,1,223.1764705882353,38,13,21,36.46410886773373,0.6203399122807017,44.68482905982905,1021.2606837606819,26.87528115159689,0
2040,4,1,0,50,0.02,0.0,1.0,50,1150,600,550,0.5217391304347826,17,6,11,320.3945473064773,0.45923469387755106,0.33396486825596017,0.1837082404340015,130508.09500328716,-1637.183596318226,128870.91140696894,1256,0,222.8,38,12,14,36.3668444165621,0.6217105263157895,44.551282051282044,1021.7948717948706,26.889338731443964,0
2041,4,0,0,50,0.0,0.0,1.0,50,1550,1200,350,0.7741935483870968,19,12,7,321.13270364054256,0.4587244897959184,0.3359234869865164,0.18452111565940343,130589.9824334318,-1612.6571745562267,128977.32525887557,1257,1,223.8,38,12,15,36.26528692380057,0.622532894736842,44.47115384615384,1022.1153846153834,26.897773279352194,0
2042,4,0,0,50,0.0,0.0,1.0,50,1650,1400,250,0.8484848484848485,19,14,5,326.819616643369,0.45796768707482993,0.34024439918533633,0.18878639031987535,130794.81336805546,-1450.7378472222335,129344.07552083323,1258,2,224.8,39,11,18,35.91310251188051,0.6228632478632479,44.27083333333333,1022.9166666666658,26.228632478632456,0
2043,4,0,0,50,0.0,0.0,1.0,50,1100,700,400,0.6363636363636364,15,7,8,325.3084913367778,0.4579591836734694,0.3384690553745924,0.18843340913281298,130901.38888888902,-1483.3333333333235,129418.0555555557,1259,3,225.8,39,11,19,35.84419109663407,0.6239316239316239,44.16666666666667,1023.3333333333344,26.239316239316267,0
2044,4,0,3,47,0.0,0.06,0.94,50,1850,1400,450,0.7567567567567568,23,14,9,320.6390634685895,0.4573809523809524,0.3288097660223801,0.18650189312995488,131061.33355034744,-1595.3233506944189,129466.01019965301,1260,4,226.8,39,11,19,35.802390640895226,0.625534188034188,44.01041666666668,1023.9583333333351,26.255341880341923,0
2045,4,0,1,46,0.0,0.02127659574468085,0.9787234042553191,47,1300,800,500,0.6153846153846154,18,8,10,340.0084210526319,0.45486432315757014,0.2893751399776039,0.18649422632794443,128767.28121119122,-643.3367390674337,128123.94447212378,1261,5,240.87234042553192,38,9,19,37.63333333333331,0.6041666666666667,46.26068376068375,1014.957264957263,26.709401709401657,8
2046,4,1,1,46,0.02127659574468085,0.02127659574468085,0.9787234042553191,47,1650,1100,550,0.6666666666666666,22,11,11,336.90381228464014,0.45418979340117177,0.28778005531735906,0.1858051883528047,128984.24373584613,-708.943312148459,128275.30042369767,1262,0,239.95744680851064,38,9,20,37.4912354508484,0.606359649122807,46.04700854700854,1015.8119658119645,26.73189383715696,0
2047,4,0,1,45,0.0,0.021739130434782608,0.9782608695652174,46,950,600,350,0.631578947368421,13,6,7,340.51971404505315,0.4544182769726248,0.2948056580734564,0.18767077805369944,128957.11343277435,-417.51212195925245,128539.6013108151,1263,1,245.69565217391303,38,8,20,37.42702745345535,0.6060855263157895,46.07371794871794,1015.7051282051272,26.72908232118756,0
2048,4,1,0,46,0.021739130434782608,0.0,1.0,46,1150,700,450,0.6086956521739131,16,7,9,339.9623757054553,0.4544585346215781,0.30506058446186723,0.18852459016393458,129201.38888888905,-414.8154996712511,128786.5733892178,1264,0,246.1304347826087,36,10,21,37.192622950819676,0.6122685185185186,45.83333333333334,1016.666666666668,28.240740740740776,0
2049,4,0,0,46,0.0,0.0,1.0,46,1400,1100,300,0.7857142857142857,17,11,6,337.52824294802804,0.45336151368760064,0.3040683901025254,0.1881554079743889,129407.39300679431,-464.27000278636433,128943.12300400795,1265,1,247.1304347826087,35,11,21,37.04510768589087,0.6163690476190475,45.63078703703703,1017.476851851851,29.07076719576717,0
2050,4,0,1,45,0.0,0.021739130434782608,0.9782608695652174,46,1200,700,500,0.5833333333333334,17,7,10,335.16420546197725,0.4533514492753623,0.3012902587932871,0.18739791398843542,129525.18332315245,-517.5589688357311,129007.62435431672,1266,2,248.1304347826087,35,11,17,36.9856215652833,0.6175595238095238,45.5150462962963,1017.939814814815,29.083994708994716,0
2051,4,1,0,46,0.021739130434782608,0.0,1.0,46,1100,900,200,0.8181818181818182,13,9,4,325.3442190261405,0.4537238325281803,0.2930457227828329,0.1837819288277676,129927.00277970143,-745.8001500461689,129181.20262965526,1267,0,245.19565217391303,37,9,18,36.82826055782607,0.6176801801801801,45.12061403508772,1019.5175438596491,27.554528212422948,0
2052,4,0,0,46,0.0,0.0,1.0,46,1050,500,550,0.47619047619047616,16,5,11,324.3002258540241,0.45355273752012887,0.2955346650998827,0.18361624887322137,130017.30974687697,-767.071416831041,129250.23833004593,1268,1,246.19565217391303,38,8,18,36.763434946574485,0.6167763157894737,45.03205128205128,1019.8717948717941,26.838731443994583,0
2053,4,0,0,46,0.0,0.0,1.0,46,1500,1000,500,0.6666666666666666,20,10,10,319.8989869191691,0.45317028985507246,0.18490837930711024,0.17188250098006774,127943.71712805488,-992.3571021384716,126951.36002591641,1269,2,247.19565217391303,41,5,16,38.98231679414265,0.5909552845528455,47.073412698412696,1011.7063492063489,24.675764614789,8
2054,4,0,0,46,0.0,0.0,1.0,46,1250,700,550,0.56,18,7,11,320.2063248807052,0.4527073268921095,0.1874201080565172,0.17269478536377977,128094.31295666403,-996.6781620055497,127097.63479465847,1270,3,248.19565217391303,41,5,16,38.82096890108455,0.592479674796748,46.92460317460317,1012.3015873015863,24.690282617111862,0
2055,4,0,1,45,0.0,0.021739130434782608,0.9782608695652174,46,1400,900,500,0.6428571428571429,19,9,10,317.8220114020089,0.4522544283413849,0.188010012286139,0.17243844142658202,128333.90404704517,-1042.5025712399647,127291.4014758052,1271,4,249.19565217391303,38,8,16,38.6372223393786,0.5997807017543859,46.688034188034194,1013.247863247864,26.664417453891158,0
2056,4,0,0,45,0.0,0.0,1.0,45,1400,1000,400,0.7142857142857143,18,10,8,324.6475821304377,0.45071548821548824,0.19447373971735926,0.17590333564347493,128279.7832657609,-670.8557053108245,127608.92756045007,1272,5,255.0222222222222,38,7,17,38.519475497433746,0.5992324561403508,46.741452991452995,1013.0341880341886,26.65879442195233,0
2057,4,2,0,47,0.0425531914893617,0.0,1.0,47,1100,800,300,0.7272727272727273,14,8,6,335.91452365398834,0.4538621646623497,0.19196178430722033,0.17706370890264383,127170.80213758674,-749.9835652285865,126420.81857235816,1273,0,245.12765957446808,39,8,16,39.368072050673014,0.5862713675213675,47.838541666666664,1008.6458333333328,25.862713675213662,8
2058,4,1,0,48,0.020833333333333332,0.0,1.0,48,1250,900,350,0.72,16,9,7,327.60737821387335,0.45454713356973997,0.19649816597890934,0.17384712697918642,127442.37075617263,-1249.787808641993,126192.58294753064,1274,0,241.0,41,7,13,39.299633195781766,0.5858739837398375,47.569444444444436,1009.7222222222206,24.627371273712697,0
2059,4,3,0,51,0.058823529411764705,0.0,1.0,51,850,400,450,0.47058823529411764,13,4,9,318.92049988028685,0.4565849673202615,0.22583149556685744,0.17295813001806423,128316.28207439448,-2011.6034109194916,126304.67866347499,1275,0,227.76470588235293,42,9,16,38.62734315225706,0.5932539682539683,46.70542635658914,1013.1782945736427,24.123292727943873,0
2060,4,1,1,51,0.019230769230769232,0.019230769230769232,0.9807692307692307,52,1250,800,450,0.64,17,8,9,312.4831309330028,0.4578934137757667,0.2320673211579749,0.17067857294356945,128600.36914779915,-2362.910801911147,126237.45834588801,1276,0,224.3653846153846,43,9,14,38.501404319546864,0.594718992248062,46.4251893939394,1014.2992424242435,23.588354474982406,0
2061,4,0,0,51,0.0,0.0,1.0,51,1350,800,550,0.5925925925925926,19,8,11,314.4737480677335,0.4568464052287582,0.2312324127051928,0.17159970006657435,128561.83992097818,-2114.135268313212,126447.70465266496,1277,1,229.7450980392157,42,9,14,38.490110835085034,0.595734126984127,46.46317829457364,1014.1472868217045,24.146363971945345,0
2062,4,1,0,52,0.019230769230769232,0.0,1.0,52,1350,900,450,0.6666666666666666,18,9,9,309.3227237766228,0.4568643162393162,0.24389666421130163,0.17001121133888075,128848.62075617288,-2428.838734567897,126419.78202160499,1278,0,226.30769230769232,44,8,15,38.329343365253074,0.5958806818181819,46.18055555555556,1015.277777777778,23.074494949494955,0
2063,4,1,1,52,0.018867924528301886,0.018867924528301886,0.9811320754716981,53,1700,1200,500,0.7058823529411765,22,12,10,308.13166775981324,0.4580763183357523,0.2604051183571785,0.17118603104359195,129273.6054167383,-2632.377166950447,126641.22824978785,1279,0,223.0188679245283,43,10,16,37.92844228202501,0.6015019379844961,45.7623106060606,1016.9507575757567,23.650017618040852,0
2064,4,0,0,52,0.0,0.0,1.0,52,1600,1200,400,0.75,20,12,8,317.37668488276876,0.45752419557566615,0.2545099261360786,0.17610715584425288,129225.45882295992,-2197.370455262838,127028.08836769708,1280,1,228.21153846153845,43,9,16,37.742250318214275,0.6010174418604651,45.8096590909091,1016.7613636363652,23.645613107822445,0
2065,4,0,0,52,0.0,0.0,1.0,52,1450,900,550,0.6206896551724138,20,9,11,316.8685439478397,0.457445638511815,0.2562515217048824,0.17636279269884417,129345.84212149901,-2202.8742682506954,127142.96785324831,1281,2,229.21153846153845,43,9,16,37.63304474647799,0.6022286821705427,45.691287878787875,1017.2348484848479,23.656624383368555,0
2066,4,1,1,52,0.018867924528301886,0.018867924528301886,0.9811320754716981,53,1200,700,500,0.5833333333333334,17,7,10,312.95867768595053,0.45857522980164495,0.2692967409948541,0.17564007421150274,129672.49657064464,-2483.573388203024,127188.92318244162,1282,0,225.8679245283019,44,9,13,37.40151515151516,0.6041666666666667,45.37037037037037,1018.5185185185179,23.148148148148135,0
2067,4,0,1,51,0.0,0.019230769230769232,0.9807692307692307,52,1100,700,400,0.6363636363636364,15,7,8,315.1145220281063,0.45775986676721975,0.2692465020662458,0.17695634797504833,129696.07445987652,-2226.176697530866,127469.89776234564,1283,1,230.92307692307693,44,8,14,37.32274338696483,0.6044034090909092,45.34722222222222,1018.611111111111,23.150252525252522,0
2068,4,0,1,50,0.0,0.0196078431372549,0.9803921568627451,51,1650,1300,350,0.7878787878787878,20,13,7,324.31279561393603,0.4569607843137255,0.2707406070812781,0.1822861575347296,129731.44531250003,-1785.2864583333317,127946.1588541667,1284,2,236.0392156862745,43,8,14,37.05265848670756,0.6061046511627908,45.3125,1018.7500000000002,23.691860465116285,0
2069,4,0,1,49,0.0,0.02,0.98,50,1450,900,550,0.6206896551724138,20,9,11,333.0763647833986,0.45639455782312927,0.26885719718577694,0.18774368728787705,129842.52467550019,-1350.5047773571366,128492.01989814304,1285,3,238.6,42,8,15,36.716818786841614,0.6086309523809523,45.20348837209302,1019.1860465116273,24.26633444075303,0
2070,4,0,2,47,0.0,0.04081632653061224,0.9591836734693877,49,1350,1000,350,0.7407407407407407,17,10,7,338.0647953214004,0.4552331349206349,0.26714588459956046,0.1903152777087713,129793.15020131001,-1024.3010486148676,128768.84915269514,1286,4,244.28571428571428,42,7,15,36.63980284011664,0.6081349206349207,45.251937984496124,1018.9922480620155,24.26172019195275,0
2071,4,1,0,48,0.020833333333333332,0.0,1.0,48,850,500,350,0.5882352941176471,12,5,7,316.73491890887703,0.45418698286052006,0.22147186602200275,0.17540256219435704,129147.08547921687,-1330.7452540028019,127816.34022521407,1287,0,249.25,38,10,17,37.838098241188426,0.6080043859649122,45.886752136752136,1016.4529914529913,26.748762932973456,8
2072,4,1,0,49,0.02040816326530612,0.0,1.0,49,1600,1200,400,0.75,20,12,8,318.2976367354268,0.45571145124716556,0.18761744421827387,0.17062518924538478,127850.36886492666,-1589.8694614089654,126260.4994035177,1288,0,245.14285714285714,42,7,15,39.1180415828303,0.5885416666666667,47.16569767441859,1011.3372093023229,24.07945736434102,8
2073,4,0,1,48,0.0,0.02040816326530612,0.9795918367346939,49,1600,1400,200,0.875,18,14,4,320.1548444411121,0.4549496882086168,0.19277329778875774,0.17214505075458744,127972.89544648735,-1605.771513130241,126367.12393335711,1289,1,246.14285714285714,42,7,15,38.946083125837966,0.589781746031746,47.04457364341084,1011.8217054263547,24.090992986341778,0
2074,4,0,0,48,0.0,0.0,1.0,48,1450,1000,450,0.6896551724137931,19,10,9,321.39100346020786,0.45359596631205673,0.19534313725490238,0.1729002233804912,127993.90589569137,-1372.7820294784824,126621.12386621289,1290,2,252.22916666666666,41,7,16,38.89338235294116,0.5914634146341464,47.02380952380951,1011.90476190476,24.680603948896586,0
2075,4,1,2,47,0.02040816326530612,0.04081632653061224,0.9591836734693877,49,1900,1300,600,0.6842105263157895,25,13,12,316.4250713374727,0.4540107709750567,0.19430928577566964,0.17208416911232,128427.65239771285,-1672.277031474912,126755.37536623795,1291,0,248.0612244897959,40,9,13,38.57717565670742,0.5973958333333333,46.595528455284544,1013.6178861788607,25.340447154471516,0
2076,4,1,0,48,0.020833333333333332,0.0,1.0,48,1350,900,450,0.6666666666666666,18,9,9,327.34711876836116,0.4521091903073286,0.2742870534833226,0.16907929162072277,126342.87308673502,-1328.404903628089,125014.46818310693,1292,0,254.02083333333334,41,7,13,40.433195184527314,0.5746951219512195,48.6607142857143,1005.3571428571456,24.520905923345016,8
2077,4,3,0,51,0.058823529411764705,0.0,1.0,51,1850,1600,250,0.8648648648648649,21,16,5,314.1861894679317,0.4554411764705882,0.2840706530546091,0.16528925619834728,127092.01388888934,-2213.8888888888487,124878.1250000005,1293,0,240.01960784313727,44,7,16,39.9965564738292,0.578125,47.916666666666686,1008.333333333337,22.91666666666675,0
2078,4,3,5,49,0.05555555555555555,0.09259259259259259,0.9074074074074074,54,1100,700,400,0.6363636363636364,15,7,8,317.0902507188355,0.4580858374097368,0.23827679715655292,0.17260136332052312,128463.58861396536,-2362.2910845201704,126101.29752944519,1294,0,227.62962962962962,42,12,12,38.52374466322564,0.5947420634920635,46.56007751937984,1013.7596899224794,24.13713547434475,8
2079,4,1,1,49,0.02,0.02,0.98,50,1650,1300,350,0.7878787878787878,20,13,7,334.0219680626678,0.45386054421768707,0.26556149732620304,0.18084797424506582,128250.02170138895,-1432.335069444439,126817.68663194451,1295,0,246.66,39,11,16,38.31242287124642,0.5972222222222222,46.770833333333336,1012.9166666666672,25.972222222222236,0
2080,4,2,1,50,0.0392156862745098,0.0196078431372549,0.9803921568627451,51,1150,600,550,0.5217391304347826,17,6,11,325.2733924763355,0.4546078431372549,0.2705843058666355,0.1775836136167302,128582.21379469894,-1835.1254213761633,126747.08837332278,1296,0,242.72549019607843,40,11,15,38.195557782231134,0.5989583333333333,46.44308943089431,1014.2276422764229,25.355691056910572,0
2081,4,1,0,51,0.0196078431372549,0.0,1.0,51,1300,800,500,0.6153846153846154,18,8,10,331.7760202645088,0.453235294117647,0.28811556654693926,0.18231256559089343,128840.02267995238,-1650.7940048912715,127189.22867506111,1297,0,243.7058823529412,40,11,16,37.76818485151818,0.6015625,46.1890243902439,1015.2439024390242,25.381097560975604,0
2082,4,1,0,52,0.019230769230769232,0.0,1.0,52,2200,1900,300,0.8636363636363636,25,19,6,327.1800875591743,0.4542169431875314,0.2856135320660156,0.18179295592474504,129278.89034511535,-1939.9982029545886,127338.89214216075,1298,0,240.0,40,12,17,37.438792845008486,0.6059895833333333,45.75711382113821,1016.9715447154472,25.42428861788618,0
2083,4,0,0,52,0.0,0.0,1.0,52,1850,1600,250,0.8648648648648649,21,16,5,348.0365856508235,0.45342351684263454,0.31318496318496347,0.18189242372248915,126823.46242901566,-1518.8647577426877,125304.59767127298,1299,1,241.0,42,10,17,39.41899150232484,0.578125,48.18313953488372,1007.2674418604649,23.98255813953488,8
2084,4,1,2,51,0.018867924528301886,0.03773584905660377,0.9622641509433962,53,1550,1100,450,0.7096774193548387,20,11,9,342.37617114610237,0.4542815674891147,0.3263342212065681,0.18101093622131753,127292.15876165267,-1883.0715509367565,125409.08721071591,1300,0,237.43396226415095,41,12,18,39.0807281426137,0.584349593495935,47.71825396825396,1009.1269841269831,24.61285327138983,0
2085,4,0,1,50,0.0,0.0196078431372549,0.9803921568627451,51,2200,1700,500,0.7727272727272727,27,17,10,345.4059550563746,0.45532679738562093,0.3205500284198921,0.18303353203343378,127385.30305420332,-1400.0715476834464,125985.23150651988,1301,1,244.9607843137255,42,9,15,38.9088196710821,0.5838293650793651,47.625968992248055,1009.4961240310066,24.035622000738254,0
2086,4,2,0,52,0.038461538461538464,0.0,1.0,52,950,500,450,0.5263157894736842,14,5,9,337.7996605366888,0.4577991452991453,0.3138000576202824,0.18110945655280308,127857.05061983476,-1761.9863406795157,126095.06427915524,1302,0,233.69230769230768,43,9,17,38.618133583021226,0.5872093023255813,47.159090909090914,1011.3636363636367,23.520084566596204,0
2087,4,3,3,52,0.05454545454545454,0.05454545454545454,0.9454545454545454,55,1400,1000,400,0.7142857142857143,18,10,8,321.79272399558624,0.460662177328844,0.3147161750275711,0.17591895705011967,128635.55304856983,-2719.911674050347,125915.64137451947,1303,0,221.8909090909091,42,13,16,38.22953481707901,0.5964781746031746,46.390503875968996,1014.4379844961243,24.153285345145814,0
2088,4,0,3,49,0.0,0.057692307692307696,0.9423076923076923,52,1650,1000,650,0.6060606060606061,23,10,13,339.2154041945874,0.4583176219205631,0.22707242069330813,0.1839645366316705,128316.28207439465,-1499.0526974039958,126817.22937699065,1304,1,235.46153846153845,42,10,18,38.1132842387146,0.5932539682539683,46.70542635658915,1013.178294573644,24.123292727943905,8
2089,4,2,1,50,0.0392156862745098,0.0196078431372549,0.9803921568627451,51,1800,1400,400,0.7777777777777778,22,14,8,339.49609859567965,0.45928104575163403,0.2743524875198702,0.18633172969007133,128792.54301717473,-1455.0868234905756,127337.45619368415,1305,0,238.47058823529412,43,8,18,37.620599713903644,0.596656976744186,46.23579545454546,1015.0568181818194,23.605972515856266,0
2090,4,1,1,50,0.0196078431372549,0.0196078431372549,0.9803921568627451,51,1550,1100,450,0.7096774193548387,20,11,9,338.6756217950292,0.458937908496732,0.2815807658136906,0.1866718766378976,128960.81285152677,-1464.8233040633443,127495.98954746342,1306,0,239.3921568627451,43,8,19,37.47008825905899,0.5983527131782946,46.070075757575765,1015.7196969696981,23.621388301620886,0
2091,4,0,1,49,0.0,0.02,0.98,50,950,500,450,0.5263157894736842,14,5,9,329.4528424471584,0.45846938775510204,0.2798784023945382,0.17779809886938724,128120.56220048461,-1557.614945621011,126562.9472548636,1307,1,241.9,43,7,15,38.56017912262652,0.5898740310077519,46.89867424242423,1012.4053030303002,23.544309372797677,8
2092,4,1,0,50,0.02,0.0,1.0,50,1450,1100,350,0.7586206896551724,18,11,7,328.555355895882,0.4584948979591837,0.2946256096394766,0.1782928571148537,128340.8272959104,-1566.5845204850502,126774.24277542536,1308,0,242.86,42,8,16,38.35827675241466,0.5935019841269842,46.681201550387584,1013.2751937984473,24.12559985234398,0
2093,4,1,0,51,0.0196078431372549,0.0,1.0,51,800,700,100,0.875,9,7,2,329.8559949706293,0.458921568627451,0.3163018100110515,0.1807125174900439,128720.46100206596,-1708.1568526170981,127012.30414944886,1309,0,239.07843137254903,43,8,13,37.938596491228076,0.5959302325581395,46.30681818181817,1014.7727272727261,23.599365750528513,0
2094,4,0,0,51,0.0,0.0,1.0,51,950,700,250,0.7368421052631579,12,7,5,331.79717086210775,0.4588725490196079,0.31549604916593554,0.18221647908000968,128816.57483930193,-1651.8049816345444,127164.76985766739,1310,1,240.07843137254903,43,8,14,37.79151119402986,0.5968992248062015,46.212121212121204,1015.1515151515136,23.608174770965434,0
2095,4,0,2,49,0.0,0.0392156862745098,0.9607843137254902,51,1500,1300,200,0.8666666666666667,17,13,4,330.26167479476004,0.4588725490196079,0.3094624387140652,0.18203426124607347,128960.81285152634,-1681.8371929522773,127278.97565857405,1311,2,241.07843137254903,43,8,14,37.683743551494786,0.5983527131782946,46.070075757575744,1015.7196969696946,23.621388301620804,0
2096,4,0,3,46,0.0,0.061224489795918366,0.9387755102040817,49,2100,1500,600,0.7142857142857143,27,15,12,337.86193301903825,0.4561897675736961,0.3118462386385994,0.18585066646228332,128881.41605259586,-1091.1751284478205,127790.24092414803,1312,3,251.6734693877551,42,7,15,37.57157171485829,0.5989583333333333,46.14825581395348,1015.4069767441849,24.17635658914726,0
2097,4,3,2,47,0.061224489795918366,0.04081632653061224,0.9591836734693877,49,1500,1000,500,0.6666666666666666,20,10,10,330.046563022256,0.45875850340136054,0.3096222717475894,0.18471544515960653,129563.26116233705,-1246.4280778575562,128316.83308447948,1313,0,231.0612244897959,40,9,15,37.077219338523996,0.6088541666666667,45.477642276422756,1018.0894308943075,25.45223577235769,0
2098,4,0,1,46,0.0,0.02127659574468085,0.9787234042553191,47,1800,1400,400,0.7777777777777778,22,14,8,340.51348885156995,0.45854532839962997,0.3061913369193585,0.1901038163474192,129466.28146701382,-582.9969618055612,128883.28450520826,1314,1,236.95744680851064,39,8,15,36.90933128625043,0.6095085470085471,45.572916666666664,1017.7083333333327,26.095085470085454,0
2099,4,0,1,45,0.0,0.021739130434782608,0.9782608695652174,46,1450,800,650,0.5517241379310345,21,8,13,346.86518353081755,0.4579710144927536,0.2689804430979996,0.18165819817507314,126908.26958550356,-353.6702473958291,126554.59933810773,1315,2,234.54347826086956,39,7,15,39.36138822840207,0.5836004273504274,48.098958333333336,1007.6041666666674,25.836004273504294,8
2100,4,2,1,46,0.0425531914893617,0.02127659574468085,0.9787234042553191,47,1850,1600,250,0.8648648648648649,21,16,5,339.80424978894314,0.45920058587727414,0.290330435469329,0.1809863491874222,127591.41845703125,-728.6458333333329,126862.77262369792,1316,0,229.61702127659575,39,8,16,38.8391629721277,0.5905448717948718,47.421875,1010.3125,25.90544871794872,0
2101,4,2,3,45,0.041666666666666664,0.0625,0.9375,48,950,600,350,0.631578947368421,13,6,7,338.45442008999805,0.46042036052009455,0.3087642235609096,0.1824137458926617,128067.37061273085,-931.0064693634406,127136.36414336742,1317,0,225.39583333333334,40,8,18,38.38667168674698,0.59375,46.95121951219514,1012.1951219512223,25.30487804878056,0
2102,4,0,1,44,0.0,0.022222222222222223,0.9777777777777777,45,1250,700,550,0.56,18,7,11,359.78166440363765,0.4586279461279461,0.31178093413808483,0.19281035972078758,127839.40882050266,198.85505636351792,128038.26387686619,1318,1,226.46666666666667,37,8,18,38.08041038707579,0.5965653153153153,47.17653508771931,1011.2938596491244,27.332266477003362,0
2103,4,0,0,44,0.0,0.0,1.0,44,1400,1000,400,0.7142857142857143,18,10,8,370.71495615942865,0.45671467582804787,0.30102218355806887,0.1908360242298536,126204.8123150887,579.9526824423367,126784.76499753103,1319,2,232.20454545454547,38,6,16,39.48564593301437,0.578125,48.79807692307692,1004.8076923076918,26.44230769230768,8
2104,4,0,1,43,0.0,0.022727272727272728,0.9772727272727273,44,1650,1200,450,0.7272727272727273,21,12,9,368.83310957873925,0.4564283826638478,0.29549802413549875,0.1903648232598112,126312.18639281543,517.6232969902886,126829.80968980573,1320,3,233.20454545454547,38,6,14,39.422140149502255,0.5792214912280702,48.69123931623932,1005.2350427350431,26.453553756185343,0
2105,4,0,0,43,0.0,0.0,1.0,43,1500,1100,400,0.7333333333333333,19,11,8,371.10516210906314,0.4560031376891842,0.2968585497525251,0.19144181322756204,126291.69702456507,773.5001394659698,127065.19716403104,1321,4,239.5581395348837,37,6,14,39.38618141158502,0.5807995495495495,48.711622807017534,1005.1535087719284,27.166311047889955,0
2106,4,0,1,42,0.0,0.023255813953488372,0.9767441860465116,43,1400,1000,400,0.7142857142857143,18,10,8,372.68012526488997,0.4566952750092285,0.29662381255403236,0.1930318909686524,126457.07242853564,825.6075186595795,127282.67994719523,1322,5,240.5581395348837,37,6,14,39.17600112649442,0.5824887387387387,48.547149122807014,1005.8114035087714,27.18409198672355,0
2107,4,2,0,44,0.045454545454545456,0.0,1.0,44,1050,600,450,0.5714285714285714,15,6,9,367.5763393889712,0.4599079457364341,0.308493875466207,0.19273749913597363,126957.38965821096,533.3065097888831,127490.69616799985,1323,0,235.04545454545453,38,6,17,38.78913565850384,0.5858004385964912,48.050213675213676,1007.7991452991453,26.52103013945119,0
2108,4,0,0,44,0.0,0.0,1.0,44,1100,600,500,0.5454545454545454,16,6,10,366.39735156226476,0.45998502466525726,0.30571480818844154,0.19288817643492528,127119.65610812926,515.332405118845,127634.9885132481,1324,1,236.04545454545453,37,7,17,38.65198343662788,0.5892454954954955,47.889254385964904,1008.442982456139,27.25521574205781,0
2109,4,2,0,46,0.043478260869565216,0.0,1.0,46,1300,800,500,0.6153846153846154,18,8,10,354.7808203943163,0.4617552334943639,0.31912057881414757,0.18970511635960563,127749.32861328138,-135.39767795137573,127613.93093533,1325,0,226.7391304347826,39,7,17,38.299094109565516,0.5921474358974359,47.26562500000001,1010.937500000001,25.921474358974386,0
2110,4,0,3,43,0.0,0.06521739130434782,0.9347826086956522,46,1750,1400,350,0.8,21,14,7,359.3009325490573,0.4619464573268921,0.32400366868298636,0.19302972388159012,127938.82118985063,-6.292447451915791,127932.52874239872,1326,1,227.7391304347826,40,6,17,37.990750041855,0.5924479166666667,47.078252032520325,1011.6869918699188,25.292174796747968,0
2111,4,2,1,44,0.044444444444444446,0.022222222222222223,0.9777777777777777,45,950,700,250,0.7368421052631579,12,7,5,358.7578723376132,0.4623947811447811,0.31840045701228203,0.1943688194141109,128276.40109592023,204.19899121462456,128480.60008713485,1327,0,223.82222222222222,39,6,19,37.659061696658085,0.5974893162393162,46.74479166666667,1013.0208333333342,25.974893162393183,0
2112,4,0,1,43,0.0,0.022727272727272728,0.9772727272727273,44,1700,1200,500,0.7058823529411765,22,12,10,363.4792758911503,0.46217626849894294,0.3150856945669269,0.19721038058075888,128333.9040470449,529.3429030608348,128863.24695010573,1328,1,228.1590909090909,38,6,20,37.48066919724449,0.5997807017543859,46.68803418803418,1013.2478632478618,26.6644174538911,0
2113,4,1,1,43,0.022727272727272728,0.022727272727272728,0.9772727272727273,44,1350,1000,350,0.7407407407407407,17,10,7,360.43673848497883,0.46252862931641997,0.31569234071543884,0.19735886844194375,128698.84033203124,477.5580512152777,129176.39838324652,1329,0,222.9318181818182,39,5,16,37.18485867296309,0.6017628205128205,46.328125,1014.6874999999999,26.0176282051282,0
2114,4,0,1,42,0.0,0.023255813953488372,0.9767441860465116,43,1500,1200,300,0.8,18,12,6,365.59495471933155,0.4605020302694722,0.3205010753425668,0.19970992520744124,128604.67916757963,803.4443713930751,129408.12353897271,1330,1,229.06976744186048,38,5,17,37.15021768134261,0.6025219298245614,46.42094017094016,1014.3162393162378,26.692532613585204,0
2115,4,0,0,42,0.0,0.0,1.0,42,1350,1000,350,0.7407407407407407,17,10,7,365.5976166953228,0.4600391986062718,0.30954439931847877,0.19977221217061,128616.79945992984,1004.3990699061164,129621.19852983595,1331,2,233.33333333333334,37,5,17,37.13776438583218,0.6044481981981982,46.40899122807017,1014.3640350877182,27.415244191559953,0
2116,4,1,1,42,0.023255813953488372,0.023255813953488372,0.9767441860465116,43,800,500,300,0.625,11,5,6,330.62476720547807,0.4607096714654854,0.15658977269529184,0.17328092978908677,126938.35101460772,-204.8819212225207,126733.4690933852,1332,0,228.88372093023256,40,3,16,39.7396463627807,0.5822916666666667,48.06910569105691,1007.7235772357724,25.19308943089431,8
2117,4,1,0,43,0.023255813953488372,0.0,1.0,43,1000,500,500,0.5,15,5,10,331.60303257974164,0.4622093023255814,0.17009417643667124,0.17445203018325553,127092.01388888896,-171.08760493091853,126920.92628395805,1333,0,229.30232558139534,39,4,18,39.557506887052334,0.5854700854700854,47.91666666666667,1008.333333333334,25.854700854700873,0
2118,4,3,1,45,0.06521739130434782,0.021739130434782608,0.9782608695652174,46,1100,900,200,0.8181818181818182,13,9,4,314.3854285966371,0.46685789049919485,0.10446919680132183,0.15927390168922917,125546.23035556826,-1306.0189121945002,124240.21144337376,1334,0,215.2826086956522,41,5,17,41.57757539761101,0.5665650406504066,49.45436507936508,1002.1825396825406,24.443476577622942,8
2119,4,3,1,47,0.0625,0.020833333333333332,0.9791666666666666,48,1300,700,600,0.5384615384615384,19,7,12,304.2250980152075,0.4699966755319149,0.13785198526267317,0.15704090260764622,126317.93986402421,-1911.2299028407797,124406.70996118343,1335,0,202.95833333333334,41,7,15,41.03989851639856,0.5744410569105691,48.685515873015866,1005.2579365079357,24.518486256291116,0
2120,4,1,1,47,0.020833333333333332,0.020833333333333332,0.9791666666666666,48,1800,1200,600,0.6666666666666666,24,12,12,302.84325450407016,0.46968269799054374,0.14350414078674967,0.157283109597275,126567.38281249985,-1933.9843750000139,124633.39843749984,1336,0,203.9375,41,7,18,40.81909937888198,0.5769817073170731,48.43749999999999,1006.2499999999989,24.54268292682924,0
2121,4,2,2,47,0.04081632653061224,0.04081632653061224,0.9591836734693877,49,1150,700,450,0.6086956521739131,16,7,9,312.3713841627713,0.4723462301587302,0.1293969428173165,0.15904359062807874,125752.09690110256,-1889.4752137041182,123862.62168739844,1337,0,200.59183673469389,42,7,15,41.41628828132547,0.5672123015873016,49.24903100775193,1003.0038759689911,23.88104466592836,8
2122,4,4,4,47,0.0784313725490196,0.0784313725490196,0.9215686274509804,51,1600,1200,400,0.75,20,12,8,305.1089264840885,0.47297385620915033,0.17671595690171515,0.15850496238188716,126579.02949245568,-2475.583618680151,124103.44587377553,1338,0,193.3921568627451,44,7,14,40.75017635872901,0.5729166666666667,48.42592592592594,1006.2962962962984,22.870370370370416,0
2123,4,4,4,47,0.0784313725490196,0.0784313725490196,0.9215686274509804,51,2100,1700,400,0.8095238095238095,25,17,8,306.90095282352706,0.4723856209150327,0.19510544239270633,0.16073287190249144,126909.4104442345,-2410.2762024784656,124499.13424175604,1339,0,194.23529411764707,45,6,17,40.366924367733404,0.575,48.09782608695652,1007.6086956521747,22.391304347826104,0
2124,4,4,6,45,0.0784313725490196,0.11764705882352941,0.8823529411764706,51,1550,1200,350,0.7741935483870968,19,12,7,304.679082060047,0.4750653594771242,0.20997943181776368,0.16123483895709956,127330.8412606177,-2440.728683471796,124890.1125771459,1340,0,194.1764705882353,43,8,16,39.99225933571025,0.5818798449612403,47.67992424242425,1009.2803030303044,23.471634954193124,0
2125,4,1,0,46,0.021739130434782608,0.0,1.0,46,900,500,400,0.5555555555555556,13,5,8,330.4674945030543,0.4723530595813204,0.22272031776790868,0.17330756969787378,126963.95503875024,-808.5079772291434,126155.44706152109,1341,0,214.2391304347826,40,6,20,39.71736244159862,0.5825520833333333,48.04369918699188,1007.8252032520338,25.195630081300845,0
2126,4,4,2,48,0.08,0.04,0.96,50,1750,1500,250,0.8571428571428571,20,15,5,309.7330485459694,0.4744727891156462,0.24284291187739404,0.1663381186635765,127923.87777176882,-2075.420373095833,125848.45739867298,1342,0,198.02,42,8,21,39.25965836526183,0.5892857142857143,47.09302325581397,1011.6279069767465,24.086378737541583,0
2127,4,0,0,48,0.0,0.0,1.0,48,1200,900,300,0.75,15,9,6,323.7114162722344,0.4727947695035461,0.24328740949316163,0.1726923993246303,127656.23967215323,-1335.2435719478697,126320.99610020536,1343,1,207.125,40,8,21,39.179404666130345,0.5895833333333333,47.357723577235795,1010.5691056910603,25.264227642276506,0
2128,4,0,0,48,0.0,0.0,1.0,48,1450,1000,450,0.6896551724137931,19,10,9,323.78804039145837,0.47324726654846333,0.24789321136576792,0.17317437773194835,127758.96044021464,-1326.635311322579,126432.32512889206,1344,2,208.125,40,8,21,39.072552271813436,0.590625,47.25609756097563,1010.9756097561014,25.274390243902538,0
2129,4,1,3,46,0.02040816326530612,0.061224489795918366,0.9387755102040817,49,1550,1300,250,0.8387096774193549,18,13,5,319.3143013143518,0.47379889455782315,0.16500129355435011,0.16760151803799542,126998.66683813413,-1564.5349352564112,125434.13190287772,1345,0,204.85714285714286,44,5,20,39.962834527527704,0.5771780303030303,48.009259259259245,1007.9629629629605,22.908249158249102,8
2130,4,3,2,47,0.061224489795918366,0.04081632653061224,0.9591836734693877,49,1500,1000,500,0.6666666666666666,20,10,10,314.5678744430247,0.47615504535147396,0.20126513009103864,0.16725727561362408,127522.0645732896,-1777.096746966025,125744.96782632357,1346,0,204.69387755102042,43,6,18,39.54739358709918,0.5838178294573644,47.4905303030303,1010.0378787878778,23.489252995066927,0
2131,4,1,1,47,0.020833333333333332,0.020833333333333332,0.9791666666666666,48,1200,900,300,0.75,15,9,6,327.1389530305755,0.47372746749408984,0.21781755159414762,0.17504450440620656,127776.88108436999,-1239.8409801093617,126537.04010426062,1347,0,206.60416666666666,42,6,19,38.96955466104403,0.5877976190476191,47.23837209302326,1011.0465116279074,24.072535991140654,0
2132,4,1,0,48,0.020833333333333332,0.0,1.0,48,1450,800,650,0.5517241379310345,21,8,13,322.0561429730276,0.47318262411347517,0.20541393826005638,0.17370232938353525,128096.59539284905,-1349.1409119604994,126747.45448088855,1348,0,205.6875,43,5,21,38.771827252884336,0.5896317829457365,46.92234848484849,1012.3106060606069,23.542107117688534,0
2133,4,0,3,45,0.0,0.0625,0.9375,48,1450,1000,450,0.6896551724137931,19,10,9,300.9193029074383,0.4729425236406619,0.12536769307798212,0.1586827928004968,127187.51793503224,-1940.6203368916324,125246.89759814061,1349,1,206.6875,43,5,15,40.23344598823382,0.5804263565891472,47.8219696969697,1008.712121212122,23.45842142353772,8
2134,4,1,2,44,0.021739130434782608,0.043478260869565216,0.9565217391304348,46,1050,400,650,0.38095238095238093,17,4,13,309.47065152535276,0.47533212560386473,0.11834263926532551,0.16329949077701209,127214.17662888354,-1326.189175079616,125887.98745380391,1350,0,209.7826086956522,42,4,17,39.99055486184484,0.582093253968254,47.79554263565892,1008.8178294573648,24.01947212993726,0
2135,4,0,0,44,0.0,0.0,1.0,44,1350,1100,250,0.8148148148148148,16,11,5,359.71433279194014,0.473661028893587,0.19852049910873437,0.18546796188145984,126270.10192202358,525.4623985208825,126795.56432054446,1351,1,219.8409090909091,36,8,16,39.694677871148464,0.5824652777777778,48.73310810810812,1005.0675675675692,27.91854354354359,8
2136,4,1,2,43,0.022222222222222223,0.044444444444444446,0.9555555555555556,45,1450,800,650,0.5517241379310345,21,8,13,357.8070516522761,0.47415824915824917,0.20587088886467897,0.18607993921338495,126622.5560388774,61.28868978917096,126683.84472866658,1352,0,215.93333333333334,37,8,17,39.3796301340015,0.584177927927928,48.38267543859649,1006.4692982456145,27.201872925557147,0
2137,4,2,1,44,0.044444444444444446,0.022222222222222223,0.9777777777777777,45,1850,1400,450,0.7567567567567568,23,14,9,354.1875563579964,0.4717382154882155,0.21430626579141454,0.1857009600961978,126953.8478786743,-6.905369921499926,126946.9425087528,1353,0,216.6,37,8,19,39.13010463134227,0.5875563063063063,48.053728070175445,1007.7850877192991,27.2374348032243,0
2138,4,0,0,44,0.0,0.0,1.0,44,1350,1000,350,0.7407407407407407,17,10,7,351.91785441329034,0.47068798449612403,0.2145482979933384,0.18488078830444707,127035.24470416376,141.19415023133269,127176.43885439509,1354,1,222.20454545454547,36,8,19,39.103691912421816,0.5902777777777778,47.97297297297298,1008.1081081081093,28.003003003003034,0
2139,4,1,0,45,0.022222222222222223,0.0,1.0,45,1600,1200,400,0.75,20,12,8,344.42861962963167,0.4711279461279461,0.21604222420457941,0.18298790644778062,127489.75326678027,-217.76337147958918,127271.98989530068,1355,0,218.24444444444444,36,9,17,38.82647561700862,0.5949074074074074,47.52252252252252,1009.9099099099099,28.053053053053052,0
2140,4,1,3,43,0.021739130434782608,0.06521739130434782,0.9347826086956522,46,1300,800,500,0.6153846153846154,18,8,10,338.16120621910835,0.47112520128824475,0.22205490750559664,0.1814739457458566,127894.85857427282,-550.1840710603284,127344.67450321249,1356,0,214.47826086956522,37,9,19,38.570347786811205,0.5971283783783784,47.12171052631579,1011.5131578947365,27.3381934566145,0
2141,4,0,0,43,0.0,0.0,1.0,43,1400,1000,400,0.7142857142857143,18,10,8,356.08622147083685,0.4708840900701366,0.2307692307692304,0.1906108597285068,127793.2098765432,501.0802469135794,128294.29012345678,1357,1,228.37209302325581,35,8,20,38.221153846153854,0.6,47.22222222222222,1011.1111111111111,28.88888888888889,0
2142,4,0,1,42,0.0,0.023255813953488372,0.9767441860465116,43,1500,700,800,0.4666666666666667,23,7,16,358.8897490110192,0.47079180509413066,0.23120689242423853,0.19309372772943606,127998.08873724696,587.440388160133,128585.52912540709,1358,2,229.37209302325581,35,8,20,37.940471424758854,0.6020833333333333,47.01967592592592,1011.9212962962953,28.91203703703701,0
2143,4,0,1,41,0.0,0.023809523809523808,0.9761904761904762,42,1400,1100,300,0.7857142857142857,17,11,6,363.98524626203374,0.4706373403019744,0.22895583274496012,0.19552127830181795,127933.68055555546,913.1944444444352,128846.8749999999,1359,3,235.38095238095238,34,8,20,37.8775398132894,0.6035539215686274,47.08333333333333,1011.6666666666658,29.754901960784288,0
2144,4,0,0,41,0.0,0.0,1.0,41,2000,1700,300,0.85,23,17,6,360.2365235734949,0.4698424796747967,0.22198870663522063,0.19467850845570886,128175.55334787101,1034.876760140329,129210.43010801134,1360,4,237.8780487804878,33,8,21,37.72477207632418,0.608270202020202,46.84436274509804,1012.6225490196078,30.685531788472964,0
2145,4,1,0,42,0.023809523809523808,0.0,1.0,42,1500,1100,400,0.7333333333333333,19,11,8,350.75306008370404,0.4681087882307395,0.2218850929247551,0.19185607047710665,128657.32001133767,625.3897392289975,129282.70975056666,1361,0,233.1904761904762,34,8,20,37.47286435109128,0.610906862745098,46.369047619047606,1014.5238095238078,29.83893557422964,0
2146,4,0,0,42,0.0,0.0,1.0,42,1300,1000,300,0.7692307692307693,16,10,6,351.5312045820042,0.4678668215253581,0.22498254433738318,0.19272048354093782,128747.9184382085,651.7821712018001,129399.7006094103,1362,1,234.1904761904762,34,8,20,37.36070381231671,0.6118259803921569,46.2797619047619,1014.8809523809514,29.849439775910334,0
2147,4,0,0,42,0.0,0.0,1.0,42,1250,800,450,0.64,17,8,9,352.6737116569364,0.46755226480836237,0.22743721623749735,0.1936412581647584,128808.33510487532,685.4627267573685,129493.79783163269,1363,2,235.1904761904762,34,8,20,37.27009303780149,0.6124387254901961,46.220238095238095,1015.1190476190479,29.856442577030823,0
2148,4,0,3,39,0.0,0.07142857142857142,0.9285714285714286,42,950,500,450,0.5263157894736842,14,5,9,353.1019210272386,0.467491773132017,0.22735038440279398,0.19417190744302504,128868.76594387754,700.7617630385467,129569.5277069161,1364,3,236.1904761904762,34,8,20,37.197600343924634,0.6130514705882353,46.160714285714285,1015.3571428571428,29.86344537815126,0
2149,4,0,0,39,0.0,0.0,1.0,39,1000,900,100,0.9,11,9,2,377.57425082984463,0.46761133603238864,0.22340793439059348,0.20540989117472677,128441.33377075195,1899.2280748155376,130340.56184556748,1365,4,252.12820512820514,31,8,20,37.013621280239775,0.6159274193548387,46.58203125,1013.671875,32.69909274193548,0
2150,4,1,0,40,0.025,0.0,1.0,40,900,600,300,0.6666666666666666,12,6,6,372.4517841287391,0.4674412393162393,0.23484089569829103,0.19813500867287465,127542.56129535148,1532.7725053644494,129075.33380071593,1366,0,246.8,34,6,17,38.064722058534656,0.5995710784313726,47.470238095238095,1010.1190476190477,29.709383753501402,8
2151,4,2,0,42,0.047619047619047616,0.0,1.0,42,1250,900,350,0.72,16,9,7,360.2660034990288,0.46769744483159115,0.2541547758939062,0.19527794202399565,128295.24518140573,846.9175170067854,129142.16269841252,1367,0,236.0,34,8,19,37.60159616137877,0.6072303921568627,46.72619047619047,1013.0952380952368,29.796918767506966,0
2152,4,0,1,41,0.0,0.023809523809523808,0.9761904761904762,42,1200,900,300,0.75,15,9,6,359.9305119980206,0.467116724738676,0.2542735391154525,0.19622596239045761,128525.67361379009,852.0623017403736,129377.73591553046,1368,1,237.0,35,7,17,37.3745624548187,0.6074404761904761,46.49884259259258,1014.004629629628,28.9715608465608,0
2153,4,1,0,42,0.023809523809523808,0.0,1.0,42,1350,1200,150,0.8888888888888888,15,12,3,360.70577356273014,0.4675159698025552,0.26444676193735206,0.19752076932070303,128701.7763658479,884.6947605881331,129586.47112643602,1369,0,237.8095238095238,35,7,18,37.1750361202996,0.6092261904761904,46.32523148148148,1014.6990740740739,28.99140211640211,0
2154,4,1,2,41,0.023255813953488372,0.046511627906976744,0.9534883720930233,43,1450,1100,350,0.7586206896551724,18,11,7,357.0495622347894,0.4673772609819122,0.25994459833795003,0.19757034329668785,129115.5360385725,620.1291240565091,129735.66516262901,1370,0,233.25581395348837,36,7,19,36.845798707294556,0.611400462962963,45.9177927927928,1016.3288288288301,28.23135635635639,0
2155,4,0,0,41,0.0,0.0,1.0,41,1050,600,450,0.5714285714285714,15,6,9,373.0913872452336,0.466234756097561,0.2703689806128833,0.20551644212661188,128936.76757812509,1421.0394965277935,130357.80707465288,1371,1,244.70731707317074,35,6,19,36.6207264957265,0.6116071428571428,46.09375000000001,1015.6250000000007,29.017857142857164,0
2156,4,0,1,40,0.0,0.024390243902439025,0.975609756097561,41,1400,1000,400,0.7142857142857143,18,10,8,372.9829547338142,0.4657012195121952,0.2773581079016163,0.20606780110812803,129054.34355977798,1427.0140764317573,130481.35763620974,1372,2,245.70731707317074,35,6,19,36.50342199187453,0.612797619047619,45.97800925925926,1016.0879629629632,29.031084656084662,0
2157,4,1,1,40,0.024390243902439025,0.024390243902439025,0.975609756097561,41,1400,700,700,0.5,21,7,14,370.8939977259484,0.46671747967479676,0.2716896359628942,0.20634820757460215,129329.78777675742,1393.7795761965172,130723.56735295395,1373,0,243.5121951219512,32,9,20,36.27549859318107,0.6223958333333333,45.707070707070706,1017.1717171717168,31.78661616161615,0
2158,4,2,2,40,0.047619047619047616,0.047619047619047616,0.9523809523809523,42,1900,1400,500,0.7368421052631579,24,14,10,357.9402876589999,0.46816927990708473,0.26280917463751985,0.20215242722574492,129918.78311526822,900.6333201172705,130819.41643538549,1374,0,237.92857142857142,33,9,18,36.00580498457347,0.6259469696969697,45.12867647058824,1019.4852941176474,30.89349376114083,0
2159,4,0,0,40,0.0,0.0,1.0,40,1300,1000,300,0.7692307692307693,16,10,6,376.8069727891153,0.46605235042735044,0.2743489583333327,0.2110119047619048,129586.77685950424,1765.8402203856872,131352.61707988993,1375,1,250.8,32,8,18,35.86309523809523,0.625,45.45454545454546,1018.1818181818192,31.81818181818185,0
2160,4,0,0,40,0.0,0.0,1.0,40,1500,1100,400,0.7333333333333333,19,11,8,378.93657813430497,0.4651575854700855,0.2731597305749336,0.21315823481790344,129762.65889321425,1834.3635861207351,131597.022479335,1376,2,251.8,33,7,18,35.62966081308635,0.6243686868686869,45.281862745098046,1018.8725490196086,30.874925727866927,0
2161,4,0,2,38,0.0,0.05,0.95,40,1350,700,650,0.5185185185185185,20,7,13,378.39566536343676,0.46469017094017095,0.273160394372971,0.21336384737814937,129856.32216274997,1827.413885284516,131683.73604803448,1377,3,252.8,33,7,18,35.54804917638572,0.6253156565656566,45.18995098039216,1019.240196078432,30.88606654783127,0
2162,4,0,0,38,0.0,0.0,1.0,38,1450,1100,350,0.7586206896551724,18,11,7,391.0572471677519,0.4624081318160265,0.27171456247981896,0.21980114237359846,129731.44531250001,2546.4843750000014,132277.92968750003,1378,4,252.60526315789474,31,7,18,35.352760736196316,0.6290322580645161,45.3125,1018.7500000000001,32.862903225806456,0
2163,4,1,1,38,0.02564102564102564,0.02564102564102564,0.9743589743589743,39,1300,1000,300,0.7692307692307693,16,10,6,387.76156216762945,0.46274741340530817,0.25140681734568204,0.2087245749344226,128016.72222541079,2127.992838740967,130144.71506415175,1379,0,247.10256410256412,32,7,20,37.19094406321482,0.6090494791666667,47.00126262626264,1011.9949494949506,31.624842171717205,8
2164,4,2,0,40,0.05,0.0,1.0,40,1350,1100,250,0.8148148148148148,16,11,5,372.63622084514355,0.46358173076923076,0.2595468401922858,0.20491388314559839,128868.76594387762,1604.2339852607847,130472.9999291384,1380,0,236.325,34,6,19,36.70174307265409,0.6130514705882353,46.16071428571429,1015.3571428571433,29.863445378151276,0
2165,4,0,1,39,0.0,0.025,0.975,40,1550,1100,450,0.7096774193548387,20,11,9,370.86804622413365,0.4623397435897436,0.2569672131147549,0.20566318926974667,129201.38888888876,1583.7620464852519,130785.15093537401,1381,1,237.325,33,7,20,36.40710382513664,0.6186868686868687,45.83333333333333,1016.6666666666656,30.808080808080774,0
2166,4,0,0,39,0.0,0.0,1.0,39,1400,700,700,0.5,21,7,14,380.61005106154226,0.4606668915879442,0.2751155947877255,0.2110655737704918,129201.38888888896,2035.0694444444498,131236.4583333334,1382,2,244.23076923076923,32,7,21,36.15949453551911,0.62109375,45.833333333333336,1016.6666666666673,31.770833333333353,0
2167,4,1,1,39,0.025,0.025,0.975,40,1000,800,200,0.8,12,8,4,370.8875924493932,0.4613114316239317,0.2693655189019979,0.20730769467595286,129513.05537533642,1606.9570597846923,131120.0124351211,1383,0,239.1,33,7,16,36.08887149851511,0.6218434343434344,45.52696078431372,1017.8921568627452,30.845216874628644,0
2168,4,0,0,39,0.0,0.0,1.0,39,1050,700,350,0.6666666666666666,14,7,7,373.82533910834803,0.4604419703103914,0.2613594989046253,0.20961461322472139,129637.82709775082,1892.3809352172138,131530.20803296805,1384,1,231.23076923076923,33,6,16,35.886983553951055,0.6231060606060606,45.40441176470588,1018.3823529411761,30.86007130124776,0
2169,4,0,1,38,0.0,0.02564102564102564,0.9743589743589743,39,1250,900,350,0.72,16,9,7,372.5814927437041,0.4604982006297796,0.2504271448221411,0.2095833917910118,129762.65889321406,1869.433030565152,131632.0919237792,1385,2,232.23076923076923,33,6,17,35.79153636436531,0.6243686868686869,45.28186274509803,1018.8725490196072,30.874925727866884,0
2170,4,0,0,38,0.0,0.0,1.0,38,1100,600,500,0.5454545454545454,16,6,10,375.8643913048997,0.45945945945945943,0.23476745583463532,0.2126150645851851,129981.25908604868,2171.0653654844346,132152.32445153312,1386,3,224.3684210526316,33,5,18,35.48539338220566,0.6265782828282829,45.067401960784316,1019.7303921568631,30.900920974450397,0
2171,4,0,0,38,0.0,0.0,1.0,38,900,500,400,0.5555555555555556,13,5,8,374.62282518211805,0.45944464201043145,0.23418586119227447,0.21208239123575415,130012.5027032872,2141.1302143406424,132153.63291762784,1387,4,225.3684210526316,33,5,18,35.485259953536826,0.6268939393939394,45.036764705882355,1019.8529411764706,30.90463458110517,0
2172,4,1,1,38,0.02564102564102564,0.02564102564102564,0.9743589743589743,39,900,600,300,0.6666666666666666,12,6,6,363.5499097851047,0.4600202429149798,0.22590885449360587,0.20762524142054775,130353.7485827664,1678.0187074829862,132031.76729024938,1388,0,220.56410256410257,34,5,19,35.42103831506955,0.6280637254901961,44.70238095238095,1021.1904761904759,30.035014005602232,0
2173,4,0,1,37,0.0,0.02631578947368421,0.9736842105263158,38,850,600,250,0.7058823529411765,11,6,5,365.6845657678613,0.4588223091512565,0.22593928021732057,0.20966403660558144,130505.75573979593,1944.7881235827713,132450.5438633787,1389,1,225.28947368421052,34,4,16,35.21228979766205,0.6295955882352942,44.55357142857143,1021.7857142857144,30.052521008403367,0
2174,4,0,0,37,0.0,0.0,1.0,37,1400,1200,200,0.8571428571428571,16,12,4,370.15017709259257,0.45773898898898896,0.2215412920110904,0.2132964832638534,130700.81218762034,2275.785755478686,132976.597943099,1390,2,231.21621621621622,33,4,16,34.90032758069672,0.6338383838383839,44.36274509803923,1022.5490196078447,30.986333927510444,0
2175,4,0,1,36,0.0,0.02702702702702703,0.972972972972973,37,1050,700,350,0.6666666666666666,14,7,7,368.870804515167,0.45748873873873874,0.22261513850298886,0.21290426932804893,130763.47588667837,2246.96571030375,133010.44159698213,1391,3,232.21621621621622,33,4,17,34.86949836248902,0.634469696969697,44.301470588235304,1022.7941176470601,30.993761140820006,0
2176,4,0,1,35,0.0,0.027777777777777776,0.9722222222222222,36,1200,900,300,0.75,15,9,6,375.64378639745877,0.45739087301587306,0.196924362499326,0.20005215601166979,127586.77551903109,2385.435890042284,129972.21140907337,1392,4,236.44444444444446,33,3,15,37.93870289503477,0.6022727272727273,47.42647058823529,1010.2941176470584,30.614973262032073,8
2177,4,0,0,35,0.0,0.0,1.0,35,850,400,450,0.47058823529411764,13,4,9,382.0711949813923,0.455812324929972,0.20022497187851562,0.20338999541225022,127569.89282024796,2748.1562786960567,130318.04909894401,1393,5,243.4857142857143,32,3,15,37.793713285839274,0.6044921875,47.44318181818182,1010.2272727272729,31.569602272727277,0
2178,4,3,1,37,0.07894736842105263,0.02631578947368421,0.9736842105263158,38,800,500,300,0.625,11,5,6,376.2681820458832,0.4583629682313893,0.1418297571327516,0.19971881853023649,127452.38803854867,2080.9308296321146,129533.31886818078,1394,0,225.18421052631578,34,4,17,38.060991904425045,0.5986519607843137,47.5595238095238,1009.761904761904,29.698879551820706,8
2179,4,2,0,39,0.05128205128205128,0.0,1.0,39,1050,700,350,0.6666666666666666,14,7,7,364.4628338407105,0.45962663067926224,0.14320066405949117,0.19653007878789128,128087.5274556651,1536.6286472283036,129624.15610289341,1395,0,217.7948717948718,36,3,19,37.70789298030926,0.6009837962962963,46.931306306306304,1012.2747747747746,28.11874374374374,0
2180,4,0,0,39,0.0,0.0,1.0,39,1000,800,200,0.8,12,8,4,363.64468130503155,0.4598515519568151,0.14241084585912178,0.19682536286745794,128237.60880730955,1526.622922012228,129764.23172932178,1396,1,218.7948717948718,33,6,19,37.574989917322036,0.6089015151515151,46.78308823529411,1012.8676470588224,30.692959001782498,0
2181,4,2,1,40,0.04878048780487805,0.024390243902439025,0.975609756097561,41,1200,800,400,0.6666666666666666,16,8,8,345.603459136046,0.46130589430894314,0.15156910388717826,0.1897240913917367,128800.9863748883,702.8132862592195,129503.79966114752,1397,0,209.0731707317073,36,5,18,37.45701131573107,0.6082175925925926,46.22747747747747,1015.0900900900892,28.196946946946923,0
2182,4,0,0,40,0.0,0.0,1.0,40,1250,800,450,0.64,17,8,9,350.2565681012276,0.4594284188034188,0.15302874743326522,0.1916572456913456,128672.41753472206,1013.6718749999801,129686.08940972204,1398,1,215.25,35,5,18,37.47005475701574,0.6089285714285715,46.35416666666666,1014.583333333332,28.9880952380952,0
2183,4,1,0,41,0.024390243902439025,0.0,1.0,41,1100,1000,100,0.9090909090909091,12,10,2,359.9131697223209,0.45995934959349594,0.2115738610216289,0.19075397995283,127392.29024943303,1024.2860685940918,128416.57631802713,1399,0,210.97560975609755,34,7,16,38.53552476415093,0.5980392156862745,47.61904761904761,1009.523809523809,29.691876750700263,8
2184,4,1,0,42,0.023809523809523808,0.0,1.0,42,1200,900,300,0.75,15,9,6,349.0701583824872,0.46210801393728224,0.21110093143991482,0.18631299651564043,127676.2099194101,513.5909636488309,128189.80088305894,1400,0,206.92857142857142,35,7,17,38.51828523438693,0.5988095238095238,47.33796296296296,1010.6481481481478,28.875661375661366,0
2185,4,0,0,42,0.0,0.0,1.0,42,900,400,500,0.4444444444444444,14,4,10,348.1598022418857,0.46210801393728224,0.20870531570097084,0.1861483350044912,127745.77100326677,495.18847394691477,128240.95947721368,1401,1,207.92857142857142,36,6,17,38.4700716646244,0.5975115740740741,47.26914414414414,1010.9234234234234,28.081206206206204,0
2186,4,0,2,40,0.0,0.047619047619047616,0.9523809523809523,42,1100,600,500,0.5454545454545454,16,6,10,350.9280707932995,0.46166037553232675,0.2060345741860221,0.18802709282361757,127831.16731596459,571.9089866893871,128403.07630265398,1402,2,208.92857142857142,36,6,18,38.31268559762435,0.5983796296296297,47.18468468468468,1011.261261261261,28.090590590590583,0
2187,4,0,2,38,0.0,0.05,0.95,40,1050,600,450,0.5714285714285714,15,6,9,356.9851490670056,0.46181891025641025,0.19939917601281776,0.19137032101518367,127851.72994898826,1128.2337748628165,128979.96372385108,1403,3,215.525,35,5,19,38.13849469748989,0.6005952380952381,47.16435185185185,1011.3425925925919,28.895502645502628,0
2188,4,1,0,39,0.02564102564102564,0.0,1.0,39,1100,600,500,0.5454545454545454,16,6,10,369.178401289965,0.4622975708502024,0.22994210090984368,0.1984844762654901,127968.81028163558,1648.664158950594,129617.47444058617,1404,0,221.64102564102564,35,4,20,37.7101921757035,0.6017857142857144,47.0486111111111,1011.8055555555537,28.908730158730105,0
2189,4,2,2,39,0.04878048780487805,0.04878048780487805,0.9512195121951219,41,1200,600,600,0.5,18,6,12,354.639796801172,0.46316056910569103,0.22554246674187772,0.19339448073958904,128536.57171201808,917.1984245086818,129453.77013652676,1405,0,211.78048780487805,34,7,17,37.49755419895124,0.6096813725490196,46.488095238095234,1014.0476190476186,29.82492997198878,0
2190,4,1,0,40,0.025,0.0,1.0,40,950,600,350,0.631578947368421,13,6,7,357.155555888248,0.46300747863247865,0.24545143638850897,0.1963012867325632,128848.62075617274,1203.8001543209755,130052.4209104937,1406,0,216.825,35,5,19,37.115253077975375,0.6107142857142858,46.18055555555555,1015.2777777777769,29.007936507936485,0
2191,4,0,0,40,0.0,0.0,1.0,40,1050,400,650,0.38095238095238093,17,4,13,361.9829059829061,0.4623263888888889,0.2430000000000001,0.19939736346515985,128936.76757812477,1334.5811631944157,130271.34874131918,1407,1,217.825,35,5,19,36.90277777777777,0.6116071428571428,46.093749999999986,1015.6249999999982,29.017857142857093,0
2192,4,0,0,40,0.0,0.0,1.0,40,800,500,300,0.625,11,5,6,360.4388555860882,0.46220619658119655,0.23904238350233653,0.19884172441729048,128995.54887099174,1299.0016021518982,130294.55047314364,1408,2,218.825,35,5,20,36.88202593900726,0.6122023809523809,46.03587962962962,1015.8564814814798,29.024470899470852,0
2193,4,1,0,41,0.024390243902439025,0.0,1.0,41,1150,800,350,0.6956521739130435,15,8,7,353.2996644366913,0.4636178861788618,0.238906713145421,0.19650616778921776,129319.0854338133,937.8419978137758,130256.92743162709,1409,0,214.46341463414635,35,6,21,36.73380367167351,0.6154761904761905,45.71759259259259,1017.1296296296285,29.060846560846528,0
2194,4,1,1,41,0.023809523809523808,0.023809523809523808,0.9761904761904762,42,1100,900,200,0.8181818181818182,13,9,4,346.90895464452217,0.4641163375919473,0.24328564058831592,0.1949154288021336,129717.10519641277,600.0050726402258,130317.110269053,1410,0,210.33333333333334,36,6,17,36.491727467020425,0.6174768518518519,45.326576576576585,1018.6936936936949,28.29704704704708,0
2195,4,0,1,40,0.0,0.024390243902439025,0.975609756097561,41,1200,800,400,0.6666666666666666,16,8,8,356.10230169664015,0.46166158536585367,0.25023763929265197,0.2000035965049222,129701.96926708252,1037.4339581189959,130739.40322520152,1411,1,216.4390243902439,35,6,17,36.27298507745332,0.6193452380952381,45.34143518518518,1018.6342592592596,29.10383597883599,0
2196,4,1,1,40,0.024390243902439025,0.024390243902439025,0.975609756097561,41,1300,1100,200,0.8461538461538461,15,11,4,357.9458725158879,0.4625508130081301,0.25331971399387165,0.20256012092084036,129996.88042534703,1106.3693576388653,131103.2497829859,1412,0,216.390243902439,35,6,18,35.926327885597544,0.6223214285714286,45.05208333333332,1019.791666666665,29.136904761904717,0
2197,4,0,0,40,0.0,0.0,1.0,40,1350,900,450,0.6666666666666666,18,9,9,364.2437901518256,0.4616720085470085,0.2543540474243666,0.2052857858781948,129837.58680555549,1458.5069444444355,131296.0937499999,1413,1,222.625,34,6,18,35.92770509675659,0.6228553921568627,45.20833333333333,1019.1666666666661,29.975490196078415,0
2198,4,0,0,40,0.0,0.0,1.0,40,1100,900,200,0.8181818181818182,13,9,4,363.70681396920435,0.4611778846153846,0.25418855808523055,0.20562038690734216,129958.94451530604,1453.3907312925057,131412.33524659855,1414,2,223.625,34,6,20,35.81800934033859,0.6240808823529411,45.08928571428571,1019.6428571428565,29.98949579831931,0
2199,4,0,1,39,0.0,0.025,0.975,40,1450,900,550,0.6206896551724138,20,9,11,365.15221662657325,0.46005608974358975,0.2534231423709583,0.2072644423414839,130114.93866008664,1502.3516535922556,131617.2903136789,1415,3,224.625,35,5,21,35.62263660427302,0.6235119047619048,44.936342592592595,1020.2546296296301,29.15013227513229,0
2200,4,0,0,39,0.0,0.0,1.0,39,850,500,350,0.5882352941176471,12,5,7,372.8972313642834,0.457461763382816,0.2574639151804692,0.21098003195947485,129989.2928004534,1894.529478458037,131883.82227891145,1416,4,231.0,34,5,21,35.552864036111764,0.6243872549019608,45.0595238095238,1019.7619047619038,29.99299719887952,0
2201,4,0,0,39,0.0,0.0,1.0,39,1300,1000,300,0.7692307692307693,16,10,6,370.82295074688665,0.4572368421052631,0.25479878412379864,0.21048321383347113,130114.93866008661,1849.9210980367004,131964.85975812332,1417,5,232.0,35,4,21,35.47799678578182,0.6235119047619048,44.936342592592595,1020.2546296296299,29.150132275132282,0
2202,4,0,0,39,0.0,0.0,1.0,39,1100,800,300,0.7272727272727273,14,8,6,369.0316529711155,0.4568151147098516,0.2550959284912564,0.2099432977999546,130203.5175004287,1809.843857167356,132013.36135759606,1418,6,233.0,35,4,21,35.433677326680275,0.6244047619047619,44.84953703703704,1020.6018518518521,29.160052910052915,0
2203,4,0,0,39,0.0,0.0,1.0,39,1150,900,250,0.782608695652174,14,9,5,370.34568929612675,0.4563371569950518,0.2585034013605445,0.21101091599430477,130262.5868055555,1848.4642918381307,132111.05109739365,1419,7,234.0,33,6,21,35.34013605442176,0.6294191919191919,44.791666666666664,1020.8333333333329,30.934343434343422,0
2204,4,1,0,40,0.025,0.0,1.0,40,1000,700,300,0.7,13,7,6,364.8404103527893,0.4560096153846154,0.2684804753820036,0.21026516800175407,130706.03358892731,1537.3685860339306,132243.40217496123,1420,0,229.125,35,5,19,35.03077249575551,0.6294642857142857,44.35763888888888,1022.5694444444432,29.216269841269806,0
2205,4,0,0,40,0.0,0.0,1.0,40,1550,1100,450,0.7096774193548387,20,11,9,363.95524473706774,0.4556223290598291,0.2701827791235416,0.21000263867230282,130751.61944038619,1517.5475306387304,132269.1669710249,1421,1,230.125,36,4,19,35.00720289216765,0.6278935185185186,44.313063063063055,1022.7477477477466,28.409659659659628,0
2206,4,0,1,39,0.0,0.025,0.975,40,1600,1000,600,0.625,22,10,12,366.4383210021574,0.4552083333333334,0.26969630281690127,0.21238465951961769,130924.43795146496,1595.146244217188,132519.58419568214,1422,2,231.125,36,4,21,34.76860512030515,0.6296296296296297,44.14414414414414,1023.4234234234233,28.428428428428425,0
2207,4,0,1,38,0.0,0.02564102564102564,0.9743589743589743,39,1200,700,500,0.5833333333333334,17,7,10,374.7820659868291,0.45434098065677014,0.26858713425877623,0.21749163986794728,130972.46334876542,2017.2260802469114,132989.68942901233,1423,3,236.33333333333334,35,4,22,34.50644504748982,0.6321428571428571,44.09722222222222,1023.6111111111111,29.246031746031747,0
2208,4,1,0,39,0.02564102564102564,0.0,1.0,39,1550,1200,350,0.7741935483870968,19,12,7,365.4177265672268,0.4558591992802519,0.20932210300679177,0.20569933917505523,129790.4074502743,1686.025377229073,131476.43282750336,1424,0,215.87179487179486,35,4,17,35.945782220202936,0.6202380952380953,45.254629629629626,1018.9814814814811,29.113756613756603,8
2209,4,0,0,39,0.0,0.0,1.0,39,1150,700,450,0.6086956521739131,16,7,9,361.8706798624981,0.45543747188484035,0.2028226088171592,0.204317753091595,129908.37191358021,1602.0061728395,131510.37808641972,1425,1,216.87179487179486,35,4,17,35.916212534059945,0.6214285714285714,45.138888888888886,1019.4444444444441,29.126984126984116,0
2210,4,0,0,39,0.0,0.0,1.0,39,1250,900,350,0.72,16,9,7,362.7585395221116,0.45566239316239315,0.2084979257811943,0.2051704294423937,129975.34855379042,1629.9335230500933,131605.28207684052,1426,2,217.87179487179486,36,3,17,35.82551076753176,0.6200810185185186,45.073198198198206,1019.7072072072084,28.325200200200232,0
2211,4,0,0,39,0.0,0.0,1.0,39,1350,900,450,0.6666666666666666,18,9,9,363.35149185627654,0.455634278002699,0.2078233863593253,0.20580828403641638,130032.77084094236,1649.5202550523568,131682.29109599473,1427,3,218.87179487179486,36,3,17,35.752042618968744,0.6206597222222222,45.016891891891895,1019.9324324324331,28.331456456456475,0
2212,4,0,0,39,0.0,0.0,1.0,39,1000,600,400,0.6,14,6,8,363.0906835680096,0.4549876293297346,0.21129155948712275,0.20626737829528097,130147.65346004779,1651.0800919162268,131798.73355196402,1428,4,219.87179487179486,36,3,17,35.64199131810322,0.6218171296296297,44.90427927927927,1020.3828828828821,28.343968968968948,0
2213,4,1,0,40,0.025,0.0,1.0,40,1100,800,300,0.7272727272727273,14,8,6,355.8403314423681,0.45428685897435894,0.21680922170612948,0.20382885176130947,130469.4348663621,1285.3588419930911,131754.7937083552,1429,0,215.35,35,5,18,35.50057116423096,0.6270833333333333,44.58912037037036,1021.6435185185169,29.189814814814767,0
2214,4,0,0,40,0.0,0.0,1.0,40,850,500,350,0.5882352941176471,12,5,7,353.9239257878865,0.45407318376068373,0.21575668328047182,0.2028857413542504,130498.99798525349,1237.3435356652615,131736.34152091874,1430,1,216.35,35,5,18,35.51955897900619,0.6273809523809524,44.56018518518517,1021.759259259257,29.19312169312163,0
2215,4,0,0,40,0.0,0.0,1.0,40,900,500,400,0.5555555555555556,13,5,8,352.4855269376184,0.4531917735042735,0.21542119565217432,0.20267917798913035,130617.28395061703,1208.140432098734,131825.42438271575,1431,2,217.35,35,5,18,35.43648097826086,0.6285714285714286,44.44444444444443,1022.2222222222201,29.206349206349145,0
2216,4,0,0,40,0.0,0.0,1.0,40,1000,500,500,0.5,15,5,10,351.54159805210725,0.45247061965811963,0.21318737270875787,0.20306697016892272,130794.81336805524,1195.9635416666285,131990.77690972187,1432,3,218.35,35,5,18,35.28088934147996,0.6303571428571428,44.270833333333314,1022.9166666666641,29.226190476190403,0
2217,4,0,1,39,0.0,0.025,0.975,40,1150,700,450,0.6086956521739131,16,7,9,353.90458586554087,0.4513888888888889,0.20810719131614697,0.20537612581330988,130972.4633487653,1270.3510802468968,132242.8144290122,1433,4,219.35,35,5,19,35.04070556309361,0.6321428571428571,44.097222222222214,1023.6111111111102,29.24603174603172,0
2218,4,1,2,38,0.025,0.05,0.95,40,950,700,250,0.7368421052631579,12,7,5,349.3488034085241,0.4513888888888889,0.20401039313149627,0.2039865176630775,131209.51753257884,1167.5775891632368,132377.09512174208,1434,0,217.825,35,5,21,34.91772104232565,0.6345238095238095,43.86574074074074,1024.537037037037,29.27248677248677,0
2219,4,1,0,39,0.02564102564102564,0.0,1.0,39,1150,700,450,0.6086956521739131,16,7,9,352.3017554214488,0.4502361673414305,0.18864928655723645,0.20651746209533395,131359.5300635572,1455.6921902218128,132815.222253779,1435,0,190.87179487179486,33,6,22,34.690550906555075,0.6404671717171717,43.71936274509803,1025.122549019607,31.06431966726082,0
2220,4,0,0,39,0.0,0.0,1.0,39,1250,700,550,0.56,18,7,11,353.58921202515376,0.45003936122357174,0.18904548700174395,0.2076126973343481,131422.35145436839,1493.9051386485783,132916.25659301697,1436,1,191.87179487179486,33,6,22,34.59411477630372,0.6410984848484849,43.65808823529411,1025.3676470588225,31.07174688057038,0
2221,4,0,0,39,0.0,0.0,1.0,39,1100,800,300,0.7272727272727273,14,8,6,350.93849014983937,0.4484649122807018,0.19064943178164295,0.20707596744359436,131610.9057363754,1437.4665092752825,133048.37224565068,1437,2,192.87179487179486,33,6,19,34.47178928301288,0.6429924242424243,43.474264705882355,1026.1029411764705,31.094028520499105,0
2222,4,0,1,38,0.0,0.02564102564102564,0.9743589743589743,39,750,500,250,0.6666666666666666,10,5,5,350.93849014983937,0.4484649122807018,0.19064943178164295,0.20707596744359436,131610.9057363754,1437.4665092752825,133048.37224565068,1438,3,193.87179487179486,33,6,19,34.47178928301288,0.6429924242424243,43.474264705882355,1026.1029411764705,31.094028520499105,0
2223,4,0,1,37,0.0,0.02631578947368421,0.9736842105263158,38,850,500,350,0.5882352941176471,12,5,7,358.28793290409277,0.44739805595068755,0.1925289590297754,0.21092254832701823,131522.3255280075,1824.5724288338097,133346.8979568413,1439,4,198.44736842105263,32,6,22,34.37269202363367,0.64453125,43.56060606060607,1025.757575757577,32.05492424242428,0
2224,4,1,3,35,0.02631578947368421,0.07894736842105263,0.9210526315789473,38,1250,900,350,0.72,16,9,7,349.6002863620092,0.4472350640113798,0.18741325931461472,0.20765414599574772,131862.521701389,1619.8350694444532,133482.35677083346,1440,0,196.81578947368422,33,5,20,34.252450980392155,0.6455176767676767,43.22916666666667,1027.0833333333342,31.1237373737374,0
2225,4,0,1,34,0.0,0.02857142857142857,0.9714285714285714,35,950,400,550,0.42105263157894735,15,4,11,365.53151509374845,0.44614845938375347,0.17315761729045875,0.21628611482621385,131716.66953627198,2629.3187557392316,134345.9882920112,1441,1,205.14285714285714,32,3,20,33.990621156211574,0.646484375,43.37121212121213,1026.5151515151529,32.07859848484853,0
2226,4,0,0,34,0.0,0.0,1.0,34,1200,1000,200,0.8333333333333334,14,10,4,373.84111932799084,0.4457070707070707,0.17136458644371433,0.22049910331621028,131595.18771701402,3039.1384548611295,134634.32617187515,1442,2,176.61764705882354,31,3,20,33.90016920473774,0.6478494623655914,43.48958333333334,1026.0416666666679,33.09811827956993,0
2227,4,0,0,34,0.0,0.0,1.0,34,850,400,450,0.47058823529411764,13,4,9,377.40283321762706,0.44431446821152704,0.17299370280836834,0.22338167695854155,131728.82080078137,3142.9660373264032,134871.78683810777,1443,3,177.61764705882354,31,3,20,33.67368510062573,0.6491935483870968,43.35937500000001,1026.562500000001,33.11491935483874,0
2228,4,1,0,35,0.02857142857142857,0.0,1.0,35,800,700,100,0.875,9,7,2,364.6951490423911,0.44373249299719886,0.17717442778216252,0.21857556945918144,132203.1572830579,2642.770029843896,134845.9273129018,1444,0,173.5142857142857,32,3,21,33.521332105586225,0.6513671875,42.89772727272727,1028.4090909090912,32.1377840909091,0
2229,4,1,0,36,0.027777777777777776,0.0,1.0,36,1050,900,150,0.8571428571428571,12,9,3,358.633951546719,0.44451058201058197,0.17576064104089895,0.21696192187523972,132555.70461180792,2307.7952289984623,134863.49984080638,1445,0,169.66666666666666,33,3,22,33.32230056725775,0.6524621212121212,42.55514705882353,1029.7794117647056,31.205436720142593,0
2230,4,0,0,36,0.0,0.0,1.0,36,900,500,400,0.5555555555555556,13,5,8,359.2258259195716,0.444212962962963,0.17805013485641763,0.21750243811441505,132587.25610342182,2325.753316032294,134913.00941945412,1446,1,170.66666666666666,33,3,22,33.275325241948266,0.6527777777777778,42.52450980392157,1029.901960784314,31.209150326797396,0
2231,4,0,0,36,0.0,0.0,1.0,36,1050,700,350,0.6666666666666666,14,7,7,359.9199161916738,0.44394841269841273,0.17926375248732285,0.21860399120273233,132704.48022959172,2352.5970804988506,135057.07731009056,1447,2,171.66666666666666,34,2,18,33.13956287309839,0.6516544117647058,42.41071428571428,1030.357142857142,30.30462184873947,0
2232,4,0,1,35,0.0,0.027777777777777776,0.9722222222222222,36,1150,900,250,0.782608695652174,14,9,5,360.812561982404,0.4434193121693122,0.1770404168752331,0.219504873442141,132765.81809807237,2380.714994331049,135146.5330924034,1448,3,172.66666666666666,34,2,18,33.05489777059028,0.6522671568627452,42.35119047619047,1030.5952380952367,30.311624649859905,0
2233,4,0,0,35,0.0,0.0,1.0,35,800,600,200,0.75,10,6,4,369.9530144269104,0.44268207282913163,0.18354380895725408,0.22418565870642967,132618.81134960105,2812.5458056997295,135431.35715530076,1449,5,178.5142857142857,33,2,21,32.96735574063057,0.6530934343434344,42.493872549019606,1030.024509803921,31.212863933452155,0
2234,4,0,0,35,0.0,0.0,1.0,35,1100,800,300,0.7272727272727273,14,8,6,370.8492778092805,0.44254201680672267,0.1872540022432958,0.2249176788791349,132650.37035034588,2838.6588091118624,135489.02915945774,1450,6,179.5142857142857,33,2,18,32.91250297406614,0.6534090909090908,42.46323529411764,1030.1470588235281,31.216577540106915,0
2235,4,0,0,35,0.0,0.0,1.0,35,900,500,400,0.5555555555555556,13,5,8,371.51427082759284,0.44201680672268906,0.1942204780592227,0.22589034731664684,132745.06987997395,2863.3375684832686,135608.4074484572,1451,7,180.5142857142857,33,2,18,32.80005054108695,0.6543560606060606,42.37132352941176,1030.5147058823522,31.22771836007128,0
2236,4,0,1,34,0.0,0.02857142857142857,0.9714285714285714,35,1150,1100,50,0.9565217391304348,12,11,1,370.3009310629043,0.44131652661064424,0.1854884447538676,0.2259131060937064,132871.38848339568,2840.4797734044478,135711.86825680014,1452,8,181.5142857142857,33,2,18,32.704222631641514,0.6556186868686869,42.248774509803916,1031.0049019607834,31.242572786690406,0
2237,4,0,0,34,0.0,0.0,1.0,34,950,700,250,0.7368421052631579,12,7,5,380.1620661426957,0.44106506238859183,0.19390872086740374,0.23181652502278685,132853.2025590503,3301.1495957045436,136154.35215475483,1453,9,185.8235294117647,32,2,18,32.468360889977546,0.6578776041666667,42.26641414141415,1030.934343434345,32.21669823232328,0
2238,4,0,1,33,0.0,0.029411764705882353,0.9705882352941176,34,700,400,300,0.5714285714285714,10,4,6,386.48430483742993,0.44047088532382656,0.2281916210801198,0.22001818922444555,130229.35867309583,3295.1163217299295,133524.47499482575,1454,10,186.8235294117647,31,3,20,34.96207530722456,0.6340725806451613,44.82421875000001,1020.703125000001,32.92590725806455,8
2239,4,0,0,33,0.0,0.0,1.0,33,850,600,250,0.7058823529411765,11,6,5,394.33389481024346,0.43943339646464646,0.2155139381166784,0.22408554860773713,130159.7005434154,3665.2763325239885,133824.97687593938,1455,11,188.66666666666666,30,3,20,34.8327186512118,0.6361111111111111,44.89247311827957,1020.4301075268814,34.014336917562716,0
2240,4,0,0,33,0.0,0.0,1.0,33,850,600,250,0.7058823529411765,11,6,5,412.0956563268064,0.43892045454545453,0.19236735960285434,0.22955138270675715,129377.95380015431,4082.300423499505,133460.2542236538,1456,12,189.66666666666666,29,4,20,35.17846985210466,0.6311063218390804,45.65972222222222,1017.3611111111111,35.08141762452107,8
2241,4,1,1,33,0.029411764705882353,0.029411764705882353,0.9705882352941176,34,1050,800,250,0.7619047619047619,13,8,5,401.37732730773786,0.4392825311942959,0.203424264512027,0.2268888528283532,129954.0499624235,3632.12184934676,133586.17181177024,1457,0,185.05882352941177,30,4,18,34.86274057474295,0.6340277777777779,45.09408602150538,1019.6236559139792,33.98745519713264,0
2242,4,0,1,32,0.0,0.030303030303030304,0.9696969696969697,33,850,700,150,0.8235294117647058,10,7,3,403.4736383884087,0.43943339646464646,0.13563471088554713,0.21751761892035304,128078.6217583551,3735.2695041232746,131813.89126247837,1458,1,169.84848484848484,31,2,16,36.729804476460004,0.612231182795699,46.94010416666667,1012.2395833333339,32.652889784946254,8
2243,4,0,0,32,0.0,0.0,1.0,32,700,300,400,0.42857142857142855,11,3,8,406.35668678875055,0.43884408602150543,0.11404942902668935,0.21906028691525273,128076.49592799741,4008.948108162786,132085.4440361602,862,2,130.59375,30,2,17,36.65903155844732,0.6149305555555555,46.942204301075265,1012.2311827956986,33.74103942652329,0
2244,4,1,0,33,0.030303030303030304,0.0,1.0,33,600,400,200,0.6666666666666666,8,4,4,397.9499386656243,0.440853851010101,0.1088355945792372,0.21667400156996877,128474.33302137593,3625.270589192718,132099.60361056865,863,0,127.60606060606061,31,2,16,36.46341724462712,0.616263440860215,46.54947916666667,1013.8020833333339,32.70329301075271,0
2245,4,1,0,34,0.029411764705882353,0.0,1.0,34,1100,600,500,0.5454545454545454,16,6,10,391.180184766974,0.4424019607843137,0.10890104425658897,0.21552420590859867,128944.78242016125,3288.128762371192,132232.91118253244,864,0,124.82352941176471,32,2,18,36.15324051052544,0.6184895833333333,46.08585858585859,1015.656565656566,31.73926767676769,0
2246,4,0,0,34,0.0,0.0,1.0,34,1100,900,200,0.8181818181818182,13,9,4,390.1913155946357,0.4419191919191919,0.11049422875898252,0.21550236901784722,129040.97995421391,3270.1339467911507,132311.11390100507,865,1,125.82352941176471,32,2,18,36.07995733399611,0.6194661458333333,45.99116161616162,1016.0353535353539,31.75110479797981,0
2247,4,1,0,35,0.02857142857142857,0.0,1.0,35,700,300,400,0.42857142857142855,11,3,8,380.08471902019954,0.4431022408963585,0.11761629507294225,0.21211179480804682,129450.69204152249,2840.4459823144907,132291.13802383697,866,0,123.2,33,2,16,35.91843288375078,0.6212121212121212,45.588235294117645,1017.6470588235294,30.83778966131907,0
2248,4,0,0,35,0.0,0.0,1.0,35,1200,900,300,0.75,15,9,6,383.0962447457994,0.4431022408963585,0.12068230277185554,0.2144719407916508,129575.43372741232,2927.972414455957,132503.40614186827,867,1,124.2,33,2,16,35.71457229979137,0.6224747474747474,45.46568627450979,1018.1372549019591,30.852644087938152,0
2249,4,0,1,34,0.0,0.02857142857142857,0.9714285714285714,35,800,600,200,0.75,10,6,4,381.0605636919966,0.44320728291316525,0.12210323667428735,0.21384161680244299,129669.02941476816,2882.350688437114,132551.38010320527,868,2,125.2,33,2,16,35.67097320819796,0.6234217171717171,45.37377450980391,1018.5049019607827,30.863784907902506,0
2250,4,0,0,34,0.0,0.0,1.0,34,600,400,200,0.6666666666666666,8,4,4,392.94421676621215,0.442346256684492,0.11932054339028353,0.22059018765852684,129683.21352731851,3391.6537534435124,133074.86728076203,869,3,123.97058823529412,32,2,16,35.353910995413415,0.6259765625,45.35984848484848,1018.560606060605,31.830018939393906,0
2251,4,0,0,34,0.0,0.0,1.0,34,850,600,250,0.7058823529411765,11,6,5,390.38458138399585,0.44180778371954843,0.118754736780738,0.22005477241142563,129844.02101826345,3337.820758085907,133181.84177634935,870,4,124.97058823529412,32,2,18,35.25509993392797,0.6276041666666667,45.2020202020202,1019.1919191919193,31.849747474747478,0
2252,4,0,0,34,0.0,0.0,1.0,34,1250,1100,150,0.88,14,11,3,390.4713263365498,0.441677807486631,0.027608338195513005,0.20861864462151689,127716.42261081295,3224.588644936366,130941.01125574931,871,5,125.97058823529412,31,3,19,37.430895487139864,0.6085349462365591,47.29817708333335,1010.8072916666686,32.60668682795705,8
2253,4,1,0,35,0.02857142857142857,0.0,1.0,35,1150,1000,150,0.8695652173913043,13,10,3,377.82180900607943,0.4422268907563025,0.026102292768959368,0.2040237768632832,128144.53125000023,2683.1597222222504,130827.69097222248,872,0,123.34285714285714,32,3,20,37.311385459533604,0.6103515625,46.875000000000014,1012.5000000000018,31.640625000000057,0
2254,4,0,0,35,0.0,0.0,1.0,35,900,600,300,0.6666666666666666,12,6,6,377.82180900607943,0.4422268907563025,0.026102292768959368,0.2040237768632832,128144.53125000023,2683.1597222222504,130827.69097222248,873,1,124.34285714285714,32,3,20,37.311385459533604,0.6103515625,46.875000000000014,1012.5000000000018,31.640625000000057,0
2255,4,0,0,35,0.0,0.0,1.0,35,1050,700,350,0.6666666666666666,14,7,7,377.96862666560014,0.44208683473389354,0.019275563628593506,0.20459273435299907,128240.42986685039,2694.1718319559386,130934.60169880633,874,2,125.34285714285714,32,3,20,37.20939291947147,0.611328125,46.78030303030304,1012.8787878787884,31.65246212121214,0
2256,4,0,0,35,0.0,0.0,1.0,35,950,800,150,0.8421052631578947,11,8,3,377.0055026639877,0.4424719887955182,0.015508678237649898,0.20456180925480083,128336.3643537651,2676.7031106519908,131013.06746441708,875,3,126.34285714285714,32,3,21,37.135514018691566,0.6123046875,46.68560606060607,1013.2575757575771,31.664299242424285,0
2257,4,0,0,35,0.0,0.0,1.0,35,1150,900,250,0.782608695652174,14,9,5,378.50384211759683,0.4416316526610644,0.016831841716634433,0.20603439649913136,128464.33280086225,2724.8487080400064,131189.18150890226,876,4,127.34285714285714,32,3,17,36.96651720845269,0.6136067708333333,46.55934343434344,1013.762626262627,31.680082070707094,0
2258,4,0,0,35,0.0,0.0,1.0,35,1150,800,350,0.6956521739130435,15,8,7,378.6167934895068,0.4413515406162465,0.02534940787368023,0.20692566795202041,128624.38303489455,2739.87029384759,131364.25332874214,877,5,128.34285714285716,32,3,18,36.799850634802105,0.615234375,46.40151515151516,1014.3939393939406,31.699810606060645,0
2259,4,2,1,36,0.05405405405405406,0.02702702702702703,0.972972972972973,37,850,500,350,0.5882352941176471,12,5,7,337.59331064455847,0.44481981981981983,0.01171721416030147,0.18413251134792524,128543.91289515856,1279.1130234964571,129823.02591865501,878,0,122.35135135135135,36,1,18,37.92221913751619,0.6056134259259259,46.48085585585585,1014.0765765765757,28.168793793793768,8
2260,4,1,1,36,0.02702702702702703,0.02702702702702703,0.972972972972973,37,800,600,200,0.75,10,6,4,335.52472819689973,0.44575825825825827,0.026031799323724902,0.18445676520873455,128858.1486892297,1247.0190629818921,130105.1677522116,879,0,122.37837837837837,36,1,20,37.65458629103815,0.6087962962962963,46.17117117117117,1015.3153153153148,28.203203203203188,0
2261,4,0,1,35,0.0,0.027777777777777776,0.9722222222222222,36,1050,800,250,0.7619047619047619,13,8,5,342.875880927387,0.4444444444444444,0.032438011296000324,0.18873230735614135,128907.3819551612,1639.84642918381,130547.22838434501,880,1,126.58333333333333,35,1,20,37.417844388724255,0.6113095238095239,46.12268518518518,1015.5092592592594,29.014550264550266,0
2262,4,0,0,35,0.0,0.0,1.0,35,1000,700,300,0.7,13,7,6,348.92366641973933,0.44397759103641454,0.03825154915424589,0.1920205725522824,128898.98667800458,1995.181405895703,130894.1680839003,881,2,129.34285714285716,34,1,20,37.27286049237986,0.6133578431372548,46.13095238095239,1015.4761904761908,29.866946778711494,0
2263,4,0,0,35,0.0,0.0,1.0,35,1250,900,350,0.72,16,9,7,347.4451886691511,0.4435924369747899,0.03970467596390548,0.19164510632927376,128989.6701388888,1963.3680555555507,130953.03819444435,882,3,130.34285714285716,34,1,21,37.21800656275638,0.6142769607843137,46.041666666666664,1015.8333333333326,29.877450980392133,0
2264,4,0,0,35,0.0,0.0,1.0,35,1300,1200,100,0.9230769230769231,14,12,2,347.01951083699913,0.44285714285714284,0.03859502334376419,0.1919964720684032,129110.6310232426,1960.7816043083817,131071.41262755099,883,4,131.34285714285716,34,1,22,37.10563820233493,0.6155024509803921,45.922619047619044,1016.3095238095235,29.891456582633044,0
2265,4,0,1,34,0.0,0.02857142857142857,0.9714285714285714,35,1400,1100,300,0.7857142857142857,17,11,6,347.44411622740637,0.4419467787114846,0.039125562413233395,0.19282132532152566,129231.64859693882,1980.1551870748344,131211.80378401364,884,5,132.34285714285716,34,1,23,36.971666081255115,0.6167279411764706,45.80357142857143,1016.7857142857147,29.90546218487396,0
2266,4,0,0,34,0.0,0.0,1.0,34,950,800,150,0.8421052631578947,11,8,3,352.05562076240034,0.44019236482471774,-0.0008498504956884201,0.18645094368796922,127362.24666950083,2167.7189625849937,129529.96563208583,885,6,134.76470588235293,34,0,16,38.764644022486905,0.5977328431372548,47.648809523809504,1009.4047619047595,29.688375350139985,8
2267,4,2,0,36,0.05555555555555555,0.0,1.0,36,1100,800,300,0.7272727272727273,14,8,6,359.38183408660166,0.4464285714285714,0.07279162819329055,0.1827279466271311,125695.4089506172,1847.7131361803868,127543.1220867976,886,0,128.22222222222223,35,1,18,40.296052631578945,0.5785714285714285,49.30555555555555,1002.777777777777,28.65079365079363,8
2268,4,2,1,37,0.05263157894736842,0.02631578947368421,0.9736842105263158,38,1100,800,300,0.7272727272727273,14,8,6,363.75555808839033,0.4493835941204362,0.06031477603648372,0.17950410224842683,124450.8359723295,1478.0493130572845,125928.88528538679,887,0,122.42105263157895,35,3,19,41.47587770173608,0.5657738095238095,50.549768518518526,997.8009259259269,28.50859788359791,8
2269,4,1,0,38,0.02631578947368421,0.0,1.0,38,1400,900,500,0.6428571428571429,19,9,10,361.7639125248701,0.4510431484115695,0.06882682359641201,0.1799086004439826,124774.87622757902,1427.8094817790866,126202.6857093581,888,0,122.84210526315789,36,2,20,41.18927524797115,0.5671296296296297,50.22522522522523,999.0990990990999,27.752752752752777,0
2270,4,3,3,38,0.07317073170731707,0.07317073170731707,0.926829268292683,41,1350,900,450,0.6666666666666666,18,9,9,354.9507217056682,0.45685975609756097,0.09730636931422532,0.18070918521544568,125748.98184673849,727.1412776588861,126476.12312439737,889,0,114.78048780487805,38,3,20,40.35182324953842,0.5734649122807017,49.252136752136764,1002.9914529914549,26.39451192082776,0
2271,4,3,1,40,0.07317073170731707,0.024390243902439025,0.975609756097561,41,700,500,200,0.7142857142857143,9,5,4,343.88258688230457,0.45642784552845533,0.11314688441515641,0.17704157450502453,126209.04989996909,480.5641953074414,126689.61409527653,890,0,113.3170731707317,37,4,23,40.15531791066493,0.579954954954955,48.7938596491228,1004.8245614035077,27.157420578473182,0
2272,4,2,2,40,0.047619047619047616,0.047619047619047616,0.9523809523809523,42,1100,800,300,0.7272727272727273,14,8,6,331.27285972964006,0.45973674022454514,0.1366736382649818,0.17290022014460601,126769.03558514123,-0.9718113083592925,126768.06377383287,891,0,111.28571428571429,38,4,16,39.89696053469129,0.5838815789473684,48.23717948717948,1007.0512820512811,26.50134952766529,0
2273,4,2,1,41,0.047619047619047616,0.023809523809523808,0.9761904761904762,42,1050,800,250,0.7619047619047619,13,8,5,330.4797531688853,0.4587204800619435,0.1427118877744462,0.17285395851250868,126855.79562716997,-15.345594618074529,126840.45003255189,892,0,112.19047619047619,39,3,18,39.82794350808258,0.5830662393162394,48.15104166666666,1007.3958333333319,25.830662393162356,0
2274,4,2,0,43,0.046511627906976744,0.0,1.0,43,1100,500,600,0.45454545454545453,17,5,12,323.7313527910281,0.4615633074935401,0.15399022703533416,0.17086311453847988,127223.34120008671,-362.5434027777858,126860.79779730893,893,0,110.46511627906976,39,4,20,39.62151522973673,0.5868055555555556,47.78645833333333,1008.8541666666658,25.868055555555536,0
2275,4,1,1,43,0.022727272727272728,0.022727272727272728,0.9772727272727273,44,1450,1100,350,0.7586206896551724,18,11,7,321.55764595536164,0.4615266032417195,0.16320859916275143,0.17176220981052776,127707.59489225989,-586.9292831647858,127120.6656090951,894,0,108.93181818181819,40,4,13,39.18137107044707,0.5901041666666667,47.30691056910569,1010.7723577235772,25.26930894308943,0
2276,4,1,1,43,0.022727272727272728,0.022727272727272728,0.9772727272727273,44,1200,900,300,0.75,15,9,6,337.69246025811015,0.46100907329105006,0.2555652553470096,0.1738547025733329,126209.04989996941,-232.60765301599292,125976.44224695342,895,0,109.88636363636364,37,7,17,40.310817692419604,0.579954954954955,48.793859649122815,1004.8245614035103,27.15742057847325,8
2277,4,4,3,44,0.0851063829787234,0.06382978723404255,0.9361702127659575,47,1350,1000,350,0.7407407407407407,17,10,7,321.74533363683645,0.46671677459142774,0.261539121482498,0.16905263292782943,127040.78260294803,-1225.044203185931,125815.73839976211,896,0,102.34042553191489,40,7,15,39.8584509408602,0.5833333333333333,47.96747967479675,1008.1300813008135,25.203252032520336,0
2278,4,1,1,44,0.022222222222222223,0.022222222222222223,0.9777777777777777,45,1450,900,550,0.6206896551724138,20,9,11,333.9937455082262,0.4653829966329966,0.2598388464800685,0.17501272264631046,126930.47337278098,-521.2031558185486,126409.27021696242,897,0,107.5111111111111,38,7,17,39.66284987277355,0.5855263157894737,48.07692307692307,1007.6923076923069,26.51821862348176,0
2279,4,0,1,43,0.0,0.022727272727272728,0.9772727272727273,44,1100,800,300,0.7272727272727273,14,8,6,341.5469575664565,0.46427942212825934,0.25793007297249226,0.1794390130209142,127036.73846760533,-122.19769544476128,126914.54077216057,898,1,110.72727272727273,37,7,19,39.363534188963825,0.5884009009009009,47.97149122807017,1008.1140350877185,27.24632527264104,0
2280,4,3,3,43,0.06521739130434782,0.06521739130434782,0.9347826086956522,46,1250,1000,250,0.8,15,10,5,332.4593473786078,0.46505636070853457,0.2639219616243895,0.17724918306126664,127631.22420374009,-713.5492762882368,126917.67492745185,899,0,106.6086956521739,38,8,15,38.98397300345387,0.5926535087719298,47.38247863247862,1010.4700854700843,26.591318038686428,0
2281,4,1,2,42,0.022727272727272728,0.045454545454545456,0.9545454545454546,44,1350,1100,250,0.8148148148148148,16,11,5,337.4490537920138,0.46429043340380555,0.2320781972265018,0.17776334083686446,127145.88355613998,-209.34897545474433,126936.53458068523,900,0,110.0,38,6,16,39.35491701977401,0.5877192982456141,47.863247863247864,1008.5470085470087,26.54071075123707,8
2282,4,3,4,41,0.06666666666666667,0.08888888888888889,0.9111111111111111,45,1350,800,550,0.5925925925925926,19,8,11,330.08308922356235,0.46470959595959593,0.23655426076793495,0.17557957850800254,127538.80343967023,-580.3195529513854,126958.48388671884,901,0,108.31111111111112,39,6,17,39.13850073906018,0.5900106837606838,47.473958333333336,1010.1041666666674,25.900106837606856,0
2283,4,3,1,43,0.06818181818181818,0.022727272727272728,0.9772727272727273,44,950,600,350,0.631578947368421,13,6,7,336.8893924997458,0.4632113284002819,0.2561393900962703,0.18009307524477938,127739.20323800136,-193.20348454963087,127545.99975345173,902,0,111.18181818181819,38,6,19,38.76162544916509,0.59375,47.27564102564103,1010.8974358974363,26.602564102564113,0
2284,4,2,1,44,0.044444444444444446,0.022222222222222223,0.9777777777777777,45,950,700,250,0.7368421052631579,12,7,5,327.4251308956082,0.46336279461279456,0.2530822270248019,0.17646089833126058,128065.4418945314,-613.6311848958201,127451.81070963558,903,0,109.66666666666667,39,6,21,38.66773438304003,0.5953525641025641,46.95312500000001,1012.1875000000011,25.95352564102567,0
2285,4,0,0,44,0.0,0.0,1.0,44,950,600,350,0.631578947368421,13,6,7,328.371352605463,0.4616367159971811,0.2552375607931161,0.17732053040695023,128144.53125000015,-384.2013888888754,127760.32986111127,904,1,112.9090909090909,38,6,21,38.563100137174224,0.5978618421052632,46.87500000000001,1012.5000000000011,26.644736842105292,0
2286,4,0,2,42,0.0,0.045454545454545456,0.9545454545454546,44,1250,900,350,0.72,16,9,7,329.0660425242163,0.4615266032417195,0.2545416179094169,0.17781573267072542,128171.57594601516,-364.6173478705423,127806.95859814461,905,2,113.9090909090909,38,6,21,38.517927481184486,0.5981359649122807,46.8482905982906,1012.6068376068384,26.647548358074697,0
2287,4,1,0,43,0.023255813953488372,0.0,1.0,43,1500,900,600,0.6,21,9,12,328.80996734936207,0.4600867478774455,0.25656381634902314,0.17854651693553494,128366.66690712528,-158.3520891043392,128208.31481802094,906,0,116.37209302325581,37,6,22,38.325488710957224,0.6019144144144144,46.655701754385966,1013.3771929824563,27.38857278330963,0
2288,4,1,0,44,0.022727272727272728,0.0,1.0,44,950,700,250,0.7368421052631579,12,7,5,319.9490772061943,0.46090997181113463,0.2506796404606235,0.17513293292375964,128685.96734832729,-565.4086995032378,128120.55864882405,907,0,114.70454545454545,38,6,15,38.22500965217084,0.6033442982456141,46.34081196581197,1014.6367521367536,26.700967161493516,0
2289,4,0,2,42,0.0,0.045454545454545456,0.9545454545454546,44,1350,600,750,0.4444444444444444,21,6,15,317.64536144270994,0.4601722163495419,0.24302685950413205,0.17470494879349058,128875.73964497053,-612.6438198553451,128263.09582511518,908,1,115.70454545454545,38,6,16,38.09054082491583,0.6052631578947368,46.15384615384616,1015.3846153846163,26.720647773279374,0
2290,4,1,1,42,0.023255813953488372,0.023255813953488372,0.9767441860465116,43,1200,700,500,0.5833333333333334,17,7,10,325.3875327122858,0.4582641196013289,0.2534029835752676,0.1789244983916726,128867.17547706983,-213.6455447830163,128653.52993228681,909,0,119.13953488372093,37,6,17,37.9027177825774,0.6069819819819819,46.16228070175438,1015.3508771929821,27.44191559981033,0
2291,4,1,2,41,0.023255813953488372,0.046511627906976744,0.9534883720930233,43,1100,600,500,0.5454545454545454,16,6,10,326.28645921444115,0.4589562569213732,0.24580735089135053,0.18019652886929946,129038.51290269563,-179.29610453648812,128859.21679815913,910,0,119.04651162790698,38,5,18,37.70570452155624,0.606907894736842,45.993589743589745,1016.0256410256413,26.737516869095824,0
2292,4,0,0,41,0.0,0.0,1.0,41,900,400,500,0.4444444444444444,14,4,10,341.11047963782335,0.45779979674796745,0.2533055804423321,0.18685389252379472,128715.2666813772,581.2252708789764,129296.49195225617,911,1,125.4390243902439,36,5,19,37.658371249953746,0.607349537037037,46.31193693693693,1014.7522522522513,28.187562562562537,0
2293,4,1,0,42,0.023809523809523808,0.0,1.0,42,800,600,200,0.75,10,6,4,331.59844660560987,0.4586115950445219,0.24853897811096326,0.1830046215190214,129011.37689248646,155.99443439986052,129167.37132688632,912,0,123.42857142857143,38,4,20,37.59837171802152,0.6066337719298245,46.020299145299134,1015.9188034188018,26.734705353126362,0
2294,4,0,0,42,0.0,0.0,1.0,42,1350,900,450,0.6666666666666666,18,9,9,335.148648708158,0.45776471157568716,0.2510402987199982,0.18598999073054412,129230.01284646106,262.5324853245994,129492.54533178566,913,1,124.42857142857143,36,6,21,37.28587514305755,0.6125578703703703,45.805180180180166,1016.7792792792771,28.24386886886881,0
2295,4,0,1,41,0.0,0.023809523809523808,0.9761904761904762,42,1350,900,450,0.6666666666666666,18,9,9,361.99452524675195,0.45751064653503676,0.24195512622040605,0.19466698595437207,127978.05574792234,886.4750073546134,128864.53075527695,914,2,125.42857142857143,37,5,16,37.882441121225256,0.597972972972973,47.03947368421052,1011.842105263157,27.34708392603127,8
2296,4,2,3,40,0.046511627906976744,0.06976744186046512,0.9302325581395349,43,1250,1100,150,0.88,14,11,3,352.81895586157907,0.4580564784053156,0.2562282873139483,0.19164285220372088,128379.0134173523,459.2345128035315,128838.24793015583,915,0,123.37209302325581,35,8,16,37.70462159281254,0.605952380952381,46.643518518518505,1013.4259259259239,28.9550264550264,0
2297,4,0,0,40,0.0,0.0,1.0,40,1050,700,350,0.6666666666666666,14,7,7,371.51305279076416,0.4580128205128205,0.26748713550600356,0.2001775506257073,128056.65569540887,1514.9438175154207,129571.5995129243,916,1,132.1,35,5,18,37.561106346483676,0.6026785714285714,46.96180555555555,1012.1527777777771,28.918650793650777,0
2298,4,1,0,41,0.024390243902439025,0.0,1.0,41,1200,700,500,0.5833333333333334,17,7,10,368.60375577549297,0.4584095528455285,0.274248925843523,0.20065881273073558,128466.99948827561,1270.7138417352226,129737.71333001084,917,0,129.85365853658536,35,6,17,37.21469821516916,0.606845238095238,46.55671296296295,1013.7731481481459,28.964947089947024,0
2299,4,1,0,42,0.023809523809523808,0.0,1.0,42,1100,600,500,0.5454545454545454,16,6,10,363.1444620979445,0.45902293844367015,0.29061562513204064,0.19964088233384547,128858.14868922968,958.8246185374473,129816.97330776713,918,0,127.73809523809524,36,6,18,36.95351782017155,0.6087962962962963,46.17117117117117,1015.3153153153147,28.203203203203188,0
2300,4,0,0,42,0.0,0.0,1.0,42,1200,900,300,0.75,15,9,6,360.04001946893084,0.4583696283391405,0.28728750923872903,0.1985061721032858,128972.51136271407,887.0531003976943,129859.56446311176,919,1,128.73809523809524,36,6,18,36.91565040650408,0.6099537037037037,46.05855855855856,1015.7657657657658,28.215715715715717,0
2301,4,2,0,44,0.045454545454545456,0.0,1.0,44,1500,1100,400,0.7333333333333333,19,11,8,347.36956607729144,0.45878479563072583,0.30288736420811935,0.1958573085329408,129853.92011834319,221.45997698882536,130075.38009533202,920,0,123.8409090909091,38,6,17,36.34106394129981,0.6151315789473684,45.19230769230769,1019.230769230769,26.821862348178133,0
2302,4,1,1,44,0.022222222222222223,0.022222222222222223,0.9777777777777777,45,1300,1000,300,0.7692307692307693,16,10,6,343.9642998366563,0.4590277777777778,0.309818462201358,0.19584579744912253,130236.00396050366,-40.69281684025847,130195.3111436634,921,0,122.06666666666666,39,6,18,36.040348504949485,0.6172542735042735,44.81770833333334,1020.7291666666681,26.17254273504277,0
2303,4,0,1,43,0.0,0.022727272727272728,0.9772727272727273,44,1350,900,450,0.6666666666666666,18,9,9,349.00456563524017,0.4583553558844256,0.3111659354986056,0.19857299675482154,130208.06081753614,288.64154156623965,130496.70235910238,922,1,125.11363636363636,38,6,18,35.940062458564505,0.6186951754385965,44.84508547008548,1020.6196581196594,26.858412055780512,0
2304,4,0,1,42,0.0,0.023255813953488372,0.9767441860465116,43,1100,700,400,0.6363636363636364,15,7,8,426.29669443697884,0.4579872646733112,0.40602363705680444,0.2364008941877795,129201.38888888907,2461.7557893199128,131663.14467820898,923,2,128.65116279069767,32,11,18,34.99829234972675,0.62109375,45.83333333333334,1016.6666666666681,31.77083333333338,8
2305,4,1,0,43,0.023255813953488372,0.0,1.0,43,1300,1000,300,0.7692307692307693,16,10,6,424.11067414371104,0.4577796234772979,0.4173990291570171,0.23730772835674785,129554.63927469116,2389.101080246892,131943.74035493805,924,0,129.25581395348837,29,14,19,34.69190541155072,0.6329022988505747,45.4861111111111,1018.0555555555538,35.10536398467427,0
2306,4,0,0,43,0.0,0.0,1.0,43,1000,600,400,0.6,14,6,8,421.89260197508884,0.45731819859726835,0.4100793606952813,0.23682238057534966,129680.10210717985,2342.2151404786487,132022.3172476585,925,1,130.25581395348837,30,13,19,34.619952494061764,0.63125,45.36290322580644,1018.5483870967728,33.95161290322576,0
2307,4,1,0,44,0.022727272727272728,0.0,1.0,44,1500,1100,400,0.7333333333333333,19,11,8,411.3127772105676,0.45819018675123324,0.40052503335847267,0.23335522153836338,130096.48852878151,1902.0696004231822,131998.5581292047,926,0,128.27272727272728,31,13,20,34.46407679217187,0.632728494623656,44.954427083333336,1020.1822916666671,32.90910618279571,0
2308,4,2,1,45,0.043478260869565216,0.021739130434782608,0.9782608695652174,46,800,400,400,0.5,12,4,8,389.98548048770607,0.4602254428341385,0.37737079725355205,0.2248037299978602,130714.10323245089,995.4264349383424,131709.52966738923,927,0,123.65217391304348,32,14,19,34.379758817961054,0.6363932291666667,44.34974747474748,1022.6010101010111,31.956281565656596,0
2309,4,0,1,44,0.0,0.022222222222222223,0.9777777777777777,45,1550,1400,150,0.9032258064516129,17,14,3,424.81677542060424,0.45978535353535355,0.352502284577757,0.23047146320062678,128330.72015570916,1915.6242944588453,130246.344450168,928,1,127.4,33,12,17,35.93019271085308,0.6098484848484849,46.691176470588225,1013.2352941176456,30.704099821746837,8
2310,4,0,0,44,0.0,0.0,1.0,44,1200,800,400,0.6666666666666666,16,8,8,431.8698636127544,0.45917019027484146,0.3661383187315117,0.23358247984072153,128208.4596756708,2273.873998826647,130482.33367449745,929,2,131.25,32,12,17,35.87743631301167,0.6110026041666667,46.811868686868685,1012.7525252525248,31.6485164141414,0
2311,4,0,0,44,0.0,0.0,1.0,44,1350,1000,350,0.7407407407407407,17,10,7,432.0218347695971,0.4589059196617336,0.3681716202282077,0.23403856720840474,128272.40404359234,2283.2958690439527,130555.6999126363,930,3,132.25,32,12,17,35.80772985998586,0.6116536458333333,46.74873737373736,1013.0050505050492,31.656407828282788,0
2312,4,0,2,42,0.0,0.045454545454545456,0.9545454545454546,44,1550,1100,450,0.7096774193548387,20,11,9,431.37549258772765,0.4585095137420719,0.3595890410958906,0.2350030668574934,128496.3348765432,2286.033950617286,130782.36882716049,931,4,133.25,32,12,16,35.59360730593608,0.6139322916666667,46.52777777777778,1013.8888888888888,31.684027777777775,0
2313,4,0,1,41,0.0,0.023809523809523808,0.9761904761904762,42,1350,1000,350,0.7407407407407407,17,10,7,442.0000054850618,0.4574501548586914,0.3596683966612366,0.2405168861016117,128450.91376170662,2955.0609174471138,131405.97467915373,932,5,135.76190476190476,30,12,16,35.37108857067091,0.61875,46.572580645161295,1013.7096774193553,33.790322580645174,0
2314,4,0,1,40,0.0,0.024390243902439025,0.975609756097561,41,850,300,550,0.35294117647058826,14,3,11,452.05400954893577,0.45635162601626017,0.357438389401707,0.2458338421526179,128425.93557098767,3411.091820987653,131837.0273919753,933,6,137.02439024390245,29,12,16,35.14204804969397,0.6214080459770115,46.59722222222222,1013.6111111111112,34.95210727969349,0
2315,4,1,0,41,0.024390243902439025,0.0,1.0,41,1250,900,350,0.72,16,9,7,436.3212266399224,0.4568089430894309,0.3383181614154285,0.2396752163499152,128825.87808200369,3041.8930295409873,131867.7711115447,934,0,134.6829268292683,30,11,17,35.12925327684364,0.6225694444444445,46.20295698924731,1015.1881720430106,33.83960573476702,0
2316,4,0,2,39,0.0,0.04878048780487805,0.9512195121951219,41,1100,900,200,0.8181818181818182,13,9,4,414.99426873682813,0.45670731707317075,0.32026766090353376,0.21749508424620365,126937.59799416078,2335.6751309592314,129273.27312512002,935,1,135.6829268292683,33,8,19,37.61489622603267,0.5956439393939394,48.069852941176464,1007.7205882352931,30.53698752228161,8
2317,4,2,0,41,0.04878048780487805,0.0,1.0,41,1150,700,450,0.6086956521739131,16,7,9,410.79403629494715,0.4609247967479675,0.3223480977979183,0.2172696781559981,127308.35383326125,2259.5025050461372,129567.85633830739,936,0,131.78048780487805,33,8,21,37.337962962962976,0.5994318181818181,47.70220588235294,1009.1911764705882,30.581550802139034,0
2318,4,1,1,41,0.023809523809523808,0.023809523809523808,0.9761904761904762,42,1100,700,400,0.6363636363636364,15,7,8,408.84765172346226,0.4615635888501742,0.3383767023823543,0.21879918752913466,127783.17920918374,2048.7705498866285,129831.94975907037,937,0,129.61904761904762,34,8,19,36.89778837473998,0.6020220588235294,47.23214285714286,1011.0714285714291,29.73739495798321,0
2319,4,0,0,41,0.0,0.0,1.0,41,800,600,200,0.75,10,6,4,404.0262688868182,0.45937500000000003,0.3552340436323518,0.20424297718890824,125456.14454481361,1946.3626783721631,127402.50722318578,938,1,133.7560975609756,31,10,19,39.42520145567975,0.5853494623655914,49.54427083333335,1001.8229166666686,32.31686827956995,7
2320,4,3,3,41,0.06818181818181818,0.06818181818181818,0.9318181818181819,44,1200,1000,200,0.8333333333333334,14,10,4,378.21267044342915,0.46187896405919665,0.33664092027645953,0.19532976779222205,126338.19792005766,760.6613159179872,127098.85923597564,939,0,125.56818181818181,31,13,19,39.15957021974701,0.5944220430107527,48.66536458333334,1005.3385416666679,32.43027553763445,0
2321,4,2,2,41,0.046511627906976744,0.046511627906976744,0.9534883720930233,43,1200,800,400,0.6666666666666666,16,8,8,383.4815626237311,0.46027131782945735,0.34134612658285235,0.19781860230439258,126290.07623269895,1085.9831555171047,127376.05938821606,940,0,129.4418604651163,33,10,20,39.07685117451027,0.5890151515151515,48.713235294117645,1005.1470588235294,30.459001782531193,0
2322,4,4,1,44,0.08888888888888889,0.022222222222222223,0.9777777777777777,45,1200,800,400,0.6666666666666666,16,8,8,362.52967968173607,0.463699494949495,0.33801783779278183,0.19253070239671463,127474.24529384747,252.7918080617319,127727.03710190921,941,0,121.42222222222222,32,13,22,38.385377594398584,0.603515625,47.53787878787878,1009.8484848484841,31.557765151515127,0
2323,4,0,1,43,0.0,0.022727272727272728,0.9772727272727273,44,1150,700,450,0.6086956521739131,16,7,9,368.07760948153566,0.46229739252995067,0.34283643186082213,0.19501527420840795,127378.63363751139,577.0445936638982,127955.67823117529,942,1,125.18181818181819,32,12,22,38.34349593495935,0.6025390625,47.63257575757575,1009.4696969696962,31.545928030303006,0
2324,4,1,0,44,0.022727272727272728,0.0,1.0,44,1400,700,700,0.5,21,7,14,365.0660112266884,0.4622753699788584,0.3511444531489487,0.195262762317441,127761.29548324137,528.2613062442383,128289.5567894856,943,0,125.20454545454545,32,12,23,38.02688272761332,0.6064453125,47.25378787878787,1010.9848484848474,31.59327651515148,0
2325,4,2,2,44,0.043478260869565216,0.043478260869565216,0.9565217391304348,46,1200,900,300,0.75,15,9,6,348.4877114739668,0.46494565217391304,0.3406645792478793,0.18923967336197928,128368.35048719491,-251.8936205489585,128116.45686664595,944,0,120.71739130434783,32,14,20,37.825245036963224,0.6126302083333333,46.65404040404039,1013.3838383838362,31.66824494949488,0
2326,4,0,0,44,0.0,0.0,1.0,44,1900,1400,500,0.7368421052631579,24,14,10,369.61229766252967,0.46246256166314303,0.3540171692714067,0.1992818262854106,128082.49831795442,668.1732987312289,128750.67161668565,945,1,127.11363636363636,33,11,24,37.58272800645683,0.6073232323232323,46.93627450980391,1012.2549019607826,30.674390968508565,0
2327,4,1,0,45,0.022222222222222223,0.0,1.0,45,600,500,100,0.8333333333333334,7,5,2,357.84781493405484,0.4631313131313131,0.3483640825877885,0.19500076521284032,128507.33651055243,197.25896944592847,128704.59547999836,946,0,125.26666666666667,31,14,21,37.44609070673345,0.6165994623655914,46.51692708333334,1013.9322916666678,32.70749327956993,0
2328,4,2,0,47,0.0425531914893617,0.0,1.0,47,1400,1000,400,0.7142857142857143,18,10,8,337.24245453135046,0.46322849213691025,0.34464237620714844,0.18686881498580854,129170.24289035473,-687.6620470492068,128482.58084330552,947,0,120.8936170212766,33,14,23,37.293424753867804,0.6183712121212122,45.8639705882353,1016.5441176470592,30.804367201426036,0
2329,4,1,0,48,0.020833333333333332,0.0,1.0,48,1100,600,500,0.5454545454545454,16,6,10,328.2950669246138,0.46388334810874704,0.3373946875731342,0.1828950222905965,129383.00028344666,-1104.8398526077087,128278.16043083895,948,0,119.35416666666667,34,14,24,37.304733208518634,0.6182598039215687,45.654761904761905,1017.380952380952,29.922969187675058,0
2330,4,0,2,46,0.0,0.041666666666666664,0.9583333333333334,48,1450,1000,450,0.6896551724137931,19,10,9,327.9960773818266,0.46318151595744683,0.33710414960414936,0.18286904588274458,129413.28125000015,-1110.590277777764,128302.69097222238,949,1,120.35416666666667,34,14,25,37.28159978159978,0.6185661764705883,45.62500000000001,1017.5000000000011,29.92647058823533,0
2331,4,0,0,46,0.0,0.0,1.0,46,1600,1300,300,0.8125,19,13,6,341.97796291319537,0.45994363929146537,0.3412330719885961,0.18964232488822685,129201.38888888914,-363.1944444444094,128838.19444444473,950,2,125.80434782608695,34,12,25,37.14139344262296,0.616421568627451,45.83333333333335,1016.6666666666687,29.901960784313786,0
2332,4,1,0,47,0.02127659574468085,0.0,1.0,47,2000,1600,400,0.8,24,16,8,327.64028811666066,0.46008711069996916,0.32475537138280397,0.18365891379750468,129625.34722222258,-905.9027777777358,128719.44444444485,951,0,124.1063829787234,34,13,19,37.07549099836333,0.6207107843137255,45.416666666666686,1018.3333333333362,29.950980392156946,0
2333,4,1,2,46,0.020833333333333332,0.041666666666666664,0.9583333333333334,48,1450,900,550,0.6206896551724138,20,9,11,319.9921532607471,0.46102984633569744,0.3245270170789165,0.1811155587455834,130004.05811216657,-1279.9443024104796,128724.11380975609,952,0,122.5,36,12,20,36.88668654299176,0.6203703703703703,45.045045045045065,1019.8198198198227,28.328328328328407,0
2334,4,0,0,46,0.0,0.0,1.0,46,1250,800,450,0.64,17,8,9,335.3211263890002,0.45969202898550726,0.3341465341840657,0.18875749339697956,129790.40745027458,-495.7068758573173,129294.70057441726,953,1,128.6304347826087,35,11,21,36.71247917613205,0.6202380952380953,45.25462962962964,1018.9814814814833,29.113756613756667,0
2335,4,0,0,46,0.0,0.0,1.0,46,1450,1000,450,0.6896551724137931,19,10,9,336.3317662186063,0.4590277777777778,0.33334155850565006,0.19018503596828815,129967.37423911208,-457.5686942729462,129509.80554483912,954,2,129.6304347826087,35,11,22,36.50728339008702,0.6220238095238095,45.08101851851853,1019.6759259259281,29.133597883597947,0
2336,4,1,1,46,0.02127659574468085,0.02127659574468085,0.9787234042553191,47,1100,600,500,0.5454545454545454,16,6,10,329.690543403036,0.45802497687326554,0.33474768827004486,0.18845274271062437,130387.71896626303,-801.4757222560352,129586.243244007,955,0,127.85106382978724,33,14,25,36.25109991200703,0.6306818181818181,44.669117647058826,1021.3235294117652,30.94919786096258,0
2337,4,1,1,46,0.02127659574468085,0.02127659574468085,0.9787234042553191,47,1650,1300,350,0.7878787878787878,20,13,7,320.01692377250794,0.45760098674067223,0.31286562378125415,0.1848568347909428,130794.81336805547,-1028.6892361111197,129766.12413194435,956,0,126.2127659574468,35,12,19,36.08706720977596,0.6303571428571428,44.27083333333333,1022.916666666666,29.226190476190457,0
2338,4,0,0,46,0.0,0.0,1.0,46,1350,900,450,0.6666666666666666,18,9,9,327.9907026709328,0.45699476650563603,0.3203200346408961,0.18917270553527177,130735.62349965716,-623.9861968449815,130111.63730281217,957,1,129.6304347826087,35,11,21,35.942922891202656,0.6297619047619047,44.32870370370371,1022.6851851851859,29.21957671957674,0
2339,4,0,0,46,0.0,0.0,1.0,46,1300,900,400,0.6923076923076923,17,9,8,328.9776760253421,0.4555454911433172,0.31525566442131026,0.1906727754922392,130924.4379514651,-585.7565335605773,130338.68141790452,958,2,130.6304347826087,36,10,23,35.72705765845071,0.6296296296296297,44.14414414414415,1023.4234234234243,28.428428428428454,0
2340,4,0,1,45,0.0,0.021739130434782608,0.9782608695652174,46,1000,600,400,0.6,14,6,8,327.9389799224973,0.4554851046698873,0.3106696761605996,0.1906407420367869,131039.71370018674,-605.3939919649305,130434.31970822181,959,3,131.6304347826087,36,10,23,35.63732768734418,0.630787037037037,44.031531531531535,1023.8738738738743,28.440940940940955,0
2341,4,0,1,44,0.0,0.022222222222222223,0.9777777777777777,45,1400,1000,400,0.7142857142857143,18,10,8,343.7144279094905,0.45475589225589225,0.22399273635228667,0.19450660400196015,129996.88042534716,-63.32228290369136,129933.55814244346,960,4,135.37777777777777,39,6,18,36.28915560095336,0.6148504273504274,45.05208333333333,1019.7916666666661,26.14850427350426,8
2342,4,0,3,41,0.0,0.06818181818181818,0.9318181818181819,44,1250,700,550,0.56,18,7,11,337.6387980136965,0.4534553382663848,0.2118311754605784,0.19172011748082063,130129.69970703122,-12.63292100694548,130117.06678602427,961,5,136.6590909090909,39,5,18,36.309447847541264,0.6161858974358974,44.921875,1020.3124999999998,26.161858974358967,0
2343,4,0,0,41,0.0,0.0,1.0,41,1300,900,400,0.6923076923076923,17,9,8,355.09392265193355,0.4505335365853658,0.22974801239725084,0.2000996264009964,129831.8483179127,1020.5000608717082,130852.34837878442,962,6,145.0487804878049,36,5,18,36.16666666666668,0.6186342592592593,45.21396396396398,1019.1441441441458,28.309559559559606,0
2344,4,0,1,40,0.0,0.024390243902439025,0.975609756097561,41,1000,700,300,0.7,13,7,6,354.7782100691594,0.4502032520325203,0.22887440627416278,0.20036226673462926,129917.93894823913,1018.4107671861452,130936.34971542527,963,7,146.0487804878049,36,5,18,36.08725468537135,0.6195023148148149,45.129504504504524,1019.4819819819847,28.31894394394402,0
2345,4,0,1,39,0.0,0.025,0.975,40,1200,1000,200,0.8333333333333334,14,10,4,359.9491257156149,0.4502537393162393,0.24042390194075547,0.2036937538009175,129996.88042534732,1358.4526909722276,131355.33311631955,964,8,150.05,35,5,18,35.875255362614894,0.6223214285714286,45.052083333333336,1019.7916666666674,29.136904761904784,0
2346,4,1,0,40,0.025,0.0,1.0,40,1300,1100,200,0.8461538461538461,15,11,4,351.09967869748476,0.4512286324786325,0.2188626317579052,0.20050177767947616,130351.21588059409,1153.2540027006082,131504.4698832947,965,0,144.825,35,5,20,35.741456987419234,0.6258928571428571,44.70486111111111,1021.1805555555552,29.17658730158729,0
2347,4,0,0,40,0.0,0.0,1.0,40,900,400,500,0.4444444444444444,14,4,10,350.6611560962692,0.450894764957265,0.21858073654390964,0.2005563643907696,130410.31867551866,1145.9666227280516,131556.28529824672,966,1,145.825,35,5,20,35.692752596789425,0.6264880952380952,44.64699074074074,1021.4120370370368,29.183201058201053,0
2348,4,0,0,40,0.0,0.0,1.0,40,1200,900,300,0.75,15,9,6,349.4523883416272,0.4504407051282051,0.21284395878156492,0.20078165526642225,130587.7074358067,1126.837250300062,131714.54468610676,967,2,146.825,35,5,18,35.54394085230061,0.6282738095238095,44.473379629629626,1022.1064814814811,29.203042328042315,0
2349,4,1,1,40,0.024390243902439025,0.024390243902439025,0.975609756097561,41,1200,900,300,0.75,15,9,6,348.50388488745216,0.45,0.2261094462226112,0.20244401389851907,131010.890007406,931.5608260287277,131942.45083343473,968,0,144.21951219512195,36,5,19,35.14006526601401,0.6304976851851851,44.05968468468468,1023.7612612612608,28.437812812812798,0
2350,4,1,0,41,0.024390243902439025,0.0,1.0,41,1000,800,200,0.8,12,8,4,369.8786114169741,0.45033028455284557,0.2157725919716491,0.19947171730023056,128091.80230034728,1276.0672121657176,129367.86951251299,969,0,145.1219512195122,39,2,17,37.5664574329423,0.5956196581196581,46.927083333333336,1012.2916666666671,25.956196581196593,8
2351,4,0,0,41,0.0,0.0,1.0,41,1600,1100,500,0.6875,21,11,10,372.08876931105095,0.44916158536585366,0.21699452657802887,0.20204726239557763,128366.66690712518,1352.780723395647,129719.44763052082,970,1,146.1219512195122,37,4,17,37.22904493976771,0.6019144144144144,46.65570175438596,1013.3771929824554,27.388572783309606,0
2352,4,2,0,43,0.046511627906976744,0.0,1.0,43,1550,1100,450,0.7096774193548387,20,11,9,362.04853290227703,0.4512735326688815,0.22057729362611367,0.19970007312573534,128989.6701388887,740.1041666666463,129729.77430555534,971,0,140.27906976744185,39,4,17,36.84714246650259,0.6047008547008548,46.04166666666666,1015.8333333333318,26.047008547008506,0
2353,4,1,1,43,0.022727272727272728,0.022727272727272728,0.9772727272727273,44,1400,1100,300,0.7857142857142857,17,11,6,361.4203716989481,0.4521339852008457,0.21406317633202843,0.200860761650043,129287.27027280649,546.1051000324544,129833.37537283894,972,0,138.0681818181818,36,8,19,36.55972022293582,0.6131365740740741,45.74887387387387,1017.0045045045036,28.250125125125102,0
2354,4,0,0,43,0.0,0.0,1.0,43,1350,1200,150,0.8888888888888888,15,12,3,361.7670555885853,0.4511581764488741,0.19021651964715347,0.2017547040782493,129424.43828870401,764.2995921821877,130188.7378808862,825,1,119.67441860465117,37,6,19,36.411188936781606,0.6126126126126126,45.61403508771929,1017.5438596491211,27.501185395922192,0
2355,4,0,3,40,0.0,0.06976744186046512,0.9302325581395349,43,1550,1300,250,0.8387096774193549,18,13,5,362.2015632253126,0.45122739018087854,0.19565320778047268,0.2035822579507792,129731.44531250003,797.7864583333343,130529.23177083336,826,2,120.67441860465117,37,6,15,36.0876789366053,0.6157094594594594,45.3125,1018.7500000000002,27.53378378378379,0
2356,4,0,0,40,0.0,0.0,1.0,40,1650,1100,550,0.6666666666666666,22,11,11,373.3893700908941,0.44718215811965817,0.19392280468922785,0.20918133112527076,129602.41280131502,1678.4326556286248,131280.84545694364,827,4,126.7,36,4,16,35.93415910934159,0.6163194444444444,45.4391891891892,1018.2432432432447,28.284534534534576,0
2357,4,0,1,39,0.0,0.025,0.975,40,1150,800,350,0.6956521739130435,15,8,7,346.01382180477947,0.4460069444444445,0.1741292590589516,0.18828121145292406,128450.01737313379,889.0962844336494,129339.11365756743,828,5,127.7,37,3,18,37.804556517036254,0.602759009009009,46.57346491228069,1013.7061403508751,27.397463252726354,8
2358,4,1,1,39,0.025,0.025,0.975,40,1050,900,150,0.8571428571428571,12,9,3,339.97891683042894,0.44598023504273504,0.20145025386194293,0.18655511755182408,128783.68975309674,756.7478695367387,129540.43762263347,829,0,128.55,37,3,19,37.6173661373375,0.6061373873873874,46.24451754385963,1015.0219298245584,27.433025130393467,0
2359,4,0,0,39,0.0,0.0,1.0,39,950,600,350,0.631578947368421,13,6,7,338.66965915909276,0.44421952316689156,0.18579570776483245,0.18662088356874884,128950.68825263505,934.3371277700392,129885.02538040509,830,1,127.17948717948718,37,2,19,37.48054535967468,0.6078265765765766,46.0800438596491,1015.6798245614004,27.45080606922704,0
2360,4,1,0,40,0.025,0.0,1.0,40,1700,1500,200,0.8823529411764706,19,15,4,331.14240666029013,0.44529914529914527,0.176496534341525,0.18439403486662445,129364.36760355013,567.6056048651986,129931.97320841532,831,0,124.975,38,2,21,37.25123398445705,0.6101973684210527,45.67307692307691,1017.3076923076909,26.77125506072871,0
2361,4,0,1,39,0.0,0.025,0.975,40,1150,600,550,0.5217391304347826,17,6,11,330.3098766197538,0.44504540598290593,0.17448031496063066,0.18431175013492362,129445.8954840562,551.451553254403,129997.3470373106,832,1,125.975,38,2,18,37.18963254593176,0.6110197368421053,45.5929487179487,1017.6282051282024,26.779689608636904,0
2362,4,0,0,39,0.0,0.0,1.0,39,1100,900,200,0.8181818181818182,13,9,4,336.05880874971695,0.44405083220872693,0.17246553425020994,0.1872846658491662,129396.54659366318,896.9698609187193,130293.5164545819,833,2,129.48717948717947,37,2,21,37.093504149154015,0.6123310810810811,45.64144736842104,1017.4342105263138,27.49822190611659,0
2363,4,0,1,38,0.0,0.02564102564102564,0.9743589743589743,39,1400,800,600,0.5714285714285714,20,8,12,338.75668684175014,0.4434041835357625,0.16965158468496822,0.18972826260630246,129591.85157933227,980.0212565404933,130571.87283587277,834,3,130.48717948717947,37,2,19,36.826495082202605,0.6143018018018018,45.44956140350878,1018.2017543859662,27.51896633475584,0
2364,4,1,0,39,0.02564102564102564,0.0,1.0,39,1050,800,250,0.7619047619047619,13,8,5,339.3308081539576,0.4421108861898336,0.17781457867571926,0.19059148777208415,129703.5205544016,1002.4800900277273,130706.00064442934,835,0,131.3846153846154,37,2,20,36.69851094366703,0.615427927927928,45.33991228070177,1018.6403508771949,27.53082029397824,0
2365,4,1,0,40,0.025,0.0,1.0,40,950,600,350,0.631578947368421,13,6,7,333.79985687676566,0.443082264957265,0.17869865884325242,0.18873138827202926,129962.83512309165,676.3151526773456,130639.15027576899,836,0,129.075,38,2,21,36.57642672534226,0.6162280701754386,45.08547008547009,1019.6581196581205,26.833108412055804,0
2366,4,0,0,40,0.0,0.0,1.0,40,1150,600,550,0.5217391304347826,17,6,11,335.187651094523,0.4419738247863248,0.1775918944392081,0.19017866193117075,130099.04308431971,721.5185322156692,130820.56161653539,837,1,130.075,38,2,21,36.40302649492093,0.6175986842105263,44.95192307692309,1020.1923076923092,26.847165991902873,0
2367,4,2,2,40,0.047619047619047616,0.047619047619047616,0.9523809523809523,42,1300,1000,300,0.7692307692307693,16,10,6,323.8448265145779,0.4456784746418893,0.18557235266788186,0.18679657989495826,130738.73842191865,68.12099800056791,130806.85941991922,838,0,124.83333333333333,37,5,18,36.045776598406064,0.6258445945945945,44.325657894736864,1022.6973684210557,27.640469416785287,0
2368,4,1,0,41,0.024390243902439025,0.0,1.0,41,900,500,400,0.5555555555555556,13,5,8,321.832969609437,0.4426829268292683,0.16876072707271228,0.18636736293344605,130890.45606874178,224.9728340273784,131115.42890276917,839,0,122.92682926829268,38,3,19,35.94413412681841,0.6255482456140351,44.177350427350454,1023.290598290602,26.928699955015844,0
2369,4,0,1,40,0.0,0.024390243902439025,0.975609756097561,41,1100,800,300,0.7272727272727273,14,8,6,326.6142802977869,0.44197154471544714,0.1765505444659945,0.18967382023111537,130999.804815911,357.28139381989473,131357.0862097309,840,1,123.92682926829268,38,3,19,35.71149029430178,0.6266447368421053,44.07051282051284,1023.7179487179521,26.939946018893476,0
2370,4,0,0,40,0.0,0.0,1.0,40,1100,600,500,0.5454545454545454,16,6,10,333.5681158939814,0.44025106837606837,0.17675383651738152,0.19329999892005156,130917.78897518101,734.0000410914099,131651.78901627244,841,2,127.925,38,2,19,35.61632216306505,0.6258223684210527,44.150641025641036,1023.3974358974376,26.9315114709852,0
2371,4,0,0,40,0.0,0.0,1.0,40,1250,800,450,0.64,17,8,9,332.80618002868323,0.44055822649572646,0.17683175033921272,0.19313240526074002,130972.46334876558,717.6890432098904,131690.15239197548,842,3,128.925,38,2,19,35.580619629127085,0.6263706140350878,44.09722222222223,1023.6111111111123,26.93713450292401,0
2372,4,0,0,40,0.0,0.0,1.0,40,1000,800,200,0.8,12,8,4,336.80854033958576,0.4399172008547008,0.18593896713615,0.19601152757467716,131081.8463387576,829.8970660749765,131911.74340483258,843,4,129.925,38,2,20,35.367762128325516,0.627467105263158,43.99038461538463,1024.0384615384633,26.948380566801664,0
2373,4,0,0,40,0.0,0.0,1.0,40,1450,900,550,0.6206896551724138,20,9,11,333.75050696926405,0.43935630341880344,0.18236704900938427,0.1949249306842416,131218.63928154012,758.8574768062135,131977.49675834633,844,5,130.925,38,2,20,35.30804657629474,0.6288377192982456,43.856837606837615,1024.5726495726512,26.96243814664872,0
2374,4,0,2,38,0.0,0.05,0.95,40,850,400,450,0.47058823529411764,13,4,9,335.1199403114234,0.439690170940171,0.1823803815281977,0.19614433114139632,131300.74929003217,800.299852984155,132101.0491430163,845,6,131.925,38,2,20,35.19015601653985,0.6296600877192983,43.776709401709404,1024.8931623931626,26.97087269455691,0
2375,4,0,0,38,0.0,0.0,1.0,38,650,500,150,0.7692307692307693,8,5,3,346.68517416881514,0.4389372925557136,0.18292682926829307,0.20305845915601997,131328.12499999974,1505.9056313463088,132834.03063134605,846,7,132.5,35,3,20,34.866192411924125,0.6357142857142857,43.749999999999986,1024.999999999998,29.285714285714228,0
2376,4,0,0,38,0.0,0.0,1.0,38,1000,600,400,0.6,14,6,8,348.49808151888686,0.43902619724988146,0.18618272543661663,0.2047541778685236,131446.78605109727,1561.7905521261873,133008.57660322345,847,8,133.5,35,3,20,34.69996237772763,0.6369047619047619,43.63425925925925,1025.462962962962,29.29894179894177,0
2377,4,0,1,37,0.0,0.02631578947368421,0.9736842105263158,38,1250,700,550,0.56,18,7,11,347.51772471946725,0.4388928402086297,0.18986319589587697,0.20481363776019643,131565.50068587088,1544.2686899862554,133109.76937585714,848,9,134.5,35,3,18,34.60533243080625,0.638095238095238,43.518518518518505,1025.9259259259243,29.312169312169264,0
2378,4,0,1,36,0.0,0.02702702702702703,0.972972972972973,37,1600,1400,200,0.875,18,14,4,347.37722958831466,0.4344657157157157,0.1718904289946237,0.20536941813261153,131684.2689043209,1748.823302469124,133433.09220679002,849,10,124.35135135135135,35,2,18,34.48917456021651,0.6392857142857142,43.40277777777777,1026.3888888888882,29.32539682539681,0
2379,4,0,0,36,0.0,0.0,1.0,36,900,700,200,0.7777777777777778,11,7,4,361.69607464899036,0.43371362433862437,0.18008571019808262,0.20103900883060022,129292.17864229031,2177.007353867477,131469.1859961578,850,11,126.86111111111111,34,2,21,36.5477096258145,0.6173406862745099,45.74404761904762,1017.02380952381,29.91246498599441,8
2380,4,0,0,36,0.0,0.0,1.0,36,950,700,250,0.7368421052631579,12,7,5,363.54648148259935,0.4335482804232804,0.1814314314314316,0.2026896136485179,129413.28125000012,2209.548611111127,131622.82986111124,851,12,127.86111111111111,34,2,22,36.377286377286396,0.6185661764705883,45.62500000000001,1017.5000000000009,29.926470588235322,0
2381,4,0,0,36,0.0,0.0,1.0,36,950,600,350,0.631578947368421,13,6,7,363.44450092287155,0.43369708994708994,0.13482624169152713,0.19435583764716757,127753.08956916083,2089.0093537414778,129842.09892290231,852,13,128.86111111111111,34,2,19,38.07627767310409,0.6017156862745099,47.26190476190475,1010.9523809523796,29.73389355742293,7
2382,4,1,0,37,0.02702702702702703,0.0,1.0,37,950,600,350,0.631578947368421,13,6,7,355.6592722652898,0.43649899899899897,0.0861067002799285,0.19101934239101948,127927.48169273847,1724.7260944819193,129652.20778722038,853,0,126.35135135135135,33,4,18,38.09446295174642,0.6057449494949495,47.08946078431373,1011.6421568627459,30.655822935234724,8
2383,4,0,1,36,0.0,0.02702702702702703,0.972972972972973,37,700,300,400,0.42857142857142855,11,3,8,356.6073096383458,0.4365615615615615,0.08396771680859816,0.19197282679227257,128020.48040417153,1730.6078191080405,129751.08822327957,854,1,127.35135135135135,33,4,18,37.97529668200533,0.6066919191919191,46.997549019607845,1012.0098039215691,30.666963755199063,0
2384,4,0,1,35,0.0,0.027777777777777776,0.9722222222222222,36,950,600,350,0.631578947368421,13,6,7,357.79006349463,0.43492063492063493,0.08343724023275145,0.19336093727944295,128176.4934700541,1972.115220482769,130148.60869053687,855,2,129.02777777777777,32,4,19,37.78574397339984,0.6106770833333333,46.843434343434346,1012.6262626262629,31.644570707070717,0
2385,4,1,0,36,0.027777777777777776,0.0,1.0,36,1100,800,300,0.7272727272727273,14,8,6,350.4659735704621,0.43668981481481484,0.0868397028922363,0.1913863470898383,128592.36501696249,1813.449679879593,130405.81469684208,856,0,129.27777777777777,32,4,19,37.54642308809493,0.6149088541666667,46.4330808080808,1014.2676767676762,31.695864898989882,0
2386,4,1,0,37,0.02702702702702703,0.0,1.0,37,900,700,200,0.7777777777777778,11,7,4,340.9914112206844,0.43828203203203203,0.08477622065168888,0.1877605199193228,128921.21006644065,1392.2050713667684,130313.41513780742,857,0,126.75675675675676,33,4,20,37.45160592896506,0.6158459595959596,46.109068627450974,1015.5637254901949,30.774658348187724,0
2387,4,0,1,36,0.0,0.02702702702702703,0.972972972972973,37,900,700,200,0.7777777777777778,11,7,4,342.1276332345047,0.4379692192192192,0.07427543317557772,0.18912815565203403,129076.82742214516,1432.149894271415,130508.97731641657,858,1,127.75675675675676,33,4,20,37.26433108216756,0.6174242424242424,45.95588235294117,1016.1764705882339,30.793226381461633,0
2388,4,1,0,37,0.02702702702702703,0.0,1.0,37,650,400,250,0.6153846153846154,9,4,5,343.342507864844,0.4365928428428429,0.08150780646863565,0.1905493503514789,129232.53864198858,1474.2047830161368,130706.74342500471,859,0,128.59459459459458,33,4,21,37.07502209634004,0.6190025252525253,45.80269607843137,1016.7892156862739,30.811794414735573,0
2389,4,0,1,36,0.0,0.02702702702702703,0.972972972972973,37,1150,700,450,0.6086956521739131,16,7,9,346.9838691770628,0.4359046546546546,0.08341851849440407,0.1933328914032196,129388.34372597064,1579.1336264897946,130967.47735246044,860,1,129.59459459459458,33,4,21,36.823958082389794,0.6205808080808081,45.64950980392156,1017.4019607843126,30.83036244800947,0
2390,4,1,0,37,0.02702702702702703,0.0,1.0,37,1250,800,450,0.64,17,8,9,337.69831231724066,0.43653028028028024,0.08124212540616349,0.19003023373591466,129776.92920918358,1365.0899943310565,131142.01920351465,861,0,127.97297297297297,34,3,18,36.66559566927601,0.6222426470588236,45.26785714285714,1018.9285714285706,29.96848739495796,0
2391,4,1,0,38,0.02631578947368421,0.0,1.0,38,750,500,250,0.6666666666666666,10,5,5,325.9911857997832,0.4388780227596017,0.08563377590982868,0.1851764364697738,130144.46159122082,885.1894718792801,131029.6510631001,862,0,125.57894736842105,35,3,19,36.59161373260737,0.6238095238095238,44.907407407407405,1020.3703703703701,29.153439153439145,0
2392,4,1,0,39,0.02564102564102564,0.0,1.0,39,800,500,300,0.625,11,5,6,317.69943917210236,0.4399741340530814,0.08596187762854468,0.18195513334402222,130463.842220599,489.6579011443906,130953.5001217434,863,0,123.33333333333333,36,3,21,36.48037918871251,0.625,44.5945945945946,1021.6216216216218,28.378378378378383,0
2393,4,0,2,37,0.0,0.05128205128205128,0.9487179487179487,39,1100,500,600,0.45454545454545453,17,5,12,317.37392627377363,0.43918690958164647,0.08633260170111545,0.18244478333040184,130607.69120049111,490.2951515704967,131097.98635206162,864,1,124.33333333333333,36,3,17,36.343459659946376,0.6264467592592593,44.45382882882883,1022.1846846846853,28.394019019019037,0
2394,4,1,0,38,0.02631578947368421,0.0,1.0,38,1150,500,650,0.43478260869565216,18,5,13,323.99898789203655,0.4365961356092935,0.10006431557508866,0.1871570624176349,130794.81336805533,875.4774305555304,131670.29079861086,865,0,125.26315789473684,35,3,18,35.985234215885946,0.6303571428571428,44.27083333333332,1022.9166666666648,29.226190476190425,0
2395,4,0,0,38,0.0,0.0,1.0,38,1100,800,300,0.7272727272727273,14,8,6,324.14511406712427,0.43529220009483166,0.09991548474261536,0.18796165532430023,130942.84664619763,888.8967924811324,131831.74343867876,866,1,126.26315789473684,35,3,19,35.83213181801048,0.6318452380952381,44.126157407407405,1023.4953703703698,29.24272486772485,0
2396,4,0,0,38,0.0,0.0,1.0,38,1200,900,300,0.75,15,9,6,323.25783117650747,0.4346402323376008,0.09464283589371325,0.18788033998603051,131031.70680084023,871.4050711591271,131903.11187199937,867,2,127.26315789473684,35,3,21,35.7652234531615,0.6327380952380952,44.039351851851855,1023.8425925925928,29.25264550264551,0
2397,4,0,0,38,0.0,0.0,1.0,38,1150,900,250,0.782608695652174,14,9,5,323.610681291432,0.4340771692745377,0.09365613717874766,0.18852079781092046,131120.59709630057,886.405151534639,132007.00224783522,868,3,128.26315789473685,35,3,21,35.66657720269711,0.6336309523809525,43.9525462962963,1024.1898148148148,29.262566137566136,0
2398,4,0,0,38,0.0,0.0,1.0,38,1000,600,400,0.6,14,6,8,326.4180654510326,0.4334844713134187,0.0981087333718913,0.19090002542444695,131270.41737683627,969.8071382192952,132240.22451505557,869,4,129.26315789473685,36,2,22,35.443681318681314,0.6331018518518519,43.806306306306304,1024.7747747747744,28.465965965965957,0
2399,4,1,0,39,0.02564102564102564,0.0,1.0,39,850,500,350,0.5882352941176471,12,5,7,319.5444355690693,0.43437921727395407,0.1029806065339065,0.18847381379373235,131595.18771701376,610.1273597288075,132205.31507674255,870,0,126.92307692307692,35,4,18,35.292935702199664,0.6383928571428572,43.48958333333333,1026.0416666666656,29.31547619047616,0
2400,4,0,0,39,0.0,0.0,1.0,39,800,400,400,0.5,12,4,8,321.9982384856104,0.43395748987854255,0.10422955483848573,0.19036535859269266,131684.2689043209,680.4205246913452,132364.68942901224,871,1,127.92307692307692,35,4,18,35.14039242219215,0.6392857142857142,43.40277777777777,1026.3888888888882,29.32539682539681,0
2401,4,0,1,38,0.0,0.02564102564102564,0.9743589743589743,39,1400,700,700,0.5,21,7,14,323.3504355088891,0.43260796221322534,0.10797316273989743,0.19206236711552077,131862.52170138876,727.5607638888688,132590.08246527764,872,2,128.92307692307693,35,4,19,34.926470588235276,0.6410714285714285,43.22916666666666,1027.0833333333321,29.34523809523806,0
2402,4,0,1,37,0.0,0.02631578947368421,0.9736842105263158,38,950,700,250,0.7368421052631579,12,7,5,314.6229016640764,0.43309921763869136,0.025027970723975335,0.17497992905356743,129315.90374157931,537.1489732976075,129853.05271487692,873,3,131.28947368421052,36,2,21,37.72051225273101,0.6134259259259259,45.72072072072071,1017.1171171171163,28.25325325325323,8
2403,4,0,0,37,0.0,0.0,1.0,37,1200,800,400,0.6666666666666666,16,8,8,317.85030163364917,0.4312124624624625,0.04281764982641101,0.176921235025848,129348.51794249381,822.6930887774147,130171.21103127123,874,9,135.75675675675674,35,2,21,37.605363712216025,0.6157738095238094,45.6886574074074,1017.2453703703688,29.064153439153397,0
2404,4,0,0,37,0.0,0.0,1.0,37,1400,1000,400,0.7142857142857143,18,10,8,317.7991732568504,0.4300863363363363,0.050293130784262896,0.17782198015058884,129554.63927469132,834.4714506172757,130389.1107253086,875,10,136.75675675675674,35,2,17,37.39768076398361,0.6178571428571429,45.48611111111111,1018.0555555555553,29.08730158730158,0
2405,4,0,0,37,0.0,0.0,1.0,37,1050,600,450,0.5714285714285714,15,6,9,320.9545454545453,0.43033658658658663,0.04653562653562626,0.18012755102040814,129672.4965706448,923.795438957483,130596.29200960229,876,11,137.75675675675674,35,2,17,37.19791666666666,0.6190476190476191,45.370370370370374,1018.5185185185192,29.10052910052912,0
2406,4,1,3,35,0.02631578947368421,0.07894736842105263,0.9210526315789473,38,1500,1100,400,0.7333333333333333,19,11,8,352.57185530389336,0.4324620673304884,0.03886514848271738,0.19164939397245181,128408.33875868075,1520.0053315758096,129928.34409025656,877,0,135.10526315789474,35,3,14,37.68092668722166,0.60625,46.61458333333334,1013.5416666666682,28.95833333333338,8
2407,4,1,0,36,0.027777777777777776,0.0,1.0,36,1200,700,500,0.5833333333333334,17,7,10,361.7635832452073,0.4315806878306878,0.07589547856723433,0.1968317515228718,128446.0476899095,2093.4204931973018,130539.4681831068,878,0,142.19444444444446,34,2,15,37.40947347817577,0.6087622549019608,46.57738095238096,1013.6904761904777,29.81442577030817,0
2408,4,1,1,36,0.02702702702702703,0.02702702702702703,0.972972972972973,37,1350,1100,250,0.8148148148148148,16,11,5,355.57052198005795,0.43493493493493496,0.07498536164442693,0.19514101863361136,128789.87295310364,1758.7764703360867,130548.64942343973,879,0,139.32432432432432,35,2,16,37.215412390725966,0.6101190476190477,46.23842592592593,1015.0462962962969,29.001322751322768,0
2409,4,1,0,37,0.02702702702702703,0.0,1.0,37,700,500,200,0.7142857142857143,9,5,4,346.82874017015246,0.43674924924924924,0.08695860569059422,0.19149870831181892,129029.71172185717,1550.2424722019514,130579.95419405912,880,0,138.78378378378378,36,1,17,37.19288036651148,0.6105324074074074,46.00225225225226,1015.9909909909925,28.221971971972014,0
2410,4,1,0,38,0.02631578947368421,0.0,1.0,38,1000,900,100,0.9,11,9,2,340.56977789243626,0.43936699857752487,0.0981274127901901,0.1903778739869964,129516.42679419288,1221.9902757487298,130738.41706994161,881,0,136.10526315789474,36,2,14,36.85695320278792,0.6154513888888888,45.52364864864865,1017.9054054054058,28.27515015015016,0
2411,4,1,2,37,0.02564102564102564,0.05128205128205128,0.9487179487179487,39,1350,700,650,0.5185185185185185,20,7,13,331.63223602821415,0.4415485829959514,0.09318693926631982,0.18720005454488797,129899.05698147495,815.7429449445813,130714.79992641952,882,0,133.5897435897436,37,2,15,36.696313326879626,0.6173986486486487,45.148026315789465,1019.4078947368412,27.55156472261733,0
2412,4,0,0,37,0.0,0.0,1.0,37,850,400,450,0.47058823529411764,13,4,9,339.01927181466465,0.4390640640640641,0.07572585293880452,0.19090139331990655,129803.15778193726,1401.154406095271,131204.31218803252,883,1,134.72972972972974,36,1,16,36.605333922717044,0.6183449074074074,45.24211711711711,1019.0315315315308,28.306431431431413,0
2413,4,0,3,34,0.0,0.08108108108108109,0.9189189189189189,37,1400,1200,200,0.8571428571428571,16,12,4,339.401628664066,0.43931431431431434,0.07441238455154964,0.19181912271688198,129946.64216581428,1420.82039810078,131367.46256391506,884,2,135.72972972972974,36,1,17,36.45004970178925,0.6197916666666667,45.10135135135134,1019.5945945945932,28.322072072072032,0
2414,4,0,0,34,0.0,0.0,1.0,34,1400,1200,200,0.8571428571428571,16,12,4,365.32873809908256,0.43551322043969104,0.06435482386914604,0.2050133114342657,129669.02941476837,2674.3645773260305,132343.3939920944,885,3,140.5,33,1,18,36.071546745277345,0.6234217171717171,45.37377450980392,1018.5049019607844,30.86378490790256,0
2415,4,0,0,34,0.0,0.0,1.0,34,1200,900,300,0.75,15,9,6,364.35360075115733,0.434863339275104,0.05579989004947783,0.20518860673880962,129807.2562358276,2659.148242630378,132466.404478458,886,4,141.5,34,0,18,35.95575350467289,0.6225490196078431,45.238095238095234,1019.0476190476186,29.971988795518193,0
2416,4,1,0,35,0.02857142857142857,0.0,1.0,35,550,400,150,0.7272727272727273,7,4,3,354.1443209812593,0.43599439775910365,0.05554169030062406,0.20101623885703812,130114.93866008663,2215.8933202589224,132330.83198034554,887,0,138.42857142857142,35,0,19,35.90340801663831,0.6235119047619048,44.936342592592595,1020.25462962963,29.150132275132286,0
2417,4,0,1,34,0.0,0.02857142857142857,0.9714285714285714,35,1200,1100,100,0.9166666666666666,13,11,2,351.02040816326513,0.4352591036414566,0.060874635568513025,0.20000000000000007,130262.58680555565,2144.965277777788,132407.55208333343,888,1,139.42857142857142,35,0,21,35.833333333333336,0.625,44.79166666666667,1020.8333333333342,29.16666666666669,0
2418,4,0,2,32,0.0,0.058823529411764705,0.9411764705882353,34,1400,1000,400,0.7142857142857143,18,10,8,357.2859513280307,0.4338978015448604,0.04638484067892312,0.20439110530673552,130419.01139285375,2519.3761113514056,132938.38750420517,889,2,137.97058823529412,33,1,23,35.51477204559088,0.6309974747474747,44.638480392156865,1021.4460784313728,30.95291146761736,0
2419,4,0,0,32,0.0,0.0,1.0,32,850,500,350,0.5882352941176471,12,5,7,372.8074333779761,0.43094758064516125,0.0594925111536011,0.21332416592634754,130428.79104614268,3324.9645657009683,133753.75561184366,890,3,145.25,31,1,23,35.10848204801359,0.6360887096774194,44.62890625000001,1021.4843750000008,32.951108870967765,0
2420,4,0,0,32,0.0,0.0,1.0,32,1300,1100,200,0.8461538461538461,15,11,4,372.0768878377876,0.4298135080645162,0.06786157814291194,0.2140055418618658,130628.37600707995,3320.7599216037183,133949.13592868365,891,4,146.25,31,1,19,34.92455844266122,0.6381048387096775,44.43359374999999,1022.265624999999,32.97631048387093,0
2421,4,1,0,33,0.030303030303030304,0.0,1.0,33,1150,800,350,0.6956521739130435,15,8,7,360.70821788942686,0.4315419823232323,0.06735751295336811,0.20914884221829017,130940.15438475672,2846.2379476584097,133786.39233241513,892,0,142.78787878787878,32,1,20,34.899302985442894,0.638671875,44.12878787878788,1023.484848484849,31.98390151515153,0
2422,4,0,0,33,0.0,0.0,1.0,33,1200,800,400,0.6666666666666666,16,8,8,361.74744876824724,0.43110795454545453,0.06405986595945934,0.20992745648991984,130972.46334876538,2875.790895061728,133848.2542438271,893,1,143.78787878787878,32,1,20,34.84000452284035,0.6389973958333333,44.09722222222222,1023.6111111111107,31.98784722222221,0
2423,4,0,0,33,0.0,0.0,1.0,33,700,200,500,0.2857142857142857,12,2,10,360.48106480392215,0.43047664141414144,0.0648661980515477,0.2095441544440864,131037.09323347107,2847.2781795224937,133884.37141299355,894,2,144.78787878787878,32,1,21,34.80700456283141,0.6396484375,44.03409090909091,1023.8636363636363,31.995738636363633,0
2424,4,0,0,33,0.0,0.0,1.0,33,1000,600,400,0.6,14,6,8,360.8298500276365,0.4300820707070707,0.06739818353676097,0.21009985022068622,131101.73906042744,2861.084168707266,133962.8232291347,895,3,145.78787878787878,32,1,21,34.73266757078864,0.6402994791666667,43.97095959595959,1024.116161616161,32.00363005050503,0
2425,4,1,0,34,0.029411764705882353,0.0,1.0,34,800,400,400,0.5,12,4,8,351.62931092569914,0.432653743315508,0.06629775984024988,0.20629248353467017,131390.93888168002,2440.1810601691495,133831.11994184917,896,0,142.47058823529412,33,1,22,34.67606980635908,0.6407828282828283,43.68872549019607,1025.2450980392148,31.0680332739156,0
2426,4,0,0,34,0.0,0.0,1.0,34,950,700,250,0.7368421052631579,12,7,5,353.2269430298066,0.43189245395127746,0.07113935440332897,0.20757043955571786,131453.76778162245,2486.602508650514,133940.37029027296,897,1,143.47058823529412,33,1,22,34.57168180369663,0.6414141414141414,43.627450980392155,1025.4901960784314,31.075460487225193,0
2427,4,0,0,34,0.0,0.0,1.0,34,1300,900,400,0.6923076923076923,17,9,8,350.6900461552613,0.4321524064171123,0.07054326747421369,0.2067589483388625,131579.4706362937,2428.7221261053364,134008.19276239903,898,2,144.47058823529412,33,1,18,34.50987418378722,0.6426767676767677,43.50490196078431,1025.9803921568625,31.09031491384432,0
2428,4,0,0,34,0.0,0.0,1.0,34,1500,1200,300,0.8,18,12,6,351.7346758743596,0.43161393345216875,0.06920105355575079,0.20788834936116843,131673.78720023533,2462.8473724048176,134136.63457264015,899,3,145.47058823529412,33,1,18,34.38793532338308,0.6436237373737373,43.41299019607842,1026.3480392156848,31.10145573380863,0
2429,4,0,0,34,0.0,0.0,1.0,34,1050,600,450,0.5714285714285714,15,6,9,354.87694877891687,0.4305555555555556,0.07351236344294287,0.21053428886980308,131816.67375283438,2555.7397959183563,134372.41354875272,900,4,146.47058823529412,34,0,18,34.163188809026956,0.6427696078431373,43.27380952380952,1026.9047619047612,30.203081232492977,0
2430,4,0,0,34,0.0,0.0,1.0,34,1250,1000,250,0.8,15,10,5,357.3551387707892,0.4294971776589424,0.08311131703926788,0.21320296565364366,132030.6990504535,2636.3697562358248,134667.06880668932,901,5,147.47058823529412,34,0,18,33.883788949380275,0.6449142156862745,43.06547619047619,1027.7380952380952,30.227591036414566,0
2431,4,0,1,33,0.0,0.029411764705882353,0.9705882352941176,34,1100,800,300,0.7272727272727273,14,8,6,359.63421372561436,0.42931149732620316,0.08092747345551654,0.21525715204075746,132153.0771683673,2705.353599773238,134858.43076814053,902,6,148.47058823529412,34,0,18,33.70190266682105,0.6461397058823529,42.94642857142857,1028.2142857142853,30.24159663865545,0
2432,4,0,0,33,0.0,0.0,1.0,33,1000,500,500,0.5,15,5,10,371.35701307391025,0.42625473484848486,0.08596092028749958,0.22223147929316023,132145.87688629364,3214.6596261053287,135360.53651239898,903,7,153.21212121212122,33,0,19,33.4078267779102,0.6483585858585859,42.95343137254901,1028.186274509803,31.157159833630395,0
2433,4,0,0,33,0.0,0.0,1.0,33,600,400,200,0.6666666666666666,8,4,4,370.76359727972397,0.4260969065656566,0.0844772357107002,0.22206119520158182,132177.37956855522,3201.3121455689948,135378.6917141242,904,8,154.21212121212122,33,0,19,33.391307154490924,0.6486742424242424,42.92279411764705,1028.3088235294106,31.16087344028517,0
2434,4,0,0,33,0.0,0.0,1.0,33,900,700,200,0.7777777777777778,11,7,4,366.95657613999674,0.4259390782828283,0.07929184626825792,0.22033143777676184,132271.91014273342,3107.609453094943,135379.51959582837,905,9,155.21212121212122,33,0,19,33.3938924628703,0.6496212121212122,42.83088235294117,1028.6764705882342,31.172014260249522,0
2435,4,0,0,33,0.0,0.0,1.0,33,550,300,250,0.5454545454545454,8,3,5,366.3243180586603,0.42554450757575757,0.07679124859741604,0.22087278875625893,132429.53619100817,3102.431907199143,135531.96809820732,906,10,156.21212121212122,33,0,21,33.25135432789617,0.651199494949495,42.67769607843137,1029.2892156862738,31.19058229352345,0
2436,4,0,0,33,0.0,0.0,1.0,33,1000,700,300,0.7,13,7,6,366.9195774401845,0.42495265151515155,0.07358431355574568,0.22160254278037314,132492.61289227704,3122.8267072760486,135615.4395995531,907,11,157.21212121212122,33,0,21,33.17251418481927,0.6518308080808081,42.61642156862745,1029.5343137254904,31.198009506833042,0
2437,4,0,0,33,0.0,0.0,1.0,33,1000,700,300,0.7,13,7,6,365.44552456945195,0.42424242424242425,0.06914456319501516,0.22126831329118693,132587.2561034218,3090.6838715878484,135677.93997500965,908,12,158.21212121212122,33,0,21,33.11518324607329,0.6527777777777778,42.52450980392157,1029.9019607843138,31.20915032679739,0
2438,4,0,0,33,0.0,0.0,1.0,33,1150,900,250,0.782608695652174,14,9,5,367.5773097278386,0.42412405303030304,0.06839270650833829,0.22293325148428636,132650.37035034588,3151.853253556306,135802.22360390218,909,13,159.21212121212122,33,0,18,32.99676818145768,0.6534090909090908,42.46323529411764,1030.1470588235281,31.216577540106915,0
2439,4,0,0,33,0.0,0.0,1.0,33,900,600,300,0.6666666666666666,12,6,6,366.2080459746723,0.4231770833333333,0.07691753483479591,0.2232276871549959,132839.80320069208,3129.4009515570965,135969.20415224918,910,14,160.21212121212122,33,0,18,32.84147646219686,0.6553030303030303,42.279411764705884,1030.8823529411768,31.23885918003566,0
2440,4,0,0,33,0.0,0.0,1.0,33,1100,900,200,0.8181818181818182,13,9,4,367.4230756356474,0.4220328282828283,0.08126885389893235,0.22510680136105377,133029.37121539787,3175.612144367547,136204.9833597654,911,15,161.21212121212122,33,0,19,32.61958501623505,0.6571969696969697,42.095588235294116,1031.6176470588232,31.26114081996434,0
2441,4,0,0,33,0.0,0.0,1.0,33,800,500,300,0.625,11,5,6,368.3849395629796,0.4215198863636364,0.0736542482178395,0.22627057447555426,133124.20590938575,3208.1905096597393,136332.3964190455,912,16,162.21212121212122,33,0,20,32.49948046550291,0.6581439393939394,42.00367647058823,1031.9852941176466,31.272281639928686,0
2442,4,0,0,33,0.0,0.0,1.0,33,1050,600,450,0.5714285714285714,15,6,9,363.20120690008935,0.42005997474747475,0.06822227256545532,0.22422685498513192,133313.97667063147,3083.9594446847377,136397.9361153162,913,17,163.21212121212122,33,0,20,32.44271884023576,0.6600378787878788,41.81985294117647,1032.720588235294,31.294563279857393,0
2443,4,0,0,33,0.0,0.0,1.0,33,850,700,150,0.8235294117647058,10,7,3,362.5921704443986,0.41919191919191917,0.061835290396552445,0.22461532615846605,133440.56560277296,3076.900861447517,136517.4664642205,914,18,164.21212121212122,33,0,20,32.3314504012968,0.661300505050505,41.697303921568626,1033.2107843137253,31.309417706476523,0
2444,4,0,0,33,0.0,0.0,1.0,33,1000,600,400,0.6,14,6,8,362.37075103764215,0.41860006313131315,0.0609170127860581,0.22506577905873573,133537.4658835832,3078.018115345056,136615.48399892828,915,19,165.21212121212122,32,1,21,32.24000325759427,0.6647135416666667,41.60353535353535,1033.5858585858577,32.299558080808055,0
2445,4,0,1,32,0.0,0.030303030303030304,0.9696969696969697,33,400,300,100,0.75,5,3,2,370.7355600833315,0.41860006313131315,-0.03598666086704361,0.21643500574697286,131202.5422914263,3128.2896001537783,134330.83189158008,916,20,166.21212121212122,33,0,18,34.37699362041467,0.6388888888888888,43.87254901960784,1024.5098039215682,31.045751633986914,8
2446,4,0,0,32,0.0,0.0,1.0,32,650,500,150,0.7692307692307693,8,5,3,376.6578292849206,0.4188088037634408,-0.027198360857776605,0.21987062063437735,131198.73769258233,3483.4063488419492,134682.1440414243,917,21,168.75,32,0,18,34.22916153150933,0.6412760416666667,43.87626262626262,1024.4949494949492,32.01546717171716,0
2447,4,0,1,31,0.0,0.03125,0.96875,32,1250,1000,250,0.8,15,10,5,397.92913407816525,0.41899781586021506,-0.0048221603278268965,0.22085491172824376,129234.48562622059,3885.2971606589645,133119.78278687954,918,22,169.75,31,1,16,35.68545374994663,0.623991935483871,45.80078124999999,1016.7968749999991,32.799899193548356,8
2448,4,1,1,31,0.03125,0.03125,0.96875,32,950,700,250,0.7368421052631579,12,7,5,396.43708122906895,0.41935483870967744,0.020905282680992565,0.22169850508217886,129532.54699707023,3870.3009711371387,133402.84796820735,919,0,169.59375,31,1,15,35.4187984991899,0.627016129032258,45.50781249999999,1017.9687499999993,32.8377016129032,0
2449,4,2,0,33,0.06060606060606061,0.0,1.0,33,850,600,250,0.7058823529411765,11,6,5,380.4584408186566,0.426333648989899,0.023671079219761637,0.216414185583195,130198.14822785929,3306.996894449531,133505.1451223088,920,0,160.84848484848484,32,1,17,35.14758340550125,0.6311848958333333,44.85479797979797,1020.5808080808072,31.893150252525224,0
2450,4,0,2,31,0.0,0.06060606060606061,0.9393939393939394,33,600,500,100,0.8333333333333334,7,5,2,392.56594037831417,0.4264914772727273,-0.008449180663363087,0.21701045184113202,129076.82742214529,3534.2332276047614,132611.06064975006,921,1,161.84848484848484,33,0,20,35.98297555877151,0.6174242424242424,45.955882352941174,1016.1764705882349,30.793226381461665,8
2451,4,0,0,31,0.0,0.0,1.0,31,500,200,300,0.4,8,2,6,402.4490792066473,0.4185035842293907,0.02751982535495401,0.2220585371973312,129002.89747450095,4183.419460720491,133186.31693522143,922,2,173.19354838709677,31,0,20,35.807592070409285,0.6216397849462365,46.028645833333336,1015.8854166666673,32.77049731182798,0
2452,4,0,0,31,0.0,0.0,1.0,31,1250,900,350,0.72,16,9,7,401.4875728489224,0.41787634408602153,0.024070591638940764,0.2220843732165728,129102.12410820863,4166.579691569016,133268.70379977766,923,3,174.19354838709677,31,0,21,35.730434550501805,0.6226478494623655,45.930989583333336,1016.2760416666673,32.78309811827959,0
2453,4,0,0,31,0.0,0.0,1.0,31,800,400,400,0.5,12,4,8,400.2331513551544,0.41742831541218633,0.025122202159352458,0.22176154809295193,129168.29639010967,4139.486863878049,133307.78325398773,924,4,175.19354838709677,31,0,22,35.69459566201272,0.6233198924731183,45.86588541666667,1016.5364583333339,32.791498655914,0
2454,4,0,0,31,0.0,0.0,1.0,31,950,800,150,0.8421052631578947,11,8,3,399.41219918297963,0.41626344086021505,0.017893248404276196,0.22208773991017164,129307.31336805562,4129.3921576606,133436.7055257162,925,5,176.19354838709677,29,2,22,35.5732793936911,0.6303879310344828,45.72916666666667,1017.0833333333339,35.07183908045979,0
2455,4,0,0,31,0.0,0.0,1.0,31,950,500,450,0.5263157894736842,14,5,9,398.0058008829458,0.4166218637992831,0.01554552460640779,0.2217028510621731,129377.9538001543,4098.635223765431,133476.58902391972,926,6,177.19354838709677,29,2,22,35.536831626848695,0.6311063218390804,45.65972222222222,1017.361111111111,35.081417624521066,0
2456,4,0,0,31,0.0,0.0,1.0,31,1100,1000,100,0.9090909090909091,12,10,2,397.87259351869153,0.41639784946236563,0.00851003911801862,0.2228268894641351,129589.9908371914,4112.061149691367,133702.05198688278,927,7,178.19354838709677,29,2,19,35.323597280953045,0.6332614942528736,45.45138888888889,1018.1944444444448,35.11015325670499,0
2457,4,1,0,32,0.03125,0.0,1.0,32,750,400,350,0.5333333333333333,11,4,7,387.050313666481,0.4207409274193548,0.005480916517743406,0.2194031951709995,130063.28158908428,3668.206787109386,133731.48837619365,928,0,173.59375,31,1,20,35.11669219640882,0.6323924731182795,44.98697916666667,1020.0520833333339,32.90490591397852,0
2458,4,1,2,31,0.030303030303030304,0.06060606060606061,0.9393939393939394,33,750,600,150,0.8,9,6,3,406.1408223595805,0.421914457070707,-0.045454545454545636,0.22522354694485847,129201.38888888895,3894.9442545572983,133096.33314344625,929,0,169.3030303030303,31,2,19,35.510587431694,0.6236559139784946,45.833333333333336,1016.6666666666672,32.7956989247312,8
2459,4,3,1,33,0.08823529411764706,0.029411764705882353,0.9705882352941176,34,1250,1100,150,0.88,14,11,3,387.77012602808725,0.4262106357694593,-0.015290620149955192,0.21876088241961913,129876.19447314054,3272.421659779618,133148.61613292014,930,0,163.97058823529412,32,2,19,35.28892604979561,0.6279296875,45.17045454545455,1019.3181818181822,31.853693181818194,0
2460,4,1,1,33,0.029411764705882353,0.029411764705882353,0.9705882352941176,34,700,600,100,0.8571428571428571,8,6,2,391.6349836199657,0.4230540701128936,-0.043965966437539694,0.20808922630639154,127493.93449935105,3186.2169898596494,130680.1514892107,931,0,164.94117647058823,33,1,14,37.630318933786356,0.6013257575757576,47.51838235294117,1009.9264705882339,30.603832442067695,8
2461,4,2,1,34,0.05714285714285714,0.02857142857142857,0.9714285714285714,35,1100,800,300,0.7272727272727273,14,8,6,382.9657514691751,0.42794117647058827,-0.0340799031476996,0.20540890306073917,127873.46938775502,2794.2318594104236,130667.70124716545,932,0,161.14285714285714,34,1,17,37.45929456999372,0.6029411764705883,47.14285714285714,1011.4285714285708,29.747899159663845,0
2462,4,2,1,35,0.05555555555555555,0.027777777777777776,0.9722222222222222,36,700,500,200,0.7142857142857143,9,5,4,349.78134806623535,0.42938161375661377,0.07215330423462762,0.1832248144563565,126917.01630015433,1685.500421233309,128602.51672138764,933,0,154.52777777777777,35,1,21,39.27894555478981,0.5910714285714286,48.09027777777778,1007.6388888888889,28.78968253968254,7
2463,4,2,0,37,0.05405405405405406,0.0,1.0,37,1500,1100,400,0.7333333333333333,19,11,8,340.2468387443102,0.4310247747747748,0.08967284377120444,0.18042390117730187,127413.15593117705,1270.5052672753693,128683.66119845242,934,0,151.27027027027026,35,2,18,39.01049428713364,0.5961309523809524,47.598379629629626,1009.6064814814808,28.845899470899454,0
2464,4,2,0,39,0.05128205128205128,0.0,1.0,39,1150,700,450,0.6086956521739131,16,7,9,327.06860922298733,0.43755623031938823,0.10518597520330641,0.1763725117024896,128089.02739304412,578.7800092336208,128667.80740227774,935,0,144.46153846153845,37,2,20,38.652693529751595,0.5990990990990991,46.929824561403514,1012.2807017543868,27.358937885253695,0
2465,4,1,2,38,0.025,0.05,0.95,40,800,700,100,0.875,9,7,2,321.1996059986718,0.438928952991453,0.11626763692923014,0.17468988843468544,128429.74044568211,250.34045179321816,128680.08089747533,936,0,141.825,36,4,15,38.454060659926675,0.6044560185185186,46.593468468468465,1013.6261261261257,28.156281281281267,0
2466,4,0,0,38,0.0,0.0,1.0,38,1400,1000,400,0.7142857142857143,18,10,8,340.22591407136457,0.4363738738738739,0.12053281351526968,0.1837219935985366,128144.53124999988,1119.6180555555402,129264.14930555542,937,1,148.6578947368421,34,4,22,38.26303155006859,0.6056985294117647,46.87499999999999,1012.4999999999991,29.779411764705856,0
2467,4,2,2,38,0.05,0.05,0.95,40,1450,1300,150,0.896551724137931,16,13,3,326.6765963212554,0.43667200854700855,0.11688506473002858,0.17930412141237703,128794.39153928333,414.8226906640333,129209.21422994736,938,0,142.175,38,2,17,37.944032207136075,0.6044407894736843,46.23397435897436,1015.0641025641023,26.712213225371112,0
2468,4,0,0,38,0.0,0.0,1.0,38,950,700,250,0.7368421052631579,12,7,5,346.03454617260246,0.4354403745851114,0.12616674946667028,0.18873658923587439,128543.91289515872,1296.126912385361,129840.03980754408,939,3,150.6578947368421,36,2,19,37.70821765685729,0.6056134259259259,46.48085585585586,1014.0765765765769,28.168793793793803,0
2469,4,1,0,39,0.02564102564102564,0.0,1.0,39,1250,900,350,0.72,16,9,7,335.42375194713696,0.4368814664867296,0.1249234978579401,0.1843138587108924,128839.34389667958,843.155225646331,129682.49912232591,940,0,147.76923076923077,37,2,20,37.676292436188206,0.6067004504504505,46.18969298245613,1015.2412280701741,27.438952110004706,0
2470,4,0,1,38,0.0,0.02564102564102564,0.9743589743589743,39,950,700,250,0.7368421052631579,12,7,5,333.20234812337907,0.4361504723346829,0.12008241372986839,0.18376380080957586,128984.24373584628,795.5705767404439,129779.81431258672,941,1,148.76923076923077,38,1,20,37.58523524049922,0.606359649122807,46.047008547008545,1015.8119658119656,26.73189383715699,0
2471,4,0,0,38,0.0,0.0,1.0,38,850,500,350,0.5882352941176471,12,5,7,343.34303468112563,0.43372155049786626,0.12881723851845117,0.18906320970372067,128922.84765504758,1252.9523507232834,130175.80000577086,942,2,153.5,37,1,20,37.390232491182594,0.607545045045045,46.10745614035087,1015.5701754385955,27.4478425794215,0
2472,4,1,1,38,0.02564102564102564,0.02564102564102564,0.9743589743589743,39,950,700,250,0.7368421052631579,12,7,5,336.4283495338105,0.43581309041835353,0.1357442026764739,0.1867039198139307,129230.80800165022,896.2832087431021,130127.09121039332,943,0,150.53846153846155,35,4,22,37.25253746917093,0.6145833333333333,45.80439814814814,1016.7824074074061,29.05092592592589,0
2473,4,0,0,38,0.0,0.0,1.0,38,1100,900,200,0.8181818181818182,13,9,4,342.9857565170652,0.4350106685633002,0.1276962899050904,0.1902011922503723,129201.38888888872,1262.8472222221972,130464.23611111092,944,1,145.3684210526316,34,4,22,37.115778688524586,0.616421568627451,45.83333333333332,1016.6666666666653,29.901960784313683,0
2474,4,0,0,38,0.0,0.0,1.0,38,850,500,350,0.5882352941176471,12,5,7,343.49616348839993,0.4351884779516359,0.12566390220458667,0.19077660783601497,129261.91184807249,1280.194160997722,130542.10600907021,945,2,146.3684210526316,34,4,23,37.04123741512526,0.6170343137254901,45.77380952380952,1016.9047619047612,29.908963585434154,0
2475,4,0,0,38,0.0,0.0,1.0,38,1300,1100,200,0.8461538461538461,15,11,4,343.75899240764096,0.4349069464201043,0.12231130652183286,0.19165741083549306,129413.28125,1297.3958333333333,130710.67708333333,946,3,147.3684210526316,34,4,24,36.88063063063063,0.6185661764705883,45.625,1017.5,29.926470588235293,0
2476,4,0,0,38,0.0,0.0,1.0,38,1600,1100,500,0.6875,21,11,10,345.39046449692285,0.43392899478425795,0.1125162186925428,0.19435877617548736,129776.92920918373,1364.7427721088507,131141.67198129257,947,4,148.3684210526316,34,4,18,36.46965182848463,0.6222426470588236,45.267857142857146,1018.9285714285718,29.968487394957993,0
2477,4,0,1,37,0.0,0.02631578947368421,0.9736842105263158,38,1300,900,400,0.6923076923076923,17,9,8,343.2788358901317,0.4342549786628734,0.11169536008654113,0.19377038046982203,129898.25857426319,1318.264597505687,131216.52317176887,948,5,149.3684210526316,34,4,19,36.40030752462142,0.623468137254902,45.14880952380953,1019.4047619047631,29.982492997198914,0
2478,4,1,1,37,0.02631578947368421,0.02631578947368421,0.9736842105263158,38,1450,1100,350,0.7586206896551724,18,11,7,345.32974524444495,0.43357337600758655,0.12261149430935214,0.19583921819984448,130080.35891439911,1384.1234410430832,131464.4823554422,949,0,150.1315789473684,34,4,21,36.163301824405806,0.6253063725490196,44.970238095238095,1020.1190476190478,30.00350140056023,0
2479,4,0,0,37,0.0,0.0,1.0,37,1050,800,250,0.7619047619047619,13,8,5,347.0308392578923,0.43321446446446443,0.10787516934035413,0.19742696390813513,130203.51750042869,1636.9271905006876,131840.44469092938,950,1,146.9189189189189,35,2,21,35.99502910712937,0.6244047619047619,44.84953703703704,1020.601851851852,29.16005291005291,0
2480,4,0,0,37,0.0,0.0,1.0,37,1150,700,450,0.6086956521739131,16,7,9,348.1728365428042,0.4326514014014014,0.1057573838266388,0.19868785223071397,130323.3577806122,1675.0240251707614,131998.38180578296,951,2,147.9189189189189,34,3,22,35.84440946717967,0.6277573529411764,44.732142857142854,1021.0714285714283,30.03151260504201,0
2481,4,0,0,37,0.0,0.0,1.0,37,650,400,250,0.6153846153846154,9,4,5,348.1728365428042,0.4326514014014014,0.1057573838266388,0.19868785223071397,130323.3577806122,1675.0106292516944,131998.3684098639,952,3,148.9189189189189,34,3,22,35.84440946717967,0.6277573529411764,44.732142857142854,1021.0714285714283,30.03151260504201,0
2482,4,0,1,36,0.0,0.02702702702702703,0.972972972972973,37,900,500,400,0.5555555555555556,13,5,8,350.3536926592481,0.4327765265265265,0.10282301880017797,0.2005593753641767,130444.94224773247,1740.3734410430893,132185.31568877556,953,4,149.9189189189189,34,3,23,35.665520724080345,0.6289828431372548,44.61309523809524,1021.5476190476194,30.045518207282925,0
2483,4,1,0,37,0.02702702702702703,0.0,1.0,37,850,700,150,0.8235294117647058,10,7,3,349.2996911451709,0.43430930930930933,0.10287138559146003,0.20105802597551786,130657.8514739229,1727.7494331065773,132385.60090702947,954,0,150.0,34,3,18,35.476828132277596,0.6311274509803921,44.404761904761905,1022.3809523809523,30.070028011204478,0
2484,4,0,0,37,0.0,0.0,1.0,37,800,600,200,0.75,10,6,4,350.5240004824623,0.4341529029029029,0.10448982160274345,0.2020806150432451,130718.71456916103,1764.0093537414955,132482.72392290254,955,1,151.0,34,3,18,35.383925106713235,0.6317401960784313,44.345238095238095,1022.6190476190479,30.07703081232494,0
2485,4,0,0,37,0.0,0.0,1.0,37,1350,1100,250,0.8148148148148148,16,11,5,352.2851252990112,0.43337087087087084,0.10416398010951711,0.2035767371684199,130810.03578514735,1816.4859693877524,132626.52175453512,956,2,152.0,34,3,20,35.24646999495713,0.6326593137254901,44.25595238095238,1022.9761904761901,30.087535014005592,0
2486,4,0,0,37,0.0,0.0,1.0,37,800,600,200,0.75,10,6,4,349.5205802630658,0.43346471471471476,0.09639440533938637,0.20261823523409156,130931.84700963713,1752.6750283446654,132684.5220379818,957,3,153.0,34,3,21,35.193963010352455,0.6338848039215687,44.13690476190476,1023.4523809523805,30.101540616246485,0
2487,4,0,0,37,0.0,0.0,1.0,37,1050,700,350,0.6666666666666666,14,7,7,350.2222198682374,0.43321446446446443,0.09728850086864749,0.20399199441614363,131114.67013888867,1783.8541666666429,132898.52430555533,958,4,154.0,34,3,23,34.991185245457,0.6357230392156863,43.95833333333332,1024.166666666665,30.122549019607792,0
2488,4,0,0,37,0.0,0.0,1.0,37,850,600,250,0.7058823529411765,11,6,5,352.34576762648777,0.4329016516516517,0.10040584517572015,0.20539180112861108,131145.15306122435,1841.6879251700582,132986.8409863944,959,5,155.0,34,3,23,34.90600302185032,0.6360294117647058,43.92857142857142,1024.2857142857133,30.12605042016804,0
2489,4,0,0,37,0.0,0.0,1.0,37,1150,800,350,0.6956521739130435,15,8,7,353.7892908472795,0.43243243243243246,0.10319752838340168,0.20688982443025683,131267.1201814057,1888.180272108816,133155.30045351453,960,6,156.0,34,3,23,34.74577912019825,0.6372549019607843,43.809523809523796,1024.7619047619032,30.140056022408917,0
2490,4,0,0,37,0.0,0.0,1.0,37,1600,1200,400,0.75,20,12,8,348.88938687561614,0.43177552552552556,0.10342685383316974,0.2050022632023568,131450.17715419468,1772.3143424035968,133222.4914965983,961,7,157.0,34,3,24,34.6865083971829,0.639093137254902,43.630952380952365,1025.4761904761879,30.16106442577023,0
2491,4,0,0,37,0.0,0.0,1.0,37,1350,1200,150,0.8888888888888888,15,12,3,347.54705222639626,0.43124374374374375,0.09956302858181765,0.2055247382919057,131694.45153061207,1754.0036848072336,133448.4552154193,962,8,158.0,34,3,21,34.474551534833374,0.6415441176470589,43.39285714285713,1026.42857142857,30.18907563025206,0
2492,4,0,0,37,0.0,0.0,1.0,37,1350,1000,350,0.7407407407407407,17,10,7,347.830237370211,0.43105605605605607,0.09609122052587282,0.20585725029810042,131725.00177154157,1763.5877267573314,133488.5894982989,963,9,159.0,34,3,21,34.43648768796631,0.6418504901960784,43.36309523809522,1026.547619047616,30.192577030812238,0
2493,4,0,0,37,0.0,0.0,1.0,37,750,300,450,0.4,12,3,9,345.0458483945685,0.4300863363363363,0.09632508856057354,0.20519645939329625,131908.3776218819,1702.887613378657,133611.26523526057,964,10,160.0,34,3,22,34.323212423224,0.6436887254901961,43.184523809523796,1027.2619047619032,30.213585434173623,0
2494,4,0,1,36,0.0,0.02702702702702703,0.972972972972973,37,900,600,300,0.6666666666666666,12,6,6,344.7113885024161,0.4295232732732733,0.09651973029318417,0.2058255967033097,132061.28826530598,1704.6060090702786,133765.89427437625,965,11,161.0,34,3,23,34.17786271330399,0.6452205882352942,43.03571428571428,1027.8571428571418,30.23109243697476,0
2495,4,0,0,36,0.0,0.0,1.0,36,950,600,350,0.631578947368421,13,6,7,349.3887051965059,0.42802579365079363,0.09425280703785188,0.20946349925000787,132214.28748582763,2038.8357426303803,134253.12322845802,966,12,161.11111111111111,34,2,23,33.90366361847437,0.6467524509803921,42.88690476190476,1028.4523809523807,30.248599439775905,0
2496,4,0,0,36,0.0,0.0,1.0,36,1000,600,400,0.6,14,6,8,349.5514163944099,0.42698412698412697,0.09504987402951293,0.21041242641457375,132367.3752834467,2053.840702947837,134421.21598639453,967,13,162.11111111111111,34,2,24,33.74546891871047,0.6482843137254901,42.738095238095234,1029.0476190476188,30.266106442577023,0
2497,4,0,1,35,0.0,0.027777777777777776,0.9722222222222222,36,900,600,300,0.6666666666666666,12,6,6,348.787151462354,0.42663690476190474,0.0933934628430464,0.21063626297810326,132489.90929705222,2042.1556122449012,134532.06490929713,968,14,163.11111111111111,34,2,24,33.641930696885595,0.6495098039215687,42.61904761904762,1029.5238095238099,30.280112044817937,0
2498,4,0,0,35,0.0,0.0,1.0,35,1450,1100,350,0.7586206896551724,18,11,7,356.1643027795122,0.42661064425770306,0.09078631809909332,0.21474687573906134,132429.53619100832,2433.334684976936,134862.87087598525,969,15,164.17142857142858,33,2,24,33.51279418184703,0.651199494949495,42.677696078431374,1029.289215686275,31.190582293523484,0
2499,4,0,0,35,0.0,0.0,1.0,35,950,800,150,0.8421052631578947,11,8,3,358.6339515467186,0.42633053221288514,0.08331718263885324,0.21696192187523952,132555.70461180797,2507.795228998462,135063.49984080644,970,16,165.17142857142858,33,2,25,33.32230056725773,0.6524621212121212,42.55514705882353,1029.779411764706,31.205436720142607,0
2500,4,0,0,35,0.0,0.0,1.0,35,1000,800,200,0.8,12,8,4,361.41867302458985,0.4253501400560224,0.13477126805778483,0.20103913686992816,129322.44897959188,2347.9095804988688,131670.35856009074,971,17,166.17142857142858,34,1,20,36.52392517166042,0.6176470588235294,45.714285714285715,1017.1428571428575,29.91596638655463,8
2501,4,0,0,35,0.0,0.0,1.0,35,1100,800,300,0.7272727272727273,14,8,6,363.57169727437525,0.42489495798319327,0.1344695071010864,0.20317241906509198,129504.14540816323,2416.808390022674,131920.9537981859,972,18,167.17142857142858,34,1,15,36.284113060428865,0.6194852941176471,45.535714285714285,1017.8571428571425,29.936974789915958,0
2502,4,0,0,35,0.0,0.0,1.0,35,1400,1100,300,0.7857142857142857,17,11,6,365.9626734491592,0.4236344537815126,0.14459673784203408,0.20561671678952403,129716.28578514722,2494.263747165512,132210.54953231273,973,19,168.17142857142858,34,1,15,36.007313700284364,0.6216299019607843,45.32738095238094,1018.6904761904748,29.961484593837493,0
2503,4,1,0,36,0.027777777777777776,0.0,1.0,36,650,500,150,0.7692307692307693,8,5,3,356.0633075997188,0.42663690476190474,0.13916625691844176,0.20179973825571168,130055.9028447571,2061.626987954359,132117.52983271147,974,0,164.47222222222223,35,1,16,35.91439256401529,0.6229166666666667,44.99421296296295,1020.0231481481459,29.143518518518455,0
2504,4,0,0,36,0.0,0.0,1.0,36,1250,1100,150,0.88,14,11,3,351.6867971678467,0.4263558201058201,0.14070294784580528,0.20037968675842413,130262.5868055554,1962.3263888888703,132224.91319444426,975,1,165.47222222222223,35,1,18,35.81632653061224,0.625,44.79166666666666,1020.8333333333321,29.166666666666632,0
2505,4,0,0,36,0.0,0.0,1.0,36,900,500,400,0.5555555555555556,13,5,8,351.16740267493265,0.4259755291005291,0.1395942762851281,0.2002357892046269,130292.12648158851,1950.8695291066383,132242.99601069515,976,2,166.47222222222223,35,1,18,35.79963061633224,0.625297619047619,44.762731481481474,1020.9490740740729,29.169973544973512,0
2506,4,1,0,37,0.02702702702702703,0.0,1.0,37,1200,1000,200,0.8333333333333334,14,10,4,339.72301884695287,0.42836586586586584,0.13752179838944878,0.19602061354307654,130751.61944038629,1483.8669750831896,132235.48641546947,977,0,162.94594594594594,36,1,14,35.62678925346839,0.6278935185185186,44.31306306306306,1022.7477477477474,28.409659659659653,0
2507,4,0,0,37,0.0,0.0,1.0,37,1100,500,600,0.45454545454545453,17,5,12,339.22628146559936,0.42761511511511513,0.14025736059634397,0.1963191078596455,130866.81909950482,1478.6928820712524,132345.51198157607,978,1,163.94594594594594,36,1,14,35.523057451023554,0.6290509259259259,44.20045045045045,1023.1981981981975,28.422172172172154,0
2508,4,0,1,36,0.0,0.02702702702702703,0.972972972972973,37,800,600,200,0.75,10,6,4,340.58052179955513,0.4273961461461462,0.13581608894624653,0.1975453964668892,130953.25213304508,1520.025388564232,132473.27752160933,979,2,164.94594594594594,36,1,14,35.40108006014598,0.6299189814814814,44.11599099099099,1023.5360360360351,28.43155655655653,0
2509,4,0,0,36,0.0,0.0,1.0,36,1350,900,450,0.6666666666666666,18,9,9,351.3873274829406,0.4234623015873016,0.1464537937620951,0.2036020150461443,130913.23329260979,2000.250235768181,132913.48352837798,980,3,170.38888888888889,35,1,15,35.16502676619165,0.631547619047619,44.155092592592595,1023.3796296296301,29.239417989418005,0
2510,4,2,2,36,0.05263157894736842,0.05263157894736842,0.9473684210526316,38,1150,800,350,0.6956521739130435,15,8,7,336.82979182236454,0.4254385964912281,0.1642704870544427,0.19859586402532217,131581.12502164117,1264.0885897583769,132845.21361139955,981,0,162.3684210526316,37,1,15,34.8637161127142,0.6342905405405406,43.503289473684205,1025.9868421052624,27.72937411095304,0
2511,4,0,1,35,0.0,0.027777777777777776,0.9722222222222222,36,1550,1000,550,0.6451612903225806,21,10,11,345.56020931606173,0.4242559523809524,0.09436568587637417,0.19176786293268094,129230.01284646118,1731.3500578280832,130961.36290428926,982,1,167.25,36,0,20,37.02121866578064,0.6125578703703703,45.80518018018017,1016.7792792792781,28.243868868868834,8
2512,4,0,1,34,0.0,0.02857142857142857,0.9714285714285714,35,1250,1000,250,0.8,15,10,5,347.1537233980593,0.42170868347338936,0.1106972208678696,0.19337650371793033,129377.95380015431,1982.8076774691335,131360.76147762345,983,2,172.22857142857143,35,0,21,36.83020477815699,0.6160714285714286,45.65972222222222,1017.3611111111111,29.067460317460316,0
2513,4,0,0,34,0.0,0.0,1.0,34,1200,800,400,0.6666666666666666,16,8,8,353.0282547097026,0.4190805109922757,0.11204973562458709,0.1963719666822723,129322.44897959198,2330.8956916099937,131653.34467120198,984,3,178.23529411764707,34,0,21,36.73728152309613,0.6176470588235294,45.71428571428572,1017.1428571428582,29.915966386554654,0
2514,4,0,0,34,0.0,0.0,1.0,34,1550,1300,250,0.8387096774193549,18,13,5,353.1812050945712,0.4178735888294712,0.11403122484225836,0.19721398578402957,129473.8538123584,2345.5463435374286,131819.40015589583,985,4,179.23529411764707,34,0,19,36.57932701680508,0.6191789215686274,45.5654761904762,1017.7380952380963,29.933473389355775,0
2515,4,0,0,34,0.0,0.0,1.0,34,800,500,300,0.625,11,5,6,353.8245311136799,0.41818924539512775,0.11844494579871268,0.19803058835629533,129564.73922902503,2368.636621315204,131933.37585034024,986,5,180.23529411764707,34,0,19,36.470513719987544,0.6200980392156863,45.47619047619048,1018.0952380952388,29.943977591036433,0
2516,4,0,0,34,0.0,0.0,1.0,34,1100,700,400,0.6363636363636364,15,7,8,353.9883395929777,0.41729797979797983,0.1267523364485985,0.19935132808657163,129807.25623582768,2390.0510204081684,132197.30725623586,987,6,181.23529411764707,34,0,20,36.21982087227414,0.6225490196078431,45.23809523809524,1019.0476190476192,29.97198879551821,0
2517,4,0,0,34,0.0,0.0,1.0,34,750,400,350,0.5333333333333333,11,4,7,352.3003194177962,0.41687091503267976,0.13283895830900394,0.19886273138922803,129898.25857426308,2352.639597505672,132250.89817176876,988,7,182.23529411764707,34,0,20,36.17039394293277,0.623468137254902,45.148809523809526,1019.4047619047622,29.982492997198886,0
2518,4,0,1,33,0.0,0.029411764705882353,0.9705882352941176,34,1100,700,400,0.6363636363636364,15,7,8,353.3376157281982,0.41668523469994057,0.14043439758912046,0.20038054461779825,130080.35891439914,2392.456774376417,132472.81568877556,989,8,183.23529411764707,34,0,20,35.959077294122224,0.6253063725490196,44.970238095238095,1020.119047619048,30.003501400560236,0
2519,4,0,0,33,0.0,0.0,1.0,33,1200,800,400,0.6666666666666666,16,8,8,358.30654962115256,0.4171006944444444,0.13757168224027017,0.2038235618336719,130200.04325259502,2730.3056516724173,132930.34890426742,990,9,185.84848484848484,33,0,21,35.71085494716619,0.6287878787878788,44.85294117647058,1020.5882352941165,30.926916221033835,0
2520,4,1,0,34,0.029411764705882353,0.0,1.0,34,700,400,300,0.5714285714285714,10,4,6,355.707675651356,0.41934046345811055,0.14390658406885581,0.2041039229806978,130536.16780045342,2486.543367346928,133022.71116780036,991,0,181.35294117647058,34,0,17,35.43632533395464,0.6299019607843137,44.52380952380952,1021.9047619047611,30.056022408963564,0
2521,4,0,0,34,0.0,0.0,1.0,34,1100,800,300,0.7272727272727273,14,8,6,384.61473719648137,0.41883912655971484,0.19418374091209456,0.2062091060872705,127857.05061983495,3070.189370514069,130927.23999034901,992,1,182.35294117647058,32,2,19,37.434456928838934,0.607421875,47.15909090909092,1011.3636363636383,31.605113636363697,8
2522,4,0,1,33,0.0,0.029411764705882353,0.9705882352941176,34,700,500,200,0.7142857142857143,9,5,4,380.9819588866476,0.4188762626262626,0.19058559285955456,0.20491204151124803,127984.77993317023,2951.9784333231464,130936.75836649338,993,2,183.35294117647058,32,2,19,37.39523542134598,0.6087239583333333,47.03282828282829,1011.868686868688,31.6208964646465,0
2523,4,2,0,35,0.05714285714285714,0.0,1.0,35,950,800,150,0.8421052631578947,11,8,3,362.62109829762505,0.4242296918767507,0.17360135463644455,0.19819720196241572,128627.12762188198,2328.5820578231182,130955.7096797051,994,0,170.65714285714284,34,1,17,37.202695301803374,0.6106004901960784,46.39880952380952,1014.4047619047611,29.835434173669444,0
2524,4,1,2,34,0.027777777777777776,0.05555555555555555,0.9444444444444444,36,1450,1100,350,0.7586206896551724,18,11,7,355.6162512164962,0.4270502645502645,0.16554644186223189,0.19632700963386157,129024.94454089488,1976.6734182098587,131001.61795910474,995,0,166.88888888888889,35,1,19,36.97453861927546,0.6125,46.006944444444436,1015.9722222222207,29.027777777777732,0
2525,4,0,0,34,0.0,0.0,1.0,34,900,700,200,0.7777777777777778,11,7,4,364.32866609024904,0.4268605169340463,0.15289291392232585,0.20076835003696694,128952.32602845048,2596.205786236047,131548.53181468652,996,1,169.97058823529412,33,1,19,36.82734073359073,0.6161616161616161,46.07843137254901,1015.686274509803,30.778371954842513,0
2526,4,0,0,34,0.0,0.0,1.0,34,600,300,300,0.5,9,3,6,363.3117222349048,0.42637774806892453,0.14937147073011592,0.2008387200514551,129076.82742214516,2579.024894271414,131655.85231641657,997,2,170.97058823529412,33,1,19,36.72616176234121,0.6174242424242424,45.95588235294117,1016.1764705882339,30.793226381461633,0
2527,4,1,0,35,0.02857142857142857,0.0,1.0,35,950,700,250,0.7368421052631579,12,7,5,353.12608403963736,0.42871148459383757,0.15307350968318922,0.19737989596455097,129513.05537533638,2146.947688389074,131660.00306372545,998,0,167.05714285714285,33,2,18,36.54085400112366,0.6218434343434344,45.52696078431372,1017.8921568627449,30.845216874628633,0
2528,4,2,0,37,0.05405405405405406,0.0,1.0,37,700,600,100,0.8571428571428571,8,6,2,337.79926381094515,0.43324574574574576,0.16378102435958475,0.19173860338013388,130114.93866008642,1390.5460980366838,131505.48475812312,999,0,158.97297297297297,35,2,20,36.32031102287769,0.6235119047619048,44.93634259259259,1020.2546296296283,29.150132275132236,0
2529,4,1,1,37,0.02631578947368421,0.02631578947368421,0.9736842105263158,38,900,500,400,0.5555555555555556,13,5,8,330.2457897319516,0.43466986723565676,0.16273798730734335,0.18873632439085117,130380.76560356662,1011.6235050154406,131392.38910858205,1000,0,155.76315789473685,35,3,21,36.24395587790873,0.6261904761904762,44.67592592592593,1021.296296296297,29.179894179894198,0
2530,4,0,0,37,0.0,0.0,1.0,37,1150,900,250,0.782608695652174,14,9,5,336.6337704488012,0.43105605605605607,0.16130526143348156,0.19240380524185657,130384.14292800457,1378.34112811792,131762.48405612248,1001,1,160.83783783783784,34,3,21,36.077437152737325,0.6283700980392157,44.67261904761905,1021.3095238095241,30.038515406162475,0
2531,4,0,0,37,0.0,0.0,1.0,37,800,500,300,0.625,11,5,6,338.08095138982435,0.43043043043043044,0.16618016128676683,0.19383759557641053,130505.75573979599,1424.3020124716584,131930.05775226766,1002,2,161.83783783783784,34,3,17,35.917414268515266,0.6295955882352942,44.55357142857143,1021.7857142857149,30.052521008403378,0
2532,4,0,1,36,0.0,0.02702702702702703,0.972972972972973,37,950,600,350,0.631578947368421,13,6,7,340.03358631997133,0.4301488988988989,0.16928795570929034,0.19557055631142584,130627.42524092946,1483.5423752834186,132110.96761621287,1003,3,162.83783783783784,34,3,17,35.74443926866195,0.6308210784313726,44.434523809523796,1022.2619047619028,30.0665266106442,0
2533,4,0,2,34,0.0,0.05555555555555555,0.9444444444444444,36,1100,600,500,0.5454545454545454,16,6,10,356.1672565633485,0.42928240740740736,0.13664236625280068,0.19677736597669154,129054.34355977768,1992.9862986539492,131047.32985843164,1004,4,166.44444444444446,35,1,19,36.930577704370286,0.612797619047619,45.978009259259245,1016.0879629629608,29.031084656084595,8
2534,4,0,1,33,0.0,0.029411764705882353,0.9705882352941176,34,750,400,350,0.5333333333333333,11,4,7,380.80205266876095,0.4248180332739156,0.13760900201014392,0.1995752249264003,126937.5979941609,2867.61957540369,129805.21756956459,1005,6,176.8235294117647,33,1,18,38.47630122826218,0.5956439393939394,48.06985294117647,1007.720588235294,30.53698752228164,8
2535,4,3,1,35,0.08333333333333333,0.027777777777777776,0.9722222222222222,36,800,600,200,0.75,10,6,4,359.0220136973908,0.43093584656084655,0.13323033493553105,0.1924622304102943,127851.72994898814,1980.317108196134,129832.04705718427,1006,0,158.75,35,1,15,38.086995498588536,0.6005952380952381,47.16435185185184,1011.342592592591,28.8955026455026,0
2536,4,0,0,35,0.0,0.0,1.0,35,950,500,450,0.5263157894736842,14,5,9,365.37122869237646,0.43007703081232496,0.13269415148609798,0.19553231539283875,127783.17920918351,2337.659438775489,130120.838647959,1007,1,164.28571428571428,34,1,15,37.99673260332037,0.6020220588235294,47.23214285714285,1011.0714285714272,29.737394957983152,0
2537,4,1,0,36,0.027777777777777776,0.0,1.0,36,750,400,350,0.5333333333333333,11,4,7,360.86301567071007,0.4308201058201058,0.13089793429377328,0.1945812537025909,128085.9441979593,2044.296017661157,130130.24021562045,1008,0,160.69444444444446,35,1,16,37.800613613842536,0.6029761904761906,46.93287037037036,1012.2685185185165,28.921957671957614,0
2538,4,0,0,36,0.0,0.0,1.0,36,1050,800,250,0.7619047619047619,13,8,5,360.6469346626263,0.4309027777777778,0.13678579826005155,0.19489598641933292,128174.6669501134,2045.1735433113563,130219.84049342475,1009,1,161.69444444444446,34,2,16,37.71528920761814,0.6060049019607843,46.845238095238095,1012.6190476190478,29.782913165266113,0
2539,4,1,0,37,0.02702702702702703,0.0,1.0,37,1000,700,300,0.7,13,7,6,352.61775358499625,0.43205705705705705,0.1446251179310727,0.19294926516392524,128672.41753472241,1674.4357638889132,130346.85329861133,1010,0,158.2972972972973,35,2,13,37.41016427104722,0.6089285714285715,46.35416666666668,1014.5833333333348,28.98809523809528,0
2540,4,0,1,36,0.0,0.02702702702702703,0.972972972972973,37,750,400,350,0.5333333333333333,11,4,7,346.12124813068925,0.4320883383383383,0.11082375680793888,0.1850583945484932,127745.77100326699,1443.105140613611,129188.8761438806,1011,1,159.2972972972973,36,1,21,38.52159221714754,0.5975115740740741,47.26914414414416,1010.9234234234251,28.081206206206254,8
2541,4,1,1,36,0.02702702702702703,0.02702702702702703,0.972972972972973,37,1450,1200,250,0.8275862068965517,17,12,5,347.2579965692274,0.43399649649649646,0.12180204236278969,0.18711959671248324,128059.03031409814,1493.9044618943553,129552.9347759925,1012,0,159.8108108108108,36,1,22,38.17242434356919,0.6006944444444444,46.959459459459474,1012.1621621621643,28.115615615615678,0
2542,4,2,1,37,0.05263157894736842,0.02631578947368421,0.9736842105263158,38,750,500,250,0.6666666666666666,10,5,5,338.6555797364971,0.43834459459459457,0.12807057593761795,0.18462735121788762,128525.67361379036,1105.2443689427414,129630.91798273311,1013,0,154.52631578947367,35,3,16,37.91388445002471,0.6074404761904761,46.498842592592595,1014.0046296296302,28.971560846560863,0
2543,4,0,1,36,0.0,0.02702702702702703,0.972972972972973,37,1050,700,350,0.6666666666666666,14,7,7,340.113834426175,0.4381569069069069,0.10820679191286198,0.18583277087973796,128613.70991941009,1348.6604080932668,129962.37032750336,1014,1,152.7027027027027,35,2,18,37.78715959227141,0.6083333333333334,46.41203703703703,1014.3518518518514,28.981481481481467,0
2544,4,3,1,38,0.07692307692307693,0.02564102564102564,0.9743589743589743,39,850,300,550,0.35294117647058826,14,3,11,326.86105885514667,0.4407051282051282,0.12232030264817184,0.1812593144560356,129201.38888888869,650.1993312756967,129851.58822016438,1015,0,145.74358974358975,34,5,22,37.52561475409837,0.616421568627451,45.83333333333332,1016.666666666665,29.901960784313676,0
2545,4,0,1,37,0.0,0.02631578947368421,0.9736842105263158,38,1000,700,300,0.7,13,7,6,333.0164223117527,0.4394262683736368,0.12814892215432794,0.18415251801821747,129089.93632656205,997.8137503847317,130087.75007694677,1016,1,150.1315789473684,37,1,22,37.482466551575286,0.6092342342342343,45.94298245614035,1016.2280701754388,27.465623518255104,0
2546,4,1,0,38,0.02631578947368421,0.0,1.0,38,1100,700,400,0.6363636363636364,15,7,8,334.9078200137067,0.438715030820294,0.1380326871140749,0.1866043437418653,129388.3437259708,1066.8259933719285,130455.16971934272,1017,0,150.8421052631579,33,5,25,37.13111298482293,0.6205808080808081,45.64950980392157,1017.4019607843139,30.830362448009513,0
2547,4,1,1,38,0.02564102564102564,0.02564102564102564,0.9743589743589743,39,800,500,300,0.625,11,5,6,325.47634531138203,0.43966486729644627,0.1365623586027933,0.18286940819628994,129716.28578514735,643.9165249433048,130360.20231009065,1018,0,147.94871794871796,34,5,16,37.03838962253126,0.6216299019607843,45.32738095238095,1018.6904761904759,29.961484593837525,0
2548,4,1,3,36,0.02564102564102564,0.07692307692307693,0.9230769230769231,39,1100,800,300,0.7272727272727273,14,8,6,327.4441461285752,0.43845591542959966,0.13879806943795736,0.18497570365733002,129928.59977324291,708.8718820861998,130637.47165532911,1019,0,148.89743589743588,34,5,20,36.773120037365715,0.6237745098039216,45.119047619047635,1019.5238095238118,29.98599439775917,0
2549,4,1,1,36,0.02702702702702703,0.02702702702702703,0.972972972972973,37,650,300,350,0.46153846153846156,10,3,7,347.0926343306566,0.4306181181181181,0.15293538238871074,0.1948501239488804,129683.21352731885,1602.4176423324427,131285.6311696513,1020,0,157.54054054054055,32,5,21,36.52147638527334,0.6259765625,45.3598484848485,1018.5606060606077,31.83001893939399,0
2550,4,1,2,35,0.02702702702702703,0.05405405405405406,0.9459459459459459,37,900,600,300,0.6666666666666666,12,6,6,346.643157513097,0.4312124624624625,0.15407712630268788,0.19545973837535147,129856.32216275025,1602.761107506767,131459.08327025702,1021,0,158.24324324324326,33,4,22,36.35713498456974,0.6253156565656566,45.189950980392176,1019.2401960784342,30.88606654783134,0
2551,4,1,0,36,0.027777777777777776,0.0,1.0,36,850,600,250,0.7058823529411765,11,6,5,351.3224744594629,0.43002645502645503,0.15715134997929248,0.1980982386494481,129856.32216275022,1924.2888852845451,131780.61104803477,1022,0,162.16666666666666,33,3,23,36.23790128652158,0.6253156565656566,45.189950980392176,1019.240196078434,30.886066547831334,0
2552,4,0,0,36,0.0,0.0,1.0,36,800,500,300,0.625,11,5,6,352.1310661484885,0.42977843915343916,0.15972723143918133,0.19871276853616918,129887.55076172658,1947.4883458285642,131835.03910755515,1023,1,163.16666666666666,33,3,23,36.18558146990463,0.6256313131313131,45.159313725490215,1019.3627450980418,30.889780154486118,0
2553,4,1,0,37,0.02702702702702703,0.0,1.0,37,1700,1300,400,0.7647058823529411,21,13,8,341.6740339678513,0.4323073073073073,0.16024231574987513,0.19530256509520408,130387.7189662631,1510.5602412533835,131898.2792075165,1024,0,159.72972972972974,33,4,25,35.94512439004881,0.6306818181818181,44.66911764705883,1021.3235294117658,30.9491978609626,0
2554,4,0,1,36,0.0,0.02702702702702703,0.972972972972973,37,1050,700,350,0.6666666666666666,14,7,7,341.7586821630433,0.43205705705705705,0.150462010157417,0.19614078806315355,130544.21864487232,1522.9240256151622,132067.1426704875,1025,1,160.72972972972974,33,4,18,35.78454151177199,0.632260101010101,44.515931372549026,1021.9362745098052,30.96776589423652,0
2555,4,0,0,36,0.0,0.0,1.0,36,700,600,100,0.8571428571428571,8,6,2,332.24688851793144,0.4318783068783069,0.11981629235618563,0.1837129854157975,129086.92476260042,1377.7458201444629,130464.67058274489,1026,2,164.86111111111111,36,0,19,37.50507904846334,0.6111111111111112,45.945945945945944,1016.216216216216,28.22822822822822,8
2556,4,1,2,35,0.02702702702702703,0.05405405405405406,0.9459459459459459,37,1150,900,250,0.782608695652174,14,9,5,324.9897987616496,0.43628003003003,0.1184307488866172,0.18111593649905952,129396.54659366318,1010.5115275853852,130407.05812124857,1027,0,161.3783783783784,37,0,20,37.37505388511694,0.6123310810810811,45.64144736842104,1017.4342105263138,27.49822190611659,0
2557,4,1,1,35,0.027777777777777776,0.027777777777777776,0.9722222222222222,36,650,500,150,0.7692307692307693,8,5,3,336.61167656815314,0.43186177248677243,0.14841761646564144,0.18789127369650394,129459.1186414455,1515.490194586481,130974.60883603198,1028,0,166.58333333333334,36,0,18,37.01587916343919,0.6148726851851851,45.57995495495496,1017.6801801801802,28.268893893893893,0
2558,4,1,1,35,0.027777777777777776,0.027777777777777776,0.9722222222222222,36,900,600,300,0.6666666666666666,12,6,6,355.3356812900269,0.4323247354497355,0.12808590414671284,0.19025397032219166,127802.69870799866,1882.5718032221575,129685.27051122082,1029,0,167.33333333333334,36,0,13,38.230407989011404,0.5980902777777778,47.212837837837846,1011.1486486486496,28.087462462462486,8
2559,4,2,0,37,0.05405405405405406,0.0,1.0,37,1050,700,350,0.6666666666666666,14,7,7,349.98125972151934,0.4315565565565565,0.14382824382824388,0.18977857041237334,128311.11495844886,1581.2971298861319,129892.412088335,1030,0,163.7027027027027,37,0,17,37.8458694083694,0.6013513513513513,46.71052631578948,1013.157894736843,27.38264580369846,0
2560,4,1,2,36,0.02631578947368421,0.05263157894736842,0.9473684210526316,38,750,400,350,0.5333333333333333,11,4,7,345.3455619015682,0.4334103840682788,0.14204539154923257,0.18864849048869337,128604.67916757995,1282.6110380597693,129887.29020563971,1031,0,160.3684210526316,38,0,14,37.663699880626346,0.6025219298245614,46.42094017094018,1014.3162393162405,26.692532613585275,0
2561,4,2,1,37,0.05263157894736842,0.02631578947368421,0.9736842105263158,38,900,500,400,0.5555555555555556,13,5,8,348.044464467284,0.433884542437174,0.1568312488229624,0.19116291915422745,128821.50472094388,1367.1223244941268,130188.627045438,1032,0,160.73684210526315,38,0,16,37.374149301901355,0.6047149122807017,46.20726495726496,1015.1709401709406,26.715024741340542,0
2562,4,1,0,38,0.02631578947368421,0.0,1.0,38,1250,1000,250,0.8,15,10,5,345.1474509435902,0.4345365101944049,0.11995533437670347,0.18479898402042305,127802.69870799847,1230.7301100743457,129033.42881807282,1033,0,160.8421052631579,36,2,16,38.487953372684395,0.5980902777777778,47.21283783783783,1011.1486486486481,28.087462462462447,8
2563,4,1,1,38,0.02564102564102564,0.02564102564102564,0.9743589743589743,39,650,400,250,0.6153846153846154,9,4,5,340.59815558292337,0.436459739091318,0.1230980290874153,0.18379560318510396,128116.7778186556,927.2676448522459,129044.04546350783,1034,0,157.69230769230768,37,2,17,38.281955124733734,0.5993806306306306,46.902412280701746,1012.3903508771918,27.36190137505924,0
2564,4,0,0,38,0.0,0.0,1.0,38,1200,800,400,0.6666666666666666,16,8,8,349.4665102196855,0.4337067330488383,0.12978062853293526,0.1879088326944269,127973.55791179692,1344.4945367664977,129318.05244856341,1035,1,162.78947368421052,36,2,17,38.20395102949363,0.5998263888888888,47.04391891891892,1011.8243243243242,28.106231231231227,0
2565,4,1,1,38,0.02564102564102564,0.02564102564102564,0.9743589743589743,39,900,500,400,0.5555555555555556,13,5,8,319.9066728050458,0.4376124606387764,0.10688458827993763,0.1707853907864406,127685.20801373338,369.47001241870214,128054.67802615209,1036,0,159.5897435897436,38,1,15,39.24594785059902,0.5932017543859649,47.329059829059815,1010.6837606837585,26.596941070625224,8
2566,4,2,0,40,0.05,0.0,1.0,40,1100,800,300,0.7272727272727273,14,8,6,315.7000146116774,0.4396233974358974,0.13088935801667234,0.17083310105261068,128227.809578428,97.9536341335494,128325.76321256155,1037,0,156.5,37,3,19,38.79901032081124,0.6005067567567568,46.79276315789474,1012.8289473684213,27.373755334281658,0
2567,4,0,0,40,0.0,0.0,1.0,40,1050,800,250,0.7619047619047619,13,8,5,317.8463671970165,0.4394764957264958,0.1369805194805198,0.17235331178993166,128311.11495844884,156.64435210835245,128467.7593105572,1038,1,157.5,37,3,19,38.65981240981242,0.6013513513513513,46.71052631578948,1013.1578947368429,27.382645803698455,0
2568,4,0,1,39,0.0,0.025,0.975,40,1350,1100,250,0.8148148148148148,16,11,5,316.2996886573113,0.43904914529914535,0.1360365721705259,0.17175333270099138,128366.6669071254,120.46735534012083,128487.13426246552,1039,2,158.5,37,3,20,38.6424294885667,0.6019144144144144,46.65570175438597,1013.3771929824572,27.388572783309655,0
2569,4,0,1,38,0.0,0.02564102564102564,0.9743589743589743,39,1550,1300,250,0.8387096774193549,18,13,5,320.4671838008655,0.4366565452091768,0.12934719765776115,0.17454120119535357,128486.82032962024,435.16189331224405,128921.98222293248,1040,3,163.35897435897436,36,3,15,38.41450997815544,0.6050347222222222,46.53716216216217,1013.851351351352,28.162537537537556,0
2570,4,1,0,39,0.02564102564102564,0.0,1.0,39,1150,700,450,0.6086956521739131,16,7,9,325.38492867318973,0.43592555105713,0.14201270957428114,0.17862483234227342,128800.98637488837,581.9799529259005,129382.96632781427,1041,0,163.7948717948718,36,3,16,37.97010206345685,0.6082175925925926,46.22747747747748,1015.0900900900898,28.196946946946937,0
2571,4,2,2,39,0.04878048780487805,0.04878048780487805,0.9512195121951219,41,1100,700,400,0.6363636363636364,15,7,8,314.0707231189235,0.4369410569105691,0.15419590534731853,0.17549277297090798,129500.26167223671,-65.55183450216882,129434.70983773454,1042,0,156.7560975609756,38,3,12,37.547671530037434,0.6115679824561404,45.53952991452991,1017.8418803418793,26.78531264057577,0
2572,4,0,0,39,0.0,0.0,1.0,39,1400,1100,300,0.7857142857142857,17,11,6,327.0754533742085,0.43229869545659017,0.14972497062379753,0.1821701384576201,129373.18019032538,662.9583130427619,130036.13850336814,1043,1,165.64102564102564,36,3,20,37.3457217179544,0.6140046296296297,45.66441441441441,1017.3423423423417,28.259509509509492,0
2573,4,0,1,38,0.0,0.02564102564102564,0.9743589743589743,39,1350,800,550,0.5925925925925926,19,8,11,325.7636405352171,0.4315677013045434,0.15051981025475292,0.18180471123315373,129452.33298947735,634.1726540858527,130086.5056435632,1044,2,166.64102564102564,37,2,15,37.29876001149301,0.6128941441441442,45.586622807017534,1017.6535087719284,27.504148885727794,0
2574,4,1,0,39,0.02564102564102564,0.0,1.0,39,1000,700,300,0.7,13,7,6,327.200663254698,0.4338731443994602,0.1550833298813914,0.18312586849426582,129563.94184989603,678.6815414358152,130242.62339133184,1045,0,166.64102564102564,37,2,16,37.148963381798595,0.6140202702702703,45.47697368421052,1018.0921052631571,27.516002844950194,0
2575,4,0,0,39,0.0,0.0,1.0,39,950,600,350,0.631578947368421,13,6,7,325.81043820144595,0.4330859199280252,0.14632033933408128,0.18281053015740922,129663.42872242302,649.1397061509138,130312.56842857394,1046,1,167.64102564102564,38,1,16,37.08346445679919,0.6132127192982456,45.3792735042735,1018.4829059829052,26.802181736392242,0
2576,4,0,0,39,0.0,0.0,1.0,39,1650,1400,250,0.8484848484848485,19,14,5,329.54249839279345,0.43297345928924874,0.14963583129673186,0.18541869068861755,129772.26382725162,753.0952087442331,130525.35903599585,1047,2,168.64102564102564,38,1,17,36.87808010904898,0.6143092105263157,45.27243589743589,1018.9102564102549,26.813427800269864,0
2577,4,1,0,40,0.025,0.0,1.0,40,1000,800,200,0.8,12,8,4,322.29619918904143,0.43396100427350426,0.15435171005615134,0.18300818962647314,130129.69970703125,388.0615234374999,130517.76123046875,1048,0,165.4,39,1,18,36.70080398162327,0.6161858974358974,44.921875,1020.3125,26.161858974358974,0
2578,4,0,0,40,0.0,0.0,1.0,40,900,600,300,0.6666666666666666,12,6,6,322.8164171176467,0.4340144230769231,0.15575431254465677,0.18355382695888453,130182.84640841995,405.0320095485917,130587.87841796855,1049,1,166.4,39,1,18,36.63376969140212,0.6167200854700854,44.86979166666666,1020.5208333333318,26.167200854700816,0
2579,4,0,0,40,0.0,0.0,1.0,40,1650,1300,350,0.7878787878787878,20,13,7,326.5739584440433,0.4332799145299145,0.1579359965635745,0.18633925864160106,130318.55955678663,511.7783987621177,130830.33795554875,1050,2,167.4,37,3,19,36.400612113402076,0.6216216216216216,44.73684210526316,1021.0526315789467,27.59601706970126,0
2580,4,1,0,41,0.024390243902439025,0.0,1.0,41,1150,700,450,0.6086956521739131,16,7,9,323.24167545552314,0.43391768292682925,0.1716569511812791,0.18599516490883342,130644.5883213711,245.95512363941057,130890.54344501051,1051,0,164.29268292682926,38,3,14,36.15625108858466,0.6230811403508771,44.41773504273504,1022.3290598290594,26.903396311291036,0
2581,4,0,1,40,0.0,0.024390243902439025,0.975609756097561,41,1400,1000,400,0.7142857142857143,18,10,8,325.04433991189507,0.43335873983739837,0.16619935876581082,0.187890551046187,130821.45317925325,304.5545789930352,131126.0077582463,1052,1,165.29268292682926,39,2,15,35.93161337949292,0.6231303418803419,44.24479166666666,1023.0208333333316,26.231303418803375,0
2582,4,0,1,39,0.0,0.025,0.975,40,550,400,150,0.7272727272727273,7,4,3,331.34927168967215,0.43311965811965814,0.1522094188376757,0.18090075117412063,128582.2137946988,521.1245786238246,129103.33837332262,1053,2,168.65,40,0,12,38.04149966599866,0.5989583333333333,46.443089430894304,1014.2276422764218,25.355691056910544,8
2583,4,1,1,39,0.025,0.025,0.975,40,950,700,250,0.7368421052631579,12,7,5,328.40268384550717,0.43341346153846155,0.15889244942920144,0.17999062573442556,128736.86814230942,455.50660155991466,129192.37474386934,1054,0,169.1,40,0,13,37.95876727418388,0.6005208333333334,46.290650406504064,1014.8373983739833,25.370934959349583,0
2584,4,1,0,40,0.025,0.0,1.0,40,600,400,200,0.6666666666666666,8,4,4,329.2643603240989,0.4318910256410256,0.1629655586704044,0.18069738631412635,128788.4402472074,481.0886790270379,129269.52892623444,1055,0,169.85,40,0,14,37.88441963689761,0.6010416666666667,46.239837398373986,1015.0406504065045,25.37601626016261,0
2585,4,0,1,39,0.0,0.025,0.975,40,1050,800,250,0.7619047619047619,13,8,5,360.58830615664033,0.43162393162393164,0.1635534070933724,0.18860192043487636,126855.79562716994,1149.2042764903908,128004.99990366033,1056,1,170.85,39,1,16,39.069662737393585,0.5830662393162394,48.15104166666666,1007.3958333333317,25.83066239316235,8
2586,4,1,0,40,0.025,0.0,1.0,40,1400,1000,400,0.7142857142857143,18,10,8,357.5853309434508,0.4317174145299145,0.1870578267316252,0.18862126786413724,127199.76463766504,1097.1737133401816,128296.93835100521,1057,0,171.775,38,2,17,38.79187848619644,0.5882675438596492,47.80982905982905,1008.7606837606818,26.546333783175836,0
2587,4,2,2,40,0.047619047619047616,0.047619047619047616,0.9523809523809523,42,1500,1000,500,0.6666666666666666,20,10,10,343.3016337971262,0.43856465350367785,0.18888250777698024,0.18384560044571618,127810.33631601559,375.49945468966456,128185.83577070525,1058,0,164.54761904761904,40,2,15,38.52680067001674,0.5911458333333333,47.20528455284553,1011.1788617886177,25.27947154471544,0
2588,4,3,0,43,0.06976744186046512,0.0,1.0,43,1000,800,200,0.8,12,8,4,338.78698686544703,0.4409145441122185,0.21415682315896456,0.17516394130756102,126384.01828342034,2.248706372614606,126386.26698979296,1059,0,161.13953488372093,39,4,14,40.10335733278084,0.5782585470085471,48.61979166666668,1005.5208333333351,25.782585470085515,8
2589,4,0,0,43,0.0,0.0,1.0,43,1450,1000,450,0.6896551724137931,19,10,9,336.5241755907744,0.44137596899224807,0.21568070552102947,0.17499981617642973,126619.79709201395,-77.87543402776873,126541.92165798618,1060,1,162.13953488372093,39,4,15,39.91797764438006,0.5806623931623931,48.38541666666667,1006.4583333333339,25.806623931623946,0
2590,4,2,2,43,0.044444444444444446,0.044444444444444446,0.9555555555555556,45,1450,1200,250,0.8275862068965517,17,12,5,329.793713510257,0.44400252525252526,0.22453689712680402,0.17404902679512602,127220.13728807254,-607.8407918463712,126612.29649622616,1061,0,155.88888888888889,40,5,17,39.471894832275616,0.58515625,47.78963414634146,1008.8414634146338,25.221036585365844,0
2591,4,2,3,42,0.044444444444444446,0.06666666666666667,0.9333333333333333,45,1600,1000,600,0.625,22,10,12,323.711416272235,0.44482323232323234,0.21153571109323366,0.17269239932462993,127656.23967215269,-735.2435719479256,126920.99610020476,1062,0,155.75555555555556,40,5,14,39.17940466613034,0.5895833333333333,47.35772357723577,1010.5691056910558,25.264227642276396,0
2592,4,6,3,45,0.125,0.0625,0.9375,48,950,600,350,0.631578947368421,13,6,7,311.4655657721901,0.44928339243498816,0.24417808219178117,0.16967900224902888,128496.33487654319,-1593.6990951887835,126902.6357813544,1063,0,146.875,41,7,14,38.63299086757993,0.5965447154471545,46.52777777777778,1013.8888888888887,24.728997289972895,0
2593,4,1,1,45,0.021739130434782608,0.021739130434782608,0.9782608695652174,46,1500,1000,500,0.6666666666666666,20,10,10,322.2780753520806,0.4447262479871175,0.23895169578622788,0.17518243984222043,128408.33875868062,-923.3615451388844,127484.97721354173,1064,0,154.1304347826087,39,7,14,38.44852689277149,0.5988247863247863,46.614583333333336,1013.5416666666672,25.988247863247878,0
2594,4,4,2,47,0.08163265306122448,0.04081632653061224,0.9591836734693877,49,1800,1200,600,0.6666666666666666,24,12,12,316.06049590291667,0.4480583900226757,0.2732760095654563,0.17639546066224815,129453.66138353493,-1614.5209110843361,127839.14047245058,1065,0,145.6122448979592,41,8,15,37.54427438746997,0.6061991869918699,45.58531746031746,1017.6587301587305,24.820944638017817,0
2595,4,0,0,47,0.0,0.0,1.0,47,1450,1000,450,0.6896551724137931,19,10,9,326.52512765385626,0.44538236201048415,0.274328566445762,0.1810730253353205,129201.38888888908,-962.499999999982,128238.8888888891,1066,1,152.80851063829786,39,8,18,37.53415300546449,0.6068376068376069,45.83333333333334,1016.6666666666682,26.068376068376107,0
2596,4,0,1,46,0.0,0.02127659574468085,0.9787234042553191,47,1400,800,600,0.5714285714285714,20,8,12,327.1100373771859,0.4453245451742214,0.27234739717909706,0.182129796181619,129360.29188368062,-936.9900173611056,128423.30186631951,1067,2,153.80851063829786,39,8,18,37.3579254556625,0.608440170940171,45.677083333333336,1017.2916666666672,26.084401709401725,0
2597,4,0,0,46,0.0,0.0,1.0,46,1300,1000,300,0.7692307692307693,16,10,6,329.3039866079736,0.44553140096618354,0.26183498801780236,0.18375046704399198,129445.89548405632,-674.5901134122475,128771.30537064407,1068,3,155.2391304347826,38,8,16,37.21522309711287,0.6110197368421053,45.59294871794871,1017.6282051282034,26.779689608636932,0
2598,4,2,2,46,0.041666666666666664,0.041666666666666664,0.9583333333333334,48,1600,1100,500,0.6875,21,11,10,322.6008058868247,0.44769503546099293,0.273289320105049,0.1827360267395283,130034.82187145666,-1210.132334183695,128824.68953727296,1069,0,149.72916666666666,41,7,19,36.789040462989995,0.6120426829268293,45.01488095238094,1019.9404761904741,24.876596980255467,0
2599,4,0,0,46,0.0,0.0,1.0,46,1300,900,400,0.6923076923076923,17,9,8,327.7068635018354,0.4460144927536232,0.2777176079158501,0.18560192336932416,130029.2691189108,-677.7032107211237,129351.56590818967,1070,1,155.43478260869566,40,6,19,36.66446625481598,0.6135416666666667,45.020325203252035,1019.9186991869927,25.49796747967482,0
2600,4,1,1,46,0.02127659574468085,0.02127659574468085,0.9787234042553191,47,1350,1000,350,0.7407407407407407,17,10,7,323.31488700877026,0.44657724329324694,0.28196219225281793,0.18473203854852563,130371.67302441732,-969.1520366770026,129402.52098774032,1071,0,153.10638297872342,38,9,20,36.43010949541444,0.6203399122807017,44.684829059829056,1021.2606837606829,26.87528115159692,0
2601,4,0,1,45,0.0,0.021739130434782608,0.9782608695652174,46,1350,900,450,0.6666666666666666,18,9,9,330.6390325762832,0.44455515297906606,0.2892357304975499,0.18891682680195412,130371.67302441754,-578.8072311710047,129792.86579324654,1072,1,157.2608695652174,38,8,20,36.243112947658396,0.6203399122807017,44.68482905982906,1021.2606837606847,26.875281151596965,0
2602,4,1,2,44,0.021739130434782608,0.043478260869565216,0.9565217391304348,46,950,400,550,0.42105263157894735,15,4,11,327.63191512443086,0.44381038647342996,0.28312234368962863,0.1879903580183074,130535.38795976712,-646.4881702461738,129888.89978952095,1073,0,157.30434782608697,38,8,14,36.154382296567334,0.621984649122807,44.524572649572654,1021.9017094017106,26.892150247413436,0
2603,4,1,2,43,0.022222222222222223,0.044444444444444446,0.9555555555555556,45,1250,1000,250,0.8,15,10,5,332.70459945845363,0.44404461279461277,0.2832141154029564,0.19093638343305336,130542.57079101255,-313.57725453987223,130228.99353647267,1074,0,160.82222222222222,37,8,14,36.01752503576535,0.6238738738738738,44.517543859649116,1021.9298245614029,27.619724988146025,0
2604,4,2,1,44,0.044444444444444446,0.022222222222222223,0.9777777777777777,45,1250,900,350,0.72,16,9,7,334.33839679217357,0.4430765993265993,0.2878738056091694,0.19270951103113765,130710.70545744829,-259.6784587565568,130451.02699869173,1075,0,161.35555555555555,37,8,16,35.80581170920009,0.6255630630630631,44.35307017543859,1022.5877192982443,27.63750592697958,0
2605,4,0,0,44,0.0,0.0,1.0,44,1000,700,300,0.7,13,7,6,334.4682186755659,0.44339103241719524,0.27500073101552647,0.19292424709876344,130738.73842191833,-54.40940962603602,130684.32901229229,1076,1,159.5,37,7,17,35.77416371823736,0.6258445945945945,44.32565789473684,1022.697368421053,27.64046941678522,0
2606,4,1,2,43,0.022222222222222223,0.044444444444444446,0.9555555555555556,45,1050,500,550,0.47619047619047616,16,5,11,320.16988383264913,0.4452441077441078,0.15501038421599178,0.1803061977373341,129807.25623582782,-686.5996420209167,129120.65659380691,1077,0,156.93333333333334,41,4,17,37.0813862928349,0.6097560975609756,45.23809523809525,1019.0476190476203,24.854819976771225,8
2607,4,0,0,43,0.0,0.0,1.0,43,1250,700,550,0.56,18,7,11,332.3529864032854,0.44296788482835,0.19627678792142822,0.18731230524019288,129837.58680555572,30.381944444462192,129867.96875000019,1078,1,165.0,39,4,17,36.740256200599624,0.6132478632478633,45.20833333333334,1019.166666666668,26.132478632478666,0
2608,4,0,0,43,0.0,0.0,1.0,43,1450,1000,450,0.6896551724137931,19,10,9,331.05389736435734,0.4431063122923588,0.18979177657688484,0.18683353169594027,129890.67382812513,0.16276041667947538,129890.83658854182,1079,2,166.0,39,4,17,36.71954833435522,0.6137820512820513,45.15625000000001,1019.375000000001,26.13782051282054,0
2609,4,1,0,44,0.022727272727272728,0.0,1.0,44,1300,700,600,0.5384615384615384,19,7,12,329.7943705156545,0.44383148343904155,0.19492771989535962,0.18765579960842615,130210.72035701314,-211.44748909377594,129999.27286791937,1080,0,163.20454545454547,40,4,18,36.427528294998204,0.6153645833333333,44.842479674796756,1020.6300813008139,25.515752032520346,0
2610,4,1,1,44,0.022222222222222223,0.022222222222222223,0.9777777777777777,45,1900,1500,400,0.7894736842105263,23,15,8,323.1640641910518,0.44404461279461277,0.19605658048222474,0.1855215116312705,130555.17713758702,-561.8310153125633,129993.34612227445,1081,0,160.55555555555554,39,6,12,36.24853480786871,0.6204594017094017,44.50520833333334,1021.9791666666683,26.20459401709406,0
2611,4,0,1,43,0.0,0.022727272727272728,0.9772727272727273,44,1150,800,350,0.6956521739130435,15,8,7,330.7711194830221,0.4425872093023256,0.19358448074346457,0.1900592973029475,130589.98243343207,-160.92106344508545,130429.06136998699,1082,1,164.75,38,6,12,36.01899759590258,0.622532894736842,44.471153846153854,1022.1153846153857,26.897773279352254,0
2612,4,0,1,42,0.0,0.023255813953488372,0.9767441860465116,43,850,700,150,0.8235294117647058,10,7,3,340.49250814920373,0.4415143964562569,0.20053554004447038,0.19526459590414968,130514.55886667062,287.8458996999225,130802.40476637054,1083,2,169.04651162790697,37,6,12,35.84690328003721,0.6235923423423424,44.544956140350884,1021.8201754385973,27.616761498340466,0
2613,4,1,1,42,0.023255813953488372,0.023255813953488372,0.9767441860465116,43,1350,1100,250,0.8148148148148148,16,11,5,343.1668739083869,0.4405454042081949,0.2151705218529829,0.1976547930324712,130682.67549871119,369.19304497537485,131051.86854368656,1084,0,169.5581395348837,37,6,13,35.60846738159069,0.6252815315315315,44.38048245614035,1022.478070175439,27.634542437174026,0
2614,4,0,0,42,0.0,0.0,1.0,42,1500,1000,500,0.6666666666666666,20,10,10,345.14784805367856,0.4393994386372435,0.21028905008418186,0.19870623414580518,130665.25298524875,619.7661766496209,131285.01916189838,1085,1,174.5,36,6,15,35.57545801666849,0.627025462962963,44.39752252252252,1022.4099099099099,28.400275275275273,0
2615,4,1,2,41,0.023255813953488372,0.046511627906976744,0.9534883720930233,43,1200,800,400,0.6666666666666666,16,8,8,329.6020139406591,0.44061461794019935,0.18356181402038407,0.1796386340256652,128513.93771701408,-35.60379160830769,128478.33392540578,1086,0,171.41860465116278,39,4,14,38.15534894870215,0.5998931623931624,46.51041666666668,1013.958333333335,25.998931623931664,8
2616,4,0,0,41,0.0,0.0,1.0,41,1100,800,300,0.7272727272727273,14,8,6,330.62123461233136,0.4398628048780488,0.18254272082381573,0.18048231053334482,128577.58881446802,302.0962314632351,128879.68504593126,1087,1,173.1951219512195,38,3,14,38.06467045893464,0.6022478070175439,46.44764957264958,1014.2094017094033,26.689721097615877,0
2617,4,0,0,41,0.0,0.0,1.0,41,1300,600,700,0.46153846153846156,20,6,14,333.2789281568338,0.43869410569105693,0.1852302667056991,0.1825538212014768,128713.06911571344,379.47074293229184,129092.53985864573,1088,2,174.1951219512195,38,3,16,37.85928616550852,0.6036184210526316,46.31410256410257,1014.7435897435905,26.703778677462907,0
2618,4,0,0,41,0.0,0.0,1.0,41,850,700,150,0.8235294117647058,10,7,3,332.88298188538977,0.4388211382113821,0.1897007561951014,0.1828354967557789,128821.50472094388,376.4973244941266,129198.002045438,1089,3,175.1951219512195,38,3,16,37.75893671507754,0.6047149122807017,46.20726495726496,1015.1709401709406,26.715024741340542,0
2619,4,0,0,41,0.0,0.0,1.0,41,1200,800,400,0.6666666666666666,16,8,8,333.7466655241986,0.4390752032520325,0.19384486768850429,0.18444302938992752,129065.65176647302,415.0461821535505,129480.69794862658,1090,4,176.1951219512195,38,3,16,37.48860968001962,0.6071820175438596,45.96688034188034,1016.1324786324782,26.740328385065215,0
2620,4,0,0,41,0.0,0.0,1.0,41,1600,1100,500,0.6875,21,11,10,328.88437656152865,0.43892276422764226,0.18855672692049508,0.1826325260275745,129255.70371283495,302.0363065234661,129557.74001935842,1091,5,177.1951219512195,38,3,18,37.41901309798976,0.6091008771929824,45.77991452991452,1016.8803418803404,26.760008996851063,0
2621,4,0,0,41,0.0,0.0,1.0,41,1500,1100,400,0.7333333333333333,19,11,8,326.40110858021046,0.43854166666666666,0.1876381443642221,0.18187933042769713,129391.54071015041,246.70846573890333,129638.24917588932,1092,6,178.1951219512195,38,3,19,37.3442367601246,0.6104714912280702,45.646367521367516,1017.4145299145293,26.77406657669814,0
2622,4,1,1,41,0.023809523809523808,0.023809523809523808,0.9761904761904762,42,850,400,450,0.47058823529411764,13,4,9,325.5245833451926,0.4391453735965931,0.2035306713385414,0.18358836011715876,129864.12896050335,54.79329427082712,129918.92225477418,1093,0,174.92857142857142,39,3,16,36.88734883324818,0.6135149572649572,45.182291666666664,1019.2708333333323,26.135149572649546,0
2623,4,0,0,41,0.0,0.0,1.0,41,1050,800,250,0.7619047619047619,13,8,5,337.90160528235896,0.4370680894308943,0.21250814498715953,0.19118380690101447,129990.07100819999,584.7707328877158,130574.8417410877,1094,1,179.09756097560975,38,3,16,36.444255281997556,0.6165021929824561,45.05876068376068,1019.764957264957,26.835919928025184,0
2624,4,1,0,42,0.023809523809523808,0.0,1.0,42,1300,800,500,0.6153846153846154,18,8,10,359.59576138147565,0.43912117692605496,0.21807953950811076,0.19248949579831928,127793.2098765432,843.655946380303,128636.8658229235,1095,0,175.8095238095238,38,4,16,38.132440476190474,0.5942982456140351,47.22222222222222,1011.1111111111111,26.608187134502923,8
2625,4,2,1,43,0.045454545454545456,0.022727272727272728,0.9772727272727273,44,1500,1300,200,0.8666666666666667,17,13,4,353.57477950835073,0.44342406624383374,0.2284557907845579,0.19261909629932528,128496.3348765431,287.57716049381406,128783.91203703692,1096,0,168.77272727272728,38,6,16,37.56563926940638,0.6014254385964912,46.52777777777777,1013.888888888888,26.68128654970758,0
2626,4,0,2,41,0.0,0.046511627906976744,0.9534883720930233,43,1700,1400,300,0.8235294117647058,20,14,6,358.4538326667539,0.443936877076412,0.22855041068472914,0.19575238186630312,128593.16541883688,618.9425998263998,129212.10801866329,1097,1,171.65116279069767,39,4,16,37.34305997740577,0.6006944444444444,46.43229166666667,1014.270833333334,26.006944444444464,0
2627,4,1,1,41,0.023809523809523808,0.023809523809523808,0.9761904761904762,42,1250,800,450,0.64,17,8,9,358.1365500443755,0.44307733255903986,0.23668175359962507,0.19767435045743045,129016.12548828126,841.0780164930559,129857.20350477433,1098,0,171.42857142857142,39,3,17,36.919516217232314,0.6049679487179487,46.015625,1015.9375000000001,26.04967948717949,0
2628,4,0,2,39,0.0,0.04878048780487805,0.9512195121951219,41,1050,700,350,0.6666666666666666,14,7,7,366.4354142334805,0.4426829268292683,0.24434883667233587,0.20195370916624364,128957.11343277465,1250.8906558185563,130208.00408859321,1099,1,176.1951219512195,38,3,17,36.76895971389502,0.6060855263157895,46.073717948717956,1015.7051282051295,26.72908232118762,0
2629,4,0,0,39,0.0,0.0,1.0,39,1500,1000,500,0.6666666666666666,20,10,10,376.82105509983853,0.44093004948268105,0.25451723755681144,0.20790842434591145,129001.1099570858,1922.0668726159001,130923.17682970171,1100,2,183.43589743589743,36,3,17,36.46029634556406,0.6102430555555556,46.030405405405425,1015.8783783783812,28.21884384384392,0
2630,4,1,1,39,0.025,0.025,0.975,40,1700,1300,400,0.7647058823529411,21,13,8,371.90069657391234,0.44169337606837605,0.24838792221084982,0.20762684603012144,129466.28146701396,1630.0307512960708,131096.31221831002,1101,0,179.825,35,5,16,36.11075571477313,0.6169642857142856,45.57291666666667,1017.7083333333339,29.07738095238097,0
2631,4,0,0,39,0.0,0.0,1.0,39,950,300,650,0.3157894736842105,16,3,13,381.5993598753169,0.43913067926225824,0.25370962176111456,0.21242778697945167,129352.72285997731,2072.183248299323,131424.90610827663,1102,4,185.43589743589743,34,5,19,35.9798615174566,0.617953431372549,45.68452380952381,1017.2619047619046,29.91946778711484,0
2632,4,0,0,39,0.0,0.0,1.0,39,800,500,300,0.625,11,5,6,382.677008624697,0.4385964912280702,0.25901995368537234,0.21351978261905424,129443.56575963722,2107.015306122449,131550.58106575967,1103,5,186.43589743589743,34,5,16,35.85975276867883,0.6188725490196079,45.595238095238095,1017.6190476190479,29.92997198879553,0
2633,4,0,0,39,0.0,0.0,1.0,39,1400,900,500,0.6428571428571429,19,9,10,380.5886580697395,0.43814664867296443,0.2533823789523548,0.21317451162216627,129595.04145408157,2064.4805839002233,131659.5220379818,1104,6,187.43589743589743,34,5,16,35.75840835574263,0.6204044117647058,45.44642857142857,1018.2142857142851,29.947478991596622,0
2634,4,0,0,39,0.0,0.0,1.0,39,1400,1100,300,0.7857142857142857,17,11,6,400.78481579354565,0.43882141250562307,0.22665713311671687,0.21545035733265938,127963.79145408164,2481.926729024948,130445.7181831066,1105,7,188.43589743589743,34,5,16,36.91586265050791,0.6038602941176471,47.05357142857143,1011.7857142857144,29.75840336134454,8
2635,4,1,0,40,0.025,0.0,1.0,40,1100,700,400,0.6363636363636364,15,7,8,397.14555146759824,0.4420940170940171,0.22582828744430472,0.2152455115786927,128291.0574872471,2190.044554826821,130481.10204207392,1106,0,184.7,35,5,19,36.67183156251191,0.6050595238095238,46.730324074074076,1013.0787037037038,28.945105820105823,0
2636,4,0,0,40,0.0,0.0,1.0,40,1150,900,250,0.782608695652174,14,9,5,401.65280524390283,0.44180021367521366,0.2266556291390731,0.2184891471010001,128437.66744898839,2317.469885973942,130755.13733496233,1107,1,185.7,35,5,13,36.407189617111975,0.6065476190476191,46.58564814814815,1013.6574074074078,28.961640211640223,0
2637,4,0,1,39,0.0,0.025,0.975,40,1150,900,250,0.782608695652174,14,9,5,404.4661287295928,0.4415731837606838,0.2259589041095893,0.22034348803925574,128496.33487654322,2394.483024691359,130890.81790123458,1108,2,186.7,35,5,13,36.275684931506845,0.6071428571428572,46.52777777777778,1013.8888888888889,28.96825396825397,0
2638,4,0,1,38,0.0,0.02564102564102564,0.9743589743589743,39,1100,900,200,0.8181818181818182,13,9,4,422.5715206653246,0.43778115159694103,0.23332249400826166,0.23009073337505812,128476.21882086188,3058.078231292537,131534.2970521544,1109,11,192.43589743589743,34,5,13,35.83744324408956,0.6090686274509804,46.54761904761906,1013.8095238095254,29.817927170868394,0
2639,4,0,1,37,0.0,0.02631578947368421,0.9736842105263158,38,1300,1000,300,0.7692307692307693,16,10,6,430.2686290216618,0.4365516832622096,0.23916913569257758,0.23525519887987534,128641.33536380224,3470.0662004997894,132111.40156430204,1110,12,186.71052631578948,33,5,16,35.47253764999597,0.6130050505050505,46.38480392156862,1014.4607843137243,30.741235888294675,0
2640,4,0,1,36,0.0,0.02702702702702703,0.972972972972973,37,1150,800,350,0.6956521739130435,15,8,7,432.57520752633275,0.4341529029029029,0.254814725139473,0.2369875216693344,128720.4610020661,3736.256026170794,132456.7170282369,1111,13,192.2972972972973,32,5,17,35.3326801045166,0.6162109375,46.30681818181818,1014.7727272727273,31.711647727272727,0
2641,4,0,0,36,0.0,0.0,1.0,36,1150,800,350,0.6956521739130435,15,8,7,397.96698395257516,0.4343584656084656,0.2027221567857611,0.21249935180863913,127692.92091836732,2963.513321995463,130656.43424036278,1112,14,193.58333333333334,34,2,14,37.26565567334119,0.6011029411764706,47.32142857142857,1010.7142857142854,29.726890756302513,8
2642,4,2,1,37,0.05263157894736842,0.02631578947368421,0.9736842105263158,38,1150,1000,150,0.8695652173913043,13,10,3,386.5786979050809,0.43923364153627314,0.209757317833958,0.2112916667638997,128627.12762188213,2346.4958900226793,130973.6235119048,1113,0,184.3421052631579,34,4,16,36.5951277236631,0.6106004901960784,46.398809523809526,1014.4047619047623,29.83543417366948,0
2643,4,1,0,38,0.02631578947368421,0.0,1.0,38,1150,900,250,0.782608695652174,14,9,5,385.2426449720934,0.44207859174964437,0.2070535576477852,0.2112021574525465,128747.91843820873,2319.837726757385,131067.75616496611,1114,0,183.21052631578948,34,4,17,36.505376344086024,0.6118259803921569,46.27976190476191,1014.8809523809533,29.84943977591039,0
2644,4,0,0,38,0.0,0.0,1.0,38,750,300,450,0.4,12,3,9,384.033090969855,0.44218231389284024,0.20237631009016943,0.21123023868830962,128877.99968117716,2298.683315114891,131176.68299629205,1115,1,184.21052631578948,35,3,19,36.4030025836848,0.6110119047619047,46.151620370370374,1015.3935185185188,29.011243386243393,0
2645,4,0,0,38,0.0,0.0,1.0,38,1300,1000,300,0.7692307692307693,16,10,6,383.27956653745525,0.4422712185870081,0.20484565642508312,0.21097207759094314,128907.3819551612,2281.5130958504774,131188.89505101167,1116,2,185.21052631578948,35,3,19,36.39208646759362,0.6113095238095239,46.12268518518518,1015.5092592592595,29.01455026455027,0
2646,4,1,0,39,0.02564102564102564,0.0,1.0,39,1350,1000,350,0.7407407407407407,17,10,7,379.18666694601154,0.44323549257759787,0.2065365775315191,0.21127568516683123,129388.34372597066,2013.4716537531701,131401.81537972382,1117,0,181.43589743589743,33,6,20,36.00487834256806,0.6205808080808081,45.64950980392156,1017.4019607843127,30.830362448009474,0
2647,4,0,1,38,0.0,0.02564102564102564,0.9743589743589743,39,1100,800,300,0.7272727272727273,14,8,6,382.0265966296246,0.44323549257759787,0.20954939100634506,0.21336455178271885,129481.8718311465,2093.10376417722,131574.97559532372,1118,1,182.43589743589743,33,6,17,35.83722155328115,0.6215277777777778,45.55759803921568,1017.769607843136,30.841503267973817,0
2648,4,0,0,38,0.0,0.0,1.0,38,1300,900,400,0.6923076923076923,17,9,8,389.6874682584374,0.44150071123755336,0.21151936444885777,0.21680402239571614,129329.78777675735,2479.639513825103,131809.42729058245,1119,5,188.21052631578948,32,6,20,35.79759392585237,0.6223958333333333,45.7070707070707,1017.1717171717162,31.78661616161613,0
2649,4,0,1,37,0.0,0.02631578947368421,0.9736842105263158,38,1400,1300,100,0.9285714285714286,15,13,2,384.19010298566184,0.44081910858226653,0.20977555523639202,0.21479477186341212,129522.50567544118,2352.2529588817324,131874.7586343229,1120,6,189.21052631578948,32,6,17,35.7407177706111,0.6243489583333333,45.51767676767676,1017.929292929292,31.810290404040376,0
2650,4,0,1,36,0.0,0.02702702702702703,0.972972972972973,37,1000,500,500,0.5,15,5,10,393.5830507176242,0.439720970970971,0.21585182148562443,0.22016797321961634,129544.24267409153,2797.283646914626,132341.52632100615,1121,7,194.64864864864865,33,4,18,35.47949018899723,0.6221590909090908,45.496323529411754,1018.0147058823516,30.848930481283382,0
2651,4,0,1,35,0.0,0.027777777777777776,0.9722222222222222,36,1250,900,350,0.72,16,9,7,377.18599392907805,0.4369543650793651,0.14069381724926133,0.19627459161896899,126646.80262218116,2355.866190174267,129002.66881235543,1122,8,200.41666666666666,32,4,17,38.86702416792104,0.5950520833333333,48.35858585858584,1006.5656565656545,31.455176767676704,8
2652,4,3,0,38,0.07894736842105263,0.0,1.0,38,900,500,400,0.5555555555555556,13,5,8,355.4951742961685,0.442315670934092,0.14872981794263995,0.18869274520526255,127452.38803854841,1461.741780045309,128914.12981859372,1123,0,189.28947368421052,34,4,19,38.585386701249696,0.5986519607843137,47.55952380952379,1009.761904761902,29.698879551820646,0
2653,4,1,0,39,0.02564102564102564,0.0,1.0,39,1250,800,450,0.64,17,8,9,347.59539910638864,0.44348852901484476,0.15222597914905678,0.18606577246283115,127793.20987654288,1084.06635802466,128877.27623456754,1124,0,185.4102564102564,35,4,20,38.43578296703298,0.6,47.22222222222221,1011.1111111111085,28.888888888888815,0
2654,4,2,2,39,0.04878048780487805,0.04878048780487805,0.9512195121951219,41,1250,900,350,0.72,16,9,7,332.8758024691359,0.44578252032520327,0.14973983739837404,0.18091076221148672,128401.20525931321,348.8131008260346,128750.01836013925,1125,0,177.3170731707317,36,5,17,38.18726851851852,0.6041666666666667,46.621621621621614,1013.5135135135123,28.15315315315312,0
2655,4,2,0,41,0.04878048780487805,0.0,1.0,41,950,700,250,0.7368421052631579,12,7,5,328.9123812362882,0.4476626016260163,0.14836089981321576,0.18004256105339944,128686.69979100715,265.3297723398996,128952.02956334705,1126,0,169.65853658536585,36,5,19,37.996901590825,0.6070601851851851,46.34009009009009,1014.6396396396391,28.18443443443442,0
2656,4,4,3,42,0.08888888888888889,0.06666666666666667,0.9333333333333333,45,1150,800,350,0.6956521739130435,15,8,7,302.915771234099,0.45317760942760943,0.15920547260289553,0.1700293002943178,129678.39084201369,-1142.6468354968388,128535.74400651685,1127,0,155.48888888888888,39,6,15,37.65127497102336,0.6116452991452992,45.36458333333332,1018.541666666665,26.11645299145295,0
2657,4,0,3,39,0.0,0.07142857142857142,0.9285714285714286,42,1350,1100,250,0.8148148148148148,16,11,5,323.75028234941254,0.44898132017034453,0.1545335098902676,0.18029742614873068,129368.6579043554,-23.37209526006211,129345.28580909534,1128,1,167.54761904761904,37,5,20,37.43488179923836,0.6120495495495495,45.668859649122815,1017.3245614035104,27.495258416311092,0
2658,4,0,1,38,0.0,0.02564102564102564,0.9743589743589743,39,1100,700,400,0.6363636363636364,15,7,8,347.6111224305659,0.4430386864597391,0.1697080072607502,0.19159031631638213,128959.43877551051,1165.5470521542356,130124.98582766474,1129,2,181.05128205128204,34,5,20,37.244588998280996,0.6139705882352942,46.07142857142859,1015.7142857142882,29.873949579832004,0
2659,4,0,1,37,0.0,0.02631578947368421,0.9736842105263158,38,1400,1100,300,0.7857142857142857,17,11,6,346.5124792313988,0.4429528212422949,0.16109170227173308,0.1920138236649451,129171.97312510741,1351.9401309585342,130523.91325606595,1130,3,179.18421052631578,35,3,20,37.05607897832935,0.6139880952380952,45.86226851851853,1016.5509259259279,29.044312169312224,0
2660,4,0,0,37,0.0,0.0,1.0,37,900,500,400,0.5555555555555556,13,5,8,345.4290009712444,0.4423485985985986,0.14729587332327077,0.1917029952758545,129231.6485969389,1528.0752027212816,130759.72379966019,1131,4,175.2972972972973,34,3,21,37.02288959138275,0.6167279411764706,45.80357142857144,1016.7857142857154,29.905462184873983,0
2661,4,0,0,37,0.0,0.0,1.0,37,800,400,400,0.5,12,4,8,348.381079618075,0.4418480980980981,0.14343776192810664,0.19393591696002965,129352.7228599775,1612.808248299336,130965.53110827683,1132,5,176.2972972972973,34,3,21,36.82465379364151,0.617953431372549,45.68452380952382,1017.2619047619062,29.919467787114886,0
2662,4,0,0,37,0.0,0.0,1.0,37,900,600,300,0.6666666666666666,12,6,6,345.0881142771391,0.4409096596596596,0.1379443280530619,0.1932900223583739,129595.0414540816,1544.3416950113342,131139.38314909293,1133,6,177.2972972972973,34,3,18,36.6620873767489,0.6204044117647058,45.44642857142857,1018.2142857142853,29.947478991596626,0
2663,4,1,2,36,0.02631578947368421,0.05263157894736842,0.9473684210526316,38,450,200,250,0.4444444444444444,7,2,5,336.6280773952388,0.44181187766714086,0.13656415314265224,0.18963597066315288,129819.89354263124,1140.2042341821107,130960.09777681335,1134,0,173.60526315789474,35,3,19,36.649275979557096,0.6205357142857143,45.22569444444445,1019.0972222222227,29.117063492063508,0
2664,4,0,0,36,0.0,0.0,1.0,36,1050,700,350,0.6666666666666666,14,7,7,350.171454787375,0.4409556878306878,0.1315919600138986,0.19697736638039476,129762.65889321406,1887.8358083429298,131650.49470155698,1135,1,176.58333333333334,33,3,19,36.36236067677009,0.6243686868686869,45.28186274509803,1018.8725490196072,30.874925727866884,0
2665,4,0,0,36,0.0,0.0,1.0,36,650,400,250,0.6153846153846154,9,4,5,350.5033615663726,0.4409556878306878,0.1272246272246269,0.19747872322398052,129825.097318339,1900.8266051518472,131725.92392349086,1136,2,177.58333333333334,33,3,19,36.29048420715087,0.625,45.22058823529411,1019.1176470588227,30.882352941176446,0
2666,4,1,2,35,0.02702702702702703,0.05405405405405406,0.9459459459459459,37,900,800,100,0.8888888888888888,10,8,2,343.0530747320221,0.44150400400400397,0.1256195532910418,0.1950033790850725,130171.45691609975,1531.1437074829905,131702.60062358275,1137,0,173.75675675675674,34,3,21,36.12901501011046,0.6262254901960784,44.88095238095238,1020.4761904761903,30.01400560224089,0
2667,4,1,0,36,0.027777777777777776,0.0,1.0,36,1100,900,200,0.8181818181818182,13,9,4,351.3621912803213,0.4369874338624338,0.14260326224676256,0.20035581215306997,130293.8642138838,1956.0675281141512,132249.93174199795,1138,0,178.94444444444446,33,3,22,35.792897011163106,0.6297348484848485,44.76102941176469,1020.9558823529389,30.93805704099815,0
2668,4,0,0,36,0.0,0.0,1.0,36,1050,800,250,0.7619047619047619,13,8,5,351.9192476449766,0.4366071428571428,0.1419012582640229,0.20148343738794783,130450.30757400974,1981.5948193002416,132431.90239330998,1139,1,179.94444444444446,33,3,22,35.62010156749841,0.6313131313131313,44.60784313725489,1021.5686274509784,30.956625074272072,0
2669,4,0,0,36,0.0,0.0,1.0,36,1050,800,250,0.7619047619047619,13,8,5,352.00835495406426,0.4359292328042328,0.14929681569379571,0.20267810251081825,130669.48596993927,1999.350159794289,132668.83612973357,1140,2,180.94444444444446,33,3,19,35.395815853609804,0.6335227272727273,44.39338235294117,1022.4264705882339,30.982620320855574,0
2670,4,0,2,34,0.0,0.05555555555555555,0.9444444444444444,36,1250,1000,250,0.8,15,10,5,378.4166503073963,0.43558201058201057,0.127312104893468,0.21017132814862022,129261.91184807259,2582.971938775515,131844.8837868481,1141,3,181.94444444444446,34,2,17,36.15346718176852,0.6170343137254901,45.773809523809526,1016.904761904762,29.90896358543418,8
2671,4,0,0,34,0.0,0.0,1.0,34,1200,900,300,0.75,15,9,6,390.6879871002417,0.43176247771836,0.15790742526518775,0.21665424739195233,129201.38888888895,3295.4861111111163,132496.87500000006,1142,4,193.3235294117647,32,2,18,35.90334699453552,0.62109375,45.833333333333336,1016.6666666666672,31.77083333333335,0
2672,4,0,0,34,0.0,0.0,1.0,34,1000,700,300,0.7,13,7,6,386.6670890657158,0.43166963755199045,0.15556545358957918,0.21512362358517997,129329.78777675745,3201.5145138251173,132531.30229058256,1143,5,194.3235294117647,32,2,19,35.87440003310163,0.6223958333333333,45.707070707070706,1017.171717171717,31.786616161616156,0
2673,4,0,0,34,0.0,0.0,1.0,34,1200,800,400,0.6666666666666666,16,8,8,389.6666908451769,0.4317996137849079,0.1610366196360664,0.21732345062430994,129426.12879106714,3286.6102629833545,132712.7390540505,1144,6,195.3235294117647,32,2,13,35.69973528560201,0.6233723958333333,45.61237373737373,1017.5505050505043,31.79845328282826,0
2674,4,1,0,35,0.02857142857142857,0.0,1.0,35,950,700,250,0.7368421052631579,12,7,5,381.43837832840296,0.4341386554621849,0.16451923076923136,0.21559560514214035,129950.0192233753,2913.584919261786,132863.60414263708,1145,0,190.71428571428572,33,2,16,35.375100160256416,0.6262626262626263,45.098039215686256,1019.6078431372523,30.897207367795524,0
2675,4,0,0,35,0.0,0.0,1.0,35,900,800,100,0.8888888888888888,10,8,2,381.8496694893093,0.43333333333333335,0.16412526812526806,0.2166938308451599,130106.25608239598,2936.206176710853,133042.46225910683,1146,1,191.71428571428572,33,2,17,35.205580580580566,0.6278409090909092,44.94485294117646,1020.2205882352924,30.915775401069467,0
2676,4,0,0,35,0.0,0.0,1.0,35,550,100,450,0.18181818181818182,10,1,9,380.90093868239427,0.4330182072829132,0.16577330908342236,0.21632886872234733,130137.51471789683,2913.9003027681506,133051.41502066498,1147,2,192.71428571428572,33,2,17,35.19797421731123,0.6281565656565656,44.9142156862745,1020.343137254901,30.919489007724273,0
2677,4,0,0,35,0.0,0.0,1.0,35,900,600,300,0.6666666666666666,12,6,6,381.0007584890975,0.4325980392156863,0.15326795144366012,0.21743139176240794,130325.14537677797,2930.795847750843,133255.94122452883,1148,3,193.71428571428572,33,2,17,35.00460073611777,0.630050505050505,44.730392156862735,1021.0784313725475,30.941770647652955,0
2678,4,1,0,36,0.027777777777777776,0.0,1.0,36,1050,700,350,0.6666666666666666,14,7,7,370.1138801514069,0.4345734126984127,0.15350536799896553,0.21337437788594502,130718.71456916085,2476.1621315192588,133194.8767006801,1149,0,189.30555555555554,34,2,17,34.883100504462554,0.6317401960784313,44.34523809523809,1022.6190476190463,30.077030812324892,0
2679,4,0,0,36,0.0,0.0,1.0,36,900,600,300,0.6666666666666666,12,6,6,370.6546380815183,0.43412698412698414,0.16319242453622973,0.21453041173809034,130870.93431122419,2501.5837585033682,133372.51806972755,1150,1,190.30555555555554,34,2,17,34.71495055264689,0.6332720588235294,44.196428571428555,1023.2142857142833,30.094537815125978,0
2680,4,1,1,36,0.02702702702702703,0.02702702702702703,0.972972972972973,37,1100,800,300,0.7272727272727273,14,8,6,363.9944120412241,0.4360610610610611,0.1603173972933274,0.2120465142957725,131120.59709630016,2145.432929312373,133266.03002561253,1151,0,186.13513513513513,35,2,18,34.63256205974311,0.6336309523809525,43.952546296296276,1024.1898148148116,29.262566137566047,0
2681,4,0,0,36,0.0,0.0,1.0,36,1350,1000,350,0.7407407407407407,17,10,7,377.5563892642475,0.4345734126984127,0.17447492831124523,0.2197388403552812,131084.19075963713,2698.334750566884,133782.52551020402,1152,1,191.63888888888889,34,2,18,34.32220220103851,0.6354166666666667,43.988095238095234,1024.0476190476186,30.119047619047606,0
2682,4,0,0,36,0.0,0.0,1.0,36,1100,700,400,0.6363636363636364,15,7,8,378.28161606244225,0.4335482804232804,0.18072503066692502,0.22068564787914008,131175.63952664402,2724.266581632657,133899.9061082767,1153,2,192.63888888888889,34,2,18,34.21097230292465,0.6363357843137255,43.898809523809526,1024.4047619047622,30.1295518207283,0
2683,4,0,0,36,0.0,0.0,1.0,36,950,700,250,0.7368421052631579,12,7,5,374.70329339124225,0.433316798941799,0.1785115060466438,0.2192944019582056,131297.62081916098,2639.5301870748312,133937.1510062358,1154,3,193.63888888888889,34,2,18,34.17910519998451,0.6375612745098039,43.779761904761905,1024.8809523809523,30.143557422969185,0
2684,4,0,0,36,0.0,0.0,1.0,36,900,600,300,0.6666666666666666,12,6,6,373.07420723754,0.43371362433862437,0.17787803938754143,0.21905346610221027,131422.35145436844,2606.0614595102716,134028.4129138787,1155,4,194.63888888888889,33,3,19,34.09463268395682,0.6410984848484849,43.658088235294116,1025.3676470588232,31.0717468805704,0
2685,4,0,0,36,0.0,0.0,1.0,36,800,300,500,0.375,13,3,10,371.61393096183247,0.4335978835978836,0.1777976901632814,0.21873478214842035,131516.61169982693,2574.6810121107196,134091.29271193765,1156,5,195.63888888888889,33,3,19,34.03673835125448,0.6420454545454546,43.56617647058823,1025.7352941176466,31.082887700534744,0
2686,4,1,0,37,0.02702702702702703,0.0,1.0,37,850,500,350,0.5882352941176471,12,5,7,361.95739334687613,0.43365240240240244,0.18329414784876374,0.2159487337086096,132030.6990504535,2157.897534013604,134188.5965844671,1157,0,191.32432432432432,34,3,16,33.765541140584574,0.6449142156862745,43.06547619047619,1027.7380952380952,30.227591036414566,0
2687,4,0,2,35,0.0,0.05405405405405406,0.9459459459459459,37,950,500,450,0.5263157894736842,14,5,9,364.99513490933936,0.43321446446446443,0.11217453688764656,0.2167111513326134,131847.23816609985,2306.5795068027246,134153.81767290257,1158,1,192.32432432432432,34,3,19,33.872580271241446,0.6430759803921569,43.24404761904762,1027.02380952381,30.206582633053237,8
2688,4,0,0,35,0.0,0.0,1.0,35,1100,700,400,0.6363636363636364,15,7,8,377.90316868786425,0.42801120448179275,0.13491552009274943,0.2240941720053513,131799.59518274217,2961.4969302672034,134761.09211300936,1159,2,203.85714285714286,33,2,19,33.589305605283066,0.6448863636363636,43.29044117647059,1026.8382352941173,31.116310160427798,0
2689,4,0,1,34,0.0,0.02857142857142857,0.9714285714285714,35,1400,1100,300,0.7857142857142857,17,11,6,381.9502614940854,0.4269957983193277,0.13219738276990212,0.22743401934420535,131956.93963860048,3080.1975201845376,135037.13715878502,1160,3,204.85714285714286,33,2,19,33.32637563613231,0.6464646464646464,43.13725490196078,1027.4509803921565,31.13487819370171,0
2690,4,0,0,34,0.0,0.0,1.0,34,850,700,150,0.8235294117647058,10,7,3,354.2766154341186,0.4252636660724896,0.09395377220709977,0.20248761384472352,130384.14292800435,2438.4105725623353,132822.5535005667,1161,4,205.2941176470588,34,0,16,35.62696701247232,0.6283700980392157,44.67261904761904,1021.3095238095224,30.03851540616242,8
2691,4,0,0,34,0.0,0.0,1.0,34,700,500,200,0.7142857142857143,9,5,4,354.2766154341186,0.4252636660724896,0.09395377220709977,0.20248761384472352,130384.14292800435,2438.4105725623353,132822.5535005667,1162,5,206.2941176470588,34,0,16,35.62696701247232,0.6283700980392157,44.67261904761904,1021.3095238095224,30.03851540616242,0
2692,4,1,0,35,0.02857142857142857,0.0,1.0,35,1200,800,400,0.6666666666666666,16,8,8,344.5901484133903,0.42633053221288514,0.09522084977041989,0.19874664173503356,130735.62349965691,2010.0415809327676,132745.66508058968,1163,0,201.37142857142857,35,0,14,35.51852271012525,0.6297619047619047,44.328703703703695,1022.685185185184,29.219576719576686,0
2693,4,0,0,35,0.0,0.0,1.0,35,750,400,350,0.5333333333333333,11,4,7,344.42501885753194,0.4251750700280112,0.09469092319126293,0.19956789100513073,130913.23329260961,2017.9585691014995,132931.19186171112,1164,1,202.37142857142857,35,0,15,35.34315388675263,0.631547619047619,44.15509259259259,1023.3796296296287,29.239417989417962,0
2694,4,0,0,35,0.0,0.0,1.0,35,1500,1300,200,0.8666666666666667,17,13,4,367.5883868879726,0.42496498599439775,0.1453907346747776,0.20510088323227096,129443.56575963719,2599.9942370209383,132043.55999665812,1165,2,203.37142857142857,34,1,14,36.243614490719075,0.6188725490196079,45.595238095238095,1017.6190476190477,29.929971988795522,8
2695,4,1,0,36,0.027777777777777776,0.0,1.0,36,1000,900,100,0.9,11,9,2,360.73603320616957,0.4271494708994709,0.1417158867181585,0.20306394094290986,129790.40745027407,2164.0153463648467,131954.42279663892,1166,0,198.69444444444446,35,1,15,36.06504619112524,0.6202380952380953,45.25462962962961,1018.9814814814792,29.11375661375655,0
2696,4,1,0,37,0.02702702702702703,0.0,1.0,37,1150,800,350,0.6956521739130435,15,8,7,354.0001853875906,0.42836586586586584,0.15176531640888324,0.20125154830504022,130176.38204082432,1816.4926751075063,131992.87471593183,1167,0,194.2972972972973,36,1,16,35.84473626131097,0.6221064814814814,44.87612612612611,1020.4954954954932,28.347097097097034,0
2697,4,0,1,36,0.0,0.02702702702702703,0.972972972972973,37,1000,700,300,0.7,13,7,6,357.4260698416476,0.42761511511511513,0.1537811187590179,0.20411457697170546,130351.21588059382,1918.2130918573043,132269.42897245113,1168,1,195.2972972972973,35,2,19,35.579947296837815,0.6258928571428571,44.70486111111109,1021.180555555553,29.17658730158723,0
2698,4,1,0,37,0.02702702702702703,0.0,1.0,37,1050,700,350,0.6666666666666666,14,7,7,356.91724379055916,0.42833458458458457,0.16341125901615294,0.2046016511807178,130498.99798525359,1915.4685356652762,132414.46652091885,1169,0,196.13513513513513,35,2,14,35.443097719377754,0.6273809523809524,44.560185185185176,1021.7592592592578,29.19312169312165,0
2699,4,0,0,37,0.0,0.0,1.0,37,1150,700,450,0.6086956521739131,16,7,9,351.85343948798794,0.42792792792792794,0.15232191321855137,0.202470451530775,130646.86381440745,1793.7096782835933,132440.57349269104,1170,1,197.13513513513513,35,2,14,35.42268104456773,0.6288690476190476,44.41550925925925,1022.3379629629619,29.209656084656054,0
2700,4,0,0,37,0.0,0.0,1.0,37,1250,900,350,0.72,16,9,7,349.9019710509765,0.4277715215215215,0.15056341991606836,0.20181030131895747,130735.62349965703,1748.9304698216717,132484.5539694787,1171,2,198.13513513513513,35,2,14,35.38271465218047,0.6297619047619047,44.3287037037037,1022.6851851851849,29.21957671957671,0
2701,4,0,0,37,0.0,0.0,1.0,37,850,700,150,0.8235294117647058,10,7,3,346.46588082708547,0.42714589589589586,0.14763524977301667,0.2005962575240513,130883.62328800156,1669.3419656635829,132552.96525366514,1172,3,199.13513513513513,35,2,14,35.32087716321683,0.63125,44.18402777777778,1023.263888888889,29.236111111111114,0
2702,4,0,1,36,0.0,0.02702702702702703,0.972972972972973,37,1050,500,550,0.47619047619047616,16,5,11,343.36518370798,0.4265515515515515,0.13862692804707089,0.199720695612393,131061.33355034713,1600.3797743055504,132661.7133246527,1173,4,200.13513513513513,35,2,15,35.220625635808766,0.6330357142857144,44.010416666666664,1023.9583333333326,29.25595238095236,0
2703,4,0,0,36,0.0,0.0,1.0,36,1300,1000,300,0.7692307692307693,16,10,6,352.56659683569245,0.42298280423280427,0.152517795088426,0.20503213653710578,131053.71492346957,2041.0324546485472,133094.7473781181,1174,5,206.5,34,2,15,34.99278184707206,0.6351102941176471,44.01785714285715,1023.9285714285729,30.115546218487438,0
2704,4,0,0,36,0.0,0.0,1.0,36,1450,1100,350,0.7586206896551724,18,11,7,352.1691295566198,0.42220568783068785,0.15568168982265895,0.20579229729140328,131239.1643759647,2043.676456404338,133282.84083236902,1175,6,207.5,35,1,16,34.81552863436123,0.6348214285714286,43.836805555555564,1024.6527777777792,29.27579365079369,0
2705,4,1,0,37,0.02702702702702703,0.0,1.0,37,1100,800,300,0.7272727272727273,14,8,6,340.3600573797847,0.42454954954954954,0.15207151840163236,0.20086533956247443,131616.85333982663,1559.4239509780425,133176.27729080466,1176,0,202.86486486486487,36,1,13,34.73715978928887,0.6365740740740741,43.46846846846849,1026.1261261261286,28.503503503503573,0
2706,4,0,0,37,0.0,0.0,1.0,37,1000,800,200,0.8,12,8,4,340.4149741973229,0.4241741741741742,0.15839687866892715,0.201507980830052,131732.43344696081,1568.7385865595645,133301.1720335204,1177,1,203.86486486486487,36,1,13,34.61930488518356,0.6377314814814814,43.35585585585587,1026.576576576579,28.516016016016085,0
2707,4,0,0,37,0.0,0.0,1.0,37,1100,700,400,0.6363636363636364,15,7,8,343.7038063518063,0.4234234234234234,0.15985165349479247,0.20469670555834735,131963.74584043506,1671.2883491599778,133635.03418959503,1178,2,204.86486486486487,36,1,13,34.30193263188661,0.6400462962962963,43.130630630630634,1027.4774774774778,28.54104104104105,0
2708,4,0,0,37,0.0,0.0,1.0,37,900,600,300,0.6666666666666666,12,6,6,344.9229511673941,0.42332957957957956,0.15536469759276184,0.20620835764290402,132108.41912436092,1713.445159686725,133821.86428404765,1179,3,205.86486486486487,36,1,14,34.12499543579071,0.6414930555555556,42.98986486486487,1028.0405405405413,28.556681681681702,0
2709,4,0,1,36,0.0,0.02702702702702703,0.972972972972973,37,850,400,450,0.47058823529411764,13,4,9,342.5217973492129,0.42289164164164167,0.1515123709844992,0.20508632994069936,132166.3106307322,1653.9684532505642,133820.27908398275,1180,4,206.86486486486487,36,1,14,34.12847260248969,0.6420717592592593,42.933558558558566,1028.2657657657667,28.562937937937964,0
2710,4,1,0,37,0.02702702702702703,0.0,1.0,37,900,600,300,0.6666666666666666,12,6,6,344.27058789291453,0.4210147647647648,0.16204972215482405,0.20660759197200287,132253.17166829002,1706.175432188962,133959.34710047898,1181,0,207.54054054054055,36,1,15,33.996149916064525,0.6429398148148149,42.84909909909911,1028.6036036036046,28.57232232232235,0
2711,4,0,0,37,0.0,0.0,1.0,37,1550,1100,450,0.7096774193548387,20,11,9,342.9269472202404,0.4200763263263263,0.15793955881483268,0.20675147081748022,132426.97934420916,1682.555951221506,134109.53529543066,1182,1,208.54054054054055,36,1,15,33.85599015317287,0.6446759259259259,42.68018018018019,1029.27927927928,28.591091091091112,0
2712,4,0,0,37,0.0,0.0,1.0,37,650,300,350,0.46153846153846156,10,3,7,348.0292094514555,0.4198886386386386,0.16233952425574483,0.21031269411861575,132513.9259825704,1823.7433802045289,134337.66936277493,1183,2,209.54054054054055,36,1,15,33.63729993802181,0.6455439814814814,42.59572072072072,1029.6171171171168,28.600475475475466,0
2713,4,0,0,37,0.0,0.0,1.0,37,950,700,250,0.7368421052631579,12,7,5,352.51288225530595,0.41935685685685686,0.16863895709418775,0.2136802739555525,132629.89921932088,1950.7496094067271,134580.6488287276,1184,3,210.54054054054055,36,1,14,33.40530592908422,0.6467013888888888,42.48310810810812,1030.0675675675693,28.612987987988035,0
2714,4,1,0,38,0.02631578947368421,0.0,1.0,38,800,500,300,0.625,11,5,6,346.89148016081316,0.42139343290659076,0.1683060079495322,0.21206735009451133,132948.3427044527,1623.7294771349448,134572.07218158763,1185,0,205.97368421052633,38,0,15,33.23038606305465,0.6461074561403508,42.17414529914531,1031.3034188034205,27.13956365272159,0
2715,4,0,0,38,0.0,0.0,1.0,38,650,300,350,0.46153846153846156,10,3,7,347.148771401546,0.4214527027027027,0.17358608847338441,0.21253781787456738,133003.43940618387,1634.3961164073457,134637.83552259122,1186,1,206.97368421052633,38,0,15,33.16847919903333,0.6466557017543859,42.1207264957265,1031.5170940170947,27.145186684660388,0
2716,4,0,1,37,0.0,0.02631578947368421,0.9736842105263158,38,1150,900,250,0.782608695652174,14,9,5,350.7311837465036,0.42114153627311524,0.1793767915336073,0.21520722824801347,133086.10586054495,1735.4894897362826,134821.59535028122,1187,2,207.97368421052633,38,0,15,32.99315765859046,0.6474780701754386,42.04059829059829,1031.8376068376067,27.153621232568597,0
2717,4,0,0,37,0.0,0.0,1.0,37,900,600,300,0.6666666666666666,12,6,6,356.2348578225727,0.41938813813813813,0.1836355330561774,0.21802871226655435,132991.11415291234,2075.2141283856467,135066.328281298,1188,3,214.43243243243242,37,0,15,32.9465424683746,0.6483671171171171,42.132675438596486,1031.4692982456133,27.877548601232792,0
2718,4,0,0,37,0.0,0.0,1.0,37,1000,700,300,0.7,13,7,6,358.08199567641503,0.41816816816816815,0.17917322337211883,0.2199913670565545,133132.52635426272,2134.472145275455,135266.99849953817,1189,4,215.43243243243242,37,0,15,32.756941493129325,0.6497747747747749,41.99561403508771,1032.0175438596482,27.89236605026076,0
2719,4,1,0,38,0.02631578947368421,0.0,1.0,38,1100,700,400,0.6363636363636364,15,7,8,355.3356739300216,0.419467164532954,0.18973335194750773,0.22047654554249158,133500.54974848006,1887.93438846565,135388.4841369457,1190,0,210.73684210526315,37,1,16,32.45877541998231,0.6534346846846847,41.6392543859649,1033.4429824561382,27.930891417733466,0
2720,4,0,0,38,0.0,0.0,1.0,38,800,500,300,0.625,11,5,6,354.6932030156341,0.418859649122807,0.19080901234843606,0.22058360936882537,133585.55036164954,1876.3773468759368,135461.92770852547,1191,1,211.73684210526315,37,1,17,32.39022061943148,0.6542792792792793,41.55701754385964,1033.7719298245597,27.939781887150264,0
2721,4,0,0,38,0.0,0.0,1.0,38,1500,1100,400,0.7333333333333333,19,11,8,355.7709808559603,0.418830014224751,0.18870809338868777,0.22193332615300385,133698.9265927978,1913.2396506617395,135612.16624345953,1192,2,212.73684210526315,37,1,17,32.24881608707943,0.6554054054054055,41.44736842105263,1034.2105263157894,27.951635846372685,0
2722,4,0,1,37,0.0,0.02631578947368421,0.9736842105263158,38,1250,900,350,0.72,16,9,7,358.6929690256285,0.4166518492176387,0.190862658287843,0.22496365014172126,133897.45071800935,2005.6148286011062,135903.06554661045,1193,3,213.73684210526315,37,1,14,31.974498534449268,0.6573761261261262,41.25548245614035,1034.9780701754382,27.972380275011844,0
2723,4,0,0,37,0.0,0.0,1.0,37,1250,1000,250,0.8,15,10,5,375.5605470555567,0.4151338838838839,0.17869089137499805,0.21931000366569015,131212.72243527303,2457.2543961980064,133669.97683147102,1194,4,217.0,36,1,18,34.243102879753785,0.6325231481481481,43.86261261261261,1024.5495495495488,28.45970970970969,8
2724,4,0,1,36,0.0,0.02702702702702703,0.972972972972973,37,1300,800,500,0.6153846153846154,18,8,10,373.12446295194684,0.4153215715715716,0.1753460777851028,0.21854432830042583,131328.12499999985,2400.347222222207,133728.47222222207,1195,5,218.0,36,1,19,34.18868563685637,0.6336805555555556,43.74999999999999,1024.9999999999989,28.47222222222219,0
2725,4,0,0,36,0.0,0.0,1.0,36,1100,700,400,0.6363636363636364,15,7,8,376.8903548457627,0.41630291005291004,0.1694234315607246,0.22092110343275412,131357.7852393045,2701.4964581189734,134059.2816974235,1196,6,221.05555555555554,35,1,19,34.062158932670954,0.6360119047619048,43.7210648148148,1025.115740740739,29.289021164021115,0
2726,4,0,0,36,0.0,0.0,1.0,36,700,300,400,0.42857142857142855,11,3,8,377.34168683680855,0.41612103174603177,0.17308271242567907,0.22135712993380466,131387.44882758913,2715.592313957469,134103.0411415466,1197,7,222.05555555555554,35,1,19,34.02056521411907,0.6363095238095238,43.692129629629626,1025.2314814814813,29.292328042328037,0
2727,4,0,0,36,0.0,0.0,1.0,36,1350,1000,350,0.7407407407407407,17,10,7,376.87836411265647,0.4158564814814815,0.1769705174488574,0.22211767416852293,131565.50068587094,2716.8381344307136,134282.33882030167,1198,8,223.05555555555554,35,1,17,33.85228640192539,0.638095238095238,43.51851851851851,1025.925925925925,29.312169312169285,0
2728,4,0,0,36,0.0,0.0,1.0,36,1050,700,350,0.6666666666666666,14,7,7,377.38757472889904,0.4155753968253968,0.1740425451948735,0.22328555038496367,131713.96933138292,2741.4430887774406,134455.41242016037,1199,9,224.05555555555554,35,1,17,33.68909027699477,0.6395833333333334,43.373842592592595,1026.50462962963,29.328703703703713,0
2729,4,0,0,36,0.0,0.0,1.0,36,1400,1100,300,0.7857142857142857,17,11,6,377.24303665280877,0.41440145502645503,0.17436532972810603,0.2244242086682527,131921.96609224964,2753.3286179698252,134675.29471021946,1200,10,225.05555555555554,35,1,17,33.48261228781733,0.6416666666666666,43.1712962962963,1027.3148148148148,29.35185185185185,0
2730,4,0,0,36,0.0,0.0,1.0,36,1150,600,550,0.5217391304347826,17,6,11,369.9714583857557,0.41440145502645503,0.18214864846754875,0.20435931788649578,129045.69644187338,2383.6350428046553,131429.33148467803,1201,11,226.05555555555554,33,3,17,36.588745828810374,0.6171085858585859,45.98651960784314,1016.053921568628,30.78951277480691,8
2731,4,0,0,36,0.0,0.0,1.0,36,800,500,300,0.625,11,5,6,371.77285220723934,0.41426917989417994,0.18456328630571983,0.2056779361810966,129107.96215698295,2399.7670667531816,131507.72922373613,1202,12,227.05555555555554,33,3,18,36.479435467663485,0.617739898989899,45.92524509803922,1016.2990196078437,30.796939988116474,0
2732,4,2,1,37,0.05263157894736842,0.02631578947368421,0.9736842105263158,38,800,300,500,0.375,13,3,10,351.7002952327241,0.4186818397344713,0.17688947676028155,0.1972981000469478,129655.6565334467,1520.0203273711402,131175.67686081785,1203,0,216.05263157894737,34,4,14,36.43215468536918,0.6210171568627452,45.38690476190476,1018.4523809523808,29.954481792717083,0
2733,4,0,0,37,0.0,0.0,1.0,37,800,400,400,0.5,12,4,8,360.2137449439981,0.4142892892892893,0.18521759212576394,0.20182171319889947,129606.62853529885,1937.2178068531246,131543.84634215198,1204,1,222.8918918918919,33,4,14,36.26526958719461,0.622790404040404,45.43504901960784,1018.259803921568,30.856357694592973,0
2734,4,0,1,36,0.0,0.02702702702702703,0.972972972972973,37,750,400,350,0.5333333333333333,11,4,7,361.8781910332186,0.41356981981981983,0.1880124049958063,0.20356260353519476,129762.65889321404,1991.655252787375,131754.31414600142,1205,2,223.8918918918919,33,4,15,36.06416887178252,0.6243686868686869,45.28186274509803,1018.872549019607,30.87492572786688,0
2735,4,1,0,37,0.02702702702702703,0.0,1.0,37,1050,800,250,0.7619047619047619,13,8,5,360.5431155507368,0.4174486986986987,0.18318809119649648,0.2039902462224314,129989.29280045355,1973.3489229024958,131962.64172335604,1206,0,208.21621621621622,34,3,16,35.86782045295353,0.6243872549019608,45.05952380952381,1019.7619047619049,29.992997198879557,0
2736,4,0,2,35,0.0,0.05405405405405406,0.9459459459459459,37,900,700,200,0.7777777777777778,11,7,4,335.21245665056244,0.41704204204204204,0.06074829706531881,0.17846830555562,127575.06397867472,1153.2371105247669,128728.30108919949,1207,1,209.21621621621622,36,1,18,38.97187232935755,0.595775462962963,47.43806306306307,1010.2477477477485,28.062437437437456,8
2737,4,0,0,35,0.0,0.0,1.0,35,650,300,350,0.46153846153846156,10,3,7,346.62580099679593,0.4110994397759104,0.09524932614555293,0.18371167452830195,127392.29024943312,1831.490929705218,129223.78117913834,1208,18,222.02857142857144,34,1,18,38.87087264150942,0.5980392156862745,47.61904761904762,1009.5238095238096,29.691876750700285,0
2738,4,3,0,38,0.07894736842105263,0.0,1.0,38,600,300,300,0.5,9,3,6,324.67572457671235,0.42093409198672355,0.09711446926641853,0.17520344623125603,128116.77781865599,719.2815337411787,128836.05935239716,1209,0,205.42105263157896,37,1,21,38.68494801256363,0.5993806306306306,46.90241228070177,1012.3903508771949,27.361901375059322,0
2739,4,0,1,37,0.0,0.02631578947368421,0.9736842105263158,38,1250,1000,250,0.8,15,10,5,325.1107409032441,0.41955606922712185,0.09248413304315095,0.17604765676812265,128255.57503270257,739.4530047707224,128995.0280374733,1210,1,206.42105263157896,37,1,22,38.53242043732411,0.6007882882882882,46.76535087719299,1012.9385964912296,27.376718824087288,0
2740,4,0,1,36,0.0,0.02702702702702703,0.972972972972973,37,850,700,150,0.8235294117647058,10,7,3,329.2663671776144,0.4183871371371371,0.07684148851464023,0.17831131684302526,128258.57688347166,1046.2471339583215,129304.82401742999,1211,2,200.05405405405406,36,1,22,38.424124513618686,0.6027199074074074,46.762387387387406,1012.9504504504533,28.137512512512593,0
2741,4,0,0,36,0.0,0.0,1.0,36,900,500,400,0.5555555555555556,13,5,8,333.3284789970878,0.41808862433862437,0.06886375752037166,0.18079042782778848,128320.3727816358,1354.5669367283904,129674.93971836418,1212,3,202.72222222222223,35,1,23,38.258224811514715,0.6053571428571429,46.701388888888886,1013.1944444444445,28.9484126984127,0
2742,4,0,0,36,0.0,0.0,1.0,36,1050,800,250,0.7619047619047619,13,8,5,341.6780161588871,0.41908068783068786,0.11616954474097341,0.17532132037427825,126072.10884871359,1415.2136088791494,127487.32245759273,1213,4,203.72222222222223,36,0,20,40.35167638483965,0.5804398148148149,48.93018018018018,1004.2792792792793,27.896646646646648,8
2743,4,1,1,36,0.02702702702702703,0.02702702702702703,0.972972972972973,37,1000,600,400,0.6,14,6,8,331.8367745818001,0.4227352352352352,0.10837917389754326,0.1718768341749775,126457.07242853566,992.6214075484686,127449.69383608413,1214,0,199.1891891891892,37,0,16,40.20301882335841,0.5824887387387387,48.547149122807014,1005.8114035087715,27.184091986723555,0
2744,4,1,2,35,0.02702702702702703,0.05405405405405406,0.9459459459459459,37,1500,1200,300,0.8,18,12,6,344.7859787341586,0.42558183183183185,0.06328501974806366,0.17344666468409378,125253.50677958367,1238.7206174868707,126492.22739707054,1215,0,199.51351351351352,36,1,16,41.11823602204972,0.5720486111111112,49.74662162162162,1001.0135135135137,27.805930930930934,8
2745,4,3,0,38,0.07894736842105263,0.0,1.0,38,900,700,200,0.7777777777777778,11,7,4,334.3841858520709,0.42855026078710284,0.09404083980442923,0.17054711820214305,125823.72100069241,814.6925015389234,126638.41350223134,1216,0,195.0,37,1,19,40.790528233151164,0.5760135135135135,49.17763157894736,1003.2894736842097,27.11593172119486,0
2746,4,3,2,39,0.07317073170731707,0.04878048780487805,0.9512195121951219,41,1150,700,450,0.6086956521739131,16,7,9,316.39624102452325,0.43610264227642276,0.12006650737863511,0.16506219438661998,126750.8802625869,-179.10722079148854,126571.77304179542,1217,0,181.65853658536585,39,2,17,40.290097755249796,0.5819978632478633,48.255208333333336,1006.9791666666674,25.81997863247865,0
2747,4,1,0,40,0.025,0.0,1.0,40,1200,700,500,0.5833333333333334,17,7,10,329.9374223625592,0.4344284188034188,0.13223830734966624,0.17254464533868952,126849.74163790273,370.4953566732466,127220.23699457597,1218,0,187.125,38,2,18,39.8478099480327,0.584703947368421,48.157051282051285,1007.371794871795,26.509784075573553,0
2748,4,2,0,42,0.047619047619047616,0.0,1.0,42,1150,800,350,0.6956521739130435,15,8,7,329.93361752413426,0.43933894696089815,0.18062371338980587,0.17625646275527043,127712.20419908344,27.772184783430703,127739.97638386687,1219,0,179.16666666666666,38,4,18,38.9650054610154,0.5934758771929824,47.30235042735044,1010.7905982906002,26.599752586594743,0
2749,4,2,0,44,0.045454545454545456,0.0,1.0,44,1550,1100,450,0.7096774193548387,20,11,9,325.6544197550528,0.442411028893587,0.21704631514758121,0.17695613179282493,128394.44739006224,-435.36460643064794,127959.08278363159,1220,0,171.97727272727272,37,7,17,38.377127736304956,0.6021959459459459,46.628289473684205,1013.4868421052626,27.391536273115204,0
2750,4,0,0,44,0.0,0.0,1.0,44,1750,1300,450,0.7428571428571429,22,13,9,321.3266219008837,0.441508104298802,0.2152543717964277,0.1754771350223728,128593.16541883691,-535.9185112847125,128057.2469075522,1221,1,172.97727272727272,39,5,17,38.28448615247679,0.6006944444444444,46.43229166666667,1014.2708333333343,26.006944444444468,0
2751,4,1,0,45,0.022222222222222223,0.0,1.0,45,1200,900,300,0.75,15,9,6,318.0835214853744,0.4441077441077441,0.22787280628633066,0.1755870217719099,129020.6425263567,-792.1319361821581,128228.51059017456,1222,0,170.11111111111111,40,5,18,37.93221299723251,0.6033854166666667,46.01117886178862,1015.9552845528458,25.398882113821145,0
2752,4,1,1,45,0.021739130434782608,0.021739130434782608,0.9782608695652174,46,750,500,250,0.6666666666666666,10,5,5,311.581028817891,0.44474637681159424,0.23632035769475657,0.17313406854576407,129280.82817925367,-1143.4562776398795,128137.37190161379,1223,0,167.3913043478261,39,7,19,37.833422957424276,0.6076388888888888,45.75520833333334,1016.9791666666683,26.076388888888932,0
2753,4,0,0,45,0.0,0.0,1.0,45,1600,1100,500,0.6875,21,11,10,312.69976963296904,0.4451388888888889,0.2405432149315858,0.17445825525668068,129439.78000217036,-904.8421223958136,128534.93787977454,1224,1,171.06666666666666,39,6,14,37.643843620977904,0.6092414529914529,45.59895833333334,1017.6041666666684,26.092414529914574,0
2754,4,0,0,45,0.0,0.0,1.0,45,1500,1100,400,0.7333333333333333,19,11,8,314.6368877804739,0.4447180134680135,0.2470797009826755,0.17609119227847986,129563.26116233734,-846.9237474386803,128716.33741489866,1225,2,172.06666666666666,40,5,15,37.469430025953294,0.6088541666666667,45.47764227642277,1018.0894308943099,25.452235772357746,0
2755,4,0,0,45,0.0,0.0,1.0,45,900,500,400,0.5555555555555556,13,5,8,316.92838118940165,0.44404461279461277,0.25268852967915034,0.1778418945285657,129666.74619108994,-780.9856071121711,128885.76058397777,1226,3,173.06666666666666,40,5,15,37.306259562296276,0.6098958333333333,45.3760162601626,1018.4959349593495,25.46239837398374,0
2756,4,0,0,45,0.0,0.0,1.0,45,1350,700,650,0.5185185185185185,20,7,13,307.8225404776643,0.4434132996632996,0.05017006237466948,0.1735330105930576,129847.94439693641,-984.8237449600017,128863.12065197641,1227,4,174.06666666666666,40,5,17,37.354796091335125,0.61171875,45.19817073170732,1019.2073170731711,25.48018292682928,8
2757,4,0,1,44,0.0,0.022222222222222223,0.9777777777777777,45,1200,800,400,0.6666666666666666,16,8,8,311.8676534928738,0.44305555555555554,0.05259170653907508,0.17616307994597483,129925.6395002976,-896.0791360962207,129029.56036420139,1228,5,175.06666666666666,40,5,18,37.17312931951091,0.6125,45.121951219512205,1019.5121951219526,25.487804878048813,0
2758,4,0,2,42,0.0,0.045454545454545456,0.9545454545454546,44,1300,800,500,0.6153846153846154,18,8,10,312.5154161014012,0.4400436046511628,0.06988972840514629,0.17733348698129311,130103.13042534703,-668.1532118055753,129434.97721354145,1229,6,179.8181818181818,39,5,18,36.97714587162207,0.6159188034188035,44.94791666666666,1020.2083333333318,26.159188034187995,0
2759,4,0,0,42,0.0,0.0,1.0,42,1300,900,400,0.6923076923076923,17,9,8,355.4207351414854,0.4376330816879597,-0.0010040319392838892,0.1981015633561579,129401.82317029855,921.9750816060829,130323.79825190463,1230,8,188.95238095238096,36,6,21,36.59564655967533,0.6142939814814814,45.636261261261254,1017.454954954954,28.26263763763761,8
2760,4,1,1,42,0.023255813953488372,0.023255813953488372,0.9767441860465116,43,1550,1200,350,0.7741935483870968,19,12,7,347.6031918395209,0.4383305647840532,-0.001985341642174898,0.19530915935119755,129717.84056770003,418.067083972498,130135.90765167252,1231,0,185.53488372093022,38,5,18,36.47330012235623,0.6137609649122807,45.325854700854684,1018.6965811965786,26.807804768331014,0
2761,4,1,1,42,0.023255813953488372,0.023255813953488372,0.9767441860465116,43,1300,1100,200,0.8461538461538461,15,11,4,339.73228367933217,0.43881506090808414,0.023794154257638533,0.19248807788050915,130044.55133912241,236.066481298825,130280.61782042123,1232,0,186.1860465116279,38,5,19,36.34235012743968,0.6170504385964912,45.00534188034187,1019.9786324786305,26.84154295996396,0
2762,4,0,1,41,0.0,0.023809523809523808,0.9761904761904762,42,1350,1000,350,0.7407407407407407,17,10,7,342.6167668335488,0.4357820363917925,0.04586156523126461,0.19466583819317188,130153.54624379036,518.5574411936282,130672.10368498399,1233,1,191.38095238095238,38,4,19,36.15829930548284,0.6181469298245614,44.89850427350426,1020.4059829059807,26.8527890238416,0
2763,4,0,1,40,0.0,0.024390243902439025,0.975609756097561,41,1200,800,400,0.6666666666666666,16,8,8,334.72257652377647,0.43417174796747965,0.0801914080634214,0.18526379235473212,129125.75511975623,444.2610898526053,129570.01620960883,1234,2,196.65853658536585,41,0,18,37.40269643728647,0.6028963414634146,45.907738095238095,1016.3690476190476,24.789488966318235,8
2764,4,0,2,38,0.0,0.05,0.95,40,650,500,150,0.7692307692307693,8,5,3,334.8127919143546,0.4317975427350427,0.09270406468047421,0.18580360775628169,129230.01284646119,653.6608571478109,129883.673703609,1235,3,201.95,36,4,19,37.29441244877616,0.6125578703703703,45.80518018018017,1016.7792792792782,28.243868868868837,0
2765,4,0,1,37,0.0,0.02631578947368421,0.9736842105263158,38,1200,900,300,0.75,15,9,6,349.01962192063957,0.42978010905642483,0.10516635782835992,0.19341419351047637,129174.2357572684,1416.8685851778591,130591.10434244626,1236,5,211.1315789473684,38,0,19,36.99005955508845,0.6082785087719298,45.860042735042725,1016.5598290598274,26.751574448942826,0
2766,4,0,0,37,0.0,0.0,1.0,37,1150,900,250,0.782608695652174,14,9,5,359.53028467560205,0.42673923923923923,0.11522201813463995,0.19909472753541357,129145.65659626012,1886.3549361341657,131032.01153239429,1237,17,217.7027027027027,37,0,20,36.752067601582155,0.6097972972972974,45.88815789473683,1016.4473684210504,27.47155049786623,0
2767,4,0,0,37,0.0,0.0,1.0,37,1450,1200,250,0.8275862068965517,17,12,5,361.07259320097756,0.4270207707707708,0.10629805908052137,0.20118286367479993,129388.34372597087,1943.7650515436862,131332.10877751457,1238,18,218.7027027027027,33,4,20,36.46561069621779,0.6205808080808081,45.649509803921575,1017.4019607843145,30.83036244800953,0
2768,4,1,0,38,0.02631578947368421,0.0,1.0,38,800,500,300,0.625,11,5,6,352.7502812383687,0.4286688003793267,0.1113443116994941,0.19826998566156612,129731.44531250012,1552.5607638889023,131284.00607638902,1239,0,213.92105263157896,35,3,19,36.32839127471029,0.6196428571428572,45.31250000000001,1018.7500000000009,29.107142857142883,0
2769,4,1,0,39,0.02564102564102564,0.0,1.0,39,1050,800,250,0.7619047619047619,13,8,5,346.4858430503933,0.4307242465137202,0.12356290963790695,0.1969910654410515,130178.65022170299,1221.0118738458166,131399.66209554882,1240,0,209.4102564102564,37,2,20,36.03414544608002,0.6202139639639639,44.87390350877194,1020.5043859649136,27.58119962067334,0
2770,4,0,0,39,0.0,0.0,1.0,39,950,600,350,0.631578947368421,13,6,7,345.0576869811935,0.43027440395861444,0.1163619145152317,0.19716977279403922,130374.54433094816,1197.3477416128217,131571.892072561,1241,1,210.4102564102564,37,2,20,35.872074296757575,0.6221846846846847,44.68201754385966,1021.2719298245629,27.60194404931251,0
2771,4,0,0,39,0.0,0.0,1.0,39,1150,500,650,0.43478260869565216,18,5,13,344.15057173767497,0.4291497975708502,0.1201570543774646,0.1973624109552857,130514.5588666705,1183.332010811018,131697.89087748152,1242,2,211.4102564102564,37,2,17,35.75345620059377,0.6235923423423424,44.54495614035088,1021.8201754385964,27.61676149834044,0
2772,4,1,0,40,0.025,0.0,1.0,40,1250,900,350,0.72,16,9,7,339.7391643801938,0.4301014957264957,0.12408644811025282,0.19673650038896565,130890.45606874114,893.7228340273034,131784.17890276844,1243,0,207.1,38,2,18,35.48605310781654,0.6255482456140351,44.17735042735042,1023.2905982905968,26.928699955015706,0
2773,4,1,1,40,0.024390243902439025,0.024390243902439025,0.975609756097561,41,1200,900,300,0.75,15,9,6,333.94498052318056,0.43173272357723574,0.12916390829050117,0.19518816241274672,131248.05908203125,565.926106770833,131813.9851888021,1244,0,203.02439024390245,39,2,19,35.27339381925384,0.6274038461538461,43.828125,1024.6875,26.27403846153846,0
2774,4,0,0,40,0.0,0.0,1.0,40,1000,700,300,0.7,13,7,6,337.35654168252853,0.4325721153846154,0.12554228803837808,0.1968905586240878,131191.27498584607,851.6469656293161,132042.92195147538,1245,1,197.825,38,2,19,35.24329092362778,0.6285635964912281,43.883547008547,1024.4658119658102,26.959626630679214,0
2775,4,2,0,42,0.047619047619047616,0.0,1.0,42,2100,1600,500,0.7619047619047619,26,16,10,325.2736815171327,0.4339793844367015,0.1264241300737654,0.19374997551237888,131969.53124999988,185.31439476950956,132154.8456447694,1246,0,189.35714285714286,39,3,20,34.76953230602865,0.6346153846153846,43.12499999999999,1027.499999999999,26.346153846153822,0
2776,4,0,1,41,0.0,0.023809523809523808,0.9761904761904762,42,1150,800,350,0.6956521739130435,15,8,7,326.5039228306382,0.4328421409214092,0.1267187726154293,0.19530871020232712,132130.12695312488,228.20095486109673,132358.32790798598,1247,1,190.35714285714286,39,3,20,34.57657885849375,0.6362179487179487,42.96874999999999,1028.124999999999,26.362179487179464,0
2777,4,0,1,40,0.0,0.024390243902439025,0.975609756097561,41,1650,1100,550,0.6666666666666666,22,11,11,331.7958289907808,0.43071646341463415,0.13189136568634163,0.19815069340287375,132068.34781804707,563.9453895463209,132632.29320759338,1248,2,195.34146341463415,38,3,20,34.502650452135946,0.6373355263157895,43.02884615384614,1027.8846153846132,27.049595141700348,0
2778,4,0,0,40,0.0,0.0,1.0,40,1050,600,450,0.5714285714285714,15,6,9,337.3490544656637,0.42859241452991453,0.13051050890856697,0.20127133593295124,132031.50398439894,908.1406057632905,132939.64459016224,1249,3,201.0,37,3,20,34.39700469433477,0.638795045045045,43.06469298245613,1027.7412280701744,27.776789947842552,0
2779,4,0,0,40,0.0,0.0,1.0,40,950,700,250,0.7368421052631579,12,7,5,336.402058833932,0.42845886752136747,0.1297898442500529,0.20085559869485844,132059.67821829786,885.0295283163861,132944.70774661424,1250,4,202.0,37,3,20,34.393001920204796,0.6390765765765766,43.037280701754376,1027.8508771929817,27.779753437648154,0
2780,4,0,1,39,0.0,0.025,0.975,40,950,500,450,0.5263157894736842,14,5,9,338.6924375795282,0.42792467948717944,0.1250426348326581,0.20343229509418284,132285.18029586028,960.7980340104616,133245.97832987073,1251,5,203.0,37,3,20,34.10742201378525,0.6413288288288288,42.81798245614035,1028.7280701754387,27.80346135609294,0
2781,4,0,0,39,0.0,0.0,1.0,39,700,500,200,0.7142857142857143,9,5,4,346.72566028707473,0.4273785425101215,0.12504352123274587,0.20776238384131027,132195.261139518,1367.0978410843381,133562.35898060235,1252,6,206.02564102564102,36,3,20,33.99127609870053,0.6423611111111112,42.90540540540541,1028.3783783783792,28.56606606606609,0
2782,4,0,0,39,0.0,0.0,1.0,39,850,600,250,0.7058823529411765,11,6,5,347.4596373979196,0.42757534862798025,0.1250192974330906,0.20868137985733035,132282.13168827607,1392.5403021264462,133674.6719904025,1253,7,207.02564102564102,36,3,21,33.885011859149785,0.6432291666666667,42.820945945945944,1028.7162162162158,28.57545045045044,0
2783,4,0,1,38,0.0,0.02564102564102564,0.9743589743589743,39,1450,1100,350,0.7586206896551724,18,11,7,344.8876502584358,0.4262539361223572,0.12218397858356234,0.20845096345808614,132520.55165816328,1341.041787271277,133861.59344543456,1254,8,208.02564102564102,34,5,21,33.71150807415117,0.6498161764705883,42.589285714285715,1029.6428571428573,30.28361344537816,0
2784,4,0,0,38,0.0,0.0,1.0,38,1200,800,400,0.6666666666666666,16,8,8,344.9219486834288,0.42718705547652913,0.12495361047399478,0.2088117409419413,132581.8470096371,1546.0778061224485,134127.92481575956,1255,9,211.07894736842104,34,4,22,33.64904827958234,0.6504289215686274,42.529761904761905,1029.8809523809518,30.290616246498583,0
2785,4,0,0,38,0.0,0.0,1.0,38,1250,800,450,0.64,17,8,9,346.90470848290215,0.426683262209578,0.053703393405019284,0.20426341238337142,131530.20154867705,1525.6892449882394,133055.89079366528,1256,10,212.07894736842104,36,2,21,34.65665825008236,0.6357060185185186,43.55292792792793,1025.7882882882884,28.494119119119123,8
2786,4,0,0,38,0.0,0.0,1.0,38,1200,1000,200,0.8333333333333334,14,10,4,344.52611061342844,0.42631282598387865,0.05361329591259234,0.20363235876334548,131674.6370525931,1473.0701140329502,133147.70716662606,1257,11,213.07894736842104,36,2,17,34.572041182064225,0.6371527777777778,43.41216216216216,1026.3513513513512,28.509759759759756,0
2787,4,0,0,38,0.0,0.0,1.0,38,1300,900,400,0.6923076923076923,17,9,8,345.2166340386977,0.4262683736367947,0.05672655704399765,0.20481655730636855,131819.15181651255,1501.2327783865114,133320.38459489905,1258,12,214.07894736842104,36,2,17,34.4086979566473,0.638599537037037,43.271396396396405,1026.9144144144152,28.52540040040042,0
2788,4,0,0,38,0.0,0.0,1.0,38,1000,500,500,0.5,15,5,10,348.2844864380962,0.42589793741109533,0.056970424306765244,0.20710893645947293,131905.89871966562,1588.1556387468577,133494.05435841248,1259,13,215.07894736842104,36,2,17,34.2425363589856,0.6394675925925926,43.18693693693694,1027.2522522522524,28.53478478478479,0
2789,4,0,1,37,0.0,0.02631578947368421,0.9736842105263158,38,1450,1200,250,0.8275862068965517,17,12,5,346.60353941719734,0.4245050972024656,0.0514841551732097,0.2070547845418963,132079.4781267754,1555.8429206233272,133635.32104739873,1260,14,216.07894736842104,36,2,18,34.1109315658779,0.6412037037037037,43.01801801801802,1027.9279279279276,28.553553553553545,0
2790,4,0,0,37,0.0,0.0,1.0,37,1100,700,400,0.6363636363636364,15,7,8,355.4127967607354,0.42336086086086083,0.057755886095602005,0.21176877917059136,131981.4238790296,1981.5773962620124,133963.0012752916,1261,15,222.45945945945945,35,2,18,33.983348351730875,0.6422619047619047,43.11342592592593,1027.5462962962972,29.358465608465636,0
2791,4,0,0,37,0.0,0.0,1.0,37,1150,800,350,0.6956521739130435,15,8,7,358.4526644990178,0.4222034534534535,0.056074083989437584,0.21458850885507247,132159.87761488341,2074.6120541838163,134234.48966906723,1262,16,223.45945945945945,35,2,18,33.72542398319075,0.644047619047619,42.93981481481482,1028.2407407407409,29.378306878306883,0
2792,4,0,0,37,0.0,0.0,1.0,37,350,300,50,0.8571428571428571,4,3,1,358.4526644990178,0.4222034534534535,0.056074083989437584,0.21458850885507247,132159.87761488341,2074.6120541838163,134234.48966906723,1263,17,224.45945945945945,35,2,18,33.72542398319075,0.644047619047619,42.93981481481482,1028.2407407407409,29.378306878306883,0
2793,4,0,0,37,0.0,0.0,1.0,37,1350,900,450,0.6666666666666666,18,9,9,355.5140814856298,0.4215152652652652,0.05564614214564978,0.2131917338285133,132224.21481870385,2001.5140562860204,134225.72887498987,1264,18,225.45945945945945,36,1,18,33.736176502792084,0.642650462962963,42.877252252252255,1028.4909909909911,28.569194194194196,0
2794,4,0,0,37,0.0,0.0,1.0,37,850,600,250,0.7058823529411765,11,6,5,367.6792018889146,0.4211086086086086,0.0767848773629114,0.20518871589284593,129450.69204152253,2162.8933029459345,131613.58534446848,1265,19,226.45945945945945,33,4,19,36.234043834296706,0.6212121212121212,45.588235294117645,1017.6470588235297,30.837789661319082,8
2795,4,0,1,36,0.0,0.02702702702702703,0.972972972972973,37,1400,1200,200,0.8571428571428571,16,12,4,370.1425362857152,0.4203578578578579,0.07688554980973694,0.20754955982012777,129637.82709775085,2196.8948241061025,131834.72192185695,1266,20,227.45945945945945,33,4,20,35.980746089049326,0.6231060606060606,45.40441176470588,1018.3823529411764,30.860071301247768,0
2796,4,0,0,36,0.0,0.0,1.0,36,1150,700,450,0.6086956521739131,16,7,9,368.873092788376,0.41947751322751325,0.08835953373970717,0.20716710454439027,129700.23548635117,2368.585399846186,132068.82088619735,1267,21,232.52777777777777,33,3,21,35.94953079884505,0.6237373737373737,45.34313725490195,1018.6274509803902,30.86749851455728,0
2797,4,0,1,35,0.0,0.027777777777777776,0.9722222222222222,36,550,400,150,0.7272727272727273,7,4,3,368.72545698621207,0.41957671957671955,0.08594637582367626,0.20724913616811214,129731.44531249988,2367.057291666653,132098.50260416654,1268,22,233.52777777777777,33,3,22,35.921523517382404,0.6240530303030303,45.31249999999999,1018.7499999999991,30.871212121212093,0
2798,4,0,0,35,0.0,0.0,1.0,35,900,600,300,0.6666666666666666,12,6,6,372.08064825561667,0.4206932773109244,0.07898305684896378,0.20922081886930796,129747.52456700832,2655.3086100907885,132402.83317709912,1269,23,235.4,32,3,22,35.81970091295906,0.6266276041666667,45.29671717171716,1018.81313131313,31.837910353535314,0
2799,4,0,0,35,0.0,0.0,1.0,35,1300,1000,300,0.7692307692307693,16,10,6,370.7266510814572,0.42065826330532213,0.07141264532568914,0.20914578994972746,129876.19447314029,2629.7133264462545,132505.90779958654,1270,24,236.4,32,3,22,35.72324414715719,0.6279296875,45.17045454545453,1019.3181818181802,31.85369318181813,0
2800,4,0,0,35,0.0,0.0,1.0,35,1000,800,200,0.8,12,8,4,371.55784364271017,0.41964285714285715,0.07944406132300696,0.21065374166943537,130069.31889921938,2665.655130853985,132734.97403007335,1271,25,237.4,32,3,22,35.50563188513431,0.6298828125,44.9810606060606,1020.0757575757568,31.8773674242424,0
2801,4,1,0,36,0.027777777777777776,0.0,1.0,36,1350,1100,250,0.8148148148148148,16,11,5,359.9606645618759,0.42377645502645506,0.07921662669864138,0.20675426600868058,130575.52984429052,2200.410899653963,132775.9407439445,1272,0,231.77777777777777,33,3,15,35.28776978417266,0.6325757575757576,44.48529411764705,1022.0588235294106,30.97147950089123,0
2802,4,0,0,36,0.0,0.0,1.0,36,700,600,100,0.8571428571428571,8,6,2,361.9730634219072,0.42313161375661373,0.08060982593524835,0.20841554645472538,130669.48596993939,2259.7668264609724,132929.25279640037,1273,1,232.77777777777777,33,3,15,35.141111310879374,0.6335227272727273,44.393382352941174,1022.4264705882348,30.9826203208556,0
2803,4,1,0,37,0.02702702702702703,0.0,1.0,37,1300,1100,200,0.8461538461538461,15,11,4,353.0314070886724,0.4259884884884885,0.07944022179890964,0.20481538718950099,130962.30867346936,1846.7616213151869,132809.07029478456,1274,0,227.45945945945945,34,3,17,35.07332131503449,0.6341911764705883,44.107142857142854,1023.5714285714284,30.10504201680672,0
2804,4,0,0,37,0.0,0.0,1.0,37,1100,800,300,0.7272727272727273,14,8,6,352.2083947668262,0.42542542542542544,0.07820025069821646,0.2051488706959383,131114.67013888902,1835.93750000002,132950.60763888905,1275,1,228.45945945945945,34,3,18,34.94033089232438,0.6357230392156863,43.95833333333334,1024.1666666666679,30.122549019607877,0
2805,4,0,0,37,0.0,0.0,1.0,37,550,200,350,0.36363636363636365,9,2,7,353.3605742589384,0.4244557057057057,0.08072624733482203,0.20647484471464253,131236.6230867348,1874.769699546501,133111.3927862813,1276,2,229.45945945945945,34,3,20,34.78757600402774,0.6369485294117647,43.83928571428572,1024.642857142858,30.136554621848767,0
2806,4,0,0,37,0.0,0.0,1.0,37,800,400,400,0.5,12,4,8,354.91022864972234,0.42401776776776773,0.0841594552602083,0.20838834267454232,131422.3514543686,1928.6592486259324,133351.01070299454,1277,3,230.45945945945945,33,4,20,34.560251583602245,0.6410984848484849,43.65808823529412,1025.3676470588243,31.071746880570434,0
2807,4,0,0,37,0.0,0.0,1.0,37,1200,800,400,0.6666666666666666,16,8,8,357.19213983692265,0.4230480480480481,0.07939091197009729,0.21072135888120735,131602.8220663267,2001.4987244898189,133604.32079081654,1278,4,231.45945945945945,34,3,15,34.319526627218934,0.640625,43.48214285714287,1026.07142857143,30.178571428571473,0
2808,4,0,0,37,0.0,0.0,1.0,37,1500,1200,300,0.8,18,12,6,355.65153177107857,0.4223911411411411,0.08084341387610827,0.2105893916428218,131743.6731074247,1970.9678283607775,133714.64093578546,1279,5,232.45945945945945,35,2,17,34.21692972566703,0.6398809523809523,43.34490740740741,1026.6203703703713,29.33201058201061,0
2809,4,0,0,37,0.0,0.0,1.0,37,1300,1000,300,0.7692307692307693,16,10,6,357.58221593176665,0.4214527027027027,0.08497341154541949,0.21239521982453144,131862.521701389,2030.338541666677,133892.86024305568,1280,6,233.45945945945945,35,2,17,34.0474983096687,0.6410714285714285,43.22916666666667,1027.0833333333342,29.34523809523812,0
2810,4,0,0,37,0.0,0.0,1.0,37,1200,700,500,0.5833333333333334,17,7,10,361.1670700257886,0.42132757757757755,0.08699200609059798,0.2146924143656312,131892.24222232937,2127.0269365140593,134019.26915884344,1281,7,234.45945945945945,35,2,17,33.925469483568094,0.6413690476190477,43.20023148148148,1027.199074074074,29.348544973544968,0
2811,4,0,2,35,0.0,0.05405405405405406,0.9459459459459459,37,1250,1000,250,0.8,15,10,5,362.2499970879103,0.4211086086086086,0.0411770131906648,0.20178564476569888,129377.95380015418,1999.9599462019733,131377.91374635615,1282,8,235.45945945945945,35,2,18,36.44624573378838,0.6160714285714286,45.659722222222214,1017.3611111111101,29.067460317460288,8
2812,4,1,1,35,0.027777777777777776,0.027777777777777776,0.9722222222222222,36,600,400,200,0.6666666666666666,8,4,4,361.54997618217317,0.41731150793650795,0.0714114008757909,0.20219842029651802,129534.44054705203,2166.6347789115475,131701.07532596358,1283,0,242.47222222222223,34,2,13,36.30472069543522,0.6197916666666667,45.50595238095237,1017.9761904761895,29.94047619047616,0
2813,4,0,0,35,0.0,0.0,1.0,35,1000,700,300,0.7,13,7,6,368.0707905645635,0.4134803921568628,0.07509850140224716,0.20524457851293273,129419.51600646373,2527.1087141964454,131946.62472066018,1284,38,250.4,33,2,19,36.25584628046087,0.6208964646464646,45.6188725490196,1017.5245098039205,30.83407605466426,0
2814,4,0,0,35,0.0,0.0,1.0,35,1200,1000,200,0.8333333333333334,14,10,4,366.4446389485683,0.41320028011204485,0.07385165695024853,0.20498691015122925,129544.24267409154,2494.158646914627,132038.40132100615,1285,39,251.4,33,2,13,36.170172745876954,0.6221590909090908,45.496323529411754,1018.0147058823517,30.848930481283386,0
2815,4,0,0,35,0.0,0.0,1.0,35,1250,800,450,0.64,17,8,9,364.52278371611146,0.4127450980392157,0.06575003437371119,0.20472387690866978,129700.23548635119,2455.7381776239617,132155.97366397514,1286,40,252.4,33,2,15,36.06031440487649,0.6237373737373737,45.34313725490195,1018.6274509803903,30.867498514557283,0
2816,4,0,0,35,0.0,0.0,1.0,35,1000,600,400,0.6,14,6,8,361.15329339911864,0.41190476190476194,0.06155325799471045,0.20380414480962472,129887.55076172622,2381.8633458285226,132269.41410755474,1287,41,253.4,33,2,15,35.95565841147711,0.6256313131313131,45.15931372549019,1019.3627450980389,30.889780154486026,0
2817,4,0,0,35,0.0,0.0,1.0,35,950,700,250,0.7368421052631579,12,7,5,358.83469269887786,0.41137955182072833,0.05408690576338704,0.20298188157357996,129981.25908604857,2328.3570321510874,132309.61611819966,1288,42,254.4,33,2,15,35.919535913151456,0.6265782828282829,45.06740196078431,1019.7303921568622,30.90092097445037,0
2818,4,2,1,36,0.05405405405405406,0.02702702702702703,0.972972972972973,37,1250,800,450,0.64,17,8,9,341.9122476811631,0.4160097597597598,0.06659772745351211,0.1969004430257753,130676.44702717758,1535.9755444101409,132212.42257158773,1289,0,241.59459459459458,35,2,12,35.64683797449248,0.6291666666666667,44.38657407407407,1022.4537037037032,29.21296296296295,0
2819,4,0,1,35,0.0,0.027777777777777776,0.9722222222222222,36,950,800,150,0.8421052631578947,11,8,3,353.0202553477243,0.41345899470899466,0.06693066231850309,0.20288031542272825,130597.00255102043,2020.677437641726,132617.67998866216,1290,1,249.30555555555554,34,2,13,35.44335740352511,0.6305147058823529,44.464285714285715,1022.1428571428573,30.06302521008404,0
2820,4,0,0,35,0.0,0.0,1.0,35,1250,900,350,0.72,16,9,7,351.24530978812123,0.4128151260504202,0.0424729304924909,0.20233708690611477,130688.28124999997,2180.7291666666674,132869.01041666663,1291,2,245.2,34,1,13,35.396291768541154,0.6314338235294117,44.375,1022.4999999999998,30.0735294117647,0
2821,4,1,0,36,0.027777777777777776,0.0,1.0,36,1000,600,400,0.6,14,6,8,341.02844010341846,0.41603835978835974,0.04992467043314486,0.1988209285187914,131150.23389274688,1745.1919367283872,132895.42582947528,1292,0,239.36111111111111,35,1,16,35.1906779661017,0.6339285714285714,43.92361111111111,1024.3055555555552,29.265873015873005,0
2822,4,0,1,35,0.0,0.027777777777777776,0.9722222222222222,36,1000,800,200,0.8,12,8,4,352.1245060500921,0.41544312169312164,0.023486662218558774,0.1884431902888111,127783.17920918364,1917.9931579113056,129701.17236709494,1293,1,240.36111111111111,34,2,18,38.331567172965954,0.6020220588235294,47.232142857142854,1011.0714285714283,29.737394957983184,8
2823,4,0,0,35,0.0,0.0,1.0,35,900,600,300,0.6666666666666666,12,6,6,362.823753646653,0.41414565826330535,0.03351808230566711,0.19381932124854873,127710.61610918868,2267.289023452505,129977.90513264119,1294,2,246.71428571428572,33,2,18,38.13550759780148,0.6035353535353536,47.303921568627445,1010.7843137254895,30.629827688651197,0
2824,4,2,0,37,0.05405405405405406,0.0,1.0,37,950,600,350,0.631578947368421,13,6,7,347.57385374222247,0.41841841841841837,0.056174069795488446,0.18925440783048356,128476.21882086148,1531.730792807297,130007.94961366878,1295,0,234.32432432432432,34,3,16,37.73827696884297,0.6090686274509804,46.54761904761904,1013.8095238095223,29.817927170868302,0
2825,4,1,0,38,0.02631578947368421,0.0,1.0,38,1400,1100,300,0.7857142857142857,17,11,6,341.86578878713567,0.42173423423423423,0.0577003827096807,0.1881763131002714,128907.381955161,1213.8047625171287,130121.18671767814,1296,0,229.1315789473684,35,3,18,37.44348833675254,0.6113095238095239,46.122685185185176,1015.5092592592578,29.014550264550223,0
2826,4,0,0,38,0.0,0.0,1.0,38,1150,900,250,0.782608695652174,14,9,5,343.7236399172031,0.42068219535324797,0.06282636195226621,0.18990244397942857,129054.34355977773,1271.8057430983938,130326.14930287612,1297,1,230.1315789473684,35,3,19,37.246672931617084,0.612797619047619,45.978009259259245,1016.0879629629611,29.0310846560846,0
2827,4,0,0,38,0.0,0.0,1.0,38,1300,900,400,0.6923076923076923,17,9,8,343.79326392157975,0.42056365576102417,0.06871594771006784,0.19022360746662786,129113.15164448271,1277.6463638116927,130390.79800829441,1298,2,231.1315789473684,35,3,20,37.18504441407586,0.6133928571428571,45.92013888888887,1016.3194444444418,29.037698412698337,0
2828,4,0,0,38,0.0,0.0,1.0,38,750,300,450,0.4,12,3,9,345.3677577019116,0.41992650545282123,0.061822125813449036,0.19182474253082046,129263.69214965375,1328.7625836350069,130592.45473328876,1299,3,232.1315789473684,33,5,21,36.991845424600314,0.6193181818181819,45.7720588235294,1016.9117647058805,30.81550802139032,0
2829,4,0,0,38,0.0,0.0,1.0,38,1200,1000,200,0.8333333333333334,14,10,4,342.28762783575803,0.41991168800379325,0.06229950931291173,0.19071623397935963,129388.3437259706,1257.605848712017,130645.94957468261,1300,4,233.1315789473684,33,5,22,36.94340721111381,0.6205808080808081,45.64950980392156,1017.4019607843122,30.83036244800946,0
2830,4,0,0,38,0.0,0.0,1.0,38,1100,700,400,0.6363636363636364,15,7,8,343.32673262677986,0.4201932195353248,0.06348799047094045,0.1920548934633441,129544.24267409166,1295.2003135813065,130839.44298767296,1301,5,234.1315789473684,33,5,17,36.758531960996734,0.6221590909090908,45.49632352941176,1018.0147058823527,30.848930481283414,0
2831,4,1,1,38,0.02564102564102564,0.02564102564102564,0.9743589743589743,39,850,500,350,0.5882352941176471,12,5,7,342.26290465861086,0.42276765632028795,0.09251016739103912,0.19412517642606134,130085.41907793198,1104.6826774691226,131190.1017554011,1302,0,229.10256410256412,35,4,18,36.23638529611981,0.6232142857142857,44.96527777777777,1020.1388888888879,29.146825396825367,0
2832,4,0,0,38,0.0,0.0,1.0,38,1350,1000,350,0.7407407407407407,17,10,7,359.00630964985464,0.4227566382171645,0.00986205843428678,0.19537501272523677,128454.92118415998,1664.096391211717,130119.01757537169,1303,1,233.97368421052633,33,5,16,37.47028127014829,0.6111111111111112,46.568627450980394,1013.7254901960787,30.71895424836602,8
2833,4,1,0,39,0.02564102564102564,0.0,1.0,39,1000,700,300,0.7,13,7,6,349.78707358948947,0.42462325686009894,0.015424890820506798,0.19264257745590282,128929.2109552154,1219.5542800453477,130148.76523526074,1304,0,228.94871794871796,34,5,18,37.22013831907161,0.6136642156862745,46.101190476190474,1015.595238095238,29.870448179271705,0
2834,4,2,0,41,0.04878048780487805,0.0,1.0,41,1100,800,300,0.7272727272727273,14,8,6,333.19726820585845,0.43089430894308944,0.03950361441881922,0.18625665475032502,129516.42679419293,430.9039191218333,129947.33071331476,1305,0,218.73170731707316,36,5,16,37.044566139322185,0.6154513888888888,45.52364864864865,1017.9054054054061,28.275150150150168,0
2835,4,0,1,40,0.0,0.024390243902439025,0.975609756097561,41,1450,900,550,0.6206896551724138,20,9,11,334.3015124184159,0.4305132113821138,0.042976240887036,0.18742024654679068,129631.0811444891,467.1732966074213,130098.25444109652,1306,1,219.73170731707316,36,5,17,36.900088466216964,0.6166087962962963,45.41103603603604,1018.3558558558559,28.287662662662665,0
2836,4,1,0,41,0.024390243902439025,0.0,1.0,41,1200,900,300,0.75,15,9,6,330.35572784713577,0.4316056910569106,0.03962269235952065,0.18615936095993607,129831.84831791231,378.13894976055457,130209.98726767287,1307,0,220.3658536585366,36,5,18,36.79696132596685,0.6186342592592593,45.213963963963955,1019.1441441441426,28.309559559559517,0
2837,4,0,1,40,0.0,0.024390243902439025,0.975609756097561,41,1300,900,400,0.6923076923076923,17,9,8,333.38954565076943,0.43147865853658535,0.04209431756345383,0.18842128254195176,129946.64216581453,464.5703981008106,130411.21256391534,1308,1,221.3658536585366,36,5,18,36.60329688535453,0.6197916666666667,45.101351351351354,1019.5945945945952,28.32207207207209,0
2838,4,0,0,40,0.0,0.0,1.0,40,1650,1300,350,0.7878787878787878,20,13,7,341.34103620254047,0.429286858974359,0.04243473325766178,0.1930176205997679,129967.37423911192,872.6396390603718,130840.01387817229,1309,2,227.575,35,5,18,36.379587589860016,0.6220238095238095,45.081018518518526,1019.6759259259269,29.13359788359791,0
2839,4,0,1,39,0.0,0.025,0.975,40,1200,800,400,0.6666666666666666,16,8,8,362.74990955368764,0.42893963675213675,-0.0218283801245156,0.19707019655587366,128385.71605725607,1321.4678187375573,129707.18387599362,1310,3,228.575,34,6,15,37.446160773718624,0.6081495098039216,46.63690476190475,1013.4523809523796,29.807422969187634,8
2840,4,2,1,40,0.04878048780487805,0.024390243902439025,0.975609756097561,41,1350,1100,250,0.8148148148148148,16,11,5,352.1288273562855,0.42870934959349594,0.010472019031949165,0.19411322794464556,128966.1565500684,882.540294924529,129848.69684499293,1311,0,223.82926829268294,35,6,17,37.12302491643875,0.611904761904762,46.0648148148148,1015.7407407407392,29.021164021163976,0
2841,4,1,0,41,0.024390243902439025,0.0,1.0,41,1300,1100,200,0.8461538461538461,15,11,4,343.151767831099,0.43084349593495935,0.01746095184601093,0.1908464758036014,129315.90374157943,674.9961955198437,129990.89993709927,1312,0,223.17073170731706,36,5,19,36.99508229997046,0.6134259259259259,45.72072072072072,1017.1171171171172,28.253253253253256,0
2842,4,1,2,40,0.023809523809523808,0.047619047619047616,0.9523809523809523,42,1000,600,400,0.6,14,6,8,337.38809618664607,0.4341003677893922,0.012786596119929161,0.18923071481772727,129647.68005540136,348.3167897814356,129995.9968451828,1313,0,218.83333333333334,37,5,14,36.80465834051103,0.6148648648648649,45.394736842105246,1018.4210526315766,27.524893314366935,0
2843,4,1,0,41,0.024390243902439025,0.0,1.0,41,1250,900,350,0.72,16,9,7,348.01180226726746,0.4309451219512195,0.025511634426689467,0.19582156635038772,129774.47041636224,832.6094675756757,130607.07988393791,1314,0,224.53658536585365,36,5,18,36.40537503684055,0.6180555555555556,45.27027027027027,1018.9189189189183,28.303303303303284,0
2844,4,0,0,41,0.0,0.0,1.0,41,550,400,150,0.7272727272727273,7,4,3,343.854538974972,0.43056402439024394,0.07826676413903089,0.17834174081941023,126512.22160905278,501.27657285359254,127013.49818190637,1315,1,225.53658536585365,37,4,16,39.84411898274295,0.5830518018018018,48.49232456140351,1006.0307017543859,27.190018966334755,8
2845,4,0,0,41,0.0,0.0,1.0,41,1200,900,300,0.75,15,9,6,391.51958208663495,0.43145325203252033,0.11321776026494357,0.193132761475461,124435.16333616764,1751.9587046210295,126187.12204078867,1316,2,226.53658536585365,34,7,14,40.79962613848787,0.5677083333333333,50.56547619047618,997.7380952380938,29.345238095238052,8
2846,4,3,2,42,0.06818181818181818,0.045454545454545456,0.9545454545454546,44,1000,500,500,0.5,15,5,10,373.279697045818,0.441166754756871,0.148793585698217,0.18824756891879935,125356.61363352185,558.6157519621393,125915.22938548398,1317,0,212.02272727272728,37,7,16,40.29834574254534,0.5712274774774775,49.64364035087719,1001.4254385964912,27.06555239449976,0
2847,4,1,1,42,0.023255813953488372,0.023255813953488372,0.9767441860465116,43,1300,800,500,0.6153846153846154,18,8,10,372.5652513033422,0.43980712440014763,0.17171254755946186,0.18926314766209765,125658.76038781146,763.217528470275,126421.97791628173,1318,0,217.65116279069767,37,6,17,40.003463108778064,0.5743243243243243,49.34210526315788,1002.631578947367,27.09815078236127,0
2848,4,2,1,43,0.045454545454545456,0.022727272727272728,0.9772727272727273,44,1850,1400,450,0.7567567567567568,23,14,9,367.27638506382976,0.4454281183932347,0.2011229946524069,0.18936694030587387,126270.10192202318,476.38356226535836,126746.48548428854,1319,0,213.3409090909091,36,8,16,39.504668534080295,0.5824652777777778,48.7331081081081,1005.067567567566,27.9185435435435,0
2849,4,0,0,43,0.0,0.0,1.0,43,1050,600,450,0.5714285714285714,15,6,9,373.5708728429775,0.44153746770025837,0.20303091912857152,0.19221449408910282,126185.22872534691,827.825206963714,127013.05393231062,1320,1,219.30232558139534,36,7,19,39.43412351490698,0.5815972222222222,48.817567567567565,1004.7297297297292,27.909159159159145,0
2850,4,0,0,43,0.0,0.0,1.0,43,1250,900,350,0.72,16,9,7,375.6749034088717,0.4415143964562569,0.2080051262815703,0.19409870009458385,126355.00365230103,893.6807584611727,127248.6844107622,1321,2,220.30232558139534,36,7,16,39.20600918458781,0.5833333333333333,48.64864864864865,1005.4054054054061,27.927927927927946,0
2851,4,3,0,46,0.06521739130434782,0.0,1.0,46,800,700,100,0.875,9,7,2,355.42388082812147,0.44713164251207727,0.21970694061998852,0.18686299524907038,127065.75656467004,-167.55913628473218,126898.1974283853,1322,0,206.8695652173913,39,7,19,38.9839902538141,0.5852029914529915,47.94270833333333,1008.2291666666658,25.852029914529894,0
2852,4,0,1,45,0.0,0.021739130434782608,0.9782608695652174,46,1350,900,450,0.6666666666666666,18,9,9,352.07894714590276,0.44665861513687605,0.21082845884165025,0.18598337954285887,127257.91229032032,-239.0282196204393,127018.88407069989,1323,1,207.8695652173913,37,9,21,38.871078750996155,0.5906531531531531,47.75219298245615,1008.9912280701773,27.270033191085872,0
2853,4,2,2,45,0.0425531914893617,0.0425531914893617,0.9574468085106383,47,1050,800,250,0.7619047619047619,13,8,5,326.5160935016354,0.45021970397779837,0.18487301480624874,0.17003654307648972,126677.74128818477,-1089.39902181441,125588.34226637037,1324,0,202.19148936170214,37,10,17,40.110350179718985,0.584740990990991,48.32785087719298,1006.6885964912276,27.207799905168315,8
2854,4,1,0,46,0.021739130434782608,0.0,1.0,46,1350,1000,350,0.7407407407407407,17,10,7,324.36766327065766,0.4481481481481482,0.1503247830828316,0.16766919234452837,126374.37120075419,-984.7618978916429,125389.60930286255,1325,0,207.47826086956522,37,9,16,40.475736095965125,0.5816441441441442,48.62938596491229,1005.4824561403517,27.175201517306803,8
2855,4,4,2,48,0.08,0.04,0.96,50,1400,800,600,0.5714285714285714,20,8,12,307.76266098346923,0.45392857142857146,0.18879806724380876,0.16314377130254998,127399.61848932524,-2156.1990058969222,125243.41948342831,1326,0,191.8,40,10,15,39.84422186430441,0.5869791666666666,47.611788617886184,1009.5528455284561,25.238821138211403,0
2856,4,2,1,49,0.04,0.02,0.98,50,2300,1900,400,0.8260869565217391,27,19,8,307.2167680220196,0.45232142857142854,0.20516135518246692,0.16420661964078634,127733.27637525639,-2151.6391326260564,125581.63724263033,1327,0,192.68,40,10,17,39.517568110988265,0.5903645833333333,47.281504065040664,1010.8739837398396,25.27184959349599,0
2857,4,2,1,50,0.0392156862745098,0.0196078431372549,0.9803921568627451,51,1200,900,300,0.75,15,9,6,316.94825192225215,0.4498202614379085,0.16649864571060768,0.16739153588434763,127249.61480034729,-2083.1443401848164,125166.47046016247,1328,0,189.66666666666666,39,12,16,39.76572716635693,0.5870726495726496,47.76041666666667,1008.9583333333339,25.87072649572651,7
2858,4,2,2,50,0.038461538461538464,0.038461538461538464,0.9615384615384616,52,1650,1300,350,0.7878787878787878,20,13,7,311.1690535793674,0.45127890899949724,0.20294335889191184,0.16685099252272975,127861.72251966428,-2442.6777629056755,125419.04475675861,1329,0,186.94230769230768,40,12,16,39.28670116559484,0.5916666666666667,47.15447154471545,1011.3821138211387,25.284552845528466,0
2859,4,0,2,48,0.0,0.04,0.96,50,1500,1000,500,0.6666666666666666,20,10,10,319.1794469266998,0.4502210884353741,0.19560439560439602,0.17085488041370397,127793.20987654317,-1842.206790123458,125951.00308641972,1330,1,195.08,38,12,16,39.1540750915751,0.5942982456140351,47.22222222222222,1011.1111111111109,26.608187134502916,0
2860,4,2,2,48,0.04,0.04,0.96,50,1400,800,600,0.5714285714285714,20,8,12,314.76877657803675,0.45125,0.20281303258145367,0.17129397416071543,128453.40617563936,-1913.3756981624838,126540.03047747687,1331,0,184.9,40,10,13,38.59294068504593,0.59765625,46.570121951219505,1013.7195121951208,25.34298780487802,0
2861,4,0,0,48,0.0,0.0,1.0,48,1500,1200,300,0.8,18,12,6,325.35050472680655,0.4494219119385343,0.20167457805907185,0.17604582105080635,128225.67389875083,-1256.3424556212976,126969.33144312953,1332,1,193.47916666666666,38,10,18,38.556830168776386,0.5986842105263157,46.794871794871796,1012.8205128205129,26.653171390013497,0
2862,4,1,1,48,0.02040816326530612,0.02040816326530612,0.9795918367346939,49,1450,1300,150,0.896551724137931,16,13,3,321.927623472081,0.4496173469387755,0.21601049538731054,0.17592206494787455,128619.58007812497,-1518.760850694446,127100.81922743052,1333,0,190.51020408163265,39,10,14,38.242366673512706,0.6009615384615384,46.40625,1014.3749999999998,26.00961538461538,0
2863,4,0,0,48,0.0,0.0,1.0,48,1500,900,600,0.6,21,9,12,327.79608812617437,0.44765809692671393,0.21983621234463913,0.1790619137324451,128604.67916757964,-1168.777850829151,127435.90131675049,1334,1,195.29166666666666,38,10,14,38.10871778667229,0.6025219298245614,46.42094017094016,1014.3162393162379,26.692532613585207,0
2864,4,0,2,46,0.0,0.041666666666666664,0.9583333333333334,48,1100,600,500,0.5454545454545454,16,6,10,329.34969515010397,0.4478797281323877,0.22312401263823078,0.18003312351469392,128631.7723742602,-1127.032996383977,127504.73937787622,1335,2,196.29166666666666,38,10,14,38.0417324907846,0.602796052631579,46.39423076923076,1014.4230769230757,26.695344129554623,0
2865,4,0,1,45,0.0,0.021739130434782608,0.9782608695652174,46,1300,900,400,0.6923076923076923,17,9,8,336.1042517921706,0.4450684380032206,0.23122836827395044,0.18358344426270973,128601.01814229782,-555.3302035143186,128045.6879387835,1336,3,205.06521739130434,36,10,14,37.90177084489841,0.6061921296296297,46.42454954954955,1014.3018018018028,28.175050050050075,0
2866,4,2,1,46,0.0425531914893617,0.02127659574468085,0.9787234042553191,47,1600,1300,300,0.8125,19,13,6,321.832785744629,0.44752158495220473,0.2318160886651497,0.17871671264395436,129255.70371283508,-1080.255360143184,128175.44835269189,1337,0,193.04255319148936,38,9,16,37.598278700007015,0.6091008771929824,45.77991452991453,1016.8803418803415,26.76000899685109,0
2867,4,0,1,45,0.0,0.021739130434782608,0.9782608695652174,46,1400,1200,200,0.8571428571428571,16,12,4,330.17113247744913,0.44505837359098227,0.2363969260921135,0.1832242316854212,129229.25954380205,-666.4458054401282,128562.81373836192,1338,1,197.84782608695653,37,9,17,37.413166361120076,0.6106418918918919,45.80592105263158,1016.7763157894746,27.480440967283094,0
2868,4,1,1,45,0.021739130434782608,0.021739130434782608,0.9782608695652174,46,1150,900,250,0.782608695652174,14,9,5,327.10525089286546,0.4476449275362319,0.23217616240381633,0.18216581739399787,129368.65790435509,-736.5665397045354,128632.09136465055,1339,0,198.2391304347826,37,9,19,37.349554501688594,0.6120495495495495,45.6688596491228,1017.3245614035079,27.495258416311025,0
2869,4,0,1,44,0.0,0.022222222222222223,0.9777777777777777,45,1400,1000,400,0.7142857142857143,18,10,8,328.3741967799623,0.44753787878787876,0.205279153803815,0.1839133167248933,129591.85157933214,-489.0759656817433,129102.7756136504,1340,1,188.0,37,8,15,37.09078182209778,0.6143018018018018,45.449561403508774,1018.2017543859652,27.518966334755817,0
2870,4,1,2,43,0.022222222222222223,0.044444444444444446,0.9555555555555556,45,1450,1200,250,0.8275862068965517,17,12,5,326.2862045743948,0.44617003367003366,0.1978415976479866,0.18418232203571033,129899.05698147506,-523.1459439442906,129375.91103753078,1341,0,188.95555555555555,37,8,17,36.832557993618,0.6173986486486487,45.14802631578947,1019.4078947368421,27.551564722617353,0
2871,4,1,0,44,0.022727272727272728,0.0,1.0,44,800,500,300,0.625,11,5,6,333.698727145081,0.4446132840028189,0.1991863385233552,0.18804318061413358,129831.8483179126,-135.05549468386053,129696.79282322874,1342,0,193.45454545454547,36,8,18,36.71178637200737,0.6186342592592593,45.21396396396397,1019.144144144145,28.309559559559585,0
2872,4,0,0,44,0.0,0.0,1.0,44,1450,1100,350,0.7586206896551724,18,11,7,334.73350579083666,0.44437103594080335,0.19725003263609242,0.18904194809260425,129917.93894823888,-102.42256614721711,129815.51638209166,1343,1,194.45454545454547,36,8,18,36.59813505651902,0.6195023148148149,45.12950450450451,1019.4819819819827,28.318943943943964,0
2873,4,1,2,43,0.022222222222222223,0.044444444444444446,0.9555555555555556,45,1550,1100,450,0.7096774193548387,20,11,9,329.41149074019387,0.4458333333333333,0.20596077869684093,0.1875530010581322,130234.60493853857,-419.8449282471745,129814.7600102914,1344,0,191.11111111111111,37,8,20,36.41312618612814,0.620777027027027,44.81907894736841,1020.7236842105247,27.58712660028445,0
2874,4,0,0,43,0.0,0.0,1.0,43,1050,600,450,0.5714285714285714,15,6,9,340.9969945875689,0.4446520856404577,0.20549393583222564,0.193859144601791,130176.38204082457,277.95100844086693,130454.33304926543,1345,1,195.53488372093022,36,7,20,36.17647870227323,0.6221064814814814,44.876126126126124,1020.4954954954951,28.347097097097087,0
2875,4,5,2,46,0.10416666666666667,0.041666666666666664,0.9583333333333334,48,1250,700,550,0.56,18,7,11,310.8181898141355,0.44879395685579193,0.22427839851024256,0.18268687037135295,131461.6224500867,-1422.7661221980059,130038.85632788869,1346,0,176.0625,39,9,21,35.651028440832924,0.6295405982905983,43.619791666666664,1025.5208333333326,26.295405982905965,0
2876,4,1,1,46,0.02127659574468085,0.02127659574468085,0.9787234042553191,47,700,500,200,0.7142857142857143,9,5,4,319.23103120116906,0.4474059512796793,0.22932870965739238,0.18724578089281285,131382.88498064148,-1011.701229089046,130371.18375155244,1347,0,180.7872340425532,38,9,22,35.51458072808113,0.6304824561403508,43.6965811965812,1025.2136752136757,26.97930724246515,0
2877,4,0,1,45,0.0,0.021739130434782608,0.9782608695652174,46,1100,800,300,0.7272727272727273,14,8,6,326.525216471677,0.44565217391304346,0.2306468716861083,0.19125048393341068,131328.12499999985,-623.611111111128,130704.51388888873,1348,1,185.58695652173913,37,9,22,35.38279132791328,0.6317567567567568,43.74999999999999,1024.9999999999989,27.702702702702673,0
2878,4,1,1,45,0.021739130434782608,0.021739130434782608,0.9782608695652174,46,1250,900,350,0.72,16,9,7,325.0314376920451,0.44556159420289854,0.22953937430614957,0.18532222067930673,130289.8540799181,-695.618060121274,129594.23601979684,1349,0,181.45652173913044,38,8,19,36.469015976001096,0.6195175438596492,44.76495726495726,1020.9401709401703,26.866846603688693,7
2879,4,0,2,43,0.0,0.044444444444444446,0.9555555555555556,45,1250,1000,250,0.8,15,10,5,334.9002432659036,0.44396043771043775,0.23963344788087038,0.19109013880466277,130318.55955678683,-271.25654047397836,130047.30301631286,1350,1,186.44444444444446,37,8,20,36.18807273768615,0.6216216216216216,44.736842105263165,1021.0526315789484,27.596017069701308,0
2880,4,0,1,42,0.0,0.023255813953488372,0.9767441860465116,43,1050,800,250,0.7619047619047619,13,8,5,352.9839050781538,0.4396917681801403,0.24623115577889343,0.20069656317300794,130180.8021038793,590.3455785667558,130771.14768244606,1351,2,195.37209302325581,38,5,20,35.866179857621454,0.618421052631579,44.87179487179488,1020.5128205128227,26.855600539811125,0
2881,4,0,1,41,0.0,0.023809523809523808,0.9761904761904762,42,1250,800,450,0.64,17,8,9,362.4516591076261,0.43766937669376693,0.2463421122638998,0.20621638404485257,130206.62607725472,1038.7215297014677,131245.3476069562,1352,3,200.9047619047619,37,5,20,35.59840996991836,0.6204954954954955,44.846491228070185,1020.6140350877208,27.58416311047894,0
2882,4,1,0,42,0.023809523809523808,0.0,1.0,42,800,500,300,0.625,11,5,6,360.57574357160365,0.43757259001161436,0.2459814011694399,0.2066988743019554,130498.99798525359,1010.9786926366523,131509.97667789026,1353,0,200.95238095238096,35,7,19,35.34964506872075,0.6273809523809524,44.560185185185176,1021.7592592592578,29.19312169312165,0
2883,4,0,0,42,0.0,0.0,1.0,42,1400,1100,300,0.7857142857142857,17,11,6,356.76441739750544,0.43712495160665893,0.2435117632150816,0.20498286077016065,130587.70743580667,917.8094725222841,131505.51690832895,1354,1,201.95238095238096,35,7,19,35.357099045030765,0.6282738095238095,44.473379629629626,1022.1064814814808,29.20304232804231,0
2884,4,1,2,41,0.023255813953488372,0.046511627906976744,0.9534883720930233,43,900,700,200,0.7777777777777778,11,7,4,354.5640657307519,0.43738464377999264,0.18095792620572637,0.19527728904035488,128929.9859832711,542.7880049674827,129472.77398823858,1355,0,198.2325581395349,38,5,19,37.098060873834086,0.6058114035087719,46.100427350427346,1015.5982905982894,26.726270805218142,8
2885,4,0,0,41,0.0,0.0,1.0,41,1450,1000,450,0.6896551724137931,19,10,9,369.20421962656064,0.4350609756097561,0.20423413551939174,0.20282608409100814,128829.56594685897,1312.8838720477193,130142.4498189067,1356,1,208.17073170731706,36,5,19,36.828896283971154,0.6085069444444444,46.19932432432432,1015.2027027027024,28.200075075075066,0
2886,4,1,0,42,0.023809523809523808,0.0,1.0,42,1500,1200,300,0.8,18,12,6,362.77060400035265,0.437862950058072,0.2102316455833415,0.20147297893470906,129260.2304633916,979.4339709297615,130239.66443432137,1357,0,204.1904761904762,35,7,20,36.55294407769937,0.6148809523809524,45.77546296296296,1016.8981481481479,29.054232804232797,0
2887,4,0,0,42,0.0,0.0,1.0,42,1200,800,400,0.6666666666666666,16,8,8,365.16272363903624,0.43777826171118855,0.2148816973597949,0.2032561860711519,129348.51794249396,1046.6514221107627,130395.16936460472,1358,1,205.1904761904762,35,7,21,36.4021551560663,0.6157738095238094,45.688657407407405,1017.24537037037,29.06415343915343,0
2888,4,0,1,41,0.0,0.023809523809523808,0.9761904761904762,42,1250,900,350,0.72,16,9,7,362.39619392398555,0.43770567169957414,0.21622360436729005,0.20292802787710387,129584.09857521001,992.156823345332,130576.25539855534,1359,2,206.1904761904762,35,7,19,36.23264086241522,0.6181547619047619,45.457175925925924,1018.171296296296,29.090608465608454,0
2889,4,1,1,41,0.023809523809523808,0.023809523809523808,0.9761904761904762,42,1050,600,450,0.5714285714285714,15,6,9,365.5540385554658,0.43906068524970965,0.23532859343888002,0.20723639370393043,130066.77685682134,1109.287112380728,131176.06396920208,1360,0,200.9047619047619,37,5,20,35.66132340821955,0.6190878378378378,44.983552631578945,1020.0657894736843,27.569345661450928,0
2890,4,1,0,42,0.023809523809523808,0.0,1.0,42,1450,1200,250,0.8275862068965517,17,12,5,359.8873334438316,0.44121418892760356,0.2243946307830662,0.20553352505200953,130353.74858276626,982.9744390542241,131336.72302182048,1361,0,199.16666666666666,34,8,21,35.51454301702029,0.6280637254901961,44.70238095238094,1021.1904761904747,30.035014005602196,0
2891,4,0,1,41,0.0,0.023809523809523808,0.9761904761904762,42,1100,700,400,0.6363636363636364,15,7,8,362.6829248820417,0.4410448122338366,0.2302882001087545,0.2077800307969081,130475.34722222229,1064.2361111111168,131539.5833333334,1362,1,200.16666666666666,34,8,22,35.31980696030451,0.6292892156862745,44.583333333333336,1021.6666666666672,30.049019607843153,0
2892,4,0,1,40,0.0,0.024390243902439025,0.975609756097561,41,1300,900,400,0.6923076923076923,17,9,8,396.89664370065884,0.440015243902439,0.17443778712094282,0.21611073003547415,128476.21882086188,2032.3837868480932,130508.60260770997,1363,2,202.46341463414635,34,7,14,36.48817911382497,0.6090686274509804,46.54761904761906,1013.8095238095254,29.817927170868394,8
2893,4,1,0,41,0.024390243902439025,0.0,1.0,41,1400,1200,200,0.8571428571428571,16,12,4,398.9151990454384,0.4395071138211382,0.19484722830332823,0.21836571878383257,128687.51594387759,2067.0812074829955,130754.59715136059,1364,0,203.390243902439,34,7,15,36.220374281356335,0.6112132352941176,46.339285714285715,1014.6428571428575,29.842436974789926,0
2894,4,0,1,40,0.0,0.024390243902439025,0.975609756097561,41,1500,1000,500,0.6666666666666666,20,10,10,403.7612882758574,0.43920223577235773,0.20051022742872826,0.22186058417632146,128838.54875283434,2204.00368480724,131042.55243764157,1365,1,204.390243902439,34,7,15,35.94263015947466,0.6127450980392157,46.19047619047618,1015.2380952380942,29.859943977591005,0
2895,4,1,1,40,0.024390243902439025,0.024390243902439025,0.975609756097561,41,1200,900,300,0.75,15,9,6,402.3029719120603,0.4367632113821138,0.20626638572094325,0.22156531009566066,128929.21095521527,2173.720946712,131102.93190192728,1366,0,205.17073170731706,34,7,16,35.88676591255421,0.6136642156862745,46.10119047619047,1015.5952380952369,29.870448179271676,0
2896,4,2,2,40,0.047619047619047616,0.047619047619047616,0.9523809523809523,42,1150,700,450,0.6086956521739131,16,7,9,381.7419130268407,0.4386009485094851,0.1874522862015755,0.21344056739167586,129525.18332315233,1489.3252431823942,131014.50856633473,1367,0,194.52380952380952,35,7,14,35.80028898995641,0.6175595238095238,45.51504629629629,1017.9398148148141,29.083994708994688,0
2897,4,0,1,39,0.0,0.025,0.975,40,1250,900,350,0.72,16,9,7,367.6426448979595,0.4355502136752137,0.17846285714285726,0.1988178703867208,128203.13169795946,1426.5876843278397,129629.7193822873,1368,2,205.25,35,5,18,37.50904761904762,0.6041666666666667,46.817129629629626,1012.7314814814808,28.935185185185166,8
2898,4,0,0,39,0.0,0.0,1.0,39,1050,800,250,0.7619047619047619,13,8,5,389.3034549483475,0.43406995051731895,0.1947686577854173,0.2042359860367941,126978.48820103878,2086.632832156466,129065.12103319525,1369,5,211.46153846153845,36,3,15,38.219972067039095,0.5896990740740741,48.02927927927927,1007.8828828828821,27.996746746746723,8
2899,4,2,1,40,0.04878048780487805,0.024390243902439025,0.975609756097561,41,1600,1300,300,0.8125,19,13,6,374.7329984460318,0.4388465447154472,0.19764045291743648,0.19898743265797142,127469.3412594053,1353.3936920154792,128822.73495142077,1370,0,202.09756097560975,38,3,14,38.08232825504301,0.5910087719298245,47.54273504273504,1009.8290598290592,26.57444894286998,0
2900,4,0,0,40,0.0,0.0,1.0,40,1550,1100,450,0.7096774193548387,20,11,9,377.7885059442421,0.43855502136752134,0.20471344838814765,0.20107253063340844,127562.34039560237,1638.3171985610809,129200.65759416345,1371,1,207.1,37,3,15,37.90963403162198,0.59375,47.450657894736835,1010.1973684210516,27.30263157894734,0
2901,4,0,0,40,0.0,0.0,1.0,40,1350,1000,350,0.7407407407407407,17,10,7,375.77252266158393,0.4374065170940171,0.20321807688343863,0.2006670769061829,127696.68104383656,1596.9807942708087,129293.66183810738,1372,2,208.1,39,1,16,37.822602116183994,0.5916132478632479,47.31770833333332,1010.7291666666647,25.916132478632427,0
2902,4,2,0,42,0.047619047619047616,0.0,1.0,42,1250,1000,250,0.8,15,10,5,362.5917362861215,0.44143195896244675,0.20796597993559707,0.19606429368260944,128198.62349559859,899.1041845727988,129097.72768017139,1373,0,199.14285714285714,38,4,18,37.64154095017054,0.5984100877192983,46.82158119658119,1012.7136752136746,26.650359874044067,0
2903,4,0,0,42,0.0,0.0,1.0,42,1800,1200,600,0.6666666666666666,24,12,12,363.088849052509,0.44082704219899344,0.2115395235585007,0.19713209692404382,128360.96871803999,921.2872790196441,129282.25599705963,1374,1,200.14285714285714,38,4,18,37.46287998594271,0.6000548245614035,46.66132478632478,1013.3547008547005,26.66722896986054,0
2904,4,0,0,42,0.0,0.0,1.0,42,1250,900,350,0.72,16,9,7,358.35583320311423,0.440028552071235,0.2024017456566518,0.19518060014358746,128487.53390842007,808.8514539930454,129296.38536241312,1375,2,201.14285714285714,39,3,11,37.453444467276256,0.5996260683760684,46.53645833333333,1013.8541666666661,25.996260683760667,0
2905,4,1,2,41,0.023255813953488372,0.046511627906976744,0.9534883720930233,43,1100,800,300,0.7272727272727273,14,8,6,351.92751678614025,0.44096068660022153,0.2031943852589757,0.1930093415784287,128762.65290377768,463.02413824444716,129225.67704202213,1376,0,197.4418604651163,40,3,13,37.335619638863854,0.60078125,46.26524390243903,1014.9390243902452,25.37347560975613,0
2906,4,1,0,42,0.023809523809523808,0.0,1.0,42,1400,1000,400,0.7142857142857143,18,10,8,353.36748991804035,0.44105691056910573,0.2019534265583922,0.19413300770807387,128830.99500868093,704.9370659722608,129535.93207465319,1377,0,201.97619047619048,39,3,14,37.22937615431974,0.6030982905982907,46.197916666666686,1015.2083333333363,26.030982905982984,0
2907,4,2,3,41,0.045454545454545456,0.06818181818181818,0.9318181818181819,44,1100,500,600,0.45454545454545453,17,5,12,346.3689553525485,0.44353417899929526,0.21650717703349232,0.19321405849276177,129433.96297053696,166.91299227685934,129600.87596281382,1378,0,193.75,40,4,11,36.79321049302573,0.6075520833333333,45.60467479674798,1017.5813008130101,25.43953252032525,0
2908,4,1,0,42,0.023809523809523808,0.0,1.0,42,950,600,350,0.631578947368421,13,6,7,361.1040562562572,0.4396293070073558,0.2206939504449752,0.20066255175150663,129282.86540516098,936.9134204470663,130219.77882560804,1379,0,202.5952380952381,38,4,20,36.57225023636938,0.609375,45.753205128205124,1016.9871794871788,26.762820512820493,0
2909,4,0,1,41,0.0,0.023809523809523808,0.9761904761904762,42,600,300,300,0.5,9,3,6,359.3064774373926,0.43909698025551686,0.2181137688050132,0.19992180924080563,129333.8012695313,894.0945095486117,130227.8957790799,1380,1,203.5952380952381,39,3,21,36.566073562041296,0.6081730769230769,45.703125,1017.1875000000003,26.081730769230777,0
2910,4,0,0,41,0.0,0.0,1.0,41,1150,700,450,0.6086956521739131,16,7,9,364.0654551857634,0.4380843495934959,0.2159437033925009,0.20258721208788136,129337.19735051856,1217.4411251734814,130554.63847569205,1381,2,208.41463414634146,38,3,21,36.44159402023597,0.6099232456140351,45.69978632478632,1017.2008547008538,26.76844354475931,0
2911,4,0,0,41,0.0,0.0,1.0,41,1150,800,350,0.6956521739130435,15,8,7,355.8412114997993,0.4380589430894309,0.20373657465235917,0.19902073788908387,129537.39636005364,1018.9488110582427,130556.34517111188,1382,3,209.41463414634146,40,1,13,36.44699843599215,0.60859375,45.50304878048781,1017.9878048780496,25.44969512195124,0
2912,4,1,0,42,0.023809523809523808,0.0,1.0,42,1200,1100,100,0.9166666666666666,13,11,2,345.3882648174686,0.43970189701897017,0.19138445568963292,0.1950115279815551,129908.37191358008,573.7654320987452,130482.13734567883,1383,0,205.4047619047619,41,1,15,36.33628519527701,0.6107723577235773,45.13888888888888,1019.4444444444431,24.864498644986416,0
2913,4,0,1,41,0.0,0.023809523809523808,0.9761904761904762,42,1400,900,500,0.6428571428571429,19,9,10,342.5710945010668,0.4401616337591947,0.188961165318434,0.1936713811486227,129958.94451530596,504.03557256234694,130462.98008786832,1384,1,206.4047619047619,41,1,15,36.356781474995145,0.6112804878048781,45.08928571428571,1019.642857142856,24.86933797909405,0
2914,4,0,0,41,0.0,0.0,1.0,41,1200,900,300,0.75,15,9,6,370.18223039045756,0.4377032520325203,0.22524343874617458,0.19594752333203913,127340.90206842487,1289.4289122909067,128630.33098071578,1385,2,212.26829268292684,37,4,14,38.32914629730219,0.5914977477477478,47.66995614035088,1009.3201754385963,27.278923660502603,8
2915,4,0,1,40,0.0,0.024390243902439025,0.975609756097561,41,800,500,300,0.625,11,5,6,369.6352606377866,0.43734756097560973,0.2281225418400339,0.19619430058866716,127451.5971861534,1222.120868921199,128673.7180550746,1386,3,213.26829268292684,37,4,14,38.22924584645455,0.5926238738738738,47.560307017543856,1009.7587719298243,27.29077761972498,0
2916,4,0,0,40,0.0,0.0,1.0,40,1150,800,350,0.6956521739130435,15,8,7,384.09028050324144,0.435403311965812,0.23913989290495286,0.20348612733044083,127376.05003652314,1784.7805575846296,129160.83059410777,1387,8,219.525,36,4,14,37.94204596162429,0.59375,47.635135135135144,1009.4594594594606,28.040540540540572,0
2917,4,0,0,40,0.0,0.0,1.0,40,650,400,250,0.6153846153846154,9,4,5,386.06597288232564,0.43533653846153847,0.24671368045490016,0.2052534505501827,127518.18700034512,1846.0865848957287,129364.27358524085,1388,9,220.525,36,4,14,37.74598617460141,0.5951967592592593,47.49436936936938,1010.022522522524,28.056181181181223,0
2918,4,0,0,40,0.0,0.0,1.0,40,950,800,150,0.8421052631578947,11,8,3,389.72091108633566,0.43532318376068374,0.2504291127953633,0.20763515524148515,127603.50722343997,1945.9510185861905,129549.45824202616,1389,10,221.525,36,4,14,37.565945905780964,0.5960648148148149,47.40990990990993,1010.3603603603628,28.065565565565635,0
2919,4,1,0,41,0.024390243902439025,0.0,1.0,41,1750,1300,450,0.7428571428571429,22,13,9,387.0879771124676,0.43734756097560973,0.2491405085099312,0.20818343164294056,127982.32299884956,1708.0837031558315,129690.40670200539,1390,0,217.09756097560975,38,3,16,37.24329532256362,0.596217105263158,47.035256410256416,1011.8589743589753,26.627867746288825,0
2920,4,2,1,42,0.046511627906976744,0.023255813953488372,0.9767441860465116,43,1100,700,400,0.6363636363636364,15,7,8,373.5547699050396,0.4402224067921742,0.2575889377749838,0.20397766361402736,128588.99493113297,1007.3146681682998,129596.30959930127,1391,0,207.95348837209303,37,6,14,36.96441441441442,0.6041666666666667,46.436403508771946,1014.2543859649148,27.412280701754455,0
2921,4,0,1,41,0.0,0.023809523809523808,0.9761904761904762,42,1200,700,500,0.5833333333333334,17,7,10,376.44217740061055,0.438951800232288,0.2638663639312362,0.20541083768603247,128561.19340806796,1279.1711151508325,129840.3645232188,1392,1,213.9047619047619,37,5,15,36.91964446606841,0.6038851351351351,46.46381578947369,1014.1447368421061,27.409317211948814,0
2922,4,1,0,42,0.023809523809523808,0.0,1.0,42,1100,700,400,0.6363636363636364,15,7,8,380.5783723721987,0.4389276035617499,0.26507936507936525,0.20854072447037894,128728.0476324446,1398.2221693213303,130126.26980176594,1393,0,214.83333333333334,37,5,16,36.64404376012966,0.6055743243243243,46.29934210526316,1014.8026315789474,27.427098150782363,0
2923,4,1,1,42,0.023255813953488372,0.023255813953488372,0.9767441860465116,43,1250,900,350,0.72,16,9,7,374.7216113206418,0.4399916943521595,0.2596141148851878,0.20694555886523258,129038.51290269564,1070.703895463514,130109.21679815916,1394,0,210.8139534883721,38,5,17,36.475420609884324,0.606907894736842,45.993589743589745,1016.0256410256414,26.737516869095828,0
2924,4,1,0,43,0.023255813953488372,0.0,1.0,43,1000,700,300,0.7,13,7,6,353.1800260148405,0.43941491325212256,0.16984261457873395,0.19390080864871118,128804.55864800357,504.0179511577562,129308.57659916133,1395,0,210.46511627906978,39,4,17,37.26109543355566,0.6028311965811965,46.223958333333336,1015.1041666666674,26.028311965811984,8
2925,4,2,1,44,0.044444444444444446,0.022222222222222223,0.9777777777777777,45,650,300,350,0.46153846153846156,10,3,7,343.64664272066307,0.44084595959595957,0.17129250271387098,0.19096161074477458,129282.86540516098,-112.64441375432159,129170.22099140666,1396,0,202.06666666666666,38,7,20,37.01609938018701,0.609375,45.753205128205124,1016.9871794871788,26.762820512820493,0
2926,4,0,2,42,0.0,0.045454545454545456,0.9545454545454546,44,1700,1200,500,0.7058823529411765,22,12,10,352.49565967611977,0.44166226215644816,0.11166117723130409,0.19130011735619573,128344.1443977761,385.44736664538596,128729.59176442148,1397,1,201.79545454545453,36,8,17,37.748434837371256,0.603587962962963,46.677927927927925,1013.2882882882878,28.146896896896884,8
2927,4,3,3,42,0.06666666666666667,0.06666666666666667,0.9333333333333333,45,850,600,250,0.7058823529411765,11,6,5,337.7818782403605,0.4477483164983165,0.12863400175204953,0.18560963861290794,128839.3438966798,-296.08088546475074,128543.26301121505,1398,0,197.0888888888889,37,8,16,37.616440760341305,0.6067004504504505,46.189692982456144,1015.2412280701758,27.438952110004752,0
2928,4,1,1,42,0.023255813953488372,0.023255813953488372,0.9767441860465116,43,1500,1200,300,0.8,18,12,6,341.48143019750194,0.4464285714285714,0.09835466521747205,0.18033125739366,127245.76971379505,90.92145448785877,127336.69116828291,1399,0,207.13953488372093,40,3,13,39.15084441310771,0.5854166666666667,47.76422764227644,1008.9430894308971,25.223577235772428,8
2929,4,2,1,43,0.045454545454545456,0.022727272727272728,0.9772727272727273,44,1400,800,600,0.5714285714285714,20,8,12,337.0434377032101,0.4484452078928823,0.11861792827618256,0.179410001366011,127567.61508133354,-200.83449467748838,127366.78058665605,1400,0,202.79545454545453,41,3,13,38.93325067923665,0.5871443089430894,47.44543650793651,1010.2182539682547,24.63946960898182,0
2930,4,1,3,41,0.022727272727272728,0.06818181818181818,0.9318181818181819,44,1450,1000,450,0.6896551724137931,19,10,9,337.39793609871447,0.4467494714587738,0.12372746009511104,0.18026993030465674,127717.98946719902,-181.6427902179304,127536.34667698109,1401,0,203.77272727272728,41,3,14,38.77046733405305,0.5886686991869918,47.29662698412699,1010.8134920634928,24.653987611304704,0
2931,4,1,1,41,0.023809523809523808,0.023809523809523808,0.9761904761904762,42,900,500,400,0.5555555555555556,13,5,8,341.2602648069213,0.4435249709639954,0.12415333833605513,0.18295394318113764,127854.65630425354,326.34277343750466,128180.99907769104,1402,0,211.07142857142858,39,3,15,38.53308356507706,0.593215811965812,47.161458333333336,1011.3541666666673,25.932158119658137,0
2932,4,0,0,41,0.0,0.0,1.0,41,1550,1100,450,0.7096774193548387,20,11,9,342.44374183982194,0.4399136178861789,0.11142649016603379,0.18370876979362843,127880.99500868071,558.4092881944542,128439.40429687516,1403,1,217.1219512195122,39,2,17,38.47622725712323,0.593482905982906,47.13541666666667,1011.4583333333346,25.93482905982909,0
2933,4,0,1,40,0.0,0.024390243902439025,0.975609756097561,41,1450,1100,350,0.7586206896551724,18,11,7,337.1775982658472,0.4398882113821138,0.10017063133594295,0.18207590306355742,128144.53124999997,441.4930555555543,128586.02430555552,1404,2,218.1219512195122,39,2,18,38.34019204389576,0.5961538461538461,46.875,1012.4999999999998,25.961538461538456,0
2934,4,1,1,40,0.024390243902439025,0.024390243902439025,0.975609756097561,41,1050,600,450,0.5714285714285714,15,6,9,336.7706232750836,0.44146341463414634,0.12101891672430876,0.1833026681047602,128461.13281249996,452.38715277777595,128913.51996527774,1405,0,218.78048780487805,39,2,14,38.02746951637211,0.5993589743589743,46.5625,1013.7499999999997,25.993589743589734,0
2935,4,0,0,40,0.0,0.0,1.0,40,1200,800,400,0.6666666666666666,16,8,8,340.86659176161675,0.4414129273504273,0.11409608091024048,0.18594860281616446,128550.50131492419,763.714250493073,129314.21556541725,1406,1,217.525,38,2,15,37.83251685630005,0.6019736842105263,46.474358974358964,1014.1025641025624,26.68690958164638,0
2936,4,0,0,40,0.0,0.0,1.0,40,1250,800,450,0.64,17,8,9,340.6974530795261,0.44125267094017095,0.11590334807327829,0.1866173246452903,128713.06911571308,770.4429651544696,129483.51208086754,1407,2,218.525,38,2,17,37.67108865024215,0.6036184210526316,46.31410256410255,1014.7435897435876,26.703778677462832,0
2937,4,1,0,41,0.024390243902439025,0.0,1.0,41,950,500,450,0.5263157894736842,14,5,9,338.073003514087,0.4437245934959349,0.13222842911225974,0.1867250326317325,129042.58355034684,525.162760416627,129567.74631076347,1408,0,214.17073170731706,39,2,19,37.40217688469687,0.6052350427350428,45.989583333333314,1016.0416666666636,26.052350427350348,0
2938,4,0,2,39,0.0,0.04878048780487805,0.9512195121951219,41,1550,1300,250,0.8387096774193549,18,13,5,337.27492609513615,0.4436229674796748,0.126149540183927,0.1870342771982114,129201.3888888885,515.2777777777383,129716.66666666623,1409,1,215.17073170731706,39,2,19,37.26092896174863,0.6068376068376069,45.833333333333314,1016.6666666666636,26.06837606837599,0
2939,4,0,1,38,0.0,0.02564102564102564,0.9743589743589743,39,1500,1000,500,0.6666666666666666,20,10,10,348.7407500241916,0.44073324336482234,0.12904867397370978,0.19325615621483985,129173.52123970799,1209.6141360802922,130383.13537578828,1410,2,226.17948717948718,37,2,20,36.997874195520076,0.6100788288288288,45.86074561403507,1016.5570175438565,27.4745139876718,0
2940,4,0,3,35,0.0,0.07894736842105263,0.9210526315789473,38,750,600,150,0.8,9,6,3,363.7919922443663,0.44161925082977715,0.09583652122277897,0.19428937337824856,127700.83703639591,1709.1293715374063,129409.96640793332,1411,3,223.07894736842104,37,1,18,38.12106747667606,0.5951576576576576,47.313596491228076,1010.7456140350886,27.317449027975368,8
2941,4,1,0,36,0.027777777777777776,0.0,1.0,36,850,400,450,0.47058823529411764,13,4,9,364.12398134944993,0.4434027777777778,0.10301788605826911,0.19634735862928654,128087.52745566508,2127.948091672749,130215.47554733783,1412,0,225.52777777777777,36,0,19,37.71646827604109,0.6009837962962963,46.931306306306304,1012.2747747747745,28.118743743743735,0
2942,4,1,2,35,0.02702702702702703,0.05405405405405406,0.9459459459459459,37,1200,700,500,0.5833333333333334,17,7,10,352.7866391443046,0.4454767267267267,0.09640873750462764,0.19218973625025554,128496.33487654326,1666.3833878923983,130162.71826443567,1413,0,220.40540540540542,35,2,16,37.58561643835615,0.6071428571428572,46.52777777777778,1013.8888888888893,28.96825396825398,0
2943,4,2,0,37,0.05405405405405406,0.0,1.0,37,850,600,250,0.7058823529411765,11,6,5,352.30340756973675,0.44115990990990994,0.1247543417591288,0.19392158707759502,128907.38195516092,1682.9019847393356,130590.28393990026,1414,0,220.97297297297297,35,2,19,37.178500873793794,0.6113095238095239,46.12268518518517,1015.5092592592571,29.014550264550202,0
2944,4,0,0,37,0.0,0.0,1.0,37,1300,1000,300,0.7692307692307693,16,10,6,363.2653770024925,0.44069069069069067,0.08053961230835927,0.1943124965166425,127763.95486379025,1904.962786136825,129668.91764992707,1415,1,221.97297297297297,35,2,18,38.06966704827324,0.5997023809523809,47.251157407407405,1010.99537037037,28.885582010582,8
2945,4,0,1,36,0.0,0.02702702702702703,0.972972972972973,37,1050,800,250,0.7619047619047619,13,8,5,361.3228529518765,0.44087837837837834,0.0827789684638296,0.19383673492611705,127880.9950086805,1841.2651909722172,129722.26019965272,1416,2,222.97297297297297,35,2,18,37.99884140061791,0.6008928571428571,47.135416666666664,1011.4583333333329,28.89880952380951,0
2946,4,0,0,36,0.0,0.0,1.0,36,1200,800,400,0.6666666666666666,16,8,8,363.5805786298167,0.4393683862433862,0.09731697117018179,0.19589113304884048,128054.1454081633,2111.600056689344,130165.74546485265,1417,3,228.88888888888889,34,2,19,37.76439857288481,0.6047794117647058,46.964285714285715,1012.1428571428575,29.76890756302522,0
2947,4,0,0,36,0.0,0.0,1.0,36,1150,800,350,0.6956521739130435,15,8,7,365.4030609724965,0.4389880952380953,0.10035347001711847,0.19702106705447903,128084.27047902481,2160.476899092957,130244.74737811777,1418,4,229.88888888888889,34,2,19,37.687433846877575,0.6050857843137255,46.9345238095238,1012.2619047619037,29.772408963585402,0
2948,4,0,1,35,0.0,0.027777777777777776,0.9722222222222222,36,750,300,450,0.4,12,3,9,364.2737387593355,0.43882275132275134,0.10002286236854174,0.1967078189300412,128144.53124999999,2135.9516723356005,130280.48292233559,1419,5,230.88888888888889,33,3,20,37.65432098765432,0.6079545454545454,46.875,1012.4999999999999,30.68181818181818,0
2949,4,0,0,35,0.0,0.0,1.0,35,1150,800,350,0.6956521739130435,15,8,7,370.234419829822,0.43841036414565826,0.08881047515264773,0.19946288802182,128051.48748378029,2481.813635380626,130533.30111916093,1420,6,228.65714285714284,33,2,20,37.59875590265165,0.6070075757575757,46.966911764705884,1012.1323529411766,30.670677361853837,0
2950,4,0,0,35,0.0,0.0,1.0,35,850,500,350,0.5882352941176471,12,5,7,370.37037037037044,0.43781512605042017,0.09171075837742548,0.20000000000000015,128144.53125000009,2492.2212910899784,130636.75254109007,1421,7,229.65714285714284,32,3,20,37.50000000000001,0.6103515625,46.87500000000001,1012.5000000000007,31.64062500000002,0
2951,4,0,1,34,0.0,0.02857142857142857,0.9714285714285714,35,700,400,300,0.5714285714285714,10,4,6,368.6258170036254,0.4377801120448179,0.0934520840755253,0.19921691727554428,128176.49347005412,2449.8329252117173,130626.32639526583,1422,8,230.65714285714284,32,3,20,37.51142975893599,0.6106770833333333,46.843434343434346,1012.626262626263,31.64457070707072,0
2952,4,0,1,33,0.0,0.029411764705882353,0.9705882352941176,34,1150,700,450,0.6086956521739131,16,7,9,370.91798410341505,0.4367572786690434,0.1041781198460694,0.20125874391006837,128336.36435376515,2720.453110652007,131056.81746441715,1423,9,236.47058823529412,32,2,20,37.28971962616824,0.6123046875,46.68560606060608,1013.2575757575776,31.6642992424243,0
2953,4,0,1,32,0.0,0.030303030303030304,0.9696969696969697,33,850,600,250,0.7058823529411765,11,6,5,381.0488829822437,0.4365924873737374,0.11228824282916516,0.20695767315078886,128375.34798516176,3183.4565904405486,131558.80457560232,1424,10,243.3030303030303,31,2,15,36.993152811683586,0.615255376344086,46.64713541666667,1013.411458333334,32.6906922043011,0
2954,4,1,0,33,0.030303030303030304,0.0,1.0,33,1100,700,400,0.6363636363636364,15,7,8,381.307301030134,0.4357638888888889,0.12770145932297705,0.20812912177461199,128573.35620456267,3205.1918877495614,131778.54809231224,1425,0,243.78787878787878,31,2,16,36.78384580819104,0.617271505376344,46.451822916666664,1014.1927083333329,32.71589381720429,0
2955,4,0,0,33,0.0,0.0,1.0,33,1050,900,150,0.8571428571428571,12,9,3,381.55608125803224,0.43540877525252525,0.12328612154396135,0.20886816546250328,128688.43102744622,3220.3706892153914,131908.8017166616,1426,1,244.78787878787878,32,1,17,36.6597706155633,0.6158854166666667,46.33838383838384,1014.6464646464649,31.707702020202028,0
2956,4,0,0,33,0.0,0.0,1.0,33,1050,800,250,0.7619047619047619,13,8,5,383.2288368210012,0.43497474747474746,0.016178209196689775,0.20969937475486233,128672.41753472218,3262.1961805555507,131934.61371527772,1427,2,245.78787878787878,33,0,17,36.63372689938398,0.6133207070707071,46.354166666666664,1014.5833333333329,30.74494949494948,8
2957,4,1,1,33,0.029411764705882353,0.029411764705882353,0.9705882352941176,34,950,500,450,0.5263157894736842,14,5,9,372.1801094536354,0.43738859180035655,0.01833926256860008,0.20513182776863137,128959.43877551005,2799.227607709732,131758.66638321977,1428,0,239.52941176470588,34,0,18,36.620712220659485,0.6139705882352942,46.07142857142856,1015.7142857142844,29.873949579831894,0
2958,4,0,0,33,0.0,0.0,1.0,33,1200,1000,200,0.8333333333333334,14,10,4,383.1771477765691,0.433633207070707,0.030829530829530993,0.21115506654070462,128952.32602845035,3282.3168973471447,132234.6429257975,1429,1,247.6969696969697,33,0,19,36.348737129987136,0.6161616161616161,46.078431372549005,1015.6862745098019,30.778371954842484,0
2959,4,1,1,33,0.029411764705882353,0.029411764705882353,0.9705882352941176,34,900,700,200,0.7777777777777778,11,7,4,378.6140164960716,0.43527183600713015,0.045291226717694144,0.21092799119787647,129383.0002834466,2997.2434807256104,132380.24376417222,1430,0,241.38235294117646,34,0,20,36.02489468757312,0.6182598039215687,45.6547619047619,1017.3809523809515,29.922969187675044,0
2960,4,1,0,34,0.029411764705882353,0.0,1.0,34,850,700,150,0.8235294117647058,10,7,3,374.1820042269256,0.43423202614379086,0.05656108597285092,0.20974789411252412,129625.34722222206,2900.6944444444243,132526.04166666648,1431,0,241.8235294117647,34,0,15,35.89061647572286,0.6207107843137255,45.41666666666666,1018.333333333332,29.950980392156822,0
2961,4,0,0,34,0.0,0.0,1.0,34,600,300,300,0.5,9,3,6,372.6546285132546,0.43358214497920383,0.061473578563130626,0.2093766025074139,129716.28578514719,2867.8748582766234,132584.16064342382,1432,1,242.8235294117647,34,0,16,35.83688792801216,0.6216299019607843,45.32738095238094,1018.6904761904746,29.961484593837486,0
2962,4,0,0,34,0.0,0.0,1.0,34,800,700,100,0.875,9,7,2,372.9068428284004,0.4333778966131907,0.060143244023479925,0.20968047049444474,129746.60572562352,2876.6794217686997,132623.28514739222,1433,2,243.8235294117647,34,0,16,35.79959297343616,0.6219362745098039,45.297619047619044,1018.8095238095233,29.964985994397743,0
2963,4,0,1,33,0.0,0.029411764705882353,0.9705882352941176,34,750,500,250,0.6666666666666666,10,5,5,371.04086601449916,0.43300653594771243,0.061572292468389245,0.20895459296605995,129807.2562358276,2832.759353741488,132640.01558956908,1434,3,244.8235294117647,34,0,16,35.78538746105918,0.6225490196078431,45.238095238095234,1019.0476190476186,29.971988795518193,0
2964,4,1,0,34,0.029411764705882353,0.0,1.0,34,900,600,300,0.6666666666666666,12,6,6,373.7260037847999,0.43042557932263814,0.05300298753476862,0.21128470114962458,129958.94451530626,2913.807397959199,132872.75191326544,1435,0,245.61764705882354,34,0,19,35.56260945709282,0.6240808823529411,45.08928571428572,1019.6428571428582,29.98949579831936,0
2965,4,0,0,34,0.0,0.0,1.0,34,1000,700,300,0.7,13,7,6,376.1595427320342,0.4305555555555556,0.0497288763813577,0.21348922392142633,130110.72137188222,2988.4778911564754,133099.1992630387,1436,1,246.61764705882354,34,0,20,35.34616880591208,0.6256127450980392,44.9404761904762,1020.2380952380963,30.00700280112048,0
2966,4,0,1,33,0.0,0.029411764705882353,0.9705882352941176,34,1250,1000,250,0.8,15,10,5,410.0719095114753,0.4302956030897207,0.02635178073108113,0.223284679117629,128476.21882086145,3736.8976757369387,132213.1164965984,1437,2,247.61764705882354,34,0,15,36.154248864881794,0.6090686274509804,46.54761904761904,1013.809523809522,29.817927170868295,8
2967,4,0,0,33,0.0,0.0,1.0,33,850,600,250,0.7058823529411765,11,6,5,421.99985287560685,0.42846433080808083,0.03934925762336916,0.23001493957132896,128517.04422577866,4246.834751057301,132763.87897683596,1438,3,255.93939393939394,33,0,16,35.809966964789304,0.6117424242424243,46.50735294117648,1013.970588235295,30.726381461675608,0
2968,4,0,0,33,0.0,0.0,1.0,33,600,500,100,0.8333333333333334,7,5,2,421.8892489115652,0.42850378787878785,0.03536024901583801,0.23013404975235355,128548.11137843628,4246.613231689749,132794.72461012602,1439,4,256.93939393939394,33,0,17,35.780840886203436,0.6120580808080809,46.47671568627452,1014.0931372549029,30.730095068330392,0
2969,4,0,0,33,0.0,0.0,1.0,33,950,700,250,0.7368421052631579,12,7,5,420.8464608275573,0.4279119318181818,0.04081393646611042,0.23046353807223371,128703.50346020756,4232.882785467122,132936.3862456747,1440,5,257.93939393939394,33,0,18,35.64764492753623,0.6136363636363636,46.3235294117647,1014.7058823529408,30.748663101604265,0
2970,4,1,0,34,0.029411764705882353,0.0,1.0,34,1450,1200,250,0.8275862068965517,17,12,5,412.2359753694439,0.43042557932263814,0.043771403372172335,0.22807897094808455,129110.63102324273,3844.8093820861764,132955.4404053289,1441,0,251.3235294117647,34,0,19,35.44863535199718,0.6155024509803921,45.92261904761905,1016.3095238095245,29.891456582633076,0
2971,4,0,0,34,0.0,0.0,1.0,34,1300,1000,300,0.7692307692307693,16,10,6,411.37898028617633,0.4297571301247772,0.04880156440429384,0.22865391207448327,129292.1786422904,3837.6169217687248,133129.7955640591,1442,1,252.3235294117647,34,0,19,35.28449217683093,0.6173406862745099,45.74404761904763,1017.0238095238107,29.912464985994433,0
2972,4,1,1,34,0.02857142857142857,0.02857142857142857,0.9714285714285714,35,1450,1100,350,0.7586206896551724,18,11,7,434.3178832052107,0.4316526610644258,-0.0027461965178225967,0.23984306034326003,129035.9687805178,4324.2287114634555,133360.19749198126,1443,0,246.0857142857143,31,4,18,34.96424986116452,0.6219758064516129,45.996093750000014,1016.0156250000017,32.77469758064522,8
2973,4,1,0,35,0.02857142857142857,0.0,1.0,35,1250,700,550,0.56,18,7,11,431.81877433797393,0.4315826330532213,0.00038793024575012325,0.23926253876909617,129168.29639010968,4155.45908610027,133323.75547620995,1444,0,247.0,31,4,19,34.891897228982515,0.6233198924731183,45.86588541666667,1016.536458333334,32.791498655914005,0
2974,4,0,0,35,0.0,0.0,1.0,35,1050,700,350,0.6666666666666666,14,7,7,431.91251671840837,0.43109243697478994,-0.0026128490249011094,0.24013828170523088,129303.89577190994,4169.598447420584,133473.49421933052,1445,1,248.0,30,5,19,34.7503964583058,0.6274305555555555,45.732526881720425,1017.0698924731174,33.90232974910391,0
2975,4,0,0,35,0.0,0.0,1.0,35,650,400,250,0.6153846153846154,9,4,5,429.5565525286561,0.4308823529411765,-0.0016234597243045545,0.23941190452631383,129400.0328911676,4116.926405164936,133516.95929633253,1446,2,249.0,31,4,19,34.711735346813406,0.6256720430107527,45.638020833333336,1017.4479166666672,32.82090053763442,0
2976,4,0,0,35,0.0,0.0,1.0,35,1150,900,250,0.782608695652174,14,9,5,425.0787561195104,0.430812324929972,-0.002865916069600516,0.23731539698786383,129466.28146701393,4006.6731770833435,133472.95464409728,1447,3,250.0,31,4,18,34.75776185602184,0.6263440860215054,45.57291666666667,1017.7083333333337,32.82930107526883,0
2977,4,0,0,35,0.0,0.0,1.0,35,1000,800,200,0.8,12,8,4,428.3391787798507,0.4302170868347339,-0.000518882575411439,0.2397411624108555,129565.68611992727,4099.611918131506,133665.29803805877,1448,4,251.0,31,4,18,34.57296862343863,0.6273521505376345,45.475260416666664,1018.098958333333,32.84190188172042,0
2978,4,1,1,35,0.027777777777777776,0.027777777777777776,0.9722222222222222,36,1200,800,400,0.6666666666666666,16,8,8,418.58796691236336,0.43086970899470894,0.006986584107327332,0.23653588753095448,129940.55333958293,3678.3104083767244,133618.86374795964,1449,0,245.0,32,4,19,34.43782249742002,0.6285807291666667,45.107323232323246,1019.5707070707089,31.861584595959652,0
2979,4,0,1,34,0.0,0.02857142857142857,0.9714285714285714,35,1150,900,250,0.782608695652174,14,9,5,421.50455791010006,0.42801120448179275,0.09266222789526357,0.23118548004049308,128765.68657487497,3862.434064174645,132628.12063904962,1450,1,252.85714285714286,33,2,18,35.567093294695326,0.6142676767676767,46.26225490196078,1014.9509803921562,30.756090314913823,8
2980,4,0,1,33,0.0,0.029411764705882353,0.9705882352941176,34,1200,900,300,0.75,15,9,6,405.30150080787064,0.4259135472370767,0.04700285874185117,0.21922357950511973,128210.45769585519,3594.24997437511,131804.7076702303,1451,2,259.8529411764706,31,3,18,36.54806291248822,0.6135752688172043,46.80989583333334,1012.760416666668,32.6696908602151,8
2981,4,1,1,33,0.029411764705882353,0.029411764705882353,0.9705882352941176,34,1000,600,400,0.6,14,6,8,403.78120627232323,0.4290144087938206,0.04055401536497483,0.22003108840046082,128507.33651055246,3577.7694702148638,132085.10598076732,1452,0,252.47058823529412,31,3,16,36.28175698814263,0.6165994623655914,46.51692708333334,1013.932291666668,32.70749327956994,0
2982,4,0,0,33,0.0,0.0,1.0,33,950,800,150,0.8421052631578947,11,8,3,395.86492690008345,0.42341382575757575,0.05218316118790067,0.2193411983185915,129168.29639010967,3767.3680623372493,132935.66445244692,1453,4,261.1212121212121,31,2,19,35.80560714743179,0.6233198924731183,45.86588541666667,1016.5364583333339,32.791498655914,8
2983,4,1,2,32,0.029411764705882353,0.058823529411764705,0.9411764705882353,34,750,700,50,0.9333333333333333,8,7,1,384.73562292440056,0.426730540701129,0.04728839712468491,0.2146116269203562,129433.15505981445,3159.513346354167,132592.6684061686,1454,0,254.41176470588235,31,3,18,35.818004905097034,0.626008064516129,45.60546875,1017.578125,32.825100806451616,0
2984,4,1,0,33,0.030303030303030304,0.0,1.0,33,1000,800,200,0.8,12,8,4,382.96157518072954,0.4248737373737374,0.07359196671393065,0.21488704742207093,129665.12891981343,3331.3524034288293,132996.48132324227,1455,0,261.3333333333333,31,2,19,35.62654478820421,0.6283602150537635,45.37760416666667,1018.4895833333339,32.85450268817206,0
2985,4,0,0,33,0.0,0.0,1.0,33,1100,800,300,0.7272727272727273,14,8,6,408.3090247959479,0.4248737373737374,0.028962049862578665,0.21602752567873007,127321.88118828683,3798.707919650627,131120.58910793747,1456,1,262.3333333333333,31,2,15,37.386708166688166,0.604502688172043,47.68880208333334,1009.244791666668,32.55628360215058,8
2986,4,1,0,34,0.029411764705882353,0.0,1.0,34,750,400,350,0.5333333333333333,11,4,7,402.69635395237196,0.426711972667855,0.04360700063187872,0.21521942655158172,127729.38507550265,3487.231532496701,131216.61660799934,1457,0,255.58823529411765,32,2,16,37.10862686318593,0.6061197916666667,47.28535353535354,1010.8585858585872,31.58933080808085,0
2987,4,3,0,37,0.08108108108108109,0.0,1.0,37,700,300,400,0.42857142857142855,11,3,8,381.6292109785556,0.43280780780780775,0.06655463221350288,0.2086699958968835,128643.06205257644,2418.7900537980327,131061.85210637447,1458,0,235.78378378378378,35,2,16,36.704340178741234,0.6086309523809523,46.38310185185186,1014.4675925925936,28.98478835978839,0
2988,4,0,0,37,0.0,0.0,1.0,37,800,300,500,0.375,13,3,10,385.94304798178905,0.4321196196196196,0.06428049671292957,0.21165319498138288,128760.50407503874,2538.8442804784167,131299.34835551717,1459,1,236.78378378378378,35,2,16,36.47472630858708,0.6098214285714285,46.26736111111112,1014.9305555555568,28.99801587301591,0
2989,4,1,0,38,0.02631578947368421,0.0,1.0,38,950,600,350,0.631578947368421,13,6,7,376.02981158313867,0.43515884305357994,0.06915368327723836,0.20777201407928128,129058.31665702882,2105.954899155929,131164.27155618474,1460,0,231.52631578947367,36,2,17,36.4219679337988,0.6108217592592593,45.97409909909911,1016.1036036036049,28.225100100100136,0
2990,4,0,1,37,0.0,0.02631578947368421,0.9736842105263158,38,1200,800,400,0.6666666666666666,16,8,8,368.1430564704968,0.43514402560455195,0.06950651155546517,0.20445669368835562,129260.23046339172,1917.33052457802,131177.56098796974,1461,1,232.52631578947367,35,3,18,36.4163631535018,0.6148809523809524,45.77546296296297,1016.8981481481488,29.054232804232825,0
2991,4,1,1,37,0.02631578947368421,0.02631578947368421,0.9736842105263158,38,1300,1100,200,0.8461538461538461,15,11,4,369.0565040415863,0.43549964438122335,0.06480218281036798,0.20650260874998688,129554.63927469135,1962.5964506172777,131517.23572530862,1462,0,233.3421052631579,35,3,14,36.09311050477487,0.6178571428571429,45.48611111111111,1018.0555555555555,29.087301587301585,0
2992,4,0,0,37,0.0,0.0,1.0,37,650,500,150,0.7692307692307693,8,5,3,373.50109827695144,0.4320883383383383,0.0645795932420139,0.20836431827734497,129436.83556241429,2268.960048010981,131705.79561042527,1463,3,240.64864864864865,35,2,14,36.100053078556286,0.6166666666666667,45.601851851851855,1017.5925925925927,29.074074074074076,0
2993,4,0,0,37,0.0,0.0,1.0,37,700,500,200,0.7142857142857143,9,5,4,373.36462749359157,0.43171296296296297,0.06802390793294677,0.20875663692346727,129525.18332315248,2272.024364497603,131797.20768765008,1464,4,241.64864864864865,35,2,14,36.01347830206556,0.6175595238095238,45.5150462962963,1017.9398148148152,29.08399470899472,0
2994,4,0,0,37,0.0,0.0,1.0,37,750,400,350,0.5333333333333333,11,4,7,367.49120879592573,0.43133758758758756,0.12602534293998668,0.1913223014226431,126666.55411746216,1909.7690173281514,128576.3231347903,1465,5,242.64864864864865,36,1,13,39.09064212999217,0.5865162037037037,48.33896396396397,1006.644144144145,27.96233733733736,8
2995,4,1,0,38,0.02631578947368421,0.0,1.0,38,1100,800,300,0.7272727272727273,14,8,6,356.5797917312695,0.43373636794689424,0.1298043346347164,0.1873368345815593,127036.73846760533,1459.7467489996843,128496.48521660501,1466,0,237.23684210526315,37,1,15,38.984663911246464,0.5884009009009009,47.97149122807017,1008.1140350877185,27.24632527264104,0
2996,4,2,1,39,0.05,0.025,0.975,40,550,200,350,0.36363636363636365,9,2,7,344.77579091697953,0.4365251068376068,0.1369672131147539,0.18344710766010353,127550.26989051426,795.2610595653819,128345.53095007964,1467,0,226.325,38,2,13,38.75572889123919,0.5918311403508771,47.462606837606835,1010.1495726495725,26.582883490778226,0
2997,4,0,0,39,0.0,0.0,1.0,39,1050,600,450,0.5714285714285714,15,6,9,388.60682530085546,0.4350258659469186,0.15259335425272313,0.1995461556189833,126101.95500042841,2057.887450563479,128159.84245099188,1468,1,233.12820512820514,35,4,18,39.14256357071521,0.5827380952380952,48.90046296296295,1004.398148148146,28.697089947089886,8
2998,4,0,0,39,0.0,0.0,1.0,39,1550,1200,350,0.7741935483870968,19,12,7,391.50972192546,0.43519455690508324,0.15611276384757033,0.20246645619573783,126392.7469135802,2096.797839506163,128489.54475308636,1469,2,234.12820512820514,35,4,17,38.76899171270717,0.5857142857142856,48.61111111111111,1005.5555555555552,28.73015873015872,0
2999,4,1,0,40,0.025,0.0,1.0,40,1750,1200,550,0.6857142857142857,23,12,11,385.5435223619737,0.43727297008547006,0.16982122905027963,0.20226345399411866,126978.48820103888,1791.1467210453693,128769.63492208425,1470,0,229.25,36,4,18,38.3147113594041,0.5896990740740741,48.02927927927928,1007.8828828828829,27.996746746746748,0
3000,4,1,1,40,0.024390243902439025,0.024390243902439025,0.975609756097561,41,1050,800,250,0.7619047619047619,13,8,5,392.1925499485284,0.43940548780487804,0.21098145645298616,0.20851066867150864,127518.18700034496,1802.387311297791,129320.57431164275,1471,0,224.6341463414634,36,5,15,37.59128665403056,0.5951967592592593,47.49436936936937,1010.0225225225226,28.056181181181184,0
3001,4,1,0,41,0.024390243902439025,0.0,1.0,41,1000,800,200,0.8,12,8,4,390.9427417458637,0.43854166666666666,0.21164840659101736,0.2088751220185044,127717.31190650113,1786.0312170278398,129503.34312352896,1472,0,225.34146341463415,36,5,16,37.41806855317885,0.5972222222222222,47.2972972972973,1010.8108108108111,28.078078078078086,0
3002,4,2,1,42,0.046511627906976744,0.023255813953488372,0.9767441860465116,43,1050,900,150,0.8571428571428571,12,9,3,385.18173999290906,0.4416989664082687,0.12663594225226737,0.20906795620817867,128349.6914250044,1456.665762652523,129806.35718765693,1473,0,215.8139534883721,35,8,18,36.91473919664952,0.6056547619047619,46.67245370370371,1013.3101851851861,28.951719576719604,8
3003,4,0,1,41,0.0,0.023809523809523808,0.9761904761904762,42,1050,600,450,0.5714285714285714,15,6,9,387.1035775259186,0.43931475029036005,0.14629685559918104,0.21045976111466638,128415.880102041,1542.0493197279138,129957.92942176892,1474,1,221.92857142857142,34,8,12,36.79821470519144,0.6084558823529411,46.60714285714287,1013.57142857143,29.81092436974794,0
3004,4,0,0,41,0.0,0.0,1.0,41,1200,700,500,0.5833333333333334,17,7,10,373.98148765037394,0.4373983739837399,0.05135074186878663,0.19995424744713558,127745.77100326675,1354.9106961691382,129100.6816994359,1475,2,228.3170731707317,36,5,16,37.817477999331636,0.5975115740740741,47.26914414414414,1010.9234234234232,28.0812062062062,8
3005,4,1,1,41,0.023809523809523808,0.023809523809523808,0.9761904761904762,42,1100,700,400,0.6363636363636364,15,7,8,364.7012515150416,0.4389276035617499,0.061142320648333026,0.19652990383744004,128061.27997316477,940.8218153662602,129002.10178853103,1476,0,223.85714285714286,37,5,17,37.72873560105442,0.5988175675675675,46.95723684210526,1012.1710526315785,27.35597439544807,0
3006,4,2,1,42,0.046511627906976744,0.023255813953488372,0.9767441860465116,43,1300,900,400,0.6923076923076923,17,9,8,350.41200324357084,0.44239110372831303,0.08296274695633188,0.1914743911403584,128616.79945992974,413.8281730916964,129030.62763302143,1477,0,218.8372093023256,37,6,15,37.5228578892372,0.6044481981981982,46.408991228070164,1014.3640350877174,27.41524419155993,0
3007,4,1,1,42,0.023255813953488372,0.023255813953488372,0.9767441860465116,43,1050,700,350,0.6666666666666666,14,7,7,356.15591360173954,0.44252953119232186,0.08191412658176955,0.19543184897518062,128783.68975309687,573.4145362034212,129357.10428930029,1478,0,219.8139534883721,37,6,16,37.206865975297966,0.6061373873873874,46.24451754385964,1015.0219298245595,27.4330251303935,0
3008,4,0,3,39,0.0,0.07142857142857142,0.9285714285714286,42,950,500,450,0.5263157894736842,14,5,9,356.14722559432585,0.44092382888114595,0.07641341649758271,0.1960150190662458,128902.86138733636,781.6792908539503,129684.54067819031,1479,1,223.23809523809524,38,4,16,37.085525162195324,0.6055372807017544,46.12713675213674,1015.4914529914515,26.723459289248723,0
3009,4,1,1,39,0.025,0.025,0.975,40,1000,700,300,0.7,13,7,6,360.55984552830836,0.4424813034188034,0.08315139088994794,0.19922421838346166,129058.31665702879,1306.649343600373,130364.96600062915,1480,0,232.725,36,4,18,36.81494514019728,0.6108217592592593,45.97409909909911,1016.1036036036047,28.225100100100132,0
3010,4,0,0,39,0.0,0.0,1.0,39,1250,800,450,0.64,17,8,9,369.7446561784435,0.4407613585245164,0.08342534658324108,0.2041269554675713,129024.9445408953,1741.256751543237,130766.20129243853,1481,1,239.51282051282053,35,4,19,36.615686944634305,0.6125,46.00694444444446,1015.9722222222242,29.027777777777835,0
3011,4,0,1,38,0.0,0.02564102564102564,0.9743589743589743,39,1150,800,350,0.6956521739130435,15,8,7,370.6179416732702,0.4404520917678812,0.08554814034266123,0.20568212084674484,129231.6485969388,1779.234083679773,131010.88268061857,1482,2,240.51282051282053,34,5,19,36.38259571478749,0.6167279411764706,45.80357142857143,1016.7857142857146,29.905462184873958,0
3012,4,0,1,37,0.0,0.02631578947368421,0.9736842105263158,38,1050,700,350,0.6666666666666666,14,7,7,352.9015729860985,0.4403449502133712,-0.021237108819345707,0.18992521018888217,128009.3505734532,1434.940234860115,129444.29080831331,1483,3,240.8421052631579,38,0,15,38.08043883727477,0.5964912280701755,47.00854700854701,1011.9658119658123,26.63067926225822,8
3013,4,1,2,36,0.02631578947368421,0.05263157894736842,0.9473684210526316,38,1500,1200,300,0.8,18,12,6,374.09459606577894,0.43834459459459457,0.09043119093810636,0.18839135047384423,125297.79620181398,1828.2385627108565,127126.03476452484,1484,0,241.73684210526315,34,4,18,40.338882282996444,0.576593137254902,49.70238095238095,1001.1904761904756,29.446778711484576,8
3014,4,3,3,36,0.07692307692307693,0.07692307692307693,0.9230769230769231,39,1200,900,300,0.75,15,9,6,371.4529276942284,0.4460470085470085,0.13261305872864027,0.19161364232377745,126290.07623269905,1588.8069933856004,127878.88322608465,1485,0,234.46153846153845,33,6,17,39.379114850036565,0.5890151515151515,48.71323529411765,1005.1470588235302,30.459001782531217,0
3015,4,1,0,37,0.02702702702702703,0.0,1.0,37,1000,800,200,0.8,12,8,4,370.7399368454254,0.4449136636636637,0.130023057234119,0.18336079715206643,124544.68621147993,1881.4295972965451,126426.11580877648,1486,0,227.75675675675674,31,6,20,41.204126445777895,0.5759408602150538,50.45572916666666,998.1770833333325,32.19926075268815,8
3016,4,2,0,39,0.05128205128205128,0.0,1.0,39,1050,700,350,0.6666666666666666,14,7,7,351.48171303711507,0.4488585245164192,0.13133018886236147,0.17654271593993484,125189.4656795224,1001.1923265413266,126190.65800606372,1487,0,217.02564102564102,32,7,24,41.01690638405248,0.580078125,49.810606060606055,1000.757575757575,31.273674242424217,0
3017,4,3,3,39,0.07142857142857142,0.07142857142857142,0.9285714285714286,42,900,700,200,0.7777777777777778,11,7,4,337.7762441046402,0.4543408826945412,0.1858698961469505,0.17459352250353666,126372.79620181394,140.05116681657228,126512.84736863051,1488,0,202.45238095238096,34,8,13,40.14030310206016,0.5876225490196079,48.63095238095237,1005.4761904761895,29.572829131652632,0
3018,4,2,0,41,0.04878048780487805,0.0,1.0,41,1350,1000,350,0.7407407407407407,17,10,7,340.2126003245469,0.45464939024390244,0.18902439024390216,0.17714518154829878,126672.22222222241,419.0972222222423,127091.31944444466,1489,0,204.390243902439,34,7,17,39.77131622516554,0.5906862745098039,48.33333333333334,1006.6666666666682,29.607843137254946,0
3019,4,1,0,42,0.023809523809523808,0.0,1.0,42,1200,1000,200,0.8333333333333334,14,10,4,337.7413969255952,0.4550667828106853,0.20943420966367277,0.17819334234887949,127208.74592764069,192.73191015090327,127401.4778377916,1490,0,200.5,35,7,19,39.283119167813986,0.594047619047619,47.80092592592593,1008.796296296297,28.822751322751344,0
3020,4,1,0,43,0.023255813953488372,0.0,1.0,43,1050,600,450,0.5714285714285714,15,6,9,328.2038561459714,0.45621077888519745,0.21312168269517495,0.17449083495988268,127518.18700034512,-229.6078595487147,127288.5791407964,1491,0,196.8139534883721,36,7,14,39.20703720221505,0.5951967592592593,47.49436936936938,1010.022522522524,28.056181181181223,0
3021,4,1,2,42,0.022727272727272728,0.045454545454545456,0.9545454545454546,44,1700,1200,500,0.7058823529411765,22,12,10,320.2541854368355,0.4562852360817477,0.21412701853256677,0.1721016522437791,127950.3203509737,-604.6748759233292,127345.64547505038,1492,0,193.3181818181818,37,7,16,38.966597124381316,0.5976914414414414,47.066885964912295,1011.7324561403535,27.344120436225772,0
3022,4,1,1,42,0.023255813953488372,0.023255813953488372,0.9767441860465116,43,1050,700,350,0.6666666666666666,14,7,7,327.1576925096387,0.4531423034330011,0.21289607639050656,0.17553945006699992,127888.11404309732,-232.08394205014156,127656.03010104717,1493,0,198.65116279069767,36,7,18,38.855488755288356,0.5989583333333333,47.128378378378386,1011.4864864864878,28.096846846846883,0
3023,4,0,0,42,0.0,0.0,1.0,42,1400,1000,400,0.7142857142857143,18,10,8,336.2770253247549,0.45172764227642276,0.21098322597521513,0.1802692421648901,127851.7299489884,198.71988597394335,128050.44983496235,1494,1,204.21428571428572,35,7,19,38.66206988632028,0.6005952380952381,47.164351851851855,1011.3425925925931,28.89550264550266,0
3024,4,1,0,43,0.023255813953488372,0.0,1.0,43,1200,900,300,0.75,15,9,6,326.09115801638427,0.4527731635289775,0.206808598701399,0.17596395621652455,128116.0277676327,-244.49922895866905,127871.52853867403,1495,0,200.4418604651163,36,7,20,38.649888765294754,0.6012731481481481,46.90315315315316,1012.387387387389,28.121871871871917,0
3025,4,1,1,43,0.022727272727272728,0.022727272727272728,0.9772727272727273,44,1450,900,550,0.6206896551724138,20,9,11,320.86165641139416,0.4529818534178999,0.20761077052044685,0.17450608878301885,128429.74044568237,-558.3609792224428,127871.37946645993,1496,0,196.86363636363637,36,8,14,38.462624523201136,0.6044560185185186,46.59346846846848,1013.6261261261277,28.156281281281323,0
3026,4,1,2,42,0.022727272727272728,0.045454545454545456,0.9545454545454546,44,1350,900,450,0.6666666666666666,18,9,9,321.8719585104136,0.45419309372797745,0.2136835278858622,0.1760023262493114,128644.60699445991,-518.58167897814,128126.02531548178,1497,0,197.8409090909091,37,7,15,38.21831315751549,0.6047297297297297,46.381578947368425,1014.473684210527,27.418207681365594,0
3027,4,1,0,43,0.023255813953488372,0.0,1.0,43,950,300,650,0.3157894736842105,16,3,13,327.65054784514257,0.4548034330011074,0.20695411690760568,0.17891189891189888,128588.99493113253,-173.54907279163996,128415.4458583409,1498,0,202.46511627906978,37,6,17,38.128378378378386,0.6041666666666667,46.436403508771924,1014.2543859649113,27.41228070175436,0
3028,4,1,1,43,0.022727272727272728,0.022727272727272728,0.9772727272727273,44,900,400,500,0.4444444444444444,14,4,10,319.89031565610924,0.4558998414376321,0.20853336648623877,0.17618061069681185,128929.98598327112,-551.3092172547397,128378.67676601639,1499,0,198.8409090909091,38,6,20,37.978425906445054,0.6058114035087719,46.100427350427346,1015.5982905982896,26.72627080521815,0
3029,4,1,2,42,0.022727272727272728,0.045454545454545456,0.9545454545454546,44,1400,1100,300,0.7857142857142857,17,11,6,312.76965432969257,0.4548317477096547,0.20571648358109496,0.17405903318635593,129340.77222077924,-708.6555626425509,128632.11665813669,1500,0,196.75,37,7,22,37.74242301749846,0.6117680180180181,45.69627192982455,1017.2149122806999,27.4922949265054,0
3030,4,1,0,43,0.023255813953488372,0.0,1.0,43,1150,700,450,0.6086956521739131,16,7,9,319.8671831765358,0.4545035068290882,0.208048802460715,0.17828500925354704,129401.82317029855,-321.7206649216937,129080.10250537685,1501,0,201.37209302325581,36,7,23,37.49999999999998,0.6142939814814814,45.636261261261254,1017.454954954954,28.26263763763761,0
3031,4,0,0,43,0.0,0.0,1.0,43,1400,1200,200,0.8571428571428571,16,12,4,323.0493400139404,0.45429586563307495,0.20732940120330445,0.18084762124247886,129573.74762854064,-228.25726909341924,129345.49035944723,1502,1,202.37209302325581,36,7,17,37.244681635512315,0.6160300925925926,45.46734234234234,1018.1306306306301,28.28140640640639,0
3032,4,0,1,42,0.0,0.023255813953488372,0.9767441860465116,43,850,500,350,0.5882352941176471,12,5,7,321.9132582775144,0.4546419342930971,0.20360088363349305,0.18047499036599873,129631.08114448898,-254.0072589481481,129377.07388554084,1503,2,203.37209302325581,36,7,17,37.21547974492238,0.6166087962962963,45.41103603603603,1018.355855855855,28.28766266266264,0
3033,4,2,2,42,0.045454545454545456,0.045454545454545456,0.9545454545454546,44,700,300,400,0.42857142857142855,11,3,8,289.7744019583579,0.4552832100070472,0.13017645186229498,0.15975152496270212,128969.0239461466,-1324.081169307586,127644.94277683902,1504,0,198.95454545454547,40,4,19,38.703518425879594,0.6028645833333333,46.06199186991871,1015.7520325203262,25.393800813008156,8
3034,4,1,0,43,0.023255813953488372,0.0,1.0,43,1600,1200,400,0.75,20,12,8,294.5543817770058,0.4538344407530454,0.13550511589755332,0.1625800161556956,129016.12548828137,-999.5469835069279,128016.57850477444,1505,0,204.04651162790697,39,4,20,38.534403944085604,0.6049679487179487,46.01562500000001,1015.9375000000009,26.04967948717951,0
3035,4,0,1,42,0.0,0.023255813953488372,0.9767441860465116,43,1150,900,250,0.782608695652174,14,9,5,298.9787691480788,0.45330380214101146,0.1387723980175377,0.16579731743666165,129201.38888888876,-874.1726345486206,128327.21625434014,1506,1,205.04651162790697,38,5,21,38.234289617486354,0.6085526315789473,45.83333333333333,1016.6666666666656,26.754385964912252,0
3036,4,2,1,43,0.045454545454545456,0.022727272727272728,0.9772727272727273,44,1350,900,450,0.6666666666666666,18,9,9,329.49555555555577,0.45360949612403095,0.14669191919191937,0.17907367149758457,128401.20525931334,-234.30804114925832,128166.89721816409,1507,0,200.25,36,8,15,38.272916666666674,0.6041666666666667,46.62162162162162,1013.5135135135133,28.15315315315315,8
3037,4,1,2,42,0.022727272727272728,0.045454545454545456,0.9545454545454546,44,1200,700,500,0.5833333333333334,17,7,10,335.09175332820644,0.4535103946441155,0.16758430311777683,0.18303040765476997,128601.01814229779,-181.3718701809857,128419.6462721168,1508,0,201.1818181818182,36,8,16,37.927445320306425,0.6061921296296297,46.42454954954955,1014.3018018018025,28.17505005005007,0
3038,4,0,2,40,0.0,0.047619047619047616,0.9523809523809523,42,1450,1100,350,0.7586206896551724,18,11,7,351.12854024681303,0.45227206736353076,0.16027105223085103,0.1907246587097454,128379.01341735257,615.5071159122098,128994.52053326479,1509,1,210.8095238095238,35,7,16,37.74744936805238,0.605952380952381,46.64351851851852,1013.4259259259262,28.955026455026463,0
3039,4,1,1,40,0.024390243902439025,0.024390243902439025,0.975609756097561,41,1000,500,500,0.5,15,5,10,360.062944647831,0.44951727642276423,0.1775616629008845,0.19620320534648603,128506.39349489796,1054.078089569167,129560.47158446713,1510,0,216.4390243902439,34,7,18,37.39090446557866,0.609375,46.517857142857146,1013.9285714285714,29.821428571428573,0
3040,4,0,0,40,0.0,0.0,1.0,40,1200,1000,200,0.8333333333333334,14,10,4,365.8184634279805,0.4478365384615384,0.17928655314151487,0.19903796907918567,128446.04768990948,1397.5871598639671,129843.63484977344,1511,1,222.525,34,6,18,37.30671364259152,0.6087622549019608,46.57738095238096,1013.6904761904776,29.814425770308166,0
3041,4,0,0,40,0.0,0.0,1.0,40,1350,900,450,0.6666666666666666,18,9,9,366.72204589036556,0.4467815170940171,0.18368544600938996,0.20028665583243066,128596.93877551034,1431.8664965986586,130028.80527210899,1512,2,223.525,34,6,19,37.12954812206574,0.6102941176470589,46.42857142857144,1014.2857142857154,29.831932773109276,0
3042,4,0,1,39,0.0,0.025,0.975,40,850,500,350,0.5882352941176471,12,5,7,368.6222804619269,0.44619391025641025,0.18522167487684715,0.20224411603721953,128778.12500000013,1494.0972222222372,130272.22222222236,1513,3,224.525,34,6,20,36.896209633278595,0.6121323529411764,46.25000000000001,1015.000000000001,29.85294117647062,0
3043,4,0,0,39,0.0,0.0,1.0,39,650,300,350,0.46153846153846156,10,3,7,368.6222804619269,0.44719973009446695,0.1756557618626584,0.20224411603721953,128778.12500000013,1694.0972222222372,130472.22222222236,1514,4,221.05128205128204,34,5,20,36.896209633278595,0.6121323529411764,46.25000000000001,1015.000000000001,29.85294117647062,0
3044,4,0,1,38,0.0,0.02564102564102564,0.9743589743589743,39,850,400,450,0.47058823529411764,13,4,9,370.99896969032136,0.4472559604138551,0.17210407858480026,0.20463698825905072,128989.67013888899,1771.0069444444537,130760.67708333344,1515,5,222.05128205128204,34,5,20,36.61983866557286,0.6142769607843137,46.04166666666667,1015.8333333333342,29.877450980392183,0
3045,4,0,0,38,0.0,0.0,1.0,38,1300,800,500,0.6153846153846154,18,8,10,375.52449186307473,0.4457236842105263,0.16347874375269922,0.20665960745755027,128898.98667800463,2080.9452947845925,130979.93197278921,1516,6,228.26315789473685,34,4,20,36.59754787026183,0.6133578431372548,46.13095238095239,1015.4761904761912,29.866946778711505,0
3046,4,1,0,39,0.02564102564102564,0.0,1.0,39,900,500,400,0.5555555555555556,13,5,8,406.357370371841,0.4460470085470085,0.2514704139612922,0.212807025426578,126906.72607891186,2528.9548049611885,129435.68088387305,1517,0,223.3846153846154,33,6,17,37.86436795589069,0.5953282828282829,48.100490196078425,1007.5980392156855,30.533273915626832,8
3047,4,4,1,42,0.09302325581395349,0.023255813953488372,0.9767441860465116,43,1200,700,500,0.5833333333333334,17,7,10,370.1236276356153,0.45166574381690666,0.26482827968183464,0.20077260642490252,128325.39859693873,905.5300428995083,129230.92863983824,1518,0,203.51162790697674,34,9,19,37.32106489640858,0.6075367647058824,46.69642857142857,1013.2142857142853,29.800420168067216,0
3048,4,1,1,42,0.023255813953488372,0.023255813953488372,0.9767441860465116,43,1600,1000,600,0.625,22,10,12,370.24702494904784,0.45182724252491696,0.2835828633328694,0.20267279342586644,128687.5159438778,929.2339852608038,129616.7499291386,1519,0,204.2325581395349,34,9,17,36.94757323321209,0.6112132352941176,46.33928571428573,1014.6428571428592,29.842436974789976,0
3049,4,1,0,43,0.023255813953488372,0.0,1.0,43,1900,1500,400,0.7894736842105263,23,15,8,366.45856453045434,0.4513658176448874,0.28039446570503324,0.20197832510166938,128959.43877551044,851.65816326533,129811.09693877577,1520,0,205.1860465116279,34,9,18,36.76599859353025,0.6139705882352942,46.071428571428584,1015.7142857142876,29.873949579831987,0
3050,4,0,0,43,0.0,0.0,1.0,43,1000,700,300,0.7,13,7,6,367.9360186474999,0.4511812476928756,0.28359286658219873,0.20325785884507544,129050.14349489806,896.4392006802809,129946.58269557834,1521,1,206.1860465116279,34,9,18,36.635910954891614,0.6148897058823529,45.98214285714286,1016.0714285714294,29.88445378151263,0
3051,4,0,0,43,0.0,0.0,1.0,43,1400,1200,200,0.8571428571428571,16,12,4,367.66067930856883,0.450812107788852,0.28226376717172164,0.20342964240759565,129113.15164448306,893.9658082561818,130007.11745273924,1522,2,207.1860465116279,35,8,19,36.57862145541511,0.6133928571428571,45.92013888888889,1016.3194444444447,29.03769841269842,0
3052,4,1,1,43,0.022727272727272728,0.022727272727272728,0.9772727272727273,44,1300,1000,300,0.7692307692307693,16,10,6,360.2705894733,0.45148431994362226,0.27999114652501067,0.20095092879510784,129430.46932067239,525.9982955929295,129956.46761626532,1523,0,203.45454545454547,36,8,16,36.4431164231961,0.6145833333333333,45.60810810810813,1017.5675675675706,28.26576576576585,0
3053,4,0,0,43,0.0,0.0,1.0,43,1450,1000,450,0.6896551724137931,19,10,9,368.7384356828701,0.45099667774086377,0.28719924632956095,0.2050932514418397,129319.08543381363,936.9834533607886,130256.06888717442,1524,4,209.1860465116279,35,8,19,36.34122287968441,0.6154761904761905,45.7175925925926,1017.1296296296312,29.060846560846603,0
3054,4,0,0,43,0.0,0.0,1.0,43,1650,1200,450,0.7272727272727273,21,12,9,372.57118432232005,0.4500968992248062,0.289495608293066,0.20800116976166114,129466.28146701398,1047.0811631944541,130513.36263020843,1525,5,210.1860465116279,35,8,16,36.0936966905493,0.6169642857142856,45.57291666666667,1017.708333333334,29.077380952380974,0
3055,4,1,2,42,0.022727272727272728,0.045454545454545456,0.9545454545454546,44,1000,700,300,0.7,13,7,6,360.10842159885203,0.45120903805496826,0.2815218483174282,0.20292535588229235,129831.84831791274,550.7083942050422,130382.55671211777,1526,0,206.38636363636363,36,8,17,36.03890423572744,0.6186342592592593,45.21396396396398,1019.144144144146,28.309559559559613,0
3056,4,0,0,42,0.0,0.0,1.0,42,1150,800,350,0.6956521739130435,15,8,7,380.9586497089067,0.44836430507162217,0.2967225711612991,0.21321717096273388,129564.73922902513,1471.761621315218,131036.50085034035,1527,1,216.5952380952381,34,8,17,35.77988579669474,0.6200980392156863,45.47619047619049,1018.0952380952396,29.943977591036457,0
3057,4,0,0,42,0.0,0.0,1.0,42,1250,700,550,0.56,18,7,11,374.7351825150628,0.44786827332559037,0.29084017898884684,0.21038282293955918,129685.96938775528,1319.5790816326773,131005.54846938796,1528,2,217.5952380952381,34,8,17,35.81477910238431,0.6213235294117647,45.35714285714287,1018.5714285714299,29.95798319327735,0
3058,4,2,0,44,0.045454545454545456,0.0,1.0,44,1300,1100,200,0.8461538461538461,15,11,4,360.4516328838289,0.4485222868217054,0.2878462319803097,0.20507847181434496,130206.62607725472,586.6381963681326,130793.26427362286,1529,0,208.6590909090909,37,7,19,35.64944134078213,0.6204954954954955,44.846491228070185,1020.6140350877208,27.58416311047894,0
3059,4,0,2,42,0.0,0.045454545454545456,0.9545454545454546,44,1050,500,550,0.47619047619047616,16,5,11,359.55898380623086,0.44811486962649755,0.2859685538375141,0.20501646208725144,130291.3280679332,569.4955267042244,130860.82359463742,1530,1,209.6590909090909,36,8,19,35.586256342378135,0.6232638888888888,44.76351351351354,1020.9459459459492,28.359609609609702,0
3060,4,0,1,41,0.0,0.023809523809523808,0.9761904761904762,42,1200,600,600,0.5,18,6,12,371.85983766636053,0.4471423732094464,0.2856035939718897,0.21171284108325608,130233.0504785024,1285.6882019461782,131518.7386804486,1531,2,217.35714285714286,35,7,19,35.331504894734856,0.624702380952381,44.82060185185186,1020.7175925925939,29.163359788359823,0
3061,4,0,0,41,0.0,0.0,1.0,41,1100,600,500,0.5454545454545454,16,6,10,378.1958227175893,0.4464939024390244,0.2939775433821026,0.21499371817543456,130173.98787133509,1646.2516878858298,131820.23955922094,1532,3,223.14634146341464,35,6,19,35.22988261313372,0.6241071428571429,44.878472222222236,1020.4861111111128,29.15674603174608,0
3062,4,0,1,40,0.0,0.024390243902439025,0.975609756097561,41,1350,800,550,0.5925925925925926,19,8,11,381.14371047649615,0.4458587398373984,0.29849540887853765,0.21750296771503055,130323.3577806123,1734.4157700696114,132057.77355068192,1533,4,224.14634146341464,34,7,19,35.00276903346158,0.6277573529411764,44.73214285714286,1021.0714285714291,30.031512605042032,0
3063,4,0,1,39,0.0,0.025,0.975,40,1300,900,400,0.6923076923076923,17,9,8,382.29564912662596,0.4455929487179487,0.2892174571728239,0.21884449400637604,130444.94224773246,1973.7067743764221,132418.64902210888,1534,5,227.3,34,6,19,34.849764984656034,0.6289828431372548,44.61309523809524,1021.5476190476193,30.04551820728292,0
3064,4,0,0,39,0.0,0.0,1.0,39,700,400,300,0.5714285714285714,10,4,6,385.9063100397317,0.44610323886639675,0.28342023902911717,0.22076383625128101,130419.01139285375,2265.903889129185,132684.91528198292,1535,6,230.69230769230768,33,6,20,34.78391821635674,0.6309974747474747,44.638480392156865,1021.4460784313728,30.95291146761736,0
3065,4,0,0,39,0.0,0.0,1.0,39,1300,900,400,0.6923076923076923,17,9,8,389.12234500231204,0.4457658569500675,0.28731358202390966,0.2229630921157577,130481.60750973185,2354.6618187716285,132836.2693285035,1536,7,231.69230769230768,33,6,20,34.63813422094278,0.6316287878787878,44.57720588235294,1021.6911764705883,30.960338680926917,0
3066,4,0,0,39,0.0,0.0,1.0,39,1200,900,300,0.75,15,9,6,389.5777984941711,0.4448099415204678,0.2838908897609109,0.22388989142375862,130597.00255102053,2375.538548752852,132972.54109977337,1537,8,232.69230769230768,34,5,17,34.509181613479306,0.6305147058823529,44.46428571428572,1022.1428571428581,30.063025210084064,0
3067,4,0,0,39,0.0,0.0,1.0,39,1250,800,450,0.64,17,8,9,392.8423665600339,0.4445287899235268,0.22828838932218676,0.22202214649404187,129946.64216581461,2411.750103316244,132358.39226913085,1538,9,233.69230769230768,36,3,21,35.08785251454239,0.6197916666666667,45.10135135135136,1019.5945945945958,28.322072072072107,8
3068,4,0,0,39,0.0,0.0,1.0,39,1000,700,300,0.7,13,7,6,392.5995388974811,0.4442757534862798,0.2269509568328425,0.2227025186519902,130090.20580969492,2414.6709631929334,132504.87677288786,1539,10,234.69230769230768,36,3,21,34.94774993560732,0.6212384259259259,44.96058558558559,1020.1576576576583,28.33771271271273,0
3069,4,1,0,40,0.025,0.0,1.0,40,1350,1000,350,0.7407407407407407,17,10,7,381.78829902676245,0.4440571581196581,0.22617253880140487,0.2186921035372637,130469.43486636235,1962.5689913316476,132432.003857694,1540,0,229.8,35,5,22,34.83783184169782,0.6270833333333333,44.589120370370374,1021.6435185185189,29.189814814814827,0
3070,4,0,1,39,0.0,0.025,0.975,40,1000,800,200,0.8,12,8,4,381.97948156252056,0.4441239316239316,0.23244054360135924,0.2193029143171038,130558.13426997601,1974.1056884430761,132532.2399584191,1541,1,230.8,35,5,17,34.742827482068705,0.6279761904761905,44.50231481481482,1021.9907407407409,29.199735449735453,0
3071,4,0,0,39,0.0,0.0,1.0,39,1250,1000,250,0.8,15,10,5,388.92828228492556,0.44337606837606836,0.2365070826609288,0.22246697746697755,130414.54081632658,2344.3806689342478,132758.92148526083,1542,13,237.69230769230768,34,5,21,34.71129564879565,0.6286764705882353,44.642857142857146,1021.4285714285718,30.0420168067227,0
3072,4,1,1,39,0.025,0.025,0.975,40,950,700,250,0.7368421052631579,12,7,5,382.7030031939544,0.44477831196581197,0.24205509673039982,0.2212368767319399,130824.41332572438,2013.3791741683756,132837.79249989276,1543,0,232.725,35,5,18,34.45395878115925,0.6306547619047619,44.241898148148145,1023.0324074074068,29.229497354497337,0
3073,4,0,0,39,0.0,0.0,1.0,39,1000,600,400,0.6,14,6,8,389.1022716421393,0.4441632928475034,0.24442495615134052,0.22538565546063555,130901.38888888896,2386.8055555555657,133288.19444444453,1544,1,237.51282051282053,34,5,18,34.212133550488595,0.633578431372549,44.16666666666667,1023.3333333333339,30.098039215686292,0
3074,4,0,0,39,0.0,0.0,1.0,39,1200,700,500,0.5833333333333334,17,7,10,387.0138757659451,0.44379779577148,0.23904985970342407,0.22470846169556805,130992.77388038553,2339.2042233560164,133331.97810374154,1545,2,238.51282051282053,34,5,20,34.1728204830019,0.6344975490196079,44.077380952380956,1023.6904761904766,30.10854341736696,0
3075,4,0,0,39,0.0,0.0,1.0,39,1200,1000,200,0.8333333333333334,14,10,4,387.2923949262451,0.4434322986954566,0.23825752306765025,0.22544494146759309,131090.96364883397,2354.1066529492437,133445.0703017832,1546,3,239.51282051282053,35,4,20,34.06607896323087,0.6333333333333333,43.98148148148148,1024.0740740740737,29.25925925925925,0
3076,4,0,0,39,0.0,0.0,1.0,39,1050,800,250,0.7619047619047619,13,8,5,388.34685410717316,0.44275753486279806,0.2051282051282053,0.2139584775316185,128943.91593874284,2266.5403187847583,131210.4562575276,1547,4,240.51282051282053,36,3,16,36.226069039435274,0.6096643518518519,46.086711711711715,1015.6531531531534,28.212587587587596,8
3077,4,0,0,39,0.0,0.0,1.0,39,1100,700,400,0.6363636363636364,15,7,8,390.5699903604667,0.44213900134952766,0.20659973751044025,0.21627513699347087,129144.15048494452,2287.9659220031003,131432.1164069476,1548,5,241.51282051282053,36,3,16,35.96485153999557,0.6116898148148149,45.88963963963965,1016.4414414414424,28.23448448448451,0
3078,4,1,0,40,0.025,0.0,1.0,40,1300,800,500,0.6153846153846154,18,8,10,381.8980705481049,0.44264155982905984,0.09265309613410899,0.20943490810733778,128760.50407503854,1884.8174918654495,130645.321566904,1549,0,236.45,35,5,15,36.577360588436534,0.6098214285714285,46.26736111111111,1014.9305555555552,28.998015873015863,8
3079,4,1,0,41,0.024390243902439025,0.0,1.0,41,1400,1200,200,0.8571428571428571,16,12,4,374.7742261086953,0.44390243902439025,0.09364816005793619,0.20752835367221345,129144.15048494424,1479.979810891959,130624.1302958362,1550,0,231.65853658536585,36,5,19,36.3662382746141,0.6116898148148149,45.88963963963963,1016.4414414414401,28.234484484484447,0
3080,4,0,1,40,0.0,0.024390243902439025,0.975609756097561,41,1000,600,400,0.6,14,6,8,373.8512872200248,0.4438770325203252,0.08722302110341817,0.20762689061410464,129260.23046339153,1464.8333906197072,130725.06385401124,1551,1,232.65853658536585,35,6,20,36.27124592154183,0.6148809523809524,45.775462962962955,1016.8981481481474,29.054232804232782,0
3081,4,0,1,39,0.0,0.025,0.975,40,1150,800,350,0.6956521739130435,15,8,7,375.93033918559354,0.4424813034188034,0.10041539901708418,0.20943289952282174,129383.00028344683,1727.7990362811947,131110.79931972802,1552,2,237.95,34,6,20,36.09315274202357,0.6182598039215687,45.65476190476191,1017.3809523809534,29.9229691876751,0
3082,4,0,0,39,0.0,0.0,1.0,39,850,600,250,0.7058823529411765,11,6,5,371.6020003993184,0.44137989203778677,0.12217494430101161,0.2078200592161265,129534.44054705223,1827.0514455782436,131361.49199263047,1553,3,244.23076923076923,34,5,16,36.04890266245665,0.6197916666666667,45.50595238095239,1017.976190476191,29.940476190476208,0
3083,4,0,0,39,0.0,0.0,1.0,39,900,500,400,0.5555555555555556,13,5,8,372.2158883073335,0.4410706252811516,0.12190054771605108,0.20848477358825288,129595.04145408161,1847.4666950113335,131442.50814909296,1554,4,245.23076923076923,34,5,16,35.97154020031958,0.6204044117647058,45.44642857142857,1018.2142857142854,29.94747899159663,0
3084,4,0,1,38,0.0,0.02564102564102564,0.9743589743589743,39,1350,1000,350,0.7407407407407407,17,10,7,370.9816397472303,0.4403396311291048,0.12722527365509717,0.2084366310779417,129716.28578514747,1824.472080498874,131540.75786564633,1555,5,246.23076923076923,34,5,17,35.87949437108021,0.6216299019607843,45.327380952380956,1018.6904761904768,29.961484593837554,0
3085,4,0,0,38,0.0,0.0,1.0,38,1250,900,350,0.72,16,9,7,380.05640461159777,0.43923364153627314,0.13109132475033092,0.21327810794915517,129669.02941476837,2256.3090217704757,131925.33843653885,1556,7,253.57894736842104,33,5,18,35.696541731841336,0.6234217171717171,45.37377450980392,1018.5049019607844,30.86378490790256,0
3086,4,0,1,37,0.0,0.02631578947368421,0.9736842105263158,38,900,500,400,0.5555555555555556,13,5,8,382.93214098889916,0.43861130867709813,0.1259082048555733,0.215749572118136,129825.09731833916,2342.8404940407654,132167.93781237994,1557,8,254.57894736842104,33,5,19,35.46426567259902,0.625,45.22058823529412,1019.117647058824,30.882352941176485,0
3087,4,0,1,36,0.0,0.02702702702702703,0.972972972972973,37,1300,900,400,0.6923076923076923,17,9,8,379.55610104189003,0.4364677177177177,0.12191196334120225,0.21441414573369053,129928.59977324275,2463.038548752853,132391.6383219956,1558,9,260.13513513513516,34,3,20,35.44488556749185,0.6237745098039216,45.11904761904763,1019.5238095238104,29.98599439775913,0
3088,4,1,0,37,0.02702702702702703,0.0,1.0,37,950,600,350,0.631578947368421,13,6,7,378.0285497197714,0.4363113113113113,0.13518244583713113,0.21438296773982282,130080.3589143992,2434.8178854875423,132515.17679988674,1559,0,260.3243243243243,34,3,21,35.329384992414525,0.6253063725490196,44.9702380952381,1020.1190476190485,30.00350140056025,0
3089,4,1,1,37,0.02631578947368421,0.02631578947368421,0.9736842105263158,38,1150,700,450,0.6086956521739131,16,7,9,375.91406683120516,0.43625533428165003,0.1359776933883836,0.21485454892371178,130384.14292800473,2202.7742346938994,132586.91716269864,1560,0,254.44736842105263,34,4,22,35.07450363290205,0.6283700980392157,44.67261904761906,1021.3095238095254,30.038515406162514,0
3090,4,1,1,37,0.02631578947368421,0.02631578947368421,0.9736842105263158,38,1200,900,300,0.75,15,9,6,373.62541603026693,0.4371591986723566,0.14189561955202445,0.21472207644149086,130597.00255102053,2158.871882086184,132755.8744331067,1561,0,254.60526315789474,34,4,16,34.91682195822656,0.6305147058823529,44.46428571428572,1022.1428571428581,30.063025210084064,0
3091,4,0,0,37,0.0,0.0,1.0,37,750,400,350,0.5333333333333333,11,4,7,381.5308851647317,0.43640515515515516,0.14260517715412102,0.2184369133745335,130450.30757401013,2554.1642637447308,133004.47183775486,1562,1,262.4594594594595,33,4,22,34.863843570057576,0.6313131313131313,44.60784313725491,1021.5686274509816,30.956625074272168,0
3092,4,0,0,37,0.0,0.0,1.0,37,1100,800,300,0.7272727272727273,14,8,6,382.231193462496,0.4355292792792793,0.1418497634324971,0.21954601607969831,130575.52984429078,2582.0081218762143,133157.537966167,1563,2,263.4594594594595,33,4,16,34.71872501998401,0.6325757575757576,44.485294117647065,1022.0588235294127,30.971479500891295,0
3093,4,1,0,38,0.02631578947368421,0.0,1.0,38,1400,1100,300,0.7857142857142857,17,11,6,371.79956882664504,0.4357959933617828,0.14329072341641047,0.21576085214585636,130972.46334876552,2139.1010802469264,133111.56442901245,1564,0,257.5,35,3,20,34.58276797829037,0.6321428571428571,44.09722222222223,1023.6111111111119,29.24603174603177,0
3094,4,0,0,38,0.0,0.0,1.0,38,1000,500,500,0.5,15,5,10,373.12956047112885,0.4347884068278805,0.14631578947368373,0.2175360085750654,131150.233892747,2187.205825617291,133337.4397183643,1565,1,258.5,35,3,21,34.36864406779661,0.6339285714285714,43.923611111111114,1024.305555555556,29.26587301587303,0
3095,4,0,0,38,0.0,0.0,1.0,38,1250,800,450,0.64,17,8,9,372.01203757153604,0.43514402560455195,0.1414061245964795,0.2173876282918024,131239.1643759644,2164.5097897376436,133403.67416570205,1566,2,259.5,35,3,21,34.307226363944416,0.6348214285714286,43.83680555555555,1024.652777777777,29.275793650793627,0
3096,4,0,0,38,0.0,0.0,1.0,38,950,700,250,0.7368421052631579,12,7,5,373.0424154278214,0.4344179706021811,0.14353919655648562,0.21868096540494442,131360.48179076106,2200.6967062512676,133561.17849701233,1567,3,260.5,32,6,21,34.15804491521946,0.6429036458333333,43.71843434343434,1025.126262626262,32.035195707070685,0
3097,4,0,0,38,0.0,0.0,1.0,38,1500,1300,200,0.8666666666666667,17,13,4,376.3033166314221,0.4325213371266003,0.13867031920887474,0.22209274177658428,131619.4795971074,2305.769341138651,133925.24893824605,1568,4,261.5,32,6,18,33.812446167097335,0.6455078125,43.465909090909086,1026.136363636363,32.066761363636346,0
3098,4,1,0,39,0.02564102564102564,0.0,1.0,39,650,400,250,0.6153846153846154,9,4,5,368.8180339395998,0.4330578047683311,0.13592031110279335,0.21968726369445707,131969.53124999988,1934.5486111110977,133904.07986111098,1569,0,255.76923076923077,34,5,19,33.65098675317653,0.6443014705882353,43.12499999999999,1027.499999999999,30.22058823529409,0
3099,4,1,1,39,0.025,0.025,0.975,40,1200,800,400,0.6666666666666666,16,8,8,357.0627079011052,0.4344818376068376,0.08384096147513986,0.21056299881469087,131587.96623904322,1422.0311105024084,133009.99734954562,1570,0,250.35,36,4,13,34.33784253466505,0.6362847222222222,43.49662162162163,1026.0135135135145,28.500375375375402,8
3100,4,1,0,40,0.025,0.0,1.0,40,1150,1000,150,0.8695652173913043,13,10,3,356.628981131053,0.4323450854700855,0.08952232093890533,0.21126617420219704,131761.33639974444,1397.9822305413657,133159.3186302858,1571,0,251.1,36,4,15,34.174024715732514,0.6380208333333333,43.32770270270271,1026.68918918919,28.519144144144168,0
3101,4,0,1,39,0.0,0.025,0.975,40,1250,1100,150,0.88,14,11,3,354.5120054549053,0.4314636752136752,0.08370518583488651,0.21065172649864455,131876.97991488132,1350.3945245921823,133227.3744394735,1572,1,252.1,36,4,15,34.111756751818156,0.6391782407407407,43.2150900900901,1027.1396396396412,28.5316566566567,0
3102,4,1,0,40,0.025,0.0,1.0,40,1350,900,450,0.6666666666666666,18,9,9,347.87980283959735,0.4325053418803419,0.09863347573666359,0.20797607859349626,132108.41912436092,1191.5701596867257,133299.98928404765,1573,0,252.75,36,4,17,34.049001351005955,0.6414930555555556,42.98986486486487,1028.0405405405413,28.556681681681702,0
3103,4,0,1,39,0.0,0.025,0.975,40,1150,800,350,0.6956521739130435,15,8,7,347.7877450359185,0.43203792735042734,0.09882594417077151,0.2088784385866615,132282.1316882764,1201.220857682033,133483.35254595842,1574,1,253.75,36,4,17,33.87657361795293,0.6432291666666667,42.82094594594596,1028.7162162162183,28.575450450450507,0
3104,4,0,0,39,0.0,0.0,1.0,39,1150,1000,150,0.8695652173913043,13,10,3,371.59647910671725,0.43165204678362573,0.08883443921807088,0.21627015651393652,131084.19075963713,1989.342734902572,133073.5334945397,1575,2,245.07692307692307,34,5,21,34.474782996202435,0.6354166666666667,43.988095238095234,1024.0476190476186,30.119047619047606,8
3105,4,0,0,39,0.0,0.0,1.0,39,900,600,300,0.6666666666666666,12,6,6,371.6441047318311,0.43125843454790824,0.09022018873320015,0.21733100907144012,131267.12018140565,1956.9302721088163,133224.05045351447,1576,3,246.07692307692307,34,5,21,34.288355793060724,0.6372549019607843,43.809523809523796,1024.7619047619028,30.140056022408906,0
3106,4,0,0,39,0.0,0.0,1.0,39,1000,700,300,0.7,13,7,6,374.688332864157,0.43100539811066124,0.08884885032112577,0.22018202032354395,131453.76778162242,2050.852792097227,133504.62057371964,1577,4,247.07692307692307,33,6,21,34.02147068196304,0.6414141414141414,43.627450980392155,1025.4901960784312,31.075460487225186,0
3107,4,0,1,38,0.0,0.02564102564102564,0.9743589743589743,39,1400,1100,300,0.7857142857142857,17,11,6,376.4966344477518,0.43089293747188484,0.0859132107489533,0.22179122638720153,131548.0392907776,2105.478812235685,133653.5181030133,1578,5,248.07692307692307,33,6,21,33.879738581611136,0.6423611111111112,43.53553921568628,1025.8578431372553,31.086601307189554,0
3108,4,0,0,38,0.0,0.0,1.0,38,1300,900,400,0.6923076923076923,17,9,8,384.1812468150163,0.42995791844476056,0.09428312159709651,0.22540113613713375,131392.84256708494,2495.7332159983644,133888.5757830833,1579,6,255.42105263157896,32,6,21,33.83979885057472,0.6432291666666667,43.686868686868685,1025.252525252525,32.039141414141405,0
3109,4,0,1,37,0.0,0.02631578947368421,0.9736842105263158,38,1250,800,450,0.64,17,8,9,378.7773650410902,0.4293355855855856,0.09065766804409492,0.2233631979915746,131587.09092184468,2368.4423145597398,133955.53323640442,1580,7,256.42105263157896,32,6,19,33.781739683321035,0.6451822916666667,43.49747474747475,1026.010101010101,32.062815656565654,0
3110,4,0,0,37,0.0,0.0,1.0,37,1400,1100,300,0.7857142857142857,17,11,6,375.4157021302084,0.4281156156156156,0.09995290109875943,0.222435131007559,131768.1375552672,2493.565575740099,134261.7031310073,1581,8,261.86486486486484,33,4,19,33.68494867510145,0.6445707070707071,43.32107843137255,1026.7156862745096,31.112596553773017,0
3111,4,0,0,37,0.0,0.0,1.0,37,700,600,100,0.8571428571428571,8,6,2,375.2396542089288,0.4266766766766767,0.10648964603396216,0.22325294685830013,131925.4632382977,2500.733041378309,134426.19627967602,1582,9,262.86486486486484,33,4,20,33.530533023181825,0.6461489898989898,43.16789215686274,1027.3284313725485,31.131164587046925,0
3112,4,0,1,36,0.0,0.02702702702702703,0.972972972972973,37,1350,900,450,0.6666666666666666,18,9,9,376.4807033600977,0.42627002002002,0.11199535850698661,0.22436323366555935,131988.41979346887,2538.218623846603,134526.63841731547,1583,10,263.86486486486484,33,4,20,33.43507751937985,0.646780303030303,43.106617647058826,1027.5735294117649,31.13859180035651,0
3113,4,0,1,35,0.0,0.027777777777777776,0.9722222222222222,36,850,700,150,0.8235294117647058,10,7,3,378.1878535569427,0.4257936507936508,0.11919235335052614,0.22627359967040306,132138.240437838,2794.615504795434,134932.8559426334,1584,11,269.55555555555554,32,4,20,33.239950468705224,0.6507161458333333,42.96085858585859,1028.1565656565658,32.12989267676768,0
3114,4,0,0,35,0.0,0.0,1.0,35,1000,800,200,0.8,12,8,4,388.00618774306406,0.4236344537815126,0.126496469310158,0.2308724601276603,131929.3975830078,3237.884521484375,135167.2821044922,1585,12,277.85714285714283,31,4,20,33.19866920152093,0.6512096774193548,43.1640625,1027.34375,33.140120967741936,0
3115,4,0,0,35,0.0,0.0,1.0,35,850,500,350,0.5882352941176471,12,5,7,372.6469428147296,0.42394957983193277,0.10110002558199027,0.20839440621785107,129532.54699707043,2671.9190809461948,132204.46607801662,1586,13,278.85714285714283,31,4,20,36.02423893578921,0.627016129032258,45.50781250000001,1017.9687500000009,32.83770161290325,8
3116,4,0,0,35,0.0,0.0,1.0,35,900,600,300,0.6666666666666666,12,6,6,372.867752949616,0.4233543417366947,0.10243483661205177,0.2090465014923978,129631.97708129896,2667.116800944024,132299.09388224297,1587,14,279.85714285714283,31,4,20,35.91732195371435,0.6280241935483871,45.41015625000001,1018.359375000001,32.85030241935487,0
3117,4,0,0,35,0.0,0.0,1.0,35,750,500,250,0.6666666666666666,10,5,5,369.3109346314208,0.4230392156862745,0.10119777972538713,0.20757821498248838,129731.4453125001,2582.248263888903,132313.693576389,1588,15,280.85714285714283,31,4,20,35.906612133606,0.6290322580645161,45.31250000000001,1018.7500000000008,32.86290322580648,0
3118,4,0,1,34,0.0,0.02857142857142857,0.9714285714285714,35,1200,800,400,0.6666666666666666,16,8,8,369.8953507388337,0.42247899159663865,0.09932685115931195,0.20914443982930017,129963.68620130757,2614.5926581488816,132578.27885945645,1589,16,281.85714285714283,31,4,21,35.655434597539696,0.6313844086021505,45.08463541666667,1019.6614583333339,32.8923051075269,0
3119,4,0,0,34,0.0,0.0,1.0,34,1100,600,500,0.5454545454545454,16,6,10,369.7909397228791,0.4222185086155674,0.11508903945099025,0.21034624671217675,130198.1482278594,2829.2191166717676,133027.36734453117,1590,17,289.05882352941177,32,2,21,35.41975957771454,0.6311848958333333,44.85479797979798,1020.5808080808081,31.893150252525253,0
3120,4,0,0,34,0.0,0.0,1.0,34,850,400,450,0.47058823529411764,13,4,9,370.860034617691,0.4214572192513369,0.12323233081014573,0.21148462046816846,130295.819176568,2864.3183443232774,133160.13752089127,1591,18,290.05882352941177,31,3,22,35.29325022318581,0.634744623655914,44.759114583333336,1020.9635416666672,32.93430779569894,0
3121,4,0,0,34,0.0,0.0,1.0,34,1050,700,350,0.6666666666666666,14,7,7,370.2726633761595,0.42030600118835415,0.12510683600485817,0.2120554245875438,130462.04460991763,2861.305745442717,133323.35035536034,1592,19,291.05882352941177,31,3,23,35.139455348797675,0.6364247311827957,44.59635416666667,1021.6145833333342,32.95530913978497,0
3122,4,1,0,35,0.02857142857142857,0.0,1.0,35,1150,1000,150,0.8695652173913043,13,10,3,361.04494848466487,0.42118347338935574,0.13368446253291832,0.20974753126849024,131014.28086553246,2460.408857170315,133474.68972270278,1593,0,283.7142857142857,33,2,20,34.81565717021786,0.6369949494949495,44.056372549019606,1023.7745098039214,31.023469994058225,0
3123,4,0,0,35,0.0,0.0,1.0,35,1200,1000,200,0.8333333333333334,14,10,4,361.17835467267685,0.4205532212885154,0.13016214738496767,0.21102810785592258,131233.93233672148,2479.7711517204953,133713.70348844197,1594,1,284.7142857142857,33,2,21,34.5900360802137,0.6392045454545454,43.841911764705884,1024.6323529411766,31.049465240641716,0
3124,4,2,2,35,0.05405405405405406,0.05405405405405406,0.9459459459459459,37,1150,800,350,0.6956521739130435,15,8,7,343.17493109839137,0.4243305805805806,0.12315027127266354,0.20391964914028393,131877.8061224491,1651.465196985673,133529.27131943477,1595,0,270.27027027027026,34,3,18,34.40204373358058,0.6433823529411764,43.21428571428572,1027.1428571428582,30.210084033613477,0
3125,4,0,0,35,0.0,0.0,1.0,35,950,800,150,0.8421052631578947,11,8,3,357.8144770115046,0.42317927170868347,0.1269669437463754,0.21153991880920164,131684.268904321,2423.707561728396,134107.9764660494,1596,1,271.9142857142857,32,3,20,34.221357690572844,0.6461588541666667,43.40277777777778,1026.3888888888891,32.074652777777786,0
3126,4,0,1,34,0.0,0.02857142857142857,0.9714285714285714,35,850,600,250,0.7058823529411765,11,6,5,357.2098253872592,0.42240896358543417,0.12822710983065178,0.21172232507647154,131781.4827568615,2414.728088970516,134196.210845832,1597,2,272.9142857142857,32,3,20,34.13879324479425,0.6471354166666667,43.30808080808081,1026.7676767676764,32.08648989898989,0
3127,4,0,0,34,0.0,0.0,1.0,34,1150,600,550,0.5217391304347826,17,6,11,359.0514097078312,0.42155005941770646,0.1222003445729758,0.21308039641577606,131829.0901184082,2666.684129503038,134495.77424791123,1598,3,275.5,31,3,20,34.04349456912219,0.6502016129032258,43.26171875,1026.953125,33.12752016129032,0
3128,4,0,0,34,0.0,0.0,1.0,34,1100,700,400,0.6363636363636364,15,7,8,359.0633987385259,0.4212344028520499,0.12498508531201535,0.2132750067205944,131862.52170138896,2669.401041666676,134531.92274305565,1599,4,276.5,31,3,20,34.00946585530764,0.6505376344086021,43.22916666666667,1027.083333333334,33.13172043010755,0
3129,4,0,0,34,0.0,0.0,1.0,34,850,500,350,0.5882352941176471,12,5,7,381.8623571789734,0.4204731134878194,0.1460220925902942,0.2126237050304761,129361.89746263139,3079.687818845019,132441.5852814764,1600,5,277.5,32,2,19,35.963809937528445,0.6227213541666667,45.67550505050505,1017.29797979798,31.790561868686876,8
3130,4,1,0,35,0.02857142857142857,0.0,1.0,35,950,800,150,0.8421052631578947,11,8,3,373.8926801794498,0.42307422969187675,0.13884229341399656,0.20998621335483683,129700.23548635136,2698.7937331795333,132399.0292195309,1601,0,270.54285714285714,33,2,18,35.821703561116436,0.6237373737373737,45.343137254901954,1018.6274509803918,30.867498514557326,0
3131,4,2,1,36,0.05405405405405406,0.02702702702702703,0.972972972972973,37,950,700,250,0.7368421052631579,12,7,5,358.3159482862396,0.4265515515515515,0.1498016997167142,0.2049344292693494,130410.31867551853,1945.6194005058144,132355.93807602435,1602,0,256.86486486486484,35,2,20,35.49728517469311,0.6264880952380952,44.64699074074073,1021.4120370370358,29.183201058201025,0
3132,4,1,0,37,0.02702702702702703,0.0,1.0,37,800,600,200,0.75,10,6,4,352.5125159800424,0.4269269269269269,0.15564314172754035,0.20378405027780216,130824.41332572441,1823.4486186128195,132647.86194433723,1603,0,255.1891891891892,35,2,17,35.22610495154051,0.6306547619047619,44.241898148148145,1023.032407407407,29.229497354497344,0
3133,4,0,0,37,0.0,0.0,1.0,37,650,400,250,0.6153846153846154,9,4,5,351.1516963207143,0.42670795795795796,0.15462883698177854,0.20315320651015126,130854.01663237296,1789.9219821673355,132643.9386145403,1604,1,256.18918918918916,35,2,17,35.23095776772248,0.6309523809523809,44.212962962962955,1023.148148148147,29.2328042328042,0
3134,4,0,1,36,0.0,0.02702702702702703,0.972972972972973,37,1400,1200,200,0.8571428571428571,16,12,4,351.8350231884401,0.4256443943943944,0.15396085740913312,0.20433229022335841,131002.08340031272,1818.2242101765842,132820.3076104893,1605,2,257.18918918918916,35,2,18,35.06371302053889,0.6324404761904762,44.068287037037024,1023.7268518518501,29.249338624338577,0
3135,4,1,0,37,0.02702702702702703,0.0,1.0,37,750,600,150,0.8,9,6,3,375.53552679552604,0.4269269269269269,0.1612996630092598,0.20670945496260615,128907.38195516102,2281.860318072682,131189.2422732337,1606,0,258.05405405405406,35,2,18,36.58869006914368,0.6113095238095239,46.122685185185176,1015.5092592592579,29.014550264550223,7
3136,4,0,1,36,0.0,0.02702702702702703,0.972972972972973,37,850,400,450,0.47058823529411764,13,4,9,374.1177339047611,0.4258946446446446,0.15543773438510256,0.2065412244161002,129024.94454089506,2254.103973765428,131279.04851466048,1607,1,259.05405405405406,35,2,18,36.50461380724538,0.6125,46.00694444444444,1015.9722222222222,29.027777777777775,0
3137,4,0,0,36,0.0,0.0,1.0,36,1100,600,500,0.5454545454545454,16,6,10,381.4299298568397,0.42298280423280427,0.16819341901376306,0.21039053597080917,128989.6701388891,2640.1041666666897,131629.7743055558,1608,2,267.1111111111111,34,2,19,36.35493573967732,0.6142769607843137,46.04166666666668,1015.8333333333351,29.877450980392208,0
3138,4,1,0,37,0.02702702702702703,0.0,1.0,37,1100,800,300,0.7272727272727273,14,8,6,370.0884573579746,0.4270207707707708,0.16368071219996772,0.20570368843260764,129292.17864229037,2170.0821995465017,131462.26084183686,1609,0,260.86486486486484,34,3,20,36.3343282999727,0.6173406862745099,45.74404761904763,1017.0238095238104,29.912464985994426,0
3139,4,1,2,36,0.02631578947368421,0.05263157894736842,0.9473684210526316,38,800,600,200,0.75,10,6,4,361.5704103371773,0.4303728070175439,0.16207743670646546,0.2024122650067135,129573.74762854083,1770.0066197954832,131343.7542483363,1610,0,254.97368421052633,36,2,17,36.26419459499318,0.6160300925925926,45.46734234234235,1018.1306306306317,28.281406406406436,0
3140,4,1,0,37,0.02702702702702703,0.0,1.0,37,950,600,350,0.631578947368421,13,6,7,375.45767276130783,0.4295232732732733,0.13853326105475117,0.19938333504822917,127471.58893014808,2172.0372245798762,129643.62615472796,1611,0,262.35135135135135,35,2,15,38.06172397325691,0.5967261904761905,47.540509259259245,1009.837962962961,28.85251322751317,8
3141,4,0,0,37,0.0,0.0,1.0,37,1500,1100,400,0.7333333333333333,19,11,8,373.6417286318412,0.42902277277277273,0.13270550265091874,0.19977259070446918,127745.77100326677,2146.2301406135834,129892.00114388035,1612,1,263.35135135135135,36,1,16,37.82606475808548,0.5975115740740741,47.26914414414414,1010.9234234234233,28.081206206206204,0
3142,4,0,0,37,0.0,0.0,1.0,37,1300,800,500,0.6153846153846154,18,8,10,370.8775034116255,0.4296171171171171,0.13631440879882528,0.19928011307715568,127945.07345183015,2090.389883126361,130035.46333495651,1613,2,264.35135135135135,36,1,17,37.69154422677352,0.599537037037037,47.07207207207207,1011.7117117117112,28.10310310310309,0
3143,4,0,0,37,0.0,0.0,1.0,37,1400,1000,400,0.7142857142857143,18,10,8,372.52689510933783,0.42911661661661665,0.12930722975289277,0.2016068558504524,128232.43694540893,2154.161667121791,130386.59861253072,1614,3,265.35135135135135,35,2,19,37.35537367158038,0.6044642857142857,46.78819444444444,1012.8472222222222,28.938492063492063,0
3144,4,2,0,39,0.05128205128205128,0.0,1.0,39,1200,800,400,0.6666666666666666,16,8,8,358.2592222820983,0.4323549257759784,0.14110595964128048,0.19672383629226955,128811.51532202208,1429.5826600492367,130241.09798207133,1615,0,252.69230769230768,37,2,17,37.12509901346582,0.6064189189189189,46.21710526315789,1015.1315789473678,27.43598862019913,0
3145,4,0,0,39,0.0,0.0,1.0,39,1250,900,350,0.72,16,9,7,360.5476389805602,0.4319613135402609,0.1457355843623791,0.19867654847572452,128950.68825263546,1498.5732388811962,130449.26149151666,1616,1,253.69230769230768,37,2,19,36.925019792004015,0.6078265765765766,46.08004385964912,1015.6798245614037,27.450806069227127,0
3146,4,1,0,40,0.025,0.0,1.0,40,1150,700,450,0.6086956521739131,16,7,9,353.4044800171732,0.43361378205128204,0.15010240230266803,0.19669147677111096,129344.54038075249,1142.674935934391,130487.21531668688,1617,0,248.325,36,4,20,36.70522897523894,0.6137152777777778,45.69256756756757,1017.2297297297307,28.25638138138141,0
3147,4,1,1,40,0.024390243902439025,0.024390243902439025,0.975609756097561,41,1100,600,500,0.5454545454545454,16,6,10,343.13171992422247,0.4353150406504065,0.1548206893111872,0.19286369085395952,129731.44531250001,702.9947916666672,130434.44010416669,1618,0,243.2439024390244,37,4,17,36.573364008179944,0.6157094594594594,45.3125,1018.7500000000001,27.533783783783786,0
3148,4,0,0,40,0.0,0.0,1.0,40,1300,1000,300,0.7692307692307693,16,10,6,350.91553772967296,0.4334268162393162,0.15771611583593503,0.1969579715994522,129675.59880203534,1101.0364968067213,130776.63529884205,1619,1,250.3,37,3,17,36.43186833889548,0.6151463963963963,45.367324561403514,1018.5307017543868,27.527856804172615,0
3149,4,0,0,40,0.0,0.0,1.0,40,950,700,250,0.7368421052631579,12,7,5,376.11612878831517,0.4332932692307692,0.1192959736284438,0.2014331902854949,127813.2723922903,1654.596064389521,129467.86845667982,1620,2,251.3,34,6,18,37.694254768071595,0.602328431372549,47.202380952380956,1011.1904761904766,29.74089635854343,8
3150,4,1,1,40,0.024390243902439025,0.024390243902439025,0.975609756097561,41,1150,1000,150,0.8695652173913043,13,10,3,368.1902112445785,0.4363821138211382,0.12639296267253464,0.19854000053254464,128087.52745566532,1232.1147583394454,129319.64221400477,1621,0,246.14634146341464,36,5,19,37.613564727259245,0.6009837962962963,46.93130630630632,1012.2747747747763,28.11874374374379,0
3151,4,4,2,42,0.09090909090909091,0.045454545454545456,0.9545454545454546,44,1700,1300,400,0.7647058823529411,21,13,8,341.01837380156945,0.44254316420014095,0.138106004837522,0.18820334976663528,129011.37689248673,-0.937328444036126,129010.4395640427,1622,0,230.13636363636363,38,6,16,37.35912468889123,0.6066337719298245,46.02029914529915,1015.9188034188039,26.73470535312642,0
3152,4,1,1,42,0.023255813953488372,0.023255813953488372,0.9767441860465116,43,1100,700,400,0.6363636363636364,15,7,8,357.22435120943715,0.43888427464008856,0.1646375124208328,0.19753909827023053,129089.936326562,622.8137503847313,129712.75007694673,1623,0,236.46511627906978,37,6,17,36.867447129909365,0.6092342342342343,45.94298245614035,1016.2280701754385,27.465623518255093,0
3153,4,1,2,41,0.023255813953488372,0.046511627906976744,0.9534883720930233,43,650,300,350,0.46153846153846156,10,3,7,352.5723230210581,0.43865356220007384,0.18293166384356763,0.1963710460032206,129373.18019032538,522.7286269855138,129895.90881731089,1624,0,237.1627906976744,36,7,19,36.69724559073132,0.6140046296296297,45.66441441441441,1017.3423423423417,28.259509509509492,0
3154,4,0,0,41,0.0,0.0,1.0,41,1000,800,200,0.8,12,8,4,367.6472094848293,0.4375762195121951,0.1854795414592043,0.20330276476762482,129089.93632656174,1291.9109726069241,130381.84729916867,1625,1,247.6829268292683,37,4,19,36.60264710113652,0.6092342342342343,45.942982456140335,1016.2280701754363,27.465623518255036,0
3155,4,0,1,40,0.0,0.024390243902439025,0.975609756097561,41,750,400,350,0.5333333333333333,11,4,7,370.916992537682,0.4372205284552846,0.18471446498522814,0.2055452144540854,129173.52123970827,1382.5308027469887,130556.05204245525,1626,2,248.6829268292683,37,4,19,36.434288821774,0.6100788288288288,45.86074561403508,1016.5570175438587,27.474513987671855,0
3156,4,0,2,38,0.0,0.05,0.95,40,1100,700,400,0.6363636363636364,15,7,8,407.9521181915272,0.43737980769230766,0.21264740566037776,0.21621462264150948,127392.29024943312,2398.5686603531094,129790.85890978623,1627,3,255.325,34,6,17,37.32311320754717,0.5980392156862745,47.61904761904762,1009.5238095238096,29.691876750700285,8
3157,4,2,0,40,0.05,0.0,1.0,40,950,800,150,0.8421052631578947,11,8,3,402.17481017295046,0.4374332264957265,0.244559585492228,0.21506728513782705,127753.08956916096,2275.814909297047,130028.904478458,1628,0,255.925,34,6,19,37.097415214319355,0.6017156862745099,47.26190476190476,1010.9523809523806,29.73389355742296,0
3158,4,1,0,41,0.024390243902439025,0.0,1.0,41,1500,1200,300,0.8,18,12,6,393.7687015797182,0.43874491869918697,0.2428399405000825,0.2129649574512301,128206.57920030778,1897.9452074947887,130104.52440780257,1629,0,250.65853658536585,33,8,21,36.84404243304292,0.6085858585858586,46.81372549019609,1012.7450980392173,30.689245395127795,0
3159,4,1,0,42,0.023809523809523808,0.0,1.0,42,1500,1200,300,0.8,18,12,6,387.6024457993995,0.44098432055749126,0.24556626169529383,0.21249587462635913,128747.91843820874,1580.6016156462747,130328.52005385501,1630,0,245.66666666666666,34,8,19,36.44550342130988,0.6118259803921569,46.27976190476191,1014.8809523809534,29.849439775910394,0
3160,4,1,0,43,0.023255813953488372,0.0,1.0,43,1150,900,250,0.782608695652174,14,9,5,361.1366694745244,0.44326781100036916,0.19497303824613255,0.18762309758281118,126581.5477639803,542.6477152828628,127124.19547926316,1631,0,240.93023255813952,36,7,21,39.33807072515667,0.5856481481481481,48.42342342342343,1006.3063063063072,27.952952952952977,8
3161,4,2,1,44,0.044444444444444446,0.022222222222222223,0.9777777777777777,45,1300,900,400,0.6923076923076923,17,9,8,358.02962713576284,0.4466119528619528,0.22063200815494421,0.18944286096018542,127325.5315500688,120.34414607302537,127445.87569614183,1632,0,231.17777777777778,35,10,15,38.65156727828746,0.5952380952380952,47.6851851851852,1009.259259259261,28.835978835978885,0
3162,4,0,0,44,0.0,0.0,1.0,44,1350,1000,350,0.7407407407407407,17,10,7,370.28915515876116,0.44593463706835795,0.22082327701796767,0.19552651650906558,127242.10778061229,623.2745181405971,127865.38229875288,1633,1,237.4318181818182,34,10,22,38.4279744346116,0.5965073529411764,47.767857142857146,1008.9285714285718,29.67436974789917,0
3163,4,1,1,44,0.022222222222222223,0.022222222222222223,0.9777777777777777,45,1400,900,500,0.6428571428571429,19,9,10,359.94108886383356,0.4476430976430976,0.22255826682450564,0.1916977281691523,127588.49511584804,184.868371699262,127773.3634875473,1634,0,233.13333333333333,35,10,16,38.33354813457059,0.5979166666666667,47.424768518518526,1010.300925925927,28.865740740740772,0
3164,4,0,0,44,0.0,0.0,1.0,44,1400,1100,300,0.7857142857142857,17,11,6,369.6865458734243,0.44683756166314303,0.22777087395282125,0.1968105412974827,127572.62613378669,632.3767006802564,128205.00283446694,1635,1,239.29545454545453,34,10,17,38.103690392018216,0.5998774509803921,47.44047619047618,1010.2380952380939,29.712885154061585,0
3165,4,1,2,43,0.022222222222222223,0.044444444444444446,0.9555555555555556,45,1350,1100,250,0.8148148148148148,16,11,5,356.51612415894715,0.4481481481481482,0.2244487653614955,0.19181664452441072,127998.08873724706,126.6764992712574,128124.76523651832,1636,0,234.95555555555555,35,10,19,38.000519463189605,0.6020833333333333,47.019675925925924,1011.9212962962961,28.91203703703703,0
3166,4,2,0,45,0.044444444444444446,0.0,1.0,45,1600,1200,400,0.75,20,12,8,353.3946662117854,0.4490740740740741,0.22507519512659413,0.19181464988742591,128349.69142500425,71.61927190500433,128421.31069690925,1637,0,220.48888888888888,35,10,22,37.71999333714069,0.6056547619047619,46.6724537037037,1013.3101851851849,28.95171957671957,0
3167,4,1,2,44,0.021739130434782608,0.043478260869565216,0.9565217391304348,46,1850,1600,250,0.8648648648648649,21,16,5,346.3019939330893,0.4503723832528181,0.23250044601742603,0.19051891880992466,128886.73460200054,-273.2533631604715,128613.48123884006,1638,0,216.67391304347825,36,10,19,37.35190011459834,0.6090856481481481,46.14301801801801,1015.427927927927,28.206331331331306,0
3168,4,0,0,44,0.0,0.0,1.0,44,1650,1400,250,0.8484848484848485,19,14,5,368.56066176690723,0.4469146405919662,0.24640544835898548,0.20174968016951517,128687.5159438776,685.8312074829946,129373.34715136059,1639,1,227.45454545454547,34,10,19,36.99034964214477,0.6112132352941176,46.339285714285715,1014.6428571428576,29.84243697478993,0
3169,4,2,1,45,0.043478260869565216,0.021739130434782608,0.9782608695652174,46,1400,1000,400,0.7142857142857143,18,10,8,361.86426995671013,0.4481481481481482,0.26437751657379893,0.20253031653598044,129564.73922902481,179.017857142838,129743.75708616765,1640,0,218.52173913043478,34,12,19,36.26588322419707,0.6200980392156863,45.47619047619047,1018.095238095237,29.943977591036383,0
3170,4,1,0,46,0.021739130434782608,0.0,1.0,46,1200,800,400,0.6666666666666666,16,8,8,356.5668493431483,0.4489130434782609,0.2800553857081838,0.2022629360175065,130090.20580969479,77.17096319291693,130167.3767728877,1641,0,217.95652173913044,36,10,21,35.86672553997864,0.6212384259259259,44.960585585585584,1020.1576576576573,28.3377127127127,0
3171,4,0,1,45,0.0,0.021739130434782608,0.9782608695652174,46,1950,1200,750,0.6153846153846154,27,12,15,355.351936693045,0.4480072463768116,0.27905944986690345,0.20246796392975788,130262.58680555534,57.92663440465259,130320.51343995999,1642,1,218.95652173913044,35,11,21,35.72278911564626,0.625,44.79166666666666,1020.8333333333317,29.166666666666618,0
3172,4,0,0,45,0.0,0.0,1.0,45,1200,900,300,0.75,15,9,6,362.88398681396455,0.4474326599326599,0.27621564208181204,0.20724492935354083,130353.74858276622,460.65759637185965,130814.40617913808,1643,2,221.84444444444443,34,11,21,35.438039169969706,0.6280637254901961,44.70238095238094,1021.1904761904743,30.035014005602186,0
3173,4,0,0,45,0.0,0.0,1.0,45,1200,900,300,0.75,15,9,6,364.3282986137259,0.4473905723905724,0.28213235960584737,0.20855911477013866,130444.94224773225,504.9567743763928,130949.89902210864,1644,3,222.84444444444443,34,11,21,35.30862758808218,0.6289828431372548,44.61309523809523,1021.5476190476177,30.04551820728287,0
3174,4,0,0,45,0.0,0.0,1.0,45,1650,1200,450,0.7272727272727273,21,12,9,366.10940453686237,0.4471801346801347,0.2812198067632854,0.2105129076086956,130617.28395061711,564.043209876525,131181.32716049365,1645,4,223.84444444444443,35,10,18,35.088315217391305,0.6285714285714286,44.444444444444436,1022.2222222222208,29.206349206349167,0
3175,4,0,0,45,0.0,0.0,1.0,45,1600,1100,500,0.6875,21,11,10,369.81175507236844,0.44715909090909095,0.2769366175046839,0.21345698756201914,130765.21675936617,671.7028624399568,131436.91962180613,1646,5,224.84444444444443,35,10,19,34.843673380860764,0.6300595238095238,44.299768518518505,1022.8009259259239,29.22288359788354,0
3176,4,0,0,45,0.0,0.0,1.0,45,1650,1400,250,0.8484848484848485,19,14,5,370.9480993352809,0.44642255892255894,0.2789916811178972,0.21493598258994426,130913.23329260953,712.4030135459307,131625.63630615544,1647,6,225.84444444444443,35,10,19,34.664574379853725,0.631547619047619,44.15509259259258,1023.379629629628,29.23941798941794,0
3177,4,1,0,46,0.021739130434782608,0.0,1.0,46,1500,1000,500,0.6666666666666666,20,10,10,368.0782514189108,0.4465479066022544,0.2839417104634492,0.21526427300206213,131270.4173768363,463.55713821929663,131733.9745150556,1648,0,221.91304347826087,36,10,21,34.37637362637362,0.6331018518518519,43.806306306306304,1024.7747747747746,28.465965965965964,0
3178,4,0,0,46,0.0,0.0,1.0,46,1550,1300,250,0.8387096774193549,18,13,5,371.1296068033016,0.4452596618357488,0.28852550705013047,0.21838981244959235,131506.13667052475,561.1768405511449,132067.3135110759,1649,1,222.91304347826087,35,11,22,34.05974949221394,0.6375,43.57638888888889,1025.694444444445,29.30555555555557,0
3179,4,0,1,45,0.0,0.021739130434782608,0.9782608695652174,46,900,500,400,0.5555555555555556,13,5,8,371.4100720967187,0.44465579710144926,0.2916848500301552,0.219406602883518,131654.57182623888,579.5668027692032,132234.13862900808,1650,2,223.91304347826087,35,11,20,33.90250836434721,0.6389880952380953,43.43171296296296,1026.2731481481483,29.32208994708995,0
3180,4,0,0,45,0.0,0.0,1.0,45,1550,1000,550,0.6451612903225806,21,10,11,376.9223825399659,0.44396043771043775,0.29221152482955115,0.222717468120428,131663.90483276636,925.4145408163201,132589.3193735827,1651,3,228.17777777777778,34,11,20,33.75164327417546,0.6412377450980392,43.422619047619044,1026.3095238095232,30.18557422969186,0
3181,4,1,0,46,0.021739130434782608,0.0,1.0,46,1300,900,400,0.6923076923076923,17,9,8,366.89653801669255,0.4456622383252818,0.2933877015556614,0.21929845563016576,132100.3796403464,493.4343921467741,132593.81403249316,1652,0,224.19565217391303,35,11,21,33.568359228402,0.6434523809523809,42.99768518518518,1028.0092592592594,29.371693121693124,0
3182,4,0,0,46,0.0,0.0,1.0,46,1950,1700,250,0.8717948717948718,22,17,5,369.0181415644761,0.44551127214170694,0.2897425358893817,0.22126148488137184,132219.38898533932,558.2706404320822,132777.6596257714,1653,1,225.19565217391303,35,11,21,33.39382174206617,0.6446428571428571,42.881944444444436,1028.4722222222208,29.384920634920594,0
3183,4,0,0,46,0.0,0.0,1.0,46,1850,1500,350,0.8108108108108109,22,15,7,370.47026041696415,0.4449476650563607,0.28901967304504317,0.22300955215756435,132368.22601862552,607.6982328103431,132975.92425143585,1654,2,226.19565217391303,35,11,21,33.206449405766136,0.6461309523809524,42.73726851851851,1029.0509259259247,29.401455026454993,0
3184,4,0,0,46,0.0,0.0,1.0,46,2000,1600,400,0.8,24,16,8,371.7624448843225,0.44371980676328504,0.2981215702828195,0.22524430484167784,132612.5,660.0727934242129,133272.57279342422,1655,3,227.19565217391303,34,12,21,32.92711704422869,0.6507352941176471,42.5,1030.0,30.294117647058822,0
3185,4,0,1,45,0.0,0.021739130434782608,0.9782608695652174,46,1500,1100,400,0.7333333333333333,19,11,8,376.88403714282765,0.44312600644122385,0.2955476975006026,0.22909467875760664,132735.14739229032,805.1516439909416,133540.29903628127,1656,4,228.19565217391303,34,12,17,32.671701709796686,0.6519607843137255,42.38095238095239,1030.4761904761913,30.308123249299744,0
3186,4,0,1,44,0.0,0.022222222222222223,0.9777777777777777,45,1600,1200,400,0.75,20,12,8,374.9819989439379,0.44236111111111115,0.28809340518347426,0.2286862049897538,132857.85147392287,963.8605442176818,133821.71201814056,1657,5,230.77777777777777,34,11,17,32.59719014626634,0.6531862745098039,42.26190476190476,1030.9523809523807,30.32212885154061,0
3187,4,0,0,44,0.0,0.0,1.0,44,1650,1200,450,0.7272727272727273,21,12,9,376.0643747571411,0.4406382135306554,0.2938021297802025,0.23028959768697024,133011.31129535154,1204.1631235827713,134215.47441893432,1658,6,235.77272727272728,34,10,17,32.41488747836123,0.654718137254902,42.11309523809524,1031.5476190476195,30.33963585434175,0
3188,4,0,1,43,0.0,0.022727272727272728,0.9772727272727273,44,1400,1000,400,0.7142857142857143,18,10,8,374.14778383645273,0.44007663847780126,0.2859483635524698,0.22987151935352304,133134.14292800458,1162.3689058956957,134296.5118339003,1659,7,236.77272727272728,34,10,17,32.340812089052946,0.6559436274509804,41.99404761904762,1032.0238095238099,30.353641456582643,0
3189,4,0,0,43,0.0,0.0,1.0,43,1300,600,700,0.46153846153846156,20,6,14,371.3404093418948,0.4396917681801403,0.2627379878077387,0.22925169447063357,133313.9766706315,1300.9733335736269,134614.95000420514,1660,8,233.67441860465115,33,10,18,32.23258079189906,0.6600378787878788,41.81985294117647,1032.7205882352941,31.2945632798574,0
3190,4,0,1,42,0.0,0.023255813953488372,0.9767441860465116,43,850,500,350,0.5882352941176471,12,5,7,372.340125993113,0.43971483942414175,0.2637167360183663,0.23006470541568616,133345.61827181862,1329.98486159171,134675.60313341033,1661,9,234.67441860465115,33,10,18,32.1749920898592,0.6603535353535354,41.78921568627452,1032.8431372549028,31.298276886512205,0
3191,4,0,0,42,0.0,0.0,1.0,42,1150,800,350,0.6956521739130435,15,8,7,380.5003946347139,0.43717334494773524,0.2705913518360028,0.2348764322805528,133309.18281616675,1744.8393339965287,135054.02215016328,1662,10,240.61904761904762,32,10,18,32.00090679382157,0.6624348958333333,41.82449494949495,1032.7020202020203,32.271938131313135,0
3192,4,0,1,41,0.0,0.023809523809523808,0.9761904761904762,42,1550,1100,450,0.7096774193548387,20,11,9,382.4329844613726,0.43681039488966317,0.27218993397382674,0.2369061346064534,133440.56560277296,1806.4147503364065,135246.98035310936,1663,11,241.61904761904762,33,9,18,31.818956825999283,0.661300505050505,41.697303921568626,1033.2107843137253,31.309417706476523,0
3193,4,0,0,41,0.0,0.0,1.0,41,1650,1100,550,0.6666666666666666,22,11,11,389.66322866565883,0.435619918699187,0.27655788472830367,0.24137881908940848,133439.60636988565,2199.3015699928483,135638.9079398785,1664,12,247.53658536585365,32,9,18,31.633162246934695,0.6637369791666667,41.69823232323232,1033.2070707070702,32.287720959595944,0
3194,4,0,0,41,0.0,0.0,1.0,41,850,600,250,0.7058823529411765,11,6,5,390.8135111868809,0.43495934959349597,0.2756853418874319,0.24274473018790776,133539.50500488284,2237.8125521859633,135777.3175570688,1665,13,248.53658536585365,31,10,18,31.503002435542122,0.6673387096774194,41.6015625,1033.5937500000002,33.34173387096775,0
3195,4,0,1,40,0.0,0.024390243902439025,0.975609756097561,41,1250,800,450,0.64,17,8,9,392.9266006447264,0.4345020325203252,0.27243500182704206,0.24517014838343,133707.7861362034,2307.4691772461006,136015.25531344948,1666,14,249.53658536585365,31,10,16,31.279244827730913,0.669018817204301,41.438802083333336,1034.244791666667,33.362735215053775,0
3196,4,0,0,40,0.0,0.0,1.0,40,1400,1200,200,0.8571428571428571,16,12,4,403.3765807810298,0.43206463675213674,0.26956719521705264,0.2515056250023698,133680.636851081,2784.727641923915,136465.36449300492,1667,15,255.65,30,10,19,31.0363595009098,0.6715277777777777,41.46505376344086,1034.1397849462362,34.47132616487454,0
3197,4,0,0,40,0.0,0.0,1.0,40,950,600,350,0.631578947368421,13,6,7,403.3765807810298,0.4317441239316239,0.26956719521705264,0.2515056250023698,133680.636851081,2784.727641923915,136465.36449300492,1668,16,256.65,30,10,19,31.0363595009098,0.6715277777777777,41.46505376344086,1034.1397849462362,34.47132616487454,0
3198,4,0,1,39,0.0,0.025,0.975,40,1100,800,300,0.7272727272727273,14,8,6,401.68365946895807,0.43143696581196583,0.268263609198389,0.25115833687510736,133784.90513715462,2747.8420554399427,136532.74719259457,1669,17,257.65,30,10,17,30.97527175089862,0.6725694444444444,41.36424731182796,1034.5430107526886,34.48476702508962,0
3199,4,0,1,38,0.0,0.02564102564102564,0.9743589743589743,39,650,300,350,0.46153846153846156,10,3,7,400.6105414357829,0.43125843454790824,0.25684321307129476,0.2509601756317407,133854.43990996078,2924.699929182579,136779.13983914338,1670,18,258.71794871794873,30,9,17,30.93312984370265,0.6732638888888889,41.297043010752695,1034.81182795699,34.49372759856634,0
3200,4,0,0,38,0.0,0.0,1.0,38,1600,1200,400,0.75,20,12,8,415.9316034688096,0.4299875533428165,0.2725982517334391,0.2614126620789633,133975.00964506165,3544.8881172839383,137519.8977623456,1671,19,265.7368421052632,29,9,18,30.415436901887137,0.6774425287356323,41.18055555555555,1035.2777777777771,35.69923371647507,0
3201,4,0,0,38,0.0,0.0,1.0,38,1150,800,350,0.6956521739130435,15,8,7,414.4269858108062,0.42957266477003314,0.27677097006393714,0.2614887022146355,134118.8368055555,3516.493055555551,137635.32986111107,1672,20,266.7368421052632,29,9,18,30.30973451327434,0.6788793103448276,41.041666666666664,1035.833333333333,35.71839080459769,0
3202,4,0,0,38,0.0,0.0,1.0,38,1050,800,250,0.7619047619047619,13,8,5,412.63863033587546,0.4295282124229493,0.27747989276139395,0.2608715408733584,134190.77932098752,3474.459876543194,137665.23919753073,1673,21,267.7368421052632,29,9,18,30.283735478105445,0.6795977011494253,40.972222222222214,1036.1111111111102,35.727969348658974,0
3203,4,0,1,37,0.0,0.02631578947368421,0.9736842105263158,38,650,500,150,0.7692307692307693,8,5,3,413.95924345344815,0.4288762446657184,0.28000528960592463,0.2623499663924719,134280.73459201385,3517.3502604166606,137798.0848524305,1674,22,268.7368421052632,31,7,18,30.159128978224455,0.674731182795699,40.885416666666664,1036.458333333333,33.434139784946225,0
3204,4,0,1,36,0.0,0.02702702702702703,0.972972972972973,37,950,700,250,0.7368421052631579,12,7,5,421.78136176369117,0.4271771771771771,0.2922522989976615,0.26673605560593067,134202.3847590762,3920.8129191235985,138123.1976781998,1675,23,276.2972972972973,30,7,18,30.03524019544256,0.6767361111111111,40.961021505376344,1036.1559139784947,34.538530465949826,0
3205,4,0,0,36,0.0,0.0,1.0,36,800,500,300,0.625,11,5,6,431.4901928717451,0.4236937830687831,0.30629311757781674,0.2719883658702116,134082.87278163584,4371.0889274691435,138453.961709105,1676,24,283.9166666666667,29,7,18,29.90408899915069,0.6785201149425287,41.07638888888889,1035.6944444444448,35.71360153256706,0
3206,4,0,0,36,0.0,0.0,1.0,36,1100,700,400,0.6363636363636364,15,7,8,428.7433190002823,0.4227678571428572,0.29870120509715736,0.27088143466017855,134167.56995028336,4304.689848537414,138472.25979882077,1677,25,284.9166666666667,30,6,18,29.889941186645906,0.6763888888888889,40.99462365591398,1036.0215053763447,34.53405017921149,0
3207,4,0,0,36,0.0,0.0,1.0,36,1550,1100,450,0.7096774193548387,20,11,9,427.1388869684102,0.42141203703703706,0.30240791160666736,0.27115409343105734,134341.68915842872,4276.511916117473,138618.2010745462,1678,26,285.9166666666667,30,6,18,29.756309693590907,0.678125,40.82661290322581,1036.6935483870968,34.556451612903224,0
3208,4,0,1,35,0.0,0.027777777777777776,0.9722222222222222,36,700,600,100,0.8571428571428571,8,6,2,425.6234132217975,0.42131283068783065,0.30230029095727806,0.2704496713009018,134376.52654931214,4238.759177361552,138615.2857266737,1679,27,286.9166666666667,30,6,18,29.760554403249504,0.6784722222222221,40.793010752688176,1036.827956989248,34.560931899641595,0
3209,4,0,0,35,0.0,0.0,1.0,35,550,300,250,0.5454545454545454,8,3,5,431.5292079453152,0.4221638655462185,0.2949024712390653,0.27361958189429797,134298.7292631173,4590.764853395065,138889.49411651236,1680,28,286.6,29,6,19,29.685755281611517,0.6806752873563218,40.86805555555556,1036.5277777777778,35.74233716475096,0
3210,4,0,0,35,0.0,0.0,1.0,35,1050,800,250,0.7619047619047619,13,8,5,431.8837315823922,0.4214985994397759,0.29811501291742415,0.27438400478830277,134370.720003858,4606.505594135796,138977.2255979938,1681,29,287.6,29,6,19,29.604124804643885,0.6813936781609196,40.79861111111111,1036.8055555555552,35.75191570881225,0
3211,4,0,0,35,0.0,0.0,1.0,35,850,600,250,0.7058823529411765,11,6,5,431.4373006622751,0.42153361344537815,0.29774436090225587,0.2741439322330139,134376.526549312,4595.009177361537,138971.53572667352,1682,30,288.6,30,5,19,29.609854377322616,0.6784722222222221,40.79301075268817,1036.8279569892468,34.56093189964156,0
3212,4,0,0,35,0.0,0.0,1.0,35,850,700,150,0.8235294117647058,10,7,3,427.85092091455755,0.4211484593837535,0.2904601488172365,0.27290524029905394,134515.92127702612,4510.552159209138,139026.47343623525,1683,31,289.6,30,5,19,29.56265656042152,0.6798611111111111,40.658602150537625,1037.3655913978484,34.57885304659495,0
3213,4,0,0,35,0.0,0.0,1.0,35,1200,900,300,0.75,15,9,6,429.33975465073354,0.420203081232493,0.2933871222907767,0.2749601407444059,134662.60404280614,4563.2109089096175,139225.81495171576,1684,32,290.6,28,7,19,29.376614987080107,0.6875,40.51724137931034,1037.9310344827584,37.068965517241374,0
3214,4,0,0,35,0.0,0.0,1.0,35,1150,800,350,0.6956521739130435,15,8,7,416.3090044063989,0.4204481792717087,0.2880315143088865,0.24797536349424648,131969.53125000012,3988.020833333349,135957.55208333346,1685,33,291.6,29,6,20,32.43106244931062,0.6573275862068966,43.12500000000001,1027.500000000001,35.431034482758655,8
3215,4,0,0,35,0.0,0.0,1.0,35,700,500,200,0.7142857142857143,9,5,4,417.4945215485756,0.4197829131652661,0.2888803088803087,0.24914995640802104,132040.89506172852,4025.2700617284136,136066.1651234569,1686,34,292.6,29,6,20,32.32826576576578,0.6580459770114943,43.055555555555564,1027.7777777777787,35.44061302681995,0
3216,4,0,0,35,0.0,0.0,1.0,35,1050,900,150,0.8571428571428571,12,9,3,417.4945215485756,0.4197829131652661,0.2888803088803087,0.24914995640802104,132040.89506172852,4025.2700617284136,136066.1651234569,1687,35,293.6,29,6,20,32.32826576576578,0.6580459770114943,43.055555555555564,1027.7777777777787,35.44061302681995,0
3217,4,0,0,35,0.0,0.0,1.0,35,1650,1300,350,0.7878787878787878,20,13,7,421.77127989588035,0.41964285714285715,0.2955106448626965,0.253610522846484,132326.54320987666,4162.307098765448,136488.8503086421,1688,36,294.6,29,6,20,31.928883189344848,0.6609195402298851,42.777777777777786,1028.8888888888898,35.47892720306517,0
3218,4,0,0,35,0.0,0.0,1.0,35,1000,600,400,0.6,14,6,8,422.2661546542072,0.41887254901960785,0.2976238654101868,0.2551148332886421,132505.2300347222,4190.494791666661,136695.72482638885,1689,37,295.6,29,6,20,31.73521179009847,0.6627155172413793,42.604166666666664,1029.5833333333333,35.50287356321839,0
3219,4,0,0,35,0.0,0.0,1.0,35,950,600,350,0.631578947368421,13,6,7,424.41443575628307,0.4189075630252101,0.3019362296503225,0.2569006564190071,132576.73852237646,4253.496334876527,136830.23485725297,1690,38,296.6,29,6,20,31.607524162733192,0.663433908045977,42.534722222222214,1029.8611111111104,35.51245210727967,0
3220,4,0,0,35,0.0,0.0,1.0,35,1000,700,300,0.7,13,7,6,428.56869557169716,0.41817226890756304,0.30431517532204966,0.26040549979086164,132719.8133680556,4375.911458333338,137095.72482638893,1691,39,297.6,29,6,19,31.3557251651166,0.6648706896551724,42.395833333333336,1030.416666666667,35.53160919540231,0
3221,4,0,0,35,0.0,0.0,1.0,35,1000,900,100,0.9,11,9,2,427.6083537944591,0.41750700280112046,0.3056312054095336,0.2604708868347663,132813.31521346405,4358.416616082798,137171.73182954686,1692,40,298.6,30,5,19,31.285858651714705,0.6628472222222221,42.30510752688173,1030.7795698924738,34.359318996415794,0
3222,4,0,0,35,0.0,0.0,1.0,35,1350,900,450,0.6666666666666666,18,9,9,430.2670585364301,0.4169467787114846,0.3094499767333645,0.26355145046026357,133021.21497066141,4446.929377673731,137468.14434833513,1693,41,299.6,30,5,20,31.007057546145493,0.6649305555555556,42.10349462365592,1031.586021505377,34.3862007168459,0
3223,4,0,0,35,0.0,0.0,1.0,35,1100,800,300,0.7272727272727273,14,8,6,429.13614908854174,0.4163165266106443,0.30451636904761914,0.26408378405448724,133194.58896982312,4431.722597988211,137626.31156781132,1694,42,300.6,30,5,20,30.861002604166668,0.6666666666666667,41.935483870967744,1032.2580645161293,34.40860215053764,0
3224,4,0,0,35,0.0,0.0,1.0,35,950,700,250,0.7368421052631579,12,7,5,426.98823774007315,0.416421568627451,0.302192794836982,0.26300694900412985,133229.27731890956,4377.466867556922,137606.74418646647,1695,43,301.6,30,5,20,30.88139565160787,0.6670138888888889,41.9018817204301,1032.3924731182783,34.413082437275946,0
3225,4,0,0,35,0.0,0.0,1.0,35,950,600,350,0.631578947368421,13,6,7,426.98823774007315,0.4161764705882353,0.302192794836982,0.26300694900412985,133229.27731890956,4377.466867556922,137606.74418646647,1696,44,302.6,30,5,20,30.88139565160787,0.6670138888888889,41.9018817204301,1032.3924731182783,34.413082437275946,0
3226,4,0,1,34,0.0,0.02857142857142857,0.9714285714285714,35,1100,1000,100,0.9090909090909091,12,10,2,426.24485949487894,0.4158963585434174,0.30100593146278465,0.2630392976304542,133298.66756633716,4363.574365533591,137662.24193187075,1697,45,303.6,30,5,20,30.830513254371123,0.6677083333333333,41.83467741935484,1032.6612903225807,34.42204301075269,0
3227,4,0,0,34,0.0,0.0,1.0,34,1050,800,250,0.7619047619047619,13,8,5,433.2087882508362,0.4166109625668449,0.2637870233936528,0.24706112755300488,130299.25724996686,4521.33742509425,134820.59467506112,1698,46,306.2352941176471,28,6,21,33.69834177690215,0.6436011904761905,44.75574712643677,1020.977011494252,36.463464696223284,8
3228,4,0,0,34,0.0,0.0,1.0,34,1150,800,350,0.6956521739130435,15,8,7,433.80429820553826,0.41640671420083186,0.2643914507707712,0.24810255478223409,130409.29954832204,4514.422934007126,134923.72248232918,1699,47,307.2352941176471,28,6,21,33.57070849158344,0.6447172619047619,44.64798850574712,1021.408045977011,36.478858784893255,0
3229,4,0,0,34,0.0,0.0,1.0,34,1150,900,250,0.782608695652174,14,9,5,378.7532590248765,0.41610962566844917,0.17032041636180395,0.20717171202888304,128657.3200113379,2945.87585034014,131603.19586167805,1700,48,308.2352941176471,34,0,15,36.76269263866071,0.610906862745098,46.36904761904762,1014.5238095238097,29.838935574229698,8
3230,4,1,0,35,0.02857142857142857,0.0,1.0,35,1100,700,400,0.6363636363636364,15,7,8,366.71714082945533,0.4200980392156863,0.16779611366077551,0.20245553850320488,129024.94454089501,2463.131751543207,131488.07629243823,1701,0,300.4,35,0,17,36.692583732057415,0.6125,46.00694444444444,1015.9722222222218,29.027777777777768,0
3231,4,0,1,34,0.0,0.02857142857142857,0.9714285714285714,35,1350,900,450,0.6666666666666666,18,9,9,370.02230251436816,0.42023809523809524,0.1651938321570725,0.20550913576578259,129261.9118480727,2566.0786131582445,131827.99046123095,1702,1,301.4,34,1,17,36.366873487863884,0.6170343137254901,45.77380952380953,1016.904761904763,29.908963585434204,0
3232,4,2,0,36,0.05555555555555555,0.0,1.0,36,800,400,400,0.5,12,4,8,358.45159387929766,0.424917328042328,0.16522115420027284,0.20213989882875566,129860.54202428806,2109.7436541271363,131970.2856784152,1703,0,283.52777777777777,36,0,14,36.051955585018256,0.6189236111111112,45.18581081081083,1019.2567567567589,28.31268768768775,0
3233,4,0,1,35,0.0,0.027777777777777776,0.9722222222222222,36,800,400,400,0.5,12,4,8,356.4486020923528,0.4247850529100529,0.1631411318531606,0.20130562662146462,129917.93894823916,2061.813544963924,131979.7524932031,1704,1,284.52777777777777,36,0,14,36.04468132110903,0.6195023148148149,45.129504504504524,1019.481981981985,28.318943943944028,0
3234,4,0,0,35,0.0,0.0,1.0,35,1350,1200,150,0.8888888888888888,15,12,3,364.13431855708626,0.4193627450980392,0.16930736422165693,0.20575107198007533,129937.87140185619,2462.967651534648,132400.83905339084,1705,2,293.57142857142856,35,0,15,35.82853237219512,0.6217261904761905,45.10995370370371,1019.5601851851856,29.130291005291017,0
3235,4,0,0,35,0.0,0.0,1.0,35,1150,800,350,0.6956521739130435,15,8,7,361.94815383595926,0.41862745098039217,0.17294563843236443,0.20529028493630266,130085.41907793209,2416.835455246916,132502.25453317902,1706,3,294.57142857142856,35,0,15,35.734343090537784,0.6232142857142857,44.96527777777778,1020.1388888888888,29.146825396825395,0
3236,4,0,0,35,0.0,0.0,1.0,35,550,300,250,0.5454545454545454,8,3,5,360.1910735482192,0.41817226890756304,0.16822048315753646,0.20475852324143468,130173.987871335,2377.5016878858155,132551.48955922082,1707,4,295.57142857142856,35,0,16,35.68922252466826,0.6241071428571429,44.87847222222223,1020.4861111111121,29.15674603174606,0
3237,4,0,0,35,0.0,0.0,1.0,35,1200,1100,100,0.9166666666666666,13,11,2,357.8297818915174,0.41852240896358545,0.16814420133771746,0.20403468041791034,130292.1264815886,2324.4806402177633,132616.60712180636,1708,5,296.57142857142856,35,0,17,35.62958186902468,0.625297619047619,44.76273148148148,1020.9490740740736,29.16997354497353,0
3238,4,0,0,35,0.0,0.0,1.0,35,1150,900,250,0.782608695652174,14,9,5,364.9722893209963,0.4182422969187675,0.17879077296641088,0.20874144220724491,130410.31867551855,2519.2305116169255,132929.54918713548,1709,6,297.57142857142856,35,0,17,35.32731350330501,0.6264880952380952,44.64699074074073,1021.4120370370359,29.183201058201025,0
3239,4,0,1,34,0.0,0.02857142857142857,0.9714285714285714,35,1600,1400,200,0.875,18,14,4,366.8327947861329,0.41792717086834735,0.17160320155226794,0.21141342086989443,130706.03358892731,2589.451919367264,133295.48550829457,1710,7,298.57142857142856,35,0,14,34.97983870967741,0.6294642857142857,44.35763888888888,1022.5694444444432,29.216269841269806,0
3240,4,0,0,34,0.0,0.0,1.0,34,1050,800,250,0.7619047619047619,13,8,5,368.38062283737025,0.4178178847296494,0.08550173010380635,0.1981794489947877,127993.90589569154,2630.0949546485163,130624.00085034006,1711,8,285.4117647058824,34,0,19,37.70465686274509,0.6041666666666667,47.02380952380952,1011.9047619047614,29.761904761904745,8
3241,4,2,1,35,0.05555555555555555,0.027777777777777776,0.9722222222222222,36,1250,900,350,0.72,16,9,7,349.53888433296703,0.4234457671957672,0.08352352695043552,0.19084169740870968,128584.3611352238,1789.1354038721965,130373.49653909598,1712,0,270.5,35,1,18,37.5780982540226,0.6080357142857142,46.44097222222222,1014.2361111111113,28.978174603174608,0
3242,4,0,0,35,0.0,0.0,1.0,35,750,500,250,0.6666666666666666,10,5,5,357.7087030624343,0.4194327731092437,0.09076419763442689,0.19462553396655777,128446.04768990926,2189.253826530607,130635.30151643987,1713,1,279.22857142857146,34,1,18,37.51223331376002,0.6087622549019608,46.57738095238095,1013.6904761904759,29.814425770308116,0
3243,4,0,0,35,0.0,0.0,1.0,35,1050,700,350,0.6666666666666666,14,7,7,359.58421947414456,0.4192577030812325,0.09460995523664217,0.19653734022701624,128627.12762188201,2250.457057823119,130877.58467970513,1714,2,280.22857142857146,34,1,19,37.279710910300025,0.6106004901960784,46.39880952380952,1014.4047619047614,29.83543417366945,0
3244,4,0,0,35,0.0,0.0,1.0,35,1400,1200,200,0.8571428571428571,16,12,4,363.336016618032,0.4185924369747899,0.09584561779683787,0.19964752253341328,128838.5487528343,2362.3370181405735,131200.88577097486,1715,3,281.22857142857146,34,1,19,36.96866205440902,0.6127450980392157,46.19047619047618,1015.2380952380938,29.859943977590994,0
3245,4,3,0,38,0.07894736842105263,0.0,1.0,38,850,600,250,0.7058823529411765,11,6,5,339.5835809950215,0.42629800853485067,0.10684148186769238,0.1903266576162198,129619.76431450044,1203.34874672974,130823.11306123018,1716,0,259.94736842105266,37,1,18,36.77710329851763,0.6145833333333333,45.42214912280701,1018.3114035087706,27.52192982456137,0
3246,4,0,0,38,0.0,0.0,1.0,38,1000,700,300,0.7,13,7,6,340.23222083012354,0.42569049312470364,0.11131250424813621,0.19137032663156808,129759.37307633097,1229.663935056913,130989.03701138789,1717,1,260.94736842105266,37,1,18,36.61886569091691,0.615990990990991,45.28508771929823,1018.8596491228054,27.536747273589334,0
3247,4,1,0,39,0.02564102564102564,0.0,1.0,39,950,700,250,0.7368421052631579,12,7,5,337.23965900057567,0.42909356725146197,0.12827493623305153,0.19147673861209838,130126.2932372707,976.7493516692116,131103.04258893992,1718,0,255.23076923076923,38,1,19,36.32308027923209,0.6178728070175439,44.92521367521367,1020.2991452991446,26.849977507872225,0
3248,4,1,1,39,0.025,0.025,0.975,40,1250,700,550,0.56,18,7,11,333.17638097226126,0.42901976495726496,0.12784901813499272,0.19106896580187693,130514.5588666704,697.0163559056055,131211.575222576,1719,0,249.825,37,3,15,36.03379743892406,0.6235923423423424,44.54495614035087,1021.8201754385956,27.61676149834042,0
3249,4,0,0,39,0.0,0.0,1.0,39,950,600,350,0.631578947368421,13,6,7,341.60580778550934,0.4273504273504274,0.13240987210570654,0.19593749050857875,130521.3723013556,1117.3717636555714,131638.74406501118,1720,1,257.05128205128204,36,3,16,35.81156784953346,0.6255787037037037,44.5382882882883,1021.8468468468484,28.38463463463468,0
3250,4,0,0,39,0.0,0.0,1.0,39,1250,900,350,0.72,16,9,7,345.8121834724096,0.4271255060728745,0.13435908732747603,0.1990887009350671,130665.25298524888,1237.1272877607464,131902.38027300962,1721,2,258.05128205128204,36,3,18,35.55847743877813,0.627025462962963,44.39752252252253,1022.4099099099109,28.400275275275302,0
3251,4,0,0,39,0.0,0.0,1.0,39,1250,1000,250,0.8,15,10,5,346.5377667414948,0.4267881241565452,0.13579188107490014,0.20003120595078383,130766.77439212082,1263.1251923668997,132029.89958448772,1722,3,259.05128205128204,37,2,18,35.437214122355634,0.6261261261261262,44.298245614035096,1022.807017543861,27.64343290659084,0
3252,4,0,0,39,0.0,0.0,1.0,39,1400,1100,300,0.7857142857142857,17,11,6,345.7078959704453,0.4261414754835808,0.1368038935380762,0.20019287954080592,130890.45606874155,1249.9728340273468,132140.4289027689,1723,4,260.05128205128204,38,1,18,35.333359434815904,0.6255482456140351,44.17735042735044,1023.2905982906001,26.92869995501579,0
3253,4,0,1,38,0.0,0.02564102564102564,0.9743589743589743,39,1600,1200,400,0.75,20,12,8,346.4761815132286,0.42571974808816915,0.13333547320611738,0.20178132903923518,131109.19922017687,1285.2429414128187,132394.4421615897,1724,5,261.05128205128204,38,1,19,35.09262639961052,0.6277412280701755,43.96367521367522,1024.1452991453,26.95119208277105,0
3254,4,0,0,38,0.0,0.0,1.0,38,1050,600,450,0.5714285714285714,15,6,9,356.1408981042339,0.4234826932195353,0.1325259437551789,0.20692517520841497,131019.23338190588,1732.2614891120263,132751.4948710179,1725,6,268.7105263157895,37,1,19,34.936163471493344,0.6286599099099099,44.051535087719294,1023.793859649122,27.670104314841137,0
3255,4,0,1,37,0.0,0.02631578947368421,0.9736842105263158,38,1100,500,600,0.45454545454545453,17,5,12,356.34415080292246,0.4227270033191086,0.13159542047607298,0.2073806123525203,131081.8463387573,1742.0498438527236,132823.89618261004,1726,7,269.7105263157895,38,0,20,34.86763171622326,0.627467105263158,43.99038461538461,1024.038461538461,26.948380566801603,0
3256,4,1,0,38,0.02631578947368421,0.0,1.0,38,1150,900,250,0.782608695652174,14,9,5,357.12036646320365,0.42407539118065435,0.09775682024327237,0.20153700481452158,129889.23890106351,1677.6807973014106,131566.91969836492,1727,0,268.36842105263156,36,2,17,36.0567185888938,0.619212962962963,45.15765765765767,1019.3693693693716,28.315815815815878,8
3257,4,1,0,39,0.02564102564102564,0.0,1.0,39,1300,1000,300,0.7692307692307693,16,10,6,350.4072545104326,0.4263945119208277,0.09653189221349079,0.19950710288915105,130234.60493853886,1327.0300717528546,131561.6350102917,1728,0,262.46153846153845,37,2,19,35.877354352418806,0.620777027027027,44.819078947368425,1020.723684210527,27.587126600284513,0
3258,4,0,0,39,0.0,0.0,1.0,39,1200,800,400,0.6666666666666666,16,8,8,350.9517343274647,0.4256635177687809,0.08605364933867388,0.20068234531984866,130402.54122662744,1352.9996008387243,131755.54082746617,1729,1,263.46153846153845,37,2,19,35.69321434961532,0.6224662162162162,44.6546052631579,1021.3815789473686,27.60490753911807,0
3259,4,0,1,38,0.0,0.02564102564102564,0.9743589743589743,39,1100,800,300,0.7272727272727273,14,8,6,350.80159644398634,0.42546671165092215,0.08360641754782772,0.20117662013916993,130514.55886667062,1356.9431219221428,131871.50198859276,1730,2,264.46153846153845,37,2,15,35.58355241978754,0.6235923423423424,44.544956140350884,1021.8201754385973,27.616761498340466,0
3260,4,0,0,38,0.0,0.0,1.0,38,1000,600,400,0.6,14,6,8,363.0869002831637,0.42440137505926984,0.09693596384878145,0.20810407114776708,130492.60567577752,1876.0311409382784,132368.6368167158,1731,3,272.13157894736844,36,2,15,35.29198354090892,0.6252893518518519,44.56644144144146,1021.7342342342374,28.381506506506597,0
3261,4,0,0,38,0.0,0.0,1.0,38,800,300,500,0.375,13,3,10,365.2157129519001,0.4245643669985775,0.09937009152813658,0.20947960678416866,130521.37230135573,1933.6912081000296,132455.06350945577,1732,4,273.13157894736844,36,2,15,35.20842517081772,0.6255787037037037,44.53828828828831,1021.8468468468494,28.384634634634708,0
3262,4,0,0,38,0.0,0.0,1.0,38,750,600,150,0.8,9,6,3,364.12462140863835,0.4238679468942627,0.1055241121755468,0.2091642445509371,130578.9150637126,1909.3996023050354,132488.31466601763,1733,5,274.13157894736844,36,2,16,35.17794182459233,0.6261574074074074,44.481981981981995,1022.072072072074,28.390890890890944,0
3263,4,0,1,37,0.0,0.02631578947368421,0.9736842105263158,38,1500,1000,500,0.6666666666666666,20,10,10,362.95939983747365,0.42315670934091987,0.10896046546668359,0.20942803489986903,130751.61944038645,1891.5058639720926,132643.12530435855,1734,6,275.13157894736844,36,2,16,35.032665345371804,0.6278935185185186,44.31306306306307,1022.7477477477487,28.409659659659685,0
3264,4,0,1,36,0.0,0.02702702702702703,0.972972972972973,37,700,500,200,0.7142857142857143,9,5,4,371.0089535699491,0.4201076076076076,0.11176884698968492,0.21300449024854679,130558.13426997591,2287.647355109729,132845.78162508563,1735,8,283.4054054054054,35,2,16,35.023121932804834,0.6279761904761905,44.50231481481481,1021.9907407407401,29.19973544973543,0
3265,4,0,0,36,0.0,0.0,1.0,36,850,400,450,0.47058823529411764,13,4,9,378.30999722671675,0.41846891534391534,0.035173552387855356,0.20684611341101505,128641.33536380272,2535.5245552666524,131176.85991906936,1736,9,291.3888888888889,33,3,19,36.790287509060164,0.6130050505050505,46.38480392156865,1014.4607843137283,30.741235888294796,7
3266,4,1,0,37,0.02702702702702703,0.0,1.0,37,1200,800,400,0.6666666666666666,16,8,8,372.5166709197042,0.42123373373373374,0.037790955512474245,0.20531732792551174,128959.43877551044,2207.908163265332,131167.34693877577,1737,0,284.4864864864865,34,3,20,36.61216596343179,0.6139705882352942,46.071428571428584,1015.7142857142876,29.873949579831987,0
3267,4,0,1,36,0.0,0.02702702702702703,0.972972972972973,37,800,400,400,0.5,12,4,8,373.35434779243855,0.4210147647647648,0.033700640755604194,0.20593617645202858,128989.67013888907,2231.7708333333585,131221.44097222242,1738,1,285.4864864864865,34,3,20,36.560021875854524,0.6142769607843137,46.04166666666668,1015.8333333333348,29.8774509803922,0
3268,4,1,0,37,0.02702702702702703,0.0,1.0,37,1450,900,550,0.6206896551724138,20,9,11,370.3614758632471,0.42173423423423423,0.05664479508410203,0.20668559782045703,129450.69204152231,2188.883482314477,131639.5755238368,1739,0,282.8918918918919,33,4,20,36.16580362877331,0.6212121212121212,45.58823529411764,1017.6470588235279,30.83778966131903,0
3269,4,0,0,37,0.0,0.0,1.0,37,950,600,350,0.631578947368421,13,6,7,391.22157713356626,0.42139014014014015,0.07063747458195979,0.20364347494138893,126659.88592128048,2512.954152249161,129172.84007352965,1740,1,283.8918918918919,33,4,17,38.500324648973304,0.5928030303030303,48.34558823529413,1006.6176470588252,30.503565062388645,8
3270,4,1,0,38,0.02631578947368421,0.0,1.0,38,650,400,250,0.6153846153846154,9,4,5,392.0946239433325,0.42493480322427696,0.0835438684673484,0.20182982000912292,126202.37252576271,2482.910847138334,128685.28337290105,1741,0,277.39473684210526,32,6,18,38.951107899807326,0.5904947916666667,48.80050505050505,1004.79797979798,31.399936868686876,8
3271,4,6,4,40,0.13636363636363635,0.09090909090909091,0.9090909090909091,44,800,400,400,0.5,12,4,8,346.474708697545,0.4400876497533474,0.12309989944993172,0.18555108964046232,127811.68845221613,59.828186079581485,127871.51663829571,1742,0,240.4318181818182,37,7,16,38.445203498879486,0.5962837837837838,47.203947368421055,1011.1842105263162,27.329302987197735,0
3272,4,0,0,40,0.0,0.0,1.0,40,1100,900,200,0.8181818181818182,13,9,4,376.2872182671628,0.4315037393162393,0.12667001062197603,0.19839960176587873,127182.05959467114,1571.3966836734633,128753.4562783446,1743,1,265.35,34,6,18,38.33844761792361,0.5958946078431373,47.82738095238095,1008.6904761904757,29.667366946778696,0
3273,4,2,0,42,0.047619047619047616,0.0,1.0,42,1200,700,500,0.5833333333333334,17,7,10,360.17508531986755,0.4361207897793264,0.13700284970883403,0.1931543597087477,127867.13219452149,810.9110495537179,128678.0432440752,1744,0,253.66666666666666,37,5,18,38.042064180398974,0.5968468468468469,47.14912280701755,1011.4035087719305,27.335229966808935,0
3274,4,0,0,42,0.0,0.0,1.0,42,1300,1100,200,0.8461538461538461,15,11,4,358.2639594652561,0.4360361014324429,0.12636489359506275,0.1926608285515958,127978.05574792247,769.9849953831981,128748.04074330567,1745,1,254.66666666666666,37,5,19,37.976809709579534,0.597972972972973,47.03947368421053,1011.8421052631581,27.347083926031303,0
3275,4,2,1,43,0.045454545454545456,0.022727272727272728,0.9772727272727273,44,1650,1000,650,0.6060606060606061,23,10,13,344.5015631015226,0.4378853946441155,0.14579097293846122,0.18877217090021278,128728.04763244471,69.61913761928321,128797.666770064,1746,0,244.04545454545453,37,7,19,37.55931478480102,0.6055743243243243,46.299342105263165,1014.8026315789483,27.42709815078239,0
3276,4,1,2,42,0.022727272727272728,0.045454545454545456,0.9545454545454546,44,1100,600,500,0.5454545454545454,16,6,10,339.7312856530836,0.4399445031712474,0.13741107785899986,0.18746934851553437,129006.37846500856,-34.49943732686339,128971.8790276817,1747,0,229.5,37,7,20,37.39690142111891,0.6083896396396397,46.02521929824562,1015.8991228070183,27.456733048838334,0
3277,4,1,0,43,0.023255813953488372,0.0,1.0,43,900,600,300,0.6666666666666666,12,6,6,343.40836142403987,0.43754614248800294,0.14072048434362783,0.18974731445983561,129058.31665702882,263.94101026704084,129322.25766729585,1748,0,234.72093023255815,36,7,21,37.25063726033469,0.6108217592592593,45.97409909909911,1016.1036036036049,28.225100100100136,0
3278,4,0,0,43,0.0,0.0,1.0,43,1750,1200,550,0.6857142857142857,23,12,11,341.30610051061507,0.43775378368401624,0.13362561951963348,0.18926974664679574,129201.38888888898,219.44444444445,129420.83333333343,1749,1,235.72093023255815,36,7,21,37.15846994535518,0.6122685185185186,45.833333333333336,1016.6666666666674,28.240740740740762,0
3279,4,1,0,44,0.022727272727272728,0.0,1.0,44,1150,900,250,0.782608695652174,14,9,5,331.71364390952283,0.4384249471458774,0.13922290548744676,0.18551984759373544,129536.03512619257,-206.2259541397483,129329.80917205282,1750,0,231.3409090909091,37,7,18,37.062419215855215,0.6137387387387387,45.504385964912274,1017.98245614035,27.513039355144596,0
3280,4,1,0,45,0.022222222222222223,0.0,1.0,45,1850,1500,350,0.8108108108108109,22,15,7,325.71346213615004,0.4403198653198653,0.1526585842074193,0.18406947848664212,129943.7717013891,-535.1128472221969,129408.6588541669,1751,0,227.17777777777778,39,6,19,36.801866230758776,0.6143162393162394,45.10416666666668,1019.5833333333351,26.143162393162438,0
3281,4,0,2,43,0.0,0.044444444444444446,0.9555555555555556,45,1100,800,300,0.7272727272727273,14,8,6,327.4941007116135,0.44002525252525254,0.14977473643595607,0.1854537154463512,130023.43885633702,-483.6181640624757,129539.82069227454,1752,1,228.17777777777778,39,6,19,36.675794947741124,0.6151175213675213,45.02604166666668,1019.8958333333351,26.15117521367526,0
3282,4,0,0,43,0.0,0.0,1.0,43,1800,1200,600,0.6666666666666666,24,12,12,344.66318769689883,0.43662329272794387,0.1478896668342624,0.1945557775360092,129899.0569814752,354.2846116112769,130253.34159308647,1753,2,239.4418604651163,37,6,20,36.36421695170483,0.6173986486486487,45.14802631578948,1019.4078947368431,27.551564722617382,0
3283,4,0,0,43,0.0,0.0,1.0,43,1550,1100,450,0.7096774193548387,20,11,9,346.836842269591,0.43664636397194534,0.15123655120854695,0.19634385087945638,130010.85820877597,418.5111043782913,130429.36931315427,1754,3,240.4418604651163,37,6,20,36.195368777550804,0.6185247747747749,45.038377192982466,1019.8464912280717,27.563418681839778,0
3284,4,0,0,43,0.0,0.0,1.0,43,1600,1200,400,0.75,20,12,8,349.5125657903274,0.4363002953119232,0.1521399047376284,0.19856922693802126,130150.67737188368,497.8594375192394,130648.53680940291,1755,4,241.4418604651163,37,6,20,35.98529622465793,0.6199324324324325,44.901315789473685,1020.3947368421055,27.57823613086772,0
3285,4,0,0,43,0.0,0.0,1.0,43,1500,1100,400,0.7333333333333333,19,11,8,347.56662772873904,0.43611572535991144,0.14784089801404643,0.1981785564143866,130291.32806793276,457.0315954945639,130748.35966342733,1756,5,242.4418604651163,36,7,20,35.892345025369494,0.6232638888888888,44.76351351351351,1020.9459459459456,28.3596096096096,0
3286,4,0,0,43,0.0,0.0,1.0,43,1200,800,400,0.6666666666666666,16,8,8,351.14538365202117,0.43593115540789956,0.15158965576472916,0.20096150000678145,130435.08193582104,560.335377607346,130995.41731342839,1757,6,243.4418604651163,36,7,20,35.65529342593613,0.6247106481481481,44.62274774774775,1021.5090090090097,28.375250250250268,0
3287,4,0,0,43,0.0,0.0,1.0,43,1550,1300,250,0.8387096774193549,18,13,5,348.3789677971935,0.4352390180878553,0.14576000245930643,0.20041725409777694,130636.47050766973,502.19975042609116,131138.6702580958,1758,7,244.4418604651163,36,7,16,35.522003745318365,0.6267361111111112,44.42567567567567,1022.2972972972965,28.397147147147123,0
3288,4,1,1,43,0.022727272727272728,0.022727272727272728,0.9772727272727273,44,1400,800,600,0.5714285714285714,20,8,12,343.0229826564933,0.43502246300211417,0.16079273763168356,0.19938337649501336,131034.66932508699,189.58062065974224,131224.24994574673,1759,0,239.86363636363637,39,5,18,35.256320581951385,0.625267094017094,44.03645833333334,1023.8541666666681,26.252670940170976,0
3289,4,0,0,43,0.0,0.0,1.0,43,1100,900,200,0.8181818181818182,13,9,4,349.68705036394687,0.4344545957918051,0.16287810729044727,0.20249713230869915,130890.45606874132,554.1395006939848,131444.5955694353,1760,1,246.2325581395349,38,5,18,35.231563652815474,0.6255482456140351,44.177350427350426,1023.2905982905983,26.928699955015745,0
3290,4,0,0,43,0.0,0.0,1.0,43,900,600,300,0.6666666666666666,12,6,6,348.27275857409995,0.4344545957918051,0.15695004126814593,0.20196446895519815,130945.1247351887,520.9239626707451,131466.04869785946,1761,2,247.2325581395349,38,5,19,35.21246520528881,0.6260964912280702,44.12393162393162,1023.5042735042724,26.934322986954538,0
3291,4,0,0,43,0.0,0.0,1.0,43,1200,700,500,0.5833333333333334,17,7,10,349.97964575070904,0.43429309708379477,0.15305062701401573,0.20353185223754788,131054.4963109063,573.2812385856967,131627.777549492,1762,3,248.2325581395349,38,5,20,35.058213341680585,0.6271929824561404,44.017094017094,1023.9316239316217,26.94556905083215,0
3292,4,0,0,43,0.0,0.0,1.0,43,1400,1100,300,0.7857142857142857,17,11,6,349.66086730601916,0.4338547434477667,0.15906666408053272,0.2045089658048374,131273.37643363274,580.2325315947052,131853.60896522744,1763,4,249.2325581395349,38,5,20,34.84522692521548,0.6293859649122807,43.8034188034188,1024.786324786324,26.968061178587476,0
3293,4,1,0,44,0.022727272727272728,0.0,1.0,44,1650,1100,550,0.6666666666666666,22,11,11,366.9740266345061,0.43540785764622975,0.03230825777995605,0.20393553607160209,129285.00987082545,693.6563941771262,129978.66626500258,1764,0,244.54545454545453,37,7,19,36.420822102425866,0.611204954954955,45.75109649122806,1016.9956140350862,27.486367946894223,7
3294,4,0,1,43,0.0,0.022727272727272728,0.9772727272727273,44,1000,500,500,0.5,15,5,10,363.5636214473383,0.43528673361522197,0.03179466831261224,0.20261302362821917,129396.54659366333,608.7754164742889,130005.32201013762,1765,1,245.54545454545453,37,7,19,36.393895714337035,0.6123310810810811,45.64144736842105,1017.4342105263149,27.49822190611662,0
3295,4,1,0,44,0.022727272727272728,0.0,1.0,44,1150,800,350,0.6956521739130435,15,8,7,378.7894539293201,0.4346811134601832,-0.009639924819467405,0.19846494193902203,126926.22369382868,878.6962094105697,127804.91990323925,1766,0,245.45454545454547,37,7,15,38.53871962277839,0.5872747747747749,48.081140350877185,1007.6754385964897,27.23447131341864,8
3296,4,2,1,45,0.043478260869565216,0.021739130434782608,0.9782608695652174,46,1250,900,350,0.72,16,9,7,368.38033148964627,0.4382347020933977,0.012647050707774943,0.19587557108566414,127523.29082657577,195.5226358400763,127718.81346241586,1767,0,235.7391304347826,38,8,14,38.187319300472474,0.5915570175438596,47.489316239316224,1010.0427350427325,26.58007197480875,0
3297,4,0,1,44,0.0,0.022222222222222223,0.9777777777777777,45,1650,1300,350,0.7878787878787878,20,13,7,375.64555881420176,0.43686868686868685,0.006713917980182282,0.1996052539331445,127496.31461620607,578.6848701511747,128074.99948635725,1768,1,241.9777777777778,38,7,15,38.03157727705489,0.591282894736842,47.51602564102562,1009.9358974358945,26.57726045883933,0
3298,4,1,0,45,0.022222222222222223,0.0,1.0,45,1150,600,550,0.5217391304347826,17,6,11,378.0960282524118,0.43688973063973063,0.029007004532344505,0.20256932904384167,127828.32031249999,666.2760416666661,128494.59635416666,1769,0,237.4,39,6,16,37.62875978574371,0.592948717948718,47.1875,1011.2499999999999,25.929487179487175,0
3299,4,0,1,44,0.0,0.022222222222222223,0.9777777777777777,45,1550,1000,550,0.6451612903225806,21,10,11,375.7923038161943,0.4365951178451179,0.02997118155619627,0.20239456895111638,128039.08420138869,623.220486111092,128662.30468749978,1770,1,238.4,39,6,18,37.47083847948401,0.5950854700854701,46.97916666666666,1012.0833333333317,25.95085470085466,0
3300,4,2,0,46,0.043478260869565216,0.0,1.0,46,1000,800,200,0.8,12,8,4,361.21066169814935,0.4389492753623188,0.04497986116659525,0.19737506387298182,128616.79945993004,91.72545879501945,128708.52491872506,1771,0,230.95652173913044,37,9,14,37.249013620149164,0.6044481981981982,46.40899122807018,1014.3640350877199,27.41524419156,0
3301,4,0,1,45,0.0,0.021739130434782608,0.9782608695652174,46,1350,1100,250,0.8148148148148148,16,11,5,389.39484327209027,0.43913043478260866,0.02387860979752965,0.20928315356337637,127955.29827781422,979.6660239323508,128934.96430174657,1772,1,231.95652173913044,38,8,13,37.21268919394578,0.5959429824561404,47.061965811965806,1011.7521367521362,26.625056230319373,8
3302,4,1,3,43,0.021739130434782608,0.06521739130434782,0.9347826086956522,46,1450,1000,450,0.6896551724137931,19,10,9,375.6830096046487,0.4393115942028985,0.036663836632557345,0.20421204935492956,128408.33875868088,468.78326547550773,128877.12202415639,1773,0,232.91304347826087,39,7,14,37.095323741007206,0.5988247863247863,46.61458333333335,1013.5416666666692,25.988247863247928,8
3303,4,0,0,43,0.0,0.0,1.0,43,1150,800,350,0.6956521739130435,15,8,7,389.3376687158111,0.4380537098560355,0.020863240501482805,0.21024234110653867,128144.53125000047,1378.2986111111554,129522.82986111162,1774,3,242.58139534883722,39,4,16,37.019890260631,0.5961538461538461,46.87500000000002,1012.5000000000038,25.96153846153856,0
3304,4,1,1,43,0.022727272727272728,0.022727272727272728,0.9772727272727273,44,1500,1200,300,0.8,18,12,6,381.1686339057253,0.4415301268498943,0.03666489743362922,0.2079898935099737,128561.19340806788,1000.6988929285951,129561.89230099648,1775,0,238.04545454545453,37,7,15,36.79981169135401,0.6038851351351351,46.463815789473685,1014.1447368421054,27.409317211948796,0
3305,4,1,2,42,0.022727272727272728,0.045454545454545456,0.9545454545454546,44,1550,1000,550,0.6451612903225806,21,10,11,366.3416720066109,0.44225687103594086,0.0846839051206354,0.18953830423053533,126411.6206578202,463.55892708027585,126875.17958490047,1776,0,238.8409090909091,36,8,14,39.38223217618516,0.583912037037037,48.592342342342356,1005.6306306306324,27.934184184184232,8
3306,4,1,0,43,0.023255813953488372,0.0,1.0,43,1550,1400,150,0.9032258064516129,17,14,3,386.00609629434814,0.4419066076042821,0.06502465105866806,0.2002658806210054,126524.89271365991,1306.3622321646346,127831.25494582455,1777,0,244.51162790697674,36,7,16,38.770893963137105,0.5850694444444444,48.47972972972975,1006.0810810810835,27.946696696696765,8
3307,4,1,3,41,0.022727272727272728,0.06818181818181818,0.9318181818181819,44,1200,600,600,0.5,18,6,12,383.18231897182187,0.44169529598308666,0.06964617881030555,0.20049425664653214,126870.984341336,922.9435980301857,127793.92793936619,1778,0,239.9318181818182,37,7,18,38.484980409229436,0.5867117117117118,48.13596491228071,1007.456140350879,27.22854433380754,0
3308,4,2,1,42,0.046511627906976744,0.023255813953488372,0.9767441860465116,43,1050,600,450,0.5714285714285714,15,6,9,371.20474814569764,0.4446520856404577,0.0726349430921005,0.19648876979190064,127340.90206842516,854.1018630732818,128195.00393149845,1779,0,227.06976744186048,37,6,16,38.30334510229948,0.5914977477477478,47.66995614035089,1009.3201754385987,27.278923660502667,0
3309,4,0,1,41,0.0,0.023809523809523808,0.9761904761904762,42,1000,700,300,0.7,13,7,6,377.09745706778574,0.4428716608594658,0.07401708311408095,0.19908168048734834,127233.9923327047,1195.9229922490479,128429.91532495375,1780,1,233.47619047619048,36,6,19,38.264594262752546,0.5923032407407407,47.77590090090092,1008.8963963963995,28.024899899899985,0
3310,4,4,1,44,0.08888888888888889,0.022222222222222223,0.9777777777777777,45,1100,700,400,0.6363636363636364,15,7,8,365.8814752122444,0.4444654882154882,0.1398151153425411,0.19881496034019872,128394.44739006255,401.9229434933655,128796.37033355591,1781,0,218.7111111111111,37,8,17,37.35788795124238,0.6021959459459459,46.62828947368422,1013.4868421052649,27.391536273115268,0
3311,4,0,1,43,0.0,0.022727272727272728,0.9772727272727273,44,1500,1000,500,0.6666666666666666,20,10,10,374.12532144616,0.44365530303030304,0.14169934112130633,0.20274887901985902,128287.09621783963,799.0902219787557,129086.18643981838,1782,1,224.61363636363637,36,8,21,37.25892063139174,0.6030092592592593,46.73423423423424,1013.0630630630644,28.14064064064068,0
3312,4,0,1,42,0.0,0.023255813953488372,0.9767441860465116,43,1250,900,350,0.72,16,9,7,370.87626676499247,0.4410068290882245,0.09057950626612743,0.1905763836147643,126131.01912133479,789.2353387664008,126920.25446010119,1783,2,230.72093023255815,35,8,19,39.55776875216037,0.5830357142857143,48.87152777777777,1004.5138888888881,28.700396825396805,8
3313,4,4,0,46,0.08695652173913043,0.0,1.0,46,1000,500,500,0.5,15,5,10,343.02464699667144,0.44801731078904994,0.14653693995673622,0.1767408746996709,126241.80768606468,-475.41172577417024,125766.39596029051,1784,0,216.54347826086956,36,10,18,40.14315329448677,0.5821759259259259,48.761261261261275,1004.9549549549569,27.915415415415467,8
3314,4,2,3,45,0.041666666666666664,0.0625,0.9375,48,1500,1300,200,0.8666666666666667,17,13,4,326.39868532678463,0.4500591016548463,0.15804872012445248,0.1705813084956169,126822.8367667472,-1321.0385619840497,125501.79820476315,1785,0,208.47916666666666,38,10,19,39.96451173808518,0.5844298245614035,48.183760683760696,1007.2649572649588,26.50697255960418,0
3315,4,3,0,48,0.0625,0.0,1.0,48,900,500,400,0.5555555555555556,13,5,8,319.25265099705956,0.45391917848699764,0.1708795139266186,0.16875830827834223,127285.57254395587,-1472.4633494768395,125813.10919447904,1786,0,207.66666666666666,37,11,22,39.67082744757144,0.5909346846846847,47.72478070175439,1009.1008771929828,27.272996680891428,0
3316,4,0,4,44,0.0,0.08333333333333333,0.9166666666666666,48,1450,1100,350,0.7586206896551724,18,11,7,319.7149987054659,0.454011524822695,0.17187047494931962,0.16958155000460423,127423.91889812255,-1452.1323868882687,125971.78651123427,1787,1,208.66666666666666,37,11,15,39.51772009846509,0.5923423423423424,47.58771929824562,1009.6491228070179,27.2878141299194,0
3317,4,1,0,45,0.022222222222222223,0.0,1.0,45,1200,700,500,0.5833333333333334,17,7,10,335.7572656836053,0.45016835016835016,0.1926061857246626,0.17752987261948783,127296.33012099189,-451.86645340364237,126844.46366758825,1788,0,222.62222222222223,35,10,20,39.243438658867575,0.5949404761904762,47.71412037037037,1009.1435185185181,28.83267195767195,0
3318,4,2,1,46,0.0425531914893617,0.02127659574468085,0.9787234042553191,47,1450,1100,350,0.7586206896551724,18,11,7,317.92319012695384,0.4525901942645698,0.2006856278659086,0.1710853132175892,128005.79415060394,-1260.7979137811735,126744.99623682276,1789,0,214.10638297872342,37,10,18,38.96898815328494,0.5982545045045045,47.01206140350877,1011.9517543859641,27.35004741583687,0
3319,4,0,1,45,0.0,0.021739130434782608,0.9782608695652174,46,1600,1100,500,0.6875,21,11,10,325.5525575650535,0.4510366344605475,0.19817866435385967,0.17458702273139823,127867.1321945212,-874.5056171129784,126992.62657740821,1790,1,219.67391304347825,37,9,18,38.91749783174328,0.5968468468468469,47.149122807017534,1011.4035087719283,27.33522996680887,0
3320,4,0,2,43,0.0,0.044444444444444446,0.9555555555555556,45,1300,1000,300,0.7692307692307693,16,10,6,329.0190723296531,0.44966329966329965,0.2058726802912847,0.17716563229638055,128030.53634293073,-575.102340516202,127455.43400241453,1791,2,225.0222222222222,36,9,18,38.6630225140017,0.6004050925925926,46.98761261261261,1012.0495495495493,28.11248748748748,0
3321,4,2,1,44,0.044444444444444446,0.022222222222222223,0.9777777777777777,45,1300,900,400,0.6923076923076923,17,9,8,332.35194237883087,0.45191498316498313,0.22276043402585044,0.18075527693968868,128429.74044568177,-463.2252607337432,127966.51518494803,1792,0,210.15555555555557,36,9,19,38.171453171869786,0.6044560185185186,46.59346846846845,1013.6261261261229,28.156281281281192,0
3322,4,0,0,44,0.0,0.0,1.0,44,800,500,300,0.625,11,5,6,333.1293406741843,0.450636451726568,0.2235700422422655,0.18134741423027817,128466.99948827563,-240.77463241601174,128226.22485585962,1793,1,214.79545454545453,35,9,19,38.113773452068344,0.606845238095238,46.55671296296295,1013.773148148146,28.964947089947028,0
3323,4,1,0,45,0.022222222222222223,0.0,1.0,45,1500,1100,400,0.7333333333333333,19,11,8,325.08312147821266,0.4511153198653199,0.22621019422261734,0.17871642824680237,128858.1486892295,-622.0781592403447,128236.07052998916,1794,0,211.0,36,9,20,37.919624371487764,0.6087962962962963,46.17117117117116,1015.3153153153131,28.20320320320314,0
3324,4,0,0,45,0.0,0.0,1.0,45,1250,700,550,0.56,18,7,11,325.04117482214923,0.45092592592592595,0.21898497166789865,0.17920974308653947,128972.51136271395,-615.7246773800971,128356.78668533385,1795,1,212.0,36,9,20,37.80441611234295,0.6099537037037037,46.05855855855855,1015.7657657657649,28.21571571571569,0
3325,4,1,0,46,0.021739130434782608,0.0,1.0,46,800,600,200,0.75,10,6,4,318.7178295342342,0.45245571658615136,0.22918638762102006,0.1774948392808297,129368.65790435509,-953.5804285934269,128415.07747576166,1796,0,208.3695652173913,37,9,21,37.562872745562984,0.6120495495495495,45.6688596491228,1017.3245614035079,27.495258416311025,0
3326,4,0,0,46,0.0,0.0,1.0,46,1150,800,350,0.6956521739130435,15,8,7,320.2938551303481,0.45248590982286635,0.23204102765946533,0.17849889980507488,129396.5465936632,-911.0162501923926,128485.5303434708,1797,1,209.3695652173913,37,9,21,37.49449922764666,0.6123310810810811,45.64144736842104,1017.4342105263139,27.49822190611659,0
3327,4,2,0,48,0.041666666666666664,0.0,1.0,48,1450,1000,450,0.6896551724137931,19,10,9,306.9332308086633,0.4536975472813239,0.23982162309368205,0.1739288307915759,130049.99999999999,-1616.6666666666683,128433.33333333331,1798,0,201.60416666666666,39,9,18,37.17320261437907,0.6153846153846154,45.0,1019.9999999999999,26.15384615384615,0
3328,4,0,2,46,0.0,0.041666666666666664,0.9583333333333334,48,1750,1500,250,0.8571428571428571,20,15,5,306.56368252915865,0.45260786052009455,0.2376973191807854,0.1744315308606677,130209.42382812501,-1616.5039062499977,128592.91992187501,1799,1,202.60416666666666,39,9,18,37.02158603796694,0.6169871794871795,44.84375,1020.6250000000001,26.1698717948718,0
3329,4,2,1,47,0.041666666666666664,0.020833333333333332,0.9791666666666666,48,1400,900,500,0.6428571428571429,19,9,10,303.49094236044306,0.45220153664302604,0.24073176591443812,0.17454633443131498,130625.9411250744,-1671.2420062462772,128954.69911882812,1800,0,191.375,40,8,15,36.67983895019386,0.61953125,44.4359756097561,1022.256097560976,25.5564024390244,0
3330,4,0,0,47,0.0,0.0,1.0,47,1600,1200,400,0.75,20,12,8,304.1488642696508,0.45133749614554425,0.2247028467492922,0.17504219534054272,130651.91436975347,-1452.4737259567646,129199.44064379671,1801,1,196.4468085106383,40,7,15,36.63684559310804,0.6197916666666667,44.41056910569106,1022.3577235772359,25.558943089430898,0
3331,4,1,1,47,0.020833333333333332,0.020833333333333332,0.9791666666666666,48,1300,900,400,0.6923076923076923,17,9,8,302.3399133869648,0.4515735815602837,0.23321103361425966,0.1760324267283494,131099.43000637754,-1672.681937358278,129426.74806901926,1802,0,193.33333333333334,41,7,17,36.232502663954286,0.6227134146341464,43.973214285714285,1024.1071428571427,24.978222996515676,0
3332,4,0,0,47,0.0,0.0,1.0,47,1700,1100,600,0.6470588235294118,23,11,12,307.69319434267805,0.4510869565217391,0.23210178976822804,0.17888106941733886,131041.82287535531,-1335.8645853988992,129705.95828995641,1803,1,198.36170212765958,40,7,17,36.15343258891647,0.6236979166666667,44.02947154471545,1023.8821138211384,25.59705284552846,0
3333,4,0,0,47,0.0,0.0,1.0,47,1800,1400,400,0.7777777777777778,22,14,8,306.42289441539623,0.45070151094665434,0.22490833057146387,0.1786255843153717,131145.89659139724,-1362.7789551523665,129783.11763624488,1804,2,199.36170212765958,40,7,17,36.081208453219546,0.6247395833333333,43.92784552845528,1024.2886178861784,25.60721544715446,0
3334,4,0,1,46,0.0,0.02127659574468085,0.9787234042553191,47,2150,1600,550,0.7441860465116279,27,16,11,309.562177121635,0.4501426148627814,0.2262386734037276,0.18119179084571624,131302.08462431436,-1270.768164617611,130031.31645969675,1805,3,200.36170212765958,40,7,19,35.84366220459428,0.6263020833333333,43.775406504065046,1024.8983739837408,25.62245934959352,0
3335,4,0,1,45,0.0,0.021739130434782608,0.9782608695652174,46,1300,1000,300,0.7692307692307693,16,10,6,314.9364374936684,0.45018115942028986,0.21700164923790655,0.18472677592843792,131382.8849806415,-924.5458693494717,130458.33911129204,1806,4,204.93478260869566,38,8,21,35.624652633041535,0.6304824561403508,43.6965811965812,1025.213675213676,26.979307242465158,0
3336,4,0,0,45,0.0,0.0,1.0,45,1750,1400,350,0.8,21,14,7,318.26293872694833,0.449179292929293,0.21120144534778684,0.18641114982578394,131328.125,-640.625,130687.5,1807,5,210.17777777777778,38,7,21,35.59451219512195,0.6299342105263157,43.75,1025.0,26.973684210526315,0
3337,4,0,2,43,0.0,0.044444444444444446,0.9555555555555556,45,1400,1000,400,0.7142857142857143,18,10,8,319.080078125,0.44859006734006734,0.21486111111111117,0.18769416360294117,131492.4391847469,-608.6764464168264,130883.76273833009,1808,6,211.17777777777778,38,7,22,35.408203125,0.631578947368421,43.58974358974359,1025.6410256410259,26.990553306342786,0
3338,4,0,0,43,0.0,0.0,1.0,43,1100,700,400,0.6363636363636364,15,7,8,330.8900604921531,0.4478820598006645,0.20261474639310073,0.19409942723714957,131385.84530476414,94.85406014121224,131480.69936490536,1809,7,219.32558139534885,36,7,23,35.212772773872274,0.6342592592592593,43.69369369369369,1025.2252252252247,28.478478478478465,0
3339,4,0,0,43,0.0,0.0,1.0,43,900,700,200,0.7777777777777778,11,7,4,331.73618782156177,0.4476974898486526,0.2043753112907547,0.1947426170287118,131414.71021274658,119.00299793036288,131533.71321067694,1810,8,220.32558139534885,36,7,23,35.16199890170235,0.6345486111111112,43.66554054054054,1025.3378378378382,28.481606606606615,0
3340,4,0,1,42,0.0,0.023255813953488372,0.9767441860465116,43,1050,700,350,0.6666666666666666,14,7,7,334.21732360553455,0.4470514950166113,0.21324468139432717,0.19664414621441906,131501.32395909424,190.00410883856892,131691.3280679328,1811,9,221.32558139534885,36,7,23,35.0111166007905,0.6354166666666667,43.58108108108108,1025.6756756756758,28.490990990990994,0
3341,4,2,0,44,0.045454545454545456,0.0,1.0,44,1250,900,350,0.72,16,9,7,308.1560163347906,0.4486103770260747,0.137744328333965,0.17902904893637142,131015.81090124926,-710.6779969592878,130305.13290428997,1812,0,216.3409090909091,40,4,16,36.167775130699475,0.6234375,44.05487804878049,1023.7804878048781,25.594512195121954,8
3342,4,1,0,45,0.022222222222222223,0.0,1.0,45,1650,1300,350,0.7878787878787878,20,13,7,305.54693277526025,0.4487373737373737,0.13570806311102546,0.17884449645899195,131302.70460325308,-976.1722686760168,130326.53233457706,1813,0,212.51111111111112,41,4,17,35.94591923982834,0.6247459349593496,43.774801587301575,1024.9007936507915,24.997580332946132,0
3343,4,0,0,45,0.0,0.0,1.0,45,1550,1200,350,0.7741935483870968,19,12,7,304.2961448691007,0.44776936026936026,0.1354071725777699,0.1792045091195273,131536.54095611055,-994.7850750528793,130541.75588105767,1814,1,213.51111111111112,40,5,17,35.74297437421571,0.6286458333333333,43.54674796747967,1025.8130081300797,25.645325203251993,0
3344,4,0,1,44,0.0,0.022222222222222223,0.9777777777777777,45,850,500,350,0.5882352941176471,12,5,7,304.37518279286934,0.4476010101010101,0.13643216356893695,0.1796187154096785,131614.7395420218,-987.9479187322552,130626.79162328954,1815,2,214.51111111111112,40,5,14,35.66240797596646,0.6294270833333333,43.470528455284544,1026.1178861788605,25.652947154471512,0
3345,4,0,0,44,0.0,0.0,1.0,44,1100,800,300,0.7272727272727273,14,8,6,306.34339816102573,0.4471568886539817,0.12858335716855995,0.18106787654952505,131675.35942925324,-732.4245876736364,130942.9348415796,1816,3,209.79545454545453,39,5,14,35.551037754998475,0.6316773504273504,43.41145833333332,1026.3541666666647,26.316773504273453,0
3346,4,0,1,43,0.0,0.022727272727272728,0.9772727272727273,44,1450,900,550,0.6206896551724138,20,9,11,308.0448798390447,0.4466173361522199,0.13078554305734835,0.18297123585620376,131862.521701389,-676.0850694444349,131186.43663194455,1817,4,210.79545454545453,39,5,14,35.31947261663285,0.6335470085470085,43.22916666666667,1027.0833333333342,26.335470085470106,0
3347,4,0,0,43,0.0,0.0,1.0,43,1200,900,300,0.75,15,9,6,312.52551958911243,0.445344222960502,0.13448894780383247,0.18569965051481632,131876.23844875448,-357.062011469063,131519.1764372854,1818,6,216.6046511627907,38,5,15,35.190650787046664,0.6354166666666667,43.215811965811966,1027.1367521367522,27.02991452991453,0
3348,4,0,0,43,0.0,0.0,1.0,43,1150,900,250,0.782608695652174,14,9,5,309.4872093398033,0.44539036544850497,0.13044380316490356,0.184346729041535,131969.53124999997,-431.4236111111117,131538.10763888885,1819,7,217.6046511627907,39,4,15,35.175047310083805,0.6346153846153846,43.125,1027.4999999999998,26.34615384615384,0
3349,4,0,0,43,0.0,0.0,1.0,43,1650,1200,450,0.7272727272727273,21,12,9,310.6044333263472,0.4449981543004799,0.12651313603555425,0.1856665749544351,132103.35422092033,-393.6225043402548,131709.73171658008,1820,8,218.6046511627907,39,4,15,35.012095957037204,0.6359508547008548,42.99479166666668,1028.0208333333348,26.359508547008584,0
3350,4,0,0,43,0.0,0.0,1.0,43,1600,1300,300,0.8125,19,13,6,310.8336772401392,0.44425987449243265,0.12509829218794932,0.18699239121669267,132344.40646701382,-372.58029513889437,131971.8261718749,1821,9,219.6046511627907,39,4,16,34.76454410474456,0.6383547008547008,42.760416666666664,1028.9583333333328,26.383547008546994,0
3351,4,0,0,43,0.0,0.0,1.0,43,1600,1300,300,0.8125,19,13,6,309.5189238831017,0.4436830933923957,0.12467452237138366,0.18701152786592148,132507.9800044743,-397.2436739238742,132110.73633055043,1822,10,220.6046511627907,38,5,18,34.63452492131024,0.6417214912280702,42.60149572649572,1029.5940170940162,27.094579397210953,0
3352,4,0,0,43,0.0,0.0,1.0,43,1100,700,400,0.6363636363636364,15,7,8,309.34793650247076,0.44342930970837946,0.1259094856701728,0.18731872536958644,132590.49236613332,-396.68095733802,132193.8114087953,1823,11,221.6046511627907,38,5,18,34.55631915629323,0.6425438596491229,42.521367521367516,1029.914529914529,27.103013945119187,0
3353,4,0,0,43,0.0,0.0,1.0,43,1000,700,300,0.7,13,7,6,345.2300253652043,0.4433370247323736,0.06849048453172668,0.19643227575657787,130209.42382812499,491.297065333022,130700.72089345801,1824,12,222.6046511627907,39,4,19,36.03499013404097,0.6169871794871795,44.84375,1020.6249999999999,26.169871794871792,8
3354,4,0,0,43,0.0,0.0,1.0,43,1700,1200,500,0.7058823529411765,22,12,10,343.61805230476875,0.44229881875230714,0.07014181104838335,0.19691469934660694,130486.54994806065,367.5285304131711,130854.07847847382,1825,13,223.6046511627907,37,6,21,35.79541389425486,0.6233108108108107,44.572368421052616,1021.7105263157871,27.613798008534786,0
3355,4,0,0,43,0.0,0.0,1.0,43,1150,700,450,0.6086956521739131,16,7,9,340.5342484328661,0.4416297526762643,0.07437070081810782,0.1955711478522945,130570.58572108703,292.75125519387933,130863.33697628092,1826,14,224.6046511627907,37,6,16,35.78914547795299,0.6241554054054055,44.490131578947356,1022.0394736842086,27.622688477951584,0
3356,4,1,0,44,0.022727272727272728,0.0,1.0,44,1600,1100,500,0.6875,21,11,10,335.25554647794706,0.4411997885835095,0.08043381699733532,0.19419519390326345,130901.3888888888,-22.91666666667095,130878.47222222213,1827,0,220.47727272727272,39,5,18,35.58971226927254,0.6239316239316239,44.166666666666664,1023.3333333333326,26.23931623931622,0
3357,4,0,1,43,0.0,0.022727272727272728,0.9772727272727273,44,1450,1000,450,0.6896551724137931,19,10,9,352.9387442686205,0.43983439041578576,0.07315646704351986,0.19356393404781516,128762.65290377753,314.76024935554193,129077.41315313308,1828,1,221.47727272727272,40,4,16,37.30996128300123,0.60078125,46.265243902439025,1014.939024390244,25.3734756097561,8
3358,4,0,2,41,0.0,0.046511627906976744,0.9534883720930233,43,1000,700,300,0.7,13,7,6,360.06158309538654,0.4399916943521595,0.08026883568182686,0.19754730099557688,128778.12499999997,673.6111111111102,129451.73611111108,1829,17,227.6046511627907,39,4,16,37.113437328954575,0.6025641025641026,46.25,1014.9999999999998,26.02564102564102,0
3359,4,0,0,41,0.0,0.0,1.0,41,1500,1000,500,0.6666666666666666,20,10,10,366.4173818173542,0.4377286585365854,0.09062998247486531,0.20078110531199575,128728.04763244434,1233.638835987966,129961.68646843231,1830,18,237.5609756097561,37,4,16,37.003309022150184,0.6055743243243243,46.29934210526314,1014.8026315789454,27.427098150782307,0
3360,4,1,1,41,0.023809523809523808,0.023809523809523808,0.9761904761904762,42,950,700,250,0.7368421052631579,12,7,5,361.7039270832082,0.4392058652729385,0.0974558452481078,0.20003068339624852,129092.79348381906,938.6740722477823,130031.46755606684,1831,0,232.88095238095238,38,4,17,36.750727151668066,0.6074561403508771,45.94017094017094,1016.2393162393156,26.74313990103462,0
3361,4,1,0,42,0.023809523809523808,0.0,1.0,42,1550,1100,450,0.7096774193548387,20,11,9,354.0227171133668,0.43858885017421606,0.10559065049232141,0.19823920066494524,129584.09857521014,775.2799057472739,130359.37848095741,1832,0,232.54761904761904,35,7,17,36.445781705884585,0.6181547619047619,45.45717592592593,1018.171296296297,29.090608465608486,0
3362,4,0,0,42,0.0,0.0,1.0,42,1000,700,300,0.7,13,7,6,356.43388429752076,0.43835898180410376,0.11082251082251071,0.2000394248608534,129672.49657064464,843.9343278463571,130516.430898491,1833,1,233.54761904761904,35,7,17,36.294507575757585,0.6190476190476191,45.37037037037037,1018.5185185185179,29.100529100529084,0
3363,4,0,1,41,0.0,0.023809523809523808,0.9761904761904762,42,2000,1400,600,0.7,26,14,12,362.1326497914829,0.4375362950058072,0.11258758916735045,0.20436563253818618,129889.23890106338,1007.4268525282193,130896.6657535916,1834,2,234.54761904761904,36,6,17,35.928984386507594,0.619212962962963,45.157657657657666,1019.3693693693706,28.31581581581585,0
3364,4,0,0,41,0.0,0.0,1.0,41,750,400,350,0.5333333333333333,11,4,7,368.39109411578266,0.43661077235772355,0.12101547576202187,0.20831357760975897,129967.37423911181,1375.764639060358,131343.13887817218,1835,3,240.0487804878049,35,6,17,35.690030268634125,0.6220238095238095,45.08101851851852,1019.6759259259261,29.13359788359789,0
3365,4,1,0,42,0.023809523809523808,0.0,1.0,42,550,300,250,0.5454545454545454,8,3,5,359.6834652228237,0.4382500967866822,0.12623906705539367,0.2049359278595159,130262.58680555565,970.6597222222318,131233.24652777787,1836,0,235.3095238095238,36,6,18,35.61224489795919,0.622974537037037,44.79166666666667,1020.8333333333342,28.356481481481506,0
3366,4,0,1,41,0.0,0.023809523809523808,0.9761904761904762,42,1450,1000,450,0.6896551724137931,19,10,9,353.53037682491316,0.4386856368563686,0.11905904259268785,0.20256926127761513,130481.60750973174,825.8423743271701,131307.4498840589,1837,1,236.3095238095238,33,9,18,35.54723421694455,0.6316287878787878,44.577205882352935,1021.6911764705874,30.960338680926892,0
3367,4,2,1,42,0.046511627906976744,0.023255813953488372,0.9767441860465116,43,1000,900,100,0.9,11,9,2,337.96013197780275,0.43888427464008856,0.13270112283947966,0.19672837156181594,131090.9636488342,260.7038751714812,131351.6675240057,1838,0,230.8139534883721,35,8,20,35.329076250753445,0.6333333333333333,43.98148148148149,1024.0740740740755,29.2592592592593,0
3368,4,0,1,41,0.0,0.023809523809523808,0.9761904761904762,42,1250,800,450,0.64,17,8,9,341.154433174538,0.43831058846302745,0.13535293199662046,0.1987409861199137,131120.5970963007,546.4745959790982,131667.0716922798,1839,1,235.9047619047619,35,7,20,35.217373902889236,0.6336309523809525,43.952546296296305,1024.189814814816,29.262566137566168,0
3369,4,0,1,40,0.0,0.024390243902439025,0.975609756097561,41,1350,1000,350,0.7407407407407407,17,10,7,347.5988500835544,0.4388211382113821,0.13064277834965266,0.20214318523114647,131053.71492346958,910.8241213152138,131964.5390447848,1840,2,237.58536585365854,34,7,20,35.119947292950435,0.6351102941176471,44.01785714285715,1023.928571428573,30.11554621848744,0
3370,4,0,1,39,0.0,0.025,0.975,40,1200,900,300,0.75,15,9,6,354.27428681683267,0.43842147435897433,0.1326711345141216,0.2061501351421629,131077.01965590185,1287.4435313341405,132364.463187236,1841,3,243.325,33,7,20,34.92550263283869,0.6376262626262627,43.995098039215705,1024.0196078431395,31.030897207367865,0
3371,4,0,0,39,0.0,0.0,1.0,39,900,600,300,0.6666666666666666,12,6,6,354.8945166203207,0.43792172739541163,0.137114012248565,0.20735660750960921,131233.93233672174,1514.8405961649692,132748.7729328867,1842,4,249.02564102564102,33,6,20,34.75100167444085,0.6392045454545454,43.8419117647059,1024.6323529411789,31.049465240641783,0
3372,4,0,0,39,0.0,0.0,1.0,39,850,500,350,0.5882352941176471,12,5,7,355.2002914644418,0.437246963562753,0.13684898670734347,0.20822174486641176,131360.4817907612,1531.8900748875424,132892.37186564875,1843,5,250.02564102564102,32,7,20,34.615305661616794,0.6429036458333333,43.718434343434346,1025.126262626263,32.03519570707072,0
3373,4,0,0,39,0.0,0.0,1.0,39,1150,700,450,0.6086956521739131,16,7,9,356.2263150098161,0.43690958164642374,0.13922300304964663,0.20935384446524793,131457.57607642072,1565.7295811651798,133023.3056575859,1844,6,251.02564102564102,32,7,20,34.490940244603124,0.6438802083333333,43.62373737373737,1025.5050505050501,32.047032828282816,0
3374,4,1,0,40,0.025,0.0,1.0,40,1300,800,500,0.6153846153846154,18,8,10,349.1025911221739,0.43818108974358977,0.1383054892601432,0.20718694855551123,131831.05656478286,1204.5126874279233,133035.5692522108,1845,0,245.725,33,7,19,34.29693715194907,0.6452020202020202,43.25980392156863,1026.9607843137262,31.120023767082614,0
3375,4,1,0,41,0.024390243902439025,0.0,1.0,41,1000,600,400,0.6,14,6,8,340.1771150590913,0.43922764227642275,0.145155311735488,0.20348776518989298,132130.12695312512,789.529079861125,132919.65603298624,1846,0,240.70731707317074,35,6,20,34.2251350894968,0.64375,42.96875000000001,1028.125000000001,29.375000000000025,0
3376,4,0,0,41,0.0,0.0,1.0,41,1000,700,300,0.7,13,7,6,342.2968097137734,0.43841463414634146,0.1421927347859373,0.2057252428360874,132308.68115837194,857.7678915895157,133166.44904996146,1847,1,241.70731707317074,35,6,20,33.991098548768136,0.6455357142857143,42.79513888888889,1028.8194444444448,29.39484126984128,0
3377,4,1,1,41,0.023809523809523808,0.023809523809523808,0.9761904761904762,42,1200,800,400,0.6666666666666666,16,8,8,331.85085440874735,0.43902439024390244,0.14174194894176928,0.2016701813516094,132725.77649444874,409.0626071673555,133134.8391016161,1848,0,236.92857142857142,35,7,18,33.841237972219105,0.649702380952381,42.3900462962963,1030.439814814815,29.44113756613757,0
3378,4,0,0,41,0.0,0.0,1.0,41,800,300,500,0.375,13,3,10,340.0152910003037,0.4384908536585366,0.1489857131581025,0.206009264547243,132612.50000000012,818.0555555555707,133430.55555555568,1849,1,243.46341463414635,34,7,22,33.74460625674217,0.6507352941176471,42.50000000000001,1030.000000000001,30.29411764705885,0
3379,4,0,1,40,0.0,0.024390243902439025,0.975609756097561,41,1150,800,350,0.6956521739130435,15,8,7,340.99113890835497,0.4381097560975609,0.1510261491150673,0.20676918885592122,132643.15653344677,846.0282029478456,133489.1847363946,1850,2,244.46341463414635,34,7,18,33.68870141376786,0.6510416666666667,42.470238095238095,1030.119047619048,30.297619047619058,0
3380,4,0,0,40,0.0,0.0,1.0,40,1050,700,350,0.6666666666666666,14,7,7,340.7051677915735,0.43786057692307695,0.1456873315363878,0.20721576598471114,132755.59413580247,1046.103395061721,133801.69753086418,1851,3,243.9,35,5,18,33.583221024258755,0.65,42.36111111111111,1030.5555555555554,29.44444444444444,0
3381,4,0,0,40,0.0,0.0,1.0,40,1100,800,300,0.7272727272727273,14,8,6,342.0343191702706,0.43737980769230766,0.14471704468897406,0.2083555161785518,132815.2394654491,1085.4740012002594,133900.71346664935,1852,4,244.9,35,5,18,33.48912718017815,0.6505952380952381,42.30324074074073,1030.787037037036,29.451058201058174,0
3382,4,0,0,40,0.0,0.0,1.0,40,1100,800,300,0.7272727272727273,14,8,6,340.00612182430393,0.43696581196581197,0.1344949494949501,0.20778151889263,132934.57031249985,1039.7135416666526,133974.2838541665,1853,5,245.9,35,5,18,33.42171717171718,0.6517857142857143,42.18749999999999,1031.2499999999989,29.464285714285683,0
3383,4,0,2,38,0.0,0.05,0.95,40,1450,1100,350,0.7586206896551724,18,11,7,362.6963704273652,0.4361111111111111,0.07238148984198656,0.21309614336780205,131446.7860510974,1562.1811771261991,133008.9672282236,1854,6,246.9,35,5,21,34.3359668924003,0.6369047619047619,43.63425925925926,1025.462962962963,29.2989417989418,8
3384,4,0,1,37,0.0,0.02631578947368421,0.9736842105263158,38,1250,900,350,0.72,16,9,7,378.3395402065072,0.43216571834992884,0.0865404014158988,0.22142250860896134,131297.62081916098,2335.016298185941,133632.63711734692,1855,7,259.8157894736842,34,4,21,34.08593719750649,0.6375612745098039,43.779761904761905,1024.8809523809523,30.143557422969185,0
3385,4,0,1,36,0.0,0.02702702702702703,0.972972972972973,37,1200,800,400,0.6666666666666666,16,8,8,390.23998432919245,0.42858483483483484,0.10039148220121596,0.22838722128416208,131297.62081916127,2847.5162981859703,134145.13711734724,1856,8,267.3783783783784,34,3,21,33.781023734851125,0.6375612745098039,43.77976190476192,1024.8809523809546,30.143557422969252,0
3386,4,1,1,36,0.02702702702702703,0.02702702702702703,0.972972972972973,37,1400,1100,300,0.7857142857142857,17,11,6,391.3113115247552,0.42748998998999,0.10701718208486621,0.23075440620102777,131587.09092184476,2898.3105118386648,134485.40143368344,1857,0,268.13513513513516,32,5,16,33.46024079087704,0.6451822916666667,43.497474747474755,1026.0101010101016,32.062815656565675,0
3387,4,0,0,36,0.0,0.0,1.0,36,1100,800,300,0.7272727272727273,14,8,6,396.9638949773164,0.4267526455026455,0.10526779794902197,0.23352386861361615,131495.00740898974,3239.754062228723,134734.76147121846,1858,1,274.69444444444446,31,5,22,33.408578773644784,0.6468413978494624,43.58723958333333,1025.651041666666,33.08551747311826,0
3388,4,1,0,37,0.02702702702702703,0.0,1.0,37,700,300,400,0.42857142857142855,11,3,8,385.3954982830315,0.4273335835835836,0.1068056007815048,0.2288180279586991,131846.31191970204,2762.595015814712,134608.90693551674,1859,0,268.2432432432432,32,5,17,33.349725432341614,0.6477864583333333,43.244949494949495,1027.0202020202019,32.09438131313131,0
3389,4,0,1,36,0.0,0.02702702702702703,0.972972972972973,37,900,600,300,0.6666666666666666,12,6,6,386.67762445062226,0.4265828328328329,0.11456351301541168,0.2305618450845137,132008.45457415044,2808.943124426062,134817.3976985765,1860,1,269.2432432432432,32,5,18,33.15287504607446,0.6494140625,43.087121212121204,1027.6515151515139,32.11410984848481,0
3390,4,0,0,36,0.0,0.0,1.0,36,850,600,250,0.7058823529411765,11,6,5,393.8599373344512,0.42681878306878307,0.11461677085093225,0.2347690804715624,131996.2904188366,3197.6101345485863,135193.9005533852,1861,2,270.3611111111111,31,5,19,32.980655516134476,0.6518817204301075,43.09895833333332,1027.6041666666652,33.148521505376294,0
3391,4,0,1,35,0.0,0.027777777777777776,0.9722222222222222,36,1000,700,300,0.7,13,7,6,395.97856765551376,0.4262070105820106,0.11055872211667017,0.23665789490085365,132096.661461724,3261.4893595377357,135358.15082126172,1862,3,271.3611111111111,31,5,19,32.82470445429597,0.6528897849462365,43.00130208333332,1027.9947916666652,33.16112231182791,0
3392,4,0,0,35,0.0,0.0,1.0,35,900,400,500,0.4444444444444444,14,4,10,402.47084094770275,0.423984593837535,0.11829101982103207,0.2402571835071884,132052.4071605099,3629.4486718117746,135681.8558323217,1863,4,279.62857142857143,30,5,19,32.70263937927728,0.6552083333333334,43.04435483870968,1027.8225806451615,34.26075268817205,0
3393,4,0,0,35,0.0,0.0,1.0,35,1000,600,400,0.6,14,6,8,405.10654406455046,0.4240546218487395,0.11846179706030724,0.24227208409302153,132121.49029150762,3704.6560657301407,135826.14635723777,1864,5,280.62857142857143,30,5,19,32.56498670850222,0.6559027777777777,42.97715053763441,1028.091397849462,34.26971326164873,0
3394,4,0,0,35,0.0,0.0,1.0,35,1150,800,350,0.6956521739130435,15,8,7,372.4747184581681,0.4232843137254902,0.0999178194767838,0.21463598417230367,130700.81218762022,2736.5496443675584,133437.36183198777,1865,6,281.62857142857143,33,2,16,34.84090364333653,0.6338383838383839,44.36274509803922,1022.5490196078438,30.98633392751042,8
3395,4,1,0,36,0.027777777777777776,0.0,1.0,36,950,700,250,0.7368421052631579,12,7,5,362.6690102758247,0.4248181216931217,0.08937338501292014,0.210740100565682,131023.24263038555,2303.6139455782377,133326.8565759638,1866,0,274.77777777777777,34,2,17,34.76501937984496,0.6348039215686274,44.04761904761905,1023.8095238095242,30.11204481792718,0
3396,4,0,0,36,0.0,0.0,1.0,36,1050,500,550,0.47619047619047616,16,5,11,361.39411898329195,0.42367724867724865,0.08910315985130102,0.2113369956663165,131267.12018140606,2287.8330498866367,133554.9532312927,1867,1,275.77777777777777,34,2,17,34.55095066604708,0.6372549019607843,43.80952380952382,1024.761904761906,30.140056022409,0
3397,4,0,0,36,0.0,0.0,1.0,36,1350,1000,350,0.7407407407407407,17,10,7,359.3690438103735,0.4232969576719577,0.09291944057387602,0.21082331098739368,131389.14399092982,2243.438208616793,133632.58219954662,1868,2,276.77777777777777,34,2,17,34.47950534138412,0.6384803921568627,43.6904761904762,1025.238095238096,30.154061624649884,0
3398,4,0,0,36,0.0,0.0,1.0,36,850,600,250,0.7058823529411765,11,6,5,357.85245260701294,0.42319775132275134,0.08274012173733625,0.21060496800970127,131511.22448979612,2212.3228458050135,133723.54733560112,1869,3,277.77777777777777,34,2,18,34.39506925100588,0.6397058823529411,43.571428571428584,1025.7142857142871,30.1680672268908,0
3399,4,1,0,37,0.02702702702702703,0.0,1.0,37,1050,900,150,0.8571428571428571,12,9,3,351.98663643956553,0.4248936436436436,0.08343840798201851,0.209071580439405,131862.5217013892,1882.7690972222601,133745.29079861144,1870,0,271.2432432432432,35,2,16,34.191176470588246,0.6410714285714285,43.229166666666686,1027.0833333333358,29.345238095238166,0
3400,4,0,0,37,0.0,0.0,1.0,37,1050,600,450,0.5714285714285714,15,6,9,353.2692084903788,0.424486986986987,0.08688237533307985,0.2099976038414009,131892.24222232957,1918.693603180754,133810.93582551033,1871,1,272.2432432432432,35,2,16,34.128286384976555,0.6413690476190477,43.200231481481495,1027.1990740740757,29.34854497354502,0
3401,4,0,1,36,0.0,0.02702702702702703,0.972972972972973,37,1200,700,500,0.5833333333333334,17,7,10,356.57414170927666,0.4238613613613614,0.07910883856829809,0.21279424585876203,132040.89506172854,2016.4737654321152,134057.36882716065,1872,2,273.2432432432432,35,2,16,33.89358108108108,0.6428571428571428,43.055555555555564,1027.777777777779,29.3650793650794,0
3402,4,0,0,36,0.0,0.0,1.0,36,600,200,400,0.3333333333333333,10,2,8,366.31492449336645,0.4214451058201058,0.08954551306810887,0.21802053781915534,131938.95266439908,2466.24149659864,134405.19416099772,1873,3,281.6666666666667,34,2,18,33.74613750482813,0.6439950980392157,43.154761904761905,1027.3809523809523,30.21708683473389,0
3403,4,0,0,36,0.0,0.0,1.0,36,1200,700,500,0.5833333333333334,17,7,10,367.2219113376601,0.421494708994709,0.08664672199704082,0.21944368196544614,132091.8810232427,2501.4066043084017,134593.2876275511,1874,4,282.6666666666667,34,2,19,33.56856784404557,0.6455269607843137,43.00595238095239,1027.976190476191,30.23459383753503,0
3404,4,0,1,35,0.0,0.027777777777777776,0.9722222222222222,36,1050,700,350,0.6666666666666666,14,7,7,364.3796236781338,0.4206018518518519,0.08177744345433258,0.2188050262823317,132275.51197562355,2439.7002551020337,134715.2122307256,1875,5,283.6666666666667,34,2,20,33.4565347374918,0.6473651960784313,42.82738095238095,1028.690476190476,30.25560224089635,0
3405,4,0,0,35,0.0,0.0,1.0,35,1050,800,250,0.7619047619047619,13,8,5,372.1734603520101,0.41834733893557424,0.0935269186907457,0.22327747339059487,132240.39619677534,2843.2731701749426,135083.6693669503,1876,6,291.9428571428571,33,2,20,33.29150780412249,0.6493055555555556,42.86151960784314,1028.553921568628,31.16830065359479,0
3406,4,1,0,36,0.027777777777777776,0.0,1.0,36,950,600,350,0.631578947368421,13,6,7,361.1165983251947,0.41780753968253964,0.09367770506973372,0.21883093070823786,132618.81134960108,2378.2646698385206,134997.07601943958,1877,0,284.80555555555554,33,3,22,33.1948988697204,0.6530934343434344,42.493872549019606,1030.0245098039213,31.212863933452162,0
3407,4,0,0,36,0.0,0.0,1.0,36,950,600,350,0.631578947368421,13,6,7,362.47251269915597,0.4174603174603175,0.09130193466539849,0.22020728950682825,132713.49961553252,2420.9991349481043,135134.49875048062,1878,1,285.80555555555554,33,3,20,33.0647399302252,0.654040404040404,42.40196078431373,1030.3921568627452,31.224004753416523,0
3408,4,0,0,36,0.0,0.0,1.0,36,1100,900,200,0.8181818181818182,13,9,4,367.8504743444052,0.41613756613756614,0.10114755830230049,0.22460768440738937,132902.9775206651,2577.684664552096,135480.6621852172,1879,2,286.80555555555554,33,3,20,32.735619206085104,0.6559343434343434,42.21813725490196,1031.127450980392,31.246286393345212,0
3409,4,0,0,36,0.0,0.0,1.0,36,1100,800,300,0.7272727272727273,14,8,6,367.096811011668,0.4152116402116402,0.10261740714342293,0.22490691085125356,133029.371215398,2566.9315888120063,135596.30280421,1880,3,287.80555555555554,33,3,20,32.62799952482774,0.6571969696969697,42.09558823529412,1031.617647058824,31.261140819964368,0
3410,4,0,1,35,0.0,0.027777777777777776,0.9722222222222222,36,1000,800,200,0.8,12,8,4,365.28275945531027,0.4146329365079365,0.09267943593599526,0.22474628801256996,133187.44781153902,2530.215692281834,135717.66350382086,1881,4,288.80555555555554,33,3,20,32.51600280976691,0.6587752525252526,41.94240196078432,1032.2303921568641,31.279708853238308,0
3411,4,0,1,34,0.0,0.02857142857142857,0.9714285714285714,35,1150,900,250,0.782608695652174,14,9,5,377.3492958301303,0.4125700280112045,0.10282778146737037,0.2319137702342474,133146.24304917888,3048.5282114070274,136194.7712605859,1882,5,296.65714285714284,32,3,20,32.246044368322316,0.6608072916666667,41.982323232323246,1032.070707070709,32.252209595959656,0
3412,4,0,0,34,0.0,0.0,1.0,34,1100,800,300,0.7272727272727273,14,8,6,386.198305787313,0.41174613784907904,0.10771451257429931,0.23750147168161614,133169.65950859923,3485.9793768988807,136655.6388854981,1883,6,302.2352941176471,31,3,20,31.99416025398428,0.6636424731182795,41.95963541666667,1032.161458333334,33.29553091397852,0
3413,4,0,0,34,0.0,0.0,1.0,34,1200,800,400,0.6666666666666666,16,8,8,384.8002729251557,0.4105763517528223,0.11408323258694453,0.2374981295384757,133304.08944023994,3459.089999728752,136763.1794399687,1884,7,303.2352941176471,31,3,20,31.89501639137563,0.664986559139785,41.82942708333334,1032.6822916666679,33.31233198924735,0
3414,4,0,1,33,0.0,0.029411764705882353,0.9705882352941176,34,400,300,100,0.75,5,3,2,384.8002729251557,0.4105763517528223,0.11408323258694453,0.2374981295384757,133304.08944023994,3459.089999728752,136763.1794399687,1885,8,304.2352941176471,31,3,20,31.89501639137563,0.664986559139785,41.82942708333334,1032.6822916666679,33.31233198924735,0
3415,4,0,0,33,0.0,0.0,1.0,33,1100,700,400,0.6363636363636364,15,7,8,383.551173385181,0.409603851010101,0.10450400895377565,0.2371559983214842,133371.3298373753,3630.9460110134646,137002.27584838876,1886,9,306.7878787878788,31,2,20,31.85966322114375,0.6656586021505376,41.76432291666667,1032.942708333334,33.32073252688174,0
3416,4,0,0,33,0.0,0.0,1.0,33,1050,700,350,0.6666666666666666,14,7,7,385.15718362868586,0.4099984217171717,0.1128508214308892,0.23901427415644094,133505.8614942763,3684.148322211376,137190.00981648767,1887,10,307.7878787878788,31,2,20,31.682966906051828,0.667002688172043,41.634114583333336,1033.463541666667,33.33753360215055,0
3417,4,0,0,33,0.0,0.0,1.0,33,1000,800,200,0.8,12,8,4,385.7336044246308,0.40936710858585856,0.11494463465744498,0.23980728939131915,133573.15275404195,3704.7307332356872,137277.88348727764,1888,11,308.7878787878788,31,2,20,31.60045870596632,0.6676747311827957,41.56901041666667,1033.723958333334,33.345934139784966,0
3418,4,0,0,33,0.0,0.0,1.0,33,1000,600,400,0.6,14,6,8,375.9743411575916,0.40897253787878785,0.0848688615259221,0.21387392849456444,130200.04325259513,3190.3750961168757,133390.418348712,1889,12,309.7878787878788,33,0,20,35.26006644252322,0.6287878787878788,44.85294117647059,1020.5882352941175,30.926916221033864,8
3419,4,3,1,35,0.08333333333333333,0.027777777777777776,0.9722222222222222,36,1000,700,300,0.7,13,7,6,355.81406325450996,0.41908068783068786,0.08050360591614747,0.2065357493603769,130982.06948502593,2121.0524713903533,133103.1219564163,1890,0,284.8888888888889,36,0,17,34.98212321232124,0.6302083333333333,44.08783783783786,1023.6486486486516,28.43468468468477,0
3420,4,1,0,36,0.027777777777777776,0.0,1.0,36,1150,800,350,0.6956521739130435,15,8,7,357.5993551664804,0.4198247354497355,0.07944230651762263,0.2083514500473508,131126.2038009297,2178.129184928221,133304.33298585794,1891,0,285.8611111111111,36,0,18,34.79063588052044,0.6316550925925926,43.947072072072096,1024.211711711715,28.450325325325416,0
3421,4,1,0,37,0.02702702702702703,0.0,1.0,37,750,500,250,0.6666666666666666,10,5,5,349.25733138551647,0.42107732732732733,0.07251332135656674,0.2053596027476488,131476.45968632144,1784.1341892247624,133260.5938755462,1892,0,279.1081081081081,35,2,21,34.65055204453975,0.637202380952381,43.60532407407409,1025.578703703706,29.30224867724874,0
3422,4,0,0,37,0.0,0.0,1.0,37,450,300,150,0.6666666666666666,6,3,3,348.2246419207508,0.4215778278278279,0.07049161358086597,0.2050406117166208,131530.20154867735,1760.4114672104906,133290.61301588782,1893,1,280.1081081081081,36,1,21,34.622808943535716,0.6357060185185186,43.552927927927946,1025.7882882882907,28.494119119119187,0
3423,4,1,1,37,0.02631578947368421,0.02631578947368421,0.9736842105263158,38,950,700,250,0.7368421052631579,12,7,5,339.4070878290555,0.42391239924134666,0.07801484177944062,0.20189873053145568,131918.83710612904,1354.8376663973816,133273.67477252643,1894,0,273.7105263157895,37,1,14,34.45749724267977,0.6376689189189189,43.17434210526317,1027.3026315789493,27.764935988620252,0
3424,4,0,1,36,0.0,0.02702702702702703,0.972972972972973,37,1150,900,250,0.782608695652174,14,9,5,347.3216981637955,0.4214214214214214,0.07387703354384656,0.2068513821179161,131963.7458404352,1766.7744602711036,133730.52030070632,1895,1,282.05405405405406,36,1,16,34.20900007306737,0.6400462962962963,43.13063063063064,1027.477477477479,28.541041041041083,0
3425,4,0,0,36,0.0,0.0,1.0,36,1150,800,350,0.6956521739130435,15,8,7,353.8537741577406,0.41886574074074073,0.06997587983773701,0.2102606041754237,131876.97991488117,2133.033413481056,134010.01332836223,1896,2,290.77777777777777,36,0,16,34.128659138252395,0.6391782407407407,43.215090090090094,1027.13963963964,28.53165665665667,0
3426,4,1,3,34,0.02702702702702703,0.08108108108108109,0.9189189189189189,37,800,600,200,0.75,10,6,4,353.45694102301115,0.42038913913913917,0.09042041401879364,0.2123004494672147,132285.18029586037,1951.423034010476,134236.60332987085,1897,0,283.8918918918919,37,0,17,33.72770553542244,0.6413288288288288,42.817982456140356,1028.7280701754396,27.803461356092964,0
3427,4,0,0,34,0.0,0.0,1.0,34,1000,600,400,0.6,14,6,8,378.5841165523928,0.41098484848484845,0.10764310361288021,0.22459880257090387,131816.6737528346,3180.7397959183854,134997.413548753,1898,1,308.7352941176471,34,0,17,33.55456372208053,0.6427696078431373,43.27380952380953,1026.904761904763,30.20308123249303,0
3428,4,0,0,34,0.0,0.0,1.0,34,1200,800,400,0.6666666666666666,16,8,8,379.8593353953348,0.41046494355317886,0.11448508967998716,0.22644653198429074,132000.1133786848,3228.295068027211,135228.408446712,1899,2,309.7352941176471,34,0,18,33.33647088353413,0.6446078431372548,43.095238095238095,1027.6190476190475,30.224089635854337,0
3429,4,0,0,34,0.0,0.0,1.0,34,900,700,200,0.7777777777777778,11,7,4,377.0793175858475,0.4103349673202614,0.11241867911032433,0.22533424964386123,132091.8810232427,3161.823270975069,135253.70429421775,1900,3,310.7352941176471,34,0,18,33.31523837097086,0.6455269607843137,43.00595238095239,1027.976190476191,30.23459383753503,0
3430,4,1,0,35,0.02857142857142857,0.0,1.0,35,900,600,300,0.6666666666666666,12,6,6,351.134791594816,0.41165966386554625,0.023205824569513478,0.212920066690255,132643.1565334466,2315.479733560076,134958.6362670067,1901,0,302.8285714285714,34,1,16,33.42747216764899,0.6510416666666667,42.47023809523809,1030.1190476190466,30.297619047619015,8
3431,4,0,0,35,0.0,0.0,1.0,35,950,600,350,0.631578947368421,13,6,7,352.68693774109,0.4112044817927171,0.02536968576709797,0.21438610485160628,132735.14739229015,2362.7905328798015,135097.93792516994,1902,1,303.8285714285714,34,1,17,33.29506508009856,0.6519607843137255,42.38095238095237,1030.4761904761897,30.308123249299697,0
3432,4,0,0,35,0.0,0.0,1.0,35,1450,1200,250,0.8275862068965517,17,12,5,352.81267835444777,0.41053921568627455,0.020324303517297748,0.21509257536639725,132845.06715374222,2373.8847897376436,135218.95194347986,1903,2,304.8285714285714,35,0,17,33.18141630178511,0.6508928571428572,42.27430555555555,1030.9027777777771,29.45436507936506,0
3433,4,0,0,35,0.0,0.0,1.0,35,1000,700,300,0.7,13,7,6,354.37200285685134,0.4098039215686275,0.012698412698412431,0.2165606684125201,132934.5703124999,2421.657986111097,135356.228298611,1904,3,305.8285714285714,35,0,18,33.05134680134679,0.6517857142857143,42.18749999999999,1031.2499999999993,29.464285714285694,0
3434,4,0,0,35,0.0,0.0,1.0,35,1100,700,400,0.6363636363636364,15,7,8,354.32861486487894,0.4099089635854342,0.012004424707824812,0.21670708902271335,132964.41139671195,2422.61914330416,135387.0305400161,1905,4,306.8285714285714,35,0,19,33.0225049564209,0.6520833333333333,42.1585648148148,1031.3657407407393,29.467592592592553,0
3435,4,0,0,35,0.0,0.0,1.0,35,950,600,350,0.631578947368421,13,6,7,354.6022710790368,0.4096288515406163,0.015465503975378603,0.21704776372639914,132994.2558299038,2432.0130315500473,135426.26886145383,1906,5,307.8285714285714,35,0,19,32.985487731897074,0.6523809523809524,42.12962962962962,1031.48148148148,29.470899470899425,0
3436,4,0,0,35,0.0,0.0,1.0,35,1050,600,450,0.5714285714285714,15,6,9,351.4530105951736,0.409733893557423,0.017537056325614753,0.21563686093984655,133083.80922335802,2354.541082604572,135438.3503059626,1907,6,308.8285714285714,35,0,19,32.97684146569452,0.6532738095238095,42.04282407407406,1031.8287037037023,29.480820105820065,0
3437,4,0,0,35,0.0,0.0,1.0,35,1300,1100,200,0.8461538461538461,15,11,4,355.6637550894028,0.4083683473389356,0.020984194597018613,0.21927272696285854,133263.0064327203,2479.364256472906,135742.37068919322,1908,7,309.8285714285714,35,0,20,32.68843646078541,0.6550595238095238,41.86921296296296,1032.5231481481478,29.500661375661366,0
3438,4,0,0,35,0.0,0.0,1.0,35,800,300,500,0.375,13,3,10,353.2454246336564,0.4081582633053222,0.023973874623807623,0.2183076294619632,133352.65024862823,2421.242712620022,135773.89296124826,1909,8,310.8285714285714,35,0,20,32.66098909308232,0.655952380952381,41.782407407407405,1032.87037037037,29.510582010582,0
3439,4,0,0,35,0.0,0.0,1.0,35,850,700,150,0.8235294117647058,10,7,3,356.92653588447496,0.4079131652661065,0.025118020771656147,0.22111611282725244,133442.32420535403,2525.821303798003,135968.14550915203,1910,9,311.8285714285714,35,0,20,32.476032448377566,0.6568452380952381,41.69560185185185,1033.2175925925922,29.52050264550263,0
3440,4,0,1,34,0.0,0.02857142857142857,0.9714285714285714,35,900,800,100,0.8888888888888888,10,8,2,358.15774113821044,0.4065476190476191,0.038277291570704586,0.2227966922667779,133595.26643990926,2569.6391199548166,136164.90555986407,1911,10,312.8285714285714,34,1,20,32.29094695224935,0.6605392156862745,41.547619047619044,1033.8095238095234,30.406162464985982,0
3441,4,0,0,34,0.0,0.0,1.0,34,850,700,150,0.8235294117647058,10,7,3,362.4766116566976,0.4043560606060606,0.03554865929774431,0.22531247010495545,133567.21460796334,2882.9982759035056,136450.21288386686,1912,11,314.70588235294116,33,1,20,32.20744418099191,0.6625631313131313,41.57475490196079,1033.7009803921571,31.324272133095672,0
3442,4,0,0,34,0.0,0.0,1.0,34,750,500,250,0.6666666666666666,10,5,5,362.35985042995316,0.40405897207367797,0.03900536153776457,0.22562583454446616,133630.5616379518,2884.470065599773,136515.03170355156,1913,12,315.70588235294116,33,1,20,32.14696673383114,0.6631944444444444,41.513480392156865,1033.9460784313728,31.331699346405237,0
3443,4,0,0,34,0.0,0.0,1.0,34,1200,1000,200,0.8333333333333334,14,10,4,367.6123458914463,0.4031305704099822,0.040364102528373635,0.23007791225807886,133820.69283749053,3038.8277645617195,136859.52060205225,1914,13,316.70588235294116,33,1,18,31.820615697421935,0.6650883838383839,41.329656862745104,1034.6813725490206,31.35398098633396,0
3444,4,0,0,34,0.0,0.0,1.0,34,1250,700,550,0.56,18,7,11,365.5629173236847,0.40274064171123,0.04388433090498789,0.22938665673966135,133915.80912389472,2990.9307718185405,136906.73989571325,1915,14,317.70588235294116,33,1,19,31.778356618517627,0.6660353535353536,41.23774509803922,1035.0490196078438,31.365121806298298,0
3445,4,0,0,34,0.0,0.0,1.0,34,800,400,400,0.5,12,4,8,364.58109145431575,0.40240641711229946,0.04449364973262049,0.22916525748556998,133979.2387543253,2969.2594194540634,136948.49817377937,1916,15,318.70588235294116,33,1,19,31.740254103535367,0.6666666666666667,41.1764705882353,1035.2941176470592,31.372549019607856,0
3446,4,0,0,34,0.0,0.0,1.0,34,700,400,300,0.5714285714285714,10,4,6,365.6951770988103,0.40190508021390375,0.0474020594153155,0.2300639278710236,134010.95920138882,3001.432291666657,137012.39149305547,1917,16,319.70588235294116,33,1,19,31.67966130114016,0.6669823232323233,41.14583333333333,1035.416666666666,31.37626262626261,0
3447,4,0,0,34,0.0,0.0,1.0,34,800,400,400,0.5,12,4,8,371.98959111829384,0.40108808674985147,0.05642619049275921,0.23483405628998794,134137.87853529895,3179.5789179642443,137317.4574532632,1918,17,320.70588235294116,33,1,19,31.3896200559959,0.6682449494949495,41.02328431372549,1035.9068627450981,31.39111705288176,0
3448,4,0,0,34,0.0,0.0,1.0,34,750,400,350,0.5333333333333333,11,4,7,371.19253458931894,0.4012737670825906,0.0586878630813652,0.2347369394130661,134201.36072964733,3162.9086469146605,137364.269376562,1919,18,321.70588235294116,33,1,19,31.34671299034103,0.6688762626262627,40.962009803921575,1036.1519607843143,31.39854426619134,0
3449,4,0,0,34,0.0,0.0,1.0,34,800,600,200,0.75,10,6,4,374.2361895060839,0.4018679441473559,0.06544178508579801,0.23707231870059567,134264.8579422578,3249.3537641772505,137514.21170643505,1920,19,322.70588235294116,33,1,19,31.2043031413819,0.6695075757575757,40.90073529411765,1036.3970588235297,31.405971479500902,0
3450,4,0,1,33,0.0,0.029411764705882353,0.9705882352941176,34,1150,900,250,0.782608695652174,14,9,5,372.769399719824,0.40086527035056446,0.06381181476254416,0.2369648302801976,134391.89742226547,3219.4373858612134,137611.33480812667,1921,20,323.70588235294116,33,1,19,31.115190284836313,0.670770202020202,40.77818627450981,1036.887254901961,31.420825906120026,0
3451,4,0,0,33,0.0,0.0,1.0,33,800,600,200,0.75,10,6,4,379.8226701618586,0.3987531565656566,0.06455380140212874,0.24102925483114498,134328.3701731306,3604.1920475298043,137932.5622206604,1922,21,330.3636363636364,33,0,19,30.99595598376483,0.6701388888888888,40.83946078431373,1036.6421568627454,31.413398692810468,0
3452,4,0,0,33,0.0,0.0,1.0,33,550,500,50,0.9090909090909091,6,5,1,384.72910607019975,0.397885101010101,0.0672016155887123,0.24499341043431924,134455.43968966277,3745.784223615935,138201.22391327872,1923,22,331.3636363636364,33,0,19,30.741536689117336,0.6714015151515151,40.71691176470589,1037.1323529411777,31.428253119429627,0
3453,4,0,0,33,0.0,0.0,1.0,33,900,600,300,0.6666666666666666,12,6,6,387.2814957807222,0.39701704545454547,0.07010685711217324,0.24704882153608265,134518.9969753221,3819.3436719050515,138338.34064722716,1924,23,332.3636363636364,33,0,19,30.611709982279976,0.6720328282828283,40.65563725490197,1037.3774509803932,31.43568033273919,0
3454,4,0,0,33,0.0,0.0,1.0,33,950,700,250,0.7368421052631579,12,7,5,387.84698172518523,0.395675505050505,0.069940278699403,0.24829456306705786,134649.04729109275,3844.64907136996,138493.6963624627,1925,24,333.3636363636364,32,1,19,30.466849148418493,0.67578125,40.53030303030303,1037.8787878787878,32.43371212121212,0
3455,4,0,0,33,0.0,0.0,1.0,33,850,600,250,0.7058823529411765,11,6,5,385.7464849200386,0.3953993055555556,0.06860577439089854,0.24714619722184036,134677.95589436774,3790.3096164936806,138468.2655108614,1926,25,334.3636363636364,33,0,19,30.492424242424246,0.6736111111111112,40.50245098039217,1037.9901960784327,31.454248366013115,0
3456,4,0,0,33,0.0,0.0,1.0,33,850,400,450,0.47058823529411764,13,4,9,387.7372837754054,0.3948469065656566,0.07539099242156011,0.24907490564283621,134773.37630058153,3851.3325704056197,138624.70887098715,1927,26,335.3636363636364,33,0,19,30.34528797356308,0.6745580808080809,40.41053921568628,1038.3578431372553,31.465389185977433,0
3457,4,0,1,32,0.0,0.030303030303030304,0.9696969696969697,33,1350,1000,350,0.7407407407407407,17,10,7,384.67396578677824,0.39441287878787884,0.07073686016708303,0.24797575726041976,134900.6560727845,3778.5540717512513,138679.21014453575,1928,27,336.3636363636364,33,0,15,30.297545318705517,0.6758207070707071,40.28799019607843,1038.8480392156864,31.480243612596556,0
3458,4,0,0,32,0.0,0.0,1.0,32,950,700,250,0.7368421052631579,12,7,5,389.952529383168,0.39411122311827956,0.06793114973262049,0.2514521482574222,134911.26543209876,4121.797839506174,139033.06327160494,1929,28,335.0625,32,0,16,30.14984402852049,0.6783854166666667,40.27777777777778,1038.888888888889,32.46527777777778,0
3459,4,0,0,32,0.0,0.0,1.0,32,750,600,150,0.8,9,6,3,389.3714772600848,0.39430023521505375,0.0597481173326857,0.2522183613125316,135075.2813010151,4118.892364299545,139194.17366531462,1930,29,336.0625,32,0,17,30.000961577391788,0.6800130208333333,40.11994949494949,1039.5202020202012,32.48500631313129,0
3460,4,0,1,31,0.0,0.03125,0.96875,32,850,600,250,0.7058823529411765,11,6,5,386.287358764243,0.39430023521505375,0.06272383756221922,0.2511325157175272,135206.56573627688,4045.717433170076,139252.28316944695,1931,30,337.0625,32,0,17,29.949971672534488,0.6813151041666667,39.993686868686865,1040.0252525252522,32.50078914141413,0
3461,4,0,0,31,0.0,0.0,1.0,31,800,600,200,0.75,10,6,4,395.4829240813202,0.39301075268817204,0.06667231960074127,0.2574990285644391,135260.94436645508,4498.678758409289,139759.62312486436,1932,31,344.3225806451613,31,0,17,29.656532941127377,0.6844758064516129,39.94140625,1040.234375,33.55594758064516,0
3462,4,0,0,31,0.0,0.0,1.0,31,700,500,200,0.7142857142857143,9,5,4,395.4829240813202,0.39301075268817204,0.06667231960074127,0.2574990285644391,135260.94436645508,4498.678758409289,139759.62312486436,1933,32,345.3225806451613,31,0,17,29.656532941127377,0.6844758064516129,39.94140625,1040.234375,33.55594758064516,0
3463,4,0,0,31,0.0,0.0,1.0,31,1350,900,450,0.6666666666666666,18,9,9,391.65291417543676,0.39233870967741935,0.06458070974199992,0.25572631454984385,135362.548828125,4403.027343750001,139765.576171875,1934,33,346.3225806451613,31,0,17,29.654654654654664,0.685483870967742,39.84375,1040.625,33.568548387096776,0
3464,4,0,1,30,0.0,0.03225806451612903,0.967741935483871,31,850,600,250,0.7058823529411765,11,6,5,388.54594881232515,0.39171146953405017,0.06067549903984237,0.25465683661502875,135498.0807834201,4329.446072048606,139827.5268554687,1935,34,347.3225806451613,31,0,18,29.600216775054207,0.6868279569892473,39.713541666666664,1041.145833333333,33.585349462365585,0
3465,4,0,0,30,0.0,0.0,1.0,30,900,700,200,0.7777777777777778,11,7,4,404.72127916312525,0.3915948275862069,0.10286025724874648,0.24116088692144128,131983.3420951844,4683.293408197476,136666.63550338187,1936,35,357.96666666666664,30,0,18,32.71473730106823,0.6545138888888888,43.111559139784944,1027.5537634408602,34.25179211469534,8
3466,4,0,0,30,0.0,0.0,1.0,30,850,700,150,0.8235294117647058,10,7,3,405.24506837991834,0.3918103448275862,0.09973842532042898,0.24169296355950495,132017.872369638,4699.918343161045,136717.79071279906,1937,36,358.96666666666664,30,0,18,32.66631790042724,0.6548611111111111,43.077956989247305,1027.68817204301,34.25627240143366,0
3467,4,0,1,29,0.0,0.03333333333333333,0.9666666666666667,30,900,600,300,0.6666666666666666,12,6,6,401.9732581485752,0.391139846743295,0.09320261437908473,0.24061779537062597,132156.03863163365,4624.638686553349,136780.677318187,1938,37,359.96666666666664,30,0,18,32.61056644880173,0.65625,42.94354838709677,1028.2258064516125,34.27419354838708,0
3468,4,0,0,29,0.0,0.0,1.0,29,1050,900,150,0.8571428571428571,12,9,3,412.3189785755683,0.3884954844006568,0.1042729547265282,0.2462932010038562,132076.58420138882,5091.536458333325,137168.12065972213,1939,38,371.9655172413793,29,0,18,32.42509458181327,0.6584051724137931,43.02083333333333,1027.916666666666,35.44540229885055,0
3469,4,0,0,29,0.0,0.0,1.0,29,1200,1000,200,0.8333333333333334,14,10,4,413.2237190958802,0.3875205254515599,0.10476128395429618,0.24800120450762453,132255.10223765424,5130.189043209862,137385.2912808641,1940,39,372.9655172413793,29,0,20,32.22105950130525,0.6602011494252873,42.847222222222214,1028.6111111111104,35.469348659003806,0
3470,4,0,0,29,0.0,0.0,1.0,29,500,300,200,0.6,7,3,4,414.8796227534921,0.3872639573070607,0.10530579181855004,0.24923060549352113,132290.8203125,5176.953125000002,137467.7734375,1941,40,373.9655172413793,29,0,20,32.142314702308624,0.6605603448275862,42.8125,1028.75,35.474137931034484,0
3471,4,0,0,29,0.0,0.0,1.0,29,450,100,350,0.2222222222222222,8,1,7,417.82691036449455,0.3864429392446634,0.10695286720251707,0.2514768138822533,132362.27092978387,5260.90374228394,137623.1746720678,1942,41,374.9655172413793,29,0,20,31.994168128852294,0.6612787356321839,42.74305555555555,1029.0277777777771,35.48371647509576,0
3472,4,0,0,29,0.0,0.0,1.0,29,900,600,300,0.6666666666666666,12,6,6,419.74260618804306,0.3852627257799672,0.10664482898208183,0.25310923144504377,132433.7408371914,5317.616705246921,137751.35754243832,1943,42,375.9655172413793,29,0,20,31.872526199793096,0.6619971264367817,42.673611111111114,1029.3055555555559,35.4932950191571,0
3473,4,1,0,30,0.03333333333333333,0.0,1.0,30,700,500,200,0.7142857142857143,9,5,4,409.2389964796214,0.38678160919540233,0.10481529769665365,0.24951217034965792,132847.95388195172,4873.31266620419,137721.2665481559,1944,0,364.4,30,0,19,31.724250325945253,0.6631944444444444,42.27150537634409,1030.913978494624,34.36379928315413,0
3474,4,0,0,30,0.0,0.0,1.0,30,1200,800,400,0.6666666666666666,16,8,8,412.4453415704827,0.38587164750957853,0.10449135609417093,0.2524007616596399,132986.5537200832,4969.936914672209,137956.4906347554,1945,1,365.4,30,0,19,31.501661454261143,0.6645833333333333,42.137096774193544,1031.4516129032254,34.381720430107514,0
3475,4,0,0,30,0.0,0.0,1.0,30,1100,1000,100,0.9090909090909091,12,10,2,414.323905379312,0.38484195402298854,0.09543224349789403,0.25425776351694473,133090.55102107173,5028.519373627,138119.07039469873,1946,2,366.4,30,0,20,31.348237158612303,0.665625,42.03629032258064,1031.8548387096769,34.39516129032256,0
3476,4,0,0,30,0.0,0.0,1.0,30,850,700,150,0.8235294117647058,10,7,3,416.5634353479959,0.3841714559386973,0.09645879442780902,0.25658570544570597,133229.27731890956,5099.689089779145,138328.9664086887,1947,3,367.4,30,0,20,31.15045783969102,0.6670138888888889,41.9018817204301,1032.3924731182783,34.413082437275946,0
3477,4,0,0,30,0.0,0.0,1.0,30,1100,1000,100,0.9090909090909091,12,10,2,418.53296302328226,0.3836685823754789,0.09252125629012697,0.2585214861632557,133333.36946467793,5160.882038385931,138494.25150306386,1948,4,368.4,30,0,20,30.994599167100464,0.6680555555555556,41.8010752688172,1032.7956989247307,34.42652329749102,0
3478,4,0,0,30,0.0,0.0,1.0,30,850,600,250,0.7058823529411765,11,6,5,418.18418314256,0.38290229885057475,0.09731182795698912,0.25927419354838704,133472.22222222207,5163.194444444426,138635.4166666665,1949,5,369.4,30,0,20,30.863575268817197,0.6694444444444445,41.66666666666666,1033.3333333333321,34.44444444444441,0
3479,4,0,0,30,0.0,0.0,1.0,30,1200,900,300,0.75,15,9,6,411.16595261834374,0.38290229885057475,0.0910816432657302,0.2558809472119984,133611.1472424558,4987.270927274827,138598.41816973063,1950,6,370.4,30,0,20,30.904944531114566,0.6708333333333334,41.53225806451613,1033.8709677419356,34.462365591397855,0
3480,4,0,0,30,0.0,0.0,1.0,30,900,700,200,0.7777777777777778,11,7,4,412.0176842064906,0.3829501915708812,0.0985277561271325,0.2578627750424036,133819.67026534854,5027.214128801014,138846.88439414956,1951,7,371.4,30,0,19,30.67301030570712,0.6729166666666666,41.33064516129032,1034.6774193548383,34.489247311827945,0
3481,4,0,0,30,0.0,0.0,1.0,30,650,400,250,0.6153846153846154,9,4,5,414.6359850416054,0.38199233716475095,0.10276984333073669,0.2604833896240166,133958.77594230545,5108.825803561104,139067.60174586656,1952,8,372.4,30,0,20,30.46530122046223,0.6743055555555555,41.196236559139784,1035.2150537634407,34.50716845878136,0
3482,4,0,0,30,0.0,0.0,1.0,30,800,500,300,0.625,11,5,6,411.18273847842653,0.3819444444444444,0.10006057459328455,0.2588032530423037,134028.3558792924,5022.029280841709,139050.3851601341,1953,9,373.4,30,0,20,30.48470491519556,0.675,41.12903225806451,1035.4838709677417,34.51612903225806,0
3483,4,0,0,30,0.0,0.0,1.0,30,1150,900,250,0.782608695652174,14,9,5,411.2744925106287,0.3814655172413793,0.09437813527071426,0.2598445728091741,134167.56995028324,5035.939848537398,139203.50979882065,1954,10,374.4,30,0,21,30.34239318457015,0.6763888888888889,40.994623655913976,1036.0215053763438,34.53405017921146,0
3484,4,0,0,30,0.0,0.0,1.0,30,500,300,200,0.6,7,3,4,409.6389717398363,0.3812260536398468,0.09515780371811489,0.2593034870372855,134237.20408428722,4997.758050063595,139234.96213435082,1955,11,375.4,30,0,21,30.31479680069174,0.6770833333333333,40.92741935483871,1036.2903225806454,34.543010752688176,0
3485,4,0,0,30,0.0,0.0,1.0,30,750,500,250,0.6666666666666666,10,5,5,410.22417776467375,0.3810344827586207,0.09888485477178444,0.26016849168759554,134306.8562839633,5019.1839374494,139326.0402214127,1956,12,376.4,30,0,21,30.229674533195027,0.6777777777777778,40.86021505376343,1036.559139784945,34.55197132616483,0
3486,4,0,0,30,0.0,0.0,1.0,30,850,600,250,0.7058823529411765,11,6,5,410.85864748247377,0.3801963601532567,0.10299848779433995,0.2613169386090093,134411.36845661336,5044.814610070509,139456.18306668388,1957,13,377.4,30,0,21,30.10828472672283,0.6788194444444444,40.75940860215053,1036.962365591397,34.5654121863799,0
3487,4,0,1,29,0.0,0.03333333333333333,0.9666666666666667,30,1150,1000,150,0.8695652173913043,13,10,3,403.4489508577037,0.3796455938697318,0.07483600104959298,0.23545849184053722,131190.39231414025,4585.725228350082,135776.11754249033,1958,14,378.4,30,0,20,33.55145193737426,0.6465277777777778,43.88440860215053,1024.462365591397,34.14874551971323,8
3488,4,0,0,29,0.0,0.0,1.0,29,850,700,150,0.8235294117647058,10,7,3,410.05688020683715,0.3785919540229885,0.06704850964348297,0.2390647819387686,131150.23389274688,4955.811149691352,136106.04504243823,1959,15,378.86206896551727,29,0,20,33.423022598870055,0.649066091954023,43.92361111111111,1024.3055555555552,35.32088122605363,0
3489,4,1,0,30,0.03333333333333333,0.0,1.0,30,800,500,300,0.625,11,5,6,402.29712777273625,0.38687739463601534,0.05435721208917066,0.22347871282881943,129269.72229448482,4400.967597410091,133670.6898918949,1960,0,367.2,30,0,19,35.53837342497137,0.6270833333333333,45.76612903225806,1016.935483870967,33.89784946236556,8
3490,4,1,0,31,0.03225806451612903,0.0,1.0,31,750,400,350,0.5333333333333333,11,4,7,391.3298192374295,0.39301075268817204,0.05067592646052077,0.21958262884326907,129665.12891981323,3948.3662923176894,133613.49521213092,1961,0,356.3225806451613,31,0,19,35.413470553140705,0.6283602150537635,45.37760416666666,1018.4895833333322,32.854502688172005,0
3491,4,0,0,31,0.0,0.0,1.0,31,600,400,200,0.6666666666666666,8,4,4,393.39915774858747,0.3926075268817204,0.055940365459463015,0.22111745763110252,129731.44531249991,4007.2482638888755,133738.6935763888,1962,1,357.3225806451613,31,0,19,35.29311520109065,0.6290322580645161,45.31249999999999,1018.7499999999993,32.86290322580643,0
3492,4,0,0,31,0.0,0.0,1.0,31,800,700,100,0.875,9,7,2,396.0652234592019,0.39256272401433695,0.05828539403629662,0.2233716548442818,129864.12896050341,4086.9330512152733,133951.0620117187,1963,2,358.3225806451613,31,0,19,35.089848407426345,0.6303763440860215,45.182291666666664,1019.2708333333328,32.87970430107525,0
3493,4,2,0,33,0.06060606060606061,0.0,1.0,33,750,500,250,0.6666666666666666,10,5,5,378.5848229274363,0.3995028409090909,0.04993910308847371,0.21657546321895538,130419.01139285362,3274.9316669069503,133693.94305976055,1964,0,337.54545454545456,33,0,21,34.97088082383524,0.6309974747474747,44.63848039215686,1021.4460784313718,30.952911467617326,0
3494,4,0,0,33,0.0,0.0,1.0,33,650,500,150,0.7692307692307693,8,5,3,378.5848229274363,0.3995028409090909,0.04993910308847371,0.21657546321895538,130419.01139285362,3274.9316669069503,133693.94305976055,1965,1,338.54545454545456,33,0,21,34.97088082383524,0.6309974747474747,44.63848039215686,1021.4460784313718,30.952911467617326,0
3495,4,0,2,31,0.0,0.06060606060606061,0.9393939393939394,33,1150,800,350,0.6956521739130435,15,8,7,380.69312254742,0.39780618686868685,0.04816808700769393,0.21901669160624682,130638.16350682438,3346.610077854683,133984.77358467906,1966,2,339.54545454545456,33,0,17,34.69441780548231,0.6332070707070707,44.42401960784314,1022.3039215686281,30.97890671420085,0
3496,4,0,0,31,0.0,0.0,1.0,31,550,400,150,0.7272727272727273,7,4,3,402.3323615160352,0.3911290322580645,0.056352863726136126,0.2292358803986712,130262.58680555549,4281.770833333329,134544.35763888882,1967,6,362.3225806451613,31,0,19,34.523809523809526,0.6344086021505376,44.791666666666664,1020.8333333333328,32.930107526881706,0
3497,4,0,0,31,0.0,0.0,1.0,31,800,600,200,0.75,10,6,4,404.9988549028211,0.3913530465949821,0.0547589077835644,0.23115000146636971,130329.0557861327,4356.623670789918,134685.6794569226,1968,7,363.3225806451613,31,0,19,34.38801751253933,0.6350806451612903,44.72656249999999,1021.0937499999991,32.9385080645161,0
3498,4,0,0,31,0.0,0.0,1.0,31,1000,500,500,0.5,15,5,10,403.8331741977645,0.3899641577060932,0.05497310115527365,0.23187173257339067,130561.83073255736,4345.039706759964,134906.8704393173,1969,8,364.3225806451613,31,0,17,34.180707733469234,0.6374327956989247,44.49869791666666,1022.0052083333321,32.96790994623652,0
3499,4,0,0,31,0.0,0.0,1.0,31,1000,900,100,0.9,11,9,2,405.45436643880726,0.39023297491039427,0.05203999917866153,0.23400764499462381,130761.51741875541,4403.565639919701,135165.0830586751,1970,9,365.3225806451613,31,0,18,33.93605453002335,0.6394489247311828,44.303385416666664,1022.7864583333331,32.99311155913978,0
3500,4,0,1,30,0.0,0.03225806451612903,0.967741935483871,31,1000,500,500,0.5,15,5,10,406.728434628907,0.3904569892473118,0.052532217023721905,0.2357585174176405,130928.0395507811,4450.431315104155,135378.47086588526,1971,10,366.3225806451613,31,0,19,33.73409669211196,0.6411290322580645,44.14062499999999,1023.4374999999989,33.01411290322577,0
3501,4,0,1,29,0.0,0.03333333333333333,0.9666666666666667,30,550,300,250,0.5454545454545454,8,3,5,413.36556075176816,0.3880268199233716,0.036100166360213404,0.23952552355890105,130915.14373048893,4823.16235981036,135738.30609029927,1972,11,368.1666666666667,30,0,19,33.5774012783469,0.64375,44.1532258064516,1023.3870967741923,34.11290322580641,0
3502,4,1,0,30,0.03333333333333333,0.0,1.0,30,900,700,200,0.7777777777777778,11,7,4,404.09434373867373,0.38635057471264367,0.00920926168632552,0.23753773826857333,131465.929948549,4624.927737310674,136090.85768585966,1973,0,368.76666666666665,30,0,21,33.255242463958055,0.6493055555555556,43.615591397849464,1025.5376344086023,34.18458781362008,8
3503,4,0,0,30,0.0,0.0,1.0,30,800,700,100,0.875,9,7,2,400.84553782155245,0.3864463601532567,0.01056079664570242,0.23605348338380305,131534.8595213319,4545.032301422128,136079.89182275403,1974,1,369.76666666666665,30,0,21,33.26863862683439,0.65,43.54838709677419,1025.806451612903,34.19354838709676,0
3504,4,0,0,30,0.0,0.0,1.0,30,750,500,250,0.6666666666666666,10,5,5,402.83465117787483,0.38594348659003835,0.012048561072535824,0.23743914227341462,131569.33108235057,4600.137118453003,136169.4682008036,1975,2,370.76666666666665,30,0,19,33.18267173239006,0.6503472222222222,43.51478494623656,1025.9408602150538,34.198028673835125,0
3505,4,0,0,30,0.0,0.0,1.0,30,850,600,250,0.7058823529411765,11,6,5,399.7511512187276,0.3850574712643678,0.014611154752552924,0.2366898676750885,131741.75663371492,4532.7837755810015,136274.5404092959,1976,3,371.76666666666665,30,0,20,33.08703194553549,0.6520833333333333,43.34677419354839,1026.6129032258068,34.220430107526894,0
3506,4,1,0,31,0.03225806451612903,0.0,1.0,31,900,700,200,0.7777777777777778,11,7,4,387.25845217112635,0.3886200716845878,0.02325847284605964,0.23247277903889813,132264.03130425353,4044.0728081597317,136308.10411241325,1977,0,360.741935483871,31,0,21,32.87974683544303,0.6545698924731183,42.83854166666667,1028.645833333334,33.182123655914,0
3507,4,0,0,31,0.0,0.0,1.0,31,650,400,250,0.6153846153846154,9,4,5,387.25845217112635,0.3886200716845878,0.02325847284605964,0.23247277903889813,132264.03130425353,4044.0728081597317,136308.10411241325,1978,1,361.741935483871,31,0,21,32.87974683544303,0.6545698924731183,42.83854166666667,1028.645833333334,33.182123655914,0
3508,4,0,0,31,0.0,0.0,1.0,31,550,300,250,0.5454545454545454,8,3,5,389.6062631574934,0.38875448028673837,0.020117405965006663,0.23429746510430108,132331.00891113293,4111.397976345502,136442.40688747843,1979,2,362.741935483871,31,0,21,32.751729519952754,0.655241935483871,42.77343750000001,1028.906250000001,33.19052419354842,0
3509,4,0,0,31,0.0,0.0,1.0,31,950,600,350,0.631578947368421,13,6,7,391.32055737982876,0.3880376344086021,0.016933588320036552,0.2359632148358056,132432.58794369307,4164.735780085917,136597.323723779,1980,3,363.741935483871,30,1,21,32.60506442064944,0.6590277777777778,42.67473118279571,1029.3010752688185,34.31003584229395,0
3510,4,0,0,31,0.0,0.0,1.0,31,750,500,250,0.6666666666666666,10,5,5,389.88018864741684,0.3873655913978495,0.02296226230470677,0.23655920648607065,132666.1512586805,4144.780815972216,136810.93207465272,1981,4,364.741935483871,31,0,18,32.40647118301314,0.6586021505376345,42.447916666666664,1030.208333333333,33.23252688172042,0
3511,4,1,0,32,0.03125,0.0,1.0,32,850,700,150,0.8235294117647058,10,7,3,378.1783528433742,0.39148605510752693,0.02360677561513036,0.23141115838033904,132983.40292125818,3658.2888544536413,136641.69177571184,1982,0,354.3125,32,0,19,32.38845023870731,0.6591796875,42.14015151515152,1031.439393939395,32.23248106060609,0
3512,4,0,0,32,0.0,0.0,1.0,32,900,500,400,0.5555555555555556,13,5,8,378.26853646795047,0.3909400201612903,0.02309616326031083,0.23187038345683603,133048.52701573828,3665.614318691982,136714.14133443026,1983,1,355.3125,32,0,20,32.32060539305676,0.6598307291666667,42.07702020202021,1031.6919191919199,32.240372474747495,0
3513,4,0,1,31,0.0,0.03125,0.96875,32,750,400,350,0.5333333333333333,11,4,7,381.2610346926454,0.39054099462365593,0.015896439931490036,0.23431787199832224,133146.2430491788,3752.69487807368,136898.93792725247,1984,2,356.3125,32,0,20,32.145114590979524,0.6608072916666667,41.98232323232324,1032.070707070708,32.25220959595963,0
3514,4,0,1,30,0.0,0.03225806451612903,0.967741935483871,31,1150,700,450,0.6086956521739131,16,7,9,389.9330673008985,0.38687275985663083,0.016151419558359192,0.23936634843993962,133102.46997409404,4180.210876464849,137282.68085055889,1985,3,368.4516129032258,31,0,20,31.965431125131445,0.6629704301075269,42.024739583333336,1031.9010416666672,33.2871303763441,0
3515,4,0,0,30,0.0,0.0,1.0,30,800,400,400,0.5,12,4,8,398.9437341510255,0.3862787356321839,0.01063626492942471,0.24436497682435113,133021.2149706613,4613.596044340382,137634.81101500167,1986,4,373.1333333333333,30,0,20,31.814875135722048,0.6649305555555556,42.10349462365591,1031.586021505376,34.38620071684587,0
3516,4,0,0,30,0.0,0.0,1.0,30,900,800,100,0.8888888888888888,10,8,2,398.99651707183864,0.3865181992337165,0.011441101124570974,0.24485181946926496,133090.55102107173,4620.533262515888,137711.0842835876,1987,5,374.1333333333333,30,0,20,31.743628153358515,0.665625,42.03629032258064,1031.8548387096769,34.39516129032256,0
3517,4,0,0,30,0.0,0.0,1.0,30,1100,900,200,0.8181818181818182,13,9,4,397.70199762948926,0.38603927203065136,0.013052914876068522,0.2445119007043112,133159.9051371545,4591.59205543992,137751.49719259443,1988,6,375.1333333333333,30,0,20,31.707145027564362,0.6663194444444445,41.96908602150537,1032.1236559139777,34.404121863799254,0
3518,4,0,0,30,0.0,0.0,1.0,30,950,600,350,0.631578947368421,13,6,7,378.9439156655315,0.3863026819923372,-0.007568227395588378,0.22600664424170486,132017.87236963824,4005.4738987166293,136023.34626835486,1989,7,376.1333333333333,30,0,21,33.34205248931904,0.6548611111111111,43.07795698924732,1027.6881720430117,34.256272401433726,8
3519,4,0,0,30,0.0,0.0,1.0,30,1000,800,200,0.8,12,8,4,378.16900521356325,0.3852729885057471,-0.004458099097921497,0.2261622142985573,132121.4902915078,3992.850510174601,136114.3408016824,1990,8,377.1333333333333,30,0,22,33.257343007800586,0.6559027777777777,42.977150537634415,1028.0913978494632,34.269713261648775,0
3520,4,0,0,30,0.0,0.0,1.0,30,600,200,400,0.3333333333333333,10,2,8,380.1155769414705,0.3855603448275862,-0.0060776369102082395,0.22774191692867612,132190.591488178,4049.5405899526186,136240.1320781306,1991,9,378.1333333333333,30,0,22,33.13755282533874,0.6565972222222223,42.90994623655915,1028.360215053765,34.278673835125495,0
3521,4,0,0,30,0.0,0.0,1.0,30,650,300,350,0.46153846153846156,10,3,7,376.2240005396719,0.3851053639846744,-0.007290305722498447,0.2260297095863934,132294.27715631886,3954.456440050893,136248.73359636974,1992,10,379.1333333333333,30,0,22,33.13300235171151,0.6576388888888889,42.80913978494625,1028.7634408602166,34.29211469534055,0
3522,4,0,1,29,0.0,0.03333333333333333,0.9666666666666667,30,650,300,350,0.46153846153846156,10,3,7,378.14093002671746,0.3855124521072797,-0.008771929824561209,0.22780685296731532,132398.0034722223,4013.0208333333517,136411.02430555565,1993,11,380.1333333333333,30,0,22,32.97908232118759,0.6586805555555555,42.70833333333334,1029.1666666666674,34.30555555555558,0
3523,4,0,0,29,0.0,0.0,1.0,29,850,700,150,0.8235294117647058,10,7,3,388.97152806609165,0.3795669129720854,0.005306472033961285,0.23388807466831232,132326.54320987666,4494.251543209893,136820.79475308655,1994,17,393.86206896551727,29,0,23,32.772565694744415,0.6609195402298851,42.777777777777786,1028.8888888888898,35.47892720306517,0
3524,4,0,0,29,0.0,0.0,1.0,29,700,500,200,0.7142857142857143,9,5,4,392.1777348556577,0.37905377668308704,0.0005582745594283622,0.2367118380089686,132469.4830246913,4590.3163580246855,137059.79938271598,1995,18,394.86206896551727,29,0,23,32.545759129339814,0.6623563218390804,42.638888888888886,1029.4444444444441,35.49808429118773,0
3525,4,0,1,28,0.0,0.034482758620689655,0.9655172413793104,29,900,800,100,0.8888888888888888,10,8,2,390.0396900998462,0.3797208538587849,0.005301462552607994,0.23609341241553927,132576.7385223764,4542.038001543195,137118.7765239196,1996,19,395.86206896551727,29,0,23,32.492554506630704,0.663433908045977,42.534722222222214,1029.86111111111,35.51245210727966,0
3526,4,0,0,28,0.0,0.0,1.0,28,700,500,200,0.7142857142857143,9,5,4,399.7004491937888,0.37880291005291006,0.003757824648139785,0.24150534729533635,132508.92827652255,4992.775630862714,137501.70390738526,1997,20,397.7142857142857,28,0,23,32.31230812168574,0.6659226190476191,42.60057471264367,1029.5977011494244,36.7713464696223,0
3527,4,0,0,28,0.0,0.0,1.0,28,950,700,250,0.7368421052631579,12,7,5,398.06327041314574,0.3791335978835979,0.004623724489795755,0.2409896556014719,132582.90395032353,4955.27686946754,137538.18081979107,1998,21,398.7142857142857,28,0,23,32.27975027901785,0.6666666666666667,42.528735632183896,1029.885057471263,36.781609195402254,0
3528,4,0,0,28,0.0,0.0,1.0,28,500,400,100,0.8,6,4,2,394.12373734220677,0.3795469576719577,0.027375063099444485,0.21835751305372839,129164.87327008175,4581.388517307412,133746.26178738917,1999,22,399.7142857142857,28,0,23,35.853356890459374,0.6320684523809523,45.869252873563205,1016.5229885057457,36.30439244663378,8
3529,4,0,0,28,0.0,0.0,1.0,28,1050,800,250,0.7619047619047619,13,8,5,393.52283412675035,0.37885802469135804,0.026924474225971773,0.2186306609065256,129274.43560906318,4574.488456202916,133848.9240652661,2000,23,400.7142857142857,28,0,23,35.756628520297646,0.6331845238095238,45.761494252873554,1016.9540229885048,36.31978653530374,0
3530,4,0,0,28,0.0,0.0,1.0,28,450,400,50,0.8888888888888888,5,4,1,392.81511030560654,0.3790509259259259,0.026181733814836017,0.2188453026022029,129384.04439572585,4564.8015342185,133948.84592994436,2001,24,401.7142857142857,28,0,23,35.662630042837634,0.6343005952380952,45.653735632183896,1017.3850574712633,36.33518062397369,0
3531,4,0,0,28,0.0,0.0,1.0,28,350,200,150,0.5714285714285714,5,2,3,391.8370606134012,0.37789351851851855,0.019447974022306802,0.21870621751967848,129457.14272443509,4545.2212561104325,134002.36398054552,2002,25,402.7142857142857,28,0,21,35.61285236952327,0.6350446428571428,45.58189655172413,1017.6724137931026,36.345443349753666,0
3532,4,0,0,28,0.0,0.0,1.0,28,350,300,50,0.8571428571428571,4,3,1,391.8370606134012,0.37789351851851855,0.019447974022306802,0.21870621751967848,129457.14272443509,4545.2212561104325,134002.36398054552,2003,26,403.7142857142857,28,0,21,35.61285236952327,0.6350446428571428,45.58189655172413,1017.6724137931026,36.345443349753666,0
3533,4,0,0,28,0.0,0.0,1.0,28,700,400,300,0.5714285714285714,10,4,6,389.6546276496194,0.37759038800705463,0.017836976687908068,0.21769032983201128,129493.69963006992,4491.563862465303,133985.26349253522,2004,27,404.7142857142857,28,0,21,35.63105825334085,0.6354166666666667,45.545977011494244,1017.8160919540222,36.35057471264365,0
3534,4,0,0,28,0.0,0.0,1.0,28,950,500,450,0.5263157894736842,14,5,9,389.4058422712943,0.3767361111111111,0.01914471164506426,0.2181596208835304,129603.40131209521,4493.664329832188,134097.06564192742,2005,28,405.7142857142857,28,0,21,35.5254338930436,0.6365327380952381,45.438218390804586,1018.2471264367803,36.36596880131358,0
3535,4,0,0,28,0.0,0.0,1.0,28,900,700,200,0.7777777777777778,11,7,4,401.6050953806489,0.37665343915343913,0.0070697220867868005,0.2139459871755095,127599.58382877539,4648.9286068173,132248.51243559268,2006,29,406.7142857142857,28,0,16,37.26980233219569,0.6160714285714286,47.413793103448285,1010.3448275862079,36.08374384236457,8
3536,4,1,0,29,0.034482758620689655,0.0,1.0,29,700,300,400,0.42857142857142855,11,3,8,405.1822659809976,0.38167077175697867,0.0950488817200068,0.21202522754169817,126874.79356586072,4508.985458779226,131383.77902463995,2007,0,393.6551724137931,28,1,21,37.92694666286365,0.6086309523809523,48.132183908045974,1007.4712643678159,35.98111658456485,8
3537,4,3,0,32,0.09375,0.0,1.0,32,700,500,200,0.7142857142857143,9,5,4,370.6987710547167,0.3982484879032258,0.0945867662203912,0.1988665782840496,127880.99500868049,3081.0655381944393,130962.06054687493,2008,0,357.65625,31,1,23,37.76175763817369,0.6102150537634409,47.135416666666664,1011.4583333333328,32.627688172042994,0
3538,4,1,0,33,0.030303030303030304,0.0,1.0,33,800,700,100,0.875,9,7,2,359.5319141729749,0.4008838383838384,0.08729267988527267,0.19414723365340636,128144.5312499999,2614.6809895833176,130759.21223958321,2009,0,347.7878787878788,31,2,24,37.774348422496566,0.6129032258064516,46.87499999999999,1012.4999999999992,32.66129032258062,0
3539,4,0,0,33,0.0,0.0,1.0,33,1250,800,450,0.64,17,8,9,361.65502474871306,0.40009469696969696,0.087123159616733,0.19593844655605744,128276.40109592,2678.3610026041465,130954.76209852414,2010,1,348.7878787878788,31,2,24,37.58568980291344,0.614247311827957,46.74479166666666,1013.0208333333321,32.67809139784942,0
3540,4,1,0,34,0.029411764705882353,0.0,1.0,34,950,700,250,0.7368421052631579,12,7,5,353.778448286878,0.40392899584076053,0.08342545481166952,0.19350645554697501,128656.40503838884,2303.172667329849,130959.5777057187,2011,0,339.5,32,2,19,37.397064924289566,0.6155598958333333,46.36994949494949,1014.5202020202012,31.703756313131287,0
3541,4,0,1,33,0.0,0.029411764705882353,0.9705882352941176,34,700,300,400,0.42857142857142855,11,3,8,352.2135705403336,0.40372474747474746,0.08265745322519247,0.19280573929578454,128688.43102744601,2265.162355882029,130953.59338332804,2012,1,340.5,32,2,19,37.40407748465239,0.6158854166666667,46.33838383838383,1014.6464646464633,31.707702020201978,0
3542,4,0,2,31,0.0,0.06060606060606061,0.9393939393939394,33,850,700,150,0.8235294117647058,10,7,3,364.21130450421975,0.4008443813131313,0.0902673247686725,0.19912773848367532,128639.39285278298,2770.3842163085646,131409.77706909156,2013,2,351.72727272727275,31,2,20,37.149836349634185,0.6179435483870968,46.386718749999986,1014.4531249999983,32.724294354838655,0
3543,4,1,0,32,0.03125,0.0,1.0,32,750,400,350,0.5333333333333333,11,4,7,377.0038573964798,0.39398521505376344,0.11695671612134051,0.20638158952037877,128689.46419022419,3303.284881200122,131992.7490714243,2014,0,363.375,30,2,21,36.77418642645825,0.6211805555555556,46.33736559139784,1014.6505376344076,33.821684587813586,0
3544,4,0,0,32,0.0,0.0,1.0,32,1200,900,300,0.75,15,9,6,377.20545275133577,0.39432123655913975,0.12174298106211134,0.20684665023422896,128757.66210327766,3313.618445774055,132071.2805490517,2015,1,364.375,30,2,21,36.69933342162187,0.621875,46.27016129032257,1014.9193548387083,33.83064516129028,0
3545,4,1,1,32,0.030303030303030304,0.030303030303030304,0.9696969696969697,33,300,200,100,0.6666666666666666,4,2,2,367.381874126463,0.39741161616161613,0.11833832364397501,0.2028790349475435,129035.96878051749,2881.0952080620514,131917.06398857955,2016,0,354.3030303030303,31,2,22,36.664450638643245,0.6219758064516129,45.99609374999999,1016.0156249999993,32.77469758064514,0
3546,4,1,0,33,0.030303030303030304,0.0,1.0,33,900,700,200,0.7777777777777778,11,7,4,372.7326893290531,0.39867424242424243,0.14319568396107552,0.20756667866912967,129366.91496107305,3043.855624728728,132410.77058580177,2017,0,355.0,31,2,23,36.19088378343787,0.6253360215053764,45.670572916666664,1017.3177083333327,32.816700268817186,0
3547,4,0,0,33,0.0,0.0,1.0,33,950,700,250,0.7368421052631579,12,7,5,372.99908431093496,0.3980823863636364,0.14830842009344924,0.2080647997066348,129433.15505981434,3055.689663357191,132488.84472317153,2018,1,356.0,31,2,16,36.11657602900406,0.626008064516129,45.60546874999999,1017.5781249999991,32.82510080645158,0
3548,4,1,0,34,0.029411764705882353,0.0,1.0,34,750,500,250,0.6666666666666666,10,5,5,364.61396916492424,0.40249925727866903,0.14768584677301755,0.20485414367845456,129715.36705438212,2659.206968676656,132374.57402305878,2019,0,346.5,32,2,17,36.04259626508016,0.6263020833333333,45.32828282828282,1018.686868686868,31.833964646464626,0
3549,4,0,1,33,0.0,0.029411764705882353,0.9705882352941176,34,1000,600,400,0.6,14,6,8,362.4770249167371,0.40190508021390375,0.14445659304614056,0.2039881165326406,129779.68606519733,2608.4308999081595,132388.1169651055,2020,1,347.5,32,2,17,36.03159851301117,0.626953125,45.26515151515151,1018.9393939393931,31.841856060606034,0
3550,4,1,0,34,0.029411764705882353,0.0,1.0,34,1000,600,400,0.6,14,6,8,362.1732103707204,0.4056558229352347,0.1506424263613324,0.20482568956260058,129972.73875114777,2614.528810835618,132587.26756198338,2021,0,348.3529411764706,32,2,19,35.84308444774641,0.62890625,45.07575757575757,1019.6969696969691,31.865530303030283,0
3551,4,1,2,33,0.02857142857142857,0.05714285714285714,0.9428571428571428,35,900,600,300,0.6666666666666666,12,6,6,372.56320645031406,0.4082633053221289,0.12022978225723246,0.20824427946004725,129513.05537533615,2650.6826681409525,132163.7380434771,2022,0,339.37142857142857,33,2,17,36.04623163977846,0.6218434343434344,45.52696078431371,1017.8921568627429,30.845216874628573,8
3552,4,0,0,33,0.0,0.0,1.0,33,950,700,250,0.7368421052631579,12,7,5,386.9587830024785,0.3993450126262626,0.1405247768186082,0.21567018048369227,129400.03289116747,3414.495849609364,132814.52874077685,2023,1,360.57575757575756,31,2,21,35.795260643289836,0.6256720430107527,45.63802083333333,1017.4479166666661,32.82090053763439,0
3553,4,0,0,33,0.0,0.0,1.0,33,650,500,150,0.7692307692307693,8,5,3,382.94153901624134,0.3987531565656566,0.13689666267381484,0.213970980020726,129499.41211276577,3318.140835232194,132817.55294799796,2024,2,361.57575757575756,31,2,18,35.79604814293633,0.6266801075268817,45.54036458333333,1017.8385416666661,32.833501344086,0
3554,4,0,0,33,0.0,0.0,1.0,33,600,200,400,0.3333333333333333,10,2,8,383.5218241638922,0.39776672979797983,0.13525536696892226,0.2148381565158765,129598.82948133674,3340.7958984374895,132939.62537977422,2025,3,362.57575757575756,31,2,18,35.679880647911325,0.6276881720430108,45.44270833333333,1018.2291666666661,32.84610215053762,0
3555,4,0,0,33,0.0,0.0,1.0,33,950,600,350,0.631578947368421,13,6,7,383.69695677083985,0.39796401515151514,0.13645659044432068,0.2156641515642996,129731.44531249999,3355.5121527777774,133086.95746527775,2026,4,363.57575757575756,31,2,18,35.54021813224268,0.6290322580645161,45.3125,1018.7499999999999,32.86290322580645,0
3556,4,0,0,33,0.0,0.0,1.0,33,900,600,300,0.6666666666666666,12,6,6,382.37761008145867,0.3975299873737374,0.1348169312906764,0.21546937034611785,129830.95169067381,3328.889804416232,133159.84149509005,2027,5,364.57575757575756,31,2,19,35.47242983688941,0.6300403225806452,45.21484375,1019.1406249999999,32.875504032258064,0
3557,4,0,0,33,0.0,0.0,1.0,33,850,600,250,0.7058823529411765,11,6,5,383.5877439057413,0.3963068181818182,0.13750324081060916,0.21688632653616313,129963.68620130744,3370.4954359266435,133334.18163723408,2028,6,365.57575757575756,31,2,21,35.306394457923645,0.6313844086021505,45.084635416666664,1019.6614583333328,32.892305107526866,0
3558,4,0,0,33,0.0,0.0,1.0,33,700,400,300,0.5714285714285714,10,4,6,384.7143781070175,0.3960306186868687,0.1336365957249288,0.21807904761869576,130063.28158908417,3407.4428982204813,133470.72448730466,2029,7,366.57575757575756,31,2,21,35.17626159475789,0.6323924731182795,44.986979166666664,1020.052083333333,32.90490591397848,0
3559,4,0,0,33,0.0,0.0,1.0,33,850,800,50,0.9411764705882353,9,8,1,384.07521347493457,0.39555713383838387,0.13051531004829453,0.2182739266137101,130162.91512383352,3398.469882541229,133561.38500637474,2030,8,367.57575757575756,31,2,21,35.091154140615025,0.6334005376344086,44.889322916666664,1020.442708333333,32.9175067204301,0
3560,4,0,0,33,0.0,0.0,1.0,33,900,700,200,0.7777777777777778,11,7,4,384.51752493576066,0.39571496212121215,0.13641580967177203,0.219272866401549,130295.81917656786,3420.205179850251,133716.02435641811,2031,9,368.57575757575756,31,2,21,34.94465523105045,0.634744623655914,44.75911458333333,1020.9635416666661,32.934307795698906,0
3561,4,0,0,33,0.0,0.0,1.0,33,600,400,200,0.6666666666666666,8,4,4,384.6843561252881,0.3952414772727273,0.14023942562580705,0.2195556565308957,130329.05578613267,3427.1097819010292,133756.1655680337,2032,10,369.57575757575756,31,2,21,34.90659270594237,0.6350806451612903,44.72656249999999,1021.0937499999989,32.93850806451609,0
3562,4,0,0,33,0.0,0.0,1.0,33,700,400,300,0.5714285714285714,10,4,6,387.1165397453292,0.3949258207070707,0.14057979411707944,0.2215119806201387,130428.79104614233,3498.2284545898165,133927.01950073216,2033,11,370.57575757575756,31,2,22,34.74306883365202,0.6360887096774194,44.628906249999986,1021.4843749999981,32.95110887096768,0
3563,4,0,0,33,0.0,0.0,1.0,33,1100,900,200,0.8181818181818182,13,9,4,386.7883257945826,0.395123106060606,0.13498903407160356,0.22189435532426027,130528.56445312475,3497.3849826388614,134025.9494357636,2034,12,371.57575757575756,31,2,19,34.650016989466536,0.6370967741935484,44.531249999999986,1021.8749999999981,32.963709677419295,0
3564,4,0,0,33,0.0,0.0,1.0,33,800,700,100,0.875,9,7,2,385.5494785389036,0.39551767676767674,0.1348560133118677,0.2213736545026957,130561.83073255728,3467.609151204394,134029.4398837617,2035,13,372.57575757575756,31,2,19,34.64785853824265,0.6374327956989247,44.49869791666665,1022.0052083333316,32.9679099462365,0
3565,4,0,0,33,0.0,0.0,1.0,33,1000,800,200,0.8,12,8,4,387.29165483386737,0.39535984848484845,0.1364524223122947,0.22256511643088256,130595.1012505424,3515.6785753037957,134110.7798258462,2036,14,373.57575757575756,31,2,19,34.569532908704865,0.637768817204301,44.46614583333332,1022.1354166666655,32.972110215053725,0
3566,4,0,0,33,0.0,0.0,1.0,33,800,500,300,0.625,11,5,6,386.5081926466914,0.3954782196969697,0.14357478528601586,0.2228807154953824,130728.22570800755,3505.5060492621255,134233.73175726968,2037,15,374.57575757575756,31,2,19,34.45431202784144,0.6391129032258065,44.335937499999986,1022.656249999998,32.98891129032251,0
3567,4,0,0,33,0.0,0.0,1.0,33,800,500,300,0.625,11,5,6,385.22868256854696,0.3948469065656566,0.13897663153104145,0.22271830455784164,130828.11355590791,3479.748365614107,134307.861921522,2038,16,375.57575757575756,31,2,20,34.385606253447015,0.6401209677419355,44.23828124999998,1023.0468749999976,33.001512096774114,0
3568,4,0,0,33,0.0,0.0,1.0,33,900,600,300,0.6666666666666666,12,6,6,385.8706676803553,0.3952809343434343,0.13624217746879674,0.2234751346573256,130894.72664727079,3501.687113443974,134396.41376071476,2039,17,376.57575757575756,31,2,20,34.30157038639351,0.6407930107526882,44.173177083333314,1023.3072916666645,33.00991263440853,0
3569,4,0,0,33,0.0,0.0,1.0,33,750,500,250,0.6666666666666666,10,5,5,386.03068518751184,0.39516256313131315,0.13694364476508714,0.22434288822094614,131028.00369262672,3516.1660088432886,134544.16970147,2040,18,377.57575757575756,31,2,21,34.162241934800115,0.6421370967741935,44.042968749999986,1023.8281249999982,33.02671370967736,0
3570,4,0,0,33,0.0,0.0,1.0,33,1050,800,250,0.7619047619047619,13,8,5,384.58407134082495,0.39595170454545453,0.13159556931798977,0.22447384816836846,131194.6953667533,3491.078016493032,134685.77338324633,2041,19,378.57575757575756,31,2,22,34.03024911032029,0.6438172043010753,43.88020833333332,1024.4791666666652,33.04771505376339,0
3571,4,0,0,33,0.0,0.0,1.0,33,1100,900,200,0.8181818181818182,13,9,4,386.16216467412715,0.3963068181818182,0.12543102763343983,0.22658807631801883,131397.01844143838,3548.179231454693,134945.1976728931,2042,20,379.57575757575756,30,3,23,33.78479505331236,0.6486111111111111,43.682795698924735,1025.2688172043015,34.175627240143385,0
3572,4,0,0,33,0.0,0.0,1.0,33,1000,800,200,0.8,12,8,4,384.6769257984697,0.395636047979798,0.13140048281557704,0.22653196741465428,131534.85952133193,3519.685079199906,135054.54460053184,2043,21,380.57575757575756,30,3,23,33.683285290007,0.65,43.54838709677419,1025.8064516129032,34.193548387096776,0
3573,4,1,0,34,0.029411764705882353,0.0,1.0,34,1150,900,250,0.782608695652174,14,9,5,374.8229364027981,0.3969474153297683,0.1270434672411609,0.22322473895505518,131962.8418816461,3092.539978027354,135055.38185967345,2044,0,370.3529411764706,31,3,22,33.50349026316901,0.6515456989247312,43.13151041666667,1027.473958333334,33.14432123655916,0
3574,4,0,0,34,0.0,0.0,1.0,34,800,500,300,0.625,11,5,6,376.7158518528792,0.3972445038621509,0.1311176694166838,0.2247481646768537,132029.74319458008,3147.5394354926225,135177.2826300727,2045,1,371.3529411764706,31,3,22,33.38731048608472,0.6522177419354839,43.06640625,1027.734375,33.15272177419355,0
3575,4,0,0,34,0.0,0.0,1.0,34,800,600,200,0.75,10,6,4,378.30298837350153,0.39674316696375517,0.13315399633377578,0.2258943865522254,132063.20020887582,3191.9806586371487,135255.18086751297,2046,2,372.3529411764706,31,3,22,33.31274807870956,0.6525537634408602,43.033854166666664,1027.864583333333,33.156922043010745,0
3576,4,0,0,34,0.0,0.0,1.0,34,1500,1100,400,0.7333333333333333,19,11,8,376.87717164612775,0.397653000594177,0.1304595518420053,0.22604045397363426,132230.54885864258,3166.935051812067,135397.48391045464,2047,3,373.3529411764706,31,3,23,33.180492256403774,0.654233870967742,42.87109375,1028.515625,33.177923387096776,0
3577,4,0,0,34,0.0,0.0,1.0,34,1100,800,300,0.7272727272727273,14,8,6,380.4226425701685,0.3973002079619727,0.13560974883499344,0.22877471244973144,132331.0089111328,3268.3424207899316,135599.35133192275,2048,4,374.3529411764706,31,3,23,32.98795663545094,0.655241935483871,42.7734375,1028.90625,33.190524193548384,0
3578,4,0,0,34,0.0,0.0,1.0,34,900,600,300,0.6666666666666666,12,6,6,381.50265346832765,0.39674316696375517,0.1387369180801159,0.2296341673387646,132365.51914345485,3299.5593561881587,135665.07849964302,2049,5,375.3529411764706,32,2,23,32.925357873210636,0.6529947916666667,42.739898989899,1029.0404040404048,32.15751262626265,0
3579,4,0,0,34,0.0,0.0,1.0,34,650,400,250,0.6153846153846154,9,4,5,380.1775715984751,0.39639037433155083,0.1386324182323755,0.2292440821496949,132432.58794369307,3269.587908112355,135702.17585180543,2050,6,376.3529411764706,30,4,23,32.891801601810755,0.6590277777777778,42.67473118279571,1029.3010752688185,34.31003584229395,0
3580,4,0,0,34,0.0,0.0,1.0,34,750,600,150,0.8,9,6,3,378.92573341065304,0.3964832144979204,0.13830326490173017,0.2286991483208978,132467.1769315818,3239.0444343276827,135706.2213659095,2051,7,377.3529411764706,30,4,23,32.88913913913915,0.659375,42.64112903225807,1029.4354838709687,34.31451612903229,0
3581,4,0,0,34,0.0,0.0,1.0,34,850,600,250,0.7058823529411765,11,6,5,377.0398150668764,0.395461972667855,0.1365224891625214,0.2285641361681273,132632.61795043954,3201.555548773887,135834.17349921342,2052,8,378.3529411764706,31,3,17,32.770957106139136,0.658266129032258,42.48046875000001,1030.0781250000007,33.228326612903246,0
3582,4,0,0,34,0.0,0.0,1.0,34,900,600,300,0.6666666666666666,12,6,6,376.86457820099025,0.3953134284016637,0.13416120903056084,0.22886641652374815,132699.6888054743,3201.962449815558,135901.65125528985,2053,9,379.3529411764706,31,3,18,32.70791208559755,0.6589381720430108,42.41536458333334,1030.3385416666677,33.23672715053767,0
3583,4,0,0,34,0.0,0.0,1.0,34,950,800,150,0.8421052631578947,11,8,3,381.3080297928782,0.3940508021390374,0.14266191325014854,0.23302157376231453,132934.57031250003,3337.8038194444457,136272.37413194447,2054,10,380.3529411764706,31,3,19,32.35690235690235,0.6612903225806452,42.1875,1031.2500000000002,33.26612903225807,0
3584,4,0,0,34,0.0,0.0,1.0,34,900,800,100,0.8888888888888888,10,8,2,382.89951618025805,0.3940136660724896,0.14315309562350564,0.23441498973570363,133001.71746148012,3385.2586534288257,136386.97611490893,2055,11,381.3529411764706,31,3,19,32.24827484641924,0.6619623655913979,42.122395833333336,1031.5104166666672,33.27452956989249,0
3585,4,0,0,34,0.0,0.0,1.0,34,850,500,350,0.5882352941176471,12,5,7,385.95145392636107,0.394793523469994,0.13748497127844317,0.23713575378452229,133136.06262207034,3476.8113878038216,136612.87400987415,2056,12,382.3529411764706,31,3,19,32.034338464126506,0.6633064516129032,41.9921875,1032.0312500000002,33.291330645161295,0
3586,4,0,1,33,0.0,0.029411764705882353,0.9705882352941176,34,600,400,200,0.6666666666666666,8,4,4,385.17277355516046,0.3945150029708853,0.13687589055685856,0.23672197376239712,133146.2430491787,3456.861544740333,136603.10459391904,2057,13,383.3529411764706,32,2,19,32.04418481363672,0.6608072916666667,41.98232323232323,1032.0707070707074,32.252209595959606,0
3587,4,0,0,33,0.0,0.0,1.0,33,850,600,250,0.7058823529411765,11,6,5,427.4012419077819,0.39232165404040403,0.18415683932925342,0.2344931138034587,128778.12499999997,4408.783223650647,133186.90822365062,2058,36,395.57575757575756,29,4,17,35.40469348659005,0.625,46.25,1014.9999999999998,34.99999999999999,8
3588,4,0,0,33,0.0,0.0,1.0,33,950,700,250,0.7368421052631579,12,7,5,427.5547165655569,0.391769255050505,0.18876400769179758,0.2354126571933246,128919.1358024691,4423.996913580239,133343.13271604935,2059,37,396.57575757575756,29,4,18,35.2559719183078,0.6264367816091954,46.11111111111111,1015.5555555555553,35.0191570881226,0
3589,4,0,0,33,0.0,0.0,1.0,33,650,600,50,0.9230769230769231,7,6,1,427.5547165655569,0.391769255050505,0.18876400769179758,0.2354126571933246,128919.1358024691,4423.996913580239,133343.13271604935,2060,38,397.57575757575756,29,4,18,35.2559719183078,0.6264367816091954,46.11111111111111,1015.5555555555553,35.0191570881226,0
3590,4,0,0,33,0.0,0.0,1.0,33,950,500,450,0.5263157894736842,14,5,9,427.4636756559267,0.39216382575757575,0.18736924957020684,0.23599221037155507,129024.9445408951,4430.695408950628,133455.63994984573,2061,39,398.57575757575756,29,4,18,35.14966393255868,0.6275143678160919,46.00694444444445,1015.9722222222226,35.03352490421457,0
3591,4,0,0,33,0.0,0.0,1.0,33,850,800,50,0.9411764705882353,9,8,1,428.8387783096778,0.3919270833333333,0.18972262305595655,0.23698985117113772,129064.77627471383,4469.596196092035,133534.37247080586,2062,40,399.57575757575756,30,3,18,35.073853615520285,0.625,45.96774193548387,1016.1290322580645,33.87096774193548,0
3592,4,0,0,33,0.0,0.0,1.0,33,750,600,150,0.8,9,6,3,428.984144047299,0.39180871212121215,0.18777943368107297,0.2378912071535024,129201.388888889,4485.141707133792,133686.53059602279,2063,41,400.57575757575756,29,4,19,34.92998633879783,0.6293103448275862,45.83333333333334,1016.6666666666677,35.05747126436785,0
3593,4,1,1,33,0.029411764705882353,0.029411764705882353,0.9705882352941176,34,1050,700,350,0.6666666666666666,14,7,7,419.4879772879559,0.39581476530005943,0.19715079592993034,0.23567823423761436,129714.32978162215,4082.720365071105,133797.05014669325,2064,0,389.7647058823529,30,4,18,34.64617143862428,0.6315972222222221,45.329301075268816,1018.6827956989246,33.95609318996415,0
3594,4,1,0,34,0.029411764705882353,0.0,1.0,34,1000,800,200,0.8,12,8,4,412.586644112043,0.39726307189542487,0.21105237456690462,0.2338401823873258,130056.85492903792,3931.944263787706,133988.79919282562,2065,0,388.1764705882353,30,4,19,34.472042869064865,0.6350694444444445,44.993279569892465,1020.0268817204292,34.00089605734764,0
3595,4,0,0,34,0.0,0.0,1.0,34,750,500,250,0.6666666666666666,10,5,5,416.12578589778445,0.3962603980986334,0.21352871452808753,0.23667738519264983,130193.99144771062,4035.415402069591,134229.4068497802,2066,1,389.1764705882353,30,4,19,34.2417906844023,0.6364583333333333,44.85887096774193,1020.5645161290314,34.018817204301044,0
3596,4,1,0,35,0.02857142857142857,0.0,1.0,35,1150,900,250,0.782608695652174,14,9,5,401.64984030729124,0.3991596638655462,0.207575729121674,0.2312907142481122,130674.53833174346,3497.099556307078,134171.63788805055,2067,0,379.0285714285714,30,5,19,34.12180666929583,0.6413194444444444,44.38844086021505,1022.446236559139,34.081541218637966,0
3597,4,0,0,35,0.0,0.0,1.0,35,1000,700,300,0.7,13,7,6,399.1566529274537,0.39912464985994395,0.20355922658156578,0.23046905377677732,130777.62783269743,3440.15204069835,134217.77987339578,2068,1,380.0285714285714,30,5,19,34.080705212439774,0.6423611111111112,44.28763440860215,1022.8494623655914,34.09498207885305,0
3598,4,0,0,35,0.0,0.0,1.0,35,1450,1100,350,0.7586206896551724,18,11,7,397.9930408285475,0.3986694677871148,0.19555388800300166,0.23082383898776776,130949.53399598224,3423.400646028453,134372.9346420107,2069,2,381.0285714285714,30,5,19,33.93576274896038,0.6440972222222222,44.11962365591398,1023.5215053763445,34.11738351254482,0
3599,4,1,0,36,0.027777777777777776,0.0,1.0,36,1100,700,400,0.6363636363636364,15,7,8,388.4915443435529,0.4030919312169312,0.19294847368643886,0.22774340496029719,131361.49300469286,3006.5658569335887,134368.05886162646,2070,0,371.4166666666667,31,5,20,33.76108747195057,0.645497311827957,43.717447916666664,1025.130208333333,33.06871639784945,0
3600,4,1,0,37,0.02702702702702703,0.0,1.0,37,850,600,250,0.7058823529411765,11,6,5,387.87618482190953,0.40887762762762764,0.22112412586240415,0.2168556034697805,129522.50567544128,2647.7390699928583,132170.24474543415,2071,0,362.35135135135135,32,5,18,35.64691350367983,0.6243489583333333,45.51767676767677,1017.9292929292928,31.8102904040404,6
3601,4,1,0,38,0.02631578947368421,0.0,1.0,38,650,400,250,0.6153846153846154,9,4,5,382.1063701923081,0.41233997155049784,0.22401315789473708,0.21597316576086958,129950.01922337551,2330.9460303729247,132280.96525374844,2072,0,353.7894736842105,33,5,19,35.35807291666668,0.6262626262626263,45.09803921568627,1019.607843137254,30.897207367795577,0
3602,4,0,0,38,0.0,0.0,1.0,38,350,200,150,0.5714285714285714,5,2,3,382.5427044837322,0.41205844001896635,0.2268673426144383,0.2163927834132654,129981.25908604852,2344.67647659553,132325.93556264404,2073,1,354.7894736842105,33,5,19,35.31514140928575,0.6265782828282829,45.06740196078431,1019.7303921568619,30.900920974450358,0
3603,4,0,0,38,0.0,0.0,1.0,38,1550,1000,550,0.6451612903225806,21,10,11,383.2355417759219,0.4107989568515884,0.22565331175645076,0.2176547831395859,130137.51471789708,2374.664191657069,132512.17890955415,2074,2,355.7894736842105,33,5,19,35.138421811193844,0.6281565656565656,44.91421568627452,1020.343137254903,30.919489007724334,0
3604,4,1,0,39,0.02564102564102564,0.0,1.0,39,950,600,350,0.631578947368421,13,6,7,368.04931818188567,0.4143331084120558,0.14116418598275038,0.20516940749124657,129407.39300679445,1725.6605527692077,131133.05355956365,2075,0,347.64102564102564,35,4,20,36.26874549728889,0.6163690476190475,45.63078703703704,1017.4768518518522,29.070767195767207,8
3605,4,3,2,40,0.07142857142857142,0.047619047619047616,0.9523809523809523,42,1000,700,300,0.7,13,7,6,350.01708390139066,0.4216148857917151,0.163875514618659,0.19928863048831283,130235.3223847616,716.9175524143614,130952.23993717597,2076,0,323.73809523809524,38,4,19,35.886583280999254,0.6189692982456141,44.818376068376075,1020.7264957264966,26.86122357174991,0
3606,4,0,0,40,0.0,0.0,1.0,40,1200,700,500,0.5833333333333334,17,7,10,356.4515804362345,0.418482905982906,0.16798452943704323,0.20280264735332967,130206.62607725461,1282.4715297014532,131489.09760695606,2077,1,329.175,37,3,19,35.75150408250967,0.6204954954954955,44.84649122807018,1020.6140350877199,27.584163110478915,0
3607,4,1,0,41,0.024390243902439025,0.0,1.0,41,1300,1100,200,0.8461538461538461,15,11,4,350.39765855360287,0.4215193089430895,0.17279231002955564,0.2011710874530762,130558.13426997591,949.4889794556816,131507.6232494316,2078,0,322.1219512195122,35,6,19,35.54973574933937,0.6279761904761905,44.50231481481481,1021.9907407407401,29.19973544973543,0
3608,4,0,0,41,0.0,0.0,1.0,41,1300,900,400,0.6923076923076923,17,9,8,354.04915454911054,0.42045223577235774,0.17388689135157342,0.20443919076729608,130780.4145995656,1060.5390441116574,131840.95364367726,2079,1,323.1219512195122,36,5,19,35.2313387647253,0.6281828703703703,44.2849099099099,1022.860360360359,28.41278778778775,0
3609,4,0,1,40,0.0,0.024390243902439025,0.975609756097561,41,1150,800,350,0.6956521739130435,15,8,7,353.4626951657268,0.42022357723577236,0.17676416499993275,0.20440538418718174,130838.01442912495,1049.2714420501416,131887.2858711751,2080,2,324.1219512195122,36,5,19,35.188038891946434,0.6287615740740741,44.228603603603595,1023.0855855855846,28.419044044044014,0
3610,4,1,0,41,0.024390243902439025,0.0,1.0,41,850,600,250,0.7058823529411765,11,6,5,357.4708846022121,0.42032520325203254,0.18663232176876265,0.2074974674989848,130982.0694850253,1164.4552491680595,132146.52473419337,2081,0,324.780487804878,36,5,20,34.939723138980575,0.6302083333333333,44.087837837837824,1023.6486486486465,28.434684684684626,0
3611,4,0,0,41,0.0,0.0,1.0,41,1400,1000,400,0.7142857142857143,18,10,8,357.41742667078813,0.4205030487804878,0.1867253978303094,0.20777744522319705,131039.71370018649,1167.1754524794842,132206.88915266597,2082,1,325.780487804878,36,5,20,34.882772400645244,0.630787037037037,44.03153153153152,1023.8738738738724,28.4409409409409,0
3612,4,1,1,41,0.023809523809523808,0.023809523809523808,0.9761904761904762,42,1300,600,700,0.46153846153846156,20,6,14,351.6479411082451,0.42038085559427024,0.18905402252634662,0.20581810244364798,131300.7492900319,834.3276307619021,132135.0769207938,2083,0,319.0,38,4,21,34.76667014142258,0.6296600877192983,43.77670940170939,1024.8931623931605,26.970872694556856,0
3613,4,0,0,41,0.0,0.0,1.0,41,1150,900,250,0.782608695652174,14,9,5,358.45286404578735,0.4171747967479675,0.19423446374874676,0.20933647260273952,131215.7586949829,1206.9329024314948,132422.6915974144,2084,1,327.5853658536585,37,4,21,34.67822488584474,0.6306306306306306,43.85964912280701,1024.5614035087706,27.690848743480284,0
3614,4,0,0,41,0.0,0.0,1.0,41,900,700,200,0.7777777777777778,11,7,4,358.0854131830744,0.4169715447154472,0.19619204217724362,0.20927505854883205,131243.8457626382,1199.3013475299736,132443.14711016818,2085,2,328.5853658536585,37,4,21,34.65924291064739,0.6309121621621622,43.832236842105246,1024.6710526315765,27.69381223328585,0
3615,4,0,0,41,0.0,0.0,1.0,41,1450,1000,450,0.6896551724137931,19,10,9,356.44468266367,0.4169461382113821,0.1973307507369746,0.2092745774902651,131419.65880102038,1168.8488701978931,132588.50767121828,2086,3,329.5853658536585,34,7,22,34.52363675064824,0.6387867647058824,43.660714285714285,1025.3571428571427,30.157563025210077,0
3616,4,0,0,41,0.0,0.0,1.0,41,1300,1000,300,0.7692307692307693,16,10,6,356.54210448863336,0.4168445121951219,0.2028491609042815,0.21000159360072151,131541.75347222228,1180.0347222222333,132721.7881944445,2087,4,330.5853658536585,34,7,22,34.397847278635254,0.6400122549019608,43.54166666666667,1025.833333333334,30.171568627451,0
3617,4,0,0,41,0.0,0.0,1.0,41,1000,600,400,0.6,14,6,8,357.20192739122785,0.4165904471544715,0.20576332010709297,0.21055856431310532,131572.28599773237,1199.5748299319673,132771.86082766432,2088,5,331.5853658536585,34,7,18,34.350100564709514,0.6403186274509804,43.51190476190476,1025.9523809523805,30.17507002801119,0
3618,4,0,0,41,0.0,0.0,1.0,41,1300,800,500,0.6153846153846154,18,8,10,358.9131346349985,0.4159806910569106,0.20706954024885316,0.21218944519621113,131684.26890432098,1252.6427469135824,132936.91165123458,2089,6,332.5853658536585,35,6,19,34.19316644113668,0.6392857142857142,43.40277777777778,1026.388888888889,29.325396825396826,0
3619,4,0,0,41,0.0,0.0,1.0,41,1350,900,450,0.6666666666666666,18,9,9,356.5593363370192,0.4154979674796748,0.20631106925373777,0.21106460454858875,131732.4334469605,1194.0858087817578,132926.51925574226,2090,7,333.5853658536585,36,5,19,34.20496928477401,0.6377314814814814,43.35585585585586,1026.5765765765768,28.516016016016025,0
3620,4,0,1,40,0.0,0.024390243902439025,0.975609756097561,41,900,600,300,0.6666666666666666,12,6,6,358.0067743813279,0.41587906504065036,0.20912266810757596,0.2122435480369928,131790.2425229284,1236.3599241133106,133026.60244704172,2091,8,334.5853658536585,36,5,19,34.10949952474958,0.6383101851851851,43.29954954954955,1026.8018018018024,28.52227227227229,0
3621,4,0,2,38,0.0,0.05,0.95,40,1150,900,250,0.782608695652174,14,9,5,369.80813590908383,0.41394230769230766,0.21530658250676282,0.2193140228466171,131803.09070644723,1748.3710562414296,133551.46176268865,2092,9,343.575,35,5,20,33.793582807333934,0.6404761904761904,43.28703703703704,1026.8518518518522,29.33862433862435,0
3622,4,0,0,38,0.0,0.0,1.0,38,850,500,350,0.5882352941176471,12,5,7,375.1159554730982,0.41108048838312,0.22146274777853692,0.22218406593406595,131755.55555555562,2284.722222222228,134040.27777777784,2093,10,360.07894736842104,34,4,20,33.70535714285714,0.642156862745098,43.333333333333336,1026.6666666666672,30.196078431372566,0
3623,4,0,1,37,0.0,0.02631578947368421,0.9736842105263158,38,700,500,200,0.7142857142857143,9,5,4,371.14958596704787,0.4113472024656235,0.21735231681428857,0.22054260521513022,131877.8061224491,2189.278628117931,134067.08475056704,2094,11,361.07894736842104,34,4,20,33.683694560346154,0.6433823529411764,43.21428571428572,1027.1428571428582,30.210084033613477,0
3624,4,0,0,37,0.0,0.0,1.0,37,1200,900,300,0.75,15,9,6,378.25485033331694,0.41025400400400397,0.21943088462912264,0.22440346210283296,131816.67375283447,2572.0592403628157,134388.73299319728,2095,14,371.5405405405405,34,3,20,33.563016848288136,0.6427696078431373,43.273809523809526,1026.904761904762,30.203081232493,0
3625,4,0,0,37,0.0,0.0,1.0,37,1050,700,350,0.6666666666666666,14,7,7,377.82856160769336,0.4094094094094094,0.21283392314678573,0.224873137012027,131938.95266439897,2570.060941043071,134509.01360544204,2096,15,372.5405405405405,34,3,20,33.45041521823099,0.6439950980392157,43.1547619047619,1027.3809523809514,30.217086834733863,0
3626,4,0,0,37,0.0,0.0,1.0,37,1550,1300,250,0.8387096774193549,18,13,5,383.1422628243184,0.40872122122122123,0.21423206439417686,0.22914242255892037,132122.47732426287,2724.340986394541,134846.8183106574,2097,16,373.5405405405405,34,3,20,33.12852207812258,0.6458333333333333,42.97619047619047,1028.095238095237,30.238095238095205,0
3627,4,0,0,37,0.0,0.0,1.0,37,1100,700,400,0.6363636363636364,15,7,8,380.67770018551454,0.4093155655655656,0.1992137260446405,0.22879270297153734,132308.68115837185,2673.3928915895003,134982.07404996135,2098,17,374.5405405405405,35,2,20,33.00392338845765,0.6455357142857143,42.795138888888886,1028.8194444444441,29.394841269841262,0
3628,4,1,0,38,0.02631578947368421,0.0,1.0,38,850,600,250,0.7058823529411765,11,6,5,371.4385878711782,0.411643551446183,0.19523450285637778,0.22486460627526686,132581.8470096372,2249.2630877582524,134831.11009739543,2099,0,365.6578947368421,34,4,21,32.966323739066766,0.6504289215686274,42.529761904761905,1029.8809523809525,30.290616246498605,0
3629,4,0,0,38,0.0,0.0,1.0,38,750,500,250,0.6666666666666666,10,5,5,371.42209696773693,0.4112138454243717,0.1952866970384468,0.22522182235892274,132643.15653344675,2253.3198696145128,134896.47640306127,2100,1,366.6578947368421,34,4,18,32.90501367541123,0.6510416666666667,42.470238095238095,1030.1190476190477,30.29761904761905,0
3630,4,0,1,37,0.0,0.02631578947368421,0.9736842105263158,38,1050,700,350,0.6666666666666666,14,7,7,371.39170521055036,0.4107693219535325,0.19834099965708485,0.22552039289115403,132695.96220207473,2256.4359353566524,134952.3981374314,2101,2,367.6578947368421,35,3,18,32.8526361117352,0.6494047619047619,42.41898148148148,1030.324074074074,29.437830687830683,0
3631,4,0,1,36,0.0,0.02702702702702703,0.972972972972973,37,1150,900,250,0.782608695652174,14,9,5,380.93219943222437,0.4083771271271271,0.20721866242615294,0.2306119284316428,132581.8470096373,2700.938917233576,135282.78592687089,2102,21,378.5405405405405,34,3,20,32.72189149616615,0.6504289215686274,42.52976190476191,1029.8809523809534,30.29061624649863,0
3632,4,0,0,36,0.0,0.0,1.0,36,1500,1200,300,0.8,18,12,6,378.9505244528736,0.4070767195767196,0.19971469329529223,0.23099505881866497,132839.8032006922,2867.942618223779,135707.74581891598,2103,22,382.0,33,3,19,32.5130765572991,0.6553030303030303,42.27941176470589,1030.8823529411777,31.23885918003569,0
3633,4,0,0,36,0.0,0.0,1.0,36,600,300,300,0.5,9,3,6,378.30087142954886,0.4070436507936508,0.20091514143094868,0.23098864529812954,132902.97752066512,2855.462442329875,135758.439962995,2104,23,383.0,33,3,19,32.46622692338166,0.6559343434343434,42.21813725490196,1031.1274509803923,31.24628639334522,0
3634,4,0,0,36,0.0,0.0,1.0,36,900,600,300,0.6666666666666666,12,6,6,381.778719090731,0.40603505291005293,0.2102703202132996,0.23390198379226876,133029.3712153979,2957.5565888119922,135986.9278042099,2105,24,384.0,33,3,19,32.24934663815632,0.6571969696969697,42.095588235294116,1031.6176470588234,31.261140819964346,0
3635,4,0,0,36,0.0,0.0,1.0,36,750,400,350,0.5333333333333333,11,4,7,381.8323407032759,0.4057374338624338,0.21064539961476547,0.23472934112430605,133155.8249831796,2968.640066320653,136124.46504950026,2106,25,385.0,33,3,19,32.12073537560358,0.658459595959596,41.97303921568628,1032.1078431372555,31.2759952465835,0
3636,4,0,0,36,0.0,0.0,1.0,36,1300,900,400,0.6923076923076923,17,9,8,384.5691638505821,0.40540674603174603,0.21520523372375222,0.23681364300272686,133219.0743944637,3046.389609765479,136265.46400422917,2107,26,386.0,33,3,19,31.98648702120925,0.6590909090909092,41.911764705882355,1032.352941176471,31.28342245989306,0
3637,4,0,0,36,0.0,0.0,1.0,36,600,400,200,0.6666666666666666,8,4,4,384.6189012846815,0.4046792328042328,0.2142334322453021,0.2370456652028853,133250.7047319541,3050.147929882741,136300.85266183683,2108,27,387.0,33,3,19,31.95338773491592,0.6594065656565656,41.881127450980394,1032.4754901960787,31.287136066547838,0
3638,4,0,1,35,0.0,0.027777777777777776,0.9722222222222222,36,1300,900,400,0.6923076923076923,17,9,8,384.5090117749384,0.4037367724867725,0.21276875008003282,0.23780361334077996,133379.97626133796,3057.1605725623695,136437.13683390032,2109,28,388.0,34,2,19,31.82623602627636,0.6583946078431373,41.75595238095239,1032.9761904761913,30.38165266106445,0
3639,4,0,0,35,0.0,0.0,1.0,35,1600,1200,400,0.75,20,12,8,394.47350335593467,0.4022408963585434,0.21313987388975586,0.24374066614983986,133345.6182718184,3520.262639369459,136865.88091118788,2110,29,390.0857142857143,33,2,19,31.60348441702262,0.6603535353535354,41.7892156862745,1032.843137254901,31.298276886512152,0
3640,4,0,0,35,0.0,0.0,1.0,35,1200,900,300,0.75,15,9,6,389.4629723681408,0.4021008403361344,0.20810192861506294,0.24167963827393713,133504.84206012133,3399.098595903625,136903.94065602496,2111,30,391.0857142857143,32,3,19,31.572744858480966,0.6643880208333333,41.635101010101,1033.4595959595952,32.29561237373735,0
3641,4,0,0,35,0.0,0.0,1.0,35,800,600,200,0.75,10,6,4,391.1719475186175,0.40189075630252097,0.21186201120242942,0.24316816509756423,133570.0936926079,3449.774735996324,137019.8684286042,2112,31,392.0857142857143,32,3,20,31.46299010626603,0.6650390625,41.571969696969695,1033.712121212121,32.30350378787878,0
3642,4,0,0,35,0.0,0.0,1.0,35,750,700,50,0.9333333333333333,8,7,1,390.8899352563666,0.4014705882352941,0.21469916089527818,0.24342187679196853,133635.36126734523,3447.343542750748,137082.70481009598,2113,32,393.0857142857143,32,3,20,31.404679040989954,0.6656901041666667,41.50883838383839,1033.9646464646469,32.311395202020215,0
3643,4,0,0,35,0.0,0.0,1.0,35,1000,600,400,0.6,14,6,8,386.87610222261077,0.4015056022408963,0.20932074322266248,0.24192652258987257,133788.99491782003,3351.952974817376,137140.9478926374,2114,33,394.0857142857143,33,2,19,31.354141988470346,0.6647727272727273,41.36029411764706,1034.5588235294115,31.350267379679135,0
3644,4,0,0,35,0.0,0.0,1.0,35,1000,700,300,0.7,13,7,6,382.7404801317771,0.40154061624649856,0.20172524610128195,0.24016538597273335,133915.80912389472,3251.0002162629835,137166.80934015772,2115,34,395.0857142857143,33,2,19,31.33386612992343,0.6660353535353536,41.23774509803922,1035.0490196078438,31.365121806298298,0
3645,4,0,0,35,0.0,0.0,1.0,35,450,200,250,0.4444444444444444,7,2,5,381.9262662282323,0.40143557422969184,0.19994249860474556,0.23986105359329982,133947.5220618274,3231.615394319515,137179.1374561469,2116,35,396.0857142857143,33,2,19,31.32312754034964,0.6663510101010102,41.207107843137265,1035.1715686274524,31.368835412953104,0
3646,4,0,0,35,0.0,0.0,1.0,35,1100,800,300,0.7272727272727273,14,8,6,385.3732965360492,0.40059523809523806,0.20362087326943556,0.24286276875661086,134074.41135921283,3333.739577326031,137408.15093653885,2117,36,397.0857142857143,33,2,19,31.106649114503206,0.6676136363636364,41.08455882352941,1035.6617647058824,31.383689839572195,0
3647,4,0,0,35,0.0,0.0,1.0,35,850,600,250,0.7058823529411765,11,6,5,385.25589522508375,0.4005602240896358,0.20511399165131583,0.2432089680610629,134137.87853529892,3335.481695742022,137473.36023104095,2118,37,398.0857142857143,33,2,19,31.046053669308726,0.6682449494949495,41.02328431372549,1035.906862745098,31.391117052881754,0
3648,4,0,0,35,0.0,0.0,1.0,35,750,400,350,0.5333333333333333,11,4,7,386.63824191918195,0.3999299719887955,0.20746899185508094,0.24429295195700776,134169.6177551903,3375.0210255670886,137544.63878075738,2119,38,399.0857142857143,33,2,19,30.97843230029177,0.6685606060606061,40.99264705882353,1036.0294117647059,31.39483065953654,0
3649,4,0,0,35,0.0,0.0,1.0,35,1100,700,400,0.6363636363636364,15,7,8,388.22351817905513,0.39971988795518204,0.20476584533801678,0.24636029559464584,134328.37017313062,3429.8864919742496,137758.25666510488,2120,39,400.0857142857143,33,2,19,30.778239153564247,0.6701388888888888,40.83946078431373,1036.6421568627457,31.413398692810475,0
3650,4,0,0,35,0.0,0.0,1.0,35,850,700,150,0.8235294117647058,10,7,3,379.70037265428914,0.39877450980392154,0.19665709706395207,0.22108756084701658,131101.73906042756,2956.0598090859803,134057.79886951353,2121,40,401.0857142857143,32,3,21,34.24952739078618,0.6402994791666667,43.9709595959596,1024.116161616162,32.00363005050506,8
3651,4,0,0,35,0.0,0.0,1.0,35,1100,800,300,0.7272727272727273,14,8,6,380.990590874751,0.39842436974789913,0.19023923444976076,0.22242188126486861,131202.5422914264,2997.386822376013,134199.9291138024,2122,41,402.0857142857143,33,2,21,34.1143341307815,0.6388888888888888,43.872549019607845,1024.5098039215688,31.045751633986935,0
3652,4,0,0,35,0.0,0.0,1.0,35,1100,900,200,0.8181818181818182,13,9,4,382.01423874101454,0.39817927170868345,0.1907632374801378,0.223202030056857,131233.93233672148,3026.6461517204953,134260.57848844197,2123,42,403.0857142857143,33,2,21,34.056308057249936,0.6392045454545454,43.841911764705884,1024.6323529411766,31.049465240641716,0
3653,4,0,0,35,0.0,0.0,1.0,35,550,400,150,0.7272727272727273,7,4,3,380.0647762575188,0.3983193277310924,0.18675958188153374,0.22260936895083233,131328.12499999997,2982.672679978854,134310.79767997883,2124,43,404.0857142857143,32,3,21,34.01084010840109,0.642578125,43.75,1024.9999999999998,32.03124999999999,0
3654,4,0,0,35,0.0,0.0,1.0,35,900,700,200,0.7777777777777778,11,7,4,378.5656652672962,0.3976890756302521,0.18950035186488412,0.2221064452290783,131392.8425670849,2948.163771553919,134341.00633863884,2125,44,405.0857142857143,32,3,21,33.98373357963877,0.6432291666666667,43.686868686868685,1025.2525252525247,32.0391414141414,0
3655,4,0,0,35,0.0,0.0,1.0,35,1000,800,200,0.8,12,8,4,374.5170027628507,0.39824929971988793,0.18392750482106623,0.22062504082532172,131548.0392907775,2853.3954789023373,134401.43476967982,2126,45,406.0857142857143,33,2,21,33.9305090988731,0.6423611111111112,43.53553921568627,1025.8578431372543,31.086601307189525,0
3656,4,0,0,35,0.0,0.0,1.0,35,600,300,300,0.5,9,3,6,375.01250407786637,0.3980392156862745,0.1856716316049889,0.22128116255419134,131610.90573637543,2871.147064830838,134482.05280120627,2127,46,407.0857142857143,33,2,19,33.854228870576065,0.6429924242424243,43.474264705882355,1026.1029411764707,31.094028520499112,0
3657,4,0,0,35,0.0,0.0,1.0,35,450,300,150,0.6666666666666666,6,3,3,389.48034788967544,0.39859943977591034,0.17711516958628448,0.21545892234804084,129105.13157139566,3059.1289152237096,132164.26048661937,2128,47,408.0857142857143,32,3,17,36.03242638837123,0.6201171875,45.9280303030303,1016.2878787878778,31.758996212121183,8
3658,4,1,0,36,0.027777777777777776,0.0,1.0,36,1050,800,250,0.7619047619047619,13,8,5,378.9863917698263,0.40375330687830685,0.17775916966464034,0.21171235648347664,129490.37606175386,2615.0539485766717,132105.43001033054,2129,0,397.72222222222223,32,4,16,35.90590497456892,0.6240234375,45.54924242424242,1017.80303030303,31.80634469696969,0
3659,4,0,0,36,0.0,0.0,1.0,36,600,400,200,0.6666666666666666,8,4,4,382.3108046871188,0.40401785714285715,0.17603843769373873,0.2142693981794033,129618.91842987962,2710.9426015202553,132329.86103139987,2130,1,398.72222222222223,32,4,16,35.69022525315149,0.6253255208333333,45.4229797979798,1018.3080808080808,31.822127525252526,0
3660,4,1,0,37,0.02702702702702703,0.0,1.0,37,800,600,200,0.75,10,6,4,372.75448409763317,0.40746996996997,0.16469594594594583,0.2106873170986622,129950.01922337557,2287.89047481737,132237.90969819293,2131,0,388.9189189189189,33,4,18,35.596454326923066,0.6262626262626263,45.09803921568627,1019.6078431372545,30.89720736779559,0
3661,4,0,0,37,0.0,0.0,1.0,37,1150,700,450,0.6086956521739131,16,7,9,372.68996939726964,0.40712587587587584,0.1631651490444821,0.21135541679452025,130080.35891439894,2295.9289965986245,132376.28791099758,2132,1,389.9189189189189,34,3,18,35.46553467927025,0.6253063725490196,44.97023809523809,1020.1190476190463,30.003501400560186,0
3662,4,0,0,37,0.0,0.0,1.0,37,900,600,300,0.6666666666666666,12,6,6,376.3958511025381,0.40712587587587584,0.16564301118664138,0.21395658061345868,130171.45691609976,2399.199263038547,132570.6561791383,2133,2,390.9189189189189,34,3,18,35.278377274848346,0.6262254901960784,44.88095238095238,1020.4761904761904,30.014005602240893,0
3663,4,0,0,37,0.0,0.0,1.0,37,800,600,200,0.75,10,6,4,376.3382746136166,0.4068756256256256,0.1715820477222305,0.21477058247127767,130325.14537677809,2409.299957728182,132734.44533450628,2134,3,391.9189189189189,33,4,19,35.12361977916467,0.630050505050505,44.73039215686274,1021.0784313725484,30.94177064765298,0
3664,4,0,0,37,0.0,0.0,1.0,37,1050,800,250,0.7619047619047619,13,8,5,372.75609228033534,0.4065002502502502,0.1643274360952458,0.21375792967217597,130512.91120001934,2329.896554209934,132842.8077542293,2135,4,392.9189189189189,33,4,15,35.02438634364757,0.6319444444444444,44.54656862745099,1021.813725490197,30.96405228758173,0
3665,4,0,0,37,0.0,0.0,1.0,37,950,600,350,0.631578947368421,13,6,7,373.8237359214941,0.4071571571571571,0.16103455091586016,0.2148906810007708,130606.84479827482,2364.7877318819797,132971.63253015678,2136,5,393.9189189189189,33,4,16,34.9017653758542,0.6328914141414141,44.454656862745104,1022.1813725490206,30.97519310754608,0
3666,4,0,1,36,0.0,0.02702702702702703,0.972972972972973,37,850,700,150,0.8235294117647058,10,7,3,373.1388731340469,0.4071571571571571,0.1639112746495297,0.2150186987175754,130700.81218762031,2353.910755478684,133054.72294309898,2137,6,394.9189189189189,33,4,16,34.82392537551935,0.6338383838383839,44.36274509803923,1022.5490196078445,30.986333927510437,0
3667,4,0,0,36,0.0,0.0,1.0,36,1250,1000,250,0.8,15,10,5,371.67335412866566,0.4059523809523809,0.1475101524532323,0.21434790188000807,130732.14215986655,2517.930753796638,133250.07291366317,2138,7,389.9166666666667,33,3,16,34.82961354104254,0.6341540404040404,44.332107843137265,1022.6715686274522,30.990047534165218,0
3668,4,0,0,36,0.0,0.0,1.0,36,900,600,300,0.6666666666666666,12,6,6,370.3612845651109,0.4068783068783069,0.1481448210697227,0.21428595736896147,130857.49959450704,2492.9103289600325,133350.4099234671,2139,8,390.9166666666667,33,3,16,34.73607118617001,0.6354166666666667,44.20955882352942,1023.1617647058833,31.004901960784345,0
3669,4,0,0,36,0.0,0.0,1.0,36,900,600,300,0.6666666666666666,12,6,6,367.7819156354135,0.4067625661375662,0.14941198382290355,0.2133135110685399,130951.55709342568,2432.322904652069,133383.87999807775,2140,9,391.9166666666667,33,3,18,34.70675686462325,0.6363636363636364,44.117647058823536,1023.5294117647065,31.016042780748684,0
3670,4,1,2,35,0.02702702702702703,0.05405405405405406,0.9459459459459459,37,700,400,300,0.5714285714285714,10,4,6,357.7570272660689,0.4090027527527527,0.14317919220335584,0.2092100876838533,131267.1201814059,1992.3469387755115,133259.4671201814,2141,0,382.2972972972973,34,3,19,34.64412949194548,0.6372549019607843,43.80952380952381,1024.7619047619046,30.14005602240896,0
3671,4,1,0,36,0.027777777777777776,0.0,1.0,36,700,500,200,0.7142857142857143,9,5,4,365.6730993703005,0.4018187830687831,0.15239557576241025,0.21313080645306634,131139.7734645329,2390.857482698968,133530.63094723187,2142,0,393.27777777777777,33,3,20,34.57017229002155,0.6382575757575757,43.93382352941177,1024.2647058823532,31.03832442067737,0
3672,4,0,0,36,0.0,0.0,1.0,36,800,600,200,0.75,10,6,4,368.4166795854635,0.4013723544973545,0.14635423081660326,0.21596931563569524,131360.4817907612,2479.2136703796605,133839.69546114086,2143,1,394.27777777777777,32,4,20,34.27659399761877,0.6429036458333333,43.718434343434346,1025.126262626263,32.03519570707072,0
3673,4,0,0,36,0.0,0.0,1.0,36,700,400,300,0.5714285714285714,10,4,6,370.9681137615567,0.40168650793650795,0.14817323481116573,0.21764892223582682,131392.84256708508,2548.5109937761563,133941.35356086123,2144,2,395.27777777777777,32,4,20,34.17846880131362,0.6432291666666667,43.68686868686869,1025.252525252526,32.03914141414144,0
3674,4,0,0,36,0.0,0.0,1.0,36,750,600,150,0.8,9,6,3,370.9681137615567,0.4010251322751323,0.14817323481116573,0.21764892223582682,131392.84256708508,2548.5109937761563,133941.35356086123,2145,3,396.27777777777777,32,4,20,34.17846880131362,0.6432291666666667,43.68686868686869,1025.252525252526,32.03914141414144,0
3675,4,0,0,36,0.0,0.0,1.0,36,1000,700,300,0.7,13,7,6,370.86599355417945,0.4007771164021164,0.15021754299552637,0.21777315500025243,131425.20732897156,2548.2280188246114,133973.43534779618,2146,4,397.27777777777777,32,4,20,34.14834995690187,0.6435546875,43.65530303030303,1025.378787878788,32.043087121212125,0
3676,4,0,1,35,0.0,0.027777777777777776,0.9722222222222222,36,950,700,250,0.7368421052631579,12,7,5,375.4182318955269,0.3997354497354497,0.10709026082238537,0.21832131254451842,131053.71492346942,2639.9907879818657,133693.7057114513,2147,5,398.27777777777777,34,2,19,34.40782079603147,0.6351102941176471,44.017857142857146,1023.9285714285717,30.115546218487403,8
3677,4,0,0,35,0.0,0.0,1.0,35,750,500,250,0.6666666666666666,10,5,5,383.8023313704664,0.3957282913165266,0.11553761693831155,0.22278671813325296,130982.91710219647,3054.3097907055244,134037.226892902,2148,6,410.48571428571427,33,2,19,34.26500957739734,0.6366792929292929,44.08700980392158,1023.6519607843153,31.019756387403493,0
3678,4,0,0,35,0.0,0.0,1.0,35,850,600,250,0.7058823529411765,11,6,5,383.8023313704664,0.3957282913165266,0.11553761693831155,0.22278671813325296,130982.91710219647,3054.3097907055244,134037.226892902,2149,7,411.48571428571427,33,2,19,34.26500957739734,0.6366792929292929,44.08700980392158,1023.6519607843153,31.019756387403493,0
3679,4,0,0,35,0.0,0.0,1.0,35,1150,1000,150,0.8695652173913043,13,10,3,384.20718320576555,0.39481792717086833,0.12012443168222098,0.22393330803582906,131139.7734645329,3076.968593810079,134216.74205834296,2150,8,412.48571428571427,33,2,19,34.09557709180825,0.6382575757575757,43.93382352941177,1024.2647058823532,31.03832442067737,0
3680,4,0,0,35,0.0,0.0,1.0,35,950,800,150,0.8421052631578947,11,8,3,386.3137068820996,0.3940826330532213,0.12022485348642498,0.2257141092411769,131233.93233672171,3139.4933739427447,134373.42571066445,2151,9,413.48571428571427,33,2,20,33.946173703305014,0.6392045454545454,43.8419117647059,1024.6323529411786,31.049465240641776,0
3681,4,0,0,35,0.0,0.0,1.0,35,800,100,700,0.125,15,1,14,387.9965628924577,0.3940126050420168,0.12497096399535423,0.22725512969415412,131328.12500000026,3190.9722222222495,134519.0972222225,2152,10,414.48571428571427,33,2,22,33.80758807588075,0.6401515151515151,43.750000000000014,1025.000000000002,31.060606060606123,0
3682,4,2,1,36,0.05405405405405406,0.02702702702702703,0.972972972972973,37,1000,800,200,0.8,12,8,4,369.0202387172958,0.4017767767767768,0.11633134148347146,0.21918912974412866,131862.52170138882,2331.9878472222163,134194.50954861104,2153,0,393.02702702702703,33,4,16,33.7538032454361,0.6455176767676767,43.229166666666664,1027.0833333333328,31.123737373737356,0
3683,4,0,0,36,0.0,0.0,1.0,36,850,500,350,0.5882352941176471,12,5,7,375.55279097229715,0.39814814814814814,0.11829679147931516,0.2223325604222567,131736.6836823577,2694.815846068819,134431.4995284265,2154,1,404.94444444444446,33,3,16,33.7132177390474,0.6442550505050505,43.35171568627451,1026.5931372549016,31.108882947118232,0
3684,4,0,0,36,0.0,0.0,1.0,36,700,500,200,0.7142857142857143,9,5,4,373.4393771134156,0.39842923280423276,0.11766929259170866,0.2212641514466899,131768.1375552672,2641.482242406766,134409.61979767395,2155,2,405.94444444444446,33,3,16,33.7356767724994,0.6445707070707071,43.32107843137255,1026.7156862745096,31.112596553773017,0
3685,4,0,0,36,0.0,0.0,1.0,36,900,700,200,0.7777777777777778,11,7,4,373.95146206379457,0.3983134920634921,0.12042341302992932,0.22175083514738386,131799.59518274217,2657.3302636005355,134456.9254463427,2156,3,406.94444444444446,33,3,16,33.69074969168956,0.6448863636363636,43.29044117647059,1026.8382352941173,31.116310160427798,0
3686,4,0,0,36,0.0,0.0,1.0,36,800,500,300,0.625,11,5,6,379.1875905704829,0.3979166666666667,0.11385807255424396,0.22560181488661152,131925.46323829767,2804.8997080449753,134730.36294634265,2157,4,407.94444444444446,33,3,16,33.429137341444985,0.6461489898989898,43.16789215686274,1027.3284313725483,31.131164587046918,0
3687,4,0,0,36,0.0,0.0,1.0,36,950,800,150,0.8421052631578947,11,8,3,379.64784795466477,0.3975694444444444,0.11638570822731142,0.22606303673664127,131956.93963860045,2819.4336312956457,134776.3732698961,2158,5,408.94444444444446,33,3,16,33.38551606234097,0.6464646464646464,43.13725490196078,1027.4509803921562,31.134878193701702,0
3688,4,0,0,36,0.0,0.0,1.0,36,1100,800,300,0.7272727272727273,14,8,6,380.5349280113866,0.3969080687830688,0.11165804442385374,0.22721566863418483,132061.28826530612,2850.786564625848,134912.07482993198,2159,6,409.94444444444446,34,2,17,33.257325689135975,0.6452205882352942,43.035714285714285,1027.857142857143,30.23109243697479,0
3689,4,0,0,36,0.0,0.0,1.0,36,900,700,200,0.7777777777777778,11,7,4,379.99675298600425,0.39727182539682543,0.107589440778048,0.2274450419639722,132153.0771683673,2843.548044217682,134996.625212585,2160,7,410.94444444444446,34,2,17,33.17847632279726,0.6461397058823529,42.94642857142857,1028.2142857142853,30.24159663865545,0
3690,4,0,1,35,0.0,0.027777777777777776,0.9722222222222222,36,450,200,250,0.4444444444444444,7,2,5,379.3724279835391,0.39685846560846566,0.09992283950617309,0.22762345679012352,132244.8979591837,2834.013605442184,135078.9115646259,2161,8,411.94444444444446,34,2,17,33.10185185185185,0.6470588235294117,42.85714285714286,1028.571428571429,30.252100840336144,0
3691,4,0,0,35,0.0,0.0,1.0,35,1050,800,250,0.7619047619047619,13,8,5,388.3141794193611,0.3962535014005602,0.10843258694616509,0.2335448316908993,132334.9492983467,3277.507449058047,135612.45674740477,2162,9,422.1142857142857,33,2,18,32.780986977926,0.6502525252525253,42.76960784313725,1028.9215686274504,31.179441473559102,0
3692,4,0,0,35,0.0,0.0,1.0,35,1050,600,450,0.5714285714285714,15,6,9,385.264415710766,0.3947128851540616,0.10259322869726417,0.23268198104860846,132492.61289227701,3208.9378183871595,135701.5507106642,2163,10,423.1142857142857,33,2,19,32.70034817283657,0.6518308080808081,42.61642156862745,1029.5343137254902,31.198009506833035,0
3693,4,0,0,35,0.0,0.0,1.0,35,650,600,50,0.9230769230769231,7,6,1,386.3960884427329,0.39516806722689074,0.10154348269531521,0.233953366518208,132587.25610342177,3246.2394271434036,135833.49553056518,2164,11,424.1142857142857,33,2,19,32.575757575757564,0.6527777777777778,42.52450980392157,1029.9019607843136,31.20915032679738,0
3694,4,0,0,35,0.0,0.0,1.0,35,650,300,350,0.46153846153846156,10,3,7,382.5301263204156,0.3942577030812325,0.09333038794202109,0.23219716765167756,132681.93310565644,3150.9673262687365,135832.90043192517,2165,12,425.1142857142857,33,2,16,32.57986895840767,0.6537247474747474,42.432598039215684,1030.269607843137,31.220291146761728,0
3695,4,0,0,35,0.0,0.0,1.0,35,450,300,150,0.6666666666666666,6,3,3,384.26584295651503,0.39373249299719887,0.09502064114978848,0.2336436350991564,132745.06987997398,3201.879235149933,135946.94911512392,2166,13,426.1142857142857,33,2,17,32.47153347603758,0.6543560606060606,42.37132352941176,1030.5147058823525,31.227718360071286,0
3696,4,0,0,35,0.0,0.0,1.0,35,650,400,250,0.6153846153846154,9,4,5,385.8118590180593,0.39373249299719887,0.08612186672101063,0.2351774897144864,132839.80320069197,3250.234284890416,136090.03748558238,2167,14,427.1142857142857,33,2,17,32.33624583927721,0.6553030303030303,42.27941176470588,1030.882352941176,31.238859180035632,0
3697,4,0,0,35,0.0,0.0,1.0,35,1100,800,300,0.7272727272727273,14,8,6,385.96061626364667,0.3931372549019608,0.0910822510822511,0.23586482105000617,132934.57031249988,3261.5017361110963,136196.07204861098,2168,15,428.1142857142857,33,2,17,32.236952861952865,0.65625,42.18749999999999,1031.249999999999,31.24999999999997,0
3698,4,0,0,35,0.0,0.0,1.0,35,950,700,250,0.7368421052631579,12,7,5,388.3040115703145,0.39296218487394957,0.0918847367885145,0.2378997939882756,133029.37121539787,3331.1676999231026,136360.53891532097,2169,16,429.1142857142857,33,2,17,32.081056466302364,0.6571969696969697,42.095588235294116,1031.6176470588232,31.26114081996434,0
3699,4,0,0,35,0.0,0.0,1.0,35,800,400,400,0.5,12,4,8,387.2948071855862,0.39215686274509803,0.09037949344326313,0.2378854537789803,133124.20590938572,3311.662731881961,136435.86864126768,2170,17,430.1142857142857,33,2,19,32.01161283299688,0.6581439393939394,42.00367647058823,1031.9852941176464,31.27228163992868,0
3700,4,0,1,34,0.0,0.02857142857142857,0.9714285714285714,35,1150,900,250,0.782608695652174,14,9,5,386.2869716664295,0.39156162464985994,0.08756569800956249,0.23827628281561727,133282.33882400987,3297.046208189146,136579.38503219903,2171,18,431.1142857142857,33,2,19,31.878510958145426,0.6597222222222222,41.850490196078425,1032.5980392156855,31.29084967320259,0
3701,4,0,0,34,0.0,0.0,1.0,34,850,600,250,0.7058823529411765,11,6,5,394.54582351196495,0.3909870766488413,0.08752319709982315,0.2433330124193703,133276.58689164367,3716.744146005501,136993.3310376492,2172,19,443.94117647058823,32,2,19,31.671099290780134,0.662109375,41.8560606060606,1032.5757575757573,32.267992424242415,0
3702,4,0,0,34,0.0,0.0,1.0,34,750,400,350,0.5333333333333333,11,4,7,394.11917671463004,0.39065285204991085,0.08546670501941622,0.24349659105178786,133341.78272625234,3710.51072594632,137052.29345219865,2173,20,444.94117647058823,32,2,19,31.6164934800326,0.6627604166666667,41.79292929292929,1032.828282828282,32.27588383838381,0
3703,4,0,0,34,0.0,0.0,1.0,34,1200,900,300,0.75,15,9,6,392.9158445087742,0.38979872251931075,0.0861793819324137,0.2433936681010826,133439.60636988573,3686.1071255484185,137125.71349543415,2174,21,445.94117647058823,32,2,19,31.549146604749684,0.6637369791666667,41.698232323232325,1033.207070707071,32.287720959595966,0
3704,4,0,0,34,0.0,0.0,1.0,34,1100,600,500,0.5454545454545454,16,6,10,377.1495198902606,0.38933452168746285,0.05673202614379114,0.21758626147515034,130746.3842975207,3080.0784039893924,133826.46270151009,2175,22,446.94117647058823,32,2,19,34.67515432098765,0.63671875,44.31818181818182,1022.727272727273,31.96022727272728,8
3705,4,0,0,34,0.0,0.0,1.0,34,700,500,200,0.7142857142857143,9,5,4,376.10132739790447,0.38918597742127153,0.06295054119389332,0.2175266992080814,130843.25140610657,3042.0641069788853,133885.31551308546,2176,23,447.94117647058823,32,2,20,34.60369616191533,0.6376953125,44.22348484848485,1023.106060606061,31.972064393939405,0
3706,4,0,0,34,0.0,0.0,1.0,34,1350,1000,350,0.7407407407407407,17,10,7,373.7478622598025,0.38859180035650626,0.06237322515213006,0.2167737601106854,130951.55709342558,2988.572904652055,133940.12999807764,2177,24,448.94117647058823,33,1,20,34.55409881864624,0.6363636363636364,44.11764705882353,1023.5294117647057,31.01604278074866,0
3707,4,1,0,35,0.02857142857142857,0.0,1.0,35,750,500,250,0.6666666666666666,10,5,5,366.48466183681205,0.39303221288515405,0.06200989342983321,0.21397333784040742,131206.12953514743,2617.006802721092,133823.13633786852,2178,0,437.0857142857143,34,1,21,34.48224107212023,0.6366421568627452,43.86904761904762,1024.5238095238096,30.13305322128852,0
3708,4,0,0,35,0.0,0.0,1.0,35,600,300,300,0.5,9,3,6,368.4975874148985,0.39278711484593837,0.06318234610917539,0.21583430120015495,131328.12500000012,2678.81944444446,134006.94444444458,2179,1,438.0857142857143,34,1,21,34.30724932249323,0.6378676470588236,43.75000000000001,1025.000000000001,30.147058823529438,0
3709,4,0,0,35,0.0,0.0,1.0,35,700,300,400,0.42857142857142855,11,3,8,371.75319061297125,0.3925770308123249,0.06257918011234631,0.2182778207620163,131422.35145436856,2771.3356942041637,134193.68714857273,2180,2,439.0857142857143,33,2,21,34.128495876658306,0.6410984848484849,43.65808823529412,1025.367647058824,31.071746880570426,0
3710,4,0,0,35,0.0,0.0,1.0,35,700,500,200,0.7142857142857143,9,5,4,371.61393096183235,0.3917016806722689,0.06685099846390141,0.21873478214842032,131516.61169982696,2774.68101211072,134291.29271193768,2181,3,440.0857142857143,33,2,21,34.03673835125446,0.6420454545454546,43.56617647058823,1025.7352941176468,31.08288770053475,0
3711,4,0,0,35,0.0,0.0,1.0,35,1200,1100,100,0.9166666666666666,13,11,2,370.2813325976588,0.3911764705882353,0.06737495523457082,0.21921178255622525,131736.68368235772,2755.926957179931,134492.61063953766,2182,4,441.0857142857143,33,2,16,33.84850881381561,0.6442550505050505,43.35171568627451,1026.5931372549019,31.10888294711824,0
3712,4,0,0,35,0.0,0.0,1.0,35,650,500,150,0.7692307692307693,8,5,3,370.17333006761186,0.3905812324929972,0.06746675758608967,0.21969210382199636,131831.05656478283,2760.068242983479,134591.12480776632,2183,5,442.0857142857143,33,2,17,33.755966587112184,0.6452020202020202,43.25980392156863,1026.960784313726,31.120023767082607,0
3713,4,0,1,34,0.0,0.02857142857142857,0.9714285714285714,35,500,200,300,0.4,8,2,6,369.64674436339396,0.3903361344537815,0.06825377890628981,0.21992538381819243,131925.46323829782,2753.163596933879,134678.6268352317,2184,6,443.0857142857143,33,2,17,33.67417690564237,0.6461489898989898,43.16789215686275,1027.3284313725494,31.131164587046953,0
3714,4,0,0,34,0.0,0.0,1.0,34,700,400,300,0.5714285714285714,10,4,6,376.58593314650744,0.38515671420083186,0.07367508406871504,0.22331305971936205,131799.5951827422,3126.7747080449817,134926.36989078717,2185,32,456.94117647058823,33,1,17,33.62312030075188,0.6448863636363636,43.29044117647059,1026.8382352941176,31.116310160427805,0
3715,4,0,0,34,0.0,0.0,1.0,34,900,700,200,0.7777777777777778,11,7,4,410.78067292751086,0.3850638740344623,0.07430935479495426,0.22741517254412408,129135.20812988281,3839.023243670554,132974.23137355337,2186,33,457.94117647058823,31,3,18,35.46043641643181,0.622983870967742,45.8984375,1016.40625,32.787298387096776,8
3716,4,0,0,34,0.0,0.0,1.0,34,700,500,200,0.7142857142857143,9,5,4,408.1775720087021,0.3855837789661319,0.06744746554191461,0.22673306098065188,129267.5866021051,3752.825927734384,133020.4125298395,2187,34,458.94117647058823,31,3,19,35.391058472044406,0.6243279569892473,45.76822916666667,1016.9270833333339,32.80409946236561,0
3717,4,1,0,35,0.02857142857142857,0.0,1.0,35,900,600,300,0.6666666666666666,12,6,6,400.3072446025786,0.39061624649859944,0.06823566912819445,0.22472362854620737,129683.21352731861,3382.625975665748,133065.83950298437,2188,0,446.8,32,3,17,35.16641874302716,0.6259765625,45.359848484848484,1018.5606060606059,31.830018939393934,0
3718,4,0,0,35,0.0,0.0,1.0,35,700,100,600,0.14285714285714285,13,1,12,398.5075065397112,0.3908613445378151,0.07003877272807779,0.22408063207449,129747.52456700857,3341.072498979708,133088.5970659883,2189,1,447.8,32,3,17,35.14660015697939,0.6266276041666667,45.29671717171718,1018.8131313131321,31.837910353535378,0
3719,4,0,0,35,0.0,0.0,1.0,35,1150,900,250,0.782608695652174,14,9,5,398.40702753513705,0.3916316526610644,0.07169049978762576,0.2245769222251137,129844.02101826355,3346.1540914192556,133190.1751096828,2190,2,448.8,32,3,18,35.05068962669309,0.6276041666666667,45.20202020202021,1019.1919191919201,31.849747474747502,0
3720,4,2,0,37,0.05405405405405406,0.0,1.0,37,1150,600,550,0.5217391304347826,17,6,11,383.4015988046978,0.40193318318318316,0.07638116425658148,0.21954015116269013,130455.99819214884,2604.7547762983504,133060.7529684472,2191,0,425.4864864864865,32,5,21,34.810283030527756,0.6337890625,44.602272727272734,1021.5909090909098,31.92471590909093,0
3721,4,0,1,36,0.0,0.02702702702702703,0.972972972972973,37,1000,800,200,0.8,12,8,4,383.27770557655924,0.4014014014014014,0.07270857814336118,0.22038468070652184,130617.2839506175,2612.53858024694,133229.82253086445,2192,1,426.4864864864865,32,5,16,34.64956974637682,0.6354166666666667,44.44444444444446,1022.2222222222239,31.944444444444496,0
3722,4,0,0,36,0.0,0.0,1.0,36,600,200,400,0.3333333333333333,10,2,8,392.5625647785638,0.3965443121693122,0.07255643356841457,0.22482086739070184,130462.04460991769,3042.902967664955,133504.94757758264,2193,2,439.30555555555554,31,5,20,34.57016314045375,0.6364247311827957,44.59635416666668,1021.6145833333346,32.95530913978499,0
3723,4,0,0,36,0.0,0.0,1.0,36,650,500,150,0.7692307692307693,8,5,3,391.1110279822225,0.3966435185185185,0.06708007701891527,0.22437422131611748,130528.56445312523,3010.2322048611395,133538.7966579864,2194,3,440.30555555555554,31,5,17,34.53958545701665,0.6370967741935484,44.531250000000014,1021.8750000000018,32.963709677419416,0
3724,4,1,0,37,0.02702702702702703,0.0,1.0,37,700,500,200,0.7142857142857143,9,5,4,380.81659794829113,0.4003065565565565,0.07687895200234829,0.2204384078409253,130875.54841342737,2567.9162202836696,133443.46463371103,2195,0,429.3783783783784,32,5,18,34.45032288581772,0.6380208333333333,44.191919191919204,1023.2323232323246,31.976010101010143,0
3725,4,0,0,37,0.0,0.0,1.0,37,900,700,200,0.7777777777777778,11,7,4,385.3046769451086,0.3999624624624625,0.07588101174682316,0.22378583958960918,131004.77629833703,2695.3506019794077,133700.12690031645,2196,1,430.3783783783784,32,5,19,34.20438661404375,0.6393229166666667,44.065656565656575,1023.7373737373748,31.991792929292963,0
3726,4,1,1,37,0.02631578947368421,0.02631578947368421,0.9736842105263158,38,850,600,250,0.7058823529411765,11,6,5,375.7530922137772,0.4039977477477477,0.07838089603343468,0.2197235914050075,131265.3261365822,2264.67043925415,133529.99657583635,2197,0,420.0263157894737,33,5,20,34.18490393047916,0.639520202020202,43.81127450980393,1024.7549019607852,31.053178847296522,0
3727,4,0,0,37,0.0,0.0,1.0,37,1300,1000,300,0.7692307692307693,16,10,6,383.4842683251982,0.3997747747747748,0.08035988603177824,0.22332947946994317,131108.3946829346,2655.601361255309,133763.9960441899,2198,1,432.13513513513516,33,4,20,34.14590064217624,0.6379419191919191,43.96446078431374,1024.1421568627463,31.034610814022617,0
3728,4,0,0,37,0.0,0.0,1.0,37,800,400,400,0.5,12,4,8,377.48163984808224,0.3996496496496496,0.01939738781844058,0.20839835437650736,129024.94454089513,2340.9095293209994,131365.85407021613,2199,2,433.13513513513516,35,2,17,36.41917293233083,0.6125,46.00694444444445,1015.9722222222229,29.027777777777796,8
3729,4,0,0,37,0.0,0.0,1.0,37,1000,800,200,0.8,12,8,4,377.21888118056637,0.40036911911911915,0.02090746783229691,0.20856308417917996,129083.74592764078,2338.5652434842436,131422.311171125,2200,3,434.13513513513516,35,2,17,36.3657934700076,0.6130952380952381,45.94907407407408,1016.2037037037051,29.034391534391574,0
3730,4,0,1,36,0.0,0.02702702702702703,0.972972972972973,37,550,400,150,0.7272727272727273,7,4,3,377.590111157265,0.4003065565565565,0.02618377885970724,0.2090792153961604,129142.5607103053,2352.5907707476113,131495.15148105292,2201,4,435.13513513513516,35,2,17,36.29630683974797,0.6136904761904762,45.89120370370371,1016.4351851851859,29.041005291005312,0
3731,4,0,1,35,0.0,0.027777777777777776,0.9722222222222222,36,1000,800,200,0.8,12,8,4,384.110312564594,0.3957506613756614,0.03669868040915136,0.2126805349336256,129140.88010204096,2720.868764172357,131861.7488662133,2202,7,448.1111111111111,34,2,18,36.13233973608184,0.6158088235294117,45.89285714285715,1016.4285714285727,29.894957983193315,0
3732,4,0,0,35,0.0,0.0,1.0,35,700,500,200,0.7142857142857143,9,5,4,386.99274388605176,0.3946078431372549,0.0353629976580796,0.21460506706408353,129201.38888888907,3000.0000000000196,132201.38888888908,2203,8,450.48571428571427,34,1,18,35.99726775956283,0.616421568627451,45.83333333333334,1016.6666666666681,29.90196078431377,0
3733,4,1,1,35,0.027777777777777776,0.027777777777777776,0.9722222222222222,36,1000,600,400,0.6,14,6,8,379.64361977303474,0.3976025132275132,0.0359769487649273,0.2123173703518131,129534.44054705222,2635.3847789115775,132169.8253259638,2204,0,438.94444444444446,34,2,16,35.84424823607377,0.6197916666666667,45.50595238095239,1017.9761904761909,29.940476190476204,0
3734,4,0,0,35,0.0,0.0,1.0,35,1100,1000,100,0.9090909090909091,12,10,2,391.5727979939903,0.39450280112044817,0.043233761543620686,0.2190434500293655,129544.24267409163,3145.2003135813056,132689.44298767293,2205,10,452.48571428571427,33,2,17,35.53065185987721,0.6221590909090908,45.49632352941176,1018.0147058823525,30.848930481283407,0
3735,4,0,0,35,0.0,0.0,1.0,35,450,200,250,0.4444444444444444,7,2,5,388.5798012970074,0.3944677871148459,0.04133738601823733,0.21781858586465253,129625.34722222204,3073.958333333312,132699.30555555536,2206,11,453.48571428571427,34,1,17,35.52407255864702,0.6207107843137255,45.41666666666666,1018.3333333333319,29.950980392156822,0
3736,4,0,0,35,0.0,0.0,1.0,35,950,700,250,0.7368421052631579,12,7,5,391.2089361758998,0.3949579831932773,0.04798958489810223,0.2201418333155504,129776.92920918351,3153.9788832199315,132930.90809240344,2207,12,454.48571428571427,34,1,18,35.30250808116211,0.6222426470588236,45.26785714285713,1018.9285714285701,29.968487394957943,0
3737,4,0,0,35,0.0,0.0,1.0,35,550,400,150,0.7272727272727273,7,4,3,391.7399039708692,0.39474789915966385,0.046487784302909896,0.22084901372391008,129849.38298396781,3173.436964163238,133022.81994813104,2208,13,455.48571428571427,35,0,19,35.21509955333483,0.6208333333333333,45.19675925925926,1019.2129629629634,29.12037037037038,0
3738,4,1,0,36,0.027777777777777776,0.0,1.0,36,800,500,300,0.625,11,5,6,383.5170484725327,0.3982804232804233,0.049460387539858264,0.21771080571185156,130118.92804967143,2780.5654472039814,132899.49349687542,2209,0,443.80555555555554,36,0,20,35.15015636497427,0.6215277777777778,44.93243243243244,1020.2702702702715,28.340840840840873,0
3739,4,0,0,36,0.0,0.0,1.0,36,1100,900,200,0.8181818181818182,13,9,4,385.3394418992085,0.398859126984127,0.055215419501133844,0.21955386805885155,130262.58680555563,2839.062500000009,133101.64930555565,2210,1,444.80555555555554,36,0,20,34.95748299319728,0.622974537037037,44.79166666666667,1020.833333333334,28.356481481481502,0
3740,4,1,0,37,0.02702702702702703,0.0,1.0,37,750,600,150,0.8,9,6,3,375.3510231001198,0.4031844344344344,0.06352177024274797,0.21682041452018705,130794.8133680557,2418.793402777797,133213.6067708335,2211,0,433.7567567567568,33,4,18,34.6720128988459,0.6347853535353536,44.27083333333334,1022.9166666666678,30.99747474747478,0
3741,4,0,1,36,0.0,0.02702702702702703,0.972972972972973,37,1300,900,400,0.6923076923076923,17,9,8,377.3937185302623,0.40330955955955955,0.06250647198923054,0.21888835674755228,130951.5570934257,2484.059015763182,133435.61610918888,2212,1,434.7567567567568,33,4,19,34.46080779054918,0.6363636363636364,44.117647058823536,1023.5294117647067,31.016042780748688,0
3742,4,0,0,36,0.0,0.0,1.0,36,1250,900,350,0.72,16,9,7,386.5138350330202,0.3993882275132275,0.06566248543423159,0.22392384795872966,130907.84940631059,2919.538981991637,133827.38838830224,2213,2,447.75,32,4,20,34.27179724449929,0.6383463541666667,44.160353535353536,1023.3585858585859,31.97995580808081,0
3743,4,0,0,36,0.0,0.0,1.0,36,1300,900,400,0.6923076923076923,17,9,8,384.66049903582,0.40011574074074074,0.06263616557734175,0.2235994255685638,131037.09323347107,2880.9587350780494,133918.05196854912,2214,3,448.75,32,4,20,34.18809347638426,0.6396484375,44.03409090909091,1023.8636363636363,31.995738636363633,0
3744,4,0,0,36,0.0,0.0,1.0,36,750,600,150,0.8,9,6,3,384.65367984314304,0.3998346560846561,0.06291091387245284,0.22416024790859,131134.0679522496,2888.2403581267045,134022.3083103763,2215,4,449.75,32,4,20,34.08992850098619,0.640625,43.93939393939393,1024.2424242424229,32.007575757575715,0
3745,4,1,0,37,0.02702702702702703,0.0,1.0,37,1150,700,450,0.6086956521739131,16,7,9,373.6978071794947,0.40221471471471476,0.06207689525089144,0.21959994736502889,131453.76778162242,2424.7969530949595,133878.56473471737,2216,0,438.56756756756755,33,4,21,34.04686504142766,0.6414141414141414,43.627450980392155,1025.4901960784312,31.075460487225186,0
3746,4,0,0,37,0.0,0.0,1.0,37,900,600,300,0.6666666666666666,12,6,6,377.65075217956786,0.40233983983983984,0.07335676773154343,0.22283789626494166,131610.9057363754,2540.59150927527,134151.49724565068,2217,1,439.56756756756755,33,4,18,33.78655101715832,0.6429924242424243,43.47426470588235,1026.1029411764703,31.094028520499098,0
3747,4,0,0,37,0.0,0.0,1.0,37,1250,1100,150,0.88,14,11,3,378.3801896553978,0.4025588088088088,0.08199079958449773,0.22419160034886262,131768.13755526696,2571.6905757400705,134339.82813100703,2218,2,440.56756756756755,33,4,19,33.60885652900454,0.6445707070707071,43.321078431372534,1026.7156862745078,31.112596553772963,0
3748,4,0,1,36,0.0,0.02702702702702703,0.972972972972973,37,850,500,350,0.5882352941176471,12,5,7,373.7810414096498,0.40274649649649646,0.07661204511598241,0.22220089993586367,131893.99059256027,2459.8946318723233,134353.8852244326,2219,3,441.56756756756755,33,4,19,33.599777300564696,0.6458333333333333,43.19852941176469,1027.205882352939,31.12745098039209,0
3749,4,0,0,36,0.0,0.0,1.0,36,900,600,300,0.6666666666666666,12,6,6,383.0133116124884,0.39892526455026456,0.07499337045876464,0.22731243281251043,131831.05656478248,2898.609909650103,134729.6664744326,2220,4,454.1666666666667,33,3,19,33.42631264916467,0.6452020202020202,43.25980392156861,1026.9607843137233,31.12002376708252,0
3750,4,0,0,36,0.0,0.0,1.0,36,800,700,100,0.875,9,7,2,381.6213452741682,0.39809854497354497,0.07319497455470692,0.22723816468598176,131956.9396386004,2871.5169646289673,134828.45660322937,2221,5,455.1666666666667,33,3,20,33.33482426844782,0.6464646464646464,43.13725490196077,1027.4509803921558,31.13487819370169,0
3751,4,0,0,36,0.0,0.0,1.0,36,1100,800,300,0.7272727272727273,14,8,6,383.6873031369156,0.39823082010582006,0.07117310443490688,0.22922856828436206,132082.88278546694,2935.705017301012,135018.58780276796,2222,6,456.1666666666667,33,3,20,33.154506437768234,0.6477272727272727,43.01470588235293,1027.9411764705867,31.14973262032081,0
3752,4,0,0,36,0.0,0.0,1.0,36,600,400,200,0.6666666666666666,8,4,4,384.60524845033785,0.39785052910052915,0.0720792288952441,0.23054337464251662,132208.8860053824,2969.6462898884874,135178.53229527088,2223,7,457.1666666666667,33,3,20,33.00365427391166,0.648989898989899,42.89215686274509,1028.4313725490185,31.164587046939957,0
3753,4,0,0,36,0.0,0.0,1.0,36,1050,700,350,0.6666666666666666,14,7,7,385.98828973961645,0.39758597883597885,0.0732070526566595,0.23175863405395827,132271.9101427333,3011.081675317154,135282.99181805048,2224,8,458.1666666666667,33,3,20,32.90445556349772,0.6496212121212122,42.83088235294116,1028.6764705882333,31.172014260249494,0
3754,4,0,0,36,0.0,0.0,1.0,36,900,500,400,0.5555555555555556,13,5,8,387.33004461845775,0.39700727513227513,0.0694990274304319,0.2331476978251748,132366.47450800164,3053.902495434442,135420.3770034361,2225,9,459.1666666666667,33,3,20,32.77447798817039,0.6505681818181819,42.73897058823529,1029.044117647058,31.183155080213883,0
3755,4,0,0,36,0.0,0.0,1.0,36,950,800,150,0.8421052631578947,11,8,3,386.8969943979021,0.3976686507936508,0.06430596445316761,0.23328286230264014,132430.49178655227,3047.39560233617,135477.88738888846,2226,10,460.1666666666667,32,4,20,32.7210091593065,0.6536458333333333,42.67676767676767,1029.2929292929284,32.16540404040401,0
3756,4,0,0,36,0.0,0.0,1.0,36,1100,800,300,0.7272727272727273,14,8,6,387.2055864287913,0.39727182539682543,0.05873356495674109,0.2340742444274866,132527.98064291908,3063.1148926129977,135591.09553553208,2227,11,461.1666666666667,32,4,21,32.614704680155306,0.6546223958333333,42.582070707070706,1029.671717171717,32.17724116161616,0
3757,4,0,0,36,0.0,0.0,1.0,36,800,600,200,0.75,10,6,4,387.90546845844295,0.3974041005291005,0.056669118548486,0.23490311107761852,132592.99314164382,3086.709423783297,135679.7025654271,2228,12,462.1666666666667,32,4,22,32.53110825058233,0.6552734375,42.5189393939394,1029.9242424242432,32.1851325757576,0
3758,4,0,0,36,0.0,0.0,1.0,36,700,400,300,0.5714285714285714,10,4,6,389.3679714532873,0.3968915343915344,0.055596405228758305,0.23640198266806725,132690.54178145083,3133.0894168962313,135823.63119834705,2229,13,463.1666666666667,32,4,17,32.39506740196079,0.65625,42.42424242424242,1030.30303030303,32.19696969696969,0
3759,4,0,0,36,0.0,0.0,1.0,36,750,500,250,0.6666666666666666,10,5,5,387.6751839931415,0.3960978835978836,0.06117100928421704,0.2357827758384517,132755.59413580256,3093.209876543218,135848.8040123458,2230,14,464.1666666666667,32,4,18,32.37309074573226,0.6569010416666667,42.361111111111114,1030.555555555556,32.20486111111113,0
3760,4,0,0,36,0.0,0.0,1.0,36,500,300,200,0.6,7,3,4,387.6761032126357,0.3959490740740741,0.06818058107096725,0.2363984602487805,132853.20255905014,3100.8023734823073,135954.00493253244,2231,15,465.1666666666667,32,4,18,32.27469891814657,0.6578776041666667,42.266414141414145,1030.9343434343439,32.216698232323246,0
3761,4,0,0,36,0.0,0.0,1.0,36,900,500,400,0.5555555555555556,13,5,8,387.11162913987346,0.3956018518518518,0.06827087925544939,0.23625960863648796,132885.74667125818,3088.323576675864,135974.07024793405,2232,16,466.1666666666667,32,4,18,32.25645971099681,0.658203125,42.23484848484849,1031.0606060606071,32.22064393939397,0
3762,4,0,0,36,0.0,0.0,1.0,36,850,600,250,0.7058823529411765,11,6,5,388.16991134722866,0.39527116402116397,0.06611634899255847,0.2371117177242197,132918.2947690287,3118.9765393837415,136037.27130841243,2233,17,467.1666666666667,32,4,18,32.19638994326762,0.6585286458333333,42.20328282828283,1031.186868686869,32.22458964646466,0
3763,4,0,0,36,0.0,0.0,1.0,36,1100,700,400,0.6363636363636364,15,7,8,387.75630119824643,0.39370039682539687,0.06297927883831012,0.2378937307351405,133081.09504132243,3120.606634527108,136201.70167584953,2234,18,468.1666666666667,32,4,18,32.04310450318161,0.66015625,42.045454545454554,1031.818181818183,32.244318181818215,0
3764,4,0,0,36,0.0,0.0,1.0,36,950,600,350,0.631578947368421,13,6,7,384.944623973091,0.3926421957671958,0.06277283217936036,0.23724641236088467,133250.70473195412,3058.8284854382987,136309.53321739243,2235,19,469.1666666666667,33,3,18,31.944980217606318,0.6594065656565656,41.881127450980394,1032.475490196079,31.287136066547845,0
3765,4,0,0,36,0.0,0.0,1.0,36,900,700,200,0.7777777777777778,11,7,4,384.71898190690433,0.3922453703703704,0.06168848288316808,0.23791608939789408,133377.26362757114,3062.55301446559,136439.81664203672,2236,20,470.1666666666667,33,3,19,31.82354075216514,0.6606691919191919,41.75857843137255,1032.9656862745098,31.301990493166965,0
3766,4,0,0,36,0.0,0.0,1.0,36,1150,800,350,0.6956521739130435,15,8,7,382.9609193926792,0.39188161375661373,0.06191882169279905,0.23764481616596503,133504.8420601214,3025.4612028336664,136530.30326295504,2237,21,471.1666666666667,32,4,19,31.740735084504184,0.6643880208333333,41.63510101010101,1033.4595959595958,32.29561237373737,0
3767,4,0,0,36,0.0,0.0,1.0,36,1000,600,400,0.6,14,6,8,385.7479495434592,0.3919146825396826,-0.031113849677596006,0.2387785157853616,133412.42953746562,3092.71422753771,136505.14376500333,2238,22,472.1666666666667,35,1,18,31.761614011501972,0.656547619047619,41.72453703703703,1033.101851851851,29.517195767195744,8
3768,4,0,0,36,0.0,0.0,1.0,36,1150,900,250,0.782608695652174,14,9,5,384.57320745648497,0.39226190476190476,-0.028101390289135164,0.23824323545898973,133442.32420535412,3063.6685260202385,136505.99273137437,2239,23,473.1666666666667,35,1,18,31.76190676225682,0.6568452380952381,41.695601851851855,1033.2175925925928,29.520502645502653,0
3769,4,0,0,36,0.0,0.0,1.0,36,600,400,200,0.6666666666666666,8,4,4,386.84792420437486,0.39226190476190476,-0.030945794638740365,0.2404614768359543,133567.2146079632,3134.0466405296897,136701.26124849287,2240,24,474.1666666666667,33,3,18,31.57762793914246,0.6625631313131313,41.57475490196078,1033.7009803921562,31.324272133095644,0
3770,4,0,0,36,0.0,0.0,1.0,36,750,600,150,0.8,9,6,3,386.74996329340536,0.3921957671957672,-0.032799206806115366,0.24078304166331344,133626.03635204065,3135.9729308389797,136762.00928287965,2241,25,475.1666666666667,34,2,18,31.521061216657063,0.6608455882352942,41.51785714285713,1033.92857142857,30.409663865546175,0
3771,4,0,0,36,0.0,0.0,1.0,36,850,600,250,0.7058823529411765,11,6,5,387.06769487651945,0.3919146825396826,-0.029504694655511976,0.2411814919438624,133656.80980725592,3146.846655328759,136803.65646258468,2242,26,476.1666666666667,34,2,18,31.481934530662357,0.6611519607843137,41.48809523809522,1034.0476190476165,30.41316526610637,0
3772,4,0,0,36,0.0,0.0,1.0,36,900,400,500,0.4444444444444444,14,4,10,384.67293729416684,0.3914517195767196,-0.032892213271960014,0.24048977158894275,133779.9390589567,3092.30442176868,136872.24348072536,2243,27,477.1666666666667,34,2,16,31.42021480629076,0.6623774509803921,41.369047619047606,1034.5238095238076,30.427170868347282,0
3773,4,0,1,35,0.0,0.027777777777777776,0.9722222222222222,36,800,500,300,0.625,11,5,6,388.28858964684775,0.39095568783068785,-0.03873680443728733,0.24356284259665897,133903.125,3198.6111111111113,137101.73611111112,2244,28,478.1666666666667,34,2,16,31.203032742887817,0.6636029411764706,41.25,1035.0,30.441176470588236,0
3774,4,1,0,36,0.027777777777777776,0.0,1.0,36,1050,800,250,0.7619047619047619,13,8,5,384.674329501916,0.3887400793650793,-0.030619412515964117,0.24251207729468605,134088.01020408157,3116.043083900222,137204.05328798178,2245,0,478.3611111111111,34,2,17,31.111111111111114,0.6654411764705883,41.07142857142857,1035.714285714285,30.46218487394956,0
3775,4,0,0,36,0.0,0.0,1.0,36,800,700,100,0.875,9,7,2,385.1684600326352,0.38842592592592595,-0.03148020478251423,0.24343653650428632,134180.50063775506,3136.4193594104227,137316.91999716547,2246,1,479.3611111111111,34,2,17,31.005591941476105,0.6663602941176471,40.982142857142854,1036.0714285714282,30.472689075630242,0
3776,4,0,0,36,0.0,0.0,1.0,36,1300,600,700,0.46153846153846156,20,6,14,386.54605200835596,0.3879794973544974,-0.030776986497179415,0.24492503120704118,134273.0229591836,3180.541383219946,137453.56434240355,2247,2,480.3611111111111,34,2,17,30.87717283099778,0.6672794117647058,40.89285714285714,1036.4285714285709,30.483193277310907,0
3777,4,0,0,36,0.0,0.0,1.0,36,1000,500,500,0.5,15,5,10,386.33947577244834,0.38763227513227516,-0.03285032477061878,0.245000569231661,134303.87081916092,3177.3774092970434,137481.24822845796,2248,3,481.3611111111111,34,2,18,30.85161364419433,0.6675857843137255,40.863095238095234,1036.5476190476184,30.486694677871128,0
3778,4,0,0,36,0.0,0.0,1.0,36,950,600,350,0.631578947368421,13,6,7,387.8362192275758,0.38720238095238096,-0.0336465469948074,0.24636510818767005,134365.57716836725,3222.36748866212,137587.94465702938,2249,4,482.3611111111111,34,2,18,30.7509951391281,0.6681985294117647,40.80357142857142,1036.7857142857135,30.493697478991574,0
3779,4,0,0,36,0.0,0.0,1.0,36,1050,700,350,0.6666666666666666,14,7,7,388.89277009810974,0.3869047619047619,-0.03348641408342912,0.24724496551492944,134396.4356575963,3253.160430838992,137649.5960884353,2250,5,483.3611111111111,34,2,18,30.69269039418292,0.6685049019607843,40.77380952380952,1036.9047619047612,30.497198879551803,0
3780,4,0,0,36,0.0,0.0,1.0,36,650,400,250,0.6153846153846154,9,4,5,388.3249783567202,0.3867890211640212,-0.03734422632941725,0.24709268710484925,134427.2976899092,3240.295493197266,137667.59318310648,2251,6,484.3611111111111,34,2,18,30.676491409329202,0.6688112745098039,40.74404761904761,1037.0238095238087,30.50070028011202,0
3781,4,0,0,36,0.0,0.0,1.0,36,750,600,150,0.8,9,6,3,388.2195448460509,0.38705357142857144,-0.03871039714413205,0.24786324786324787,134550.78125,3247.161989795917,137797.94323979592,2252,7,485.3611111111111,32,4,18,30.55555555555555,0.6748046875,40.625,1037.5,32.421875,0
3782,4,0,0,36,0.0,0.0,1.0,36,850,600,250,0.7058823529411765,11,6,5,387.33634986555023,0.3873181216931217,-0.045467142528828663,0.24774454938093046,134616.28795849907,3228.356322058968,137844.64428055804,2253,8,486.3611111111111,32,4,20,30.512886806991933,0.6754557291666667,40.561868686868685,1037.752525252525,32.429766414141405,0
3783,4,0,0,36,0.0,0.0,1.0,36,650,300,350,0.46153846153846156,10,3,7,386.4137225683497,0.38655753968253964,-0.04486139831596536,0.24759993867766178,134681.81060924896,3208.5799599530596,137890.39056920202,2254,9,487.3611111111111,32,4,20,30.47125248347728,0.6761067708333333,40.49873737373737,1038.0050505050497,32.4376578282828,0
3784,4,0,0,36,0.0,0.0,1.0,36,700,400,300,0.5714285714285714,10,4,6,383.51909156842584,0.3860119047619048,-0.044255948761603436,0.24618871896699177,134747.3492022498,3135.6361914600584,137882.98539370988,2255,10,488.3611111111111,32,4,20,30.480816003891526,0.6767578125,40.43560606060606,1038.257575757576,32.44554924242425,0
3785,4,0,0,36,0.0,0.0,1.0,36,850,500,350,0.5882352941176471,12,5,7,380.62666349825787,0.3849537037037037,-0.042394211105867274,0.24515133737167405,134868.83049788533,3066.9345924644254,137935.76509034974,2256,11,489.3611111111111,33,3,15,30.434462010382255,0.6755050505050505,40.31862745098039,1038.7254901960775,31.476530005941743,0
3786,4,0,0,36,0.0,0.0,1.0,36,650,500,150,0.7692307692307693,8,5,3,379.52614468152154,0.3849206349206349,-0.03995451745245293,0.2446572721266357,134900.6560727845,3039.665182862363,137940.32125564688,2257,12,490.3611111111111,33,3,15,30.431240415241234,0.6758207070707071,40.28799019607843,1038.8480392156864,31.480243612596556,0
3787,4,0,1,35,0.0,0.027777777777777776,0.9722222222222222,36,1100,900,200,0.8181818181818182,13,9,4,378.41981132075483,0.38503637566137566,-0.03709381551362678,0.24458841463414635,134996.15532487503,3017.043925413301,138013.19925028834,2258,13,491.3611111111111,33,3,15,30.364583333333336,0.6767676767676767,40.19607843137255,1039.2156862745096,31.491384432560896,0
3788,4,0,0,35,0.0,0.0,1.0,35,750,400,350,0.5333333333333333,11,4,7,388.7630669899197,0.38455882352941173,-0.033614671251433026,0.25023200227379355,134845.68698347113,3484.6045684113915,138330.29155188252,2259,48,506.0285714285714,32,3,15,30.246322635545816,0.677734375,40.34090909090909,1038.6363636363642,32.45738636363638,0
3789,4,0,0,35,0.0,0.0,1.0,35,750,400,350,0.5333333333333333,11,4,7,391.7288165692406,0.3838235294117647,-0.025809342444270023,0.24267613778720412,133442.32420535412,3454.640748242462,136896.9649535966,2260,49,507.0285714285714,35,0,19,31.577074231731448,0.6568452380952381,41.695601851851855,1033.2175925925928,29.520502645502653,8
3790,4,0,0,35,0.0,0.0,1.0,35,1100,900,200,0.8181818181818182,13,9,4,395.2353941123875,0.38336834733893554,-0.023193117929959595,0.2458853823548747,133598.88624567474,3560.608389616594,137159.49463529134,2261,50,508.0285714285714,33,2,19,31.329026394815873,0.6628787878787878,41.544117647058826,1033.8235294117649,31.32798573975045,0
3791,4,0,0,35,0.0,0.0,1.0,35,950,800,150,0.8421052631578947,11,8,3,396.0576093397058,0.3830532212885154,-0.026262147428300242,0.2468193580213026,133662.24078479433,3587.589508842756,137249.8302936371,2262,51,509.0285714285714,33,2,19,31.24407442521925,0.663510101010101,41.4828431372549,1034.0686274509806,31.33541295306002,0
3792,4,0,0,35,0.0,0.0,1.0,35,800,600,200,0.75,10,6,4,396.9443696100807,0.3818627450980392,-0.016095468218353615,0.2483688636631542,133810.73022959183,3623.08319160998,137433.8134212018,2263,52,510.0285714285714,34,1,18,31.07189429678212,0.6626838235294117,41.339285714285715,1034.642857142857,30.43067226890756,0
3793,4,0,0,35,0.0,0.0,1.0,35,450,200,250,0.4444444444444444,7,2,5,399.14778472950354,0.381687675070028,-0.012661889422128647,0.24995623522109836,133841.52494331068,3684.5096371882105,137526.0345804989,2264,53,511.0285714285714,34,1,18,30.983950759318912,0.6629901960784313,41.30952380952381,1034.7619047619048,30.43417366946779,0
3794,4,0,0,35,0.0,0.0,1.0,35,1200,900,300,0.75,15,9,6,393.0333842521264,0.38088235294117645,-0.013338656871356713,0.24706139298209917,133981.00090288496,3531.801242069616,137512.80214495456,2265,54,512.0285714285715,35,0,18,31.002072852617854,0.6622023809523809,41.17476851851852,1035.300925925926,29.58002645502646,0
3795,4,0,0,35,0.0,0.0,1.0,35,1250,1000,250,0.8,15,10,5,396.88898598670477,0.3805672268907563,-0.008504389465283202,0.2505046843851203,134130.8258852022,3647.009495027427,137777.83538022963,2266,55,513.0285714285715,35,0,18,30.751862197392928,0.6636904761904762,41.03009259259259,1035.8796296296289,29.596560846560823,0
3796,4,0,0,35,0.0,0.0,1.0,35,1100,1000,100,0.9090909090909091,12,10,2,376.0919965754754,0.3803221288515406,-0.0881255632832828,0.22714226191449072,132492.6128922769,2974.911112282893,135467.5240045598,2267,56,514.0285714285715,33,2,20,32.93643117882792,0.6518308080808081,42.616421568627445,1029.5343137254895,31.198009506833014,8
3797,4,0,0,35,0.0,0.0,1.0,35,950,700,250,0.7368421052631579,12,7,5,371.9166624495137,0.379656862745098,-0.07916376306620221,0.22537559826158327,132618.811349601,2864.6291390330457,135483.44048863405,2268,57,515.0285714285715,33,2,21,32.91679060083282,0.6530934343434344,42.4938725490196,1030.0245098039206,31.21286393345214,0
3798,4,0,0,35,0.0,0.0,1.0,35,800,600,200,0.75,10,6,4,371.8308682337134,0.3791316526610644,-0.07992930219910888,0.2255130070975895,132650.37035034585,2864.7004757785294,135515.07082612437,2269,58,516.0285714285715,33,2,17,32.88722341184869,0.6534090909090908,42.46323529411764,1030.147058823528,31.216577540106908,0
3799,4,0,0,35,0.0,0.0,1.0,35,900,700,200,0.7777777777777778,11,7,4,371.06213796213956,0.3793067226890756,-0.07721420078138275,0.22580554126350164,132776.64389898113,2853.6770713187148,135630.32097029986,2270,59,517.0285714285715,33,2,18,32.779924692826,0.6546717171717171,42.3406862745098,1030.6372549019604,31.231431966726074,0
3800,4,0,0,35,0.0,0.0,1.0,35,700,400,300,0.5714285714285714,10,4,6,370.45553880073953,0.37934173669467786,-0.07481828680116809,0.22581681104288562,132839.80320069205,2842.2481737793187,135682.05137447137,2271,60,518.0285714285715,33,2,18,32.73200982723094,0.6553030303030303,42.279411764705884,1030.8823529411766,31.238859180035654,0
3801,4,0,0,35,0.0,0.0,1.0,35,750,400,350,0.5333333333333333,11,4,7,373.17408777240416,0.3787114845938375,-0.07795108538841444,0.22843682158402367,132997.76715986637,2926.264087129948,135924.0312469963,2272,61,519.0285714285715,33,2,19,32.503044433883815,0.6568813131313131,42.12622549019608,1031.4950980392155,31.25742721330956,0
3802,4,0,0,35,0.0,0.0,1.0,35,650,500,150,0.7692307692307693,8,5,3,372.1028971948629,0.3783613445378151,-0.07509544737243967,0.22816710061788423,133060.97902549503,2902.4751597943186,135963.45418528936,2273,62,520.0285714285715,33,2,19,32.467113077562665,0.6575126262626263,42.06495098039216,1031.7401960784316,31.264854426619138,0
3803,4,0,0,35,0.0,0.0,1.0,35,1000,900,100,0.9,11,9,2,370.17092029452067,0.37787114845938374,-0.07100286630145314,0.2277538102002007,133187.44781153885,2860.424025615154,136047.871837154,2274,63,521.0285714285715,33,2,19,32.38986010526734,0.6587752525252526,41.942401960784316,1032.2303921568628,31.279708853238265,0
3804,4,0,0,35,0.0,0.0,1.0,35,750,600,150,0.8,9,6,3,358.35180708319984,0.3774159663865546,-0.05087924970691693,0.1972090912528834,128898.98667800442,2238.23696145123,131137.22363945565,2275,64,522.0285714285715,34,1,19,37.0335091832747,0.6133578431372548,46.13095238095237,1015.4761904761896,29.86694677871146,8
3805,4,0,0,35,0.0,0.0,1.0,35,450,300,150,0.6666666666666666,6,3,3,361.57745728185347,0.3775910364145658,-0.04893941169576921,0.1994402354871398,128989.67013888873,2327.9513888888687,131317.6215277776,2276,65,523.0285714285715,34,1,19,36.859105824446274,0.6142769607843137,46.04166666666666,1015.833333333332,29.87745098039212,0
3806,4,0,0,35,0.0,0.0,1.0,35,800,700,100,0.875,9,7,2,359.8642208295627,0.37762605042016806,-0.04499121265377892,0.19879877830293274,129050.1434948977,2288.1058673469024,131338.2493622446,2277,66,524.0285714285715,34,1,19,36.840949033391894,0.6148897058823529,45.98214285714284,1016.0714285714264,29.88445378151254,0
3807,4,1,0,36,0.027777777777777776,0.0,1.0,36,1050,700,350,0.6666666666666666,14,7,7,349.50203263870327,0.38379629629629625,-0.03566552901023878,0.19468459232536087,129377.95380015392,1843.5715663579795,131221.5253665119,2278,0,510.44444444444446,35,1,22,36.77047781569965,0.6160714285714286,45.6597222222222,1017.3611111111079,29.067460317460228,0
3808,4,0,0,36,0.0,0.0,1.0,36,850,500,350,0.5882352941176471,12,5,7,352.1213079958807,0.38401124338624343,-0.04301717275105221,0.1965842959497001,129466.28146701374,1917.567274305537,131383.8487413193,2279,1,511.44444444444446,35,1,15,36.613996929375624,0.6169642857142856,45.57291666666666,1017.7083333333321,29.077380952380917,0
3809,4,1,0,37,0.02702702702702703,0.0,1.0,37,600,400,200,0.6666666666666666,8,4,4,347.34290679593914,0.38785660660660665,-0.04641312399933095,0.19544518785383416,129774.47041636214,1615.2483564645513,131389.7187728267,2280,0,498.5945945945946,36,1,16,36.42241379310344,0.6180555555555556,45.27027027027026,1018.9189189189175,28.303303303303263,0
3810,4,1,0,38,0.02631578947368421,0.0,1.0,38,1250,900,350,0.72,16,9,7,346.0224906289044,0.3908546704599336,-0.031901181525241906,0.1971523493118178,130262.58680555565,1415.6731900819832,131678.25999563764,2281,0,486.44736842105266,36,2,19,35.96088435374149,0.622974537037037,44.79166666666667,1020.8333333333342,28.356481481481506,0
3811,4,0,0,38,0.0,0.0,1.0,38,1250,1000,250,0.8,15,10,5,347.4788508692759,0.3904101469890944,-0.0344522404257418,0.19856872706575104,130377.5708774656,1460.689701525885,131838.26057899147,2282,1,487.44736842105266,36,2,19,35.80719116403868,0.6241319444444444,44.67905405405407,1021.2837837837861,28.36899399399406,0
3812,4,0,0,38,0.0,0.0,1.0,38,1200,1000,200,0.8333333333333334,14,10,4,349.60839428823135,0.3898470839260313,-0.04491108237708996,0.2009750091801318,130607.69120049126,1532.3090404594018,132140.00024095067,2283,2,488.44736842105266,36,2,15,35.519720171862936,0.6264467592592593,44.45382882882884,1022.1846846846865,28.39401901901907,0
3813,4,1,1,38,0.02564102564102564,0.02564102564102564,0.9743589743589743,39,600,400,200,0.6666666666666666,8,4,4,341.199519761441,0.3942307692307692,-0.04094430200956867,0.19737958579628073,130850.90033712308,1129.252871075725,131980.1532081988,2284,0,476.8974358974359,37,2,16,35.48867127496159,0.6269707207207207,44.21600877192983,1023.1359649122817,27.65232337600761,0
3814,4,0,0,38,0.0,0.0,1.0,38,1000,700,300,0.7,13,7,6,341.1477042271982,0.39192152678994785,-0.028649959123841162,0.1979250353611498,130963.11034404839,1335.5528864650837,132298.66323051346,2285,1,485.10526315789474,37,1,16,35.376606855918574,0.6280968468468469,44.106359649122815,1023.5745614035105,27.664177335230015,0
3815,4,0,1,37,0.0,0.02631578947368421,0.9736842105263158,38,850,700,150,0.8235294117647058,10,7,3,344.9064868783365,0.3922919630156472,-0.028423758045789338,0.20054400837297057,131047.29940943376,1439.8127308402686,132487.11214027402,2286,2,486.10526315789474,37,1,16,35.19534875419433,0.6289414414414414,44.02412280701755,1023.9035087719305,27.67306780464677,0
3816,4,0,1,36,0.0,0.02702702702702703,0.972972972972973,37,850,600,250,0.7058823529411765,11,6,5,353.8258776372685,0.38848223223223227,-0.03086254571403113,0.20538168759404685,130982.06948502573,1868.9691380569934,132851.0386230827,2287,3,500.0810810810811,36,1,17,35.03300330033003,0.6302083333333333,44.087837837837846,1023.6486486486499,28.43468468468472,0
3817,4,1,0,37,0.02702702702702703,0.0,1.0,37,600,400,200,0.6666666666666666,8,4,4,355.2823549358807,0.38719969969969975,-0.028658455046580378,0.20700147457667115,131126.2038009294,1917.3652960392903,133043.56909696868,2288,0,500.81081081081084,36,1,18,34.849963349825906,0.6316550925925926,43.947072072072075,1024.2117117117123,28.45032532532534,0
3818,4,0,0,37,0.0,0.0,1.0,37,300,100,200,0.3333333333333333,5,1,4,348.9990088117721,0.38679304304304307,-0.04054054054054068,0.18552052573678424,127512.50000000001,1527.2861121256403,129039.78611212566,2289,1,501.81081081081084,34,3,14,38.687775027502745,0.5992647058823529,47.5,1010.0000000000001,29.70588235294118,8
3819,4,1,1,37,0.02631578947368421,0.02631578947368421,0.9736842105263158,38,1100,700,400,0.6363636363636364,15,7,8,341.76999071031076,0.3916696301564722,-0.03209279350373184,0.183080589137706,127822.4682382759,1137.1767564729103,128959.64499474881,2290,0,489.57894736842104,35,3,15,38.55311224295144,0.600297619047619,47.19328703703704,1011.226851851852,28.89219576719577,0
3820,4,0,0,37,0.0,0.0,1.0,37,950,600,350,0.631578947368421,13,6,7,352.80382515995274,0.3875437937937938,-0.025114482196785914,0.18880673516594076,127783.17920918365,1616.4788832199479,129399.6580924036,2291,1,503.7567567567568,34,3,16,38.314396169394385,0.6020220588235294,47.232142857142854,1011.0714285714284,29.737394957983188,0
3821,4,1,0,38,0.02631578947368421,0.0,1.0,38,700,400,300,0.5714285714285714,10,4,6,343.6129316330504,0.392410502607871,-0.022850335715832726,0.1855509830818474,128144.53125000012,1206.4236111111245,129350.95486111124,2292,0,491.4736842105263,35,3,18,38.17729766803841,0.6035714285714286,46.87500000000001,1012.5000000000009,28.928571428571455,0
3822,4,2,1,39,0.05,0.025,0.975,40,650,400,250,0.6153846153846154,9,4,5,325.2458098355336,0.40329861111111115,-0.016191093817552904,0.17784717686751544,128644.60699446002,368.22387657743036,129012.83087103744,2293,0,467.85,37,3,14,38.13274607292117,0.6047297297297297,46.38157894736843,1014.4736842105278,27.41820768136562,0
3823,4,0,0,39,0.0,0.0,1.0,39,900,700,200,0.7777777777777778,11,7,4,331.40091150564183,0.39681736392262706,-0.01922792149358088,0.18062553312329327,128515.36502718955,718.0218224981959,129233.38684968774,2294,1,480.84615384615387,36,3,14,38.10829446172071,0.6053240740740741,46.50900900900902,1013.9639639639655,28.16566566566571,0
3824,4,0,0,39,0.0,0.0,1.0,39,1100,800,300,0.7272727272727273,14,8,6,330.70425998436076,0.3964237516869096,-0.01955743823180267,0.1806339156870308,128601.01814229779,705.7809075967941,129306.79904989459,2295,2,481.84615384615387,36,3,16,38.03870138040782,0.6061921296296297,46.42454954954955,1014.3018018018025,28.17505005005007,0
3825,4,1,0,40,0.025,0.0,1.0,40,1350,1000,350,0.7407407407407407,17,10,7,364.6238358750893,0.40211004273504275,0.10561425599474417,0.1838823574294418,125356.61363352185,1143.0000095305188,126499.61364305236,2296,0,470.775,37,3,13,40.515050731778516,0.5712274774774775,49.64364035087719,1001.4254385964912,27.06555239449976,8
3826,4,7,0,47,0.14893617021276595,0.0,1.0,47,1350,800,550,0.5925925925925926,19,8,11,353.0724246581047,0.42435630588960843,0.1996374788795794,0.17789339229570506,125318.48965031262,-251.4456642078443,125067.04398610478,2297,0,401.51063829787233,35,12,18,40.84366450891998,0.574702380952381,49.68171296296295,1001.2731481481455,28.60780423280416,8
3827,4,2,1,48,0.04081632653061224,0.02040816326530612,0.9795918367346939,49,1200,500,700,0.4166666666666667,19,5,14,345.0243430550553,0.42883715986394555,0.24227571957138072,0.17716016785883915,126100.38406227158,-1096.3664536306715,125004.0176086409,2298,0,386.0816326530612,36,13,20,40.23853571028142,0.5807291666666667,48.90202702702702,1004.3918918918907,27.89977477477474,0
3828,4,1,0,49,0.02040816326530612,0.0,1.0,49,1100,700,400,0.6363636363636364,15,7,8,339.9598129746465,0.43292942176870747,0.23878419842057363,0.1754035428099245,126298.39932838237,-1212.7239570651843,125085.67537131718,2299,0,376.8979591836735,36,13,16,40.16193330345807,0.5827546296296297,48.70495495495495,1005.1801801801796,27.921671671671657,0
3829,4,1,1,49,0.02,0.02,0.98,50,1150,800,350,0.6956521739130435,15,8,7,368.154175153489,0.43591836734693873,0.3508338833883391,0.18050277519661348,124178.98415858722,-810.2179196397146,123368.7662389475,2300,0,370.34,37,13,20,41.648789878987905,0.5591216216216216,50.82236842105263,996.7105263157891,26.938122332859166,8
3830,4,1,0,50,0.02,0.0,1.0,50,1550,1000,550,0.6451612903225806,21,10,11,365.6277648720147,0.436530612244898,0.361628392484342,0.1805522673955622,124479.70920138918,-897.3524305555216,123582.35677083366,2301,0,371.26,37,13,17,41.39918232428673,0.5622184684684685,50.52083333333335,997.916666666669,26.970720720720784,0
3831,4,6,2,54,0.10714285714285714,0.03571428571428571,0.9642857142857143,56,1500,1000,500,0.6666666666666666,20,10,10,347.73811501920636,0.44850514069264075,0.40589677429413373,0.17890647658175113,126181.50686990227,-2383.1434912665404,123798.36337863572,2302,0,332.375,37,19,19,40.08683018662012,0.5796734234234234,48.82127192982456,1004.7149122807016,27.15445708866761,0
3832,4,5,3,56,0.0847457627118644,0.05084745762711865,0.9491525423728814,59,1400,800,600,0.5714285714285714,20,8,12,309.77716401401625,0.4536211766997857,0.2888484667831446,0.16307789465300046,127118.94729573016,-3866.8811114743376,123252.06618425582,2303,0,316.3898305084746,38,21,20,40.08016385916588,0.5874451754385965,47.88995726495727,1008.4401709401711,26.537899235267663,8
3833,4,1,1,56,0.017543859649122806,0.017543859649122806,0.9824561403508771,57,1600,900,700,0.5625,23,9,14,322.97463494655494,0.45031850459482037,0.30612320863577147,0.17003161998509125,127120.40323685184,-3188.6668340637716,123931.73640278807,2304,0,328.3333333333333,36,21,21,39.7459519821329,0.5911458333333333,47.88851351351352,1008.445945945947,28.012387387387417,0
3834,4,0,2,54,0.0,0.03571428571428571,0.9642857142857143,56,1650,1100,550,0.6666666666666666,22,11,11,330.28871312001974,0.4494250541125541,0.16109846917666526,0.1724206953803646,126777.10503472232,-2825.3906249999914,123951.71440972234,2305,1,334.8392857142857,39,17,16,39.913460212384514,0.5822649572649572,48.22916666666667,1007.0833333333342,25.822649572649595,8
3835,4,3,5,52,0.05263157894736842,0.08771929824561403,0.9122807017543859,57,1450,800,650,0.5517241379310345,21,8,13,323.08962988345286,0.4504620927318295,0.23066477902475402,0.17253377428503824,127696.68104383691,-3148.1146918402733,124548.56635199665,2306,0,329.8421052631579,39,18,14,39.153805524064715,0.5916132478632479,47.317708333333336,1010.7291666666675,25.916132478632502,0
3836,4,3,3,52,0.05454545454545454,0.05454545454545454,0.9454545454545454,55,1800,1300,500,0.7222222222222222,23,13,10,333.83211308532566,0.44703984287317616,0.26424663071447574,0.1786573368984205,127783.97108966211,-2468.321382540794,125315.64970712132,2307,0,342.5272727272727,37,18,15,38.793130716119,0.5960022522522522,47.2313596491228,1011.074561403508,27.32633949739211,0
3837,4,1,0,53,0.018867924528301886,0.0,1.0,53,1650,1300,350,0.7878787878787878,20,13,7,342.4119680488247,0.4442882196419932,0.27493621725223516,0.18320468707642112,127774.2332704324,-1849.714663988333,125924.51860644408,2308,0,355.9433962264151,36,17,16,38.58622001930644,0.5978009259259259,47.24099099099098,1011.0360360360345,28.08433433433429,0
3838,4,1,1,53,0.018518518518518517,0.018518518518518517,0.9814814814814815,54,1950,1400,550,0.717948717948718,25,14,11,334.4679842164989,0.4462278709527137,0.28326474622771025,0.18061271147690883,128144.53124999955,-2227.951388888934,125916.57986111061,2309,0,350.3333333333333,37,17,17,38.40877914951991,0.5996621621621622,46.87499999999998,1012.4999999999964,27.364864864864767,0
3839,4,0,1,52,0.0,0.018867924528301886,0.9811320754716981,53,1450,1000,450,0.6896551724137931,19,10,9,346.32254568239955,0.44416727140783746,0.2874446773817847,0.18701417466849546,128144.53124999975,-1724.131944444472,126420.39930555529,2310,1,357.811320754717,36,17,17,38.10871056241425,0.6015625,46.874999999999986,1012.4999999999981,28.124999999999947,0
3840,4,2,1,53,0.037037037037037035,0.018518518518518517,0.9814814814814815,54,700,400,300,0.5714285714285714,10,4,6,339.4509737424853,0.44504862566969483,0.29240672643225096,0.18483885177991816,128477.80687326829,-2077.616670514053,126400.19020275424,2311,0,351.9074074074074,37,17,18,37.94253370827021,0.6030405405405406,46.546052631578924,1013.8157894736809,27.400426742531916,0
3841,4,2,1,54,0.03636363636363636,0.01818181818181818,0.9818181818181818,55,1200,800,400,0.6666666666666666,16,8,8,338.2497992523719,0.4469135802469136,0.31227674302979413,0.18654751109579704,128984.24373584583,-2274.2210899262627,126710.02264591957,2312,0,346.4727272727273,38,17,20,37.457053709157215,0.606359649122807,46.047008547008524,1015.811965811962,26.731893837156893,0
3842,4,1,1,54,0.01818181818181818,0.01818181818181818,0.9818181818181818,55,1400,900,500,0.6428571428571429,19,9,10,333.15545454581564,0.4481762065095398,0.31093544137022433,0.18551498468919606,129364.36760355013,-2380.128433413711,126984.23917013641,2313,0,343.2,38,17,21,37.200036756983835,0.6101973684210527,45.67307692307691,1017.3076923076909,26.77125506072871,0
3843,4,1,1,54,0.01818181818181818,0.01818181818181818,0.9818181818181818,55,1500,1100,400,0.7333333333333333,19,11,8,334.3293233711718,0.4478395061728395,0.3129564521829715,0.18715548720674885,129572.31445312501,-2336.03515625,127236.27929687501,2314,0,343.90909090909093,39,16,18,36.95902394106814,0.6105769230769231,45.46875,1018.1250000000001,26.105769230769234,0
3844,4,0,0,54,0.0,0.0,1.0,54,1600,1100,500,0.6875,21,11,10,340.35686567191976,0.44662095271372,0.30905462078722645,0.1904439561355091,129554.63927469119,-1981.0378086419964,127573.6014660492,2315,1,350.8888888888889,38,16,18,36.82355616189176,0.6121162280701755,45.4861111111111,1018.0555555555541,26.790935672514582,0
3845,4,0,2,52,0.0,0.037037037037037035,0.962962962962963,54,1450,1200,250,0.8275862068965517,17,12,5,323.5275630111523,0.44707954810156064,0.24134598488842007,0.1756530586812123,128360.96871803999,-2492.4087086346767,125868.56000940532,2316,2,351.8888888888889,38,16,21,38.46512036548937,0.6000548245614035,46.66132478632478,1013.3547008547005,26.66722896986054,8
3846,4,0,0,52,0.0,0.0,1.0,52,2150,1600,550,0.7441860465116279,27,16,11,338.19571558317557,0.44451514580191054,0.25587998836831405,0.1830163818264188,128230.06071950328,-1726.6285711387072,126503.43214836458,2317,3,366.13461538461536,36,16,21,38.22710510710844,0.6024305555555556,46.79054054054054,1012.8378378378378,28.134384384384383,0
3847,4,0,0,52,0.0,0.0,1.0,52,1200,900,300,0.75,15,9,6,339.277809553616,0.4439809577677225,0.259692341895543,0.18386404667134507,128287.09621783938,-1695.007000243501,126592.08921759589,2318,4,367.13461538461536,36,16,21,38.14148880984139,0.6030092592592593,46.73423423423423,1013.0630630630625,28.140640640640626,0
3848,4,0,1,51,0.0,0.019230769230769232,0.9807692307692307,52,2000,1500,500,0.75,25,15,10,338.4350349498255,0.4437452865761689,0.2541961149615857,0.18406367066969057,128429.74044568211,-1706.975260733714,126722.7651849484,2319,5,368.13461538461536,36,16,15,38.017303632929675,0.6044560185185186,46.593468468468465,1013.6261261261257,28.156281281281267,0
3849,4,0,0,51,0.0,0.0,1.0,51,1150,800,350,0.6956521739130435,15,8,7,368.16447360161396,0.4418300653594771,0.3119998027785811,0.19895435327612826,128173.82979948969,-665.0963804966691,127508.73341899301,2320,6,375.921568627451,35,16,18,37.525836286051735,0.6038690476190476,46.8460648148148,1012.6157407407392,28.93187830687826,8
3850,4,0,1,50,0.0,0.0196078431372549,0.9803921568627451,51,1150,800,350,0.6956521739130435,15,8,7,377.43968532064434,0.44199346405228757,0.3034778750490623,0.19802657462713255,126981.47506925209,-597.5481946575895,126383.9268745945,2321,7,376.921568627451,37,14,16,38.51582898172323,0.5878378378378378,48.026315789473685,1007.8947368421054,27.240398293029877,8
3851,4,5,2,53,0.09090909090909091,0.03636363636363636,0.9636363636363636,55,1900,1400,500,0.7368421052631579,24,14,10,353.7206214914411,0.44590347923681256,0.3283007934801907,0.19189294396247922,128329.16802300364,-1921.3692028436456,126407.79882016,2322,0,349.96363636363634,39,16,17,37.732707069668635,0.5980235042735043,46.69270833333334,1013.2291666666681,25.980235042735078,0
3852,4,2,2,53,0.03636363636363636,0.03636363636363636,0.9636363636363636,55,1400,1100,300,0.7857142857142857,17,11,6,356.2825398459088,0.4471380471380471,0.3400862954592152,0.19417996880515576,128513.93771701408,-1842.5455729166442,126671.39214409744,2323,0,350.72727272727275,39,16,14,37.47902540921856,0.5998931623931624,46.51041666666668,1013.958333333335,25.998931623931664,0
3853,4,2,1,54,0.03636363636363636,0.01818181818181818,0.9818181818181818,55,1400,900,500,0.6428571428571429,19,9,10,356.932637600696,0.44577721661055,0.34554975776867125,0.1951806264791231,128645.99745008702,-1816.408962673592,126829.58848741342,2324,0,351.6727272727273,39,16,17,37.32769021460109,0.6012286324786325,46.38020833333334,1014.4791666666683,26.012286324786366,0
3854,4,0,0,54,0.0,0.0,1.0,54,1200,700,500,0.5833333333333334,17,7,10,361.266999456081,0.44437893081761004,0.3586252076460541,0.197884311466774,128713.06911571346,-1500.0431459565987,127213.02596975685,2325,1,358.962962962963,38,16,17,37.14926826700358,0.6036184210526316,46.31410256410257,1014.7435897435906,26.70377867746291,0
3855,4,1,0,55,0.01818181818181818,0.0,1.0,55,1450,1100,350,0.7586206896551724,18,11,7,351.1255996108581,0.44560886644219977,0.29116877496016236,0.19066408881336946,128366.66690712517,-1845.8531163890343,126520.81379073614,2326,0,353.41818181818184,37,18,19,37.76013489143763,0.6019144144144144,46.65570175438596,1013.3771929824553,27.388572783309602,8
3856,4,0,2,53,0.0,0.03636363636363636,0.9636363636363636,55,1750,1300,450,0.7428571428571429,22,13,9,348.8777761004096,0.4456649831649832,0.285411372516873,0.19059381955436194,128607.98306439641,-2026.3065759468327,126581.67648844958,2327,1,354.41818181818184,40,15,17,37.57075944294159,0.59921875,46.41768292682928,1014.3292682926847,25.358231707317117,0
3857,4,0,1,52,0.0,0.018867924528301886,0.9811320754716981,53,1650,1200,450,0.7272727272727273,21,12,9,362.8950356769633,0.44416727140783746,0.2963420790091864,0.1982350672449416,128604.67916757963,-1266.0000730513711,127338.67909452826,2328,2,368.1320754716981,38,15,17,37.21868197458045,0.6025219298245614,46.42094017094016,1014.3162393162378,26.692532613585204,0
3858,4,0,2,50,0.0,0.038461538461538464,0.9615384615384616,52,1950,1300,650,0.6666666666666666,26,13,13,366.6074243602197,0.442221279537456,0.2918320882824783,0.2002629969433785,128604.67916757954,-970.5139619402753,127634.16520563926,2329,3,375.9423076923077,38,14,17,37.12454357137841,0.6025219298245614,46.420940170940156,1014.3162393162371,26.692532613585186,0
3859,4,0,1,49,0.0,0.02,0.98,50,1800,1400,400,0.7777777777777778,22,14,8,374.9048940832729,0.4406122448979592,0.284060540540541,0.20471489198761908,128588.99493113233,-358.2712950138889,128230.72363611843,2330,4,383.3,37,13,18,36.93018018018018,0.6041666666666667,46.43640350877191,1014.2543859649096,27.412280701754312,0
3860,4,2,2,49,0.0392156862745098,0.0392156862745098,0.9607843137254902,51,1600,1200,400,0.75,20,12,8,366.45599249357747,0.44166666666666665,0.30993028370688336,0.20365932727443078,129287.27027280667,-720.0166874405977,128567.25358536607,2331,0,376.29411764705884,36,15,20,36.43168899715791,0.6131365740740741,45.748873873873876,1017.0045045045051,28.25012512512514,0
3861,4,0,0,49,0.0,0.0,1.0,49,1450,800,650,0.5517241379310345,21,8,13,374.85862205817676,0.438828656462585,0.31360652615245965,0.20818633713041335,129260.23046339152,-109.13762431414455,129151.09283907738,2332,1,391.2857142857143,35,14,20,36.24563699825479,0.6148809523809524,45.775462962962955,1016.8981481481472,29.05423280423278,0
3862,4,0,0,49,0.0,0.0,1.0,49,1000,700,300,0.7,13,7,6,374.5580982216666,0.4387046485260771,0.3112842816043253,0.20848582173972288,129348.5179424938,-110.29302233369475,129238.22492016011,2333,2,392.2857142857143,35,14,20,36.163220123639405,0.6157738095238094,45.6886574074074,1017.2453703703687,29.064153439153394,0
3863,4,0,0,49,0.0,0.0,1.0,49,1350,900,450,0.6666666666666666,18,9,9,374.91789144174794,0.43921839569161,0.3150418816451863,0.20931130282204996,129466.28146701373,-92.15494791668493,129374.12651909704,2334,3,393.2857142857143,35,14,17,36.03399010576594,0.6169642857142856,45.57291666666666,1017.708333333332,29.077380952380913,0
3864,4,2,1,50,0.0392156862745098,0.0196078431372549,0.9803921568627451,51,1450,1100,350,0.7586206896551724,18,11,7,362.5381534082462,0.4402450980392157,0.32851408161330165,0.20582169112042267,130122.70752779687,-765.1107792782524,129357.59674851861,2335,0,378.8235294117647,37,14,20,35.68142127888231,0.6196509009009009,44.92872807017543,1020.285087719297,27.57527264106208,0
3865,4,0,0,50,0.0,0.0,1.0,50,1400,1100,300,0.7857142857142857,17,11,6,362.96790563405,0.43941326530612246,0.29857278983589164,0.19184285779035293,127280.60766171764,-740.4491273764972,126540.15853434114,2336,1,387.32,38,12,19,38.57309864125641,0.5890899122807017,47.729700854700866,1009.0811965811982,26.554768331084166,8
3866,4,2,0,52,0.038461538461538464,0.0,1.0,52,1400,800,600,0.5714285714285714,20,8,12,353.7188519595678,0.4424333836098542,0.31943639216777586,0.18954530403067665,127836.02812685927,-1356.3973783792433,126479.63074848002,2337,0,373.38461538461536,40,12,20,38.23715371989416,0.59140625,47.1798780487805,1011.2804878048801,25.282012195122,0
3867,4,2,0,54,0.037037037037037035,0.0,1.0,54,1350,800,550,0.5925925925925926,19,8,11,342.51690115714246,0.443854821802935,0.32380272303151436,0.18556974171327106,128276.40109592037,-2011.5175135113836,126264.88358240899,2338,0,360.51851851851853,39,15,22,38.07037275064266,0.5974893162393162,46.74479166666668,1013.0208333333353,25.97489316239321,0
3868,4,0,0,54,0.0,0.0,1.0,54,900,600,300,0.6666666666666666,12,6,6,342.55843013153674,0.44431341719077566,0.32334132693844864,0.18620634218881885,128408.33875868075,-2002.5282118055395,126405.81054687522,2339,1,361.51851851851853,39,15,17,37.93465227817746,0.5988247863247863,46.61458333333334,1013.5416666666682,25.988247863247903,0
3869,4,2,1,55,0.03571428571428571,0.017857142857142856,0.9821428571428571,56,2050,1200,850,0.5853658536585366,29,12,17,335.68115234375,0.44540719696969694,0.34935128348214306,0.18520339439655176,128999.74804736707,-2539.4431846812795,126460.30486268579,2340,0,349.57142857142856,41,15,19,37.506510416666664,0.6016260162601625,46.03174603174603,1015.8730158730157,24.777390631049162,0
3870,4,0,1,54,0.0,0.01818181818181818,0.9818181818181818,55,1200,800,400,0.6666666666666666,16,8,8,342.883368703334,0.4446127946127946,0.3536366365546788,0.18878421506624893,128917.41569378354,-2159.2724444774863,126758.14324930606,2341,1,356.8909090909091,40,15,19,37.407435204643235,0.60234375,46.112804878048784,1015.5487804878055,25.388719512195138,0
3871,4,2,2,54,0.03571428571428571,0.03571428571428571,0.9642857142857143,56,800,600,200,0.75,10,6,4,310.1453277199778,0.4445684523809524,0.269746329785699,0.16152994828570483,126682.45278108297,-3228.6499644721825,123453.8028166108,2342,0,351.4107142857143,40,16,15,40.51753146241333,0.5796875,48.32317073170733,1006.707317073173,25.167682926829325,8
3872,4,3,0,57,0.05263157894736842,0.0,1.0,57,1150,800,350,0.6956521739130435,15,8,7,301.05826383881515,0.44709429824561403,0.2862917616296532,0.159185759314134,127297.04231112445,-3733.9127255601716,123563.12958556427,2343,0,343.5438596491228,40,17,18,40.11811849613964,0.5859375,47.713414634146346,1009.1463414634155,25.22865853658539,0
3873,4,2,3,56,0.03389830508474576,0.05084745762711865,0.9491525423728814,59,1550,1200,350,0.7741935483870968,19,12,7,291.71170795649607,0.44909166179622056,0.295856785615052,0.15593502666177275,127737.36230379109,-4347.503174500651,123389.85912929043,2344,0,332.864406779661,43,16,15,39.90524980483999,0.5859980620155039,47.27746212121214,1010.8901515151542,23.509073291050097,0
3874,4,0,0,56,0.0,0.0,1.0,56,1600,1100,500,0.6875,21,11,10,311.1042068623721,0.44683441558441556,0.3022138577462221,0.16539696762745743,127517.50996984442,-3265.753239953383,124251.75672989104,2345,1,350.85714285714283,41,15,15,39.63950414170186,0.5866361788617886,47.495039682539684,1010.0198412698413,24.63463027487418,0
3875,4,1,0,57,0.017543859649122806,0.0,1.0,57,1650,1300,350,0.7878787878787878,20,13,7,307.10394378864595,0.4486476608187135,0.30664770396670127,0.1645244741980649,127825.8705907095,-3548.8342046752136,124277.03638603429,2346,0,345.6842105263158,42,15,16,39.426025297048675,0.5882936507936508,47.18992248062015,1011.2403100775177,24.0771502399409,0
3876,4,0,2,55,0.0,0.03508771929824561,0.9649122807017544,57,2100,1400,700,0.6666666666666666,28,14,14,309.3018518285499,0.4483213241436926,0.30274498734866295,0.16630947151357964,127972.89544648753,-3483.549290908003,124489.34615557952,2347,1,346.6842105263158,42,15,17,39.220615463193504,0.589781746031746,47.04457364341085,1011.8217054263561,24.09099298634181,0
3877,4,0,2,53,0.0,0.03636363636363636,0.9636363636363636,55,1500,900,600,0.6,21,9,12,316.50665326246207,0.4474326599326599,0.2957300005348651,0.17005979188464598,127943.71712805469,-2900.992457168074,125042.72467088662,2348,2,359.6545454545454,41,14,18,39.06811793162059,0.5909552845528455,47.07341269841269,1011.7063492063472,24.675764614788957,0
3878,4,1,1,53,0.018518518518518517,0.018518518518518517,0.9814814814814815,54,1750,1200,550,0.6857142857142857,23,12,11,320.11261811902244,0.4487974609829956,0.2967093158057075,0.17264927834225197,128095.48071217148,-2599.0040600024263,125496.47665216906,2349,0,362.05555555555554,42,12,19,38.82214989949269,0.5910218253968254,46.92344961240309,1012.3062015503855,24.10252860834251,0
3879,4,1,2,52,0.018518518518518517,0.037037037037037035,0.962962962962963,54,1250,600,650,0.48,19,6,13,317.5334280660719,0.4510831586303285,0.29940016061689123,0.17271759578037704,128434.73442925338,-2643.498140945656,125791.23628830773,2350,0,357.98148148148147,39,15,13,38.541880759086105,0.5990918803418803,46.588541666666664,1013.6458333333326,25.990918803418783,0
3880,4,1,2,51,0.018867924528301886,0.03773584905660377,0.9622641509433962,53,1250,900,350,0.72,16,9,7,322.5949729750759,0.44820391872278664,0.19810170810887318,0.1714237860876524,127498.15381262914,-2339.436669608009,125158.71714302113,2351,0,365.52830188679246,43,10,17,39.36913970932958,0.5835755813953488,47.51420454545455,1009.943181818182,23.48705073995772,8
3881,4,1,2,50,0.019230769230769232,0.038461538461538464,0.9615384615384616,52,1750,1000,750,0.5714285714285714,25,10,15,325.8050387738578,0.4465340623428859,0.24371041995374654,0.17436693729265568,127785.23090457136,-2073.3855780819476,125711.84532648942,2352,0,373.3076923076923,43,9,19,38.99474337360681,0.5864825581395349,47.23011363636364,1011.0795454545461,23.513477801268515,0
3882,4,3,0,53,0.05660377358490566,0.0,1.0,53,1400,900,500,0.6428571428571429,19,9,10,320.2500398741348,0.4476898887276246,0.2760185382691147,0.1740800496075608,128408.33875868085,-2372.922764577558,126035.4159941033,2353,0,365.8867924528302,39,14,15,38.49991435423092,0.5988247863247863,46.61458333333335,1013.541666666669,25.988247863247924,0
3883,4,0,0,53,0.0,0.0,1.0,53,1250,700,550,0.56,18,7,11,320.8210813642479,0.44726656990807934,0.27989036677508516,0.17485287827545318,128513.93771701408,-2354.0039062499754,126159.93381076411,2354,1,366.8867924528302,39,14,17,38.37793644270942,0.5998931623931624,46.51041666666668,1013.958333333335,25.998931623931664,0
3884,4,1,0,54,0.018518518518518517,0.0,1.0,54,1450,1200,250,0.8275862068965517,17,12,5,318.6379572765958,0.4488993710691824,0.2942127312497682,0.17509313493911952,128840.0226799524,-2589.335671557938,126250.68700839445,2355,0,361.0740740740741,40,14,19,38.10164330997663,0.6015625,46.1890243902439,1015.2439024390243,25.381097560975608,0
3885,4,0,1,53,0.0,0.018518518518518517,0.9814814814814815,54,1550,1000,550,0.6451612903225806,21,10,11,316.1594775556546,0.44863731656184486,0.2906410512974449,0.17418400323545832,128943.21852898409,-2646.6758791063567,126296.54264987772,2356,1,362.0740740740741,40,14,19,38.059710826495895,0.6026041666666666,46.08739837398374,1015.6504065040651,25.39126016260163,0
3886,4,1,1,53,0.018518518518518517,0.018518518518518517,0.9814814814814815,54,1800,1300,500,0.7222222222222222,23,13,10,310.9639313353821,0.44765461215932917,0.2894559560559957,0.1726695392309564,129253.05394441141,-2761.134245488797,126491.91969892262,2357,0,362.0,40,14,21,37.87727363581849,0.6057291666666667,45.78252032520325,1016.8699186991871,25.42174796747968,0
3887,4,1,1,53,0.018518518518518517,0.018518518518518517,0.9814814814814815,54,1600,1100,500,0.6875,21,11,10,310.31126715442394,0.44797490100163057,0.2833684833684831,0.17275949856595008,129356.41503899796,-2771.849386938993,126584.56565205897,2358,0,362.8703703703704,40,14,22,37.789085914085916,0.6067708333333333,45.68089430894309,1017.2764227642277,25.431910569105693,0
3888,4,0,0,53,0.0,0.0,1.0,53,1550,1100,450,0.7096774193548387,20,11,9,320.88405915214463,0.4462385099177552,0.28335993397262826,0.17899788770420172,129433.96297053652,-2293.3409139731834,127140.62205656334,2359,1,370.07547169811323,40,13,16,37.44153433869302,0.6075520833333333,45.60467479674796,1017.5813008130066,25.439532520325166,0
3889,4,0,1,52,0.0,0.018867924528301886,0.9811320754716981,53,1750,1400,350,0.8,21,14,7,319.2229488827123,0.44580007256894044,0.28241914516163846,0.17880569013110523,129595.74619914645,-2326.0127471306014,127269.73345201585,2360,2,371.07547169811323,42,11,16,37.319780167491466,0.6061507936507937,45.44573643410852,1018.217054263564,24.243263196751524,0
3890,4,2,1,53,0.037037037037037035,0.018518518518518517,0.9814814814814815,54,1200,900,300,0.75,15,9,6,321.13517292868767,0.4460386093640811,0.2975996423535878,0.18184152536498246,130021.0243414256,-2449.135172750239,127571.88916867536,2361,0,365.1296296296296,43,11,18,36.84037449705972,0.6090116279069768,45.028409090909086,1019.8863636363635,23.71828752642706,0
3891,4,0,3,50,0.0,0.05660377358490566,0.9433962264150944,53,1050,900,150,0.8571428571428571,12,9,3,324.9546998401222,0.44459059022738273,0.28968467402451203,0.18386146565147565,129990.70443482966,-2151.781931674778,127838.92250315488,2362,1,372.9433962264151,42,11,19,36.773683960471296,0.6101190476190477,45.05813953488372,1019.7674418604653,24.280177187153935,0
3892,4,0,2,48,0.0,0.04,0.96,50,1300,1000,300,0.7692307692307693,16,10,6,335.55108830661453,0.4386904761904762,0.2933776188042916,0.18924307775678537,129864.12896050359,-1284.790039062489,128579.3389214411,2363,2,394.84,39,11,19,36.63185573156191,0.6135149572649572,45.18229166666667,1019.2708333333343,26.135149572649595,0
3893,4,0,0,48,0.0,0.0,1.0,48,1700,1200,500,0.7058823529411765,22,12,10,348.5804192760001,0.43596705082742315,0.2955340814630101,0.1959909536310653,129744.38707325312,-554.7294310595751,129189.65764219355,2364,3,411.8541666666667,40,8,19,36.42144638403992,0.6106770833333333,45.29979674796747,1018.8008130081282,25.470020325203205,0
3894,4,0,0,48,0.0,0.0,1.0,48,1550,1000,550,0.6451612903225806,21,10,11,354.17352508651027,0.4357638888888889,0.30051358757336954,0.2003604658428308,129984.23450688136,-392.6050918052551,129591.62941507611,2365,4,412.8541666666667,41,7,19,36.03534309433472,0.6115345528455285,45.06448412698412,1019.7420634920627,24.87175764614787,0
3895,4,1,0,49,0.02040816326530612,0.0,1.0,49,1300,1000,300,0.7692307692307693,16,10,6,351.48222564567936,0.43625992063492064,0.3119112843542582,0.20013587918657222,130237.85848957392,-644.7415269515058,129593.11696262241,2366,0,405.40816326530614,42,7,20,35.84662363141575,0.6125992063492063,44.815891472868216,1020.7364341085269,24.303248431155403,0
3896,4,0,0,49,0.0,0.0,1.0,49,1500,1100,400,0.7333333333333333,19,11,8,352.9443849864385,0.4356221655328798,0.3139898076606935,0.20166140921012338,130371.67302441735,-597.2006194890307,129774.47240492832,2367,1,406.40816326530614,38,11,20,35.673623461310456,0.6203399122807017,44.684829059829056,1021.2606837606832,26.875281151596926,0
3897,4,0,0,49,0.0,0.0,1.0,49,1150,900,250,0.782608695652174,14,9,5,349.8857275236812,0.43514384920634924,0.3073527859213716,0.20028766133644912,130444.20070725105,-671.8871868596675,129772.31352039138,2368,2,407.40816326530614,40,9,20,35.67822323915639,0.6177083333333333,44.613821138211385,1021.5447154471551,25.538617886178876,0
3898,4,0,0,49,0.0,0.0,1.0,49,1400,1100,300,0.7857142857142857,17,11,6,351.3356231357384,0.4351792800453515,0.30990940528956235,0.2016570220464031,130548.03688280776,-626.7648225262835,129921.27206028148,2369,3,408.40816326530614,40,9,18,35.5359984089101,0.61875,44.512195121951216,1021.9512195121944,25.54878048780486,0
3899,4,0,0,49,0.0,0.0,1.0,49,1400,1000,400,0.7142857142857143,18,10,8,352.4379863994114,0.4344883786848073,0.30782939995326686,0.2029176473649345,130667.99433893907,-589.5270376669428,130078.46730127213,2370,4,409.40816326530614,41,8,18,35.38634452422535,0.6183943089430894,44.39484126984126,1022.4206349206332,24.93708865660081,0
3900,4,0,0,49,0.0,0.0,1.0,49,1600,1100,500,0.6875,21,11,10,355.77254117910616,0.4346832482993197,0.30624714244149875,0.20551096202228353,130794.81336805543,-493.3593750000103,130301.45399305542,2371,5,410.40816326530614,41,8,19,35.17269178547183,0.6196646341463414,44.27083333333333,1022.9166666666656,24.949186991869894,0
3901,4,1,0,50,0.02,0.0,1.0,50,1250,900,350,0.72,16,9,7,347.90505249259286,0.43642006802721084,0.31171074533012866,0.20248897942168417,131085.5761091021,-878.9331525482287,130206.64295655389,2372,0,403.18,43,7,20,35.079911842673084,0.6196705426356589,43.986742424242415,1024.0530303030282,23.815186751233213,0
3902,4,0,0,50,0.0,0.0,1.0,50,1800,1400,400,0.7777777777777778,22,14,8,347.43463837376135,0.4354166666666666,0.30885796891940864,0.20324559077805393,131280.67558299005,-877.7091906721797,130402.96639231787,2373,1,404.18,44,6,21,34.894892181664865,0.6202651515151515,43.79629629629628,1024.814814814812,23.29124579124573,0
3903,4,1,1,50,0.0196078431372549,0.0196078431372549,0.9803921568627451,51,1450,1000,450,0.6896551724137931,19,10,9,339.63148221914514,0.4369281045751634,0.3102772654207131,0.200223726822734,131576.54663181282,-1262.4667682675959,130314.07986354522,2374,0,397.2352941176471,42,9,19,34.796467699282196,0.6259920634920635,43.50775193798449,1025.9689922480607,24.427833148763348,0
3904,4,0,0,50,0.0,0.0,1.0,50,1400,1000,400,0.7142857142857143,18,10,8,343.3697247425529,0.4360714285714286,0.30332798186797594,0.20255944374924192,131601.40170550146,-962.4125841295663,130638.9891213719,2375,1,404.64,42,8,19,34.6755280637139,0.6262400793650793,43.48352713178294,1026.065891472868,24.430140273163527,0
3905,4,0,0,50,0.0,0.0,1.0,50,1150,900,250,0.782608695652174,14,9,5,340.5306219182233,0.43587585034013604,0.3045658392544066,0.20110792096609187,131643.77371908,-1034.252772755964,130609.52094632403,2376,2,405.64,43,7,19,34.70565731598536,0.6252422480620154,43.44223484848485,1026.2310606060607,23.8658386187456,0
3906,4,0,0,50,0.0,0.0,1.0,50,1500,1000,500,0.6666666666666666,20,10,10,337.9824584329124,0.43556122448979595,0.3030849720368036,0.19993988976452842,131708.02897805203,-1096.9993141289497,130611.02966392308,2377,3,406.64,44,6,19,34.70631126345542,0.6245265151515151,43.379629629629626,1026.4814814814806,23.32912457912456,0
3907,4,1,0,51,0.0196078431372549,0.0,1.0,51,1900,1400,500,0.7368421052631579,24,14,10,333.72267790709145,0.4370588235294118,0.30873540815691847,0.19932026046787754,132071.92882272627,-1384.9204473850064,130687.00837534126,2378,0,399.6470588235294,45,6,21,34.44953589472447,0.6268518518518518,43.02536231884058,1027.8985507246373,22.84219001610305,0
3908,4,0,0,51,0.0,0.0,1.0,51,1550,1100,450,0.7096774193548387,20,11,9,329.46550822798895,0.4368954248366013,0.3063991032861664,0.19738374221173396,132188.33790334227,-1489.7004141724387,130698.63748916984,2379,1,400.6470588235294,45,6,21,34.441979359347016,0.6280092592592592,42.91213768115942,1028.3514492753625,22.85225442834139,0
3909,4,0,1,50,0.0,0.0196078431372549,0.9803921568627451,51,1200,600,600,0.5,18,6,12,328.27120762101794,0.4370588235294118,0.2989937080855598,0.19703212651925361,132258.20796576343,-1516.6876706574221,130741.520295106,2380,2,401.6470588235294,45,6,21,34.40251849242692,0.6287037037037038,42.844202898550726,1028.6231884057968,22.858293075684372,0
3910,4,0,0,50,0.0,0.0,1.0,50,1350,900,450,0.6666666666666666,18,9,9,330.6069596289068,0.43755102040816324,0.2943319838056675,0.19917053421546374,132398.00347222245,-1245.659722222203,131152.34375000026,2381,3,406.9,44,6,21,34.20209176788125,0.6313920454545454,42.70833333333334,1029.1666666666686,23.390151515151558,0
3911,4,0,0,50,0.0,0.0,1.0,50,1600,1300,300,0.8125,19,13,6,325.474637489377,0.43675170068027214,0.290238800078942,0.19703464613604227,132581.09941998817,-1369.6429456672574,131211.4564743209,2382,4,407.9,40,10,21,34.15050819025065,0.6390625,42.53048780487805,1029.8780487804881,25.746951219512205,0
3912,4,1,0,51,0.0196078431372549,0.0,1.0,51,1400,900,500,0.6428571428571429,19,9,10,321.6845718880098,0.43883986928104574,0.29579896630002245,0.19604835111368363,132832.28344868022,-1653.9807531809167,131178.3026954993,2383,0,400.88235294117646,41,10,20,33.9964672954159,0.639989837398374,42.28670634920634,1030.853174603173,25.142760356174954,0
3913,4,0,1,50,0.0,0.0196078431372549,0.9803921568627451,51,1400,1100,300,0.7857142857142857,17,11,6,324.96877648152605,0.4380392156862745,0.2995496366700747,0.19892424529303296,132997.0322265038,-1556.0234323357981,131441.008794168,2384,1,401.88235294117646,42,9,20,33.74686863942383,0.6401289682539683,42.126937984496124,1031.4922480620153,24.55933923957179,0
3914,4,0,1,49,0.0,0.02,0.98,50,1750,1600,150,0.9142857142857143,19,16,3,322.72049277086546,0.43585884353741494,0.22691783931003195,0.18276433048180382,130026.3899605625,-1581.6841732564355,128444.70578730607,2385,2,410.72,44,6,14,36.794522620668786,0.607717803030303,45.02314814814815,1019.9074074074082,23.179713804713824,8
3915,4,1,0,50,0.02,0.0,1.0,50,1600,1200,400,0.75,20,12,8,319.40257409088645,0.4345748299319728,0.23523947750362795,0.18187468888315822,130238.95747599487,-1680.2683470507227,128558.68912894416,2386,0,411.56,44,6,15,36.664134313014046,0.6098484848484849,44.81481481481483,1020.7407407407436,23.198653198653265,0
3916,4,1,2,49,0.0196078431372549,0.0392156862745098,0.9607843137254902,51,1450,1100,350,0.7586206896551724,18,11,7,320.2617477899314,0.4353431372549019,0.254903777166263,0.18418889543912162,130625.35085406638,-1833.135079266625,128792.21577479976,2387,0,404.47058823529414,43,8,13,36.25183341052958,0.6150678294573644,44.43655303030304,1022.253787878789,23.773343904157883,0
3917,4,0,0,49,0.0,0.0,1.0,49,1200,600,600,0.5,18,6,12,322.44974175532195,0.4328231292517007,0.2515532060517365,0.18533133719419323,130601.15089101257,-1377.5385244490194,129223.61236656355,2388,1,420.2448979591837,43,6,13,36.22035390031499,0.6148255813953488,44.46022727272728,1022.1590909090922,23.77114164904866,0
3918,4,0,1,48,0.0,0.02040816326530612,0.9795918367346939,49,850,700,150,0.8235294117647058,10,7,3,324.3895446654253,0.43266369047619047,0.2531300139279713,0.1870305762328847,130722.17312507179,-1319.0187564566081,129403.15436861517,2389,2,421.2448979591837,43,6,13,36.04857317035527,0.6160368217054264,44.34185606060606,1022.6325757575761,23.782152924594794,0
3919,4,0,0,48,0.0,0.0,1.0,48,1050,800,250,0.7619047619047619,13,8,5,330.592594973701,0.4317929964539007,0.2514624621843553,0.1904876649160098,130697.96419450185,-958.4441718319538,129739.5200226699,2390,3,430.9583333333333,43,5,13,35.914444032845594,0.6157945736434108,44.365530303030305,1022.537878787879,23.779950669485558,0
3920,4,0,0,48,0.0,0.0,1.0,48,1450,800,650,0.5517241379310345,21,8,13,329.0513075600851,0.4314328457446808,0.2500057854299731,0.1901948248031889,130819.03126614158,-990.7653416264889,129828.26592451509,2391,4,431.9583333333333,43,5,13,35.8315784195748,0.6170058139534884,44.24715909090909,1023.0113636363641,23.79096194503172,0
3921,4,0,0,48,0.0,0.0,1.0,48,1200,600,600,0.5,18,6,12,329.7270956897535,0.43146054964539005,0.24862946038065936,0.1908755439741996,130877.70168895766,-969.2151063099959,129908.48658264766,2392,5,432.9583333333333,44,4,13,35.75505987391791,0.6162405303030303,44.189814814814824,1023.2407407407422,23.255471380471416,0
3922,4,0,1,47,0.0,0.020833333333333332,0.9791666666666666,48,1300,1000,300,0.7692307692307693,16,10,6,332.4768905932112,0.43140514184397166,0.24538565313074656,0.1931790320172958,131019.8570387518,-887.7850651577432,130132.07197359405,2393,6,433.9583333333333,44,4,14,35.541210696089955,0.6176609848484849,44.05092592592593,1023.796296296297,23.268097643097658,0
3923,4,0,0,47,0.0,0.0,1.0,47,1200,900,300,0.75,15,9,6,293.47085663562507,0.4296754548257786,0.14218864859681934,0.17199428713336992,131351.3370763103,-1683.2318981173437,129668.10517819296,2394,7,443.74468085106383,45,2,13,36.20649980854759,0.6196759259259259,43.72735507246377,1025.0905797101464,22.779790660225476,8
3924,4,1,1,47,0.020833333333333332,0.020833333333333332,0.9791666666666666,48,1200,800,400,0.6666666666666666,16,8,8,294.1400618592677,0.4306756057919621,0.15944751540277569,0.17393021635375877,131691.85167370836,-1852.8301204667955,129839.02155324156,2395,0,435.4791666666667,46,2,12,35.84762048713076,0.6218297101449275,43.39539007092198,1026.4184397163103,22.31344434165892,0
3925,4,1,0,48,0.020833333333333332,0.0,1.0,48,950,600,350,0.631578947368421,13,6,7,294.10137817091,0.43036162825059104,0.16432467046566512,0.17432354974285974,131782.8619347618,-1848.49573713596,129934.36619762584,2396,0,436.4583333333333,46,2,13,35.75735336441605,0.6227355072463768,43.30673758865248,1026.7730496453898,22.32115325316065,0
3926,4,0,0,48,0.0,0.0,1.0,48,1100,900,200,0.8181818181818182,13,9,4,292.76282395288536,0.4304447399527187,0.16337397496763106,0.1738419946434738,131851.14026111597,-1879.7775671495501,129971.36269396642,2397,1,437.4583333333333,46,2,13,35.72327722629839,0.6234148550724637,43.24024822695035,1027.0390070921974,22.3269349367869,0
3927,4,0,0,48,0.0,0.0,1.0,48,1450,1000,450,0.6896551724137931,19,10,9,295.46015347336913,0.4303893321513002,0.17007569222806862,0.17628767674816095,132033.30224994966,-1797.8840507268305,130235.41819922283,2398,2,438.4583333333333,46,2,15,35.47147704074296,0.6252264492753623,43.062943262411345,1027.7482269503544,22.342352759790312,0
3928,4,0,0,48,0.0,0.0,1.0,48,1250,800,450,0.64,17,8,9,298.1039445938993,0.42945663416075647,0.17245589840832043,0.17883153904748786,132238.38479578475,-1715.8431731301403,130522.54162265461,2399,3,439.4583333333333,46,2,15,35.1981339424237,0.6272644927536232,42.863475177304956,1028.5460992907788,22.359697810669104,0
3929,4,0,1,47,0.0,0.020833333333333332,0.9791666666666666,48,1500,1000,500,0.6666666666666666,20,10,10,296.06611874175763,0.4293458185579196,0.1756311390660008,0.17803851679361837,132329.5836791407,-1764.3387530808488,130565.24492605984,2400,4,440.4583333333333,46,2,16,35.159256706301335,0.6281702898550725,42.77482269503545,1028.9007092198567,22.3674067221708,0
3930,4,0,1,46,0.0,0.02127659574468085,0.9787234042553191,47,1250,800,450,0.64,17,8,9,303.40458242412205,0.4290009250693802,0.18176505843572044,0.18255699450942942,132351.39676538543,-1368.7959462297847,130982.60081915565,2401,5,450.1063829787234,45,2,17,34.94865023474178,0.6296296296296297,42.7536231884058,1028.985507246377,22.866344605475042,0
3931,4,0,0,46,0.0,0.0,1.0,46,1450,1000,450,0.6896551724137931,19,10,9,303.7949779020436,0.4267109500805153,0.19575273074650856,0.18339037147699272,132474.58944515302,-1150.9523913338203,131323.6370538192,2402,6,460.5869565217391,41,5,18,34.81527657319071,0.6364329268292683,42.63392857142857,1029.4642857142853,25.108885017421592,0
3932,4,0,0,46,0.0,0.0,1.0,46,1500,1000,500,0.6666666666666666,20,10,10,305.446661482843,0.425372383252818,0.20620177544069063,0.18548340100211702,132697.34883908718,-1093.6075618953237,131603.74127719185,2403,7,461.5869565217391,42,4,13,34.549868334430535,0.6371527777777778,42.417635658914726,1030.329457364341,24.531653746770022,0
3933,4,0,0,46,0.0,0.0,1.0,46,1350,1000,350,0.7407407407407407,17,10,7,305.9297091412744,0.42485909822866347,0.20953334423014036,0.18664518952197,132872.12306952692,-1070.0940072712128,131802.0290622557,2404,8,462.5869565217391,42,4,13,34.36266447368421,0.6388888888888888,42.24806201550387,1031.0077519379834,24.54780361757103,0
3934,4,0,0,46,0.0,0.0,1.0,46,1300,1000,300,0.7692307692307693,16,10,6,303.88298749691285,0.42434581320450887,0.2117309872423312,0.18594907302339211,132983.40292125824,-1117.7212465564598,131865.68167470177,2405,9,463.5869565217391,43,3,13,34.304229403843806,0.6385658914728682,42.14015151515152,1031.4393939393954,23.98696264975338,0
3935,4,0,1,45,0.0,0.021739130434782608,0.9782608695652174,46,1800,1300,500,0.7222222222222222,23,13,10,304.706708136082,0.42359098228663444,0.21025397559983094,0.1871867928560892,133129.9545526286,-1086.8819587924659,132043.07259383614,2406,10,464.5869565217391,43,3,14,34.13661528109134,0.6400193798449613,41.99810606060606,1032.007575757576,24.000176180408744,0
3936,4,0,0,45,0.0,0.0,1.0,45,1350,1100,250,0.8148148148148148,16,11,5,309.21801229914706,0.4232744107744108,0.20928951486697955,0.18991763731175984,133122.0000676041,-767.2559491617101,132354.74411844238,2407,11,474.24444444444447,42,3,14,34.02816901408451,0.6413690476190477,42.00581395348837,1031.9767441860463,24.57087486157253,0
3937,4,1,0,46,0.021739130434782608,0.0,1.0,46,950,500,450,0.5263157894736842,14,5,9,306.4632907069866,0.42404388083735906,0.21360798603082487,0.1892575678624232,133325.48227301415,-1028.1267935032208,132297.35547951094,2408,0,464.9130434782609,43,3,15,33.896096949691305,0.6419573643410852,41.80871212121212,1032.7651515151508,24.01779422128258,0
3938,4,0,2,44,0.0,0.043478260869565216,0.9565217391304348,46,1500,1200,300,0.8,18,12,6,305.02081165452677,0.423299114331723,0.211605890603086,0.1891129032258065,133472.2222222221,-1057.5581812442651,132414.66404097783,2409,1,465.9130434782609,42,4,16,33.7869623655914,0.6448412698412698,41.666666666666664,1033.3333333333326,24.603174603174587,0
3939,4,0,0,44,0.0,0.0,1.0,44,1150,700,450,0.6086956521739131,16,7,9,315.0845975075971,0.42262376673713886,0.20653267831708622,0.194694882599042,133347.0900655759,-396.87715957574915,132950.21290600015,2410,2,483.45454545454544,42,2,16,33.651921693717355,0.6436011904761905,41.78779069767442,1032.8488372093018,24.59163898117385,0
3940,4,0,1,43,0.0,0.022727272727272728,0.9772727272727273,44,700,200,500,0.2857142857142857,12,2,10,313.6174597108627,0.4221172480620155,0.20303641308517917,0.19431161957564982,133447.1910961633,-429.7261845742317,133017.46491158908,2411,3,484.45454545454544,42,2,16,33.58986682922254,0.644593253968254,41.69089147286822,1033.2364341085286,24.60086747877449,0
3941,4,0,0,43,0.0,0.0,1.0,43,1200,800,400,0.6666666666666666,16,8,8,316.7273673257024,0.4213270579549649,0.1971117779444862,0.19637096774193563,133472.22222222228,-145.1365415239363,133327.08568069834,2412,4,494.06976744186045,40,3,16,33.484543010752695,0.6479166666666667,41.66666666666667,1033.333333333334,25.83333333333335,0
3942,4,0,0,43,0.0,0.0,1.0,43,1350,900,450,0.6666666666666666,18,9,9,317.3724276108066,0.42098098929494276,0.19286803417162202,0.19746970679417342,133603.521434414,-119.58521300152037,133483.93622141247,2413,5,495.06976744186045,40,3,16,33.33681477112617,0.64921875,41.53963414634146,1033.8414634146338,25.846036585365844,0
3943,4,0,0,43,0.0,0.0,1.0,43,1200,900,300,0.75,15,9,6,317.1419649390846,0.4205195644149133,0.19036126956267352,0.19774734284437054,133682.33194527077,-120.74451384756739,133561.5874314232,2414,6,496.06976744186045,40,3,17,33.264134564989526,0.65,41.463414634146346,1034.1463414634154,25.853658536585385,0
3944,4,0,0,43,0.0,0.0,1.0,43,950,600,350,0.631578947368421,13,6,7,315.5408356447685,0.41985049833887045,0.18654457307223948,0.19716943928963163,133761.1656937835,-158.57800003304226,133602.58769375045,2415,7,497.06976744186045,40,3,13,33.22690506598553,0.65078125,41.38719512195122,1034.4512195121954,25.861280487804883,0
3945,4,0,0,43,0.0,0.0,1.0,43,450,200,250,0.4444444444444444,7,2,5,316.1386358917861,0.41994278331487633,0.18441572679557594,0.19796578048279007,133840.02267995247,-137.59956044682016,133702.42311950563,2416,8,498.06976744186045,40,3,13,33.13281608066522,0.6515625,41.3109756097561,1034.756097560976,25.868902439024403,0
3946,4,0,0,43,0.0,0.0,1.0,43,1050,700,350,0.6666666666666666,14,7,7,315.4157145598753,0.4192737172388335,0.18287235791665934,0.19779517469690713,133892.60691387404,-153.63354319517876,133738.97337067887,2417,9,499.06976744186045,40,3,13,33.099101531814625,0.6520833333333333,41.26016260162602,1034.9593495934962,25.873983739837406,0
3947,4,0,0,43,0.0,0.0,1.0,43,800,500,300,0.625,11,5,6,311.9607937908717,0.4189737910668143,0.18392505370497547,0.1961218580723816,133985.28045477436,-240.3691106072131,133744.91134416714,2418,10,500.06976744186045,41,2,13,33.096173501980346,0.6514227642276422,41.17063492063492,1035.3174603174593,25.25164537359657,0
3948,4,0,0,43,0.0,0.0,1.0,43,1300,900,400,0.6923076923076923,17,9,8,312.3072854124422,0.41874307862679955,0.19027246752738036,0.1966781354863152,134048.58599430617,-227.12999894838728,133821.45599535777,2419,11,501.06976744186045,42,1,13,33.02415707557467,0.6505456349206349,41.109496124031004,1035.5620155038755,24.65623846437799,0
3949,4,0,0,43,0.0,0.0,1.0,43,1450,1000,450,0.6896551724137931,19,10,9,311.333790596203,0.4185585086747878,0.1874129647681384,0.1961990303002486,134073.67345712383,-251.66700468722794,133822.00645243662,2420,12,502.06976744186045,42,1,13,33.0243809256487,0.6507936507936508,41.08527131782945,1035.658914728681,24.65854558877812,0
3950,4,0,2,41,0.0,0.046511627906976744,0.9534883720930233,43,600,300,300,0.5,9,3,6,311.647603603181,0.41828165374677,0.19016724430897258,0.19653104630763407,134098.76326730647,-241.68835631874418,133857.07491098772,2421,13,503.06976744186045,42,1,14,32.99127607821126,0.6510416666666667,41.0610465116279,1035.755813953487,24.66085271317826,0
3951,4,0,0,41,0.0,0.0,1.0,41,1300,1000,300,0.7692307692307693,16,10,6,320.42707716925463,0.4175813008130081,0.1818577958038341,0.20136894726238097,133971.50262946982,385.6194023068201,134357.12203177664,2422,26,511.7317073170732,40,1,14,32.89077582539837,0.6528645833333333,41.18394308943089,1035.264227642276,25.881605691056897,0
3952,4,0,0,41,0.0,0.0,1.0,41,1100,600,500,0.5454545454545454,16,6,10,319.62220827807005,0.41712398373983745,0.17899743625957254,0.20115075232521645,134024.11268300944,367.416571650472,134391.52925465992,2423,27,512.7317073170732,40,1,14,32.85917001995615,0.6533854166666666,41.13313008130081,1035.4674796747966,25.886686991869915,0
3953,4,0,0,41,0.0,0.0,1.0,41,1400,1100,300,0.7857142857142857,17,11,6,324.5887926087927,0.4170985772357723,0.18028778286605718,0.20500979875179892,134155.68300118993,509.08623339283923,134664.76923458278,2424,28,513.7317073170732,40,1,14,32.59944575240338,0.6546875,41.00609756097562,1035.9756097560987,25.899390243902467,0
3954,4,0,0,41,0.0,0.0,1.0,41,1100,700,400,0.6363636363636364,15,7,8,325.93397729338216,0.4166666666666667,0.18527590925183457,0.20615526256100045,134208.32920219458,548.6109045541778,134756.94010674875,2425,29,514.7317073170732,40,1,14,32.51213711259317,0.6552083333333334,40.955284552845534,1036.1788617886189,25.90447154471547,0
3955,4,0,0,41,0.0,0.0,1.0,41,950,600,350,0.631578947368421,13,6,7,314.7005186372068,0.4165650406504065,0.15560658853341724,0.186399537962038,131755.55555555562,116.44689007866225,131872.00244563428,2426,30,515.7317073170732,39,2,16,35.256020021645014,0.6324786324786325,43.333333333333336,1026.6666666666672,26.324786324786338,7
3956,4,0,0,41,0.0,0.0,1.0,41,750,500,250,0.6666666666666666,10,5,5,314.1773275031406,0.4160823170731707,0.14761279343855227,0.1867451854435484,131889.27001953122,87.32367621527686,131976.5936957465,2427,31,516.7317073170732,39,2,17,35.1351494101342,0.6338141025641026,43.203125,1027.1874999999998,26.33814102564102,0
3957,4,0,0,41,0.0,0.0,1.0,41,1100,800,300,0.7272727272727273,14,8,6,310.64326105768595,0.41509146341463415,0.1439634949709181,0.18542752915040456,132049.81689453125,4.077148437499972,132053.89404296875,2428,32,517.7317073170732,39,2,18,35.064799331103686,0.6354166666666667,43.046875,1027.8125,26.354166666666668,0
3958,4,1,0,42,0.023809523809523808,0.0,1.0,42,1450,1200,250,0.8275862068965517,17,12,5,303.4897389247021,0.4168844367015099,0.14052508839238698,0.18296095689460626,132424.15229030346,-362.1257188181547,132062.0265714853,2429,0,506.3809523809524,40,2,19,34.873617693522924,0.6375,42.6829268292683,1029.2682926829275,25.731707317073187,0
3959,4,0,0,42,0.0,0.0,1.0,42,700,600,100,0.8571428571428571,8,6,2,306.3365129516787,0.417090108401084,0.14442000272619215,0.1850623263395023,132502.61423631755,-281.92223957301564,132220.69199674454,2430,1,507.3809523809524,40,2,20,34.72181094330932,0.63828125,42.606707317073166,1029.5731707317063,25.739329268292657,0
3960,4,0,0,42,0.0,0.0,1.0,42,1600,1100,500,0.6875,21,11,10,304.2300429159478,0.417090108401084,0.13625343576009574,0.1843019417186571,132607.2663118019,-331.3771357987916,132275.8891760031,2431,2,508.3809523809524,40,2,21,34.67131228416378,0.6393229166666667,42.50508130081301,1029.9796747967484,25.74949186991871,0
3961,4,0,0,42,0.0,0.0,1.0,42,850,600,250,0.7058823529411765,11,6,5,305.5827770766698,0.4167634533488192,0.14238034169966696,0.1853795697921126,132659.6078413147,-292.30172598982267,132367.30611532487,2432,3,509.3809523809524,40,2,15,34.58411430074643,0.63984375,42.454268292682926,1030.1829268292681,25.754573170731703,0
3962,4,0,0,42,0.0,0.0,1.0,42,1050,700,350,0.6666666666666666,14,7,7,307.5331252084978,0.4164126016260163,0.14288296918215115,0.18708418852665706,132764.32188388176,-234.11463497258563,132530.20724890917,2433,4,510.3809523809524,40,2,15,34.4291325641784,0.6408854166666667,42.352642276422756,1030.5894308943075,25.76473577235769,0
3963,4,0,0,42,0.0,0.0,1.0,42,1300,900,400,0.6923076923076923,17,9,8,307.4378399003874,0.41561411149825783,0.14850439387111347,0.1874188370161974,132842.88452640604,-231.81410701304227,132611.07041939299,2434,5,511.3809523809524,40,2,15,34.353024776551,0.6416666666666666,42.27642276422763,1030.8943089430877,25.772357723577194,0
3964,4,0,0,42,0.0,0.0,1.0,42,1050,700,350,0.6666666666666666,14,7,7,307.0631097970509,0.41523906310491676,0.14569457156938692,0.1873214220620009,132869.07723783763,-240.16158949702327,132628.9156483406,2435,6,512.3809523809524,40,2,15,34.336495810744196,0.6419270833333333,42.25101626016259,1030.9959349593473,25.77489837398368,0
3965,4,0,0,42,0.0,0.0,1.0,42,1050,500,550,0.47619047619047616,16,5,11,305.484054656269,0.41462204800619434,0.14350229203909426,0.18688111336386187,132973.87390318236,-275.72036734090034,132698.15353584147,2436,7,513.3809523809524,40,2,15,34.27246526751403,0.64296875,42.149390243902424,1031.402439024388,25.785060975609703,0
3966,4,0,1,41,0.0,0.023809523809523808,0.9761904761904762,42,1250,800,450,0.64,17,8,9,306.06001786378675,0.4141623112659698,0.1447730673082792,0.1877599614121463,133078.71187991576,-253.9854129486722,132824.72646696708,2437,8,514.3809523809524,40,2,17,34.15287763879312,0.6440104166666667,42.04776422764226,1031.8089430894283,25.79522357723571,0
3967,4,0,0,41,0.0,0.0,1.0,41,1100,800,300,0.7272727272727273,14,8,6,314.13687718739664,0.41234756097560976,0.1388943614799638,0.19252547225643382,133042.01388888867,158.68055555553207,133200.6944444442,2438,9,524.5365853658536,39,2,17,33.98121970920839,0.6452991452991452,42.08333333333332,1031.666666666665,26.45299145299141,0
3968,4,0,0,41,0.0,0.0,1.0,41,1300,1000,300,0.7692307692307693,16,10,6,316.55973175952744,0.4120680894308943,0.14436700337529262,0.1944300844725131,133122.62505425338,228.2524956597132,133350.8775499131,2439,10,525.5365853658536,39,2,18,33.838132128797824,0.6461004273504274,42.00520833333333,1031.9791666666658,26.46100427350425,0
3969,4,0,0,41,0.0,0.0,1.0,41,550,300,250,0.5454545454545454,8,3,5,317.2752552997159,0.4116615853658536,0.1476704978956953,0.19529178757889315,133203.26063368033,252.4197048610871,133455.68033854142,2440,11,526.5365853658536,39,2,18,33.73906828119745,0.6469017094017093,41.92708333333332,1032.291666666665,26.46901709401705,0
3970,4,0,0,41,0.0,0.0,1.0,41,1150,900,250,0.782608695652174,14,9,5,315.75940612649254,0.4119410569105691,0.14568685692910832,0.19449915936107293,133230.1445855033,213.73426649303696,133443.87885199633,2441,12,527.5365853658536,39,2,18,33.7513242861467,0.6471688034188035,41.90104166666666,1032.395833333332,26.471688034188,0
3971,4,0,0,41,0.0,0.0,1.0,41,1300,1100,200,0.8461538461538461,15,11,4,314.6363887524701,0.4114075203252032,0.14756626340086165,0.19465059683457542,133391.50526258672,193.9643012152739,133585.469563802,2442,13,528.5365853658536,39,2,18,33.619143054015,0.6487713675213675,41.744791666666664,1033.0208333333328,26.487713675213662,0
3972,4,0,0,41,0.0,0.0,1.0,41,1250,800,450,0.64,17,8,9,315.07788398185005,0.4116869918699187,0.1527409712223866,0.1954938019086874,133499.82336410627,212.59278556517347,133712.41614967145,2443,14,529.5365853658536,38,3,19,33.499603707915504,0.6515899122807017,41.63995726495727,1033.4401709401714,27.195793972109772,0
3973,4,0,0,41,0.0,0.0,1.0,41,350,200,150,0.5714285714285714,5,2,3,316.6300102157324,0.4114329268292683,0.1557042919266407,0.19674986183925564,133555.03420857983,257.5063691650217,133812.54057774486,2444,15,530.5365853658536,38,3,19,33.404392764857874,0.6521381578947368,41.58653846153846,1033.6538461538457,27.201417004048572,0
3974,4,0,0,41,0.0,0.0,1.0,41,900,600,300,0.6666666666666666,12,6,6,315.73131790203104,0.4113567073170732,0.15258580935845556,0.19677806992747954,133665.49014034984,240.4762720067155,133905.96641235656,2445,16,531.5365853658536,38,3,20,33.3174053793436,0.653234649122807,41.47970085470085,1034.081196581196,27.21266306792621,0
3975,4,0,0,41,0.0,0.0,1.0,41,900,500,400,0.5555555555555556,13,5,8,315.34637154036153,0.4112804878048781,0.14691576637959858,0.19712710882022727,133775.99172921688,237.1547182043908,134013.14644742128,2446,17,532.5365853658536,38,3,14,33.2171503321973,0.6543311403508771,41.37286324786324,1034.5085470085469,27.223909131803865,0
3976,4,0,0,41,0.0,0.0,1.0,41,1400,1200,200,0.8571428571428571,16,12,4,317.43066526577945,0.41013719512195124,0.1534402855639656,0.1993250625897691,133941.82971957413,303.44882296003533,134245.27854253416,2447,18,533.5365853658536,38,3,14,32.99790140021328,0.6559758771929824,41.212606837606835,1035.1495726495727,27.240778227620336,0
3977,4,0,0,41,0.0,0.0,1.0,41,1350,1100,250,0.8148148148148148,16,11,5,320.3708842002709,0.4105436991869919,0.10388455515099992,0.1921836033167363,132237.24500868074,283.6107501347087,132520.85575881545,2448,19,534.5365853658536,39,2,16,34.62671325366283,0.6372863247863247,42.86458333333334,1028.5416666666683,26.37286324786329,8
3978,4,1,0,42,0.023809523809523808,0.0,1.0,42,1150,800,350,0.6956521739130435,15,8,7,318.2511666786516,0.4115490708478513,0.11263161951003342,0.1925477988852602,132558.85959201396,37.50000000000557,132596.35959201396,2449,0,522.7857142857143,39,3,18,34.35877334951784,0.6404914529914529,42.552083333333336,1029.7916666666672,26.404914529914542,0
3979,4,0,0,42,0.0,0.0,1.0,42,900,600,300,0.6666666666666666,12,6,6,319.7866112679308,0.4111014324428959,0.11298088497279624,0.19403003591655466,132666.1512586808,84.9717881944701,132751.12304687526,2450,1,523.7857142857143,39,3,12,34.21174587125042,0.641559829059829,42.44791666666668,1030.2083333333353,26.415598290598343,0
3980,4,0,0,42,0.0,0.0,1.0,42,1050,400,650,0.38095238095238093,17,4,13,323.3041579067406,0.4103513356562137,0.11292681987912356,0.19700849425154615,132827.17013888917,188.71527777780346,133015.88541666698,2451,2,524.7857142857143,39,3,13,33.95984909727835,0.6431623931623931,42.29166666666668,1030.8333333333355,26.43162393162399,0
3981,4,0,1,41,0.0,0.023809523809523808,0.9761904761904762,42,950,800,150,0.8421052631578947,11,8,3,321.23252729313316,0.4097706155632985,0.10404040404040393,0.19630876667913705,132934.57031250006,140.58159722222342,133075.15190972228,2452,3,525.7857142857143,39,3,13,33.90572390572391,0.6442307692307692,42.1875,1031.2500000000005,26.442307692307704,0
3982,4,0,1,40,0.0,0.024390243902439025,0.975609756097561,41,1400,1100,300,0.7857142857142857,17,11,6,348.1796448548542,0.40790142276422764,0.09524258100643479,0.19996195130573574,130570.58572108703,998.740838527213,131569.32655961424,2453,4,537.0975609756098,37,4,14,35.593798054572105,0.6241554054054055,44.490131578947356,1022.0394736842086,27.622688477951584,8
3983,4,0,0,40,0.0,0.0,1.0,40,1050,600,450,0.5714285714285714,15,6,9,353.83059003632354,0.40598290598290593,0.10553320459178206,0.2032073277713227,130570.58572108706,1239.9734774161027,131810.55919850315,2454,25,551.425,37,3,14,35.44941082859492,0.6241554054054055,44.490131578947356,1022.0394736842088,27.62268847795159,0
3984,4,0,0,40,0.0,0.0,1.0,40,1100,900,200,0.8181818181818182,13,9,4,352.3491317891925,0.4057558760683761,0.1012382445141069,0.20288695494720635,130671.89554569351,1208.425788954624,131880.32133464812,2455,26,552.425,38,2,14,35.3846656217346,0.6233552631578947,44.391025641025635,1022.4358974358965,26.906207827260435,0
3985,4,0,0,40,0.0,0.0,1.0,40,1100,900,200,0.8181818181818182,13,9,4,353.39527165962704,0.40536858974358975,0.10471688257417444,0.203777080742527,130726.51855504418,1239.62670757542,131966.1452626196,2456,27,553.425,38,2,14,35.3026187491294,0.6239035087719298,44.337606837606835,1022.6495726495725,26.911830859199277,0
3986,4,0,0,40,0.0,0.0,1.0,40,950,500,450,0.5263157894736842,14,5,9,352.8690353547415,0.4056490384615385,0.0972199018481783,0.20419496988473454,130863.12601587028,1235.5090081452133,132098.6350240155,2457,28,554.425,38,2,14,35.17781316348196,0.6252741228070176,44.20405982905982,1023.1837606837596,26.925888439046304,0
3987,4,1,0,41,0.024390243902439025,0.0,1.0,41,1050,700,350,0.6666666666666666,14,7,7,347.25352794563446,0.40805386178861786,0.1013011106316064,0.20254396167362793,131168.01757812488,909.7113715277638,132077.72894965264,2458,0,541.8780487804878,39,2,16,35.01330418276726,0.6266025641025641,43.90624999999999,1024.374999999999,26.266025641025617,0
3988,4,0,0,41,0.0,0.0,1.0,41,1050,800,250,0.7619047619047619,13,8,5,344.70222751007987,0.4085873983739838,0.09181043029942448,0.20189701897018955,131328.1249999999,854.0147569444299,132182.13975694435,2459,1,542.8780487804878,37,4,17,34.91700542005418,0.6317567567567568,43.74999999999999,1024.9999999999993,27.702702702702684,0
3989,4,1,0,42,0.023809523809523808,0.0,1.0,42,700,400,300,0.5714285714285714,10,4,6,336.3972748772784,0.4095286488579171,0.1005838795120162,0.19869220336276655,131648.63281249997,457.2482638888889,132105.88107638885,2460,0,530.9285714285714,39,3,12,34.80680741642984,0.6314102564102564,43.4375,1026.2499999999998,26.31410256410256,0
3990,4,0,0,42,0.0,0.0,1.0,42,1050,600,450,0.5714285714285714,15,6,9,337.2605166339868,0.4093834688346884,0.10382537427392369,0.19948170053489225,131702.08875868047,483.58289930555065,132185.67165798604,2461,1,531.9285714285714,39,3,12,34.73081997158514,0.6319444444444444,43.385416666666664,1026.4583333333328,26.319444444444432,0
3991,4,0,0,42,0.0,0.0,1.0,42,1400,900,500,0.6428571428571429,19,9,10,335.3644738303795,0.4088511420828494,0.10504201680672232,0.19919841638358715,131862.52170138914,444.40104166669187,132306.92274305582,2462,2,532.9285714285714,39,3,12,34.617985125084516,0.6335470085470085,43.22916666666668,1027.0833333333353,26.335470085470135,0
3992,4,0,1,41,0.0,0.023809523809523808,0.9761904761904762,42,800,600,200,0.75,10,6,4,337.07878107459067,0.40858497870692995,0.10596227945649961,0.2004988503593256,131916.0210503474,493.21831597224224,132409.23936631964,2463,3,533.9285714285714,39,3,13,34.520127763131214,0.6340811965811965,43.17708333333334,1027.291666666668,26.340811965812,0
3993,4,0,0,41,0.0,0.0,1.0,41,1350,1000,350,0.7407407407407407,17,10,7,346.8270985460409,0.40497967479674796,0.09918918987463776,0.2065285576914718,131958.55391418267,953.3604764774362,132911.91439066012,2464,4,547.829268292683,38,3,14,34.2269332085543,0.6362390350877193,43.13568376068375,1027.4572649572629,27.038349077822705,0
3994,4,0,0,41,0.0,0.0,1.0,41,650,500,150,0.7692307692307693,8,5,3,348.6208401581804,0.40530995934959346,0.10658927185258094,0.20795001263607057,132023.05230034716,1005.1974826388841,133028.24978298604,2465,5,548.829268292683,39,2,14,34.1159031015609,0.6351495726495726,43.072916666666664,1027.708333333333,26.35149572649572,0
3995,4,1,0,42,0.023809523809523808,0.0,1.0,42,600,300,300,0.5,9,3,6,341.1225107364846,0.4080163569492838,0.10342702865421183,0.20507864006509308,132319.5725097494,627.4369588208015,132947.0094685702,2466,0,536.7380952380952,40,2,15,34.01035493217438,0.6364583333333333,42.78455284552845,1028.8617886178854,25.721544715447134,0
3996,4,0,0,42,0.0,0.0,1.0,42,950,800,150,0.8421052631578947,11,8,3,340.6281290622717,0.4078590785907859,0.09935363328788571,0.20506880921433207,132372.47973552838,617.9580223292949,132990.43775785767,2467,1,537.7380952380952,41,1,15,33.96990182846492,0.6354166666666667,42.73313492063492,1029.0674603174598,25.099206349206337,0
3997,4,0,0,42,0.0,0.0,1.0,42,1050,700,350,0.6666666666666666,14,7,7,343.2010087000422,0.4077864885791715,0.10693287483077896,0.20751388468325008,132535.48127145882,697.2695536068325,133232.75082506565,2468,2,538.7380952380952,38,4,16,33.739927024970605,0.6419956140350878,42.574786324786324,1029.7008547008545,27.09739091318038,0
3998,4,0,0,42,0.0,0.0,1.0,42,900,700,200,0.7777777777777778,11,7,4,344.52955314896803,0.40805265195509094,0.10560938750111082,0.20892792147561948,132645.51487508218,740.0599934253719,133385.57486850757,2469,3,539.7380952380952,38,4,14,33.59520846297447,0.643092105263158,42.467948717948715,1030.128205128205,27.10863697705803,0
3999,4,0,0,42,0.0,0.0,1.0,42,1100,700,400,0.6363636363636364,15,7,8,346.23870820754223,0.40782278358497875,0.10410095415796694,0.21073595066739179,132783.12108490392,794.9312632405591,133578.05234814447,2470,4,540.7380952380952,38,4,14,33.41302131923569,0.6444627192982456,42.33440170940171,1030.662393162393,27.12269455690508,0
4000,4,0,0,42,0.0,0.0,1.0,42,1250,1100,150,0.88,14,11,3,343.98679922455017,0.40777439024390244,0.0937356602572641,0.20998207459305082,132893.2574169954,742.7052514792877,133635.96266847468,2471,5,541.7380952380952,38,4,14,33.36053258729665,0.6455592105263157,42.2275641025641,1031.0897435897434,27.13394062078272,0
4001,4,0,0,42,0.0,0.0,1.0,42,1350,900,450,0.6666666666666666,18,9,9,345.2581730733085,0.40804055361982194,0.09478359569259509,0.21114275303266392,132961.42713758684,781.2038845486154,133742.63102213547,2472,6,542.7380952380952,39,3,14,33.25937194896139,0.6444978632478633,42.161458333333336,1031.354166666667,26.44497863247864,0
4002,4,0,0,42,0.0,0.0,1.0,42,1100,800,300,0.7272727272727273,14,8,6,342.8454357306719,0.4081252419667054,0.09193014847295955,0.2101201234824614,133042.01388888893,722.5694444444488,133764.58333333337,2473,7,543.7380952380952,39,3,14,33.24077813677976,0.6452991452991452,42.083333333333336,1031.666666666667,26.452991452991462,0
4003,4,0,0,42,0.0,0.0,1.0,42,1250,900,350,0.72,16,9,7,337.78983729203577,0.4081373403019744,0.08540907748350901,0.20780928996821388,133183.59116803834,597.6127181241454,133781.2038861625,2474,8,544.7380952380952,40,2,14,33.22934101276624,0.6450520833333333,41.94613821138212,1032.2154471544725,25.805386178861813,0
4004,4,0,0,42,0.0,0.0,1.0,42,1200,700,500,0.5833333333333334,17,7,10,318.80023053664956,0.4074961285327139,0.028057045258760516,0.18266546462684152,130480.80490037636,-4.863145174142858,130475.94175520222,2475,9,545.7380952380952,38,4,21,36.43513193209943,0.6214364035087719,44.57799145299146,1021.6880341880353,26.886527215474615,8
4005,4,0,0,42,0.0,0.0,1.0,42,1200,700,500,0.5833333333333334,17,7,10,318.90093184495635,0.40731465350367785,0.03408898579293762,0.1831096226908076,130562.68376981534,-72.6876963254964,130489.99607348985,2476,10,546.7380952380952,38,4,17,36.349876297999856,0.6222587719298245,44.49786324786326,1022.0085470085482,26.89496176338285,0
4006,4,0,0,42,0.0,0.0,1.0,42,1400,1000,400,0.7142857142857143,18,10,8,318.8660197619851,0.40639518002322883,0.040903030664835915,0.183866598865164,130726.5185550443,-63.15107020234319,130663.36748484196,2477,11,547.7380952380952,38,4,18,36.18540186655522,0.6239035087719298,44.33760683760684,1022.6495726495734,26.911830859199302,0
4007,4,0,0,42,0.0,0.0,1.0,42,900,600,300,0.6666666666666666,12,6,6,317.41360454985073,0.4054999032133178,0.042864900771427905,0.18347963568476094,130821.45317925369,-95.0981987846971,130726.354980469,2478,12,548.7380952380952,39,3,18,36.126773410718535,0.6231303418803419,44.24479166666668,1023.0208333333351,26.231303418803464,0
4008,4,0,0,42,0.0,0.0,1.0,42,900,400,500,0.4444444444444444,14,4,10,319.8626147897445,0.4051127564847077,0.03810444499362764,0.18566390522970005,130981.34901258693,-20.79264322915634,130960.55636935777,2479,13,549.7380952380952,39,3,20,35.90289084495098,0.624732905982906,44.08854166666667,1023.6458333333344,26.247329059829088,0
4009,4,0,0,42,0.0,0.0,1.0,42,950,600,350,0.631578947368421,13,6,7,319.8367949086772,0.4052942315137437,0.042849391257163916,0.18590631916956787,131034.66932508702,-18.058268229146222,131016.61105685787,2480,14,550.7380952380952,39,3,20,35.8498024553193,0.625267094017094,44.03645833333334,1023.8541666666683,26.252670940170983,0
4010,4,0,0,42,0.0,0.0,1.0,42,1350,800,550,0.5925925925925926,19,8,11,322.7673337127865,0.405524099883856,0.03862692117725697,0.18826180069582116,131168.01757812515,67.35026041668192,131235.36783854183,2481,15,551.7380952380952,39,3,20,35.6403803131991,0.6266025641025641,43.90625000000001,1024.3750000000011,26.26602564102567,0
4011,4,0,0,42,0.0,0.0,1.0,42,650,300,350,0.46153846153846156,10,3,7,321.6293368213073,0.4052821331784746,0.03910803849803446,0.18785903544978508,131221.37586805565,40.92881944445463,131262.30468750012,2482,16,552.7380952380952,39,3,20,35.61576521621256,0.6271367521367521,43.85416666666667,1024.5833333333342,26.271367521367544,0
4012,4,0,1,41,0.0,0.023809523809523808,0.9761904761904762,42,1200,900,300,0.75,15,9,6,319.5299386697637,0.4056329849012776,0.04486276673490819,0.18702290699415872,131301.43364800356,-9.052191840267199,131292.38145616328,2483,17,553.7380952380952,39,3,20,35.58891909746925,0.6279380341880342,43.77604166666667,1024.8958333333342,26.279380341880362,0
4013,4,0,0,41,0.0,0.0,1.0,41,950,800,150,0.8421052631578947,11,8,3,320.2559516386901,0.40477642276422765,0.04645126942401778,0.1791966508024118,129554.63927469116,186.24192226078003,129740.88119695194,2484,18,566.1219512195122,38,3,15,37.33515234197362,0.6121162280701755,45.4861111111111,1018.0555555555538,26.790935672514575,8
4014,4,0,0,41,0.0,0.0,1.0,41,800,500,300,0.625,11,5,6,317.1265479306014,0.4046493902439024,0.04450920122949187,0.17776543191339197,129625.34722222204,21.527777777758104,129646.8749999998,2485,19,567.1219512195122,39,2,15,37.343153300600115,0.6111111111111112,45.41666666666666,1018.3333333333319,26.111111111111075,0
4015,4,0,0,41,0.0,0.0,1.0,41,1200,900,300,0.75,15,9,6,316.54874913730254,0.4042428861788618,0.044146366404864246,0.17780185053496167,129704.91672092024,11.58582899306549,129716.5025499133,2486,20,568.1219512195122,39,2,15,37.27726505777687,0.6119123931623931,45.33854166666667,1018.6458333333342,26.119123931623953,0
4016,4,0,0,41,0.0,0.0,1.0,41,750,500,250,0.6666666666666666,10,5,5,316.11610858101125,0.40401422764227646,0.04010175071075839,0.17767905413346488,129731.44531250001,2.039930555555486,129733.48524305558,2487,21,569.1219512195122,39,2,15,37.26141785957736,0.6121794871794872,45.3125,1018.7500000000001,26.121794871794876,0
4017,4,1,1,41,0.023809523809523808,0.023809523809523808,0.9761904761904762,42,1150,1000,150,0.8695652173913043,13,10,3,314.2178512373027,0.40781068524970965,0.029152488408652477,0.18118634168936495,130726.51855504401,-130.4253757579285,130596.09317928608,2488,0,556.547619047619,38,4,13,36.30423805543947,0.6239035087719298,44.33760683760683,1022.649572649571,26.911830859199238,8
4018,4,0,1,40,0.0,0.024390243902439025,0.975609756097561,41,1000,600,400,0.6,14,6,8,320.9221445677659,0.4040650406504065,0.024743498159152555,0.18430778247172788,130570.58572108718,180.59847741611628,130751.1841985033,2489,23,571.1219512195122,37,4,13,36.29025408575617,0.6241554054054055,44.49013157894736,1022.03947368421,27.62268847795162,0
4019,4,0,0,40,0.0,0.0,1.0,40,1350,1000,350,0.7407407407407407,17,10,7,336.4038978140305,0.40260416666666665,0.10800011046062075,0.1899853079794396,129917.93894823875,832.624996564372,130750.56394480311,2490,24,582.0,36,4,18,36.55556169225671,0.6195023148148149,45.1295045045045,1019.4819819819817,28.318943943943935,8
4020,4,0,0,40,0.0,0.0,1.0,40,1200,900,300,0.75,15,9,6,333.3109876453943,0.40211004273504275,0.10774815060174436,0.1887928464730668,130032.7708409424,668.2702550523561,130701.04109599475,2491,25,583.0,36,4,18,36.51802473225128,0.6206597222222222,45.016891891891895,1019.9324324324333,28.33145645645648,0
4021,4,0,0,40,0.0,0.0,1.0,40,1750,1400,350,0.8,21,14,7,332.66161586960607,0.4014556623931624,0.10574928271904582,0.1891204242791953,130176.38204082474,660.9371195519948,130837.31916037673,2492,26,584.0,36,4,20,36.38913411314646,0.6221064814814814,44.87612612612613,1020.4954954954966,28.347097097097127,0
4022,4,1,0,41,0.024390243902439025,0.0,1.0,41,750,500,250,0.6666666666666666,10,5,5,328.89156374232505,0.4034806910569106,0.11471154156230878,0.18892530585603448,130578.91506371257,389.2892470173156,130968.20431072988,2493,0,570.7317073170732,36,5,14,36.078209930953435,0.6261574074074074,44.481981981981995,1022.0720720720738,28.390890890890937,0
4023,4,0,1,40,0.0,0.024390243902439025,0.975609756097561,41,950,800,150,0.8421052631578947,11,8,3,328.21170421532673,0.40228658536585366,0.11162483487450436,0.1896612672450404,130809.21292914564,386.6229405081083,131195.83586965373,2494,1,571.7317073170732,36,5,18,35.86296418611478,0.6284722222222222,44.25675675675677,1022.9729729729752,28.415915915915978,0
4024,4,0,0,40,0.0,0.0,1.0,40,1400,1100,300,0.7857142857142857,17,11,6,330.29963625161815,0.40102831196581196,0.11408988128886399,0.19182536327285368,131002.08340031296,653.988099065504,131656.07149937845,2495,2,575.15,35,5,18,35.614871867345016,0.6324404761904762,44.06828703703704,1023.7268518518521,29.24933862433863,0
4025,4,1,1,40,0.024390243902439025,0.024390243902439025,0.975609756097561,41,1000,800,200,0.8,12,8,4,326.45181407588126,0.4046493902439024,0.12722036940303494,0.19164047499425557,131414.71021274678,380.1141090415039,131794.82432178827,2496,0,562.0975609756098,36,5,20,35.29745561047042,0.6345486111111112,43.665540540540555,1025.33783783784,28.481606606606665,0
4026,4,0,0,40,0.0,0.0,1.0,40,1300,900,400,0.6923076923076923,17,9,8,334.1647074139286,0.40344551282051283,0.13681448882870706,0.19663795731090544,131506.13667052472,788.9419367284047,132295.07860725312,2497,1,568.575,35,5,21,35.00761679079216,0.6375,43.57638888888889,1025.6944444444448,29.305555555555564,0
4027,4,0,0,40,0.0,0.0,1.0,40,850,400,450,0.47058823529411764,13,4,9,334.77107001917244,0.403392094017094,0.13013196480938416,0.1976085423961375,131624.8780971366,812.8402563443169,132437.71835348092,2498,2,569.575,35,5,17,34.872452816001186,0.6386904761904761,43.46064814814815,1026.1574074074083,29.318783068783095,0
4028,4,0,0,40,0.0,0.0,1.0,40,1300,1200,100,0.9230769230769231,14,12,2,331.2808809941708,0.4027644230769231,0.1325921542103481,0.19631213729454175,131773.38023244598,730.8002989969129,132504.1805314429,2499,3,570.575,35,5,18,34.81252113628679,0.6401785714285715,43.31597222222222,1026.736111111111,29.33531746031746,0
4029,4,0,0,40,0.0,0.0,1.0,40,950,500,450,0.5263157894736842,14,5,9,333.88329102362087,0.4031383547008547,0.13544624746450307,0.19831862948752413,131862.52170138885,805.3385416666625,132667.8602430555,2500,4,571.575,35,5,18,34.656017579445574,0.6410714285714285,43.229166666666664,1027.083333333333,29.345238095238088,0
4030,4,0,1,39,0.0,0.025,0.975,40,1200,900,300,0.75,15,9,6,335.94264879956023,0.4031650641025641,0.13830667868003177,0.20032469971063088,132011.15779588904,869.635604209534,132880.79340009857,2501,5,572.575,35,5,19,34.45360307091639,0.6425595238095239,43.08449074074074,1027.662037037037,29.361772486772484,0
4031,4,0,0,39,0.0,0.0,1.0,39,600,300,300,0.5,9,3,6,341.60087828698494,0.40134390463337827,0.14810450494163008,0.20353910049878213,131981.4238790295,1216.9940629286662,133198.41794195815,2502,6,587.3589743589744,35,4,19,34.33815799354208,0.6422619047619047,43.113425925925924,1027.5462962962963,29.358465608465607,0
4032,4,0,0,39,0.0,0.0,1.0,39,950,800,150,0.8421052631578947,11,8,3,340.13878743608484,0.40123144399460187,0.15162855162855182,0.20298605056669575,132040.89506172828,1182.4459876543106,133223.34104938258,2503,7,588.3589743589744,35,4,19,34.31587837837838,0.6428571428571428,43.05555555555555,1027.777777777777,29.36507936507934,0
4033,4,0,1,38,0.0,0.02564102564102564,0.9743589743589743,39,1400,1100,300,0.7857142857142857,17,11,6,338.0796172175377,0.40075348627980206,0.1485048749996396,0.2019156072971722,132070.63567654742,1130.0779910408028,133200.71366758822,2504,8,589.3589743589744,35,4,19,34.33887418834216,0.643154761904762,43.02662037037037,1027.893518518518,29.36838624338623,0
4034,4,0,0,38,0.0,0.0,1.0,38,950,700,250,0.7368421052631579,12,7,5,344.4805559995502,0.4008712660028449,0.15202544073078084,0.20519059205190582,131969.53124999988,1492.1874999999866,133461.71874999988,2505,9,601.8947368421053,34,4,19,34.276155717761554,0.6443014705882353,43.12499999999999,1027.499999999999,30.22058823529409,0
4035,4,0,0,38,0.0,0.0,1.0,38,1200,1100,100,0.9166666666666666,13,11,2,343.56413634201033,0.40042674253200566,0.1430682961021541,0.20530631953724965,132091.88102324255,1476.4066043083735,133568.28762755092,2506,10,602.8947368421053,34,4,19,34.176558579424814,0.6455269607843137,43.00595238095237,1027.9761904761897,30.23459383753499,0
4036,4,0,0,38,0.0,0.0,1.0,38,750,400,350,0.5333333333333333,11,4,7,345.44939316573056,0.4010787102892366,0.14606039929085357,0.20710182564599186,132214.28748582752,1534.6690759637,133748.95656179122,2507,11,603.8947368421053,34,4,20,34.004948489408484,0.6467524509803921,42.88690476190475,1028.4523809523798,30.248599439775877,0
4037,4,0,0,38,0.0,0.0,1.0,38,1200,700,500,0.5833333333333334,17,7,10,342.08067662148216,0.40084163110478904,0.14542936288088626,0.20608274908659985,132398.00347222193,1458.1597222221842,133856.16319444412,2508,12,604.8947368421053,34,4,20,33.90688259109311,0.6485906862745099,42.708333333333314,1029.1666666666642,30.269607843137184,0
4038,4,0,0,38,0.0,0.0,1.0,38,650,300,350,0.46153846153846156,10,3,7,338.9167259557832,0.40017484589853014,0.13818908900561833,0.20450892737890097,132459.2704790246,1378.5324546484862,133837.80293367308,2509,13,605.8947368421053,34,4,20,33.92674723410818,0.649203431372549,42.648809523809504,1029.4047619047592,30.276610644257623,0
4039,4,0,0,38,0.0,0.0,1.0,38,1100,900,200,0.8181818181818182,13,9,4,341.32445198521197,0.3986190137505927,0.14810083461079948,0.20680246208515748,132612.49999999974,1452.7777777777487,134065.2777777775,2510,14,606.8947368421053,34,4,20,33.7108953613808,0.6507352941176471,42.499999999999986,1029.999999999998,30.294117647058762,0
4040,4,0,0,38,0.0,0.0,1.0,38,900,600,300,0.6666666666666666,12,6,6,342.87730284849374,0.39814485538169747,0.14150817200116728,0.20842316948430895,132735.14739229012,1502.373866213134,134237.52125850326,2511,15,607.8947368421053,34,4,17,33.547779959950695,0.6519607843137255,42.38095238095237,1030.4761904761895,30.30812324929969,0
4041,4,0,0,38,0.0,0.0,1.0,38,1100,700,400,0.6363636363636364,15,7,8,361.5025034446621,0.3977299668089142,0.13684210526315765,0.20827682305060483,130694.03863322778,1849.244430241045,132543.28306346884,2512,16,608.8947368421053,36,2,17,35.12825807635829,0.6273148148148149,44.369369369369366,1022.5225225225222,28.403403403403395,8
4042,4,0,0,38,0.0,0.0,1.0,38,1000,800,200,0.8,12,8,4,362.3873254197192,0.396633475580844,0.13637048367285476,0.2094100804142955,130809.21292914521,1880.720162730286,132689.93309187551,2513,17,609.8947368421053,36,2,17,34.98894576544842,0.6284722222222222,44.25675675675675,1022.9729729729718,28.415915915915882,0
4043,4,0,0,38,0.0,0.0,1.0,38,750,500,250,0.6666666666666666,10,5,5,361.0240279466892,0.39654457088667616,0.13575297303661849,0.18808594462956887,126694.89590942298,1547.9803283012814,128242.87623772427,2514,18,610.8947368421053,36,2,16,39.22422632363907,0.5868055555555556,48.310810810810814,1006.7567567567571,27.965465465465474,8
4044,4,4,4,38,0.09523809523809523,0.09523809523809523,0.9047619047619048,42,650,400,250,0.6153846153846154,9,4,5,332.3781740603015,0.4108836624080527,0.14207674411756055,0.17737805526584402,127670.361328125,87.58971439767498,127757.95104252268,2515,0,553.6190476190476,39,3,14,38.946007696007705,0.5913461538461539,47.34375,1010.625,25.91346153846154,0
4045,4,2,2,38,0.05,0.05,0.95,40,950,600,350,0.631578947368421,13,6,7,345.23641111432715,0.4080662393162393,0.14522953247302772,0.18356946179273592,127523.29082657595,805.1366516911228,128328.42747826707,2516,0,578.4,38,2,15,38.77172801635991,0.5915570175438596,47.48931623931623,1010.0427350427339,26.580071974808785,0
4046,4,1,0,39,0.02564102564102564,0.0,1.0,39,1000,900,100,0.9,11,9,2,363.9835361568159,0.40221547458389567,0.17717742788287594,0.19385805214733548,127590.03371229612,1488.134329793786,129078.1680420899,2517,0,594.2051282051282,37,2,16,38.22986759279357,0.5940315315315315,47.42324561403509,1010.30701754386,27.30559506875297,0
4047,4,0,0,39,0.0,0.0,1.0,39,1600,1400,200,0.875,18,14,4,362.0955631120001,0.40207489878542507,0.1835966390292998,0.19391668310214105,127811.68845221626,1456.0090604801667,129267.69751269642,2518,1,595.2051282051282,37,2,17,38.05031446540881,0.5962837837837838,47.20394736842106,1011.1842105263173,27.329302987197764,0
4048,4,2,0,41,0.04878048780487805,0.0,1.0,41,1100,800,300,0.7272727272727273,14,8,6,357.240367425528,0.4086382113821138,0.20318939707116557,0.19483109114215802,128540.34423828154,983.9599609375291,129524.30419921907,2519,0,567.1219512195122,39,2,15,37.42777349768875,0.6001602564102564,46.484375000000014,1014.0625000000023,26.001602564102622,0
4049,4,0,1,40,0.0,0.024390243902439025,0.975609756097561,41,1150,800,350,0.6956521739130435,15,8,7,353.6479969069257,0.4083333333333334,0.20247559222357414,0.1932561276026739,128619.58007812529,897.2113715278061,129516.7914496531,2520,1,568.1219512195122,39,2,15,37.43795782843843,0.6009615384615384,46.406250000000014,1014.3750000000023,26.009615384615444,0
4050,4,0,0,40,0.0,0.0,1.0,40,950,600,350,0.631578947368421,13,6,7,353.97301007020104,0.40840010683760686,0.19347173981686128,0.194286399114788,128794.39153928336,1117.9476906640343,129912.33922994739,2521,2,561.325,38,2,16,37.251341964003785,0.6044407894736843,46.23397435897436,1015.0641025641025,26.71221322537112,0
4051,4,1,0,41,0.024390243902439025,0.0,1.0,41,1300,700,600,0.5384615384615384,19,7,12,350.29152209659486,0.41176321138211386,0.196972159367929,0.19360304804828787,129069.04432508674,842.3583984374952,129911.40272352424,2522,0,548.609756097561,39,2,18,37.06485990090551,0.6055021367521367,45.963541666666664,1016.1458333333328,26.055021367521356,0
4052,4,1,0,42,0.023809523809523808,0.0,1.0,42,1400,1100,300,0.7857142857142857,17,11,6,345.22208102750915,0.4158923732094464,0.189280325193238,0.19225513011844098,129368.65790435506,532.3869108162966,129901.04481517135,2523,0,536.5238095238095,37,5,19,36.88878709491989,0.6120495495495495,45.6688596491228,1017.3245614035077,27.495258416311017,0
4053,4,0,1,41,0.0,0.023809523809523808,0.9761904761904762,42,1150,900,250,0.782608695652174,14,9,5,343.2573566283946,0.41600125822686795,0.18708289089631336,0.19183973760273226,129508.13140822163,490.92376981377333,129999.0551780354,2524,1,537.5238095238095,37,5,14,36.796990017594894,0.6134572072072072,45.53179824561403,1017.8728070175428,27.510075865338994,0
4054,4,0,1,40,0.0,0.024390243902439025,0.975609756097561,41,1400,700,700,0.5,21,7,14,352.22251028349376,0.4117123983739837,0.19180729655902184,0.19646188906923745,129430.46932067194,917.6649622595517,130348.1342829315,2525,3,551.609756097561,36,5,14,36.64785303231519,0.6145833333333333,45.608108108108105,1017.5675675675668,28.265765765765746,0
4055,4,0,0,40,0.0,0.0,1.0,40,950,500,450,0.5263157894736842,14,5,9,367.11556791076265,0.4111912393162393,0.20881187550246882,0.1924428205779056,126946.17419249407,1354.418141532899,128300.59233402697,2526,4,561.775,35,5,19,38.81228226331304,0.5913690476190476,48.061342592592595,1007.7546296296302,28.792989417989435,8
4056,4,2,0,42,0.047619047619047616,0.0,1.0,42,850,600,250,0.7058823529411765,11,6,5,363.32304259867163,0.4167997483546264,0.25021122714522326,0.18890116864263035,126612.30867346932,854.2562361557191,127466.56490962504,2527,0,535.9761904761905,34,8,15,39.25138987461557,0.5900735294117647,48.39285714285714,1006.4285714285709,29.60084033613444,8
4057,4,2,0,44,0.045454545454545456,0.0,1.0,44,1750,1400,350,0.8,21,14,7,353.761592175916,0.42169881959126143,0.2707818994343576,0.1881339070639374,127530.03532503829,223.9526988457059,127753.988023884,2528,0,512.5681818181819,35,9,16,38.54954451701616,0.5973214285714286,47.48263888888887,1010.0694444444421,28.859126984126917,0
4058,4,0,0,44,0.0,0.0,1.0,44,1300,900,400,0.6923076923076923,17,9,8,368.367425276051,0.42166578576462294,0.27848339541887923,0.19118436053919913,126539.80070790999,524.1050164206345,127063.90572433063,2529,1,513.5681818181819,37,7,14,39.19917901772739,0.5833333333333333,48.464912280701746,1006.140350877192,27.192982456140324,8
4059,4,3,1,46,0.06382978723404255,0.02127659574468085,0.9787234042553191,47,1100,800,300,0.7272727272727273,14,8,6,352.2619460770645,0.4258980881899476,0.30537934448732473,0.18743031514680047,127550.26989051426,-411.37415511605843,127138.8957353982,2530,0,481.72340425531917,38,9,14,38.56667548034548,0.5918311403508771,47.462606837606835,1010.1495726495725,26.582883490778226,0
4060,4,0,0,46,0.0,0.0,1.0,46,1300,800,500,0.6153846153846154,18,8,10,357.52350730411575,0.4242451690821256,0.3109300041551768,0.18963574051015547,127423.91889812256,-88.59072022160069,127335.32817790096,2531,1,493.1521739130435,37,9,14,38.56338690993339,0.5923423423423424,47.58771929824562,1009.649122807018,27.287814129919404,0
4061,4,3,0,49,0.061224489795918366,0.0,1.0,49,1700,1400,300,0.8235294117647058,20,14,6,327.4145630192616,0.434187216553288,0.3106170338879919,0.17142279084966167,126896.67556787451,-1396.6211602467583,125500.05440762776,2532,0,463.8979591836735,42,7,19,39.86323491697121,0.5788690476190477,48.110465116279066,1007.5581395348836,23.989479512735322,8
4062,4,2,2,49,0.0392156862745098,0.0392156862745098,0.9607843137254902,51,1400,800,600,0.5714285714285714,20,8,12,329.13317931616814,0.4386764705882353,0.2543497796689089,0.17079088473970744,126532.44598765396,-1843.6474775320992,124688.79851012187,2533,0,446.6666666666667,44,7,14,40.19360850358918,0.5724431818181819,48.47222222222221,1006.1111111111081,22.86616161616155,8
4063,4,1,0,50,0.02,0.0,1.0,50,1550,1100,450,0.7096774193548387,20,11,9,334.1382175441951,0.43605442176870746,0.281705688763517,0.17445065996968617,126781.8734665545,-1527.4661565943768,125254.40730996012,2534,0,456.5,43,7,15,39.811647860836835,0.5763081395348837,48.224431818181806,1007.1022727272707,23.420983086680714,0
4064,4,4,2,52,0.07407407407407407,0.037037037037037035,0.962962962962963,54,1250,900,350,0.72,16,9,7,321.12412806100315,0.44313417190775684,0.30134364665424296,0.17145361774862886,127689.50267052653,-2597.6484482609994,125091.85422226554,2535,0,423.6111111111111,43,11,16,39.21080061838283,0.5855135658914729,47.324810606060616,1010.7007575757596,23.50466878083162,0
4065,4,3,0,55,0.05454545454545454,0.0,1.0,55,1350,800,550,0.5925925925925926,19,8,11,329.287881393205,0.44515993265993264,0.3398914382155722,0.17804415290739517,128195.98458465553,-2554.0858932993547,125641.89869135617,2536,0,416.8545454545455,40,15,19,38.487414283324966,0.5950520833333333,46.82418699186993,1012.7032520325222,25.317581300813053,0
4066,4,0,1,54,0.0,0.01818181818181818,0.9818181818181818,55,1150,700,450,0.6086956521739131,16,7,9,325.46183465327437,0.445131874298541,0.33124019983225717,0.1767704474489356,128376.15258774559,-2643.6923706127127,125732.46021713287,2537,1,417.8545454545455,40,15,14,38.400646811071,0.596875,46.64634146341464,1013.414634146343,25.335365853658576,0
4067,4,0,0,54,0.0,0.0,1.0,54,1550,1200,350,0.7741935483870968,19,12,7,341.7847300612302,0.4431560097833683,0.30345262170638065,0.17970955778947628,127069.66705805794,-2113.9056291182537,124955.76142893969,2538,2,426.18518518518516,46,8,15,39.32376388522525,0.5754076086956521,47.93882978723404,1008.2446808510638,21.918362627197038,8
4068,4,2,2,54,0.03571428571428571,0.03571428571428571,0.9642857142857143,56,1550,1000,550,0.6451612903225806,21,10,11,336.75489209324,0.4453192640692641,0.317292424320033,0.17958114608949244,127640.61187250564,-2603.2740099848957,125037.33786252076,2539,0,411.92857142857144,45,11,14,38.865856937970605,0.5824074074074075,47.373188405797094,1010.5072463768105,22.455716586151343,0
4069,4,2,2,54,0.03571428571428571,0.03571428571428571,0.9642857142857143,56,1750,1300,450,0.7428571428571429,22,13,9,340.2119389843193,0.4447443181818182,0.3308232806086695,0.18320091959646173,128032.35501232336,-2488.3728497057505,125543.98216261761,2540,0,412.76785714285717,46,10,17,38.37797097640738,0.5851449275362319,46.98581560283688,1012.0567375886527,22.001233425840276,0
4070,4,4,3,55,0.06896551724137931,0.05172413793103448,0.9482758620689655,58,1250,900,350,0.72,16,9,7,327.33481336129324,0.44847751562815086,0.3467163845788488,0.17969812513169095,128801.62144204433,-3167.5525753619486,125634.06886668238,2541,0,399.0689655172414,44,14,17,37.919973243333644,0.595407196969697,46.22685185185187,1015.0925925925961,23.070286195286275,0
4071,4,1,1,55,0.017857142857142856,0.017857142857142856,0.9821428571428571,56,1700,900,800,0.5294117647058824,25,9,16,336.44978409448316,0.44608360389610385,0.3476140456182464,0.18427312442664415,128709.28730244607,-2539.1576152274242,126170.12968721865,2542,0,414.2857142857143,42,14,18,37.78269830659536,0.5972222222222222,46.317829457364354,1014.7286821705451,24.160206718346313,0
4072,4,0,0,55,0.0,0.0,1.0,55,1650,1300,350,0.7878787878787878,20,13,7,338.13586202589886,0.44490740740740736,0.339554830196541,0.18519658719326468,128709.28730244606,-2295.754837449646,126413.53246499642,2543,1,422.4,42,13,18,37.7399255156608,0.5972222222222222,46.317829457364354,1014.728682170545,24.16020671834631,0
4073,4,1,2,54,0.017857142857142856,0.03571428571428571,0.9642857142857143,56,1300,800,500,0.6153846153846154,18,8,10,332.60374769015493,0.44730113636363633,0.3424816235218924,0.18354799409567846,129008.91012396722,-2618.2306014692076,126390.67952249802,2544,0,415.8392857142857,43,13,19,37.57534799900573,0.5988372093023255,46.02272727272729,1015.9090909090932,23.625792811839375,0
4074,4,1,0,55,0.01818181818181818,0.0,1.0,55,1250,1000,250,0.8,15,10,5,336.16054511037345,0.4469276094276094,0.3510217523182251,0.186183955554795,129152.1364776756,-2316.8294798990496,126835.30699777654,2545,0,423.7818181818182,42,13,20,37.339331108992695,0.6016865079365079,45.88178294573643,1016.472868217054,24.201734957548904,0
4075,4,1,2,54,0.017857142857142856,0.03571428571428571,0.9642857142857143,56,1600,1300,300,0.8125,19,13,6,334.6700678566687,0.448241341991342,0.3560693600388034,0.1868108171413977,129459.81744497304,-2534.706653816495,126925.11079115655,2546,0,417.19642857142856,40,16,17,37.06456793821983,0.6078125,45.57926829268292,1017.6829268292668,25.442073170731668,0
4076,4,0,1,53,0.0,0.018518518518518517,0.9814814814814815,54,1350,1000,350,0.7407407407407407,17,10,7,338.1644791882143,0.44561641043559286,0.3550947260624675,0.18815818457395503,129333.80126953115,-2052.780490451403,127281.02077907974,2547,2,433.35185185185185,39,15,20,37.103707970643455,0.6081730769230769,45.70312499999999,1017.1874999999992,26.08173076923075,0
4077,4,0,0,53,0.0,0.0,1.0,53,1450,900,550,0.6206896551724138,20,9,11,341.0393700787407,0.445784954039671,0.3474907146040713,0.19029876977152885,129445.8954840562,-1770.7706689678162,127675.12481508838,2548,3,419.1320754716981,38,15,17,36.91666666666668,0.6110197368421053,45.5929487179487,1017.6282051282024,26.779689608636904,0
4078,4,0,2,51,0.0,0.03773584905660377,0.9622641509433962,53,1500,1100,400,0.7333333333333333,19,11,8,342.30806967510745,0.44518021286889214,0.34568354002798896,0.19175136854293207,129598.8294813364,-1727.4549696180932,127871.37451171831,2549,4,420.1320754716981,39,14,17,36.729006820119366,0.610844017094017,45.442708333333314,1018.2291666666634,26.10844017094009,0
4079,4,0,0,51,0.0,0.0,1.0,51,2100,1600,500,0.7619047619047619,26,16,10,359.8739514513162,0.4443464052287582,0.3578690232424475,0.2005567805115169,129396.54659366318,-886.7106946368381,128509.83589902634,2550,5,425.4901960784314,37,14,20,36.48774562632468,0.6123310810810811,45.64144736842104,1017.4342105263138,27.49822190611659,0
4080,4,0,3,48,0.0,0.058823529411764705,0.9411764705882353,51,950,700,250,0.7368421052631579,12,7,5,361.4628254068113,0.4446078431372549,0.35401118155311306,0.20225362673526118,129554.63927469103,-834.1628086420144,128720.47646604902,2551,6,426.4901960784314,38,13,17,36.28638017280581,0.6121162280701755,45.48611111111109,1018.0555555555528,26.790935672514546,0
4081,4,0,0,48,0.0,0.0,1.0,48,1250,800,450,0.64,17,8,9,373.0231688765699,0.44160017730496454,0.3485339164452319,0.20745968357716632,129315.9037415795,47.56563996430208,129363.46938154381,2552,7,449.375,36,12,19,36.235514467080016,0.6134259259259259,45.72072072072073,1017.1171171171178,28.253253253253273,0
4082,4,0,1,47,0.0,0.020833333333333332,0.9791666666666666,48,1400,1000,400,0.7142857142857143,18,10,8,370.51422418320936,0.4414616578014185,0.34239300866998734,0.2065142514185871,129401.82317029877,-10.956776032777526,129390.86639426599,2553,8,450.375,36,12,19,36.211722929348845,0.6142939814814814,45.63626126126127,1017.4549549549557,28.26263763763766,0
4083,4,0,0,47,0.0,0.0,1.0,47,1450,1200,250,0.8275862068965517,17,12,5,358.16819300784687,0.44195189639222937,0.32550206796571923,0.1939344738953395,128252.72715547148,-209.93713316240414,128042.79002230908,2554,9,438.2340425531915,38,9,15,37.69820342439266,0.5989583333333333,46.76816239316239,1012.9273504273499,26.655982905982892,8
4084,4,0,2,45,0.0,0.0425531914893617,0.9574468085106383,47,1100,700,400,0.6363636363636364,15,7,8,360.7736602177194,0.44152790625963617,0.32993529976578695,0.1957424138160669,128333.90404704506,-140.10154138359258,128193.80250566146,2555,10,439.2340425531915,38,9,17,37.54920567974131,0.5997807017543859,46.68803418803419,1013.247863247863,26.664417453891133,0
4085,4,1,1,45,0.021739130434782608,0.021739130434782608,0.9782608695652174,46,1150,400,750,0.34782608695652173,19,4,15,366.2195176950783,0.44378019323671497,0.3273146776173741,0.19899864797505046,128394.44739006225,204.11051958293774,128598.5579096452,2556,0,407.39130434782606,37,9,14,37.34932291103175,0.6021959459459459,46.628289473684205,1013.4868421052627,27.391536273115207,0
4086,4,0,0,45,0.0,0.0,1.0,45,1350,900,450,0.6666666666666666,18,9,9,376.819012345679,0.4413930976430977,0.33484938271604947,0.20479294149221686,128401.20525931336,676.8030699618525,129078.00832927521,2557,12,417.44444444444446,36,9,15,37.07384259259259,0.6041666666666667,46.62162162162162,1013.5135135135134,28.153153153153152,0
4087,4,1,0,46,0.021739130434782608,0.0,1.0,46,1650,900,750,0.5454545454545454,24,9,15,372.8766752655475,0.44250201288244767,0.3460418818668427,0.20503788675528278,128867.17547706954,410.31278855028813,129277.48826561983,2558,0,409.3478260869565,37,9,16,36.6972642188625,0.6069819819819819,46.16228070175437,1015.3508771929797,27.44191559981026,0
4088,4,0,0,46,0.0,0.0,1.0,46,1100,800,300,0.7272727272727273,14,8,6,368.32860118901175,0.44252214170692433,0.3427884276965678,0.20324982072758704,129006.37846500814,303.3477848953141,129309.72624990346,2559,1,410.3478260869565,37,9,17,36.6706017269293,0.6083896396396397,46.025219298245595,1015.8991228070148,27.456733048838238,0
4089,4,0,0,46,0.0,0.0,1.0,46,1200,800,400,0.6666666666666666,16,8,8,367.2653842066103,0.4414653784219002,0.24002689376960995,0.19574034213209476,127617.7300347224,180.00153893507508,127797.73157365747,2560,2,411.3478260869565,39,7,14,38.118556701030926,0.5908119658119658,47.39583333333334,1010.4166666666681,25.908119658119695,8
4090,4,0,0,46,0.0,0.0,1.0,46,900,300,600,0.3333333333333333,15,3,12,372.0337367224901,0.4416566022544284,0.24456129659585302,0.19867051994597276,127696.68104383699,301.4946831597415,127998.17572699673,2561,3,412.3478260869565,39,7,14,37.91707461609812,0.5916132478632479,47.31770833333334,1010.7291666666681,25.916132478632516,0
4091,4,1,1,46,0.02127659574468085,0.02127659574468085,0.9787234042553191,47,1150,700,450,0.6086956521739131,16,7,9,372.17241342769876,0.44349367869256856,0.2644184247322381,0.20125956187343955,128201.54772593557,145.75173516000933,128347.29946109558,2562,0,404.5531914893617,36,11,16,37.39598391341415,0.6021412037037037,46.8186936936937,1012.7252252252267,28.131256256256297,0
4092,4,1,1,46,0.02127659574468085,0.02127659574468085,0.9787234042553191,47,1250,700,550,0.56,18,7,11,407.8516068052929,0.4435900400863398,0.24982423681776145,0.21515107698444352,127202.60080024628,1119.7980791302698,128322.39887937655,2563,0,405.1063829787234,37,10,14,37.52128623188406,0.5900900900900901,47.80701754385965,1008.7719298245618,27.264106211474644,8
4093,4,1,0,47,0.02127659574468085,0.0,1.0,47,1250,900,350,0.72,16,9,7,402.16735425447786,0.44364785692260256,0.269317619540282,0.21470108189883505,127685.20801373353,870.1644568631627,128555.37247059669,2564,0,405.70212765957444,38,9,14,37.167459478506004,0.5932017543859649,47.32905982905982,1010.6837606837596,26.596941070625252,0
4094,4,1,0,48,0.020833333333333332,0.0,1.0,48,1950,1500,450,0.7692307692307693,24,15,9,392.9959593775336,0.4452940307328605,0.2697786980827932,0.2120781637529287,128118.16541883674,469.98426649305117,128588.14968532979,2565,0,398.2291666666667,39,9,15,36.95435487190041,0.5958867521367521,46.901041666666664,1012.3958333333328,25.95886752136751,0
4095,4,1,0,49,0.02040816326530612,0.0,1.0,49,1450,900,550,0.6206896551724138,20,9,11,385.496334395163,0.4465880102040816,0.2728249194414609,0.20985471677857276,128466.999488276,104.72504206319945,128571.7245303392,2566,0,391.0816326530612,35,14,15,36.78656714997908,0.606845238095238,46.55671296296297,1013.773148148149,28.964947089947113,0
4096,4,1,1,49,0.02,0.02,0.98,50,1100,700,400,0.6363636363636364,15,7,8,373.0849326811102,0.4469302721088435,0.2743616331821126,0.20486478687791942,128811.51532202221,-388.4728955063027,128423.04242651591,2567,0,384.24,37,13,16,36.74884784330669,0.6064189189189189,46.2171052631579,1015.1315789473688,27.435988620199158,0
4097,4,2,1,50,0.0392156862745098,0.0196078431372549,0.9803921568627451,51,1300,1000,300,0.7692307692307693,16,10,6,365.692975584047,0.44906862745098036,0.2805701907735836,0.20252168307316284,129148.44292534716,-754.2643229166697,128394.17860243049,2568,0,377.5686274509804,39,12,18,36.592624854819974,0.6063034188034189,45.885416666666664,1016.4583333333328,26.063034188034173,0
4098,4,1,0,51,0.0196078431372549,0.0,1.0,51,950,300,650,0.3157894736842105,16,3,13,361.2765993720261,0.4486274509803922,0.2912446076261399,0.20151205876084155,129430.46932067223,-847.9274856570846,128582.54183501514,2569,0,377.921568627451,36,15,17,36.417524347056215,0.6145833333333333,45.60810810810812,1017.5675675675693,28.265765765765813,0
4099,4,0,1,50,0.0,0.0196078431372549,0.9803921568627451,51,1300,700,600,0.5384615384615384,19,7,12,366.1091919693791,0.4480555555555556,0.2915829164796513,0.2052526610650403,129631.08114448928,-708.1739256147866,128922.90721887449,2570,1,378.921568627451,36,15,17,36.09030004791919,0.6166087962962963,45.411036036036045,1018.3558558558574,28.287662662662704,0
4100,4,0,3,47,0.0,0.06,0.94,50,1350,900,450,0.6666666666666666,18,9,9,373.16060502954434,0.4477295918367347,0.3042823048073646,0.2092696089008898,129643.02722318674,-324.46590470678666,129318.56131847996,2571,2,386.8,35,15,17,35.89861063757245,0.61875,45.39930555555556,1018.4027777777778,29.097222222222225,0
4101,4,0,0,47,0.0,0.0,1.0,47,950,700,250,0.7368421052631579,12,7,5,386.92554470184723,0.44125809435707675,0.32009522671129154,0.21522733424040272,129322.44897959197,607.631802721105,129930.08078231307,2572,3,411.5531914893617,34,13,17,35.87532186329588,0.6176470588235294,45.71428571428572,1017.1428571428581,29.91596638655465,0
4102,4,0,0,47,0.0,0.0,1.0,47,1300,1000,300,0.7692307692307693,16,10,6,383.6786392444652,0.44071847055195806,0.31719501113501836,0.21431937833692719,129487.77113261934,536.3383653924466,130024.10949801179,2573,4,412.5531914893617,36,11,17,35.78916795751272,0.615162037037037,45.551801801801815,1017.7927927927947,28.272022022022075,0
4103,4,2,1,48,0.04081632653061224,0.02040816326530612,0.9795918367346939,49,1300,1100,200,0.8461538461538461,15,11,4,402.80769644718816,0.44391298185941047,0.332880680789426,0.21620086564410299,127901.25739644968,648.7238580436328,128549.98125449332,2574,0,396.6734693877551,38,11,13,36.928997676383595,0.5953947368421053,47.11538461538461,1011.5384615384613,26.619433198380563,8
4104,4,0,0,48,0.0,0.0,1.0,48,1150,800,350,0.6956521739130435,15,8,7,410.4701512502321,0.4423943557919621,0.3432464412168512,0.22043059461202802,127922.58795975683,901.6808056325004,128824.26876538932,2575,1,405.6041666666667,37,11,14,36.71327408049715,0.5974099099099099,47.094298245614034,1011.6228070175437,27.3411569464201,0
4105,4,1,0,49,0.02040816326530612,0.0,1.0,49,1400,900,500,0.6428571428571429,19,9,10,404.0437603033742,0.44302721088435376,0.3374273385872697,0.21863809103235315,128227.80957842804,562.1216383887424,128789.93121681678,2576,0,398.3061224489796,37,12,15,36.56208274692361,0.6005067567567568,46.79276315789474,1012.8289473684216,27.373755334281665,0
4106,4,2,1,50,0.0392156862745098,0.0196078431372549,0.9803921568627451,51,2000,1600,400,0.8,24,16,8,393.9655851786212,0.44566993464052285,0.3439006873909922,0.21658108058296788,128857.43408203126,-46.921115451388744,128810.51296657987,2577,0,383.6470588235294,39,12,17,36.17192041995827,0.6033653846153846,46.171875,1015.3125000000001,26.03365384615385,0
4107,4,0,1,49,0.0,0.02,0.98,50,1450,900,550,0.6206896551724138,20,9,11,399.24600164757277,0.44425170068027214,0.35484271436086323,0.2197355672067272,128902.86138733651,292.7904019650765,129195.65178930158,2578,1,392.12,38,12,17,35.99136419428371,0.6055372807017544,46.12713675213675,1015.4914529914527,26.723459289248755,0
4108,4,2,0,51,0.0392156862745098,0.0,1.0,51,1500,1200,300,0.8,18,12,6,389.79880022974334,0.44364379084967315,0.36546812361403735,0.2172062009706167,129391.54071015024,-112.32125246550783,129279.21945768473,2579,0,384.72549019607845,38,13,19,35.73169344394273,0.6104714912280702,45.64636752136751,1017.4145299145279,26.7740665766981,0
4109,4,1,1,51,0.019230769230769232,0.019230769230769232,0.9807692307692307,52,1750,1200,550,0.6857142857142857,23,12,11,416.2799518275664,0.445874183006536,0.33273519659658324,0.23009304800021183,129072.2714344139,351.88389540667555,129424.15532982057,2580,0,378.3076923076923,40,12,13,35.385205187185385,0.60390625,45.96036585365853,1016.1585365853647,25.403963414634116,8
4110,4,1,3,49,0.019230769230769232,0.057692307692307696,0.9423076923076923,52,1250,900,350,0.72,16,9,7,411.9627384520667,0.44665189793866267,0.342432969059006,0.2289124766936555,129280.82817925353,251.841350260163,129532.66952951369,2581,0,379.2307692307692,39,13,14,35.28127027211582,0.6076388888888888,45.755208333333336,1016.9791666666671,26.0763888888889,0
4111,4,0,0,49,0.0,0.0,1.0,49,1100,800,300,0.7272727272727273,14,8,6,434.4650562625306,0.4449404761904762,0.36073010044281295,0.2387366145955351,128839.34389667955,1395.2385589796625,130234.58245565921,2582,1,403.265306122449,37,12,14,35.16252205061741,0.6067004504504505,46.18969298245613,1015.2412280701739,27.4389521100047,0
4112,4,1,0,50,0.02,0.0,1.0,50,1400,900,500,0.6428571428571429,19,9,10,426.97204320196914,0.4459013605442177,0.36706043089858165,0.2366126378023725,129174.23575726857,1030.7574740667642,130204.99323133533,2583,0,396.18,38,12,15,35.008977053774736,0.6082785087719298,45.86004273504273,1016.5598290598288,26.75157444894286,0
4113,4,0,1,49,0.0,0.02,0.98,50,1650,1100,550,0.6666666666666666,22,11,11,355.07927976350464,0.4461989795918367,0.23163934426229527,0.19690760059612514,129201.38888888879,-710.0163680692617,128491.37252081952,2584,1,397.18,40,10,14,36.80840163934426,0.6052083333333333,45.83333333333333,1016.6666666666658,25.416666666666647,8
4114,4,0,1,48,0.0,0.02040816326530612,0.9795918367346939,49,1100,500,600,0.45454545454545453,17,5,12,359.95583438127903,0.4440547052154195,0.24394485364813634,0.20014856303523987,129307.31336805566,-491.015624999991,128816.29774305568,2585,2,406.14285714285717,39,10,15,36.57653966953435,0.607905982905983,45.72916666666667,1017.0833333333343,26.079059829059855,0
4115,4,0,1,47,0.0,0.020833333333333332,0.9791666666666666,48,1700,1400,300,0.8235294117647058,20,14,6,357.82761205171767,0.4437610815602837,0.23628931602596093,0.1998685741605105,129485.67450137154,-333.29005965364473,129152.38444171789,2586,3,402.5833333333333,40,8,13,36.449076385421854,0.6080729166666667,45.55386178861789,1017.7845528455285,25.444613821138212,0
4116,4,1,1,47,0.020833333333333332,0.020833333333333332,0.9791666666666666,48,1250,800,450,0.64,17,8,9,348.25639793868464,0.4427452718676123,0.25335864485981285,0.19612333989178543,129807.25623582759,-558.7585034013706,129248.49773242621,2587,0,403.1041666666667,41,7,16,36.36584890965731,0.6097560975609756,45.238095238095234,1019.0476190476185,24.854819976771182,0
4117,4,0,0,47,0.0,0.0,1.0,47,1250,700,550,0.56,18,7,11,349.83981256628954,0.4407762873882208,0.2587895886807665,0.19735058042968956,129873.8401827614,-312.9920186397145,129560.84816412168,2588,1,412.40425531914894,40,7,16,36.25789298770356,0.6119791666666667,45.17276422764227,1019.3089430894294,25.482723577235735,0
4118,4,1,1,47,0.020833333333333332,0.020833333333333332,0.9791666666666666,48,800,400,400,0.5,12,4,8,344.6897126197417,0.4414247192671395,0.26845238095238066,0.1963929757949692,130262.58680555563,-619.3843363738425,129643.2024691818,2589,0,404.7916666666667,40,8,18,35.99489795918368,0.6158854166666667,44.79166666666667,1020.833333333334,25.52083333333335,0
4119,4,0,0,47,0.0,0.0,1.0,47,1700,1400,300,0.8235294117647058,20,14,6,346.4470833875766,0.44029448041936475,0.26505229067450387,0.19766439530646265,130315.76063368072,-370.49696180553633,129945.26367187519,2590,1,413.8936170212766,39,8,19,35.89616064748693,0.6180555555555556,44.73958333333334,1021.041666666668,26.18055555555559,0
4120,4,0,1,46,0.0,0.02127659574468085,0.9787234042553191,47,1650,1200,450,0.7272727272727273,21,12,9,342.5067063094936,0.43985121800801724,0.25336263049782715,0.19635583180536675,130501.95448133691,-460.4410807291573,130041.51340060776,2591,2,414.8936170212766,39,8,13,35.80820759846398,0.6199252136752137,44.55729166666667,1021.7708333333343,26.19925213675216,0
4121,4,0,0,46,0.0,0.0,1.0,46,1350,700,650,0.5185185185185185,20,7,13,348.995370027818,0.4389593397745572,0.25844198352517633,0.20010741720300035,130508.09500328715,-90.65581854044984,130417.4391847467,2592,3,424.4347826086956,38,8,14,35.63624006691761,0.6217105263157895,44.551282051282044,1021.7948717948705,26.88933873144396,0
4122,4,1,0,47,0.02127659574468085,0.0,1.0,47,1050,900,150,0.8571428571428571,12,9,3,344.158603057038,0.44071847055195806,0.26927825940030425,0.1990769021923573,130848.09570312499,-393.5004340277777,130454.5952690972,2593,0,416.3829787234043,39,8,15,35.41581823118169,0.6233974358974359,44.21875,1023.1249999999999,26.233974358974358,0
4123,4,0,0,47,0.0,0.0,1.0,47,1400,1000,400,0.7142857142857143,18,10,8,345.93365544262974,0.4400053962380512,0.2686984506240573,0.20135427866527505,131088.0004882814,-330.44976128470745,130757.55072699669,2594,1,417.3829787234043,39,8,15,35.12793289933205,0.625801282051282,43.98437500000001,1024.0625000000011,26.25801282051285,0
4124,4,0,0,47,0.0,0.0,1.0,47,1650,1100,550,0.6666666666666666,22,11,11,341.7278075219777,0.43971631205673756,0.24667012627573115,0.2001548586914442,131328.12500000012,-424.30555555554105,130903.81944444457,2595,2,418.3829787234043,39,8,16,34.993224932249326,0.6282051282051282,43.75000000000001,1025.000000000001,26.282051282051306,0
4125,4,0,1,46,0.0,0.02127659574468085,0.9787234042553191,47,1500,1100,400,0.7333333333333333,19,11,8,341.47289829168767,0.43940795559666973,0.247026421718471,0.20028464034486243,131381.515842014,-427.35460069443656,130954.16124131955,2596,3,419.3829787234043,39,8,16,34.94589514326356,0.6287393162393162,43.69791666666667,1025.2083333333342,26.287393162393183,0
4126,4,1,1,46,0.02127659574468085,0.02127659574468085,0.9787234042553191,47,1300,900,400,0.6923076923076923,17,9,8,341.1924958749905,0.43927304964539005,0.2516235695838689,0.20053970876950963,131461.62245008702,-429.25618489580893,131032.3662651912,2597,0,420.17021276595744,39,8,17,34.87229134924666,0.6295405982905983,43.61979166666668,1025.520833333335,26.29540598290603,0
4127,4,0,1,45,0.0,0.021739130434782608,0.9782608695652174,46,900,700,200,0.7777777777777778,11,7,4,344.1873234313846,0.4375704508856683,0.165231768476781,0.19509008045873716,130060.11924445682,-181.8191509098087,129878.300093547,2598,1,428.9782608695652,41,5,19,36.212961161901056,0.6122967479674797,44.99007936507935,1020.0396825396807,24.879016647309285,7
4128,4,2,0,47,0.0425531914893617,0.0,1.0,47,1200,700,500,0.5833333333333334,17,7,10,375.0193882719438,0.4400053962380512,0.252013450771841,0.2006581137027279,127775.65646701379,222.94872665500384,127998.60519366879,2599,0,420.78723404255317,39,8,17,37.76057764956384,0.5924145299145299,47.23958333333333,1011.0416666666658,25.924145299145277,8
4129,4,1,0,48,0.020833333333333332,0.0,1.0,48,1350,1000,350,0.7407407407407407,17,10,7,370.92386523517325,0.4425328752955083,0.25365137522585823,0.200170289570574,128118.80845561501,-95.53527166369673,128023.27318395131,2600,0,413.0,40,8,19,37.51233855316871,0.5942708333333333,46.90040650406504,1012.3983739837396,25.30995934959349,0
4130,4,0,0,48,0.0,0.0,1.0,48,1200,700,500,0.5833333333333334,17,7,10,367.92426029965685,0.442542109929078,0.2551416819012795,0.19926195087516058,128261.74554183804,-161.86551954632,128099.88002229172,2601,1,414.0,35,13,19,37.44191803778183,0.6047619047619048,46.75925925925925,1012.9629629629621,28.94179894179892,0
4131,4,3,2,49,0.058823529411764705,0.0392156862745098,0.9607843137254902,51,1700,1100,600,0.6470588235294118,23,11,12,351.26977481071793,0.4454738562091503,0.2799302465476161,0.19493637349514314,129230.0128464616,-1114.2217871650146,128115.79105929658,2602,0,390.5882352941176,36,15,17,36.87608446856426,0.6125578703703703,45.805180180180194,1016.7792792792815,28.24386886886893,0
4132,4,0,0,49,0.0,0.0,1.0,49,1600,1200,400,0.75,20,12,8,358.37334857681554,0.44184027777777773,0.29584831165789405,0.19860110782289292,129174.91455078124,-541.4306640625007,128633.48388671874,2603,1,406.9183673469388,39,10,17,36.751652320934525,0.6065705128205128,45.859375,1016.5624999999999,26.065705128205124,0
4133,4,0,0,49,0.0,0.0,1.0,49,1250,700,550,0.56,18,7,11,356.7292178243616,0.44129109977324266,0.29536290100819906,0.19852291264286742,129340.77222077936,-572.0680732292768,128768.70414755007,2604,2,407.9183673469388,37,12,17,36.624514929395275,0.6117680180180181,45.696271929824555,1017.2149122807008,27.492294926505426,0
4134,4,1,0,50,0.02,0.0,1.0,50,1150,600,550,0.5217391304347826,17,6,11,354.6296604373972,0.4432057823129252,0.30018458311483975,0.1992571486311479,129717.84056770029,-799.6412493608066,128918.19931833948,2605,0,400.74,38,12,15,36.29435413389269,0.6137609649122807,45.3258547008547,1018.6965811965808,26.807804768331074,0
4135,4,0,1,49,0.0,0.02,0.98,50,1300,900,400,0.6923076923076923,17,9,8,354.89022135027,0.44253401360544214,0.30256363078810145,0.19987858580712103,129811.04736328126,-786.2657335069441,129024.78162977433,2606,1,401.74,39,11,15,36.192992095131004,0.6129807692307692,45.234375,1019.0625000000001,26.129807692307697,0
4136,4,1,1,49,0.02,0.02,0.98,50,1550,1100,450,0.7096774193548387,20,11,9,317.1456403969181,0.4418112244897959,0.20750840493089395,0.1729121953854475,128528.34093778652,-1837.961961590374,126690.37897619614,2607,0,402.64,43,7,12,38.45645000622589,0.5939922480620154,46.4962121212121,1014.0151515151479,23.5817477096546,8
4137,4,0,2,47,0.0,0.04081632653061224,0.9591836734693877,49,1600,1300,300,0.8125,19,13,6,304.47062844104715,0.4421060090702948,0.15847907790567262,0.15998547567175017,127043.16522444563,-2050.4379950185266,124992.72722942711,2608,1,400.9183673469388,42,7,16,40.291394335511995,0.5803571428571428,47.96511627906977,1008.1395348837209,24.003322259136212,8
4138,4,0,1,46,0.0,0.02127659574468085,0.9787234042553191,47,1400,1100,300,0.7857142857142857,17,11,6,318.5718655556023,0.44029448041936475,0.1641241672145295,0.16739024290465498,127042.00227544707,-1305.5984662383598,125736.40380920871,2609,4,403.02127659574467,41,6,17,39.93718428130946,0.5818089430894309,47.966269841269835,1008.1349206349194,24.588656600851692,0
4139,4,2,0,48,0.041666666666666664,0.0,1.0,48,1550,1100,450,0.7096774193548387,20,11,9,317.6696819019636,0.4421911938534279,0.17913062428753435,0.16925358936062831,127604.89477989299,-1492.7390494281212,126112.15573046486,2610,0,393.1666666666667,40,8,16,39.38447160195804,0.5890625,47.40853658536586,1010.3658536585372,25.259146341463428,0
4140,4,0,0,48,0.0,0.0,1.0,48,950,500,450,0.5263157894736842,14,5,9,321.56804121108024,0.44208961288416077,0.19103852596314885,0.17220678202638598,127810.33631601575,-1380.056100865878,126430.28021514986,2611,1,394.1666666666667,40,8,16,39.07621440536011,0.5911458333333333,47.205284552845534,1011.1788617886191,25.279471544715477,0
4141,4,0,1,47,0.0,0.020833333333333332,0.9791666666666666,48,1450,1100,350,0.7586206896551724,18,11,7,325.8076984366132,0.4425144060283688,0.08025598628207464,0.1710097688129683,126998.66683813414,-1276.815365225347,125721.85147290879,2612,2,395.1666666666667,44,4,15,39.79920693245145,0.5771780303030303,48.009259259259245,1007.9629629629607,22.908249158249106,8
4142,4,1,1,47,0.020833333333333332,0.020833333333333332,0.9791666666666666,48,1250,800,450,0.64,17,8,9,329.1075016282666,0.443502511820331,0.10135340632603418,0.17376609061630408,127238.61621897742,-1224.8947940012629,126013.72142497616,2613,0,395.75,42,6,16,39.470282686643614,0.5823412698412698,47.771317829457374,1008.914728682172,24.021779254337428,0
4143,4,1,0,48,0.020833333333333332,0.0,1.0,48,1400,900,500,0.6428571428571429,19,9,10,342.0026124949328,0.44319776891252954,0.1358780760626399,0.18255308333276088,127678.9302400696,-866.6944594675919,126812.23578060202,2614,0,396.4375,42,6,14,38.6940715883669,0.5868055555555556,47.33527131782945,1010.6589147286812,24.06330749354003,0
4144,4,1,1,48,0.02040816326530612,0.02040816326530612,0.9795918367346939,49,1650,1200,450,0.7272727272727273,21,12,9,344.4712800970388,0.44322208049886624,0.15291707477265426,0.18568096384050664,128072.63082709188,-976.5313827192394,127096.09944437264,2615,0,389.3265306122449,43,6,16,38.22903997879441,0.5893895348837209,46.94602272727273,1012.2159090909086,23.53990486257927,0
4145,4,0,0,48,0.0,0.0,1.0,48,1750,1400,350,0.8,21,14,7,348.5242566173253,0.44168328900709225,0.16861998301819048,0.18832117984611085,128169.64408738012,-665.9338377965969,127503.71024958353,2616,1,398.1666666666667,41,7,17,38.02731377159467,0.5932418699186992,46.850198412698404,1012.5992063492047,24.697541618273284,0
4146,4,3,2,49,0.058823529411764705,0.0392156862745098,0.9607843137254902,51,1200,800,400,0.6666666666666666,16,8,8,342.63080964160963,0.44612745098039214,0.2132196543156919,0.18887738601851556,128966.15655006861,-1362.4442729766765,127603.71227709194,2617,0,375.6862745098039,44,7,15,37.36421300516561,0.5970643939393939,46.06481481481482,1015.7407407407409,23.085016835016837,0
4147,4,0,0,49,0.0,0.0,1.0,49,1250,800,450,0.64,17,8,9,352.3606355653844,0.4444975907029478,0.21169330492265637,0.1937059149766052,128856.81918905102,-719.1858587224397,128137.63333032858,2618,1,390.3469387755102,42,7,15,37.22859801488834,0.5987103174603174,46.172480620155035,1015.3100775193789,24.174049464747117,0
4148,4,0,0,49,0.0,0.0,1.0,49,2200,1900,300,0.8636363636363636,25,19,6,356.50753074287263,0.44373582766439906,0.2180426539177287,0.19671710275306747,129004.43558079458,-601.7894432425778,128402.646137552,2619,2,391.3469387755102,42,7,16,36.97280777057102,0.6001984126984127,46.027131782945744,1015.8914728682183,24.187892211148057,0
4149,4,1,0,50,0.02,0.0,1.0,50,1000,600,400,0.6,14,6,8,350.77888362833505,0.4450170068027211,0.22721000431220295,0.19507343672280808,129312.88954293643,-927.0524053371694,128385.83713759927,2620,0,384.5,37,13,17,36.80420799195055,0.6114864864864865,45.72368421052632,1017.1052631578959,27.48933143669989,0
4150,4,0,0,50,0.0,0.0,1.0,50,1200,800,400,0.6666666666666666,16,8,8,348.75119350238714,0.4444642857142857,0.22401889763779548,0.194601940135339,129445.89548405647,-971.1178911900092,128474.77759286646,2621,1,385.5,38,12,16,36.720472440944896,0.6110197368421053,45.592948717948715,1017.6282051282046,26.779689608636964,0
4151,4,0,0,50,0.0,0.0,1.0,50,1350,800,550,0.5925925925925926,19,8,11,346.8480384540058,0.44375000000000003,0.22884115781937187,0.19455727320509558,129651.86767578126,-1006.100802951388,128645.76687282987,2622,2,386.5,39,11,16,36.55954877092497,0.6113782051282051,45.390625,1018.4375000000001,26.113782051282055,0
4152,4,0,1,49,0.0,0.02,0.98,50,1950,1500,450,0.7692307692307693,24,15,9,350.6076271523717,0.4433418367346939,0.23795991624289559,0.19765283264255987,129847.94439693645,-894.8640648753943,128953.08033206106,2623,3,387.5,40,10,18,36.26462425632333,0.61171875,45.19817073170732,1019.2073170731715,25.480182926829286,0
4153,4,1,0,50,0.02,0.0,1.0,50,1300,800,500,0.6153846153846154,18,8,10,347.5561961951322,0.4437329931972789,0.24515463917525748,0.19831147665251667,130318.55955678683,-938.7515004845513,129379.80805630228,2624,0,365.72,37,13,19,35.86501288659795,0.6216216216216216,44.736842105263165,1021.0526315789484,27.596017069701308,0
4154,4,1,1,50,0.0196078431372549,0.0196078431372549,0.9803921568627451,51,1650,1200,450,0.7272727272727273,21,12,9,339.3605121779512,0.44413398692810463,0.24920123965208152,0.19508756332760666,130608.4106445317,-1335.3325737846767,129273.07807074703,2625,0,359.52941176470586,39,12,18,35.78087316145249,0.6209935897435898,44.45312500000002,1022.1875000000036,26.20993589743599,0
4155,4,0,1,49,0.0,0.02,0.98,50,1350,900,450,0.6666666666666666,18,9,9,339.0715677005315,0.4438775510204082,0.23956605887745686,0.19545893013013083,130714.91021050396,-1135.658094618007,129579.25211588596,2626,1,351.18,39,11,20,35.680558385114246,0.6220619658119658,44.34895833333336,1022.6041666666706,26.22061965811976,0
4156,4,0,1,48,0.0,0.02040816326530612,0.9795918367346939,49,1500,1100,400,0.7333333333333333,19,11,8,339.19841266874363,0.4432575113378685,0.23811618201754814,0.19639958695581308,130885.78976014645,-920.7495744926545,129965.0401856538,2627,2,353.55102040816325,40,9,20,35.50460158241469,0.6221354166666666,44.18191056910571,1023.2723577235802,25.581808943089506,0
4157,4,0,0,48,0.0,0.0,1.0,48,1300,900,400,0.6923076923076923,17,9,8,348.3635374783907,0.4419510933806146,0.24451865988125543,0.20192753721092593,130928.0395507815,-477.8889973958019,130450.1505533857,2628,3,360.9375,39,9,20,35.227417302799005,0.624198717948718,44.140625000000014,1023.4375000000019,26.24198717948723,0
4158,4,0,0,48,0.0,0.0,1.0,48,1500,1200,300,0.8,18,12,6,348.125664268143,0.4412954343971631,0.24815615462868745,0.2024896615240148,131061.33355034747,-474.8372395833059,130586.49631076417,2629,4,361.9375,39,9,21,35.09876229230248,0.625534188034188,44.01041666666668,1023.9583333333353,26.25534188034193,0
4159,4,0,1,47,0.0,0.020833333333333332,0.9791666666666666,48,1500,800,700,0.5333333333333333,22,8,14,348.27274659863923,0.44087064125295505,0.24813988095238115,0.20315910218253982,131171.9214753125,-463.2789262343619,130708.64254907814,2630,5,362.9375,40,8,21,34.98325892857143,0.625,43.902439024390254,1024.3902439024405,25.60975609756101,0
4160,4,0,0,47,0.0,0.0,1.0,47,1150,600,550,0.5217391304347826,17,6,11,348.9850677286814,0.4407762873882208,0.24049759959198647,0.20455172418183867,131355.50356353645,-231.59223721957625,131123.91132631688,2631,6,365.8085106382979,38,9,21,34.77961611950669,0.6302083333333333,43.7232905982906,1025.1068376068379,26.976495726495735,0
4161,4,2,1,48,0.04081632653061224,0.02040816326530612,0.9795918367346939,49,1350,800,550,0.5925925925925926,19,8,11,345.6230856524475,0.4426906179138322,0.2632538034495908,0.20621157906803567,132032.1911250745,-673.3253395796037,131358.86578549488,2632,0,351.83673469387753,40,9,18,34.18372391970731,0.63359375,43.06402439024391,1027.7439024390253,25.693597560975633,0
4162,4,0,1,47,0.0,0.020833333333333332,0.9791666666666666,48,1250,800,450,0.64,17,8,9,352.76426913950195,0.4412769651300236,0.260864817195793,0.21018264733467937,131979.9735297279,-288.4362193469311,131691.53731038095,2633,1,360.1666666666667,40,8,18,34.05284673457949,0.6330729166666667,43.11483739837399,1027.5406504065058,25.688516260162647,0
4163,4,0,0,47,0.0,0.0,1.0,47,1350,1100,250,0.8148148148148148,16,11,5,353.7009798989782,0.4405257477644156,0.25443073731695365,0.21112931449868239,132049.8168945313,-58.77007378472126,131991.0468207466,2634,2,366.36170212765956,39,8,19,33.958417789939524,0.6354166666666667,43.046875,1027.8125000000005,26.35416666666668,0
4164,4,0,0,47,0.0,0.0,1.0,47,800,500,300,0.625,11,5,6,353.7009798989782,0.4405257477644156,0.25443073731695365,0.21112931449868239,132049.8168945313,-58.77007378472126,131991.0468207466,2635,3,367.36170212765956,39,8,19,33.958417789939524,0.6354166666666667,43.046875,1027.8125000000005,26.35416666666668,0
4165,4,0,1,46,0.0,0.02127659574468085,0.9787234042553191,47,1350,800,550,0.5925925925925926,19,8,11,355.9598517424984,0.4399283071230342,0.259388254767406,0.21323031895642877,132183.68055555562,10.416666666677543,132194.0972222223,2636,4,368.36170212765956,39,8,20,33.765532144786604,0.6367521367521367,42.91666666666667,1028.333333333334,26.367521367521384,0
4166,4,0,0,46,0.0,0.0,1.0,46,1350,1000,350,0.7407407407407407,17,10,7,361.98031347743563,0.4403884863123994,0.2558257345491386,0.21653004206195692,132130.12695312503,365.7009548611139,132495.82790798615,2637,5,373.54347826086956,39,7,20,33.66472475515029,0.6362179487179487,42.96875,1028.1250000000002,26.362179487179493,0
4167,4,1,1,46,0.02127659574468085,0.02127659574468085,0.9787234042553191,47,1200,900,300,0.75,15,9,6,354.8201755430576,0.4405257477644156,0.26181768744476974,0.21439906360034156,132510.87474030454,4.32016942711553,132515.19490973165,2638,0,366.5744680851064,37,10,22,33.465566205182824,0.6435810810810811,42.59868421052631,1029.6052631578934,27.82716927453766,0
4168,4,0,0,46,0.0,0.0,1.0,46,1300,1000,300,0.7692307692307693,16,10,6,354.2189038099199,0.44058977455716586,0.25353602586350354,0.21438331405305877,132571.9062601453,191.89506229202865,132763.80132243733,2639,1,368.67391304347825,36,10,22,33.41967377437581,0.6461226851851851,42.539414414414416,1029.8423423423426,28.606731731731738,0
4169,4,0,0,46,0.0,0.0,1.0,46,1750,1300,450,0.7428571428571429,22,13,9,357.9021093635385,0.4398148148148148,0.24658900881726975,0.21778724101696165,132774.9370992613,304.08601168734845,133079.02311094865,2640,2,369.67391304347825,36,10,18,33.12072042540792,0.6481481481481481,42.342342342342334,1030.6306306306296,28.6286286286286,0
4170,4,0,1,45,0.0,0.021739130434782608,0.9782608695652174,46,1150,900,250,0.782608695652174,14,9,5,362.28956228956247,0.439200885668277,0.24870443566095735,0.2213991769547325,132934.57031249988,432.1614583333195,133366.7317708332,2641,3,370.67391304347825,37,9,18,32.847222222222214,0.6478040540540541,42.18749999999999,1031.249999999999,27.871621621621596,0
4171,4,0,0,45,0.0,0.0,1.0,45,1450,1000,450,0.6896551724137931,19,10,9,364.394464380475,0.4375420875420875,0.2510357214600545,0.22234919847953305,132878.03849501756,684.0043330640026,133562.04282808155,2642,10,379.84444444444443,37,8,19,32.84977755326314,0.647240990990991,42.2423245614035,1031.0307017543848,27.8656946420104,0
4172,4,0,0,45,0.0,0.0,1.0,45,1100,900,200,0.8181818181818182,13,9,4,367.58988939836905,0.43735269360269363,0.2571975334892629,0.22480822494675246,132962.8407298397,775.1591835949264,133737.9999134346,2643,11,380.84444444444443,37,8,19,32.68215323552343,0.6480855855855856,42.16008771929823,1031.359649122805,27.874585111427162,0
4173,4,0,0,45,0.0,0.0,1.0,45,1450,1100,350,0.7586206896551724,18,11,7,360.38745344400934,0.4361531986531986,0.2538158298515212,0.22174428017790218,133189.11227493064,599.9369998460957,133789.04927477674,2644,12,381.84444444444443,37,8,20,32.64065930174916,0.6503378378378378,41.940789473684205,1032.2368421052624,27.898293029871958,0
4174,4,0,0,45,0.0,0.0,1.0,45,1400,1100,300,0.7857142857142857,17,11,6,363.8726046582823,0.43604797979797977,0.2561206072831519,0.22474203693615447,133330.62967691952,703.0727002538948,134033.7023771734,2645,13,382.84444444444443,37,8,21,32.40867307215912,0.6517454954954955,41.803728070175424,1032.785087719296,27.91311047889989,0
4175,4,0,1,44,0.0,0.022222222222222223,0.9777777777777777,45,1200,800,400,0.6666666666666666,16,8,8,365.8298647242457,0.43489057239057244,0.26057347670250897,0.2268145161290322,133472.22222222216,765.7001433133222,134237.9223655355,2646,14,383.84444444444443,36,9,22,32.21606182795699,0.6550925925925926,41.666666666666664,1033.333333333333,28.703703703703695,0
4176,4,0,0,44,0.0,0.0,1.0,44,1100,700,400,0.6363636363636364,15,7,8,375.4536788713404,0.434042459478506,0.2567299686793796,0.23205263764204437,133355.88121905705,1213.7912405649038,134569.67245962194,2647,15,392.75,36,8,22,32.084287323738906,0.6539351851851851,41.77927927927929,1032.8828828828841,28.691191191191226,0
4177,4,0,0,44,0.0,0.0,1.0,44,1450,1000,450,0.6896551724137931,19,10,9,375.0450239335985,0.43331571529245944,0.2592039218481146,0.2327155676652608,133502.12358807027,1213.9121536568923,134716.03574172716,2648,16,393.75,35,9,22,31.94798316347483,0.6574404761904762,41.63773148148149,1033.449074074075,29.52711640211643,0
4178,4,0,0,44,0.0,0.0,1.0,44,1600,1100,500,0.6875,21,11,10,380.48291802692773,0.4326770613107822,0.2672501474806237,0.23781512736536234,133771.38658479083,1379.5455032578902,135150.93208804872,2649,17,394.75,35,9,19,31.53716342209293,0.6601190476190476,41.37731481481482,1034.490740740741,29.556878306878318,0
4179,4,0,0,44,0.0,0.0,1.0,44,1250,1100,150,0.88,14,11,3,383.7450797290081,0.4322806553911205,0.26535317383656487,0.24043901596755865,133861.20119866685,1473.7154653206455,135334.9166639875,2650,18,395.75,35,9,20,31.36265984416358,0.6610119047619047,41.29050925925926,1034.837962962963,29.566798941798943,0
4180,4,0,0,44,0.0,0.0,1.0,44,1850,1600,250,0.8648648648648649,21,16,5,383.0312883023288,0.43210447498238197,0.2691291266872664,0.24057807883258628,133951.04595336074,1461.4883401920404,135412.53429355277,2651,19,396.75,35,9,20,31.29099582587954,0.6619047619047619,41.2037037037037,1035.185185185185,29.576719576719572,0
4181,4,0,1,43,0.0,0.022727272727272728,0.9772727272727273,44,1050,700,350,0.6666666666666666,14,7,7,384.23701160686477,0.4316640239605356,0.27396195353941843,0.24172885413748313,134010.9592013888,1498.3940972222122,135509.353298611,2652,20,397.75,35,9,20,31.199698189134807,0.6625,41.14583333333333,1035.4166666666658,29.58333333333331,0
4182,4,0,0,43,0.0,0.0,1.0,43,1400,1200,200,0.8571428571428571,16,12,4,387.85910880631553,0.4320551864156515,0.27322506644136335,0.24410987904466963,134026.36763038556,1796.6695011337983,135823.03713151935,2653,21,380.93023255813955,34,9,21,31.09048057024605,0.664828431372549,41.13095238095239,1035.476190476191,30.45518207282915,0
4183,4,0,1,42,0.0,0.023255813953488372,0.9767441860465116,43,1250,800,450,0.64,17,8,9,389.21936331456214,0.4317783314876338,0.2680217859567169,0.24579005076656893,134149.66695011343,1842.729591836744,135992.39654195018,2654,22,381.93023255813955,34,9,22,30.931586608442508,0.6660539215686274,41.011904761904766,1035.9523809523814,30.469187675070042,0
4184,4,1,2,41,0.023255813953488372,0.046511627906976744,0.9534883720930233,43,1050,700,350,0.6666666666666666,14,7,7,383.31393828557896,0.4315014765596161,0.26724559196981423,0.24349242075339952,134365.5771683674,1700.8397108843585,136066.41687925174,2655,0,381.25581395348837,34,9,23,30.86821104604431,0.6681985294117647,40.80357142857143,1036.7857142857147,30.493697478991606,0
4185,4,0,0,41,0.0,0.0,1.0,41,1100,800,300,0.7272727272727273,14,8,6,383.43788935548884,0.4299542682926829,0.24977592562171602,0.2441711706256963,134455.4396896627,2111.062001393698,136566.5016910564,2656,1,388.390243902439,33,8,23,30.775015754854465,0.6714015151515151,40.716911764705884,1037.1323529411768,31.4282531194296,0
4186,4,0,0,41,0.0,0.0,1.0,41,1400,1100,300,0.7857142857142857,17,11,6,384.880407531894,0.42957317073170737,0.2531860460975015,0.24595234751921488,134583.53261146814,2159.74676680672,136743.27937827486,2657,2,389.390243902439,32,9,23,30.60938387279954,0.6751302083333333,40.59343434343434,1037.6262626262621,32.42582070707069,0
4187,4,0,0,41,0.0,0.0,1.0,41,300,200,100,0.6666666666666666,4,2,2,386.2352815813309,0.4296239837398374,0.2572547623286452,0.24726277372262778,134649.04729109278,2201.2425390266317,136850.2898301194,2658,3,390.390243902439,32,9,23,30.50866788321168,0.67578125,40.53030303030303,1037.878787878788,32.433712121212125,0
4188,4,0,0,41,0.0,0.0,1.0,41,1200,600,600,0.5,18,6,12,384.7723505880398,0.42931910569105686,0.25900214989991865,0.24743960778628823,134812.90373750124,2174.4555721354964,136987.35930963673,2659,4,391.390243902439,32,9,18,30.38272543059777,0.6774088541666667,40.37247474747475,1038.510101010101,32.453440656565654,0
4189,4,0,0,41,0.0,0.0,1.0,41,1400,1000,400,0.7142857142857143,18,10,8,364.0323642575504,0.42855691056910566,0.1584979637062942,0.22237787588434885,132920.05423920543,1477.4403203879588,134397.49455959338,2660,5,392.390243902439,36,5,20,32.81687961850679,0.6495949074074074,42.20157657657658,1031.1936936936938,28.644269269269273,8
4190,4,0,0,41,0.0,0.0,1.0,41,1450,1100,350,0.7586206896551724,18,11,7,360.7353923776279,0.42830284552845527,0.16253420063663748,0.22156696620298807,133123.35139193246,1404.4608797987148,134527.81227173118,2661,6,393.390243902439,36,5,21,32.69769387458169,0.6516203703703703,42.0045045045045,1031.9819819819818,28.66616616616616,0
4191,4,1,0,42,0.023809523809523808,0.0,1.0,42,550,100,450,0.18181818181818182,10,1,9,354.0096296961214,0.4290795586527294,0.16910296652362278,0.21898389503395654,133387.25767784307,1044.0747393428642,134431.33241718594,2662,0,385.0,37,5,22,32.60656600502423,0.6523085585585586,41.748903508771924,1033.0043859649115,27.919037458511124,0
4192,4,0,1,41,0.0,0.023809523809523808,0.9761904761904762,42,1100,800,300,0.7272727272727273,14,8,6,345.9646974798492,0.429369918699187,0.0922077922077924,0.21142287068212987,132934.57031249988,928.8529884194993,133863.42330091938,2663,1,386.0,37,5,17,33.26809764309764,0.6478040540540541,42.18749999999999,1031.249999999999,27.871621621621596,8
4193,4,1,0,42,0.023809523809523808,0.0,1.0,42,900,500,400,0.5555555555555556,13,5,8,336.0466397221319,0.4298296554394115,0.09260628283604877,0.20680781101880494,133196.36774965297,552.0383610928441,133748.40611074583,2664,0,384.5952380952381,38,4,18,33.261531428965704,0.6485745614035088,41.93376068376068,1032.264957264957,27.16486729644624,0
4194,4,0,0,42,0.0,0.0,1.0,42,1200,600,600,0.5,18,6,12,356.5421044886333,0.42996273712737126,0.15707322734130202,0.21000159360072146,131541.75347222228,1159.6839844035455,132701.43745662583,2665,1,385.5952380952381,34,8,21,34.39784727863525,0.6400122549019608,43.54166666666667,1025.833333333334,30.171568627451,8
4195,4,0,0,42,0.0,0.0,1.0,42,1200,900,300,0.75,15,9,6,359.7849574758966,0.42963608207510645,0.09866576626353174,0.20469916773750899,130206.62607725458,969.2770852570078,131175.9031625116,2666,2,386.5952380952381,37,5,15,35.66645179773671,0.6204954954954955,44.84649122807018,1020.6140350877197,27.58416311047891,7
4196,4,0,2,40,0.0,0.047619047619047616,0.9523809523809523,42,800,500,300,0.625,11,5,6,358.21384076711445,0.4289585753000387,0.10113933889707138,0.20439260326123576,130318.55955678667,936.3823484148957,131254.94190520156,2667,3,387.5952380952381,37,5,15,35.592962485681575,0.6216216216216216,44.73684210526316,1021.0526315789471,27.596017069701272,0
4197,4,1,0,41,0.024390243902439025,0.0,1.0,41,950,600,350,0.631578947368421,13,6,7,357.7803046093911,0.4267276422764228,0.11498071012881672,0.206071731963099,130682.67549871113,1151.1374894198175,131833.81298813096,2668,0,365.4390243902439,37,4,14,35.23491957104558,0.6252815315315315,44.38048245614035,1022.4780701754386,27.634542437174016,0
4198,4,0,0,41,0.0,0.0,1.0,41,1300,1000,300,0.7692307692307693,16,10,6,359.19067980258296,0.4253302845528455,0.11137131088413321,0.20793842580134622,130878.94833025531,1202.099684518295,132081.0480147736,2669,1,366.4390243902439,37,4,16,35.000089298471195,0.6272522522522522,44.18859649122806,1023.2456140350865,27.65528686581315,0
4199,4,0,2,39,0.0,0.04878048780487805,0.9512195121951219,41,1300,800,500,0.6153846153846154,18,8,10,360.4474117095028,0.42510162601626017,0.10763367353069508,0.20942734804801671,131019.23338190601,1245.1087113342642,132264.34209324027,2670,2,367.4390243902439,37,4,16,34.8259389168541,0.6286599099099099,44.0515350877193,1023.7938596491231,27.670104314841165,0
4200,4,0,1,38,0.0,0.02564102564102564,0.9743589743589743,39,800,600,200,0.75,10,6,4,372.7989791192551,0.4228520017993702,0.11867352593843528,0.21518122654976227,130765.21675936654,1949.8278624400027,132715.04462180653,2671,3,386.7435897435897,35,4,16,34.767289992833156,0.6300595238095238,44.299768518518526,1022.8009259259269,29.222883597883627,0
4201,4,0,0,38,0.0,0.0,1.0,38,1200,600,600,0.5,18,6,12,373.5203291662451,0.42241583688952106,0.11747321871535621,0.21584802881812679,130810.03578514748,2172.0415249433227,132982.0773100908,2672,4,396.10526315789474,34,4,16,34.70339229605493,0.6326593137254901,44.25595238095239,1022.9761904761912,30.087535014005624,0
4202,4,0,0,38,0.0,0.0,1.0,38,1350,1100,250,0.8148148148148148,16,11,5,371.5906061450644,0.4216453295400664,0.122623376305383,0.2155827281805172,130962.30867346945,2132.8727324263123,133095.18140589577,2673,5,397.10526315789474,34,4,17,34.5984046677522,0.6341911764705883,44.10714285714286,1023.5714285714291,30.10504201680674,0
4203,4,0,1,37,0.0,0.02631578947368421,0.9736842105263158,38,1150,900,250,0.782608695652174,14,9,5,373.06323120201284,0.4204302987197724,0.12284270480921511,0.21729607163377918,131114.670138889,2182.812500000005,133297.482638889,2674,6,398.10526315789474,34,4,17,34.406360184431776,0.6357230392156863,43.958333333333336,1024.1666666666674,30.122549019607867,0
4204,4,0,0,37,0.0,0.0,1.0,37,1200,900,300,0.75,15,9,6,378.69524872673964,0.4200763263263263,0.1304413929189514,0.22018084920750935,131045.64838343432,2525.272881824308,133570.92126525863,2675,7,408.3243243243243,33,4,17,34.332111510073815,0.6373106060606061,44.02573529411765,1023.89705882353,31.02718360071303,0
4205,4,0,0,37,0.0,0.0,1.0,37,1050,800,250,0.7619047619047619,13,8,5,374.26613047542446,0.4197947947947948,0.027741188046531917,0.20363425565483942,128446.04768990923,2214.6010487528283,130660.64873866206,2676,8,409.3243243243243,34,3,15,37.092630651790955,0.6087622549019608,46.57738095238095,1013.6904761904757,29.81442577030811,8
4206,4,0,0,37,0.0,0.0,1.0,37,900,400,500,0.4444444444444444,14,4,10,374.92385678056496,0.419700950950951,0.02319684954415524,0.20430111888676075,128506.39349489787,2236.0225340135976,130742.41602891147,2677,9,410.3243243243243,34,3,15,37.01420688035693,0.609375,46.51785714285714,1013.9285714285708,29.82142857142855,0
4207,4,1,0,38,0.02631578947368421,0.0,1.0,38,1550,1400,150,0.9032258064516129,17,14,3,368.7153188691651,0.42216394025604553,0.03025641025641046,0.20310589598725193,128936.76757812499,1908.1922743055543,130844.95985243053,2678,0,400.5,35,3,17,36.731837606837615,0.6116071428571428,46.09375,1015.6249999999999,29.01785714285714,0
4208,4,0,0,38,0.0,0.0,1.0,38,700,700,0,1.0,7,7,0,371.3013849167676,0.42235656709340924,0.032628701266778526,0.2051387575949844,129054.34355977798,1983.6112986539783,131037.95485843196,2679,1,401.5,35,3,17,36.54613756312411,0.612797619047619,45.97800925925926,1016.0879629629632,29.031084656084662,0
4209,4,0,1,37,0.0,0.02631578947368421,0.9736842105263158,38,850,600,250,0.7058823529411765,11,6,5,371.3013849167676,0.42201576576576577,0.032628701266778526,0.2051387575949844,129054.34355977798,1983.6112986539783,131037.95485843196,2680,2,402.5,35,3,17,36.54613756312411,0.612797619047619,45.97800925925926,1016.0879629629632,29.031084656084662,0
4210,4,1,0,38,0.02631578947368421,0.0,1.0,38,850,600,250,0.7058823529411765,11,6,5,370.532115022843,0.42303816974869607,0.03796376186367545,0.20547690014903136,129201.38888888907,1974.6527777777974,131176.04166666686,2681,0,401.3421052631579,35,3,19,36.41564207650272,0.6142857142857143,45.83333333333334,1016.6666666666681,29.04761904761909,0
4211,4,1,0,39,0.02564102564102564,0.0,1.0,39,1200,1000,200,0.8333333333333334,14,10,4,366.5759882907457,0.4252699055330634,0.03717663850981645,0.20500923975632226,129534.44054705225,1696.8431122449106,131231.28365929716,2682,0,392.02564102564105,34,5,14,36.17681167894593,0.6197916666666667,45.50595238095239,1017.9761904761912,29.94047619047621,0
4212,4,0,1,38,0.0,0.02564102564102564,0.9743589743589743,39,800,200,600,0.25,14,2,12,366.70295920220667,0.42451079622132254,0.033618633197875836,0.2058733936308452,129685.96938775509,1711.245748299314,131397.2151360544,2683,1,393.02564102564105,34,5,15,36.019313931743795,0.6213235294117647,45.357142857142854,1018.5714285714284,29.957983193277308,0
4213,4,0,1,37,0.0,0.02631578947368421,0.9736842105263158,38,850,500,350,0.5882352941176471,12,5,7,377.0669382829432,0.4210970839260313,0.036059093327927005,0.2110965042624456,129575.4337274125,2171.7224144559705,131747.15614186847,2684,2,404.3157894736842,33,5,16,35.86803883806772,0.6224747474747474,45.4656862745098,1018.1372549019605,30.8526440879382,0
4214,4,0,0,37,0.0,0.0,1.0,37,1150,900,250,0.782608695652174,14,9,5,385.5811889298451,0.421265015015015,0.03887710693214563,0.21645674677084625,129683.21352731867,2600.6815312213025,132283.89505854,2685,3,393.8918918918919,32,5,16,35.54140324779967,0.6259765625,45.359848484848484,1018.5606060606063,31.83001893939395,0
4215,4,0,0,37,0.0,0.0,1.0,37,1550,1100,450,0.7096774193548387,20,11,9,383.41230675168123,0.42160910910910915,0.032678706744126984,0.215921667486473,129807.25623582753,2553.9399092970298,132361.19614512456,2686,4,394.8918918918919,34,3,17,35.47021028037381,0.6225490196078431,45.23809523809523,1019.047619047618,29.971988795518175,0
4216,4,0,1,36,0.0,0.02702702702702703,0.972972972972973,37,850,500,350,0.5882352941176471,12,5,7,382.03780215713437,0.4215152652652652,0.03576670212195121,0.21564862886430697,129898.25857426286,2525.209041950088,132423.46761621293,2687,5,395.8918918918919,34,3,18,35.41253065514422,0.623468137254902,45.14880952380951,1019.4047619047604,29.982492997198836,0
4217,4,0,0,36,0.0,0.0,1.0,36,1150,800,350,0.6956521739130435,15,8,7,390.13584546254316,0.4176421957671958,0.03032337809848329,0.21963300981862177,129793.87622849375,2927.44872765281,132721.32495614656,2688,6,407.6388888888889,33,3,18,35.31256263780315,0.6246843434343434,45.25122549019607,1018.9950980392149,30.878639334521665,0
4218,4,0,0,36,0.0,0.0,1.0,36,1400,900,500,0.6428571428571429,19,9,10,388.3412249451314,0.41651785714285716,0.03177799147867666,0.21932183640994876,129918.78311526803,2890.563875672797,132809.34699094083,2689,7,408.6388888888889,33,3,18,35.230972272308364,0.6259469696969697,45.128676470588225,1019.4852941176459,30.893493761140785,0
4219,4,2,1,37,0.05263157894736842,0.02631578947368421,0.9736842105263158,38,1000,800,200,0.8,12,8,4,368.6777287727084,0.421289710763395,0.041529461542706425,0.2113801567171782,130505.75573979596,2023.3674260145283,132529.12316581048,2690,0,388.07894736842104,34,4,16,35.13583051769,0.6295955882352942,44.55357142857143,1021.7857142857147,30.052521008403374,0
4220,4,1,1,37,0.02631578947368421,0.02631578947368421,0.9736842105263158,38,1300,800,500,0.6153846153846154,18,8,10,366.79356156344994,0.42167496443812236,0.04138839531891403,0.21146018079396212,130718.714569161,1989.356575963719,132708.07114512473,2691,0,389.05263157894734,34,4,17,34.96798603026776,0.6317401960784313,44.345238095238095,1022.6190476190477,30.07703081232493,0
4221,4,0,0,37,0.0,0.0,1.0,37,1150,900,250,0.782608695652174,14,9,5,369.1065238700451,0.4186061061061061,0.037518318877406864,0.21346577834045533,130840.48327664396,2258.815192743761,133099.29846938772,2692,1,382.27027027027026,34,3,19,34.78541230315724,0.6329656862745099,44.226190476190474,1023.095238095238,30.09103641456582,0
4222,4,0,0,37,0.0,0.0,1.0,37,1150,700,450,0.6086956521739131,16,7,9,365.47695833161634,0.4183871371371371,0.04419118502151442,0.21220367080982916,130992.77388038556,2174.968112244906,133167.74199263047,2693,2,383.27027027027026,34,3,19,34.72399891460247,0.6344975490196079,44.077380952380956,1023.6904761904768,30.108543417366967,0
4223,4,0,0,37,0.0,0.0,1.0,37,1450,1000,450,0.6896551724137931,19,10,9,364.9219514735989,0.41816816816816815,0.04821767374068586,0.21272279610290287,131145.15306122456,2171.5490362811843,133316.70209750574,2694,3,384.27027027027026,34,3,20,34.58396288547961,0.6360294117647058,43.92857142857143,1024.285714285715,30.126050420168085,0
4224,4,0,0,37,0.0,0.0,1.0,37,1100,800,300,0.7272727272727273,14,8,6,365.44739240693104,0.41688563563563563,0.04872336618183981,0.21387740321082732,131297.62081916098,2196.474631519276,133494.09545068027,2695,4,385.27027027027026,34,3,20,34.41626011538313,0.6375612745098039,43.779761904761905,1024.8809523809523,30.143557422969185,0
4225,4,1,2,36,0.02631578947368421,0.05263157894736842,0.9473684210526316,38,900,600,300,0.6666666666666666,12,6,6,353.84575742740094,0.4184003082029398,0.049772909430937595,0.2087054317760417,131595.18771701382,1712.8797743055459,133308.06749131935,2696,0,376.10526315789474,35,3,16,34.41307106598984,0.6383928571428572,43.48958333333333,1026.041666666666,29.315476190476172,0
4226,4,0,0,36,0.0,0.0,1.0,36,800,500,300,0.625,11,5,6,372.46005201990323,0.41387235449735454,0.06328470644505568,0.21797644611913572,131296.72369100823,2580.556907199155,133877.28059820738,2697,6,397.6111111111111,33,3,21,34.2374895372474,0.6398358585858586,43.78063725490196,1024.877450980392,31.056892453951274,0
4227,4,0,0,36,0.0,0.0,1.0,36,1100,800,300,0.7272727272727273,14,8,6,372.47539711946956,0.4131613756613757,0.13252879097949521,0.20836047972198202,129544.24267409163,2455.0079897154856,131999.25066380712,2698,7,398.6111111111111,33,3,18,36.01668773323702,0.6221590909090908,45.49632352941176,1018.0147058823525,30.848930481283407,8
4228,4,1,1,36,0.02702702702702703,0.02702702702702703,0.972972972972973,37,1350,1000,350,0.7407407407407407,17,10,7,360.54311555073707,0.41356981981981983,0.14463845119927332,0.20399024622243142,129989.29280045339,1973.3489229024808,131962.64172335586,2699,0,388.81081081081084,34,3,19,35.867820452953545,0.6243872549019608,45.0595238095238,1019.7619047619037,29.99299719887952,0
4229,4,0,0,36,0.0,0.0,1.0,36,1200,900,300,0.75,15,9,6,367.35138907476727,0.412119708994709,0.15117477729801276,0.20832786584921764,130080.35891439894,2357.040107709736,132437.39902210867,2700,1,398.0,34,2,19,35.60168436612596,0.6253063725490196,44.97023809523809,1020.1190476190463,30.003501400560186,0
4230,4,0,1,35,0.0,0.027777777777777776,0.9722222222222222,36,1050,800,250,0.7619047619047619,13,8,5,367.35168814498894,0.4117724867724868,0.1604082476426738,0.20947343695659834,130293.86421388401,2372.861745801255,132666.72595968525,2701,2,399.0,33,3,19,35.384782739166965,0.6297348484848485,44.7610294117647,1020.9558823529405,30.9380570409982,0
4231,4,0,0,35,0.0,0.0,1.0,35,1250,900,350,0.72,16,9,7,372.3312037735671,0.4122198879551821,0.16497950362760094,0.21197174273616132,130231.31315179254,2697.8363189638553,132929.14947075638,2702,3,408.9428571428571,33,2,20,35.321242045863855,0.6291035353535354,44.822303921568626,1020.7107843137251,30.930629827688637,0
4232,4,1,1,35,0.027777777777777776,0.027777777777777776,0.9722222222222222,36,950,500,450,0.5263157894736842,14,5,9,357.3228661369138,0.41415343915343916,0.15221343241839458,0.2057380726142354,130669.4859699394,2138.242803248744,132807.72877318814,2703,0,398.55555555555554,33,3,18,35.259973430820246,0.6335227272727273,44.393382352941174,1022.4264705882349,30.982620320855602,0
4233,4,0,0,35,0.0,0.0,1.0,35,1050,800,250,0.7619047619047619,13,8,5,367.502339612103,0.4094537815126051,0.15541162975381617,0.21113778844286565,130585.01882779834,2598.0599875012945,133183.07881529964,2704,5,410.9428571428571,32,3,18,35.08544368952028,0.6350911458333333,44.47601010101011,1022.0959595959608,31.940498737373776,0
4234,4,0,0,35,0.0,0.0,1.0,35,900,600,300,0.6666666666666666,12,6,6,366.74243043180246,0.4091386554621849,0.15395198701779766,0.2114054764460621,130714.10323245096,2587.681582236534,133301.7848146875,2705,6,411.9428571428571,32,3,18,34.97396797958596,0.6363932291666667,44.34974747474749,1022.6010101010116,31.956281565656614,0
4235,4,0,0,35,0.0,0.0,1.0,35,1050,700,350,0.6666666666666666,14,7,7,365.9689214678142,0.4091036414565827,0.14926552277496574,0.21131248986534332,130778.66934815345,2572.1857144679343,133350.85506262138,2706,7,412.9428571428571,32,3,19,34.92830103279431,0.6370442708333333,44.28661616161617,1022.8535353535369,31.96417297979803,0
4236,4,1,0,36,0.027777777777777776,0.0,1.0,36,950,600,350,0.631578947368421,13,6,7,353.4273654075825,0.41051587301587306,0.1403645210177875,0.20599343933588382,131139.7734645329,2069.6769271434123,133209.4503916763,2707,0,402.44444444444446,33,3,20,34.883744117412476,0.6382575757575757,43.93382352941177,1024.2647058823532,31.03832442067737,0
4237,4,0,0,36,0.0,0.0,1.0,36,850,700,150,0.8235294117647058,10,7,3,352.4928362407156,0.4104828042328042,0.1374067870957454,0.20561672143308754,131171.15600069697,2047.3785623318151,133218.53456302878,2708,1,403.44444444444446,33,3,20,34.87595705227898,0.6385732323232323,43.903186274509814,1024.3872549019618,31.042038027332175,0
4238,4,0,0,36,0.0,0.0,1.0,36,1250,800,450,0.64,17,8,9,355.59330827411833,0.40963955026455023,0.13613966584322745,0.20861806570976704,131390.93888168025,2144.3477268358442,133535.2866085161,2709,2,404.44444444444446,33,3,20,34.57446808510638,0.6407828282828283,43.688725490196084,1025.2450980392166,31.068033273915656,0
4239,4,0,1,35,0.0,0.027777777777777776,0.9722222222222222,36,900,600,300,0.6666666666666666,12,6,6,357.4761914096684,0.40952380952380957,0.14262622641759926,0.2102402140483147,131485.18786344212,2200.5648368416223,133685.75270028375,2710,3,405.44444444444446,33,3,20,34.43101027601863,0.641729797979798,43.59681372549021,1025.6127450980407,31.07917409388002,0
4240,4,0,0,35,0.0,0.0,1.0,35,1050,600,450,0.5714285714285714,15,6,9,417.9643141090136,0.40875350140056027,0.18779082985979545,0.22704977870187043,128382.79714417845,3805.696554533714,132188.49369871215,2711,4,416.8285714285714,30,5,16,36.050232095490706,0.6180555555555556,46.63978494623655,1013.4408602150531,33.78136200716844,8
4241,4,0,1,34,0.0,0.02857142857142857,0.9714285714285714,35,1050,700,350,0.6666666666666666,14,7,7,412.7545765694802,0.40812324929971994,0.1836200256739411,0.22548093628865717,128606.37240939675,3616.5737575954904,132222.94616699225,2712,5,417.8285714285714,31,4,16,35.952610183996576,0.6176075268817205,46.419270833333336,1014.3229166666671,32.72009408602152,0
4242,4,0,0,34,0.0,0.0,1.0,34,1200,600,600,0.5,18,6,12,421.0491099793198,0.40537730243612596,0.19110629405526813,0.2295082720869933,128519.04844490685,4022.5661926234147,132541.61463753026,2713,14,430.97058823529414,30,4,16,35.83200777659951,0.6194444444444445,46.50537634408602,1013.9784946236553,33.799283154121845,0
4243,4,3,1,36,0.08108108108108109,0.02702702702702703,0.972972972972973,37,950,700,250,0.7368421052631579,12,7,5,392.21385168650795,0.4153215715715716,0.20213963963963955,0.21963975694444443,129586.77685950411,2766.952343174434,132353.72920267854,2714,0,396.94594594594594,32,5,15,35.4709201388889,0.625,45.45454545454545,1018.181818181818,31.818181818181813,0
4244,4,0,0,36,0.0,0.0,1.0,36,750,500,250,0.6666666666666666,10,5,5,399.26497780580803,0.41129298941798936,0.20718184919822624,0.2229039333235853,129466.28146701385,3138.2703993055507,132604.5518663194,2715,1,408.97222222222223,31,5,16,35.414534288638684,0.6263440860215054,45.572916666666664,1017.7083333333329,32.8293010752688,0
4245,4,0,0,36,0.0,0.0,1.0,36,850,600,250,0.7058823529411765,11,6,5,396.7721536011021,0.41111111111111115,0.2011526107842303,0.22188588675632448,129532.5469970703,3078.9815266927085,132611.528523763,2716,2,409.97222222222223,31,5,16,35.410271169096966,0.627016129032258,45.5078125,1017.9687499999999,32.837701612903224,0
4246,4,1,0,37,0.02702702702702703,0.0,1.0,37,600,400,200,0.6666666666666666,8,4,4,389.55608936500016,0.414695945945946,0.20732099112485503,0.22031197322911333,129972.73875114774,2726.334366391175,132699.0731175389,2717,0,399.86486486486484,32,5,18,35.14502847944527,0.62890625,45.07575757575757,1019.6969696969688,31.865530303030276,0
4247,4,1,0,38,0.02631578947368421,0.0,1.0,38,1100,800,300,0.7272727272727273,14,8,6,380.00165480149417,0.41613323850165956,0.2021123379740759,0.21686121834288008,130325.1453767781,2304.754181084191,132629.89955786229,2718,0,390.3157894736842,33,5,19,35.03010481677069,0.630050505050505,44.73039215686274,1021.0784313725485,30.941770647652984,0
4248,4,0,0,38,0.0,0.0,1.0,38,1300,1000,300,0.7692307692307693,16,10,6,376.81484198769726,0.41583688952110004,0.2016470647651869,0.21591101976985796,130481.60750973188,2233.481263216073,132715.08877294796,2719,1,391.3157894736842,33,5,19,34.9524959018032,0.6316287878787878,44.57720588235294,1021.6911764705885,30.960338680926924,0
4249,4,0,0,38,0.0,0.0,1.0,38,1000,500,500,0.5,15,5,10,378.90723392508994,0.4154220009483167,0.20261264672472512,0.21763679965118818,130575.52984429077,2295.202566320658,132870.7324106114,2720,2,392.3157894736842,33,5,17,34.803657074340535,0.6325757575757576,44.485294117647065,1022.0588235294126,30.97147950089129,0
4250,4,0,0,38,0.0,0.0,1.0,38,1200,900,300,0.75,15,9,6,354.6731239731333,0.415244191559981,0.11580748824695042,0.20089271318478205,130032.77084094222,1623.825810607896,131656.59665155012,2721,3,393.3157894736842,36,2,16,35.97332634058371,0.6206597222222222,45.01689189189189,1019.9324324324318,28.33145645645644,8
4251,4,0,0,38,0.0,0.0,1.0,38,1050,700,350,0.6666666666666666,14,7,7,356.00067627990137,0.414681128496918,0.12453972052178575,0.20238884118246334,130176.38204082457,1668.5760084408678,131844.95804926543,2722,4,394.3157894736842,36,2,16,35.79369896270139,0.6221064814814814,44.876126126126124,1020.4954954954951,28.347097097097087,0
4252,4,0,1,37,0.0,0.02631578947368421,0.9736842105263158,38,1200,900,300,0.75,15,9,6,354.3495192252287,0.4135846372688478,0.12632901072022729,0.20175538180439975,130235.32238476122,1629.7647746365392,131865.08715939775,2723,5,395.3157894736842,38,0,16,35.77602749284767,0.6189692982456141,44.818376068376054,1020.7264957264936,26.861223571749832,0
4253,4,0,1,36,0.0,0.02702702702702703,0.972972972972973,37,1300,1000,300,0.7692307692307693,16,10,6,360.4516328838294,0.4116303803803804,0.1222546138747258,0.20507847181434488,130206.62607725443,1986.6381963681042,132193.26427362254,2724,7,406.86486486486484,37,0,17,35.64944134078214,0.6204954954954955,44.84649122807017,1020.6140350877184,27.584163110478876,0
4254,4,0,0,36,0.0,0.0,1.0,36,1100,900,200,0.8181818181818182,13,9,4,367.3469387755106,0.4087797619047619,0.13253968253968296,0.2093023255813953,130262.58680555536,2370.3365458602443,132632.9233514156,2725,8,418.8888888888889,34,2,18,35.41666666666666,0.6271446078431373,44.79166666666666,1020.8333333333318,30.02450980392152,0
4255,4,0,0,36,0.0,0.0,1.0,36,1050,800,250,0.7619047619047619,13,8,5,364.6394722692585,0.4072420634920635,0.13110796348756737,0.20855109156035015,130410.31867551853,2310.5499560613694,132720.8686315799,2726,9,419.8888888888889,35,1,19,35.33581208687441,0.6264880952380952,44.64699074074073,1021.4120370370358,29.183201058201025,0
4256,4,0,0,36,0.0,0.0,1.0,36,950,700,250,0.7368421052631579,12,7,5,364.82232022158144,0.4076719576719577,0.12491660687536976,0.20897382352990904,130469.43486636224,2319.632389188949,132789.0672555512,2727,10,420.8888888888889,35,1,20,35.27116139873872,0.6270833333333333,44.58912037037037,1021.643518518518,29.1898148148148,0
4257,4,0,0,36,0.0,0.0,1.0,36,950,600,350,0.631578947368421,13,6,7,357.98742524764697,0.4076388888888889,0.10620394595482763,0.19956039666151337,129407.39300679442,2065.2438861025403,131472.63689289696,2728,11,421.8888888888889,35,1,18,36.52468907594889,0.6163690476190475,45.63078703703704,1017.476851851852,29.0707671957672,8
4258,4,0,0,36,0.0,0.0,1.0,36,700,400,300,0.5714285714285714,10,4,6,354.883448944508,0.4078207671957672,0.12586197803356924,0.18091971108622912,125804.86288265293,1743.3621662720964,127548.22504892503,2729,12,422.8888888888889,34,2,16,40.29582492781138,0.5818014705882353,49.19642857142856,1003.2142857142846,29.506302521008372,8
4259,4,0,0,36,0.0,0.0,1.0,36,900,500,400,0.5555555555555556,13,5,8,370.54496030901544,0.40808531746031745,0.12353648135225259,0.1799969247873964,123787.67602237655,1973.7798996913596,125761.45592206791,2730,13,423.8888888888889,35,1,18,41.9966852756455,0.5589285714285714,51.21527777777778,995.1388888888889,28.432539682539684,7
4260,4,5,1,40,0.12195121951219512,0.024390243902439025,0.975609756097561,41,800,600,200,0.75,10,6,4,342.37450297220056,0.4263973577235773,0.17534424863992504,0.1722904990789217,125267.23669552206,377.9027070092915,125645.13940253135,2731,0,373.0731707317073,38,3,16,41.16439879046604,0.5685307017543859,49.73290598290599,1001.068376068377,26.343904633378344,0
4261,4,2,0,42,0.047619047619047616,0.0,1.0,42,1600,1400,200,0.875,18,14,4,336.70050999292386,0.43038617886178865,0.18703596531580313,0.17123168566835095,125704.11376953151,64.92784288197402,125769.04161241348,2732,0,365.14285714285717,39,3,18,40.85568799556805,0.5713141025641026,49.296875000000014,1002.812500000002,25.71314102564108,0
4262,4,3,2,43,0.06666666666666667,0.044444444444444446,0.9555555555555556,45,950,600,350,0.631578947368421,13,6,7,346.29383930370153,0.43651094276094277,0.2912147668904421,0.1713233795584604,124557.68364800366,-243.19932725692303,124314.48432074673,2733,0,341.73333333333335,39,6,18,41.80069306758495,0.5595619658119658,50.44270833333334,998.2291666666682,25.5956196581197,8
4263,4,4,3,44,0.0851063829787234,0.06382978723404255,0.9361702127659575,47,1100,700,400,0.6363636363636364,15,7,8,329.7819027617885,0.43950431699044096,0.3008387995138544,0.16603110882365416,125286.6224500872,-1134.9799262152394,124151.64252387197,2734,0,328.0425531914894,39,8,19,41.45954722019907,0.5670405982905983,49.713541666666686,1001.1458333333366,25.670405982906065,0
4264,4,7,4,47,0.13725490196078433,0.0784313725490196,0.9215686274509804,51,750,500,250,0.6666666666666666,10,5,5,306.5920827439758,0.4500490196078431,0.312633646907704,0.15880368357696936,126457.71362898854,-2441.2505228755454,124016.46310611299,2735,0,298.921568627451,42,9,17,40.83714675658317,0.5744047619047619,48.54651162790697,1005.8139534883712,23.94795127353265,0
4265,4,2,1,48,0.04081632653061224,0.02040816326530612,0.9795918367346939,49,1050,700,350,0.6666666666666666,14,7,7,325.47672802508083,0.44848356009070295,0.33623680808822143,0.16877391989105667,126503.47764434188,-1565.2124025051396,124938.26524183674,2736,0,309.53061224489795,40,9,18,40.31530962723506,0.5778645833333333,48.501016260162594,1005.9959349593487,25.149898373983717,0
4266,4,2,0,50,0.04,0.0,1.0,50,900,600,300,0.6666666666666666,12,6,6,322.5358020513271,0.44941326530612247,0.34363242391411375,0.1685386514784932,126817.07180846867,-1819.3908060909703,124997.68100237769,2737,0,304.3,41,9,21,40.067693456777945,0.5795223577235773,48.18948412698412,1007.2420634920628,24.566879597367386,0
4267,4,4,3,51,0.07407407407407407,0.05555555555555555,0.9444444444444444,54,1550,1200,350,0.7741935483870968,19,12,7,296.89309125334034,0.45331062194269744,0.34457113202219203,0.15885580726046986,127775.65646701399,-3211.0717681169644,124564.58469889703,2738,0,282.68518518518516,39,15,14,39.7353011882684,0.5924145299145299,47.239583333333336,1011.0416666666675,25.924145299145323,0
4268,4,0,2,49,0.0,0.0392156862745098,0.9607843137254902,51,1300,600,700,0.46153846153846156,20,6,14,317.9928943689677,0.4504738562091503,0.3520885665002986,0.1690621380910062,127518.18700034512,-2090.0245262153826,125428.16247412974,2739,1,300.078431372549,36,15,17,39.464869736499786,0.5951967592592593,47.49436936936938,1010.022522522524,28.056181181181223,0
4269,4,1,0,50,0.02,0.0,1.0,50,1500,900,600,0.6,21,9,12,323.3181297435478,0.4482993197278911,0.35376639864578907,0.17168555968179858,127469.34125940541,-1757.3701968733963,125711.97106253201,2740,0,306.94,38,12,18,39.3803339681196,0.5910087719298245,47.542735042735046,1009.8290598290603,26.574448942870006,0
4270,4,0,0,50,0.0,0.0,1.0,50,1950,1400,550,0.717948717948718,25,14,11,323.19926215146626,0.4483673469387755,0.345021645021645,0.17247960623726782,127670.36132812513,-1747.4066840277642,125922.95464409736,2741,1,307.94,39,11,19,39.177918642204354,0.5913461538461539,47.34375000000001,1010.625000000001,25.913461538461565,0
4271,4,0,0,50,0.0,0.0,1.0,50,1500,1000,500,0.6666666666666666,20,10,10,326.4860078274059,0.44801870748299316,0.3481252575195706,0.17491866247176974,127828.32031250045,-1653.1684027777374,126175.15190972271,2742,2,308.94,39,11,20,38.93352561461339,0.592948717948718,47.18750000000002,1011.2500000000036,25.92948717948727,0
4272,4,1,3,48,0.0196078431372549,0.058823529411764705,0.9411764705882353,51,1750,1400,350,0.8,21,14,7,325.8180944656816,0.448921568627451,0.3575927457030126,0.1763286422182549,128232.43694540905,-1841.9572241512228,126390.47972125783,2743,0,303.8627450980392,35,16,21,38.53809564621185,0.6044642857142857,46.78819444444445,1012.8472222222231,28.938492063492088,0
4273,4,2,0,50,0.04,0.0,1.0,50,1650,1300,350,0.7878787878787878,20,13,7,332.12108749902507,0.4478571428571429,0.35479844870137534,0.1798865902946662,128265.095308957,-1480.0914115646128,126785.00389739238,2744,0,310.34,34,16,25,38.34518353116309,0.6069240196078431,46.75595238095239,1012.976190476191,29.793417366946795,0
4274,4,0,0,50,0.0,0.0,1.0,50,1300,1100,200,0.8461538461538461,15,11,4,330.34984332466365,0.4474404761904762,0.35100707924183605,0.17970210731909358,128437.6674489884,-1514.1273362482773,126923.54011274013,2745,1,311.34,35,15,16,38.21410900510008,0.6065476190476191,46.58564814814815,1013.657407407408,28.961640211640226,0
4275,4,1,3,48,0.0196078431372549,0.058823529411764705,0.9411764705882353,51,1400,1000,400,0.7142857142857143,18,10,8,326.734742430109,0.44792483660130716,0.35959005632490637,0.17966530373532125,128867.17547706992,-1778.9233225607804,127088.25215450914,2746,0,306.2156862745098,37,14,18,37.86852051835854,0.6069819819819819,46.16228070175439,1015.3508771929828,27.441915599810347,0
4276,4,0,0,48,0.0,0.0,1.0,48,900,700,200,0.7777777777777778,11,7,4,340.3894751885845,0.4450539302600473,0.3545470973141609,0.18570937618943806,128555.01570001703,-848.2451346021988,127706.77056541483,2747,1,319.6666666666667,35,13,19,37.84000989119686,0.6077380952380953,46.469907407407405,1014.1203703703694,28.974867724867696,0
4277,4,0,0,48,0.0,0.0,1.0,48,1350,600,750,0.4444444444444444,21,6,15,338.1292487200997,0.44487847222222227,0.3501096369490395,0.1846895174785894,128601.01814229778,-903.2468701809831,127697.77127211679,2748,2,320.6666666666667,36,12,19,37.850421894082395,0.6061921296296297,46.42454954954955,1014.3018018018024,28.175050050050068,0
4278,4,1,1,48,0.02040816326530612,0.02040816326530612,0.9795918367346939,49,1400,1100,300,0.7857142857142857,17,11,6,329.2452986206137,0.4449404761904762,0.3449536999297178,0.18142767407035965,128950.68825263547,-1308.718427785468,127641.96982485,2749,0,315.1020408163265,37,12,21,37.71984868113282,0.6078265765765766,46.08004385964912,1015.6798245614038,27.45080606922713,0
4279,4,0,2,46,0.0,0.041666666666666664,0.9583333333333334,48,1050,700,350,0.6666666666666666,14,7,7,336.94655187937826,0.4438164893617021,0.3548684589361546,0.18554096096948863,128922.8476550476,-911.9782048322722,128010.86945021534,2750,1,322.4375,37,11,21,37.5526344202116,0.607545045045045,46.10745614035087,1015.5701754385957,27.447842579421504,0
4280,4,0,0,46,0.0,0.0,1.0,46,1500,600,900,0.4,24,6,18,352.6544353521979,0.44006642512077293,0.36004274019652804,0.1934555341344708,128772.40997331774,-117.56769438359407,128654.84227893414,2751,2,336.82608695652175,36,10,21,37.30722290025517,0.6079282407407407,46.25563063063062,1014.977477477476,28.193818818818777,0
4281,4,0,1,45,0.0,0.021739130434782608,0.9782608695652174,46,1250,1000,250,0.8,15,10,5,356.72844941201134,0.4404287439613526,0.3553713828381886,0.19639665181914012,128915.3236851715,-2.4472952682579034,128912.87638990325,2752,3,337.82608695652175,36,10,22,37.058059806313295,0.609375,46.114864864864856,1015.5405405405393,28.209459459459424,0
4282,4,1,0,46,0.021739130434782608,0.0,1.0,46,1250,1000,250,0.8,15,10,5,357.0948669712439,0.4405797101449275,0.34978617248752597,0.19802533532041722,129201.38888888896,28.064635581532514,129229.45352447049,2753,0,329.89130434782606,34,12,23,36.75717213114753,0.616421568627451,45.833333333333336,1016.6666666666673,29.901960784313744,0
4283,4,0,0,46,0.0,0.0,1.0,46,1550,900,650,0.5806451612903226,22,9,13,357.86460843541647,0.4401268115942029,0.3436145754918509,0.19967537029412152,129443.56575963722,64.65419501133726,129508.21995464855,2754,1,330.89130434782606,34,12,19,36.490992044922784,0.6188725490196079,45.595238095238095,1017.6190476190479,29.92997198879553,0
4284,4,0,1,45,0.0,0.021739130434782608,0.9782608695652174,46,1100,700,400,0.6363636363636364,15,7,8,371.45508484094137,0.44049919484702094,0.33385663980532,0.19019312267538865,125984.07206632622,173.10445011333982,126157.17651643956,2755,2,331.89130434782606,34,12,20,39.694997826001035,0.5836397058823529,49.017857142857125,1003.9285714285688,29.527310924369672,8
4285,4,5,1,49,0.1,0.02,0.98,50,1450,700,750,0.4827586206896552,22,7,15,340.63327032136146,0.4482568027210884,0.3306869565217394,0.17969186278420402,127202.60080024588,-1329.2619373465388,125873.33886289934,2756,0,306.12,37,13,17,39.216485507246375,0.5900900900900901,47.80701754385963,1008.7719298245585,27.26410621147455,0
4286,4,2,1,50,0.0392156862745098,0.0196078431372549,0.9803921568627451,51,950,500,450,0.5263157894736842,14,5,9,334.44038431807064,0.4488562091503268,0.33500049766099305,0.17806690732610758,127577.25180802084,-1666.6029750164614,125910.64883300438,2757,0,301.078431372549,38,13,16,38.98913388324871,0.5921052631578947,47.435897435897424,1010.2564102564087,26.585695006747596,0
4287,4,1,1,50,0.0196078431372549,0.0196078431372549,0.9803921568627451,51,850,500,350,0.5882352941176471,12,5,7,356.53647075893184,0.4497875816993464,0.35745997634397875,0.18486494541112886,126500.20089122641,-1169.3401179779496,125330.86077324847,2758,0,302.03921568627453,38,13,18,39.537533630699514,0.581140350877193,48.5042735042735,1005.982905982905,26.473234367971184,8
4288,4,3,1,52,0.05660377358490566,0.018867924528301886,0.9811320754716981,53,1750,1200,550,0.6857142857142857,23,12,11,343.0728891853366,0.4523615142718916,0.39887968496774096,0.18209557559122563,127451.59718615346,-1850.8190828648947,125600.77810328857,2759,0,291.5660377358491,37,16,20,38.89978553588881,0.5926238738738738,47.56030701754386,1009.7587719298248,27.290777619724995,0
4289,4,1,1,52,0.018867924528301886,0.018867924528301886,0.9811320754716981,53,1700,1000,700,0.5882352941176471,24,10,14,334.59752155362276,0.451348572810837,0.3835013549292601,0.17902996384782063,127775.65646701405,-2049.316406249984,125726.34006076407,2760,0,284.54716981132077,39,14,21,38.78228243698056,0.5924145299145299,47.23958333333334,1011.041666666668,25.924145299145334,0
4290,4,2,0,54,0.037037037037037035,0.0,1.0,54,1500,1300,200,0.8666666666666667,17,13,4,322.6172957063709,0.45215321453529,0.39750852826510696,0.1751351033834589,128355.5555555559,-2516.992187499963,125838.56336805594,2761,0,279.9259259259259,39,15,23,38.4936951754386,0.5982905982905983,46.666666666666686,1013.3333333333361,25.982905982906054,0
4291,4,0,2,52,0.0,0.037037037037037035,0.962962962962963,54,1850,1200,650,0.6486486486486487,25,12,13,323.4744878995486,0.45216049382716045,0.4010823869580933,0.1764159181905944,128540.34423828148,-2484.0955946180275,126056.24864366345,2762,1,280.9259259259259,39,15,17,38.28379130285913,0.6001602564102564,46.484375000000014,1014.0625000000018,26.001602564102612,0
4292,4,1,0,53,0.018867924528301886,0.0,1.0,53,1450,800,650,0.5517241379310345,21,8,13,341.21483275166963,0.4525731736816643,0.4314784957950235,0.17800725612225654,126750.27041644129,-1948.4901147180742,124801.7803017232,2763,0,286.66037735849056,42,11,17,39.665928919681804,0.5773809523809523,48.25581395348837,1006.9767441860463,23.975636766334436,8
4293,4,5,3,55,0.08620689655172414,0.05172413793103448,0.9482758620689655,58,1800,1300,500,0.7222222222222222,23,13,10,329.39705328796185,0.4575834341601129,0.44250053629104236,0.17708000796870002,127965.07284750491,-3169.276332521883,124795.79651498303,2764,0,262.86206896551727,46,12,16,38.720282426472735,0.5844655797101449,47.052304964539,1011.790780141842,21.995451742213955,0
4294,4,2,1,56,0.03508771929824561,0.017543859649122806,0.9824561403508771,57,1000,500,500,0.5,15,5,10,335.3218126810272,0.4558270676691729,0.4553866542306717,0.1805566560522946,128029.91694398482,-2813.7552345883446,125216.16170939647,2765,0,268.43859649122805,45,12,18,38.504187923267374,0.5863425925925926,46.98822463768115,1012.047101449274,22.489935587761643,0
4295,4,2,2,56,0.034482758620689655,0.034482758620689655,0.9655172413793104,58,1550,900,650,0.5806451612903226,22,9,13,331.0382311990897,0.45656886469046176,0.37668869569496066,0.18240450547594028,128948.26721178554,-3018.653430870648,125929.6137809149,2766,0,264.7068965517241,45,13,13,37.676785130354624,0.5956018518518518,46.08242753623187,1015.6702898550699,22.57045088566822,8
4296,4,0,2,54,0.0,0.03571428571428571,0.9642857142857143,56,1250,800,450,0.64,17,8,9,339.70849744844554,0.4545522186147186,0.38017868806569033,0.18622281161918086,128744.4860985564,-2452.880814537441,126291.60528401897,2767,1,274.9642857142857,43,13,13,37.66416674442473,0.596172480620155,46.28314393939393,1014.8674242424228,23.601568005637738,0
4297,4,0,2,52,0.0,0.037037037037037035,0.962962962962963,54,1650,1100,550,0.6666666666666666,22,11,11,347.74626182109506,0.4523279175401817,0.38150392597660665,0.19076632732930954,128773.09032698727,-1843.9278431279974,126929.16248385927,2768,2,285.462962962963,41,13,14,37.43107141693545,0.599339430894309,46.254960317460316,1014.9801587301586,24.75561362756484,0
4298,4,0,1,51,0.0,0.019230769230769232,0.9807692307692307,52,950,600,350,0.631578947368421,13,6,7,350.38653715562594,0.4515224358974359,0.34698237348712513,0.18831784942473231,127955.29827781457,-1314.6521753836005,126640.64610243097,2769,3,278.7692307692308,38,14,18,38.19935762055614,0.5959429824561404,47.06196581196583,1011.7521367521389,26.625056230319444,8
4299,4,1,0,52,0.019230769230769232,0.0,1.0,52,1550,1200,350,0.7741935483870968,19,12,7,347.31667337053244,0.451860231271996,0.3603913487904207,0.18818609696567928,128279.78326576078,-1489.1186582292446,126790.66460753154,2770,0,279.13461538461536,38,14,19,37.94536138648667,0.5992324561403508,46.74145299145299,1013.0341880341877,26.658794421952308,0
4300,4,1,0,53,0.018867924528301886,0.0,1.0,53,1800,1200,600,0.6666666666666666,24,12,12,339.1904320462764,0.4527092404450895,0.36704224315430056,0.18572535124017847,128698.84033203109,-1869.3169487847372,126829.52338324636,2771,0,274.8490566037736,39,14,18,37.72381771207611,0.6017628205128205,46.32812499999999,1014.6874999999987,26.017628205128172,0
4301,4,1,1,53,0.018518518518518517,0.018518518518518517,0.9814814814814815,54,1500,800,700,0.5333333333333333,22,8,14,333.31459190027556,0.4539366410435593,0.3715871001334241,0.18424939907363846,129075.3449093757,-2195.460817428831,126879.88409194686,2772,0,270.74074074074076,41,13,19,37.4897287578509,0.6023882113821138,45.957341269841265,1016.1706349206341,24.784649632210588,0
4302,4,2,1,54,0.03636363636363636,0.01818181818181818,0.9818181818181818,55,1700,1300,400,0.7647058823529411,21,13,8,326.83669014065663,0.4545735129068462,0.37878291920845175,0.18320845658343204,129625.34722222203,-2526.551575491329,127098.7956467307,2773,0,266.54545454545456,39,16,16,37.09594926350246,0.6111111111111112,45.41666666666666,1018.3333333333318,26.11111111111107,0
4303,4,0,2,52,0.0,0.037037037037037035,0.962962962962963,54,1500,700,800,0.4666666666666667,23,7,16,349.06315452889,0.4542642091777312,0.39189464567731336,0.18523278346168137,127442.37075617311,-1806.2114197530611,125636.15933642005,2774,1,272.48148148148147,41,13,14,38.758023842274184,0.5858739837398375,47.56944444444446,1009.7222222222244,24.627371273712793,8
4304,4,0,1,51,0.0,0.019230769230769232,0.9807692307692307,52,1750,1500,250,0.8571428571428571,20,15,5,359.41465433672056,0.44996700603318246,0.40400482355927947,0.19105726362109912,127512.50000000025,-1234.0277777777474,126278.4722222225,2775,2,283.38461538461536,39,13,14,38.424779977997815,0.5897435897435898,47.500000000000014,1010.0000000000019,25.897435897435948,0
4305,4,0,0,51,0.0,0.0,1.0,51,1350,800,550,0.5925925925925926,19,8,11,357.8751515848431,0.45040849673202615,0.3996750215237608,0.1909848581230006,127670.36132812513,-1061.9900173610954,126608.37131076404,2776,3,286.84313725490193,39,12,14,38.30181062323919,0.5913461538461539,47.34375000000001,1010.625000000001,25.913461538461565,0
4306,4,0,0,51,0.0,0.0,1.0,51,1950,1300,650,0.6666666666666666,26,13,13,360.6506175444139,0.45006535947712417,0.4004731396367487,0.19398450159614816,127986.37695312499,-968.3268229166667,127018.05013020831,2777,4,287.84313725490193,39,12,14,37.90791640930616,0.594551282051282,47.03125,1011.8749999999999,25.945512820512818,0
4307,4,2,0,53,0.03773584905660377,0.0,1.0,53,1550,900,650,0.5806451612903226,22,9,13,350.08953981249795,0.4508647798742138,0.41649664404907316,0.19210307469142204,128783.68975309699,-1582.4448387965635,127201.24491430042,2778,0,277.9433962264151,37,16,15,37.360803536062804,0.6061373873873874,46.244517543859644,1015.0219298245604,27.433025130393524,0
4308,4,1,1,53,0.018518518518518517,0.018518518518518517,0.9814814814814815,54,1500,1100,400,0.7333333333333333,19,11,8,321.1683934586427,0.4513961681807594,0.3246408966386467,0.17086799266949357,127545.97757582949,-2606.576368151801,124939.40120767769,2779,0,273.77777777777777,43,11,13,39.35628964719852,0.5840600775193798,47.46685606060607,1010.1325757575771,23.491455250176212,8
4309,4,1,1,53,0.018518518518518517,0.018518518518518517,0.9814814814814815,54,1400,800,600,0.5714285714285714,20,8,12,317.2584610421668,0.45059544607500585,0.31883907136810863,0.16969195040511909,127761.29548324172,-2693.329602846627,125067.96588039509,2780,0,274.51851851851853,43,11,14,39.2352004496066,0.5862403100775193,47.25378787878789,1010.9848484848501,23.511275546159304,0
4310,4,0,0,53,0.0,0.0,1.0,53,1250,800,450,0.64,17,8,9,324.3899213486582,0.4497157716497339,0.32017232897326076,0.17336248255682385,127727.90096748991,-2313.27125022535,125414.62971726456,2781,1,280.52830188679246,42,11,14,39.08906090235174,0.5873015873015873,47.286821705426355,1010.8527131782944,24.067921742340342,0
4311,4,1,1,53,0.018518518518518517,0.018518518518518517,0.9814814814814815,54,1650,1200,450,0.7272727272727273,21,12,9,314.26308738222656,0.45147624039133477,0.3161175207012443,0.16949911221574146,128096.59539284873,-2748.7936897383074,125347.80170311042,2782,0,276.31481481481484,43,11,15,38.969052073589054,0.5896317829457365,46.92234848484848,1012.3106060606043,23.542107117688474,0
4312,4,1,1,53,0.018518518518518517,0.018518518518518517,0.9814814814814815,54,1650,1400,250,0.8484848484848485,19,14,5,313.1085596211202,0.45162910552061497,0.3204374795951679,0.1695036263908606,128244.99736237065,-2769.0607844186306,125475.93657795202,2783,0,276.85185185185185,41,13,16,38.8471269996735,0.5940040650406504,46.77579365079364,1012.8968253968236,24.70480061943472,0
4313,4,0,2,51,0.0,0.03773584905660377,0.9622641509433962,53,1800,1300,500,0.7222222222222222,23,13,10,302.2076124567475,0.45060776487663284,0.16008879023307454,0.16258004467609838,127993.90589569163,-2863.853458049884,125130.05243764175,2784,1,282.9811320754717,48,5,13,39.37867647058824,0.5824652777777778,47.023809523809526,1011.904761904762,21.08134920634921,8
4314,4,0,0,51,0.0,0.0,1.0,51,1150,800,350,0.6956521739130435,15,8,7,309.94305738063895,0.4469117647058824,0.17244252059124077,0.16680810938236693,128009.92565923533,-2264.842453221634,125745.0832060137,2785,2,294.96078431372547,46,5,13,39.16666666666667,0.5849184782608696,47.00797872340427,1011.9680851063861,21.999306197964916,0
4315,4,4,2,53,0.07272727272727272,0.03636363636363636,0.9636363636363636,55,2350,2000,350,0.851063829787234,27,20,7,294.50739480127936,0.45158529741863074,0.23824249995943725,0.16161850470828287,128787.31900467342,-3077.117299164667,125710.20170550875,2786,0,274.43636363636364,45,10,16,38.76755012195846,0.5939814814814814,46.24094202898551,1015.0362318840582,22.556360708534626,8
4316,4,2,2,53,0.03636363636363636,0.03636363636363636,0.9636363636363636,55,1500,1400,100,0.9333333333333333,16,14,2,297.04257813338484,0.45143097643097646,0.25043983039167106,0.1636726500545283,128948.26721178621,-3339.374852315662,125608.89235947054,2787,0,275.4,45,10,20,38.53999450043105,0.5956018518518518,46.0824275362319,1015.6702898550752,22.57045088566834,0
4317,4,0,0,53,0.0,0.0,1.0,53,1650,1200,450,0.7272727272727273,21,12,9,305.1207531192944,0.450804305757136,0.22945401984556257,0.1681237840160522,128948.26721178647,-2731.041518982299,126217.22569280418,2788,1,281.8679245283019,45,8,20,38.334875442195106,0.5956018518518518,46.08242753623191,1015.6702898550773,22.570450885668382,0
4318,4,1,0,54,0.018518518518518517,0.0,1.0,54,1500,1100,400,0.7333333333333333,19,11,8,299.52241440743626,0.45211681807593757,0.2349319206282816,0.16600790283917047,129179.77698094572,-3061.55226121058,126118.22471973514,2789,0,277.6296296296296,48,6,21,38.242367210372244,0.5944010416666667,45.854591836734706,1016.5816326530635,21.17878401360549,0
4319,4,1,4,51,0.01818181818181818,0.07272727272727272,0.9272727272727272,55,1500,1200,300,0.8,18,12,6,292.1982477014604,0.4531705948372615,0.23381649048625852,0.16343034145633203,129538.5719768712,-3429.80040554653,126108.77157132467,2790,0,273.56363636363636,43,12,13,38.06550387596901,0.6041666666666667,45.50189393939395,1017.992424242426,23.674242424242465,0
4320,4,0,0,51,0.0,0.0,1.0,51,1950,1800,150,0.9230769230769231,21,18,3,302.62815976144805,0.44986928104575163,0.213460023104052,0.16825075346390259,129302.26836104809,-2373.8984945830243,126928.36986646506,2791,2,292.19607843137254,41,10,21,38.0393256600338,0.6046747967479675,45.73412698412698,1017.0634920634918,24.806426635694923,0
4321,4,0,0,51,0.0,0.0,1.0,51,1450,1200,250,0.8275862068965517,17,12,5,308.1768749358779,0.4500326797385621,0.21623667010663938,0.1722164889347551,129504.14540816311,-2217.9634353741667,127286.18197278894,2792,3,293.19607843137254,41,10,15,37.6937134502924,0.6067073170731707,45.53571428571428,1017.8571428571416,24.825783972125407,0
4322,4,0,2,49,0.0,0.0392156862745098,0.9607843137254902,51,1750,1500,250,0.8571428571428571,20,15,5,305.6088843757612,0.4497875816993464,0.17493770514340734,0.16401680953562708,127897.80836602772,-2382.6586942306867,125515.14967179703,2793,4,294.19607843137254,46,5,19,39.39052001168565,0.583786231884058,47.11879432624113,1011.5248226950342,21.989670058587702,8
4323,4,2,2,49,0.0392156862745098,0.0392156862745098,0.9607843137254902,51,900,700,200,0.7777777777777778,11,7,4,301.27521211197507,0.45016339869281047,0.18623416444767193,0.16268861454046638,128144.53124999996,-2478.1703479452767,125666.36090205469,2794,0,293.84313725490193,45,6,21,39.248971193415635,0.5875,46.875,1012.4999999999997,22.499999999999993,0
4324,4,0,1,48,0.0,0.02040816326530612,0.9795918367346939,49,1250,900,350,0.72,16,9,7,267.76651415681744,0.44733205782312924,0.143340560548066,0.13634159951261163,125754.68176273812,-3061.081167320571,122693.60059541755,2795,1,305.51020408163265,46,3,13,42.532113605562415,0.5620471014492754,49.24645390070921,1003.0141843971618,21.804656182546996,8
4325,4,6,2,52,0.1111111111111111,0.037037037037037035,0.962962962962963,54,1600,600,1000,0.375,26,6,20,255.05877866791351,0.45341981132075476,0.20192369555426937,0.13342300196090004,126861.04253472193,-4327.931378420374,122533.11115630156,2796,0,278.0925925925926,49,5,13,41.72207171809083,0.5699404761904762,48.14583333333332,1007.4166666666642,20.55952380952376,0
4326,4,0,2,50,0.0,0.038461538461538464,0.9615384615384616,52,1650,1200,450,0.7272727272727273,21,12,9,267.9917032432303,0.4508232780291604,0.20475269045220879,0.14038121350394464,126917.01630015414,-3597.45852623458,123319.55777391956,2797,1,288.8269230769231,47,5,15,41.339306225591535,0.572695035460993,48.09027777777777,1007.6388888888874,21.439125295508244,0
4327,4,3,1,52,0.05660377358490566,0.018867924528301886,0.9811320754716981,53,1500,1100,400,0.7333333333333333,19,11,8,269.5616010099195,0.45286042573778423,0.25000794372033086,0.14317144783514327,127478.14857235408,-3727.357235411173,123750.79133694292,2798,0,283.58490566037733,48,5,11,40.72850005613563,0.5772569444444444,47.534013605442176,1009.863945578231,21.03883219954648,0
4328,4,1,1,52,0.018867924528301886,0.018867924528301886,0.9811320754716981,53,1600,1200,400,0.75,20,12,8,275.5994471861451,0.4527092404450895,0.26202663482849986,0.14700286491742154,127649.95198759793,-3563.9487597759985,124086.00322782193,2799,0,284.5660377358491,48,5,12,40.40130988443849,0.5789930555555556,47.3639455782313,1010.5442176870762,21.05300453514742,0
4329,4,0,2,50,0.0,0.038461538461538464,0.9615384615384616,52,1100,800,300,0.7272727272727273,14,8,6,286.8533301562231,0.4512946204122675,0.2689301336011529,0.1530497923775779,127661.58869237077,-3075.969630111882,124585.61906225889,2800,1,290.84615384615387,47,5,12,40.10515089045412,0.5802304964539007,47.35243055555556,1010.5902777777778,21.501920803782507,0
4330,4,4,3,51,0.07407407407407407,0.05555555555555555,0.9444444444444444,54,1950,1400,550,0.717948717948718,25,14,11,287.3039820153718,0.4556982296762171,0.2992158387608961,0.15592993895706042,128346.57226120385,-3422.368463041978,124924.20379816188,2801,0,278.72222222222223,46,8,18,39.397419072615925,0.5883152173913043,46.675531914893604,1013.297872340423,22.028214616096154,0
4331,4,2,3,50,0.03773584905660377,0.05660377358490566,0.9433962264150944,53,1300,1100,200,0.8461538461538461,15,11,4,294.6725570031428,0.45565735365263665,0.3020217078945766,0.16003866833743488,128373.91369985281,-3034.346119512724,125339.56758034008,2802,0,283.5660377358491,45,8,13,39.18297878679534,0.5898148148148148,46.64855072463767,1013.405797101448,22.520128824476622,0
4332,4,1,2,49,0.0196078431372549,0.0392156862745098,0.9607843137254902,51,1350,900,450,0.6666666666666666,18,9,9,302.26737378841847,0.4541176470588235,0.3122960128688781,0.16428096690605906,128402.47342249655,-2437.624314128952,125964.8491083676,2803,0,293.27450980392155,44,7,14,38.96153084840729,0.5913825757575757,46.62037037037037,1013.5185185185184,23.034511784511782,0
4333,4,1,0,50,0.02,0.0,1.0,50,1100,600,500,0.5454545454545454,16,6,10,314.660514006639,0.4537670068027211,0.32769989047097514,0.17202697562159372,128637.19135802473,-1904.5910493827091,126732.60030864202,2804,0,299.14,44,6,15,38.4087486308872,0.59375,46.38888888888889,1014.4444444444448,23.055555555555564,0
4334,4,0,0,50,0.0,0.0,1.0,50,1600,1200,400,0.75,20,12,8,317.56257182067105,0.4533843537414966,0.3326407005381742,0.17433342387931988,128801.62144204394,-1819.4851680384027,126982.13627400553,2805,1,300.14,44,6,17,38.16796649335645,0.595407196969697,46.226851851851855,1015.0925925925928,23.0702861952862,0
4335,4,0,0,50,0.0,0.0,1.0,50,1600,1000,600,0.625,22,10,12,317.221216107352,0.45329931972789117,0.3264575544816264,0.17455921109128592,128895.62864369001,-1822.3143861454032,127073.31425754461,2806,2,301.14,44,6,17,38.081099358682096,0.5963541666666667,46.13425925925926,1015.4629629629632,23.07870370370371,0
4336,4,0,2,48,0.0,0.04,0.96,50,1300,1000,300,0.7692307692307693,16,10,6,319.02444702792934,0.45324829931972793,0.32451636429938935,0.17575987742086177,128942.64510459545,-1772.8287894375721,127169.81631515788,2807,3,302.14,44,6,18,37.98754824201539,0.5968276515151515,46.08796296296297,1015.648148148149,23.082912457912474,0
4337,4,1,1,48,0.02040816326530612,0.02040816326530612,0.9795918367346939,49,1550,1000,550,0.6451612903225806,21,10,11,327.2208292252431,0.45048540249433106,0.3231977354700266,0.18057742057244927,129008.91012396711,-1357.1194903581104,127651.79063360901,2808,0,308.8979591836735,43,6,19,37.71206189410888,0.5988372093023255,46.02272727272728,1015.9090909090922,23.625792811839354,0
4338,4,0,0,48,0.0,0.0,1.0,48,1350,1000,350,0.7407407407407407,17,10,7,330.21305451077006,0.45013297872340424,0.3069425906505232,0.18277597513263694,129127.51379311651,-1072.081849798673,128055.43194331783,1740,1,257.8333333333333,42,6,19,37.51549242063116,0.6014384920634921,45.90600775193799,1016.3759689922489,24.199427833148782,0
4339,4,1,0,49,0.02040816326530612,0.0,1.0,49,1650,1100,550,0.6666666666666666,22,11,11,325.54526945470593,0.451140873015873,0.3065466371306025,0.181778677422364,129473.07715136248,-1370.0248109035597,128103.05234045892,1741,0,253.55102040816325,38,11,18,37.283268598222406,0.6112938596491229,45.56623931623932,1017.7350427350433,26.7825011246064,0
4340,4,0,0,49,0.0,0.0,1.0,49,1700,1300,400,0.7647058823529411,21,13,8,325.1755928426164,0.45089285714285715,0.3074844208407388,0.18207540539307512,129581.83235627163,-1372.6301683833572,128209.20218788827,1742,1,254.55102040816325,38,11,18,37.182362714235744,0.612390350877193,45.45940170940172,1018.1623931623946,26.793747188484065,0
4341,4,0,2,47,0.0,0.04081632653061224,0.9591836734693877,49,1700,1300,400,0.7647058823529411,21,13,8,317.66641959557785,0.45082199546485263,0.18081679229318226,0.17883190944684682,129793.15020131013,-1552.0314571545555,128241.11874415557,1743,2,255.55102040816325,42,7,15,37.15944750855838,0.6081349206349207,45.25193798449613,1018.9922480620164,24.261720191952772,8
4342,4,0,1,46,0.0,0.02127659574468085,0.9787234042553191,47,1250,800,450,0.64,17,8,9,321.8417001484845,0.4495837187789084,0.18338635911712076,0.18124769429414664,129807.25623582772,-1044.5223922902433,128762.73384353748,1744,5,265.70212765957444,41,6,15,37.03879478193146,0.6097560975609756,45.23809523809524,1019.0476190476195,24.854819976771207,0
4343,4,3,1,48,0.061224489795918366,0.02040816326530612,0.9795918367346939,49,1350,900,450,0.6666666666666666,18,9,9,311.7360946380875,0.4516900510204082,0.20145778256923208,0.17854606799683118,130465.21183704966,-1664.2624874023693,128800.94934964729,1745,0,253.30612244897958,41,8,19,36.63130381303812,0.6163617886178862,44.59325396825397,1021.6269841269843,24.91773132017035,0
4344,4,0,1,47,0.0,0.020833333333333332,0.9791666666666666,48,1800,1500,300,0.8333333333333334,21,15,6,311.1190502650785,0.4508348108747045,0.21430853473098455,0.1787763287719521,130591.93244716852,-1474.0724009511378,129117.86004621739,1746,1,259.3125,41,7,13,36.51919748293377,0.6176321138211383,44.469246031746025,1022.1230158730147,24.92982965543938,0
4345,4,1,1,47,0.020833333333333332,0.020833333333333332,0.9791666666666666,48,1350,900,450,0.6666666666666666,18,9,9,310.5857330785665,0.4507886377068558,0.21608367294132869,0.17882103715685488,130667.99433893918,-1483.277037666929,129184.71730127225,1747,0,260.2708333333333,41,7,14,36.4561097095543,0.6183943089430894,44.394841269841265,1022.4206349206341,24.93708865660083,0
4346,4,0,1,46,0.0,0.02127659574468085,0.9787234042553191,47,1350,1000,350,0.7407407407407407,17,10,7,314.76228778430317,0.4492175454825778,0.2169024271095259,0.18127208800216782,130677.89019639429,-1173.5056637913988,129504.3845326029,1748,1,266.51063829787233,40,7,15,36.33937150051356,0.6200520833333334,44.385162601626014,1022.4593495934955,25.56148373983739,0
4347,4,0,3,43,0.0,0.06521739130434782,0.9347826086956522,46,1250,800,450,0.64,17,8,9,320.9632921217769,0.45007045088566827,0.2167157633613146,0.18476567226834265,130661.65500217024,-812.4810112847135,129849.17399088552,1749,2,272.0652173913044,39,7,16,36.19725335371031,0.6215277777777778,44.40104166666667,1022.3958333333342,26.2152777777778,0
4348,4,0,0,43,0.0,0.0,1.0,43,1100,900,200,0.8181818181818182,13,9,4,342.32777284115076,0.44495201181247696,0.23461449706417747,0.19577004411533683,130406.32482144331,328.3413481048895,130734.6661695482,1750,3,290.83720930232556,36,7,22,35.90959206174201,0.6244212962962963,44.650900900900915,1021.3963963963984,28.372122122122178,0
4349,4,0,0,43,0.0,0.0,1.0,43,1400,1100,300,0.7857142857142857,17,11,6,341.6058077855093,0.4451365817644887,0.2339062283754758,0.19593749050857867,130521.3723013556,317.3717636555694,130838.74406501117,1751,4,291.83720930232556,36,7,18,35.81156784953346,0.6255787037037037,44.5382882882883,1021.8468468468484,28.38463463463468,0
4350,4,0,0,43,0.0,0.0,1.0,43,1400,1000,400,0.7142857142857143,18,10,8,339.9902898894954,0.4447674418604651,0.22575118507079628,0.19602868714200058,130722.82745160707,288.89840008928036,131011.72585169635,1752,5,292.83720930232556,36,7,19,35.649065815071765,0.6276041666666667,44.34121621621622,1022.6351351351356,28.40653153153154,0
4351,4,0,0,43,0.0,0.0,1.0,43,1350,1100,250,0.8148148148148148,16,11,5,337.833966496175,0.4446520856404577,0.22380264815213025,0.19522161270046157,130809.21292914549,238.35905161920306,131047.5719807647,1753,6,293.83720930232556,36,7,19,35.616881329810646,0.6284722222222222,44.256756756756765,1022.972972972974,28.415915915915946,0
4352,4,0,1,42,0.0,0.023255813953488372,0.9767441860465116,43,1500,1100,400,0.7333333333333333,19,11,8,336.2718383425156,0.4436830933923957,0.21563505080252865,0.19504625007626836,130953.25213304527,207.17816634202282,131160.43029938728,1754,7,294.83720930232556,36,7,19,35.511332379799754,0.6299189814814814,44.115990990990994,1023.5360360360366,28.431556556556572,0
4353,4,0,1,41,0.0,0.023809523809523808,0.9761904761904762,42,1100,900,200,0.8181818181818182,13,9,4,345.78206566102654,0.44271438250096784,0.20626487085903777,0.20097162633623133,131031.70680084024,661.6828489369053,131693.38964977715,1755,8,300.8333333333333,35,7,20,35.18869168739166,0.6327380952380952,44.039351851851855,1023.842592592593,29.252645502645514,0
4354,4,0,2,39,0.0,0.04878048780487805,0.9512195121951219,41,1250,1000,250,0.8,15,10,5,342.042353618167,0.4426067073170732,0.18895399509245214,0.1992873290299315,131126.20380092936,770.1430738170657,131896.34687474644,1756,9,303.2439024390244,36,5,21,35.18897746014294,0.6316550925925926,43.947072072072075,1024.211711711712,28.450325325325334,0
4355,4,0,0,39,0.0,0.0,1.0,39,1400,1200,200,0.8571428571428571,16,12,4,354.12771988773187,0.4412393162393162,0.1852530580014602,0.20659451048365654,131175.63952664402,1490.5860260771005,132666.22555272112,1757,10,309.5897435897436,34,5,21,34.82955645942281,0.6363357843137255,43.898809523809526,1024.4047619047622,30.1295518207283,0
4356,4,0,0,39,0.0,0.0,1.0,39,1400,1000,400,0.7142857142857143,18,10,8,354.3527388717635,0.44042397660818716,0.18056858907329465,0.20705458407802246,131236.6230867348,1500.8113662131673,132737.43445294796,1758,11,310.5897435897436,34,5,21,34.762160644436705,0.6369485294117647,43.83928571428572,1024.642857142858,30.136554621848767,0
4357,4,1,1,39,0.025,0.025,0.975,40,1050,400,650,0.38095238095238093,17,4,13,347.6354708535854,0.441025641025641,0.1815096310048736,0.20491945881095758,131572.28599773248,1147.870606575973,132720.15660430846,1759,0,303.8,34,6,15,34.595468786261314,0.6403186274509804,43.511904761904766,1025.9523809523814,30.17507002801122,0
4358,4,0,0,39,0.0,0.0,1.0,39,650,300,350,0.46153846153846156,10,3,7,357.55226189885946,0.4398335582546109,0.18249349550891303,0.2099396333549303,131422.35145436847,1598.07180531526,133020.42325968374,1760,13,312.5897435897436,33,6,21,34.492525198199274,0.6410984848484849,43.658088235294116,1025.3676470588234,31.071746880570405,0
4359,4,0,0,39,0.0,0.0,1.0,39,800,500,300,0.625,11,5,6,364.79770639100315,0.43941183085919927,0.1038429104927121,0.203097636535997,129357.17520004313,1704.2546736831835,131061.42987372632,1761,14,313.5897435897436,33,6,22,36.4026171545597,0.6202651515151515,45.68014705882352,1017.279411764705,30.826648841354697,8
4360,4,1,0,40,0.025,0.0,1.0,40,700,600,100,0.8571428571428571,8,6,2,352.26978584391,0.44034455128205124,0.08726867717614817,0.19106379834433626,128320.37278163573,1146.0536846138173,129466.42646624954,1762,0,306.725,35,5,21,37.778444139821794,0.6053571428571429,46.701388888888886,1013.1944444444439,28.94841269841268,8
4361,4,0,1,39,0.0,0.025,0.975,40,1400,1000,400,0.7142857142857143,18,10,8,353.7382865901823,0.4399706196581197,0.09412318757849025,0.1925664171686392,128466.99948827577,1088.7392564728912,129555.73874474867,1763,1,307.725,35,5,16,37.59145355253642,0.606845238095238,46.556712962962955,1013.7731481481472,28.964947089947064,0
4362,4,1,1,39,0.025,0.025,0.975,40,1350,1200,150,0.8888888888888888,15,12,3,353.27118519899847,0.44086538461538466,0.11637773722627731,0.193592609489051,128731.13854595326,1095.4003772290682,129826.53892318234,1764,0,308.25,35,5,17,37.333675486617985,0.6095238095238096,46.29629629629629,1014.8148148148141,28.994708994708976,0
4363,4,1,1,39,0.025,0.025,0.975,40,1100,700,400,0.6363636363636364,15,7,8,349.1427538346071,0.44045138888888885,0.13812734721748043,0.19404917001547695,129289.65627411251,1028.966665594979,130318.6229397075,1765,0,307.55,35,5,20,36.869452031410034,0.6151785714285714,45.74652777777777,1017.0138888888878,29.05753968253965,0
4364,4,1,0,40,0.025,0.0,1.0,40,1350,900,450,0.6666666666666666,18,9,9,341.673222940741,0.43965010683760686,0.14211517761033376,0.19190714879803392,129703.52055440121,863.243978916573,130566.7645333178,1766,0,307.575,37,3,17,36.638858988159306,0.615427927927928,45.339912280701746,1018.6403508771918,27.53082029397816,0
4365,4,0,0,40,0.0,0.0,1.0,40,1350,1100,250,0.8148148148148148,16,11,5,343.1864696730009,0.4390758547008547,0.14293975255513724,0.19344561768408391,129843.17440221999,912.0841268467302,130755.25852906672,1767,1,308.575,37,3,18,36.458557468172856,0.6168355855855856,45.202850877192986,1019.1885964912286,27.54563774300618,0
4366,4,1,1,40,0.024390243902439025,0.024390243902439025,0.975609756097561,41,1150,500,650,0.43478260869565216,18,5,13,336.2807675344353,0.4396341463414634,0.14512080206133415,0.1910658899893748,130153.54624379062,553.6268856381022,130707.17312942873,1768,0,302.0243902439024,38,3,20,36.319931595295444,0.6181469298245614,44.89850427350427,1020.4059829059828,26.852789023841652,0
4367,4,0,1,39,0.0,0.025,0.975,40,1300,600,700,0.46153846153846156,20,6,14,337.4513313101612,0.4398370726495726,0.13936398796734006,0.19199248116350742,130206.62607725458,787.6798630347866,130994.30594028937,1769,1,307.125,37,3,21,36.23630210571552,0.6204954954954955,44.84649122807018,1020.6140350877197,27.58416311047891,0
4368,4,0,0,39,0.0,0.0,1.0,39,600,400,200,0.6666666666666666,8,4,4,344.4902514022287,0.43868083670715247,0.14052187694571794,0.1955564960967541,130118.92804967148,1164.940447203981,131283.86849687545,1770,2,315.05128205128204,36,3,22,36.145603384841806,0.6215277777777778,44.93243243243244,1020.2702702702718,28.340840840840883,0
4369,4,1,1,39,0.025,0.025,0.975,40,1150,800,350,0.6956521739130435,15,8,7,337.7532064452002,0.43887553418803416,0.14737308146399064,0.19341405190226976,130458.54403518388,812.5583112111369,131271.10234639503,1771,0,308.15,37,3,23,35.97355640227539,0.6230292792792793,44.59978070175438,1021.6008771929822,27.61083451872925,0
4370,4,1,0,40,0.025,0.0,1.0,40,1400,1200,200,0.8571428571428571,16,12,4,335.9986578100399,0.4385149572649573,0.152310744156122,0.19366646988482292,130710.7054574485,783.7243190212362,131494.42977646974,1772,0,308.525,37,3,17,35.76336764600756,0.6255630630630631,44.353070175438596,1022.587719298246,27.63750592697962,0
4371,4,0,0,40,0.0,0.0,1.0,40,850,400,450,0.47058823529411764,13,4,9,334.13623767053485,0.43838141025641025,0.14921464565240616,0.19273275749864444,130738.73842191836,736.9100348184068,131475.64845673676,1773,1,309.525,37,3,17,35.78265162074263,0.6258445945945945,44.32565789473684,1022.6973684210533,27.640469416785223,0
4372,4,1,1,40,0.024390243902439025,0.024390243902439025,0.975609756097561,41,900,600,300,0.6666666666666666,12,6,6,330.6973203362777,0.4393292682926829,0.1670380658750268,0.1928665393786029,131163.9135437213,475.11094674557444,131639.0244904669,1774,0,302.9512195121951,38,3,18,35.44143721318316,0.6282894736842105,43.910256410256416,1024.358974358975,26.95681511470987,0
4373,4,0,0,40,0.0,0.0,1.0,40,1350,1000,350,0.7407407407407407,17,10,7,370.8914606311646,0.4378872863247863,0.19254103815439283,0.20389984201527897,128858.14868922955,1564.2558726465732,130422.40456187613,1775,1,311.375,36,4,20,36.75687666370896,0.6087962962962963,46.17117117117116,1015.3153153153136,28.203203203203156,6
4374,4,0,1,39,0.0,0.025,0.975,40,1350,1100,250,0.8148148148148148,16,11,5,330.39999616417913,0.43815438034188037,0.0491782553729454,0.18023889445921812,128550.50131492474,509.841289694497,129060.34260461923,1776,2,312.375,38,2,14,38.09787189211968,0.6019736842105263,46.47435897435899,1014.1025641025669,26.6869095816465,8
4375,4,0,0,39,0.0,0.0,1.0,39,850,300,550,0.35294117647058826,14,3,11,336.0980710725773,0.4366284300494827,0.07527848665289438,0.18372200258112412,128631.77237426056,846.5781147271764,129478.35048898774,1777,5,321.3333333333333,38,1,14,37.87058978409689,0.602796052631579,46.39423076923078,1014.4230769230785,26.695344129554698,0
4376,4,1,1,39,0.025,0.025,0.975,40,1300,1100,200,0.8461538461538461,15,11,4,329.9726404893293,0.43724626068376066,0.08817571032926419,0.18164332423097004,128910.32036675383,507.3757595486494,129417.69612630249,1778,0,314.275,39,1,15,37.74243939549356,0.6038995726495726,46.119791666666686,1015.5208333333362,26.038995726495802,0
4377,4,0,0,39,0.0,0.0,1.0,39,1000,700,300,0.7,13,7,6,335.89432205884117,0.43508209626630684,0.09873466878094561,0.1852484462955608,128984.24373584654,865.0150211849184,129849.25875703146,1779,1,323.15384615384613,38,1,15,37.51687175711681,0.606359649122807,46.04700854700856,1015.8119658119676,26.731893837157042,0
4378,4,0,0,39,0.0,0.0,1.0,39,1600,1400,200,0.875,18,14,4,338.267563812869,0.4344073324336482,0.10991551800800337,0.18745578740124957,129174.23575726886,939.0908074001266,130113.32656466898,1780,2,324.15384615384613,38,1,16,37.26331231389033,0.6082785087719298,45.86004273504275,1016.5598290598311,26.751574448942925,0
4379,4,2,3,38,0.04878048780487805,0.07317073170731707,0.926829268292683,41,900,500,400,0.5555555555555556,13,5,8,326.8366901406561,0.43846544715447155,0.11304937926629655,0.1832084565834323,129625.34722222247,273.266742457473,129898.61396467994,1781,0,309.2926829268293,39,2,14,37.09594926350246,0.6111111111111112,45.41666666666668,1018.3333333333353,26.11111111111116,0
4380,4,0,0,38,0.0,0.0,1.0,38,1400,1100,300,0.7857142857142857,17,11,6,338.2923974435198,0.43412162162162166,0.12197141560798586,0.18866306780503994,129424.43828870423,1156.660703293328,130581.09899199755,1782,1,331.92105263157896,37,1,18,37.00835129310347,0.6126126126126126,45.6140350877193,1017.5438596491229,27.50118539592224,0
4381,4,0,0,38,0.0,0.0,1.0,38,1350,900,450,0.6666666666666666,18,9,9,342.27526635887614,0.43419570886676145,0.12461808803106278,0.19156273949018468,129563.94184989603,1269.3065414358139,130833.24839133184,1783,2,332.92105263157896,37,1,14,36.765280021540114,0.6140202702702703,45.47697368421052,1018.0921052631571,27.516002844950194,0
4382,4,0,0,38,0.0,0.0,1.0,38,850,500,350,0.5882352941176471,12,5,7,342.0749435612325,0.43406235182550973,0.1229316832132008,0.19185942486695212,129647.68005540161,1269.8445675592425,130917.52462296085,1784,3,333.92105263157896,37,1,15,36.6853287395923,0.6148648648648649,45.39473684210526,1018.4210526315785,27.524893314366988,0
4383,4,1,0,39,0.02564102564102564,0.0,1.0,39,950,600,350,0.631578947368421,13,6,7,339.94897765497467,0.43544759334233013,0.1420874173465525,0.1931500705284152,130153.5462437905,1049.1129967491972,131202.65924053968,1785,0,326.3333333333333,38,1,16,36.22635500645655,0.6181469298245614,44.898504273504265,1020.4059829059818,26.852789023841627,0
4384,4,0,0,39,0.0,0.0,1.0,39,1550,1200,350,0.7741935483870968,19,12,7,337.3000069981194,0.4355319388214125,0.13781328398447945,0.1923209041738816,130290.57167830471,989.4478048731604,131280.01948317786,1786,1,327.3333333333333,37,2,17,36.15515250778648,0.6213400900900901,44.764254385964904,1020.9429824561391,27.593053579895653,0
4385,4,0,0,39,0.0,0.0,1.0,39,1000,600,400,0.6,14,6,8,335.87003232341635,0.4349134053081421,0.13823474364479105,0.19219688090448067,130430.54112803933,961.5420129270469,131392.08314096637,1787,2,328.3333333333333,37,2,19,36.04998568770573,0.6227477477477478,44.62719298245614,1021.4912280701749,27.607871028923647,0
4386,4,0,0,39,0.0,0.0,1.0,39,1300,900,400,0.6923076923076923,17,9,8,335.3904025703934,0.4336763382816014,0.13455899746395317,0.19275643235272552,130598.6036568944,960.3036511234138,131558.9073080178,1788,3,329.3333333333333,37,2,12,35.89224415361508,0.6244369369369369,44.46271929824561,1022.1491228070173,27.625651967757225,0
4387,4,0,1,38,0.0,0.02564102564102564,0.9743589743589743,39,850,700,150,0.8235294117647058,10,7,3,334.280121987195,0.43347953216374274,0.1333086862289663,0.19261860611315124,130699.20562358461,938.0292798962665,131637.2349034809,1789,4,330.3333333333333,38,1,13,35.81892348413611,0.6236293859649122,44.36431623931624,1022.5427350427349,26.909019343229865,0
4388,4,0,0,38,0.0,0.0,1.0,38,1150,600,550,0.5217391304347826,17,6,11,359.8602437077075,0.43200272641062115,0.1851079554452837,0.1918613170997776,127631.95363860471,1596.9023057954419,129228.85594440016,1790,5,338.86842105263156,36,2,16,38.291030498904135,0.5963541666666667,47.38175675675675,1010.472972972972,28.068693693693668,8
4389,4,0,0,38,0.0,0.0,1.0,38,850,500,350,0.5882352941176471,12,5,7,360.4151848425704,0.43105440967283076,0.18648509221371556,0.19283715908918928,127774.23327043254,1610.3547804561254,129384.58805088866,1791,6,339.86842105263156,36,2,16,38.13117249573032,0.5978009259259259,47.24099099099099,1011.0360360360355,28.08433433433432,0
4390,4,0,1,37,0.0,0.02631578947368421,0.9736842105263158,38,1250,700,550,0.56,18,7,11,360.41701652147674,0.43025426742532,0.17999742174407318,0.19338504434862014,127888.11404309703,1618.6105023942732,129506.7245454913,1792,7,340.86842105263156,36,2,17,38.01445483559713,0.5989583333333333,47.12837837837837,1011.4864864864855,28.09684684684682,0
4391,4,0,0,37,0.0,0.0,1.0,37,1350,1300,50,0.9629629629629629,14,13,1,366.6888020963986,0.4305242742742743,0.17665406456439303,0.1972898582602346,127998.08873724705,1987.093165937925,129985.18190318497,1793,8,345.7027027027027,35,2,17,37.74317072705784,0.6020833333333333,47.019675925925924,1011.921296296296,28.912037037037027,0
4392,4,1,0,38,0.02631578947368421,0.0,1.0,38,700,300,400,0.42857142857142855,11,3,8,357.23010932117444,0.43301031294452347,0.17094442039751523,0.1938695128873297,128344.14439777611,1569.6785467900283,129913.82294456614,1794,0,337.57894736842104,36,2,18,37.628500777950656,0.603587962962963,46.677927927927925,1013.288288288288,28.146896896896887,0
4393,4,2,1,39,0.05,0.025,0.975,40,1050,700,350,0.6666666666666666,14,7,7,345.9892243168254,0.43696581196581197,0.19496739587715628,0.19081586686800317,128984.24373584626,925.4316878515558,129909.67542369782,1795,0,321.65,38,2,16,37.26050869443276,0.606359649122807,46.047008547008545,1015.8119658119655,26.731893837156985,0
4394,4,2,0,41,0.04878048780487805,0.0,1.0,41,1000,800,200,0.8,12,8,4,336.4642342388664,0.4368902439024391,0.19702235665641332,0.18748677019641447,129391.54071015042,507.3077607933269,129898.84847094375,1796,0,314.7317073170732,38,3,18,37.0882775035878,0.6104714912280702,45.646367521367516,1017.4145299145295,26.774066576698143,0
4395,4,1,1,41,0.023809523809523808,0.023809523809523808,0.9761904761904762,42,1500,800,700,0.5333333333333333,22,8,14,327.17080117660964,0.43760888501742157,0.19833036456477848,0.18395329679167197,129744.38707325331,89.7150133848858,129834.1020866382,1797,0,308.2142857142857,40,2,16,36.9667497921862,0.6106770833333333,45.29979674796748,1018.8008130081298,25.470020325203244,0
4396,4,1,0,42,0.023809523809523808,0.0,1.0,42,1450,1200,250,0.8275862068965517,17,12,5,340.981629790108,0.4389880952380953,0.13913802587835788,0.18318791821697367,127938.82118985057,324.957552548086,128263.77874239866,1798,0,309.1666666666667,40,2,17,38.45408504938892,0.5924479166666667,47.078252032520325,1011.6869918699183,25.292174796747958,8
4397,4,0,1,41,0.0,0.023809523809523808,0.9761904761904762,42,1550,1200,350,0.7741935483870968,19,12,7,333.99796157742315,0.4396172086720867,0.1301803998049733,0.18024310364216092,128118.80845561514,158.2841727807621,128277.09262839591,1799,1,310.1666666666667,40,2,17,38.44693167369337,0.5942708333333333,46.900406504065046,1012.3983739837406,25.309959349593516,0
4398,4,1,1,41,0.023809523809523808,0.023809523809523808,0.9761904761904762,42,800,400,400,0.5,12,4,8,345.0024126024867,0.44045199380565236,0.14329408129468968,0.17494903832896294,125585.03252239087,265.4278413973284,125850.4603637882,1800,0,309.6190476190476,40,2,16,40.77042988948597,0.5684895833333333,49.41565040650407,1002.3373983739846,25.058434959349615,8
4399,4,1,1,41,0.023809523809523808,0.023809523809523808,0.9761904761904762,42,1000,700,300,0.7,13,7,6,344.87509053036376,0.4412746806039489,0.16606871609403262,0.17618424826628776,125890.80909387609,283.3208366382569,126174.12993051435,1801,0,308.85714285714283,40,2,17,40.458227848101274,0.5716145833333333,49.11077235772358,1003.5569105691064,25.08892276422766,0
4400,4,2,2,41,0.046511627906976744,0.046511627906976744,0.9534883720930233,43,1700,1100,600,0.6470588235294118,23,11,12,345.6613179622994,0.4435908084163898,0.194090943673759,0.17867611531647604,126374.37120075409,136.9181436804161,126511.28934443451,1802,0,302.5348837209302,37,6,15,39.94047619047618,0.5816441441441442,48.62938596491228,1005.4824561403509,27.175201517306782,0
4401,4,1,0,42,0.023809523809523808,0.0,1.0,42,1450,1000,450,0.6896551724137931,19,10,9,350.6809150881526,0.4439363143631436,0.21172237010746353,0.18212783009416947,126567.3828125,476.9531249999996,127044.3359375,1803,0,304.85714285714283,37,5,16,39.61568322981367,0.5836148648648649,48.4375,1006.25,27.195945945945947,0
4402,4,5,3,44,0.10638297872340426,0.06382978723404255,0.9361702127659575,47,1350,800,550,0.5925925925925926,19,8,11,319.45970544786695,0.44917900092506935,0.22840651412080004,0.17048394181821808,127670.36132812499,-1239.6375868055575,126430.72374131942,1804,0,273.3191489361702,39,8,17,39.27240087954375,0.5913461538461539,47.34375,1010.6249999999999,25.913461538461537,0
4403,4,2,0,46,0.043478260869565216,0.0,1.0,46,1350,1100,250,0.8148148148148148,16,11,5,326.454850519099,0.44949677938808374,0.2457155452691906,0.17521964425821032,127901.25739644966,-849.2028270874466,127052.05456936221,1805,0,280.0217391304348,38,8,19,38.85984368398819,0.5953947368421053,47.11538461538461,1011.5384615384611,26.619433198380555,0
4404,4,0,0,46,0.0,0.0,1.0,46,1250,700,550,0.56,18,7,11,324.94519953335896,0.449225040257649,0.240061216818515,0.17500928817439684,128039.08420138898,-878.8628472222124,127160.22135416676,1806,1,281.0217391304348,39,7,19,38.75737614930698,0.5950854700854701,46.97916666666667,1012.0833333333342,25.950854700854723,0
4405,4,2,2,46,0.041666666666666664,0.041666666666666664,0.9583333333333334,48,900,600,300,0.6666666666666666,12,6,6,341.1034603745448,0.45144429669030733,0.2928394039735096,0.17760904316053894,126672.22222222228,-897.4392361111064,125774.78298611117,1807,0,270.2708333333333,39,9,17,39.7488962472406,0.5811965811965811,48.333333333333336,1006.6666666666672,25.811965811965827,7
4406,4,2,0,48,0.041666666666666664,0.0,1.0,48,1450,800,650,0.5517241379310345,21,8,13,333.624824725364,0.45116725768321514,0.31858759249698787,0.17608481893543074,127223.341200087,-1111.027018229146,126112.31418185786,1808,0,271.125,39,9,20,39.37198847014283,0.5868055555555556,47.78645833333334,1008.8541666666682,25.868055555555596,0
4407,4,0,0,48,0.0,0.0,1.0,48,1600,1200,400,0.75,20,12,8,333.37198155860983,0.45080710697399523,0.31690700994049403,0.17663793730368996,127381.02349175356,-1106.9471571180507,126274.07633463551,1809,1,272.125,39,9,17,39.21690657998829,0.5884081196581197,47.630208333333336,1009.4791666666674,25.884081196581217,0
4408,4,0,0,48,0.0,0.0,1.0,48,1950,1400,550,0.717948717948718,25,14,11,339.0370921458175,0.4502437943262411,0.3251288659793814,0.1806955930667273,127617.73003472252,-946.571180555522,126671.158854167,1810,2,273.125,39,9,19,38.831615120274925,0.5908119658119658,47.39583333333335,1010.4166666666691,25.90811965811972,0
4409,4,0,0,48,0.0,0.0,1.0,48,1200,700,500,0.5833333333333334,17,7,10,340.7638906864384,0.4501145094562648,0.32626292555566994,0.18197204355148705,127696.68104383713,-897.1164279513541,126799.56461588579,1811,3,274.125,39,9,19,38.70720825174346,0.5916132478632479,47.31770833333335,1010.7291666666692,25.916132478632544,0
4410,4,0,0,48,0.0,0.0,1.0,48,1750,1000,750,0.5714285714285714,25,10,15,341.4255425888347,0.4490709958628842,0.3278192584963948,0.18316254246064068,127880.99500868104,-867.63237847217,127013.36263020887,1812,4,275.125,39,9,19,38.50197391005838,0.593482905982906,47.13541666666669,1011.4583333333372,25.93482905982916,0
4411,4,2,0,50,0.04,0.0,1.0,50,1450,1000,450,0.6896551724137931,19,10,9,330.67417399930133,0.4528996598639456,0.3367374749498997,0.1805321803344108,128582.21379469904,-1495.9652651261458,127086.2485295729,1813,0,265.08,40,10,18,38.05861723446897,0.5989583333333333,46.44308943089432,1014.2276422764237,25.355691056910594,0
4412,4,0,1,49,0.0,0.02,0.98,50,1450,1100,350,0.7586206896551724,18,11,7,334.6450648131203,0.45264455782312923,0.34244403167465065,0.1833467792165727,128722.74900990503,-1384.71346293145,127338.03554697358,1814,1,266.08,41,9,18,37.814770912764374,0.5988313008130082,46.3045634920635,1014.7817460317472,24.750774293457248,0
4413,4,1,1,49,0.02,0.02,0.98,50,1800,1200,600,0.6666666666666666,24,12,12,329.195564430323,0.4530442176870748,0.32901025163094055,0.18188817746330455,129057.01636392364,-1503.0005308769184,127554.01583304672,1815,0,263.68,43,7,19,37.61300093196644,0.5993217054263567,45.9753787878788,1016.0984848484875,23.63019732205785,0
4414,4,1,0,50,0.02,0.0,1.0,50,1850,1400,450,0.7567567567567568,23,14,9,330.8007414456712,0.45150510204081634,0.3319066147859917,0.18418472297368446,129360.29188368063,-1441.1810756714822,127919.11080800915,1816,0,264.52,39,11,20,37.26406239333743,0.608440170940171,45.677083333333336,1017.2916666666673,26.084401709401725,0
4415,4,0,1,49,0.0,0.02,0.98,50,1350,1000,350,0.7407407407407407,17,10,7,331.6993281512646,0.45129251700680273,0.336856645861046,0.18555795844432205,129545.80213758672,-1405.9488932291715,128139.85324435755,1817,1,265.52,39,11,16,37.05287100515025,0.610309829059829,45.494791666666664,1018.0208333333327,26.103098290598275,0
4416,4,1,1,49,0.02,0.02,0.98,50,1850,1200,650,0.6486486486486487,25,12,13,335.83207195864054,0.4518792517006803,0.33980374118368606,0.18914479907722384,129811.0473632811,-1281.057400173626,128529.98996310748,1818,0,266.48,39,11,17,36.67852822924121,0.6129807692307692,45.23437499999999,1019.0624999999989,26.12980769230766,0
4417,4,0,0,49,0.0,0.0,1.0,49,1750,1300,450,0.7428571428571429,22,13,9,341.88425222332285,0.4509105725623583,0.3362993168752981,0.19263047146829737,129826.69850107745,-922.8592528672739,128903.83924821018,1819,1,272.6326530612245,38,11,17,36.50845651186358,0.6148574561403508,45.21901709401709,1019.1239316239312,26.819050832208717,0
4418,4,0,1,48,0.0,0.02040816326530612,0.9795918367346939,49,1450,900,550,0.6206896551724138,20,9,11,340.70954810989906,0.4499893707482993,0.33549436117654374,0.1928061546818447,129996.8804253473,-941.7643229166604,129055.11610243065,1820,2,273.6326530612245,39,10,17,36.365764385427305,0.6148504273504274,45.052083333333336,1019.7916666666673,26.14850427350429,0
4419,4,1,1,48,0.02040816326530612,0.02040816326530612,0.9795918367346939,49,1550,1200,350,0.7741935483870968,19,12,7,329.74124713157073,0.4497413548752835,0.3446161926430733,0.17854236231036127,128252.72715547167,-1260.3056842514834,126992.4214712202,1821,0,273.51020408163265,38,11,21,38.41806419857257,0.5989583333333333,46.7681623931624,1012.9273504273515,26.655982905982935,8
4420,4,0,2,46,0.0,0.041666666666666664,0.9583333333333334,48,1250,900,350,0.72,16,9,7,335.7811391129004,0.4491079343971631,0.34417298321602585,0.181447561129762,128172.2876870767,-992.43264754541,127179.85503953129,1822,1,279.7916666666667,37,11,21,38.34720718281898,0.5999436936936937,46.84758771929824,1012.6096491228063,27.36782835467044,0
4421,4,2,2,46,0.041666666666666664,0.041666666666666664,0.9583333333333334,48,1850,1300,550,0.7027027027027027,24,13,11,329.6318165581896,0.4526725029550827,0.32926214151895117,0.18024548267117996,128644.60699445965,-1118.9289012003896,127525.67809325927,1823,0,261.8125,37,11,19,38.02150886294855,0.6047297297297297,46.38157894736841,1014.4736842105249,27.418207681365537,0
4422,4,3,0,49,0.061224489795918366,0.0,1.0,49,1000,600,400,0.6,14,6,8,326.68469108825406,0.4524340986394558,0.3459452964236893,0.1805402729192552,129065.65176647296,-1367.2454845131278,127698.40628195983,1824,0,257.40816326530614,38,11,22,37.66800721971049,0.6071820175438596,45.966880341880334,1016.1324786324777,26.740328385065204,0
4423,4,4,5,48,0.07547169811320754,0.09433962264150944,0.9056603773584906,53,1700,1200,500,0.7058823529411765,22,12,10,298.2202753126355,0.4559748427672956,0.32707584806519807,0.16848871739351015,129933.6569842055,-2850.158469144588,127083.49851506091,1825,0,238.9056603773585,41,12,17,37.51287259576401,0.6110264227642277,45.11408730158729,1019.543650793649,24.86691831204022,0
4424,4,1,1,48,0.02040816326530612,0.02040816326530612,0.9795918367346939,49,1350,1000,350,0.7407407407407407,17,10,7,326.21971611177196,0.4534615929705215,0.34654292751583404,0.18193022629310332,129424.438288704,-1355.8392967067034,128068.59899199729,1826,0,259.3469387755102,37,12,22,37.31546336206898,0.6126126126126126,45.61403508771929,1017.543859649121,27.50118539592219,0
4425,4,0,0,48,0.0,0.0,1.0,48,1750,1400,350,0.8,21,14,7,333.2208952490214,0.45177674349881797,0.3470199867124355,0.18518879415347134,129287.27027280645,-983.7560110786554,128303.51426172779,1827,1,265.3541666666667,36,12,22,37.276695087291934,0.6131365740740741,45.74887387387387,1017.0045045045033,28.25012512512509,0
4426,4,0,0,48,0.0,0.0,1.0,48,1350,900,450,0.6666666666666666,18,9,9,334.7916112936497,0.452026078605201,0.35148236292524504,0.18646778153063082,129373.18019032553,-937.3889091794463,128435.79128114608,1828,2,266.3541666666667,36,12,22,37.149472363663186,0.6140046296296297,45.664414414414416,1017.3423423423428,28.259509509509524,0
4427,4,1,1,48,0.02040816326530612,0.02040816326530612,0.9795918367346939,49,1250,800,450,0.64,17,8,9,327.9533649038691,0.45360331632653056,0.3521012280046576,0.18420113421746923,129703.52055440118,-1292.658798861204,128410.86175553998,1829,0,261.8979591836735,37,12,20,36.988249013275926,0.615427927927928,45.339912280701746,1018.6403508771916,27.530820293978152,0
4428,4,0,1,47,0.0,0.020833333333333332,0.9791666666666666,48,2050,1400,650,0.6829268292682927,27,14,13,309.935106046969,0.45420545212765956,0.2815945343654702,0.1656595647420311,127733.27637525603,-1672.0834039403476,126061.19297131569,1830,1,266.2708333333333,40,8,15,39.44887068127742,0.5903645833333333,47.28150406504064,1010.8739837398366,25.271849593495915,8
4429,4,3,0,50,0.06,0.0,1.0,50,1850,1400,450,0.7567567567567568,23,14,9,298.51345199946144,0.458545918367347,0.2872348105073186,0.16234313905357878,128427.65239771326,-2331.2016656751657,126096.4507320381,1831,0,256.0,40,10,14,39.03106409999331,0.5973958333333333,46.595528455284565,1013.617886178864,25.340447154471597,0
4430,4,0,0,50,0.0,0.0,1.0,50,1700,1300,400,0.7647058823529411,21,13,8,296.7228677727372,0.45840136054421765,0.287720602621796,0.16185171581499044,128546.63190507695,-2371.4549477198175,126175.17695735714,1832,1,257.0,41,9,14,38.95560229570209,0.5970528455284553,46.47817460317461,1014.0873015873025,24.73383662408055,0
4431,4,1,0,51,0.0196078431372549,0.0,1.0,51,1350,900,450,0.6666666666666666,18,9,9,295.751267408659,0.4591176470588236,0.30030684029336885,0.1627874623131697,128906.01526350608,-2575.1765218436103,126330.83874166248,1833,0,252.94117647058823,42,9,16,38.61561704834607,0.5992063492063492,46.12403100775195,1015.5038759689946,24.17866371354749,0
4432,4,1,1,51,0.019230769230769232,0.019230769230769232,0.9807692307692307,52,2050,1600,450,0.7804878048780488,25,16,9,296.516463112541,0.45952740070387127,0.3161880541927349,0.16506405063821938,129352.72285997764,-2728.2815836132245,126624.44127636442,1834,0,249.05769230769232,41,11,18,38.143651258045644,0.6051829268292683,45.684523809523824,1017.2619047619073,24.81126596980262,0
4433,4,1,2,50,0.019230769230769232,0.038461538461538464,0.9615384615384616,52,1450,1300,150,0.896551724137931,16,13,3,296.4467699463084,0.4588203871292107,0.3179037336932078,0.16566143026411356,129504.14540816336,-2721.782879818581,126782.36252834478,1835,0,249.8846153846154,41,11,11,37.99220272904486,0.6067073170731707,45.53571428571429,1017.8571428571436,24.825783972125453,0
4434,4,0,0,50,0.0,0.0,1.0,50,1700,1500,200,0.8823529411764706,19,15,4,307.3365972628871,0.457593537414966,0.3210647010647012,0.17135067819999325,129413.28125000001,-2045.3125,127367.96875000001,1836,2,260.18,39,11,19,37.807125307125304,0.608974358974359,45.625,1017.5000000000001,26.08974358974359,0
4435,4,0,1,49,0.0,0.02,0.98,50,1550,1000,550,0.6451612903225806,21,10,11,304.5820534579541,0.45751700680272106,0.3118403193612773,0.17068860042777978,129614.99851279009,-2104.3195188049413,127510.67899398514,1837,3,261.18,40,10,12,37.67298735861609,0.609375,45.426829268292686,1018.2926829268299,25.45731707317075,0
4436,4,1,3,47,0.02,0.06,0.94,50,1850,1200,650,0.6486486486486487,25,12,13,308.7820039675029,0.4589285714285714,0.24641991796241447,0.17027678840564658,128979.82698042525,-2021.809359018444,126958.0176214068,1838,0,259.92,42,8,19,38.209879487424075,0.5999503968253967,46.051356589147304,1015.7945736434141,24.185585086747956,8
4437,4,3,1,49,0.06,0.02,0.98,50,850,300,550,0.35294117647058826,14,3,11,308.8928426799732,0.456734693877551,0.2847697072634623,0.17185705738653997,129330.57089240875,-2009.7621892033983,127320.80870320536,1839,0,260.4,40,10,22,37.851350451260515,0.6065104166666666,45.706300813008134,1017.1747967479686,25.429369918699216,0
4438,4,0,0,49,0.0,0.0,1.0,49,1650,1200,450,0.7272727272727273,21,12,9,314.03882050004086,0.4556760204081633,0.2904031275661698,0.17496960409719892,129386.78521050341,-1673.5053168402799,127713.27989366313,1840,1,266.18367346938777,39,10,23,37.663496979625286,0.6087072649572649,45.651041666666664,1017.3958333333328,26.087072649572637,0
4439,4,1,1,49,0.02,0.02,0.98,50,1250,900,350,0.72,16,9,7,307.3105825600289,0.4555102040816326,0.2805405405405401,0.1730153403329259,129796.16057117132,-2022.4532561636547,127773.70731500766,1841,0,261.84,40,10,17,37.42021541837039,0.6111979166666667,45.2489837398374,1019.0040650406509,25.475101626016272,0
4440,4,0,0,49,0.0,0.0,1.0,49,1250,1000,250,0.8,15,10,5,315.78154992660615,0.455109126984127,0.28387796836526036,0.1774910090966786,129731.44531249988,-1606.640625000014,128124.80468749987,1842,1,268.14285714285717,39,10,17,37.26993865030673,0.6121794871794872,45.31249999999999,1018.7499999999991,26.121794871794847,0
4441,4,1,0,50,0.02,0.0,1.0,50,1550,1300,250,0.8387096774193549,18,13,5,354.7029191926692,0.4553996598639456,0.300377965420185,0.1897088516198208,127758.96044021391,-820.60232521154,126938.35811500237,1843,0,263.76,40,10,17,38.29119756064871,0.590625,47.2560975609756,1010.9756097560955,25.27439024390239,7
4442,4,2,0,52,0.038461538461538464,0.0,1.0,52,1650,900,750,0.5454545454545454,24,9,15,348.39988931495765,0.4580191050779286,0.3009477484705647,0.1891069840152119,128350.40655570426,-1455.3846296847087,126895.02192601956,1844,0,254.57692307692307,40,12,21,37.8457944706315,0.5966145833333334,46.671747967479675,1013.3130081300812,25.332825203252032,0
4443,4,1,3,50,0.018867924528301886,0.05660377358490566,0.9433962264150944,53,1750,1200,550,0.6857142857142857,23,12,11,340.7929824892305,0.4586508224479922,0.30181111173177255,0.18653650390197243,128684.70687045553,-1829.03098897302,126855.6758814825,1845,0,250.75471698113208,42,11,15,37.6975694776048,0.5969742063492063,46.34205426356589,1014.6317829457366,24.15789959394611,0
4444,4,1,0,51,0.0196078431372549,0.0,1.0,51,1700,1100,600,0.6470588235294118,23,11,12,358.6303071435211,0.4574346405228758,0.324171744434099,0.1960486158765956,128633.75491605562,-973.607393086086,127660.14752296954,1846,0,261.3529411764706,40,11,16,37.2971348427169,0.5994791666666667,46.39227642276425,1014.430894308946,25.36077235772365,0
4445,4,1,2,50,0.019230769230769232,0.038461538461538464,0.9615384615384616,52,1050,800,250,0.7619047619047619,13,8,5,349.5708209304114,0.4577991452991453,0.3215380857540111,0.19225455949611855,128873.80248685152,-1389.8958136495037,127483.90667320201,1847,0,257.3076923076923,41,11,17,37.282099820876084,0.6003556910569106,46.15575396825398,1015.3769841269865,24.765292295780156,0
4446,4,0,1,49,0.0,0.02,0.98,50,1050,700,350,0.6666666666666666,14,7,7,356.67098544017176,0.4573639455782313,0.28881640667612096,0.1839956625509314,126291.69702456509,-952.6308916501785,125339.06613291492,1848,1,266.84,37,13,12,39.748895494709274,0.5807995495495495,48.711622807017534,1005.1535087719285,27.16631104788996,8
4447,4,0,0,49,0.0,0.0,1.0,49,1150,900,250,0.782608695652174,14,9,5,363.59600836581143,0.4560657596371882,0.29212357437931513,0.1870820984221319,126185.22872534688,-623.9109041473989,125561.31782119948,1849,2,273.2040816326531,36,13,19,39.684674587162824,0.5815972222222222,48.817567567567565,1004.729729729729,27.909159159159138,0
4448,4,0,0,49,0.0,0.0,1.0,49,1950,1300,650,0.6666666666666666,26,13,13,364.8942963934599,0.45553429705215415,0.29741170186722443,0.18861785219436447,126374.37120075396,-577.3425477069999,125797.02865304696,1850,3,274.2040816326531,37,12,15,39.45701563067975,0.5816441441441442,48.629385964912274,1005.4824561403499,27.175201517306753,0
4449,4,1,2,48,0.02,0.04,0.96,50,1450,1000,450,0.6896551724137931,19,10,9,357.15576694411425,0.4560714285714285,0.30248275862068974,0.1862862813197717,126742.1392746913,-946.6628086419814,125795.47646604932,1851,0,269.7,38,12,16,39.27298850574713,0.5836074561403508,48.263888888888886,1006.944444444444,26.498538011695896,0
4450,4,1,2,47,0.02040816326530612,0.04081632653061224,0.9591836734693877,49,1250,800,450,0.64,17,8,9,366.09754675094666,0.458687641723356,0.3123306174400178,0.19132858485409765,126822.83676674688,-514.0941175396495,126308.74264920724,1852,0,275.0612244897959,38,11,18,38.96482993918823,0.5844298245614035,48.183760683760674,1007.2649572649561,26.506972559604108,0
4451,4,1,2,46,0.020833333333333332,0.041666666666666664,0.9583333333333334,48,1800,1400,400,0.7777777777777778,22,14,8,362.4437657173187,0.4591552157210402,0.3254301868239924,0.1913838575983975,127242.10778061242,-375.2368322136886,126866.87094839873,1853,0,280.5,34,14,21,38.625860373647974,0.5965073529411764,47.76785714285715,1008.9285714285729,29.674369747899203,0
4452,4,3,1,48,0.061224489795918366,0.02040816326530612,0.9795918367346939,49,1250,1000,250,0.8,15,10,5,347.1609992127197,0.46145124716553293,0.31881081498612995,0.18640449826227523,127916.59216226374,-918.4696098125036,126998.12255245124,1854,0,272.7755102040816,36,13,15,38.320531374076964,0.5992476851851851,47.10022522522523,1011.5990990991002,28.099974974975005,0
4453,4,0,0,48,0.0,0.0,1.0,48,1650,1100,550,0.6666666666666666,22,11,11,357.7019696633673,0.4596538859338062,0.32870834261114856,0.19192826114195757,127888.11404309739,-450.8339420501284,127437.28010104726,1855,1,279.4583333333333,36,12,15,38.08311066577599,0.5989583333333333,47.12837837837839,1011.4864864864884,28.0968468468469,0
4454,4,0,0,48,0.0,0.0,1.0,48,1700,1600,100,0.9411764705882353,18,16,2,360.3194466508669,0.4593953161938534,0.3254753292524577,0.19374447804656156,127973.5579117972,-377.7276854556954,127595.8302263415,1856,2,280.4583333333333,36,12,15,37.92941940270823,0.5998263888888888,47.04391891891893,1011.8243243243264,28.10623123123129,0
4455,4,2,0,50,0.04,0.0,1.0,50,1500,1000,500,0.6666666666666666,20,10,10,346.25674721004975,0.46204931972789115,0.26426269137792135,0.18285303118624294,127245.76971379443,-956.6258678530232,126289.1438459414,1857,0,270.2,40,10,16,39.03039383561642,0.5854166666666667,47.76422764227641,1008.9430894308922,25.223577235772304,8
4456,4,1,2,49,0.0196078431372549,0.0392156862745098,0.9607843137254902,51,1250,800,450,0.64,17,8,9,340.7563459649489,0.4628267973856209,0.2720404503630538,0.18182758620689649,127665.57621671246,-1499.4289485766853,126166.14726813578,1858,0,265.88235294117646,43,8,15,38.73922413793103,0.5852713178294573,47.348484848484844,1010.6060606060597,23.50246652572232,0
4457,4,0,0,49,0.0,0.0,1.0,49,1850,1300,550,0.7027027027027027,24,13,11,396.92235575854033,0.46065405328798187,0.38127360616752437,0.20810686661590055,126953.84787867393,324.4723275072909,127278.32020618122,1859,1,277.55102040816325,37,12,17,38.05341729227868,0.5875563063063063,48.053728070175424,1007.785087719296,27.237434803224218,8
4458,4,1,1,49,0.02,0.02,0.98,50,1350,600,750,0.4444444444444444,21,6,15,388.9283892365372,0.46158163265306124,0.36991852254209645,0.20587037509616576,127340.9020684248,-94.62647160666296,127246.27559681813,1860,0,272.98,37,13,14,37.85612438891905,0.5914977477477478,47.66995614035087,1009.3201754385957,27.278923660502585,0
4459,4,0,2,47,0.0,0.04081632653061224,0.9591836734693877,49,850,600,250,0.7058823529411765,11,6,5,387.8384376219524,0.46152210884353745,0.3525683079487225,0.205715226591183,127423.91889812243,83.97872422282967,127507.89762234526,1861,1,256.18367346938777,37,12,14,37.79820083984941,0.5923423423423424,47.58771929824561,1009.649122807017,27.287814129919376,0
4460,4,2,0,49,0.04081632653061224,0.0,1.0,49,1350,900,450,0.6666666666666666,18,9,9,372.66353312816545,0.46157525510204084,0.36414160344315083,0.20083130334790888,128063.41428336618,-255.08711374096154,127808.32716962522,1862,0,255.6530612244898,38,11,17,37.525068608824164,0.5970394736842105,46.955128205128204,1012.179487179487,26.636302294197026,0
4461,4,1,1,49,0.02,0.02,0.98,50,1200,700,500,0.5833333333333334,17,7,10,364.93601119222785,0.46179421768707485,0.3593098972417519,0.19857759996893157,128450.0173731341,-624.7412402211535,127825.27613291296,1863,0,251.52,37,13,13,37.325018027762745,0.602759009009009,46.573464912280706,1013.7061403508777,27.397463252726425,0
4462,4,2,3,48,0.0392156862745098,0.058823529411764705,0.9411764705882353,51,950,600,350,0.631578947368421,13,6,7,353.7721356648884,0.4627777777777778,0.3566019124972657,0.19430883428253015,128821.5047209439,-1085.3082310614284,127736.19648988248,1864,0,247.23529411764707,38,13,15,37.22878516803479,0.6047149122807017,46.20726495726496,1015.1709401709409,26.71502474134055,0
4463,4,2,0,50,0.04,0.0,1.0,50,900,500,400,0.5555555555555556,13,5,8,362.2079909768137,0.46166666666666667,0.373712782745923,0.19935072114850097,128902.8613873364,-662.070709146051,128240.79067819034,1865,0,252.54,38,12,18,36.93165877608274,0.6055372807017544,46.12713675213674,1015.4914529914518,26.72345928924873,0
4464,4,1,2,49,0.0196078431372549,0.0392156862745098,0.9607843137254902,51,1600,1200,400,0.75,20,12,8,355.71926013328846,0.46137254901960784,0.37084845319871595,0.197556853320548,129260.23046339153,-1002.5481637984025,128257.68229959313,1866,0,248.5686274509804,35,16,20,36.732206540708695,0.6148809523809524,45.775462962962955,1016.8981481481474,29.054232804232782,0
4465,4,1,0,50,0.02,0.0,1.0,50,1200,700,500,0.5833333333333334,17,7,10,368.3434329557626,0.4600170068027211,0.3874642940763282,0.2045766972892149,129261.91184807262,-477.44472789115383,128784.46712018146,1867,0,254.22,34,16,21,36.40955474908296,0.6170343137254901,45.773809523809526,1016.9047619047623,29.908963585434183,0
4466,4,1,2,49,0.0196078431372549,0.0392156862745098,0.9607843137254902,51,1300,1000,300,0.7692307692307693,16,10,6,360.41729141815455,0.4616176470588235,0.3875470789886233,0.20206159741440613,129631.08114448912,-855.7433700592458,128775.33777442986,1868,0,250.2156862745098,36,15,17,36.235209554351435,0.6166087962962963,45.41103603603604,1018.355855855856,28.28766266266267,0
4467,4,1,1,49,0.02,0.02,0.98,50,1400,1100,300,0.7857142857142857,17,11,6,351.95027713509575,0.46258503401360546,0.38189328743545636,0.19852729224804896,129871.11418898105,-858.3650738689017,129012.74911511215,1869,0,254.38,37,13,18,36.20688109581181,0.6171171171171171,45.17543859649122,1019.2982456140338,27.548601232811723,0
4468,4,0,0,49,0.0,0.0,1.0,49,2350,1900,450,0.8085106382978723,28,19,9,356.7654223009064,0.46118551587301587,0.38353816664787455,0.20104153622809495,129831.84831791259,-536.0971613505276,129295.75115656207,1870,1,260.51020408163265,36,13,18,36.12407918968693,0.6186342592592593,45.21396396396397,1019.1441441441449,28.30955955955958,0
4469,4,2,2,49,0.0392156862745098,0.0392156862745098,0.9607843137254902,51,1550,1200,350,0.7741935483870968,19,12,7,346.12393402769385,0.46109477124183007,0.39238594148118877,0.19838170899767923,130492.60567577697,-1165.2505123366777,129327.3551634403,1871,0,251.2549019607843,36,15,17,35.7252746243433,0.6252893518518519,44.566441441441434,1021.734234234233,28.381506506506472,0
4470,4,0,1,48,0.0,0.02040816326530612,0.9795918367346939,49,1300,900,400,0.6923076923076923,17,9,8,351.63285135727807,0.4601934523809524,0.3898292121081237,0.2013897239591683,130463.84222059892,-624.9254321889571,129838.91678840996,1872,1,260.81632653061223,36,13,20,35.61370149911816,0.625,44.59459459459459,1021.6216216216211,28.378378378378365,0
4471,4,0,2,46,0.0,0.041666666666666664,0.9583333333333334,48,1550,1000,550,0.6451612903225806,21,10,11,354.2607917336177,0.4596908244680851,0.38617522309133,0.20364947476669057,130607.69120049085,-346.16318176286563,130261.52801872799,1873,2,265.0208333333333,36,12,18,35.40082993646945,0.6264467592592593,44.45382882882882,1022.1846846846832,28.39401901901898,0
4472,4,1,1,46,0.02127659574468085,0.02127659574468085,0.9787234042553191,47,1250,1000,250,0.8,15,10,5,362.4843023218782,0.4617637989515881,0.37982324503614384,0.20858787246965124,130646.86381440744,71.48745606137098,130718.3512704688,1874,0,268.51063829787233,35,12,19,35.15097267821429,0.6288690476190476,44.41550925925925,1022.3379629629618,29.20965608465605,0
4473,4,0,0,46,0.0,0.0,1.0,46,1050,500,550,0.47619047619047616,16,5,11,369.30497911295976,0.46096014492753623,0.3762191231428311,0.21223912655045982,130597.0025510203,446.0246598639315,131043.02721088423,1875,1,274.0652173913044,34,12,19,35.027224551595616,0.6305147058823529,44.46428571428571,1022.1428571428563,30.06302521008401,0
4474,4,0,1,45,0.0,0.021739130434782608,0.9782608695652174,46,1450,1200,250,0.8275862068965517,17,12,5,380.9165368589864,0.4608494363929147,0.3867011923401178,0.21077693103325304,129115.53603857254,648.7820435576433,129764.31808213018,1876,2,275.0652173913044,36,10,20,36.2393813481071,0.611400462962963,45.9177927927928,1016.3288288288303,28.231356356356397,8
4475,4,0,2,43,0.0,0.044444444444444446,0.9555555555555556,45,1150,800,350,0.6956521739130435,15,8,7,378.1949736355641,0.4602483164983165,0.3691157194696253,0.20989690714591303,129233.48263251195,775.1763122105026,130008.65894472245,1877,3,273.75555555555553,32,13,21,36.188118299598486,0.6214192708333333,45.801767676767675,1016.792929292929,31.77477904040403,0
4476,4,2,3,42,0.044444444444444446,0.06666666666666667,0.9333333333333333,45,1450,900,550,0.6206896551724138,20,9,11,370.0588419774402,0.45978535353535355,0.35380334462903296,0.20757264390751262,129651.06398581775,595.7045199469384,130246.76850576469,1878,0,272.4,32,13,20,35.96939829737994,0.6256510416666667,45.39141414141414,1018.4343434343432,31.826073232323225,0
4477,4,1,1,42,0.023255813953488372,0.023255813953488372,0.9767441860465116,43,1050,700,350,0.6666666666666666,14,7,7,385.1678157914804,0.45764119601328906,0.3558400491211915,0.21564273500520773,129577.44618236198,1381.812384379679,130959.25856674166,1879,0,281.1162790697674,30,13,21,35.659790979097906,0.6302083333333333,45.463709677419345,1018.1451612903213,33.93817204301071,0
4478,4,0,0,42,0.0,0.0,1.0,42,1550,1200,350,0.7741935483870968,19,12,7,392.2106532292081,0.45703881145954317,0.37136632019769533,0.21920378427341636,129509.03148124051,1758.964367267878,131267.99584850838,1880,1,288.6190476190476,30,12,22,35.5503653329812,0.6295138888888889,45.53091397849462,1017.8763440860208,33.929211469534025,0
4479,4,0,0,42,0.0,0.0,1.0,42,1300,1000,300,0.7692307692307693,16,10,6,393.52024790116985,0.4567847464188928,0.37103384120279603,0.22051105015527064,129611.66030754978,1800.9625390218232,131412.6228465716,1881,2,289.6190476190476,30,12,22,35.41226680746216,0.6305555555555555,45.430107526881706,1018.2795698924713,33.942652329749045,0
4480,4,0,0,42,0.0,0.0,1.0,42,800,200,600,0.25,14,2,12,395.3819493674518,0.4568452380952381,0.37367530420067885,0.2220440050180598,129698.28499688032,1856.0721503363636,131554.35714721668,1882,3,290.6190476190476,31,11,22,35.27645511099751,0.6286962365591398,45.34505208333333,1018.6197916666657,32.85870295698922,0
4481,4,0,0,42,0.0,0.0,1.0,42,1000,600,400,0.6,14,6,8,391.357833402871,0.45636130468447544,0.36563387649094703,0.22090414403107964,129897.31046888552,1767.2659979926125,131664.57646687815,1883,4,291.6190476190476,31,11,22,35.17597500745095,0.6307123655913979,45.14973958333333,1019.4010416666657,32.883904569892444,0
4482,4,0,0,42,0.0,0.0,1.0,42,1350,900,450,0.6666666666666666,18,9,9,393.3907101850246,0.45536924119241196,0.3671116136012744,0.22299730995582362,130063.28158908416,1833.1373426649257,131896.4189317491,1884,5,292.6190476190476,31,11,22,34.95500382946131,0.6323924731182795,44.986979166666664,1020.0520833333329,32.90490591397848,0
4483,4,0,0,42,0.0,0.0,1.0,42,1250,800,450,0.64,17,8,9,386.9899590705112,0.45512727448703055,0.34880584571624706,0.20760621561186018,127880.99500868082,1518.5011121962186,129399.49612087704,1885,6,293.6190476190476,31,11,19,37.34981119121182,0.6102150537634409,47.135416666666686,1011.4583333333355,32.62768817204308,8
4484,4,1,0,43,0.023255813953488372,0.0,1.0,43,1900,1600,300,0.8421052631578947,22,16,6,377.54521312736523,0.4555647840531561,0.336706387739899,0.2045270253153853,128272.40404359276,1085.726424599567,129358.13046819232,1886,0,287.7674418604651,32,11,20,37.18735718143671,0.6116536458333333,46.74873737373739,1013.0050505050526,31.656407828282894,0
4485,4,0,0,43,0.0,0.0,1.0,43,1300,1100,200,0.8461538461538461,15,11,4,377.10012251692746,0.4546419342930971,0.33940682753845275,0.20494127849989033,128400.34060618826,1083.9568347617744,129484.29744095003,1887,1,288.7674418604651,32,11,18,37.06760516589845,0.6129557291666667,46.622474747474755,1013.510101010102,31.672190656565686,0
4486,4,1,2,42,0.022727272727272728,0.045454545454545456,0.9545454545454546,44,900,700,200,0.7777777777777778,11,7,4,368.24783190412825,0.4553933227625088,0.33171061008539815,0.20197540025364208,128765.68657487533,683.5369809688937,129449.22355584423,1888,0,283.1818181818182,33,11,19,36.91841745150124,0.6142676767676767,46.2622549019608,1014.9509803921592,30.756090314913916,0
4487,4,0,0,42,0.0,0.0,1.0,42,2000,1400,600,0.7,26,14,12,377.9510246632282,0.45323993418505615,0.3291651113599605,0.20706151228482383,128720.46100206608,1330.0060261707968,130050.46702823688,1889,1,289.45238095238096,32,10,20,36.71845837999252,0.6162109375,46.30681818181818,1014.772727272727,31.71164772727272,0
4488,4,1,1,42,0.023255813953488372,0.023255813953488372,0.9767441860465116,43,1050,700,350,0.6666666666666666,14,7,7,364.9532622844775,0.4546419342930971,0.3189571110275815,0.20207334328047138,129140.88010204083,826.0770975056771,129966.95719954651,1890,0,283.69767441860466,34,9,21,36.61913406730696,0.6158088235294117,45.892857142857146,1016.4285714285716,29.89495798319328,0
4489,4,1,1,42,0.023255813953488372,0.023255813953488372,0.9767441860465116,43,1100,600,500,0.5454545454545454,16,6,10,347.5625880511853,0.4556339977851606,0.2828827161309937,0.19433013108138447,129525.1833231526,403.62158671983946,129928.80490987243,1891,0,280.27906976744185,35,8,19,36.670101383361754,0.6175595238095238,45.515046296296305,1017.9398148148161,29.083994708994748,0
4490,4,1,0,43,0.023255813953488372,0.0,1.0,43,1300,1000,300,0.7692307692307693,16,10,6,349.7442426599292,0.45508028792912514,0.28722423191867685,0.19643261516592456,129701.96926708252,472.5034025634409,130174.47266964595,1892,0,281.25581395348837,35,8,20,36.434898496382985,0.6193452380952381,45.34143518518518,1018.6342592592596,29.10383597883599,0
4491,4,1,2,42,0.022727272727272728,0.045454545454545456,0.9545454545454546,44,1250,900,350,0.72,16,9,7,372.0951832199582,0.4559548978153629,0.29716075713143164,0.20399430462701926,128747.91843820886,899.2169866596626,129647.13542486852,1893,0,275.84090909090907,34,10,19,36.838954056696004,0.6118259803921569,46.27976190476192,1014.8809523809543,29.849439775910422,8
4492,4,0,0,42,0.0,0.0,1.0,42,1000,800,200,0.8,12,8,4,385.7619408366112,0.45371176926054974,0.3258264997842035,0.2104271628492394,128548.1113784363,1517.7937872453044,130065.9051656816,1894,1,289.8333333333333,33,9,19,36.69675226586102,0.6120580808080809,46.47671568627452,1014.093137254903,30.730095068330396,0
4493,4,1,1,42,0.023255813953488372,0.023255813953488372,0.9767441860465116,43,1000,600,400,0.6,14,6,8,374.66251682911496,0.45332687338501293,0.32915082900777914,0.20697375929686074,129050.14349489803,1070.050311791392,130120.19380668942,1895,0,284.06976744186045,34,9,22,36.46504588947471,0.6148897058823529,45.98214285714286,1016.0714285714291,29.884453781512622,0
4494,4,2,1,43,0.045454545454545456,0.022727272727272728,0.9772727272727273,44,1600,1300,300,0.8125,19,13,6,367.79893448949474,0.453675563777308,0.3420905808992454,0.20623543492629565,129637.82709775091,736.3080894122395,130374.13518716315,1896,0,278.45454545454544,33,11,21,36.04041315683916,0.6231060606060606,45.404411764705884,1018.3823529411768,30.860071301247782,0
4495,4,1,1,43,0.022727272727272728,0.022727272727272728,0.9772727272727273,44,1550,1100,450,0.7096774193548387,20,11,9,358.6972190614063,0.453818710359408,0.3317544976914506,0.20278822978620104,129958.94451530614,523.1823979591861,130482.12691326533,1897,0,277.3636363636364,34,10,24,35.94570928196146,0.6240808823529411,45.089285714285715,1019.6428571428573,29.989495798319332,0
4496,4,1,0,44,0.022727272727272728,0.0,1.0,44,1250,700,550,0.56,18,7,11,349.838032196021,0.45387376673713886,0.30880950109701444,0.1996381105885079,130323.35778061229,318.4134070294871,130641.77118764177,1898,0,270.3181818181818,34,10,25,35.80190237456766,0.6277573529411764,44.73214285714286,1021.071428571429,30.03151260504203,0
4497,4,0,1,43,0.0,0.022727272727272728,0.9772727272727273,44,1300,1000,300,0.7692307692307693,16,10,6,350.04218016919987,0.4538297216349542,0.30361115230609537,0.2005381835922611,130475.34722222215,334.37499999999005,130809.72222222213,1899,1,271.3181818181818,34,10,25,35.64267264817835,0.6292892156862745,44.58333333333333,1021.666666666666,30.049019607843118,0
4498,4,0,1,42,0.0,0.023255813953488372,0.9767441860465116,43,1250,800,450,0.64,17,8,9,347.3704532250914,0.4534191583610188,0.2869842198495114,0.19963338094984165,130597.00255102033,473.1079931972662,131070.11054421759,1900,2,273.69767441860466,34,9,21,35.5877300256231,0.6305147058823529,44.46428571428571,1022.1428571428565,30.063025210084017,0
4499,4,0,2,40,0.0,0.047619047619047616,0.9523809523809523,42,1100,700,400,0.6363636363636364,15,7,8,351.6507657183607,0.45337301587301587,0.27769784172661893,0.20198122493740536,130575.52984429053,783.3970107650744,131358.92685505562,1901,3,255.61904761904762,33,9,21,35.50009992006393,0.6325757575757576,44.48529411764705,1022.0588235294107,30.971479500891235,0
4500,4,0,1,39,0.0,0.025,0.975,40,1300,1000,300,0.7692307692307693,16,10,6,369.194487017927,0.4517628205128205,0.296068741231986,0.21053483437873172,130295.81917656773,1620.8996242946819,131916.7188008624,1902,5,268.425,31,9,24,35.33576180759258,0.634744623655914,44.75911458333332,1020.963541666665,32.93430779569887,0
4501,4,1,0,40,0.025,0.0,1.0,40,1300,900,400,0.6923076923076923,17,9,8,360.4336025594859,0.450894764957265,0.27474688233115163,0.20776880762485914,130714.10323245055,1422.7510266809206,132136.85425913148,1903,0,253.95,32,8,23,35.13525332345557,0.6363932291666667,44.34974747474746,1022.6010101010083,31.95628156565651,0
4502,4,0,0,40,0.0,0.0,1.0,40,950,700,250,0.7368421052631579,12,7,5,361.54732510288085,0.4505208333333333,0.2734629629629628,0.20858499525166171,130746.38429752048,1454.20110192835,132200.5853994488,1904,1,254.95,32,8,23,35.07407407407408,0.63671875,44.318181818181806,1022.7272727272713,31.960227272727227,0
4503,4,0,0,40,0.0,0.0,1.0,40,950,500,450,0.5263157894736842,14,5,9,361.6474244388789,0.4498798076923077,0.2760055521283158,0.20951768227856413,130907.84940631049,1468.497315324954,132376.34672163543,1905,2,255.95,32,8,23,34.907978614024266,0.6383463541666667,44.16035353535353,1023.3585858585851,31.979955808080785,0
4504,4,0,0,40,0.0,0.0,1.0,40,700,500,200,0.7142857142857143,9,5,4,361.1435150568511,0.4491052350427351,0.27331668516463203,0.20992923036530511,131037.09323347113,1464.639290633619,132501.73252410474,1906,3,256.95,32,8,23,34.790048094709604,0.6396484375,44.034090909090914,1023.8636363636367,31.995738636363647,0
4505,4,0,2,38,0.0,0.05,0.95,40,1100,800,300,0.7272727272727273,14,8,6,363.4709481460734,0.4487313034188034,0.2735392011834319,0.21181582840236682,131134.06795224975,1532.6848025711631,132666.75275482092,1907,4,257.95,32,8,23,34.63233481262328,0.640625,43.93939393939394,1024.242424242424,32.00757575757575,0
4506,4,0,1,37,0.0,0.02631578947368421,0.9736842105263158,38,1400,1100,300,0.7857142857142857,17,11,6,377.99712407839576,0.4461237553342816,0.2859962529468294,0.21883590156721117,130880.75798141405,2294.5100228350097,133175.26800424905,1908,5,271.36842105263156,30,8,23,34.51716362362625,0.6434027777777778,44.18682795698925,1023.2526881720431,34.108422939068106,0
4507,4,0,0,37,0.0,0.0,1.0,37,900,600,300,0.6666666666666666,12,6,6,377.97851217692954,0.44385010010010006,0.2733931410401995,0.21941191682465666,130983.92877789341,2501.822103711411,133485.75088160482,1909,6,273.94594594594594,30,7,23,34.41302302170868,0.6444444444444444,44.086021505376344,1023.6559139784947,34.121863799283155,0
4508,4,0,0,37,0.0,0.0,1.0,37,750,400,350,0.5333333333333333,11,4,7,378.16814329138157,0.44313063063063063,0.2744691942959889,0.22050645906837182,131155.9704337207,2519.8019640999037,133675.7723978206,1910,7,274.94594594594594,30,7,23,34.233805712286234,0.6461805555555555,43.918010752688176,1024.3279569892477,34.144265232974924,0
4509,4,0,0,37,0.0,0.0,1.0,37,850,500,350,0.5882352941176471,12,5,7,380.41577914927757,0.4426926926926927,0.2760422760422767,0.22221528616512953,131224.81871097808,2583.998330731878,133808.81704170996,1911,8,275.94594594594594,30,7,23,34.10648694739606,0.646875,43.850806451612904,1024.596774193548,34.1532258064516,0
4510,4,0,0,37,0.0,0.0,1.0,37,1000,700,300,0.7,13,7,6,382.9475517334051,0.4425988488488488,0.27629596809924695,0.22409632248405317,131293.68505390795,2655.7190498901555,133949.4041037981,1912,9,276.94594594594594,30,7,23,33.97185792349727,0.6475694444444444,43.78360215053763,1024.8655913978491,34.16218637992831,0
4511,4,3,3,37,0.075,0.075,0.925,40,300,200,100,0.6666666666666666,4,2,2,351.7149248833933,0.44556623931623934,0.24446464766901155,0.20995253202825764,132051.39136690216,1288.889039071513,133340.28040597367,1913,0,257.1,33,7,20,34.00786435356305,0.6474116161616161,43.0453431372549,1027.8186274509806,31.146019013666077,0
4512,4,0,0,37,0.0,0.0,1.0,37,950,700,250,0.7368421052631579,12,7,5,381.97464997277416,0.44228603603603606,0.27670999964577936,0.22453517560032873,131465.929948549,2643.3305150884526,134109.26046363745,1914,11,278.94594594594594,30,7,24,33.82235692442115,0.6493055555555556,43.615591397849464,1025.5376344086023,34.18458781362008,0
4513,4,0,0,37,0.0,0.0,1.0,37,1500,1100,400,0.7333333333333333,19,11,8,380.7115861811974,0.44166041041041043,0.2770305664491104,0.22500879814857774,131672.772863915,2625.8700427795293,134298.64290669453,1915,12,279.94594594594594,30,7,23,33.6454513707002,0.6513888888888889,43.41397849462366,1026.3440860215062,34.21146953405021,0
4514,4,0,0,37,0.0,0.0,1.0,37,950,700,250,0.7368421052631579,12,7,5,382.4327397361659,0.44031531531531537,0.2763470183964889,0.22705272450070255,131845.2661615504,2684.3892718811358,134529.65543343153,1916,13,280.94594594594594,30,7,23,33.42685294245955,0.653125,43.24596774193548,1027.0161290322574,34.233870967741915,0
4515,4,0,0,37,0.0,0.0,1.0,37,1000,800,200,0.8,12,8,4,385.9768050949574,0.4403778778778779,0.28583953476039814,0.22999163483639518,131983.34209518446,2788.5017415308257,134771.8438367153,1917,14,281.94594594594594,30,7,23,33.19626117287988,0.6545138888888888,43.11155913978495,1027.5537634408606,34.251792114695355,0
4516,4,0,0,37,0.0,0.0,1.0,37,1050,800,250,0.7619047619047619,13,8,5,386.6942763387666,0.43993993993993996,0.28893860514103786,0.2308392764373574,132052.4071605099,2812.7820051451095,134865.189165655,1918,15,282.94594594594594,30,7,23,33.10802711302908,0.6552083333333334,43.04435483870968,1027.8225806451615,34.26075268817205,0
4517,4,0,0,37,0.0,0.0,1.0,37,750,600,150,0.8,9,6,3,380.954333803238,0.43987737737737737,0.28208443737855515,0.22803604488222004,132156.03863163374,2669.0831309978084,134825.12176263155,1919,16,283.94594594594594,30,7,23,33.15087145969498,0.65625,42.943548387096776,1028.2258064516132,34.2741935483871,0
4518,4,0,0,37,0.0,0.0,1.0,37,1050,400,650,0.38095238095238093,17,4,13,380.7036998392766,0.43956456456456455,0.27917686404554276,0.22851179724470477,132259.71075052032,2670.3522444791347,134930.06299499946,1920,17,284.94594594594594,30,7,23,33.052669976915354,0.6572916666666666,42.84274193548387,1028.6290322580649,34.28763440860216,0
4519,4,0,0,37,0.0,0.0,1.0,37,850,500,350,0.5882352941176471,12,5,7,380.367248838327,0.43922047047047047,0.2787547040711593,0.22833596244853963,132264.03130425338,2661.7811414930375,134925.81244574641,1921,18,285.94594594594594,31,6,23,33.05696202531644,0.6545698924731183,42.83854166666666,1028.6458333333326,33.182123655913955,0
4520,4,0,0,37,0.0,0.0,1.0,37,1400,1200,200,0.8571428571428571,16,12,4,381.4885111021641,0.4383133133133133,0.2802439420355327,0.23003456834806077,132432.58794369284,2704.3699760494314,135136.95791974227,1922,19,286.94594594594594,30,7,23,32.85806781579178,0.6590277777777778,42.674731182795696,1029.3010752688167,34.31003584229389,0
4521,4,0,0,37,0.0,0.0,1.0,37,900,600,300,0.6666666666666666,12,6,6,381.21927850976374,0.43828203203203203,0.2786193949531204,0.23008340851901343,132467.17693158166,2699.808323216558,135166.98525479823,1923,20,287.94594594594594,30,7,23,32.83011272141708,0.659375,42.641129032258064,1029.4354838709676,34.31451612903225,0
4522,4,0,0,37,0.0,0.0,1.0,37,900,500,400,0.5555555555555556,13,5,8,381.95839523458847,0.4380005005005005,0.27559030117442873,0.23095369107278463,132536.36845661345,2724.675721181634,135261.0441777951,1924,21,288.94594594594594,30,7,23,32.74131967106123,0.6600694444444444,42.57392473118279,1029.7043010752684,34.32347670250895,0
4523,4,0,0,37,0.0,0.0,1.0,37,750,500,250,0.6666666666666666,10,5,5,379.0050196410048,0.4373435935935936,0.26629394491661373,0.23043865865087892,132744.05142574277,2662.132363568035,135406.1837893108,1925,22,289.94594594594594,30,7,19,32.60809312638582,0.6621527777777778,42.372311827956985,1030.5107526881714,34.350358422939046,0
4524,4,0,0,37,0.0,0.0,1.0,37,1250,800,450,0.64,17,8,9,389.3530446529983,0.43671796796796797,0.2173140057927383,0.219772529674717,129897.3104688857,2715.1826646592926,132612.49313354498,1926,23,290.94594594594594,31,6,18,35.227067100949455,0.6307123655913979,45.149739583333336,1019.4010416666672,32.88390456989249,8
4525,4,0,0,37,0.0,0.0,1.0,37,950,400,550,0.42105263157894735,15,4,11,387.7177238263275,0.43690565565565564,0.21565042193073847,0.21978152304308626,130063.28158908429,2685.567898220496,132748.84948730477,1927,24,291.94594594594594,31,6,19,35.09967236830908,0.6323924731182795,44.98697916666667,1020.052083333334,32.90490591397852,0
4526,4,0,0,37,0.0,0.0,1.0,37,1150,700,450,0.6086956521739131,16,7,9,388.0766092091787,0.43634259259259256,0.2086498901606717,0.2205479613032877,130162.91512383377,2702.6365492079235,132865.5516730417,1928,25,292.94594594594594,31,6,20,34.98907426311088,0.6334005376344086,44.88932291666668,1020.4427083333351,32.91750672043016,0
4527,4,0,0,37,0.0,0.0,1.0,37,1050,800,250,0.7619047619047619,13,8,5,391.4271556133449,0.4360610610610611,0.20733529738269074,0.22321926982274526,130296.89125910509,2800.3864531352183,133097.27771224032,1929,26,293.94594594594594,30,7,21,34.76720203615939,0.6375,44.75806451612903,1020.9677419354838,34.03225806451613,0
4528,4,1,0,38,0.02631578947368421,0.0,1.0,38,1300,900,400,0.6923076923076923,17,9,8,384.5432065350613,0.43822605500237083,0.1995946262856374,0.22193878672541584,130761.51741875552,2456.690639919715,133218.20805867523,1930,0,287.1842105263158,31,7,17,34.47074580946319,0.6394489247311828,44.30338541666667,1022.7864583333342,32.99311155913981,0
4529,4,0,0,38,0.0,0.0,1.0,38,1050,700,350,0.6666666666666666,14,7,7,383.8958690232742,0.43794452347083923,0.19964626433701338,0.22175631963579728,130794.8133680556,2442.3177083333385,133237.13107638893,1931,1,288.1842105263158,31,7,17,34.453496266123544,0.6397849462365591,44.270833333333336,1022.9166666666671,32.997311827957006,0
4530,4,0,0,38,0.0,0.0,1.0,38,1350,1000,350,0.7407407407407407,17,10,7,384.5443261572244,0.4375592697961119,0.20022970647129323,0.22270699036622155,130894.7266472711,2466.9648912217917,133361.6915384929,1932,2,289.1842105263158,31,7,17,34.33550176019,0.6407930107526882,44.173177083333336,1023.3072916666671,33.009912634408614,0
4531,4,0,1,37,0.0,0.02631578947368421,0.9736842105263158,38,1250,1100,150,0.88,14,11,3,383.71194846038304,0.43747036510194404,0.19979316853752072,0.22299534743118937,131028.00369262692,2455.4021199544263,133483.40581258136,1933,3,290.1842105263158,31,7,17,34.22159163169274,0.6421370967741935,44.04296875,1023.8281249999998,33.02671370967741,0
4532,4,1,0,38,0.02631578947368421,0.0,1.0,38,1300,900,400,0.6923076923076923,17,9,8,377.2326407861015,0.43910028449502136,0.18165119187233159,0.22188709204239712,131489.9488094328,2320.460125242335,133810.40893467513,1934,0,284.86842105263156,32,6,19,33.91963149903565,0.6442057291666667,43.59217171717172,1025.6313131313138,32.05097853535356,0
4533,4,0,0,38,0.0,0.0,1.0,38,1150,600,550,0.5217391304347826,17,6,11,379.10720573802865,0.438700213371266,0.18631553039625892,0.2235577034707709,131587.0909218448,2377.1228701153086,133964.2137919601,1935,1,285.86842105263156,32,6,16,33.773279186151456,0.6451822916666667,43.497474747474755,1026.0101010101018,32.06281565656568,0
4534,4,0,1,37,0.0,0.02631578947368421,0.9736842105263158,38,1100,900,200,0.8181818181818182,13,9,4,377.26071694734304,0.4383001422475106,0.18456662630866694,0.22303653585926933,131684.268904321,2335.8603395061746,134020.1292438272,1936,2,286.86842105263156,32,6,16,33.72237257555255,0.6461588541666667,43.40277777777778,1026.3888888888891,32.074652777777786,0
4535,4,0,0,37,0.0,0.0,1.0,37,950,600,350,0.631578947368421,13,6,7,380.03871973138666,0.4365928428428429,0.19298750805600084,0.22494183681398294,131728.82080078125,2612.4104817708326,134341.2312825521,1937,3,293.6756756756757,31,6,16,33.60603754439371,0.6491935483870968,43.359375,1026.5625,33.11491935483871,0
4536,4,0,0,37,0.0,0.0,1.0,37,1250,900,350,0.72,16,9,7,383.7293842296083,0.4349036536536537,0.19707464118110485,0.2283276652768937,131929.3975830078,2725.037299262152,134654.43488226997,1938,4,294.6756756756757,31,6,17,33.30851288550909,0.6512096774193548,43.1640625,1027.34375,33.140120967741936,0
4537,4,1,1,37,0.02631578947368421,0.02631578947368421,0.9736842105263158,38,1100,900,200,0.8181818181818182,13,9,4,378.47678321404396,0.43466986723565676,0.19675886751534089,0.22781860563787298,132366.47450800176,2419.527495434455,134786.0020034362,1939,0,287.89473684210526,33,5,18,33.00223790242549,0.6505681818181819,42.7389705882353,1029.044117647059,31.183155080213908,0
4538,4,0,1,36,0.0,0.02702702702702703,0.972972972972973,37,750,500,250,0.6666666666666666,10,5,5,388.2002902128012,0.4319632132132132,0.20530987541296808,0.2332637142075149,132300.5624426078,2871.823347107427,135172.38578971522,1940,1,296.43243243243245,32,5,19,32.818636475208635,0.65234375,42.8030303030303,1028.787878787878,32.14962121212119,0
4539,4,0,0,36,0.0,0.0,1.0,36,850,600,250,0.7058823529411765,11,6,5,396.89954519972156,0.43093584656084655,0.21973597220463947,0.2380493172006528,132230.54885864246,3296.448940700942,135526.9977993434,1941,2,303.97222222222223,31,5,19,32.665659155167326,0.654233870967742,42.87109374999999,1028.515624999999,33.17792338709675,0
4540,4,0,0,36,0.0,0.0,1.0,36,900,500,400,0.5555555555555556,13,5,8,399.1214410988544,0.4305059523809524,0.22368421052631593,0.24044633158882195,132398.00347222216,3368.682352701814,135766.68582492397,1942,3,304.97222222222223,30,6,20,32.43927125506073,0.6586805555555555,42.70833333333333,1029.166666666666,34.305555555555536,0
4541,4,0,0,36,0.0,0.0,1.0,36,750,600,150,0.8,9,6,3,399.28283647717296,0.4303240740740741,0.2227806788511748,0.24120713938605218,132501.77043588835,3381.1365475777293,135882.9069834661,1943,4,305.97222222222223,30,6,20,32.330287206266306,0.6597222222222222,42.60752688172042,1029.5698924731169,34.31899641577056,0
4542,4,0,0,36,0.0,0.0,1.0,36,1250,1000,250,0.8,15,10,5,402.9080263266351,0.4282903439153439,0.22569353856857077,0.24474587399524428,132709.42630650935,3493.938605619133,136203.36491212848,1944,5,306.97222222222223,30,6,16,32.0272414992608,0.6618055555555555,42.40591397849462,1030.376344086021,34.345878136200696,0
4543,4,0,0,36,0.0,0.0,1.0,36,1350,1000,350,0.7407407407407407,17,10,7,399.260267679601,0.42761243386243386,0.22265378299861083,0.243336685082325,132833.88137817383,3407.0582071940107,136240.93958536783,1945,6,307.97222222222223,31,5,17,31.995626499936844,0.6602822580645161,42.28515625,1030.859375,33.25352822580645,0
4544,4,0,0,36,0.0,0.0,1.0,36,1050,900,150,0.8571428571428571,12,9,3,402.15313137985527,0.42683531746031744,0.22165418384807412,0.24620224936562707,133001.71746148012,3497.411431206604,136499.1288926867,1946,7,308.97222222222223,31,5,17,31.751767230497336,0.6619623655913979,42.122395833333336,1031.5104166666672,33.27452956989249,0
4545,4,0,0,36,0.0,0.0,1.0,36,1400,1100,300,0.7857142857142857,17,11,6,402.90361850141824,0.426603835978836,0.22578994588835655,0.24755147908854572,133136.0626220703,3528.20027669271,136664.26289876303,1947,8,309.97222222222223,31,5,17,31.596959374211455,0.6633064516129032,41.9921875,1032.03125,33.29133064516129,0
4546,4,0,0,36,0.0,0.0,1.0,36,850,400,450,0.47058823529411764,13,4,9,403.15878692659123,0.42624007936507935,0.22812806501331107,0.2486041353287613,133270.47559950093,3545.832655164942,136816.30825466587,1948,9,310.97222222222223,31,5,17,31.454918032786882,0.6646505376344086,41.86197916666667,1032.552083333334,33.308131720430126,0
4547,4,0,0,36,0.0,0.0,1.0,36,1350,1000,350,0.7407407407407407,17,10,7,401.1266715345103,0.42569444444444443,0.22421410067912917,0.24847307873741914,133438.5871887207,3505.1552666558164,136943.74245537652,1949,10,311.97222222222223,31,5,18,31.33808548624238,0.6663306451612903,41.69921875,1033.203125,33.32913306451613,0
4548,4,0,0,36,0.0,0.0,1.0,36,950,600,350,0.631578947368421,13,6,7,404.139259914374,0.4248346560846561,0.21779205509364208,0.2510217093270972,133539.50500488284,3593.7113444010433,137133.21634928387,1950,11,312.97222222222223,31,5,18,31.15866717057193,0.6673387096774194,41.6015625,1033.5937500000002,33.34173387096775,0
4549,4,0,0,36,0.0,0.0,1.0,36,950,700,250,0.7368421052631579,12,7,5,390.29429095198896,0.423859126984127,0.2081029610517262,0.23271833216543866,132008.4545741506,3104.429235537187,135112.88380968777,1951,12,313.97222222222223,32,4,16,33.059958225826264,0.6494140625,43.08712121212121,1027.651515151515,32.114109848484844,8
4550,4,0,0,36,0.0,0.0,1.0,36,750,300,450,0.4,12,3,9,390.29429095198896,0.423859126984127,0.2081029610517262,0.23271833216543866,132008.4545741506,3104.429235537187,135112.88380968777,1952,13,314.97222222222223,32,4,16,33.059958225826264,0.6494140625,43.08712121212121,1027.651515151515,32.114109848484844,0
4551,4,0,0,36,0.0,0.0,1.0,36,750,500,250,0.6666666666666666,10,5,5,390.34477740084037,0.424537037037037,0.20451568001310072,0.23334707618191192,132105.78799357195,3113.360881542686,135219.14887511465,1953,14,315.97222222222223,32,4,16,32.960267747482185,0.650390625,42.992424242424235,1028.030303030302,32.12594696969694,0
4552,4,0,0,36,0.0,0.0,1.0,36,1450,900,550,0.6206896551724138,20,9,11,389.94333658650277,0.4241567460317461,0.17791487306255238,0.21861984483462624,129631.97708129873,2989.062106269984,132621.0391875687,1954,15,316.97222222222223,31,5,17,35.482594936708864,0.6280241935483871,45.41015624999999,1018.3593749999992,32.85030241935481,8
4553,4,1,1,36,0.02702702702702703,0.02702702702702703,0.972972972972973,37,1200,800,400,0.6666666666666666,16,8,8,379.199676410853,0.42623873873873874,0.1799014705833164,0.21534171363851748,130133.72559241409,2469.3333269564355,132603.05891937052,1955,0,309.3783783783784,32,5,20,35.24522542589613,0.6305338541666667,44.917929292929294,1020.3282828282832,31.88525883838385,0
4554,4,0,0,36,0.0,0.0,1.0,36,950,600,350,0.631578947368421,13,6,7,380.4072673852106,0.42514880952380957,0.1946216664540008,0.2161893948149307,130162.91512383349,2702.9837714301157,132865.8988952636,1956,1,317.25,31,5,20,35.184727361660514,0.6334005376344086,44.889322916666664,1020.4427083333328,32.91750672043009,0
4555,4,0,0,36,0.0,0.0,1.0,36,1450,1200,250,0.8275862068965517,17,12,5,381.51953925618415,0.42390873015873015,0.20201859173291403,0.21756325144056302,130295.819176568,2742.080179850265,133037.89935641826,1957,2,318.25,31,5,21,35.0211760829826,0.634744623655914,44.759114583333336,1020.9635416666672,32.93430779569894,0
4556,4,0,0,36,0.0,0.0,1.0,36,900,600,300,0.6666666666666666,12,6,6,380.793911350452,0.424239417989418,0.20057007294101004,0.21789410901125436,130428.79104614267,2733.2978990343026,133162.08894517698,1958,3,319.25,31,5,21,34.90453048650945,0.6360887096774194,44.62890625000001,1021.4843750000007,32.951108870967765,0
4557,4,0,0,36,0.0,0.0,1.0,36,1150,900,250,0.782608695652174,14,9,5,380.2305852563256,0.4240079365079365,0.19731105165555385,0.2183196681548574,130561.8307325576,2728.720262315547,133290.55099487316,1959,4,320.25,31,5,17,34.783756954176745,0.6374327956989247,44.49869791666667,1022.0052083333342,32.96790994623659,0
4558,4,0,0,36,0.0,0.0,1.0,36,1050,800,250,0.7619047619047619,13,8,5,380.31238589800785,0.4239914021164021,0.19762915782024026,0.21855433596627846,130595.10125054259,2733.3869086371565,133328.48815917975,1960,5,321.25,31,5,17,34.74787685774947,0.637768817204301,44.466145833333336,1022.1354166666671,32.972110215053775,0
4559,4,0,0,36,0.0,0.0,1.0,36,1300,800,500,0.6153846153846154,18,8,10,382.1920925232838,0.42347883597883595,0.19346829640947294,0.22039182780307423,130728.22570800783,2792.6588270399307,133520.88453504775,1961,6,322.25,31,5,17,34.56465919701214,0.6391129032258065,44.3359375,1022.6562500000001,32.988911290322584,0
4560,4,0,0,36,0.0,0.0,1.0,36,1150,700,450,0.6086956521739131,16,7,9,386.21873975966616,0.4235449735449735,0.19455759221543412,0.22309811908470106,130794.81336805546,2903.081597222213,133697.89496527766,1962,7,323.25,31,5,17,34.39409368635438,0.6397849462365591,44.27083333333333,1022.9166666666658,32.99731182795696,0
4561,4,0,0,36,0.0,0.0,1.0,36,1300,1100,200,0.8461538461538461,15,11,4,386.2184469160898,0.423561507936508,0.19315771612793764,0.22348339881197576,130861.41798231321,2908.2187228732446,133769.63670518645,1963,8,324.25,31,5,18,34.3264825655383,0.6404569892473118,44.20572916666666,1023.1770833333321,33.00571236559136,0
4562,4,0,0,36,0.0,0.0,1.0,36,1000,900,100,0.9,11,9,2,386.2022530611381,0.4234457671957672,0.19573807807043653,0.2236671707301019,130894.72664727096,2910.3676689995573,133805.09431627052,1964,9,325.25,31,5,18,34.293087542944406,0.6407930107526882,44.17317708333333,1023.3072916666658,33.00991263440857,0
4563,4,1,0,37,0.02702702702702703,0.0,1.0,37,1450,1100,350,0.7586206896551724,18,11,7,381.10364992510085,0.4255505505505506,0.19922323505626083,0.22378472458725543,131425.20732897145,2617.3252410468203,134042.53257001826,1965,0,317.43243243243245,32,5,19,33.885913064893494,0.6435546875,43.655303030303024,1025.378787878787,32.043087121212096,0
4564,4,0,0,37,0.0,0.0,1.0,37,950,800,150,0.8421052631578947,11,8,3,381.10364992510085,0.4255505505505506,0.19922323505626083,0.22378472458725543,131425.20732897145,2617.3252410468203,134042.53257001826,1966,1,318.43243243243245,32,5,19,33.885913064893494,0.6435546875,43.655303030303024,1025.378787878787,32.043087121212096,0
4565,4,0,0,37,0.0,0.0,1.0,37,1050,600,450,0.5714285714285714,15,6,9,379.7381357060103,0.4261761761761762,0.20288235059283788,0.22355018945475555,131522.32552800726,2588.808539944893,134111.13406795217,1967,2,319.43243243243245,32,5,20,33.822624322993605,0.64453125,43.560606060606055,1025.757575757575,32.05492424242422,0
4566,4,1,0,38,0.02631578947368421,0.0,1.0,38,800,600,200,0.75,10,6,4,370.32906432506405,0.4280464675201517,0.20209357981419696,0.21960277636091358,131799.595182742,2161.844152489396,133961.43933523138,1968,0,312.0,33,5,19,33.783740104228826,0.6448863636363636,43.29044117647057,1026.8382352941157,31.11631016042775,0
4567,4,0,0,38,0.0,0.0,1.0,38,950,700,250,0.7368421052631579,12,7,5,370.17333006761214,0.4276463963963964,0.20473558598166108,0.21969210382199617,131831.0565647826,2160.0682429834496,133991.12480776606,1969,1,313.0,33,5,20,33.75596658711218,0.6452020202020202,43.25980392156862,1026.9607843137242,31.12002376708255,0
4568,4,1,0,39,0.02564102564102564,0.0,1.0,39,850,500,350,0.5882352941176471,12,5,7,363.70895928172365,0.4283625730994152,0.2047126293479622,0.21787226007458566,132183.6805555554,1815.2777777777578,133998.95833333314,1970,0,305.94871794871796,34,5,21,33.56631550513235,0.6464460784313726,42.91666666666666,1028.333333333332,30.245098039215645,0
4569,4,0,0,39,0.0,0.0,1.0,39,1150,600,550,0.5217391304347826,17,6,11,364.2313551374353,0.42782838506522713,0.21204057233213813,0.21907109272462413,132336.75063775494,1840.2388038548522,134176.9894416098,1971,1,306.94871794871796,34,5,21,33.398655945080804,0.6479779411764706,42.76785714285713,1028.92857142857,30.262605042016762,0
4570,4,0,0,39,0.0,0.0,1.0,39,1500,1200,300,0.8,18,12,6,361.7499057516105,0.4271817363922627,0.20720440153638542,0.21793226029426283,132398.00347222216,1778.9930555555452,134176.9965277777,1972,2,307.94871794871796,34,5,21,33.4008097165992,0.6485906862745099,42.70833333333333,1029.166666666666,30.269607843137237,0
4571,4,0,0,39,0.0,0.0,1.0,39,1150,800,350,0.6956521739130435,15,8,7,362.4620478374501,0.4266756635177688,0.20530614423744242,0.21853883302667995,132428.6352040815,1800.0708616779943,134228.7060657595,1973,3,308.94871794871796,34,5,21,33.351646233325624,0.6488970588235294,42.67857142857142,1029.2857142857133,30.27310924369745,0
4572,4,0,0,39,0.0,0.0,1.0,39,1150,800,350,0.6956521739130435,15,8,7,363.5689465008,0.42622582096266304,0.20779513256111004,0.22045985242266425,132643.1565334466,1844.9865362811647,134488.14306972775,1974,4,309.94871794871796,34,5,18,33.10725567240649,0.6510416666666667,42.47023809523809,1030.1190476190466,30.297619047619015,0
4573,4,0,0,39,0.0,0.0,1.0,39,950,700,250,0.7368421052631579,12,7,5,367.76943766121633,0.42608524516419255,0.2081500244411858,0.22337154266370726,132704.48022959183,1960.9304138321986,134665.41064342402,1975,5,310.94871794871796,34,5,18,32.93736761024456,0.6516544117647058,42.410714285714285,1030.357142857143,30.304621848739497,0
4574,4,0,0,39,0.0,0.0,1.0,39,1050,700,350,0.6666666666666666,14,7,7,366.74741442047815,0.4258884390463338,0.21040096687046805,0.222932978878066,132735.1473922902,1936.0544217687066,134671.2018140589,1976,6,311.94871794871796,34,5,18,32.93284041897719,0.6519607843137255,42.38095238095238,1030.4761904761904,30.308123249299715,0
4575,4,0,0,39,0.0,0.0,1.0,39,1250,1000,250,0.8,15,10,5,367.2208756026294,0.4256354026090868,0.2132122795016893,0.22376956803963194,132827.17013888896,1955.3819444444548,134782.55208333343,1977,7,312.94871794871796,34,5,19,32.82807868499056,0.6528799019607843,42.29166666666667,1030.833333333334,30.31862745098041,0
4576,4,0,0,39,0.0,0.0,1.0,39,1350,1100,250,0.8148148148148148,16,11,5,367.6072278266882,0.4253823661718399,0.20752594592354479,0.22455668599681045,132919.22477324257,1972.4135487528279,134891.63832199542,1978,8,313.94871794871796,34,5,19,32.72555414453936,0.6537990196078431,42.20238095238095,1031.1904761904757,30.32913165266105,0
4577,4,0,0,39,0.0,0.0,1.0,39,650,500,150,0.7692307692307693,8,5,3,371.2979233328986,0.4252136752136752,0.20622321661102827,0.227183983598604,132980.6122448979,2075.085034013597,135055.6972789115,1979,9,314.94871794871796,34,5,19,32.56867497691597,0.6544117647058824,42.14285714285714,1031.4285714285709,30.336134453781497,0
4578,4,0,0,39,0.0,0.0,1.0,39,600,300,300,0.5,9,3,6,370.879091190652,0.42487629329734594,0.18069115140244896,0.21619537266967287,131145.1530612245,1927.7990362811843,133072.95209750568,1980,10,315.94871794871796,34,5,20,34.431417557725105,0.6360294117647058,43.92857142857143,1024.2857142857144,30.12605042016807,8
4579,4,0,0,39,0.0,0.0,1.0,39,950,500,450,0.5263157894736842,14,5,9,371.7281823605708,0.4243421052631579,0.1815988634434449,0.21755322378940545,131297.62081916098,1961.4051870748308,133259.0260062358,1981,11,316.94871794871796,34,5,22,34.255333565648364,0.6375612745098039,43.779761904761905,1024.8809523809523,30.143557422969185,0
4580,4,0,0,39,0.0,0.0,1.0,39,1250,900,350,0.72,16,9,7,369.9771287825477,0.4243139901034638,0.17711885815334116,0.21706750619322873,131392.84256708494,1922.4764132772762,133315.3189803622,1982,12,317.94871794871796,32,7,22,34.20386904761906,0.6432291666666667,43.686868686868685,1025.252525252525,32.039141414141405,0
4581,4,0,0,39,0.0,0.0,1.0,39,1150,1000,150,0.8695652173913043,13,10,3,368.6504469953221,0.4240890688259109,0.17961028671357382,0.21683907175546718,131489.94880943268,1894.7656807978756,133384.71449023054,1983,13,318.94871794871796,32,7,23,34.13968566621527,0.6442057291666667,43.592171717171716,1025.631313131313,32.05097853535353,0
4582,4,0,0,39,0.0,0.0,1.0,39,900,600,300,0.6666666666666666,12,6,6,367.51289592021624,0.4238922627080522,0.17991595918017333,0.21667732145380642,131579.4706362938,1871.4304594386836,133450.90109573246,1984,14,319.94871794871796,33,6,19,34.078376333811114,0.6426767676767677,43.504901960784316,1025.9803921568632,31.090314913844338,0
4583,4,0,1,38,0.0,0.02564102564102564,0.9743589743589743,39,1200,1000,200,0.8333333333333334,14,10,4,365.49296366309585,0.4234424201529465,0.178045336306206,0.2166582001095672,131786.1128826531,1833.3793934240412,133619.49227607716,1985,15,320.94871794871796,34,5,21,33.92149758454105,0.6424632352941176,43.30357142857143,1026.7857142857147,30.199579831932784,0
4584,4,0,0,38,0.0,0.0,1.0,38,950,800,150,0.8421052631578947,11,8,3,374.23492637863706,0.4214378852536747,0.19424426531291772,0.2215523659557489,131736.68368235786,2260.0936238466115,133996.7773062045,1986,16,329.94736842105266,33,5,21,33.747040507739435,0.6442550505050505,43.35171568627452,1026.593137254903,31.108882947118275,0
4585,4,0,0,38,0.0,0.0,1.0,38,800,300,500,0.375,13,3,10,371.47752899729875,0.42077110004741586,0.1890956812216653,0.22083153532307492,131893.9905925605,2199.130742983462,134093.12133554395,1987,17,330.94736842105266,33,5,22,33.6589318380657,0.6458333333333333,43.1985294117647,1027.2058823529408,31.127450980392144,0
4586,4,0,1,37,0.0,0.02631578947368421,0.9736842105263158,38,650,400,250,0.6153846153846154,9,4,5,371.0960262368162,0.42077110004741586,0.18947117316191298,0.2209708156228315,131956.93963860054,2193.7391868512177,134150.67882545176,1988,18,331.94736842105266,33,5,22,33.605180502544535,0.6464646464646464,43.13725490196079,1027.450980392157,31.134878193701724,0
4587,4,0,0,37,0.0,0.0,1.0,37,1150,800,350,0.6956521739130435,15,8,7,373.26040525694697,0.4204517017017017,0.18556434105439235,0.2231340836712234,132105.7879935721,2461.971992653811,134567.75998622592,1989,19,338.5135135135135,32,5,22,33.39934905428641,0.650390625,42.99242424242424,1028.0303030303032,32.125946969696976,0
4588,4,0,0,37,0.0,0.0,1.0,37,750,600,150,0.8,9,6,3,373.57947417988987,0.41976351351351354,0.1846426485424526,0.2237081792441929,132170.6968676666,2475.2518875625037,134645.9487552291,1990,20,339.5135135135135,32,5,22,33.32565897184023,0.6510416666666667,42.929292929292934,1028.2828282828286,32.133838383838395,0
4589,4,0,0,37,0.0,0.0,1.0,37,650,300,350,0.46153846153846156,10,3,7,374.54425824744186,0.41973223223223227,0.18221094022199003,0.22447851239333452,132203.15728305798,2503.186696510576,134706.34397956857,1991,21,340.5135135135135,32,5,22,33.26810926949049,0.6513671875,42.89772727272728,1028.409090909092,32.13778409090912,0
4590,4,0,0,37,0.0,0.0,1.0,37,1400,1000,400,0.7142857142857143,18,10,8,376.00027744396925,0.41985735735735735,0.1878127974581527,0.22612739932774223,132333.03880025004,2551.4518607795208,134884.49066102956,1992,22,341.5135135135135,32,5,22,33.09966458052113,0.6526692708333333,42.77146464646465,1028.914141414142,32.15356691919194,0
4591,4,0,0,37,0.0,0.0,1.0,37,1450,1000,450,0.6896551724137931,19,10,9,374.97099558259526,0.4199824824824825,0.18313570937827928,0.22650081452036533,132498.5271030003,2536.6368664586957,135035.16396945898,1993,23,342.5135135135135,31,6,22,32.95932401669406,0.6569220430107527,42.610677083333336,1029.5572916666672,33.21152553763442,0
4592,4,0,0,37,0.0,0.0,1.0,37,400,200,200,0.5,6,2,4,373.2441028009831,0.4198886386386386,0.18755916113356985,0.22585980176380857,132565.56404961488,2495.8630032009646,135061.42705281585,1994,24,343.5135135135135,31,6,22,32.93623825178067,0.6575940860215054,42.54557291666667,1029.8177083333342,33.219926075268845,0
4593,4,0,0,37,0.0,0.0,1.0,37,800,600,200,0.75,10,6,4,374.9021269773974,0.41976351351351354,0.19049733418493697,0.22767463781827685,132699.68880547423,2549.879116482209,135249.56792195645,1995,25,344.5135135135135,31,6,18,32.75846181389275,0.6589381720430108,42.415364583333336,1030.338541666667,33.23672715053765,0
4594,4,0,1,36,0.0,0.02702702702702703,0.972972972972973,37,1450,1300,150,0.896551724137931,16,13,3,378.0218567690308,0.41963838838838835,0.18600411703859954,0.23039253579987848,132833.88137817406,2642.822096082928,135476.703474257,1996,26,345.5135135135135,31,6,19,32.54297187486843,0.6602822580645161,42.285156250000014,1030.8593750000018,33.25352822580651,0
4595,4,0,0,36,0.0,0.0,1.0,36,1150,800,350,0.6956521739130435,15,8,7,379.6802233600563,0.42007275132275135,0.1771448847178776,0.23191932114795807,132917.2447681814,2893.209836397283,135810.4546045787,1997,27,350.75,30,6,19,32.416308220368435,0.6638888888888889,42.20430107526882,1031.1827956989255,34.37275985663085,0
4596,4,0,0,36,0.0,0.0,1.0,36,600,500,100,0.8333333333333334,7,5,2,378.82926546311296,0.4201388888888889,0.1729432716532011,0.2318290098216851,132986.55372008332,2875.8396924500003,135862.39341253333,1998,28,351.75,30,6,19,32.368495352271744,0.6645833333333333,42.13709677419355,1031.4516129032263,34.38172043010754,0
4597,4,0,0,36,0.0,0.0,1.0,36,1300,1000,300,0.7692307692307693,16,10,6,382.8640407986108,0.4195601851851852,0.16775173611111094,0.23560864049145316,133194.58896982335,2999.0837090993514,136193.6726789227,1999,29,352.75,30,6,20,32.055121527777786,0.6666666666666667,41.93548387096776,1032.258064516131,34.4086021505377,0
4598,4,0,0,36,0.0,0.0,1.0,36,800,400,400,0.5,12,4,8,399.02122670084844,0.4193617724867725,0.1942414399783461,0.23568088282114863,131648.6328125,3352.1917725315066,135000.8245850315,2000,30,353.75,29,7,18,33.20011165245636,0.6540948275862069,43.4375,1026.25,35.38793103448276,8
4599,4,0,0,36,0.0,0.0,1.0,36,1200,900,300,0.75,15,9,6,399.8029582931742,0.4188161375661376,0.19137096652990038,0.23702832964406065,131791.2061149692,3338.1028163580304,135129.30893132722,2001,31,354.75,29,7,19,33.03561364353668,0.6555316091954023,43.298611111111114,1026.8055555555559,35.40708812260537,0
4600,4,0,0,36,0.0,0.0,1.0,36,650,500,150,0.7692307692307693,8,5,3,400.1250776592379,0.41808862433862437,0.1927541131395092,0.23766465456145075,131862.5217013888,3352.3003472222163,135214.822048611,2002,32,355.75,29,7,19,32.95512170385396,0.65625,43.229166666666664,1027.0833333333326,35.41666666666664,0
4601,4,0,0,36,0.0,0.0,1.0,36,650,400,250,0.6153846153846154,9,4,5,399.86476255501424,0.4179232804232804,0.19178606830674982,0.23818031508711715,131969.53125,3353.9930555555557,135323.52430555556,2003,33,356.75,29,7,20,32.85347391186808,0.6573275862068966,43.125,1027.5,35.43103448275862,0
4602,4,0,0,36,0.0,0.0,1.0,36,900,500,400,0.5555555555555556,13,5,8,398.7582176771363,0.4180390211640212,0.19091591591591572,0.23796861377506542,132040.89506172854,3330.4783950617457,135371.3734567903,2004,34,357.75,29,7,20,32.80968468468468,0.6580459770114943,43.055555555555564,1027.777777777779,35.44061302681997,0
4603,4,0,0,36,0.0,0.0,1.0,36,700,400,300,0.5714285714285714,10,4,6,406.0079440815212,0.4181216931216931,0.17320240486672134,0.22346195877853076,128903.70898776574,3267.1859741210847,132170.89496188684,2005,35,358.75,31,5,20,35.81882826858145,0.6206317204301075,46.12630208333333,1015.4947916666658,32.757896505376316,8
4604,4,0,0,36,0.0,0.0,1.0,36,700,600,100,0.8571428571428571,8,6,2,409.7634678145147,0.4185515873015873,0.18021914648212234,0.22628339273578602,129035.96878051749,3374.8452080620514,132410.81398857955,2006,36,359.75,31,5,20,35.58794160365671,0.6219758064516129,45.99609374999999,1016.0156249999993,32.77469758064514,0
4605,4,0,0,36,0.0,0.0,1.0,36,1200,800,400,0.6666666666666666,16,8,8,412.46118974419994,0.41884920634920636,0.1857047285563811,0.22834553525838455,129135.20812988271,3452.65231662325,132587.86044650595,2007,37,360.75,31,5,20,35.417734221538986,0.622983870967742,45.89843749999999,1016.4062499999992,32.78729838709675,0
4606,4,0,0,36,0.0,0.0,1.0,36,1200,1000,200,0.8333333333333334,14,10,4,415.05576549765016,0.41868386243386246,0.18748347872059212,0.23056622039318797,129269.72229448482,3530.8456627312703,132800.5679572161,2008,38,361.75,30,6,20,35.21400563926337,0.6270833333333333,45.76612903225806,1016.9354838709669,33.89784946236556,0
4607,4,0,0,36,0.0,0.0,1.0,36,700,400,300,0.5714285714285714,10,4,6,414.907124503452,0.4185681216931217,0.1831924076276037,0.2310840342433131,129372.25627601445,3535.4941684009545,132907.7504444154,2009,39,362.75,30,6,20,35.112795613687396,0.628125,45.66532258064515,1017.3387096774184,33.91129032258061,0
4608,4,0,0,36,0.0,0.0,1.0,36,1650,1300,350,0.7878787878787878,20,13,7,414.2820544842886,0.41722883597883603,0.1961530564355276,0.23214503289740876,129611.66030754977,3539.156983466268,133150.81729101605,2010,40,363.75,30,6,19,34.883733720520944,0.6305555555555555,45.430107526881706,1018.2795698924712,33.94265232974904,0
4609,4,0,0,36,0.0,0.0,1.0,36,650,400,250,0.6153846153846154,9,4,5,413.79972970987865,0.4165839947089947,0.18981909076248704,0.23248244265909343,129714.32978162215,3535.15092062666,133249.4807022488,2011,41,364.75,30,6,20,34.791034437260855,0.6315972222222221,45.329301075268816,1018.6827956989246,33.95609318996415,0
4610,4,1,0,37,0.02702702702702703,0.0,1.0,37,1400,1100,300,0.7857142857142857,17,11,6,404.15468513543993,0.4202327327327327,0.18881309497931476,0.22890409607128714,130030.07888793944,3110.4531182183164,133140.53200615777,2012,0,355.86486486486484,31,6,21,34.714376143665696,0.6320564516129032,45.01953125,1019.9218749999999,32.90070564516129,0
4611,4,0,1,36,0.0,0.02702702702702703,0.972972972972973,37,1100,700,400,0.6363636363636364,15,7,8,402.19861942667984,0.41973223223223227,0.18848557592814874,0.22837886824836673,130129.69970703116,3067.5971137152633,133197.29682074641,2013,1,356.86486486486484,31,6,21,34.662668027905376,0.6330645161290323,44.92187499999999,1020.3124999999993,32.91330645161288,0
4612,4,1,0,37,0.02702702702702703,0.0,1.0,37,850,600,250,0.7058823529411765,11,6,5,388.9436262536398,0.4212962962962963,0.16444613627712235,0.2232701922621959,130552.75769054188,2755.532598714432,133308.2902892563,2014,0,343.1621621621622,32,5,17,34.570360761057586,0.634765625,44.507575757575765,1021.9696969696977,31.936553030303052,0
4613,4,0,2,35,0.0,0.05405405405405406,0.9459459459459459,37,950,700,250,0.7368421052631579,12,7,5,403.31913728425275,0.4213588588588589,0.21039601535069852,0.22000434153112655,128548.11137843606,2982.1317693389406,131530.243147775,2015,1,344.1621621621622,33,4,20,36.2516364551863,0.6120580808080809,46.4767156862745,1014.0931372549011,30.730095068330336,8
4614,4,2,0,37,0.05405405405405406,0.0,1.0,37,1300,1100,200,0.8461538461538461,15,11,4,398.56968784477607,0.4224537037037037,0.20378169235010635,0.21917478192315218,128868.76594387731,2872.636763038519,131741.40270691583,2016,0,331.7027027027027,34,3,22,36.043449798725895,0.6130514705882353,46.16071428571427,1015.357142857141,29.863445378151205,0
4615,4,0,0,37,0.0,0.0,1.0,37,900,700,200,0.7777777777777778,11,7,4,396.58008555639566,0.42201576576576577,0.20419012377751122,0.2184134738464563,128929.21095521527,2826.1515022675576,131755.3624574828,2017,1,332.7027027027027,34,3,22,36.032069315828544,0.6136642156862745,46.10119047619047,1015.5952380952369,29.870448179271676,0
4616,4,2,2,37,0.05128205128205128,0.05128205128205128,0.9487179487179487,39,950,700,250,0.7368421052631579,12,7,5,376.09182395321733,0.42816576698155645,0.1924651065169487,0.21043916561657097,129554.63927469119,1945.1751070798477,131499.81438177102,2018,0,316.5897435897436,35,4,16,35.91405184174624,0.6178571428571429,45.4861111111111,1018.0555555555541,29.087301587301546,0
4617,4,1,0,38,0.02631578947368421,0.0,1.0,38,800,600,200,0.75,10,6,4,389.54694640792627,0.4243717401612139,0.22551238821287178,0.207982382154143,127688.85598013573,2350.0897998223677,130038.9457799581,2019,0,325.89473684210526,36,2,17,37.482590529247915,0.5969328703703703,47.32545045045046,1010.6981981981997,28.074949949949993,8
4618,4,3,2,39,0.07317073170731707,0.04878048780487805,0.9512195121951219,41,750,500,250,0.6666666666666666,10,5,5,369.36971790535904,0.4324695121951219,0.23323725315647703,0.20188578359663648,128627.12762188201,1306.2512811004503,129933.37890298247,2020,0,302.9756097560976,34,7,17,37.03154950514413,0.6106004901960784,46.39880952380952,1014.4047619047614,29.83543417366945,0
4619,4,1,0,40,0.025,0.0,1.0,40,1200,700,500,0.5833333333333334,17,7,10,378.00429558689495,0.4306623931623932,0.2396427314325944,0.20691911440508068,128687.51594387756,1728.8867630385516,130416.40270691611,2021,0,311.425,34,6,18,36.750801752121724,0.6112132352941176,46.339285714285715,1014.6428571428572,29.84243697478992,0
4620,4,1,0,41,0.024390243902439025,0.0,1.0,41,800,700,100,0.875,9,7,2,370.7538279614405,0.43315548780487806,0.23880099361485763,0.20468409445569322,129024.94454089503,1367.2984182098755,130392.2429591049,2022,0,304.8048780487805,35,6,20,36.59005468215994,0.6125,46.00694444444444,1015.972222222222,29.02777777777777,0
4621,4,2,2,41,0.046511627906976744,0.046511627906976744,0.9534883720930233,43,1300,900,400,0.6923076923076923,17,9,8,351.67814360639363,0.43890734588409,0.22468547681424167,0.19692632904554078,129584.09857521004,514.6201721107655,130098.7187473208,2023,0,291.5813953488372,35,8,17,36.50546114205599,0.6181547619047619,45.457175925925924,1018.1712962962962,29.09060846560846,0
4622,4,2,3,40,0.046511627906976744,0.06976744186046512,0.9302325581395349,43,1600,1300,300,0.8125,19,13,6,350.30858158423456,0.4373154300479882,0.22500584801334567,0.19696965429413119,129745.78622118743,490.21246753510127,130235.99868872254,2024,0,292.5348837209302,36,7,18,36.37600862164252,0.6177662037037037,45.29842342342342,1018.8063063063065,28.30017517517518,0
4623,4,0,0,40,0.0,0.0,1.0,40,1300,1100,200,0.8461538461538461,15,11,4,378.9182755116856,0.4328258547008547,0.24739759036144604,0.21079233825381938,129326.01042868105,1800.7977700883994,131126.80819876946,2025,1,301.425,33,7,20,36.07530120481927,0.619949494949495,45.710784313725476,1017.1568627450962,30.822935234699884,0
4624,4,0,0,40,0.0,0.0,1.0,40,1100,600,500,0.5454545454545454,16,6,10,379.1866669460117,0.4329861111111111,0.25316188870151835,0.21127568516683123,129388.34372597064,1812.466959823128,131200.81068579378,2026,2,302.425,33,7,20,36.004878342568055,0.6205808080808081,45.64950980392156,1017.4019607843126,30.83036244800947,0
4625,4,0,0,40,0.0,0.0,1.0,40,1100,600,500,0.5454545454545454,16,6,10,395.41393918976917,0.43253205128205124,0.2212710020548776,0.21535612369433568,128485.98082768646,2198.5752174644385,130684.55604515091,2027,3,303.425,33,7,18,36.51574902292599,0.6114267676767677,46.53799019607843,1013.8480392156862,30.722667855020795,8
4626,4,1,0,41,0.024390243902439025,0.0,1.0,41,1900,1600,300,0.8421052631578947,22,16,6,385.2795708968983,0.4339684959349594,0.23933805635173888,0.21242186610574715,128972.51136271407,1738.0947670643623,130710.60612977843,2028,0,297.0,36,5,19,36.27471359940872,0.6099537037037037,46.05855855855856,1015.7657657657658,28.215715715715717,0
4627,4,0,0,41,0.0,0.0,1.0,41,650,500,150,0.7692307692307693,8,5,3,385.1758510846735,0.43391768292682925,0.24047991089531817,0.21267175816927322,129029.711721857,1739.8258055352705,130769.53752739227,2029,1,298.0,36,5,19,36.218872386019356,0.6105324074074074,46.002252252252255,1015.9909909909911,28.221971971971975,0
4628,4,3,1,43,0.06818181818181818,0.022727272727272728,0.9772727272727273,44,1000,800,200,0.8,12,8,4,359.45427207009874,0.4377862931642001,0.23650576028766324,0.2027053343617735,129860.54202428782,536.127724007797,130396.66974829561,2030,0,278.6136363636364,36,8,19,36.02640592199758,0.6189236111111112,45.185810810810814,1019.2567567567569,28.312687687687692,0
4629,4,0,1,42,0.0,0.023255813953488372,0.9767441860465116,43,1450,1000,450,0.6896551724137931,19,10,9,366.07197999313576,0.4357235142118863,0.24201159706372222,0.20598378575733195,129774.4704163625,901.3594675757051,130675.8298839382,2031,1,286.09302325581393,36,7,19,35.94532861774242,0.6180555555555556,45.27027027027028,1018.9189189189204,28.303303303303345,0
4630,4,1,0,43,0.023255813953488372,0.0,1.0,43,950,600,350,0.631578947368421,13,6,7,355.5428595509727,0.43879198966408267,0.22969865424223612,0.20170553446721046,130094.74068944292,650.8512234533669,130745.59191289629,2032,0,282.4186046511628,37,6,20,35.888238033820556,0.6193693693693694,44.95614035087719,1020.1754385964914,27.572309151256526,0
4631,4,0,1,42,0.0,0.023255813953488372,0.9767441860465116,43,900,400,500,0.4444444444444444,14,4,10,354.51478076003065,0.4386304909560723,0.22944936749983724,0.20141114467355595,130150.67737188369,628.0677708525707,130778.74514273627,2033,1,283.4186046511628,37,6,20,35.857690378966964,0.6199324324324325,44.901315789473685,1020.3947368421057,27.57823613086772,0
4632,4,1,0,43,0.023255813953488372,0.0,1.0,43,1200,1000,200,0.8333333333333334,14,10,4,354.4295910951217,0.43807678110003695,0.22628443037747425,0.20224122734169095,130320.07250071017,637.9060933031913,130957.97859401336,2034,0,284.09302325581393,36,7,21,35.68802617550825,0.6235532407407407,44.73536036036036,1021.0585585585585,28.362737737737735,0
4633,4,0,0,43,0.0,0.0,1.0,43,1150,800,350,0.6956521739130435,15,8,7,356.1342677069069,0.43835363602805466,0.22722435488131,0.20351491328506227,130377.57087746523,686.384145970283,131063.95502343551,2035,1,285.09302325581393,36,7,21,35.586200242584624,0.6241319444444444,44.67905405405405,1021.2837837837833,28.368993993993982,0
4634,4,0,0,43,0.0,0.0,1.0,43,850,600,250,0.7058823529411765,11,6,5,355.1384300441692,0.43837670727205613,0.2243695087590658,0.20324673179373232,130435.08193582091,664.5020442739967,131099.5839800949,2036,2,286.09302325581393,36,7,21,35.55332010436189,0.6247106481481481,44.622747747747745,1021.5090090090087,28.37525025025024,0
4635,4,0,2,41,0.0,0.046511627906976744,0.9534883720930233,43,1200,900,300,0.75,15,9,6,355.9047644355777,0.4376614987080103,0.2211327021748828,0.20413905388675263,130521.3723013552,690.6356525444146,131212.00795389962,2037,3,287.09302325581393,36,7,18,35.446284255381684,0.6255787037037037,44.53828828828828,1021.8468468468451,28.384634634634587,0
4636,4,1,1,41,0.023809523809523808,0.023809523809523808,0.9761904761904762,42,1200,700,500,0.5833333333333334,17,7,10,359.256847283693,0.43491095625241966,0.22010474250800094,0.2075236611956391,130794.81336805547,997.7864583333221,131792.5998263888,2038,0,288.5,37,5,19,35.08358791581804,0.6264076576576576,44.27083333333333,1022.916666666666,27.646396396396376,0
4637,4,1,2,40,0.023809523809523808,0.047619047619047616,0.9523809523809523,42,900,500,400,0.5555555555555556,13,5,8,363.49766740393363,0.4368466898954704,0.11798190332728709,0.20474832247588867,129815.23762119134,1064.633949869211,130879.87157106055,2039,0,286.07142857142856,37,5,15,35.969442651172805,0.6165540540540541,45.23026315789475,1019.0789473684226,27.542674253200612,8
4638,4,0,0,40,0.0,0.0,1.0,40,1300,700,600,0.5384615384615384,19,7,12,374.78111328934193,0.43194444444444446,0.14244661517492108,0.21097013563934564,129790.40745027438,1728.5986796982238,131519.0061299726,2040,1,300.975,35,5,15,35.707254278358334,0.6202380952380953,45.25462962962963,1018.9814814814816,29.113756613756617,0
4639,4,1,0,41,0.024390243902439025,0.0,1.0,41,1050,800,250,0.7619047619047619,13,8,5,364.669470146582,0.43325711382113824,0.14662137793304653,0.20731711031796315,130176.38204082494,1294.270452885358,131470.6524937103,2041,0,294.609756097561,36,5,16,35.57253733539323,0.6221064814814814,44.876126126126145,1020.4954954954982,28.347097097097173,0
4640,4,0,0,41,0.0,0.0,1.0,41,1950,1400,550,0.717948717948718,25,14,11,363.8855774495688,0.43124999999999997,0.14351376487095302,0.2087166706559662,130521.37230135534,1298.9689858777645,131820.3412872331,2042,1,295.609756097561,36,5,14,35.24240504004115,0.6255787037037037,44.538288288288285,1021.8468468468463,28.384634634634622,0
4641,4,0,1,40,0.0,0.024390243902439025,0.975609756097561,41,800,600,200,0.75,10,6,4,366.7387491624386,0.4311229674796748,0.14536896993598258,0.2111364047968152,130665.25298524859,1384.002287760718,132049.2552730093,2043,2,296.609756097561,36,5,14,35.023589235231505,0.627025462962963,44.397522522522515,1022.4099099099085,28.400275275275234,0
4642,4,0,2,38,0.0,0.05,0.95,40,950,500,450,0.5263157894736842,14,5,9,375.74580576559583,0.4297943376068376,0.154144021739131,0.21605383831521738,130617.28395061711,1815.7793209876363,132433.06327160474,2044,3,304.8,35,5,15,34.84205163043478,0.6285714285714286,44.444444444444436,1022.2222222222208,29.206349206349167,0
4643,4,1,0,39,0.02564102564102564,0.0,1.0,39,1350,1200,150,0.8888888888888888,15,12,3,383.5601572402973,0.42664754835807467,0.15871935215128463,0.22060489418770446,130627.42524092946,2220.695153061197,132848.12039399066,2045,0,313.0,34,5,16,34.63205038624279,0.6308210784313726,44.434523809523796,1022.2619047619028,30.0665266106442,0
4644,4,1,0,40,0.025,0.0,1.0,40,1250,900,350,0.72,16,9,7,375.7762317068905,0.4276575854700855,0.16244911804613293,0.21806856910864422,130972.4633487653,1843.2677469135629,132815.73109567887,2046,0,306.15,35,5,17,34.481004070556295,0.6321428571428571,44.097222222222214,1023.6111111111102,29.24603174603172,0
4645,4,0,0,40,0.0,0.0,1.0,40,950,600,350,0.631578947368421,13,6,7,375.11519678253404,0.4280715811965812,0.15642372881355926,0.2186936423929789,131150.23389274662,1839.289158950579,132989.5230516972,2047,1,307.15,35,5,18,34.317796610169474,0.6339285714285714,43.92361111111109,1024.3055555555532,29.26587301587295,0
4646,4,0,0,40,0.0,0.0,1.0,40,900,500,400,0.5555555555555556,13,5,8,373.16395698837414,0.4275641025641026,0.14881974248927077,0.21822943693362348,131268.8145683297,1796.958054698194,133065.77262302788,2048,2,308.15,35,5,18,34.24770348618327,0.6351190476190476,43.80787037037036,1024.7685185185169,29.279100529100482,0
4647,4,1,1,40,0.024390243902439025,0.024390243902439025,0.975609756097561,41,1500,1200,300,0.8,18,12,6,365.19522500373466,0.42845528455284554,0.14475193122660746,0.21607181124470484,131713.96933138304,1420.2759291409666,133134.245260524,2049,0,301.609756097561,35,6,14,34.00197786296839,0.6395833333333334,43.3738425925926,1026.504629629631,29.32870370370374,0
4648,4,1,1,40,0.024390243902439025,0.024390243902439025,0.975609756097561,41,1550,1100,450,0.7096774193548387,20,11,9,364.73666113197396,0.42827743902439025,0.14580670691600583,0.21689229614379843,131905.89871966562,1422.1834165246357,133328.08213619026,2050,0,302.5853658536585,36,5,16,33.82002302126727,0.6394675925925926,43.18693693693694,1027.2522522522524,28.53478478478479,0
4649,4,0,1,39,0.0,0.025,0.975,40,1050,700,350,0.6666666666666666,14,7,7,369.47883575728065,0.4265758547008547,0.14217763751127133,0.2191187320079274,131803.0907064472,1739.690500685873,133542.78120713308,2051,1,311.025,35,5,16,33.8020363691013,0.6404761904761904,43.28703703703704,1026.851851851852,29.338624338624342,0
4650,4,0,1,38,0.0,0.02564102564102564,0.9743589743589743,39,700,500,200,0.7142857142857143,9,5,4,391.5344908440212,0.42524179037336934,0.09914808610511416,0.2251913377680913,130627.42524092946,2494.400571442542,133121.825812372,2052,2,319.1794871794872,34,5,19,34.428253949769044,0.6308210784313726,44.434523809523796,1022.2619047619028,30.0665266106442,8
4651,4,2,0,40,0.05,0.0,1.0,40,1150,800,350,0.6956521739130435,15,8,7,379.781470418096,0.42604166666666665,0.11754405784003641,0.22175630449478795,131209.51753257884,1966.1887002743474,133175.7062328532,2053,0,312.1,35,5,22,34.13823618014762,0.6345238095238095,43.86574074074074,1024.537037037037,29.27248677248677,0
4652,4,0,1,39,0.0,0.025,0.975,40,1150,900,250,0.782608695652174,14,9,5,378.081829598784,0.4253605769230769,0.11260162601626056,0.221447928765002,131328.12499999997,1930.5555555555547,133258.68055555553,2054,1,313.1,35,5,22,34.06165311653117,0.6357142857142857,43.75,1024.9999999999998,29.285714285714278,0
4653,4,0,0,39,0.0,0.0,1.0,39,1050,800,250,0.7619047619047619,13,8,5,382.26123031101866,0.42546671165092215,0.12167209845677673,0.22479047775627484,131480.69905045358,2251.994756235838,133732.6938066894,2055,2,318.1025641025641,34,5,23,33.800058038305295,0.6393995098039216,43.60119047619048,1025.5952380952385,30.164565826330545,0
4654,4,0,1,38,0.0,0.02564102564102564,0.9743589743589743,39,700,400,300,0.5714285714285714,10,4,6,395.2211190624954,0.4255229419703104,0.09326570865032435,0.2330134654078316,131579.47063629364,2706.181026332094,134285.65166262572,2056,3,319.1025641025641,33,6,17,33.36767399267399,0.6426767676767677,43.50490196078431,1025.980392156862,31.090314913844306,8
4655,4,0,0,38,0.0,0.0,1.0,38,800,400,400,0.5,12,4,8,402.35732071005924,0.42281590801327645,0.10035627530364355,0.2370669492943604,131554.70623214453,2986.3998252729116,134541.10605741743,2057,4,328.42105263157896,32,6,17,33.20974358974359,0.6448567708333333,43.529040404040394,1025.8838383838372,32.05886994949491,0
4656,4,0,0,38,0.0,0.0,1.0,38,850,500,350,0.5882352941176471,12,5,7,401.3650409385556,0.4226677335229967,0.10222261079054196,0.23688407318138271,131619.47959710742,2965.4915633608725,134584.9711604683,2058,5,329.42105263157896,32,6,18,33.169527500922854,0.6455078125,43.465909090909086,1026.1363636363633,32.06676136363635,0
4657,4,0,0,38,0.0,0.0,1.0,38,1100,800,300,0.7272727272727273,14,8,6,401.3432810181442,0.42203058321479375,0.09524425919693491,0.23788072603786786,131781.48275686143,2977.9225334149455,134759.40529027637,2059,6,330.42105263157896,32,6,18,33.00592310214789,0.6471354166666667,43.3080808080808,1026.767676767676,32.086489898989875,0
4658,4,0,0,38,0.0,0.0,1.0,38,1200,800,400,0.6666666666666666,16,8,8,403.08613309629294,0.4218972261735419,0.09414859539109677,0.23911739755449685,131813.89534550055,3026.470672635454,134840.366018136,2060,7,331.42105263157896,32,6,18,32.928347473257105,0.6474609375,43.276515151515156,1026.89393939394,32.09043560606062,0
4659,4,0,1,37,0.0,0.02631578947368421,0.9736842105263158,38,1250,1000,250,0.8,15,10,5,405.0119097695425,0.4219120436225699,0.08656688421311376,0.24108133941439389,131943.58555568295,3087.744713549625,135031.33026923257,2061,8,332.42105263157896,32,6,18,32.74753185039531,0.6487630208333333,43.15025252525252,1027.398989898989,32.106218434343404,0
4660,4,1,0,38,0.02631578947368421,0.0,1.0,38,1400,1000,400,0.7142857142857143,18,10,8,405.24220232956156,0.42146752015173067,0.08682548344404117,0.24271144323678423,132177.37956855522,3112.7704789023287,135290.15004745754,2062,0,333.1842105263158,33,5,20,32.50494080959759,0.6486742424242424,42.92279411764705,1028.3088235294106,31.16087344028517,0
4661,4,0,2,36,0.0,0.05263157894736842,0.9473684210526316,38,1100,800,300,0.7272727272727273,14,8,6,408.34025682510514,0.4209785443338075,0.009379509379509487,0.2300648764063399,129825.09731833919,3091.7787029027413,132916.87602124194,2063,1,334.1842105263158,33,5,17,34.8169191919192,0.625,45.22058823529412,1019.1176470588242,30.882352941176492,8
4662,4,0,0,36,0.0,0.0,1.0,36,1200,1000,200,0.8333333333333334,14,10,4,408.1996302593381,0.414781746031746,0.005752346351801663,0.23047579123873402,129908.3719135803,3405.709876543218,133314.0817901235,1481,18,296.4166666666667,32,4,17,34.73546775658493,0.6282552083333333,45.13888888888889,1019.4444444444448,31.8576388888889,0
4663,4,0,0,36,0.0,0.0,1.0,36,1000,500,500,0.5,15,5,10,406.813343582968,0.41504629629629625,0.000880986705110054,0.23067535912701784,130075.00120146085,3383.249231064961,133458.25043252582,1482,19,297.4166666666667,33,3,17,34.600752843184374,0.6275252525252526,44.975490196078425,1020.0980392156853,30.912061794414704,0
4664,4,0,1,35,0.0,0.027777777777777776,0.9722222222222222,36,1250,900,350,0.72,16,9,7,407.253766642731,0.4146825396825397,0.0037775704325742065,0.23185881774201694,130232.20663265302,3407.511337868476,133639.71797052148,1483,20,298.4166666666667,34,2,17,34.429185133348895,0.6268382352941176,44.82142857142857,1020.7142857142853,30.021008403361332,0
4665,4,0,0,35,0.0,0.0,1.0,35,1600,1200,400,0.75,20,12,8,409.82273140056924,0.4128151260504202,0.013100390397286832,0.23389106766664816,130327.04132550255,3682.200353358369,134009.2416788609,1484,21,305.0571428571429,32,3,17,34.266930464531555,0.6324869791666667,44.72853535353536,1021.085858585859,31.908933080808094,0
4666,4,0,0,35,0.0,0.0,1.0,35,1250,1000,250,0.8,15,10,5,410.68304103118464,0.41397058823529415,0.018306054346098888,0.23516181776244263,130455.99819214875,3715.2132116620737,134171.21140381083,1485,22,306.0571428571429,32,3,18,34.11352119639105,0.6337890625,44.60227272727273,1021.590909090909,31.924715909090907,0
4667,4,0,0,35,0.0,0.0,1.0,35,1450,1100,350,0.7586206896551724,18,11,7,411.4526660656891,0.41295518207282916,0.013548318808876969,0.2369803477809353,130681.82615294354,3753.8771553922998,134435.70330833585,1486,23,307.0571428571429,32,3,15,33.86381411047995,0.6360677083333333,44.38131313131313,1022.4747474747472,31.95233585858585,0
4668,4,0,0,35,0.0,0.0,1.0,35,700,300,400,0.42857142857142855,11,3,8,412.8480730230415,0.4125700280112045,0.012695278061854331,0.23858024876124698,130810.95838434855,3801.0104198551176,134611.96880420367,1487,24,308.0571428571429,32,3,16,33.69666954661399,0.6373697916666667,44.255050505050505,1022.9797979797981,31.968118686868692,0
4669,4,1,0,36,0.027777777777777776,0.0,1.0,36,1200,900,300,0.75,15,9,6,400.55689708183985,0.4146825396825397,0.020767165026984058,0.23386653027722615,131206.1295351474,3311.104024943312,134517.2335600907,1488,0,300.47222222222223,34,2,18,33.609545665814565,0.6366421568627452,43.86904761904762,1024.5238095238094,30.133053221288513,0
4670,4,0,0,36,0.0,0.0,1.0,36,1050,600,450,0.5714285714285714,15,6,9,402.3493047635224,0.4141865079365079,0.022591680350301013,0.2360604302514308,131392.84256708497,3373.2771502387263,134766.1197173237,1489,1,301.47222222222223,32,4,19,33.37412766830871,0.6432291666666667,43.686868686868685,1025.2525252525252,32.03914141414141,0
4671,4,0,0,36,0.0,0.0,1.0,36,700,600,100,0.8571428571428571,8,6,2,402.31905340530295,0.41397156084656084,0.024296578986964468,0.23664284365034596,131489.9488094327,3380.1823474645444,134870.13115689726,1490,2,302.47222222222223,32,4,19,33.27639624112602,0.6442057291666667,43.592171717171716,1025.6313131313132,32.050978535353536,0
4672,4,0,0,36,0.0,0.0,1.0,36,1200,700,500,0.5833333333333334,17,7,10,401.3650409385554,0.4138392857142857,0.014611787867601755,0.2368840731813829,131619.4795971076,3365.491563360901,134984.9711604685,1491,3,303.47222222222223,32,4,15,33.169527500922854,0.6455078125,43.4659090909091,1026.1363636363649,32.0667613636364,0
4673,4,0,0,36,0.0,0.0,1.0,36,950,700,250,0.7368421052631579,12,7,5,400.46023338462146,0.4138888888888889,0.009778597785978116,0.23695354420793133,131716.66953627198,3349.4576446281203,135066.1271809001,1492,4,304.47222222222223,32,4,15,33.09424969249692,0.646484375,43.37121212121213,1026.5151515151529,32.07859848484853,0
4674,4,0,0,36,0.0,0.0,1.0,36,650,300,350,0.46153846153846156,10,3,7,402.09831361798894,0.413640873015873,0.01419115537522031,0.23853140661233482,131813.8953455008,3400.4290059688155,135214.3243514696,1493,5,305.47222222222223,32,4,15,32.95370711914422,0.6474609375,43.27651515151517,1026.893939393942,32.09043560606069,0
4675,4,0,1,35,0.0,0.027777777777777776,0.9722222222222222,36,800,400,400,0.5,12,4,8,401.5259161926831,0.4137896825396825,0.01656285003961444,0.2383950220665174,131846.31191970228,3387.942238036963,135234.25415773923,1494,6,306.47222222222223,32,4,15,32.935568805835594,0.6477864583333333,43.24494949494951,1027.0202020202037,32.094381313131365,0
4676,4,1,1,35,0.027777777777777776,0.027777777777777776,0.9722222222222222,36,750,500,250,0.6666666666666666,10,5,5,401.6672322726044,0.41484788359788355,0.023557849885283533,0.23888630129897026,131911.1570247936,3396.8778696051663,135308.03489439876,1495,0,307.27777777777777,32,4,16,32.86627335299902,0.6484375,43.181818181818194,1027.2727272727288,32.102272727272776,0
4677,4,0,0,35,0.0,0.0,1.0,35,1150,1000,150,0.8695652173913043,13,10,3,400.78068409636364,0.4125700280112045,0.039567461292701056,0.23876670623544735,131976.0180721357,3578.6877614529344,135554.7058335886,1496,1,315.1714285714286,32,3,17,32.82338002785287,0.6490885416666667,43.11868686868688,1027.525252525254,32.11016414141419,0
4678,4,1,0,36,0.027777777777777776,0.0,1.0,36,800,600,200,0.75,10,6,4,395.52750888180344,0.4165509259259259,0.04392110939091998,0.23808204244304698,132366.4745080018,3270.9163843233428,135637.39089232514,1497,0,307.3888888888889,33,3,18,32.56358917867493,0.6505681818181819,42.7389705882353,1029.0441176470592,31.183155080213915,0
4679,4,1,0,37,0.02702702702702703,0.0,1.0,37,950,800,150,0.8421052631578947,11,8,3,384.4496707839944,0.41857482482482483,0.04768373225912215,0.23350258951827865,132704.4802295918,2803.6387471655307,135508.11897675734,1498,0,300.05405405405406,34,3,17,32.50770267668015,0.6516544117647058,42.410714285714285,1030.3571428571427,30.30462184873949,0
4680,4,0,0,37,0.0,0.0,1.0,37,400,100,300,0.25,7,1,6,384.4496707839944,0.418480980980981,0.04768373225912215,0.23350258951827865,132704.4802295918,2803.6387471655307,135508.11897675734,1499,1,301.05405405405406,34,3,17,32.50770267668015,0.6516544117647058,42.410714285714285,1030.3571428571427,30.30462184873949,0
4681,4,0,1,36,0.0,0.02702702702702703,0.972972972972973,37,1100,1000,100,0.9090909090909091,12,10,2,381.8424014208835,0.41882507507507505,0.04931028025716255,0.23287008424682046,132857.85147392284,2746.152210884349,135604.0036848072,1500,2,302.05405405405406,34,3,18,32.4203714395689,0.6531862745098039,42.26190476190476,1030.9523809523805,30.322128851540604,0
4682,4,0,0,36,0.0,0.0,1.0,36,1050,500,550,0.47619047619047616,16,5,11,393.3266540180241,0.4186177248677249,0.056625455698209315,0.2397582473622914,132839.80320069217,3249.8870626682224,136089.6902633604,1501,3,305.1666666666667,33,3,19,32.14257410049137,0.6553030303030303,42.27941176470589,1030.8823529411775,31.238859180035682,0
4683,4,1,1,36,0.02702702702702703,0.02702702702702703,0.972972972972973,37,1050,700,350,0.6666666666666666,14,7,7,385.4017311737989,0.42082707707707706,0.06070167999102005,0.23659080777723024,133103.42970521544,2859.658446712021,135963.08815192746,1502,0,297.8918918918919,34,3,20,32.08136248269498,0.6556372549019608,42.023809523809526,1031.9047619047622,30.350140056022415,0
4684,4,1,2,35,0.02702702702702703,0.05405405405405406,0.9459459459459459,37,1050,900,150,0.8571428571428571,12,9,3,382.8019234950934,0.42226601601601604,0.07465764519706442,0.23655195785209623,133349.23469387766,2809.2687074830055,136158.50340136068,1503,0,295.35135135135135,34,3,21,31.90122176118028,0.6580882352941176,41.78571428571429,1032.8571428571436,30.37815126050422,0
4685,4,0,0,35,0.0,0.0,1.0,35,1250,800,450,0.64,17,8,9,391.97524849533,0.4165966386554622,0.06123796712032026,0.2415359161225556,133243.9949526834,3445.669606417713,136689.6645591011,1504,1,295.2,32,3,21,31.77026007908362,0.6617838541666667,41.88762626262626,1032.449494949495,32.264046717171716,0
4686,4,0,0,35,0.0,0.0,1.0,35,950,500,450,0.5263157894736842,14,5,9,389.3379670813475,0.4161764705882353,0.06967755451196744,0.2411773341882411,133439.6063698857,3390.6210144373063,136830.22738432302,1505,2,296.2,32,3,21,31.641563811153205,0.6637369791666667,41.698232323232325,1033.2070707070707,32.28772095959596,0
4687,4,0,0,35,0.0,0.0,1.0,35,1150,900,250,0.782608695652174,14,9,5,391.49689134831675,0.41551120448179274,0.07069046746584329,0.24337016320946633,133570.093692608,3458.4552915518934,137028.5489841599,1506,3,297.2,32,3,21,31.4545926468792,0.6650390625,41.5719696969697,1033.712121212122,32.30350378787881,0
4688,4,0,0,35,0.0,0.0,1.0,35,950,600,350,0.631578947368421,13,6,7,393.1646230223619,0.41456582633053224,0.06663759875821906,0.2452712435016123,133700.6447843334,3513.272720895846,137213.91750522924,1507,4,298.2,32,3,18,31.28026695967118,0.6663411458333333,41.44570707070708,1034.217171717173,32.319286616161655,0
4689,4,0,0,35,0.0,0.0,1.0,35,650,400,250,0.6153846153846154,9,4,5,392.0140862464904,0.41456582633053224,0.06723632812500036,0.2447697709246382,133733.29252117145,3485.066893684342,137218.35941485577,1508,5,299.2,32,3,18,31.277211507161464,0.6666666666666667,41.414141414141426,1034.3434343434355,32.32323232323236,0
4690,4,0,0,35,0.0,0.0,1.0,35,500,400,100,0.8,6,4,2,390.23919010455506,0.41439075630252103,0.06716875116353882,0.2438200594872355,133757.3007527154,3439.4681432622197,137196.76889597764,1509,6,300.2,33,2,18,31.29899202306204,0.6644570707070707,41.390931372549026,1034.4362745098047,31.346553773024382,0
4691,4,0,0,35,0.0,0.0,1.0,35,1100,800,300,0.7272727272727273,14,8,6,391.0014333683525,0.4140056022408964,0.0665820857650341,0.24513786969530327,133884.09994052767,3469.7749963956103,137353.87493692327,1510,7,301.2,33,2,18,31.151939017169905,0.665719696969697,41.268382352941174,1034.9264705882351,31.36140819964349,0
4692,4,0,0,35,0.0,0.0,1.0,35,1100,800,300,0.7272727272727273,14,8,6,389.3380403143207,0.413515406162465,0.06415636677206105,0.24493798232432584,134010.9592013889,3435.1128472222267,137446.07204861112,1511,8,302.2,33,2,18,31.06765593561369,0.6669823232323233,41.145833333333336,1035.4166666666667,31.37626262626263,0
4693,4,0,0,35,0.0,0.0,1.0,35,900,500,400,0.5555555555555556,13,5,8,390.55284151711083,0.41313025210084037,0.06535828388863552,0.2461269249560855,134074.41135921294,3472.628466214934,137547.03982542787,1512,9,303.2,33,2,19,30.972542697116715,0.6676136363636364,41.08455882352942,1035.6617647058833,31.383689839572224,0
4694,4,0,0,35,0.0,0.0,1.0,35,1000,700,300,0.7,13,7,6,397.28212061271466,0.41278011204481796,0.09058982748873712,0.2280065797515087,130544.21864487189,3372.5768033928957,133916.79544826478,1513,10,304.2,33,2,12,34.36600611584124,0.632260101010101,44.515931372549005,1021.9362745098017,30.967765894236415,8
4695,4,0,1,34,0.0,0.02857142857142857,0.9714285714285714,35,600,400,200,0.6666666666666666,8,4,4,399.9628446832461,0.41260504201680676,0.09100935027571344,0.2301027620929406,130638.16350682428,3450.0823000768896,134088.24580690116,1514,11,305.2,33,2,12,34.20192999280748,0.6332070707070707,44.424019607843135,1022.3039215686273,30.97890671420083,0
4696,4,0,0,34,0.0,0.0,1.0,34,800,500,300,0.625,11,5,6,406.91970267129363,0.4119132501485443,0.09415468866889887,0.2345653147284561,130714.10323245075,3838.028804458727,134552.1320369095,1515,12,310.52941176470586,32,2,13,33.94683500020579,0.6363932291666667,44.349747474747474,1022.6010101010099,31.95628156565656,0
4697,4,1,1,34,0.02857142857142857,0.02857142857142857,0.9714285714285714,35,1200,1100,100,0.9166666666666666,13,11,2,401.94265696326494,0.4160014005602241,0.10799538892999072,0.22413229555177888,129419.51600646383,3403.844825307572,132823.3608317714,1516,0,302.62857142857143,33,2,20,35.3942099241238,0.6208964646464646,45.618872549019606,1017.5245098039214,30.834076054664287,8
4698,4,0,1,33,0.0,0.029411764705882353,0.9705882352941176,34,1000,600,400,0.6,14,6,8,410.5926374810178,0.4143085264408794,0.1204502649905832,0.22880743242199453,129394.0111340679,3825.6456611570197,133219.65679522493,1517,1,310.44117647058823,32,2,20,35.20026681558699,0.623046875,45.64393939393939,1017.4242424242419,31.79450757575756,0
4699,4,0,2,31,0.0,0.06060606060606061,0.9393939393939394,33,1050,900,150,0.8571428571428571,12,9,3,414.12743915697,0.4119318181818182,0.13653814831188815,0.23081253991245093,129400.03289116746,4117.620849609366,133517.65374077682,1518,2,320.3939393939394,31,2,20,35.10419332821432,0.6256720430107527,45.63802083333333,1017.447916666666,32.82090053763439,0
4700,4,0,0,31,0.0,0.0,1.0,31,1000,700,300,0.7,13,7,6,419.3348361352359,0.4091397849462366,0.12409832084226302,0.23395608285776498,129440.63484579138,4655.79348046016,134096.42832625154,1519,3,325.8709677419355,30,1,17,34.93016114119667,0.6288194444444444,45.59811827956989,1017.6075268817201,33.92025089605734,0
4701,4,0,0,31,0.0,0.0,1.0,31,1350,1200,150,0.8888888888888888,15,12,3,424.3834416364027,0.4084229390681004,0.1256330852817522,0.2371849301485222,129509.03148124056,4792.297700601213,134301.32918184178,1520,4,326.8709677419355,30,1,17,34.73166732690699,0.6295138888888889,45.53091397849462,1017.8763440860212,33.92921146953404,0
4702,4,0,0,31,0.0,0.0,1.0,31,950,500,450,0.5263157894736842,14,5,9,422.03083959418404,0.40770609318996415,0.12217518335221511,0.23607544897240368,129543.23657359215,4734.248178980206,134277.48475257235,1521,5,327.8709677419355,30,1,17,34.75651351113458,0.6298611111111111,45.49731182795698,1018.0107526881707,33.93369175627235,0
4703,4,1,0,32,0.03125,0.0,1.0,32,950,600,350,0.631578947368421,13,6,7,412.7422467348401,0.41137432795698925,0.12505189040746,0.2329746971656136,129897.31046888554,4322.821553548168,134220.1320224337,1522,0,318.59375,31,1,19,34.630992676799934,0.6307123655913979,45.14973958333333,1019.4010416666658,32.883904569892444,0
4704,4,0,0,32,0.0,0.0,1.0,32,950,600,350,0.631578947368421,13,6,7,417.31778560958674,0.41137432795698925,0.13061470438002853,0.23595780354575235,129963.68620130736,4447.231547037742,134410.9177483451,1523,1,319.59375,31,1,19,34.44656387008896,0.6313844086021505,45.08463541666666,1019.6614583333321,32.892305107526845,0
4705,4,0,0,32,0.0,0.0,1.0,32,1100,800,300,0.7272727272727273,14,8,6,417.5062967468374,0.4112903225806452,0.12596147708413152,0.23646614768025848,130030.07888793932,4457.675340440524,134487.75422837984,1524,2,320.59375,31,1,19,34.373936124941494,0.6320564516129032,45.01953124999999,1019.921874999999,32.90070564516126,0
4706,4,0,0,32,0.0,0.0,1.0,32,750,600,150,0.8,9,6,3,419.9868946674167,0.41120631720430106,0.1282027760051052,0.23827641706873331,130096.48852878131,4527.764044867599,134624.2525736489,1525,3,321.59375,31,1,19,34.242847266539016,0.632728494623656,44.95442708333332,1020.1822916666654,32.90910618279566,0
4707,4,1,0,33,0.030303030303030304,0.0,1.0,33,800,700,100,0.875,9,7,2,386.61244817155415,0.41658775252525254,0.0872745388874423,0.2104482268725025,128464.33280086236,3376.419515602955,131840.7523164653,1526,0,312.8181818181818,32,1,16,36.761012164237975,0.6136067708333333,46.55934343434345,1013.7626262626279,31.680082070707122,8
4708,4,1,0,34,0.029411764705882353,0.0,1.0,34,1150,600,550,0.5217391304347826,17,6,11,382.3433118804028,0.4201945929887106,0.10017029731072169,0.2110270343201426,129014.56921616694,3065.5715349865545,132080.1407511535,1527,0,304.5882352941176,33,1,17,36.3062927221552,0.6167929292929293,46.017156862745104,1015.9313725490204,30.78579916815213,0
4709,4,0,1,33,0.0,0.029411764705882353,0.9705882352941176,34,950,600,350,0.631578947368421,13,6,7,385.29219945201817,0.42028743315508016,0.09472396553558138,0.2134935734438537,129170.24289035461,3153.657397395223,132323.90028774983,1528,1,305.5882352941176,33,1,18,36.07230761502914,0.6183712121212122,45.86397058823529,1016.5441176470583,30.80436720142601,0
4710,4,0,0,33,0.0,0.0,1.0,33,1300,1200,100,0.9230769230769231,14,12,2,394.71916151572174,0.4163510101010101,0.1033283656234476,0.21888971684053643,129201.38888888879,3599.6527777777674,132801.04166666657,1529,2,315.6666666666667,32,1,19,35.800887978142086,0.62109375,45.83333333333333,1016.6666666666658,31.770833333333307,0
4711,4,0,0,33,0.0,0.0,1.0,33,900,600,300,0.6666666666666666,12,6,6,393.1421199920933,0.4161931818181818,0.10202584504260459,0.21854794869125685,129297.68207644625,3566.4729683195505,132864.1550447658,1530,3,316.6666666666667,32,1,20,35.742551210428296,0.6220703125,45.73863636363636,1017.0454545454543,31.782670454545446,0
4712,4,0,0,33,0.0,0.0,1.0,33,650,600,50,0.9230769230769231,7,6,1,391.8084948900813,0.41575915404040403,0.10270989868905,0.21833975462131894,129394.0111340678,3539.5345500458925,132933.5456841137,1531,4,317.6666666666667,32,1,20,35.6780528667163,0.623046875,45.643939393939384,1017.4242424242411,31.794507575757535,0
4713,4,0,0,33,0.0,0.0,1.0,33,1150,700,450,0.6086956521739131,16,7,9,389.52705822953175,0.4156407828282828,0.10225580870742168,0.21742299787604036,129458.25043362903,3485.4982909906903,132943.7487246197,1532,5,318.6666666666667,32,1,16,35.670492142266326,0.6236979166666667,45.58080808080807,1017.6767676767662,31.802398989898943,0
4714,4,0,0,33,0.0,0.0,1.0,33,1250,800,450,0.64,17,8,9,390.60143518191336,0.4154040404040404,0.10575070151120736,0.21927500192153757,129683.21352731864,3530.889864554636,133214.10339187327,1533,6,319.6666666666667,32,1,17,35.413567621172675,0.6259765625,45.359848484848484,1018.5606060606061,31.83001893939394,0
4715,4,0,0,33,0.0,0.0,1.0,33,700,400,300,0.5714285714285714,10,4,6,393.32423318196606,0.41524621212121215,0.1048422522837098,0.22152965010548817,129811.85154894902,3611.62939368431,133423.48094263332,1534,7,320.6666666666667,32,1,17,35.21300541031677,0.6272786458333333,45.233585858585855,1019.065656565656,31.84580176767675,0
4716,4,0,0,33,0.0,0.0,1.0,33,650,400,250,0.6153846153846154,9,4,5,393.72726728030483,0.4149700126262626,0.10721686638435912,0.2219390015004623,129844.02101826342,3624.6263136414636,133468.64733190488,1535,8,321.6666666666667,32,1,17,35.16992897258011,0.6276041666666667,45.2020202020202,1019.191919191919,31.84974747474747,0
4717,4,0,1,32,0.0,0.030303030303030304,0.9696969696969697,33,1300,1100,200,0.8461538461538461,15,11,4,388.57196095234735,0.41418087121212116,0.1015003320314698,0.2199366312972746,130004.92814827566,3503.2539728088936,133508.18212108457,1536,9,322.6666666666667,32,1,18,35.137324088976925,0.6292317708333333,45.04419191919192,1019.8232323232321,31.869476010101003,0
4718,4,1,0,33,0.030303030303030304,0.0,1.0,33,700,300,400,0.42857142857142855,11,3,8,379.53492920344485,0.41698232323232326,0.10807955950106707,0.21714551465741647,130423.75299714314,3300.0739720436627,133723.8269691868,1537,0,317.09090909090907,32,1,20,34.941800576843825,0.6334635416666667,44.63383838383838,1021.4646464646464,31.9207702020202,0
4719,4,0,0,33,0.0,0.0,1.0,33,600,300,300,0.5,9,3,6,382.2666864425396,0.4166666666666667,0.10910888419538955,0.2190723814938407,130488.24737271709,3376.261988572599,133864.50936128967,1538,1,318.09090909090907,32,1,17,34.806496127862914,0.6341145833333333,44.57070707070707,1021.7171717171718,31.92866161616162,0
4720,4,0,0,33,0.0,0.0,1.0,33,1100,900,200,0.8181818181818182,13,9,4,383.8862426263698,0.41714015151515155,0.10601944363366922,0.22110318583131883,130681.82615294353,3433.3910442811894,134115.2171972247,1539,2,319.09090909090907,32,1,18,34.568463406602454,0.6360677083333333,44.38131313131313,1022.4747474747471,31.952335858585847,0
4721,4,0,0,33,0.0,0.0,1.0,33,1050,900,150,0.8571428571428571,12,9,3,386.1822828917649,0.4166272095959596,0.10258538500364511,0.22373176574966075,130907.8494063105,3510.858426436066,134418.70783274656,1540,3,320.09090909090907,32,1,19,34.28027966275961,0.6383463541666667,44.16035353535353,1023.3585858585852,31.97995580808079,0
4722,4,0,1,32,0.0,0.030303030303030304,0.9696969696969697,33,1050,800,250,0.7619047619047619,13,8,5,387.9551316234291,0.4166272095959596,0.10153832354128345,0.22532522974231822,131004.77629833684,3564.7950464238247,134569.57134476068,1541,4,321.09090909090907,32,1,20,34.1365523762539,0.6393229166666667,44.06565656565656,1023.7373737373732,31.991792929292913,0
4723,4,0,0,32,0.0,0.0,1.0,32,950,700,250,0.7368421052631579,12,7,5,395.8960518023075,0.4158686155913978,0.10322355035605257,0.23027563249802857,131061.33355034722,3977.3328993055525,135038.66644965278,1542,5,324.03125,31,1,20,33.875890132248216,0.6424731182795699,44.010416666666664,1023.9583333333333,33.030913978494624,0
4724,4,0,0,32,0.0,0.0,1.0,32,1050,700,350,0.6666666666666666,14,7,7,394.50888826801366,0.41574260752688175,0.10331405693950169,0.23026676060035084,131194.6953667534,3951.494683159714,135146.19004991313,1543,6,325.03125,31,1,21,33.776054905948136,0.6438172043010753,43.88020833333333,1024.479166666666,33.04771505376342,0
4725,4,0,0,32,0.0,0.0,1.0,32,1100,900,200,0.8181818181818182,13,9,4,395.5978584176087,0.4154905913978495,0.10594512195121952,0.23170731707317074,131328.125,3990.625000000001,135318.75,1544,7,326.03125,31,1,21,33.61280487804877,0.6451612903225806,43.75,1025.0,33.064516129032256,0
4726,4,0,0,32,0.0,0.0,1.0,32,900,500,400,0.5555555555555556,13,5,8,427.49239263971606,0.4148395497311828,0.09494929169349686,0.22877177318038536,127782.23885430214,4542.548116048159,132324.7869703503,1545,8,327.03125,31,1,17,36.4274790727624,0.6092069892473118,47.23307291666666,1011.067708333332,32.61508736559136,8
4727,4,1,0,33,0.030303030303030304,0.0,1.0,33,1100,800,300,0.7272727272727273,14,8,6,416.96675040490345,0.41729797979797983,0.09466141419336771,0.22534749255725736,128177.4923536512,4089.6633572048563,132267.15571085605,1546,0,318.09090909090907,31,2,18,36.28661973340192,0.613239247311828,46.842447916666664,1012.6302083333329,32.665490591397834,0
4728,4,1,0,34,0.029411764705882353,0.0,1.0,34,800,500,300,0.625,11,5,6,417.62363555357535,0.42000891265597146,0.11953467954345931,0.2293506850990946,128816.5748393021,3959.3692607897133,132775.94410009182,1547,0,309.70588235294116,32,2,15,35.61333955223879,0.6171875,46.21212121212121,1015.1515151515151,31.723484848484848,0
4729,4,1,0,35,0.02857142857142857,0.0,1.0,35,1050,900,150,0.8571428571428571,12,9,3,410.8438591776406,0.4226190476190476,0.12131147540983611,0.22783159463487326,129201.38888888882,3616.319444444434,132817.70833333326,1548,0,301.8285714285714,33,2,16,35.39105191256831,0.6186868686868687,45.83333333333333,1016.6666666666661,30.80808080808079,0
4730,4,1,1,35,0.027777777777777776,0.027777777777777776,0.9722222222222222,36,1100,700,400,0.6363636363636364,15,7,8,395.72685852046715,0.42683531746031744,0.11471367871204152,0.22131199262318593,129534.44054705212,3052.051445578228,132586.49199263036,1549,0,294.4166666666667,34,2,15,35.434939383308006,0.6197916666666667,45.50595238095238,1017.9761904761901,29.94047619047618,0
4731,4,0,0,35,0.0,0.0,1.0,35,1050,700,350,0.6666666666666666,14,7,7,405.8260457620935,0.4208683473389356,0.13054442246495257,0.22665671217580247,129481.87183114649,3509.4232086216634,132991.29503976816,1550,2,303.8285714285714,33,2,15,35.23166265302026,0.6215277777777778,45.55759803921568,1017.7696078431359,30.841503267973813,0
4732,4,0,0,35,0.0,0.0,1.0,35,850,400,450,0.47058823529411764,13,4,9,408.43658717538744,0.4202731092436975,0.13077042105806158,0.2288401620256435,129606.62853529885,3587.217806853123,133193.84634215198,1551,3,304.8285714285714,33,2,15,35.03768504031772,0.622790404040404,45.43504901960784,1018.259803921568,30.856357694592973,0
4733,4,0,0,35,0.0,0.0,1.0,35,650,400,250,0.6153846153846154,9,4,5,407.69123527935074,0.42023809523809524,0.1304138594802695,0.22896821267851097,129700.23548635132,3575.529844290644,133275.76533064197,1552,4,305.8285714285714,33,2,15,34.96100016041065,0.6237373737373737,45.343137254901954,1018.6274509803915,30.86749851455732,0
4734,4,0,0,35,0.0,0.0,1.0,35,1300,1000,300,0.7692307692307693,16,10,6,409.19651615996554,0.41999299719887956,0.1323941242161326,0.23036350926676463,129793.87622849384,3622.2403943194904,133416.11662281334,1553,5,306.8285714285714,33,2,15,34.826994387652825,0.6246843434343434,45.25122549019608,1018.9950980392156,30.878639334521683,0
4735,4,0,2,33,0.0,0.05714285714285714,0.9428571428571428,35,1150,1100,50,0.9565217391304348,12,11,1,414.34923955122565,0.4197478991596639,0.1392659731520587,0.2345724062275717,130012.50270328732,3774.1163254517687,133786.61902873908,1554,6,307.8285714285714,33,2,15,34.47238244011858,0.6268939393939394,45.03676470588236,1019.8529411764716,30.9046345811052,0
4736,4,0,0,33,0.0,0.0,1.0,33,850,400,450,0.47058823529411764,13,4,9,435.86596824269105,0.41524621212121215,0.15518155878447182,0.24561000240716657,129830.95169067384,4717.778693305122,134548.73038397895,1555,7,326.72727272727275,31,2,16,34.10962586772283,0.6300403225806452,45.21484375,1019.1406250000001,32.87550403225807,0
4737,4,1,0,34,0.029411764705882353,0.0,1.0,34,800,500,300,0.625,11,5,6,422.224328996837,0.41824494949494945,0.14801968306193936,0.239774757738822,130133.72559241395,4189.124993623089,134322.85058603704,1556,0,318.0882352941176,32,2,17,34.147743678587645,0.6305338541666667,44.91792929292929,1020.328282828282,31.885258838383812,0
4738,4,0,0,34,0.0,0.0,1.0,34,1000,600,400,0.6,14,6,8,428.2356334014831,0.418560606060606,0.14537835911015407,0.2441969909509445,130294.81207274769,4359.376275380065,134654.18834812776,1557,1,319.0882352941176,32,2,17,33.82981902877401,0.6321614583333333,44.76010101010101,1020.9595959595961,31.904987373737377,0
4739,4,0,0,34,0.0,0.0,1.0,34,900,700,200,0.7777777777777778,11,7,4,422.79668928509756,0.41748366013071897,0.14825856176834118,0.24189711572252043,130423.75299714312,4228.546194265885,134652.299191409,1558,2,320.0882352941176,32,2,17,33.83704161516275,0.6334635416666667,44.63383838383838,1021.4646464646463,31.920770202020197,0
4740,4,0,1,33,0.0,0.029411764705882353,0.9705882352941176,34,700,200,500,0.2857142857142857,12,2,10,430.5003678973691,0.41720513963161027,0.15401386648061788,0.24712553033768103,130552.7576905417,4440.602043158848,134993.35973370055,1559,3,321.0882352941176,32,2,13,33.50861749444032,0.634765625,44.50757575757575,1021.9696969696962,31.936553030303006,0
4741,4,0,0,33,0.0,0.0,1.0,33,950,700,250,0.7368421052631579,12,7,5,434.9813171095696,0.415167297979798,0.13257093470997217,0.2508328388089984,130728.22570800781,4772.867160373264,135501.09286838106,1560,4,317.27272727272725,31,2,14,33.215028435616674,0.6391129032258065,44.3359375,1022.65625,32.988911290322584,0
4742,4,0,1,32,0.0,0.030303030303030304,0.9696969696969697,33,850,600,250,0.7058823529411765,11,6,5,436.3188312843381,0.41433869949494945,0.13491154384625204,0.25225585411339535,130828.11355590819,4816.553921169705,135644.6674770779,1561,5,318.27272727272725,31,2,14,33.07891582877265,0.6401209677419355,44.23828125,1023.0468749999999,33.00151209677419,0
4743,4,1,0,33,0.030303030303030304,0.0,1.0,33,750,500,250,0.6666666666666666,10,5,5,438.7714273196876,0.41473327020202017,0.14884022108646922,0.2547725968676058,130994.67807345913,4895.344373914921,135890.02244737404,1562,0,319.09090909090907,31,2,15,32.84628593233274,0.6418010752688172,44.07552083333333,1023.6979166666661,33.022513440860195,0
4744,4,0,0,33,0.0,0.0,1.0,33,850,700,150,0.8235294117647058,10,7,3,435.43942785879085,0.41398358585858586,0.14685373953108494,0.2537160399657222,131128.0059814453,4819.660780164931,135947.66676161025,1563,1,320.09090909090907,31,2,17,32.795681837443865,0.6431451612903225,43.9453125,1024.21875,33.03931451612903,0
4745,4,0,0,33,0.0,0.0,1.0,33,1150,900,250,0.782608695652174,14,9,5,435.2006376694872,0.41433869949494945,0.14438230808337527,0.2540177015714783,131194.69536675356,4819.203016493061,136013.89838324662,1564,2,321.09090909090907,31,2,18,32.733858668022364,0.6438172043010753,43.880208333333336,1024.4791666666672,33.04771505376346,0
4746,4,0,1,32,0.0,0.030303030303030304,0.9696969696969697,33,1500,900,600,0.6,21,9,12,439.43439204057,0.41252367424242425,0.14780614679040283,0.2582824829635469,131461.62245008675,4953.7516276041615,136415.3740776909,1565,3,322.09090909090907,31,2,18,32.35356356864737,0.646505376344086,43.619791666666664,1025.520833333333,33.081317204301065,0
4747,4,0,0,32,0.0,0.0,1.0,32,1100,700,400,0.6363636363636364,15,7,8,442.74211290218136,0.40954721102150543,0.14787134713667927,0.2604907527799958,131500.3924767314,5244.152322522829,136744.54479925422,1566,4,331.0625,30,2,19,32.22928406062988,0.6496527777777779,43.581989247311824,1025.6720430107523,34.18906810035841,0
4748,4,0,0,32,0.0,0.0,1.0,32,800,500,300,0.625,11,5,6,442.74211290218136,0.40954721102150543,0.14787134713667927,0.2604907527799958,131500.3924767314,5244.152322522829,136744.54479925422,1567,5,332.0625,30,2,19,32.22928406062988,0.6496527777777779,43.581989247311824,1025.6720430107523,34.18906810035841,0
4749,4,0,0,32,0.0,0.0,1.0,32,1350,1000,350,0.7407407407407407,17,10,7,444.3639891256661,0.4095052083333333,0.14483055009823165,0.2623912650405614,131638.287753642,5299.062933576132,136937.35068721813,1568,6,333.0625,30,2,16,32.04731499672559,0.6510416666666667,43.44758064516129,1026.2096774193546,34.206989247311824,0
4750,4,1,0,33,0.030303030303030304,0.0,1.0,33,700,600,100,0.8571428571428571,8,6,2,430.6283671947085,0.41157670454545453,0.1422203793925576,0.256912297979428,132029.74319457996,4771.150546603719,136800.89374118368,1569,0,323.93939393939394,31,2,17,32.002116854596906,0.6522177419354839,43.06640624999999,1027.734374999999,33.152721774193516,0
4751,4,0,0,33,0.0,0.0,1.0,33,750,400,350,0.5333333333333333,11,4,7,437.4397807349063,0.411261047979798,0.1618121475154919,0.2479669495135492,130063.28158908398,4778.970675998231,134842.2522650822,1570,1,324.93939393939394,31,2,17,33.83169517487872,0.6323924731182795,44.98697916666665,1020.0520833333316,32.90490591397844,8
4752,4,0,0,33,0.0,0.0,1.0,33,1050,500,550,0.47619047619047616,16,5,11,438.12889082863165,0.4105113636363636,0.1718860315674846,0.25007251567431366,130331.20022907265,4820.5254272362035,135151.72565630884,1571,2,325.93939393939394,30,3,17,33.54010354964677,0.6378472222222222,44.72446236559139,1021.1021505376339,34.03673835125446,0
4753,4,1,0,34,0.029411764705882353,0.0,1.0,34,950,800,150,0.8421052631578947,11,8,3,426.8538494319916,0.4123960190136661,0.18429993248687881,0.24688056687704685,130843.25140610646,4370.189106978872,135213.44051308534,1572,0,317.3235294117647,32,2,17,33.30556583981241,0.6376953125,44.223484848484844,1023.10606060606,31.972064393939377,0
4754,4,0,0,34,0.0,0.0,1.0,34,650,400,250,0.6153846153846154,9,4,5,428.6596380343864,0.41208036244800955,0.18402490529890736,0.2485490004225133,130940.1543847566,4425.751836547284,135365.90622130389,1573,1,318.3235294117647,32,2,17,33.160621761658035,0.638671875,44.128787878787875,1023.484848484848,31.9839015151515,0
4755,4,0,0,34,0.0,0.0,1.0,34,1150,900,250,0.782608695652174,14,9,5,434.34009253163623,0.41152332144979203,0.1921157612243427,0.2526899677497537,131069.4141541678,4585.740294357704,135655.1544485255,1574,2,319.3235294117647,32,2,17,32.88352856555694,0.6399739583333333,44.002525252525245,1023.9898989898977,31.999684343434303,0
4756,4,0,0,34,0.0,0.0,1.0,34,550,400,150,0.7272727272727273,7,4,3,436.58180292606414,0.41070632798573975,0.1978197663880048,0.2546361011602558,131166.40082963466,4652.972751504937,135819.3735811396,1575,3,320.3235294117647,32,2,17,32.727310078474865,0.6409505208333333,43.90782828282828,1024.3686868686864,32.01152146464645,0
4757,4,2,1,35,0.05555555555555555,0.027777777777777776,0.9722222222222222,36,1050,800,250,0.7619047619047619,13,8,5,417.30985351785216,0.4145006613756614,0.19683173476429938,0.24809023620213502,131895.957522922,3808.595459899799,135704.5529828218,1576,0,303.47222222222223,31,5,18,32.47995626822159,0.6508736559139785,43.19661458333333,1027.2135416666658,33.13592069892471,0
4758,4,0,0,35,0.0,0.0,1.0,35,850,600,250,0.7058823529411765,11,6,5,425.5077620937383,0.4131652661064426,0.20758135826628998,0.2518545943203478,131728.82080078125,4210.3271484375,135939.14794921875,1577,1,313.14285714285717,31,4,18,32.43911719939118,0.6491935483870968,43.359375,1026.5625,33.11491935483871,0
4759,4,0,0,35,0.0,0.0,1.0,35,1200,700,500,0.5833333333333334,17,7,10,423.2459388796053,0.41320028011204485,0.20057244302742694,0.25095620105297484,131795.66277397994,4156.395806206586,135952.05858018654,1578,2,314.14285714285717,31,4,18,32.429305097641404,0.6498655913978495,43.29427083333333,1026.8229166666658,33.12331989247309,0
4760,4,0,0,35,0.0,0.0,1.0,35,900,500,400,0.5555555555555556,13,5,8,419.70285543318846,0.4128851540616247,0.19951883396259573,0.24939976106274542,131878.7324794663,4069.9761185083057,135948.70859797462,1579,3,315.14285714285717,32,3,18,32.4359762343782,0.6481119791666667,43.213383838383834,1027.146464646464,32.098327020202,0
4761,4,0,0,35,0.0,0.0,1.0,35,950,600,350,0.631578947368421,13,6,7,419.15673868702515,0.41278011204481796,0.20246141961761932,0.249500978982906,131943.58555568312,4061.0086024385287,136004.59415812165,1580,4,316.14285714285717,32,3,18,32.384222276842394,0.6487630208333333,43.150252525252526,1027.3989898989903,32.10621843434345,0
4762,4,0,1,34,0.0,0.02857142857142857,0.9714285714285714,35,1400,1200,200,0.8571428571428571,16,12,4,413.9004054956051,0.4115896358543418,0.1971660061029077,0.24827928594751092,132235.6216840118,3946.4754871951773,136182.097171207,1581,5,317.14285714285717,32,3,19,32.22338161879042,0.6516927083333333,42.86616161616161,1028.5353535353531,32.141729797979785,0
4763,4,0,0,34,0.0,0.0,1.0,34,1200,1000,200,0.8333333333333334,14,10,4,420.32431608862584,0.4108548722519311,0.18541551844845294,0.2518756789429414,132197.07065158425,4313.128662109381,136510.19931369362,1582,6,318.47058823529414,31,3,19,32.097260909935,0.6538978494623655,42.903645833333336,1028.385416666667,33.17372311827958,0
4764,4,0,0,34,0.0,0.0,1.0,34,700,400,300,0.5714285714285714,10,4,6,423.1583957618113,0.4109477124183007,0.18680324389535574,0.2537986460229725,132230.54885864258,4390.8933851454,136621.44224378798,1583,7,319.47058823529414,31,3,19,31.99046820272609,0.654233870967742,42.87109375,1028.515625,33.177923387096776,0
4765,4,0,0,34,0.0,0.0,1.0,34,1200,900,300,0.75,15,9,6,420.5887562419904,0.410650623885918,0.18314509704653958,0.2527050770393891,132297.51798841692,4328.5697089301275,136626.08769734704,1584,8,320.47058823529414,31,3,19,31.9886986879298,0.6549059139784946,42.805989583333336,1028.776041666667,33.18632392473119,0
4766,4,1,0,35,0.02857142857142857,0.0,1.0,35,950,600,350,0.631578947368421,13,6,7,408.9938365051904,0.4132352941176471,0.17298319327731093,0.24831768644957972,132690.54178145074,3853.9227502295503,136544.46453168028,1585,0,312.2857142857143,32,3,17,31.88955269607842,0.65625,42.424242424242415,1030.3030303030293,32.19696969696967,0
4767,4,0,0,35,0.0,0.0,1.0,35,900,800,100,0.8888888888888888,10,8,2,405.4021954078154,0.41285014005602244,0.17432560092369065,0.24742259549329004,132885.746671258,3774.434687786961,136660.18135904497,1586,1,313.2857142857143,32,3,17,31.78499265246142,0.658203125,42.234848484848484,1031.060606060606,32.22064393939394,0
4768,4,0,0,35,0.0,0.0,1.0,35,850,500,350,0.5882352941176471,12,5,7,407.22594177076473,0.4129201680672269,0.1736110382456324,0.24918567178467244,132983.40292125804,3830.8582988980734,136814.2612201561,1587,2,314.2857142857143,32,3,17,31.639429550740605,0.6591796875,42.140151515151516,1031.439393939394,32.23248106060606,0
4769,4,0,0,35,0.0,0.0,1.0,35,1100,1000,100,0.9090909090909091,12,10,2,420.08973831185915,0.413515406162465,0.1837006663249614,0.23217990919162548,129069.04432508688,3862.4816838484376,132931.52600893533,1588,3,315.2857142857143,31,4,14,35.2917307363745,0.6223118279569892,45.96354166666667,1016.145833333334,32.77889784946239,8
4770,4,4,1,38,0.10256410256410256,0.02564102564102564,0.9743589743589743,39,950,600,350,0.631578947368421,13,6,7,391.29092607426344,0.4231893837156995,0.2038733425356587,0.22416947447058289,130475.34722222229,2410.831705729173,132886.17892795146,1589,0,283.84615384615387,34,5,16,34.58911092985317,0.6292892156862745,44.583333333333336,1021.6666666666672,30.049019607843153,0
4771,4,2,1,39,0.05,0.025,0.975,40,600,300,300,0.5,9,3,6,383.9382075069237,0.4264690170940171,0.21593993892093621,0.22229192485715218,130883.62328800159,2050.2447434413607,132933.86803144295,1590,0,277.7,35,5,17,34.36227519511366,0.63125,44.18402777777778,1023.2638888888893,29.23611111111112,0
4772,4,1,0,40,0.025,0.0,1.0,40,1600,1200,400,0.75,20,12,8,387.0508552030122,0.4247996794871795,0.2298113846848877,0.22635061241528878,131268.81456832998,2161.541388031557,133430.35595636154,1591,0,278.65,35,5,18,33.89193208342745,0.6351190476190476,43.807870370370374,1024.7685185185192,29.279100529100546,0
4773,4,0,0,40,0.0,0.0,1.0,40,500,200,300,0.4,8,2,6,385.02214290435586,0.4250133547008547,0.22581300813008132,0.2255129694154084,131328.125,2112.8472222222217,133440.97222222222,1592,1,279.65,35,5,18,33.883807588075875,0.6357142857142857,43.75,1025.0,29.285714285714285,0
4774,4,1,1,40,0.024390243902439025,0.024390243902439025,0.975609756097561,41,1050,800,250,0.7619047619047619,13,8,5,378.56029300740335,0.4245680894308943,0.23124573538659177,0.2239180448255989,131703.53366457668,1771.5456588345035,133475.0793234112,1593,0,273.8048780487805,36,5,16,33.669546535015535,0.6374421296296297,43.384009009009006,1026.4639639639634,28.51288788788787,0
4775,4,0,0,40,0.0,0.0,1.0,40,1050,600,450,0.5714285714285714,15,6,9,382.6508418294132,0.4234107905982906,0.23852569882777352,0.226930365555518,131803.09070644696,2086.912722908067,133890.00342935504,1594,1,280.525,35,5,17,33.463893898406965,0.6404761904761904,43.287037037037024,1026.85185185185,29.33862433862428,0
4776,4,0,1,39,0.0,0.025,0.975,40,700,400,300,0.5714285714285714,10,4,6,382.4476931034837,0.4231570512820513,0.23159006421088257,0.22769873720185235,131951.6933111494,2092.92414158947,134044.61745273886,1595,2,281.525,35,5,18,33.318899966204796,0.6419642857142858,43.14236111111109,1027.4305555555532,29.35515873015866,0
4777,4,0,1,38,0.0,0.02564102564102564,0.9743589743589743,39,1300,700,600,0.5384615384615384,19,7,12,385.5003652300952,0.4218398560503824,0.2277200277200282,0.23005666957279852,132040.8950617282,2380.3626543209625,134421.25771604915,1596,3,283.4871794871795,35,4,18,33.15033783783783,0.6428571428571428,43.05555555555554,1027.7777777777762,29.36507936507932,0
4778,4,0,0,38,0.0,0.0,1.0,38,1600,1200,400,0.75,20,12,8,396.628576042246,0.4179113323850166,0.23239720013657927,0.23644322295557058,132000.11337868456,2871.003401360516,134871.11678004506,1597,4,291.7894736842105,34,4,19,32.90566110596231,0.6446078431372548,43.09523809523808,1027.6190476190457,30.224089635854284,0
4779,4,0,0,38,0.0,0.0,1.0,38,1250,800,450,0.64,17,8,9,392.93228856100427,0.41589615931721197,0.22029344024567132,0.23537788547780503,132183.6805555553,2787.8472222221885,134971.5277777775,1598,5,292.7894736842105,34,4,19,32.815032414910846,0.6464460784313726,42.91666666666665,1028.3333333333312,30.245098039215623,0
4780,4,0,0,38,0.0,0.0,1.0,38,1100,900,200,0.8181818181818182,13,9,4,391.1942514659243,0.41457740635372214,0.21140310285199337,0.23547932518603393,132367.37528344654,2756.271258503379,135123.6465419499,1599,6,293.7894736842105,34,4,19,32.67415741169211,0.6482843137254901,42.73809523809523,1029.0476190476177,30.26610644257699,0
4781,4,0,0,38,0.0,0.0,1.0,38,850,600,250,0.7058823529411765,11,6,5,390.59810847579894,0.41426623992413464,0.21255060728744968,0.23531154339883467,132398.00347222204,2742.881944444421,135140.88541666645,1600,7,294.7894736842105,34,4,19,32.658569500674766,0.6485906862745099,42.70833333333332,1029.1666666666652,30.26960784313721,0
4782,4,0,1,37,0.0,0.02631578947368421,0.9736842105263158,38,1050,700,350,0.6666666666666666,14,7,7,383.9979185615813,0.4131845661450924,0.18766915531771922,0.21245562091770714,129110.63102324269,2333.0038265306193,131443.6348497733,1601,8,295.7894736842105,34,4,18,36.16610050368982,0.6155024509803921,45.92261904761905,1016.3095238095242,29.891456582633065,8
4783,4,1,0,38,0.02631578947368421,0.0,1.0,38,1100,800,300,0.7272727272727273,14,8,6,381.62207206814173,0.4143106922712186,0.18581503161446244,0.21212870569949802,129294.84941188472,2268.38555581545,131563.23496770018,1602,0,296.3421052631579,33,5,20,36.038353014419414,0.6196338383838385,45.741421568627445,1017.0343137254891,30.819221628045124,0
4784,4,1,1,38,0.02564102564102564,0.02564102564102564,0.9743589743589743,39,1300,1000,300,0.7692307692307693,16,10,6,370.11177716573167,0.41655420602789023,0.17995174511831435,0.20762663958379238,129655.65653344667,1797.4170918367295,131453.0736252834,1603,0,289.71794871794873,34,5,17,35.96337424508084,0.6210171568627452,45.38690476190476,1018.4523809523806,29.954481792717075,0
4785,4,0,0,38,0.0,0.0,1.0,38,1000,700,300,0.7,13,7,6,379.26566245399516,0.41333274063537223,0.18883622492301022,0.21199061859642548,129513.0553753364,2223.9709486735806,131737.02632400996,1604,1,298.3157894736842,33,5,17,35.87567220483183,0.6218434343434344,45.52696078431372,1017.892156862745,30.845216874628637,0
4786,4,1,0,39,0.02564102564102564,0.0,1.0,39,1300,1000,300,0.7692307692307693,16,10,6,371.89554629832014,0.4159075573549258,0.200644168657244,0.21041329257539024,129989.29280045339,1868.4878117913697,131857.78061224477,1605,0,291.64102564102564,34,5,18,35.57840104288272,0.6243872549019608,45.0595238095238,1019.7619047619037,29.99299719887952,0
4787,4,0,1,38,0.0,0.02564102564102564,0.9743589743589743,39,1550,1300,250,0.8387096774193549,18,13,5,369.8322129803246,0.41661043634727846,0.1879185397207095,0.21038961923558872,130201.83000283444,1830.5661848072523,132032.3961876417,1606,1,292.64102564102564,34,5,18,35.414965589641895,0.626531862745098,44.851190476190474,1020.5952380952378,30.017507002801114,0
4788,4,0,0,38,0.0,0.0,1.0,38,1500,1300,200,0.8666666666666667,17,13,4,377.6411139440484,0.41539236605026075,0.1891020779614745,0.21482207629276187,130200.04325259509,2233.7778738946527,132433.82112648975,1607,2,297.1578947368421,33,5,19,35.21753922510408,0.6287878787878788,44.85294117647059,1020.5882352941171,30.926916221033853,0
4789,4,0,0,38,0.0,0.0,1.0,38,650,400,250,0.6153846153846154,9,4,5,375.6768013327777,0.41568871503082033,0.18850698174006442,0.21404841006169922,130262.58680555577,2187.3263888889132,132449.91319444467,1608,3,298.1578947368421,33,5,19,35.204081632653065,0.6294191919191919,44.79166666666668,1020.8333333333351,30.934343434343486,0
4790,4,0,0,38,0.0,0.0,1.0,38,1150,800,350,0.6956521739130435,15,8,7,377.33737830121936,0.4156294452347084,0.19177805290951788,0.21534075589080556,130325.14537677824,2235.3097366397615,132560.455113418,1609,4,299.1578947368421,33,5,20,35.098115698511755,0.630050505050505,44.73039215686275,1021.0784313725496,30.94177064765302,0
4791,4,0,0,38,0.0,0.0,1.0,38,1450,1000,450,0.6896551724137931,19,10,9,377.33737830121936,0.415259009009009,0.19177805290951788,0.21534075589080556,130325.14537677824,2235.3097366397615,132560.455113418,1610,5,300.1578947368421,33,5,20,35.098115698511755,0.630050505050505,44.73039215686275,1021.0784313725496,30.94177064765302,0
4792,4,0,0,38,0.0,0.0,1.0,38,900,700,200,0.7777777777777778,11,7,4,372.9974772632321,0.4148441204362257,0.18864349830774474,0.21402475567029333,130536.16780045367,2137.9322562358457,132674.10005668952,1611,6,301.1578947368421,34,4,16,34.99461206896552,0.6299019607843137,44.52380952380953,1021.9047619047631,30.05602240896362,0
4793,4,1,0,39,0.02564102564102564,0.0,1.0,39,900,700,200,0.7777777777777778,11,7,4,363.5892737737707,0.4170602789023841,0.19091444196046714,0.21083409494960356,130942.84664619766,1721.882903592244,132664.72954978992,1612,0,294.4102564102564,35,4,18,34.822858946812914,0.6318452380952381,44.126157407407405,1023.49537037037,29.242724867724856,0
4794,4,0,0,39,0.0,0.0,1.0,39,1650,1400,250,0.8484848484848485,19,14,5,360.2545408257776,0.4159075573549258,0.18827764300805971,0.20954450510753814,131061.33355034732,1643.0881076388982,132704.4216579862,1613,1,295.4102564102564,35,4,19,34.78827568667345,0.6330357142857144,44.01041666666667,1023.9583333333342,29.255952380952404,0
4795,4,0,0,39,0.0,0.0,1.0,39,750,400,350,0.5333333333333333,11,4,7,360.88480321746613,0.4159356725146199,0.1877096914385048,0.21039726669793,131150.233892747,1666.0252700617361,132816.25916280874,1614,2,296.4102564102564,35,4,19,34.68220338983051,0.6339285714285714,43.923611111111114,1024.305555555556,29.26587301587303,0
4796,4,0,0,39,0.0,0.0,1.0,39,1400,900,500,0.6428571428571429,19,9,10,359.9048185603805,0.41489541160593796,0.18949343339587243,0.210801393728223,131328.12500000015,1653.1250000000146,132981.25000000017,1615,3,297.4102564102564,35,4,20,34.52743902439023,0.6357142857142857,43.75000000000001,1025.0000000000011,29.285714285714317,0
4797,4,0,0,39,0.0,0.0,1.0,39,1500,1200,300,0.8,18,12,6,394.20868702534364,0.4150641025641026,0.17170744663191773,0.21799081809969476,129089.936326562,2377.674861495843,131467.61118805784,1616,4,298.4102564102564,37,2,17,35.92783412458639,0.6092342342342343,45.94298245614035,1016.2280701754385,27.465623518255093,8
4798,4,1,1,39,0.025,0.025,0.975,40,500,300,200,0.6,7,3,4,388.63821816531123,0.41846955128205127,0.17616793977637535,0.21630123380697835,129344.54038075246,2053.7425240384223,131398.2829047909,1617,0,291.925,36,4,18,35.80920882689399,0.6137152777777778,45.69256756756757,1017.2297297297305,28.256381381381402,0
4799,4,0,0,39,0.0,0.0,1.0,39,750,500,250,0.6666666666666666,10,5,5,393.662205703681,0.41613247863247865,0.18792134339596211,0.2186293387681758,129260.23046339165,2376.9734867969814,131637.20395018862,1618,1,300.28205128205127,35,4,18,35.76760376356323,0.6148809523809524,45.77546296296296,1016.8981481481483,29.054232804232807,0
4800,4,1,0,40,0.025,0.0,1.0,40,850,500,350,0.5882352941176471,12,5,7,383.1012306060618,0.41742788461538466,0.18595996460959952,0.21462213922800577,129602.41280131493,1930.1687667397214,131532.58156805465,1619,0,293.75,36,4,13,35.68693320061932,0.6163194444444444,45.43918918918919,1018.243243243244,28.284534534534558,0
4801,4,1,0,41,0.024390243902439025,0.0,1.0,41,850,600,250,0.7058823529411765,11,6,5,366.6825259974031,0.4194359756097561,0.12003192977451449,0.2015823226676077,128857.43408203112,1249.9538845485963,130107.38796657971,1620,0,287.5609756097561,39,2,16,36.864441195581534,0.6033653846153846,46.17187499999999,1015.312499999999,26.03365384615382,8
4802,4,0,0,41,0.0,0.0,1.0,41,1650,1200,450,0.7272727272727273,21,12,9,365.2758127867432,0.4192835365853658,0.12450848296532557,0.20215519599320786,129121.97401258687,1233.0268012152837,130355.00081380215,1621,1,288.5609756097561,39,2,16,36.63021847562434,0.6060363247863247,45.911458333333336,1016.3541666666672,26.06036324786326,0
4803,4,1,1,41,0.023809523809523808,0.023809523809523808,0.9761904761904762,42,950,500,450,0.5263157894736842,14,5,9,358.25196927771015,0.4199332171893147,0.1302908022281679,0.20014179484348243,129492.78564453125,878.2335069444453,130371.01915147569,1622,0,282.6666666666667,39,3,15,36.43104168798827,0.609775641025641,45.546875,1017.8125,26.09775641025641,0
4804,4,0,0,41,0.0,0.0,1.0,41,1350,1000,350,0.7407407407407407,17,10,7,365.58825955370594,0.41765752032520326,0.15180930146832972,0.20442047752510015,129527.44904667964,1270.7429322813753,130798.19197896101,1623,1,290.0975609756098,38,3,15,36.20906801007557,0.611842105263158,45.512820512820504,1017.9487179487165,26.788124156545173,0
4805,4,0,0,41,0.0,0.0,1.0,41,1200,900,300,0.75,15,9,6,368.18068970710806,0.41740345528455286,0.15272037158291063,0.207014802891921,129745.05077069168,1353.9244557673949,131098.97522645906,1624,2,291.0975609756098,38,3,15,35.92155166387027,0.6140350877192983,45.299145299145295,1018.8034188034179,26.810616284300473,0
4806,4,0,0,41,0.0,0.0,1.0,41,1000,500,500,0.5,15,5,10,369.29793383788126,0.4169461382113821,0.159468574453016,0.2080763727631155,129826.69850107729,1388.946302688267,131215.64480376555,1625,3,292.0975609756098,38,3,15,35.81000803718068,0.6148574561403508,45.21901709401708,1019.1239316239299,26.81905083220868,0
4807,4,0,0,41,0.0,0.0,1.0,41,1150,800,350,0.6956521739130435,15,8,7,368.6197634046333,0.41686991869918694,0.15959830839796085,0.20856405700635572,129990.07100819984,1383.3818439988104,131373.45285219865,1626,4,293.0975609756098,38,3,15,35.661122751877066,0.6165021929824561,45.058760683760674,1019.7649572649559,26.835919928025156,0
4808,4,0,0,41,0.0,0.0,1.0,41,1200,700,500,0.5833333333333334,17,7,10,367.16169083021805,0.4167174796747968,0.16275148926604466,0.2081745738745201,130071.79578493665,1351.476093944024,131423.27187888068,1627,5,294.0975609756098,38,3,15,35.6152248289345,0.6173245614035088,44.97863247863247,1020.0854700854688,26.84435447593339,0
4809,4,0,1,40,0.0,0.024390243902439025,0.975609756097561,41,1050,800,250,0.7619047619047619,13,8,5,368.21537288349265,0.4166666666666667,0.16672413660988683,0.20891792012266586,130099.04308431929,1380.893532215624,131479.93661653492,1628,6,295.0975609756098,38,3,15,35.56066080217825,0.6175986842105263,44.951923076923066,1020.1923076923058,26.847165991902784,0
4810,4,0,0,40,0.0,0.0,1.0,40,950,700,250,0.7368421052631579,12,7,5,372.55770315599426,0.41733440170940167,0.15974849527085122,0.2113583457416689,130094.74068944287,1693.5595567867006,131788.30024622957,1629,7,299.35,37,3,15,35.45428489538549,0.6193693693693694,44.95614035087719,1020.1754385964911,27.572309151256515,0
4811,4,1,1,40,0.024390243902439025,0.024390243902439025,0.975609756097561,41,1000,700,300,0.7,13,7,6,365.2190087708549,0.4191310975609756,0.16039391774670886,0.20882139496706772,130398.9517130543,1324.8351778800518,131723.78689093434,1630,0,293.0243902439024,38,3,16,35.33254881450488,0.6206140350877193,44.65811965811966,1021.3675213675215,26.878092667566353,0
4812,4,0,0,40,0.0,0.0,1.0,40,950,700,250,0.7368421052631579,12,7,5,365.3668103083861,0.41792200854700856,0.1392266824085009,0.2092269558477708,130458.54403518375,1533.0444223222332,131991.58845750598,1631,1,269.5,37,3,17,35.268304354048155,0.6230292792792793,44.599780701754376,1021.6008771929812,27.610834518729224,0
4813,4,0,1,39,0.0,0.025,0.975,40,600,400,200,0.6666666666666666,8,4,4,363.5754093481053,0.41820245726495725,0.13563532946984314,0.20835151686996572,130486.54994806081,1488.3401623576303,131974.89011041843,1632,2,270.5,37,3,17,35.28564785003934,0.6233108108108107,44.57236842105262,1021.7105263157885,27.613798008534822,0
4814,4,1,1,39,0.025,0.025,0.975,40,500,300,200,0.6,7,3,4,364.4631732393295,0.42063301282051285,0.1477823661911406,0.2096169132702199,130626.62459843393,1521.718822137559,132148.3434205715,1633,0,268.825,37,3,15,35.120915120311786,0.6247184684684685,44.43530701754385,1022.2587719298228,27.62861545756278,0
4815,4,0,0,39,0.0,0.0,1.0,39,1050,600,450,0.5714285714285714,15,6,9,373.86732382488617,0.4182692307692308,0.15190266749151893,0.21492043688147472,130607.69120049072,1965.9895960148979,132573.68079650562,1634,1,276.64102564102564,36,3,16,34.89979251588262,0.6264467592592593,44.45382882882881,1022.1846846846822,28.394019019018952,0
4816,4,0,0,39,0.0,0.0,1.0,39,1000,700,300,0.7,13,7,6,373.86732382488617,0.4184941520467836,0.15190266749151893,0.21492043688147472,130607.69120049072,1965.9895960148979,132573.68079650562,1635,2,277.64102564102564,36,3,16,34.89979251588262,0.6264467592592593,44.45382882882881,1022.1846846846822,28.394019019018952,0
4817,4,0,0,39,0.0,0.0,1.0,39,1050,600,450,0.5714285714285714,15,6,9,374.12209629529025,0.41897210976158344,0.14953688015362054,0.21554750218028118,130694.03863322764,1979.105541352141,132673.1441745798,1636,3,278.64102564102564,36,3,17,34.80566262848752,0.6273148148148149,44.36936936936936,1022.5225225225211,28.403403403403363,0
4818,4,0,0,39,0.0,0.0,1.0,39,1350,800,550,0.5925925925925926,19,8,11,371.7285784686927,0.4183535762483131,0.14668946872336686,0.21512903592143556,130866.81909950475,1929.3873265156808,132796.20642602042,1637,4,279.64102564102564,36,3,18,34.69165015775185,0.6290509259259259,44.20045045045044,1023.1981981981969,28.422172172172136,0
4819,4,1,0,40,0.025,0.0,1.0,40,800,500,300,0.625,11,5,6,367.01440328688,0.42032585470085465,0.1571027287319422,0.21449340829993035,131243.84576263823,1633.676347529972,132877.5221101682,1638,0,273.625,37,3,20,34.43051096843229,0.6309121621621622,43.832236842105246,1024.6710526315767,27.693812233285858,0
4820,4,0,0,40,0.0,0.0,1.0,40,1050,800,250,0.7619047619047619,13,8,5,364.61404504268035,0.4195379273504274,0.15387391722810495,0.21403050440640892,131412.43128895387,1582.9636282317251,132995.3949171856,1639,1,274.625,37,3,20,34.32152978291093,0.6326013513513513,43.66776315789472,1025.3289473684179,27.7115931721194,0
4821,4,0,0,40,0.0,0.0,1.0,40,1550,1100,450,0.7096774193548387,20,11,9,373.9915432911274,0.4187900641025641,0.11172354948805441,0.20832608780285233,129377.95380015433,1700.6337152884646,131078.58751544278,1640,2,275.625,35,5,20,36.147610921501695,0.6160714285714286,45.65972222222222,1017.3611111111112,29.06746031746032,8
4822,4,0,1,39,0.0,0.025,0.975,40,1800,1400,400,0.7777777777777778,22,14,8,382.0770044481703,0.4187633547008547,0.11285105173393983,0.21362792461040428,129525.18332315248,1897.7188089420474,131422.90213209452,1641,3,276.625,35,5,14,35.791761417472046,0.6175595238095238,45.5150462962963,1017.9398148148152,29.08399470899472,0
4823,4,0,0,39,0.0,0.0,1.0,39,1150,700,450,0.6086956521739131,16,7,9,380.70311424219415,0.4167791273054431,0.11826731747138597,0.21390312866055214,129717.10519641264,2076.7411837513214,131793.84638016397,1642,4,282.94871794871796,36,3,17,35.631080035374765,0.6174768518518519,45.32657657657658,1018.6936936936937,28.297047047047048,0
4824,4,0,1,38,0.0,0.02564102564102564,0.9743589743589743,39,1200,600,600,0.5,18,6,12,378.8393837589157,0.41576698155645525,0.11476844887517745,0.21363708800012116,129860.54202428773,2039.2575430159811,131899.7995673037,1643,5,283.94871794871796,36,3,17,35.53244577026479,0.6189236111111112,45.18581081081081,1019.2567567567562,28.31268768768767,0
4825,4,0,1,37,0.0,0.02631578947368421,0.9736842105263158,38,950,500,450,0.5263157894736842,14,5,9,380.8356764096967,0.4145477714556662,0.12156526518930977,0.21518803550308,129937.87140185611,2296.9954293124115,132234.86683116853,1644,6,291.42105263157896,35,3,17,35.40283138456882,0.6217261904761905,45.1099537037037,1019.560185185185,29.130291005291,0
4826,4,0,0,37,0.0,0.0,1.0,37,1200,800,400,0.6666666666666666,16,8,8,387.74842820185336,0.41213088088088085,0.14310727209058016,0.2195532573962509,130019.64462868468,2682.982568027197,132702.62719671187,1645,7,298.86486486486484,34,3,17,35.14333099879382,0.6246936274509804,45.0297619047619,1019.8809523809514,29.996498599439747,0
4827,4,0,0,37,0.0,0.0,1.0,37,1150,700,450,0.6086956521739131,16,7,9,387.5646119014055,0.4120683183183183,0.1403020667726549,0.21961994674412963,130049.9999999999,2680.555555555541,132730.55555555545,1646,8,299.86486486486484,34,3,18,35.117102396514156,0.625,44.99999999999999,1019.9999999999992,29.999999999999975,0
4828,4,0,0,37,0.0,0.0,1.0,37,1350,1000,350,0.7407407407407407,17,10,7,391.1666118725468,0.41159909909909914,0.1404093934130095,0.22252630149856273,130201.83000283435,2786.121740362794,132987.95174319713,1647,9,300.86486486486484,34,3,19,34.87062094171623,0.626531862745098,44.85119047619047,1020.5952380952372,30.017507002801093,0
4829,4,0,0,37,0.0,0.0,1.0,37,1250,700,550,0.56,18,7,11,387.99448430231826,0.4111611611611612,0.13949475159268743,0.2214226056991036,130325.14537677799,2713.1016867531116,133038.2470635311,1648,10,301.86486486486484,33,4,20,34.826072171547445,0.630050505050505,44.730392156862735,1021.0784313725476,30.94177064765296,0
4830,4,0,0,37,0.0,0.0,1.0,37,1000,700,300,0.7,13,7,6,390.5654382021017,0.41138013013013014,0.14002172538465274,0.223429164544579,130419.01139285363,2787.4316669069494,133206.44305976058,1649,11,302.86486486486484,33,4,20,34.66494201159768,0.6309974747474747,44.63848039215686,1021.4460784313719,30.95291146761733,0
4831,4,0,1,36,0.0,0.02702702702702703,0.972972972972973,37,1100,1000,100,0.9090909090909091,12,10,2,361.89942442284575,0.41119244244244246,0.01199560776208064,0.20113916776746066,129289.65627411295,1961.128027514822,131250.78430162778,1650,12,303.86486486486484,35,2,17,36.54510925230453,0.6151785714285714,45.74652777777779,1017.0138888888913,29.05753968253975,8
4832,4,1,1,36,0.02702702702702703,0.02702702702702703,0.972972972972973,37,800,600,200,0.75,10,6,4,356.36729062034027,0.4132257257257257,0.03171842980868811,0.19955207228434974,129584.09857521013,1835.9068233453474,131420.00539855548,1651,0,303.18918918918916,35,2,15,36.38610226971317,0.6181547619047619,45.45717592592593,1018.1712962962969,29.090608465608483,0
4833,4,0,0,36,0.0,0.0,1.0,36,1100,900,200,0.8181818181818182,13,9,4,362.5662597038407,0.41051587301587306,0.03853151397011101,0.20261055689332275,129504.14540816334,2190.7667233560223,131694.91213151938,1652,1,312.1111111111111,34,2,15,36.309697855750485,0.6194852941176471,45.53571428571429,1017.8571428571435,29.936974789915983,0
4834,4,0,1,35,0.0,0.027777777777777776,0.9722222222222222,36,1150,900,250,0.782608695652174,14,9,5,362.5034753829431,0.4104828042328042,0.036864907699702965,0.20304467746891353,129595.04145408158,2195.7305839002233,131790.7720379818,1653,2,313.1111111111111,34,2,15,36.21877314002885,0.6204044117647058,45.44642857142857,1018.2142857142852,29.947478991596626,0
4835,4,0,0,35,0.0,0.0,1.0,35,1100,900,200,0.8181818181818182,13,9,4,371.26481295535797,0.40787815126050425,0.04371163798291011,0.20801344105502836,129606.62853529898,2623.676140186472,132230.30467548544,1654,3,322.62857142857143,33,2,17,35.983948128535324,0.622790404040404,45.435049019607845,1018.2598039215691,30.856357694593,0
4836,4,0,0,35,0.0,0.0,1.0,35,1150,900,250,0.782608695652174,14,9,5,368.8926080789015,0.40787815126050425,0.04400227022335024,0.20742332062675692,129746.60572562362,2572.512755102048,132319.11848072568,1655,4,323.62857142857143,34,1,18,35.90183648827609,0.6219362745098039,45.29761904761905,1018.8095238095241,29.964985994397768,0
4837,4,0,0,35,0.0,0.0,1.0,35,1050,800,250,0.7619047619047619,13,8,5,369.137305415775,0.40693277310924375,0.04521640471184951,0.20820511258036017,129867.92091836738,2587.818877551025,132455.7397959184,1656,5,324.62857142857143,34,1,19,35.772161878065866,0.6231617647058824,45.17857142857143,1019.2857142857146,29.978991596638664,0
4838,4,0,0,35,0.0,0.0,1.0,35,850,800,50,0.9411764705882353,9,8,1,372.3901118093875,0.4070728291316527,0.04256525727629068,0.21052945925065364,129958.94451530611,2679.085175736965,132638.02969104308,1657,6,325.62857142857143,34,1,19,35.59666277485894,0.6240808823529411,45.089285714285715,1019.6428571428571,29.989495798319325,0
4839,4,0,0,35,0.0,0.0,1.0,35,600,300,300,0.5,9,3,6,370.7237572531811,0.4063725490196079,0.04679084193499983,0.2099134453660279,130019.6446286848,2640.274234693879,132659.91886337867,1658,7,326.62857142857143,34,1,19,35.577409439321436,0.6246936274509804,45.029761904761905,1019.8809523809523,29.996498599439775,0
4840,4,0,1,34,0.0,0.02857142857142857,0.9714285714285714,35,550,300,250,0.5454545454545454,8,3,5,371.0216630464871,0.4068977591036415,0.052648250337595126,0.21040930712411302,130080.35891439914,2652.5262188208617,132732.88513322,1659,8,327.62857142857143,34,1,19,35.50808145641264,0.6253063725490196,44.970238095238095,1020.119047619048,30.003501400560236,0
4841,4,1,0,35,0.02857142857142857,0.0,1.0,35,850,500,350,0.5882352941176471,12,5,7,364.22970369251505,0.4094537815126051,0.06890595009596967,0.20853151167450612,130450.30757401012,2502.902925876251,132953.21049988637,1660,0,325.8285714285714,33,2,20,35.3057021753039,0.6313131313131313,44.60784313725491,1021.5686274509815,30.956625074272164,0
4842,4,1,0,36,0.027777777777777776,0.0,1.0,36,1200,800,400,0.6666666666666666,16,8,8,355.50588709215737,0.4121693121693122,0.06904041579396458,0.2056001072456261,130840.4832766441,2102.9124149659974,132943.3956916101,1661,0,317.75,34,2,21,35.13328097122024,0.6329656862745099,44.22619047619048,1023.095238095239,30.091036414565853,0
4843,4,0,0,36,0.0,0.0,1.0,36,400,200,200,0.5,6,2,4,355.50588709215737,0.4121693121693122,0.06904041579396458,0.2056001072456261,130840.4832766441,2102.9124149659974,132943.3956916101,1662,1,318.75,34,2,21,35.13328097122024,0.6329656862745099,44.22619047619048,1023.095238095239,30.091036414565853,0
4844,4,1,0,37,0.02702702702702703,0.0,1.0,37,1100,900,200,0.8181818181818182,13,9,4,347.7747169040119,0.4149461961961962,0.06664976650285692,0.20259766095349593,131120.59709630074,1720.0857070902098,132840.68280339096,1663,0,311.1081081081081,35,2,22,35.04786322371644,0.6336309523809525,43.952546296296305,1024.1898148148161,29.262566137566175,0
4845,4,0,0,37,0.0,0.0,1.0,37,1850,1300,550,0.7027027027027027,24,13,11,350.3205763764955,0.4141328828828829,0.07580751483190484,0.20518776616337597,131328.12500000012,1801.388888888904,133129.51388888902,1664,1,312.1081081081081,35,2,22,34.7730352303523,0.6357142857142857,43.75000000000001,1025.000000000001,29.285714285714313,0
4846,4,0,0,37,0.0,0.0,1.0,37,1050,600,450,0.5714285714285714,15,6,9,353.6372883422591,0.41363238238238237,0.06971765265604124,0.20809652385717786,131506.13667052463,1901.0947145061673,133407.2313850308,1665,2,313.1081081081081,35,2,22,34.508293838862556,0.6375,43.576388888888886,1025.6944444444441,29.305555555555546,0
4847,4,0,0,37,0.0,0.0,1.0,37,1000,700,300,0.7,13,7,6,349.9814159063433,0.4136011011011011,0.06464906318295305,0.2067478490900431,131654.57182623888,1815.330691658093,133469.902517897,1666,3,314.1081081081081,35,2,19,34.452299725574235,0.6389880952380953,43.43171296296296,1026.2731481481483,29.32208994708995,0
4848,4,0,0,37,0.0,0.0,1.0,37,1000,700,300,0.7,13,7,6,349.0670984826018,0.41344469469469475,0.06147574696779956,0.20685198601464017,131773.38023244613,1799.5502989969277,133572.93053144307,1667,4,315.1081081081081,35,2,19,34.35597734190056,0.6401785714285715,43.31597222222223,1026.7361111111122,29.33531746031749,0
4849,4,0,0,37,0.0,0.0,1.0,37,1400,1000,400,0.7142857142857143,18,10,8,347.60057683467454,0.41225600600600604,0.06748904369779285,0.20654494210482527,131876.97991488117,1768.1028579255014,133645.08277280667,1668,5,316.1081081081081,36,1,19,34.28923180937763,0.6391782407407407,43.215090090090094,1027.13963963964,28.53165665665667,0
4850,4,0,1,36,0.0,0.02702702702702703,0.972972972972973,37,1200,1000,200,0.8333333333333334,14,10,4,347.63823912326075,0.4117867867867868,0.059088674473289915,0.20735598498293328,132021.60564280505,1779.1517023780657,133800.7573451831,1669,6,317.1081081081081,36,1,19,34.14260537657974,0.640625,43.07432432432433,1027.7027027027034,28.547297297297316,0
4851,4,0,0,36,0.0,0.0,1.0,36,900,600,300,0.6666666666666666,12,6,6,354.75508635722366,0.4073412698412699,0.0625203374133314,0.21137688971002908,131981.42387902958,2164.2162851509024,134145.64016418048,1670,9,326.75,35,1,20,34.000244048959985,0.6422619047619047,43.11342592592593,1027.546296296297,29.35846560846563,0
4852,4,0,0,36,0.0,0.0,1.0,36,1100,900,200,0.8181818181818182,13,9,4,353.9734891995124,0.40649801587301587,0.07066869300911827,0.2117405053575267,132130.12695312515,2154.112413194458,134284.2393663196,1671,10,327.75,35,1,20,33.87052516041878,0.64375,42.96875000000001,1028.1250000000011,29.375000000000032,0
4853,4,0,0,36,0.0,0.0,1.0,36,800,500,300,0.625,11,5,6,354.75597245634447,0.40560515873015873,0.07632559418876506,0.21287753728693692,132249.14969403733,2183.2351412465864,134432.3848352839,1672,11,328.75,35,1,21,33.73056618281385,0.6449404761904762,42.85300925925927,1028.587962962964,29.38822751322754,0
4854,4,0,0,36,0.0,0.0,1.0,36,850,700,150,0.8235294117647058,10,7,3,355.0904398710205,0.40553902116402113,0.07611467356658075,0.2134143962145706,132308.68115837182,2196.309558256167,134504.990716628,1673,12,329.75,35,1,21,33.662040161997965,0.6455357142857143,42.795138888888886,1028.819444444444,29.394841269841255,0
4855,4,0,0,36,0.0,0.0,1.0,36,1100,800,300,0.7272727272727273,14,8,6,355.83656035115285,0.405109126984127,0.08479514757047824,0.21454926564173227,132429.53619100817,2224.714411057168,134654.25060206535,1674,13,330.75,33,3,21,33.52122772552286,0.651199494949495,42.67769607843137,1029.2892156862738,31.19058229352345,0
4856,4,0,0,36,0.0,0.0,1.0,36,1550,1100,450,0.7096774193548387,20,11,9,353.4467513515816,0.40469576719576716,0.08625591790314502,0.21364457588891986,132524.1568747596,2168.046544598218,134692.2034193578,1675,14,331.75,33,3,22,33.487562485122595,0.6521464646464646,42.58578431372548,1029.656862745097,31.201723113487787,0
4857,4,0,0,36,0.0,0.0,1.0,36,1050,800,250,0.7619047619047619,13,8,5,354.6428900722919,0.4048776455026455,0.08670474377280657,0.21472758272100412,132587.25610342165,2204.225538254501,134791.48164167616,1676,15,332.75,33,3,22,33.39332460732984,0.6527777777777778,42.52450980392156,1029.9019607843127,31.209150326797353,0
4858,4,0,0,36,0.0,0.0,1.0,36,1150,900,250,0.782608695652174,14,9,5,356.2207667176561,0.4038029100529101,0.08950910844264803,0.2169567609603333,132808.22167255374,2261.8093101210975,135070.03098267483,1677,16,333.75,33,3,19,33.130597828240774,0.6549873737373737,42.31004901960784,1030.759803921568,31.235145573380848,0
4859,4,0,0,36,0.0,0.0,1.0,36,950,700,250,0.7368421052631579,12,7,5,354.44066149564424,0.4029265873015873,0.09140084907717427,0.21669156319948943,132949.91673752826,2224.571286848066,135174.48802437633,1678,17,334.75,34,2,19,33.034168301973914,0.6541053921568627,42.172619047619044,1031.3095238095232,30.33263305322127,0
4860,4,0,0,36,0.0,0.0,1.0,36,1200,1000,200,0.8333333333333334,14,10,4,354.2506932096187,0.4021329365079365,0.09129456559363103,0.21728880099418027,133072.72002551027,2228.2206632653106,135300.94068877556,1679,18,335.75,34,2,19,32.91580131533402,0.6553308823529411,42.05357142857143,1031.785714285715,30.346638655462204,0
4861,4,0,0,36,0.0,0.0,1.0,36,1550,1200,350,0.7741935483870968,19,12,7,353.2559900155139,0.40153769841269843,0.09522482348569383,0.21739408725511142,133195.5800028344,2210.427295918369,135406.00729875278,1680,19,336.75,34,2,19,32.81820628147468,0.6565563725490196,41.93452380952381,1032.2619047619044,30.36064425770307,0
4862,4,0,0,36,0.0,0.0,1.0,36,1050,800,250,0.7619047619047619,13,8,5,354.2829716087592,0.40150462962962963,0.09133297466246493,0.21856689158850484,133287.76218820867,2244.3168934240366,135532.0790816327,1681,20,337.75,34,2,20,32.699254476981004,0.6574754901960784,41.845238095238095,1032.619047619048,30.37114845938376,0
4863,4,0,0,36,0.0,0.0,1.0,36,900,600,300,0.6666666666666666,12,6,6,354.8727930322918,0.40138888888888885,0.09048010359081671,0.21931335214821115,133352.65024862808,2264.645490397785,135617.29573902587,1682,21,338.75,35,1,21,32.61896757806663,0.655952380952381,41.7824074074074,1032.8703703703688,29.510582010581967,0
4864,4,0,0,36,0.0,0.0,1.0,36,1200,900,300,0.75,15,9,6,357.700312174818,0.40051256613756614,0.08691756272401463,0.2217741935483871,133472.22222222216,2348.7718621399126,135820.9940843621,1683,22,339.75,32,4,21,32.426075268817215,0.6640625,41.666666666666664,1033.333333333333,32.29166666666666,0
4865,4,0,0,36,0.0,0.0,1.0,36,1150,900,250,0.782608695652174,14,9,5,365.2467405401209,0.39923941798941803,0.09873641801977784,0.22785499251821276,133700.6447843334,2566.7449431180685,136267.38972745146,1684,23,340.75,32,4,17,32.00209579619907,0.6663411458333333,41.44570707070708,1034.217171717173,32.319286616161655,0
4866,4,0,0,36,0.0,0.0,1.0,36,1150,1000,150,0.8695652173913043,13,10,3,364.8304130444575,0.3986111111111111,0.10615212527964224,0.2284022333765722,133831.2596450618,2565.1427469135924,136396.4023919754,1685,24,341.75,32,4,19,31.881991051454136,0.6676432291666667,41.31944444444445,1034.7222222222229,32.335069444444464,0
4867,4,0,0,36,0.0,0.0,1.0,36,750,600,150,0.8,9,6,3,364.428742093981,0.39824735449735454,0.10885192639069774,0.22887208806452497,133947.52206182736,2562.8653943195145,136510.38745614688,1686,25,342.75,33,3,19,31.775951027978387,0.6663510101010102,41.207107843137265,1035.1715686274522,31.368835412953096,0
4868,4,0,0,36,0.0,0.0,1.0,36,1250,1000,250,0.8,15,10,5,361.6924296472453,0.397337962962963,0.1071839080459771,0.2280234882558721,134088.01020408174,2499.723639455792,136587.73384353754,1687,26,343.75,34,2,19,31.70617816091954,0.6654411764705883,41.07142857142858,1035.7142857142865,30.462184873949603,0
4869,4,0,0,36,0.0,0.0,1.0,36,1200,900,300,0.75,15,9,6,363.7877047825514,0.39735449735449735,0.09855447061076039,0.23031068873688057,134242.17864229018,2567.130810657589,136809.30945294775,1688,27,344.75,34,2,19,31.49770246984492,0.6669730392156863,40.922619047619044,1036.3095238095232,30.47969187675068,0
4870,4,0,0,36,0.0,0.0,1.0,36,1600,1300,300,0.8125,19,13,6,362.6406539793087,0.3969246031746032,0.10090136640257197,0.23036013533959124,134365.57716836716,2545.2841553287735,136910.86132369595,1689,28,345.75,34,2,19,31.40405519194702,0.6681985294117647,40.803571428571416,1036.7857142857129,30.493697478991553,0
4871,4,0,0,36,0.0,0.0,1.0,36,1000,700,300,0.7,13,7,6,368.12100431199497,0.39596560846560847,0.10146078018796922,0.23463338043675275,134489.03238378678,2701.647534013593,137190.67991780036,1690,29,346.75,34,2,19,31.138576456635654,0.6694240196078431,40.6845238095238,1037.2619047619041,30.507703081232474,0
4872,4,0,0,36,0.0,0.0,1.0,36,1050,800,250,0.7619047619047619,13,8,5,369.5101691908195,0.3954365079365079,0.099843819723338,0.235918031098754,134550.78125,2743.6047335600906,137294.3859835601,1691,30,347.75,32,4,19,31.040829986613122,0.6748046875,40.625,1037.5,32.421875,0
4873,4,0,0,36,0.0,0.0,1.0,36,1450,1200,250,0.8275862068965517,17,12,5,369.7959401140177,0.39444444444444443,0.09574209245742082,0.23673852240944138,134649.04729109278,2758.5342056932986,137407.58149678606,1692,31,348.75,32,4,19,30.935218978102192,0.67578125,40.53030303030303,1037.878787878788,32.433712121212125,0
4874,4,0,0,36,0.0,0.0,1.0,36,1550,1200,350,0.7741935483870968,19,12,7,371.7528842223197,0.39370039682539687,0.09599951361867731,0.23885122811284054,134780.1244770942,2820.980002040618,137601.10447913484,1693,32,349.75,32,4,19,30.75348573281454,0.6770833333333333,40.40404040404041,1038.3838383838388,32.44949494949496,0
4875,4,0,0,36,0.0,0.0,1.0,36,850,400,450,0.47058823529411764,13,4,9,370.7383484399412,0.393287037037037,0.09646243617797201,0.238630176390216,134845.68698347124,2798.4934573002965,137644.18044077154,1694,33,350.75,32,4,19,30.714350838803792,0.677734375,40.3409090909091,1038.636363636365,32.45738636363641,0
4876,4,0,0,36,0.0,0.0,1.0,36,1050,700,350,0.6666666666666666,14,7,7,371.0181483000754,0.3931712962962963,0.08942753794133851,0.2393829422593639,134932.48540224927,2812.480175893902,137744.96557814316,1695,34,351.75,33,3,19,30.62042934654399,0.6761363636363636,40.25735294117648,1038.970588235295,31.483957219251366,0
4877,4,0,0,36,0.0,0.0,1.0,36,1150,700,450,0.6086956521739131,16,7,9,365.7176698927085,0.3924768518518518,0.07904465569681451,0.2366998499505736,135045.2823837869,2677.6892006802755,137722.97158446716,1696,35,352.75,34,2,19,30.64559233382964,0.6749387254901961,40.148809523809526,1039.4047619047622,30.570728291316534,0
4878,4,0,0,36,0.0,0.0,1.0,36,1250,1000,250,0.8,15,10,5,365.5198919793487,0.391848544973545,0.0780862430833813,0.23738410828547288,135169.0493905896,2681.395266439911,137850.4446570295,1697,36,353.75,34,2,19,30.5273325701202,0.6761642156862745,40.029761904761905,1039.8809523809525,30.584733893557427,0
4879,4,0,0,36,0.0,0.0,1.0,36,1400,1100,300,0.7857142857142857,17,11,6,362.92583587762033,0.3903935185185185,0.07334617487380934,0.23651072928669073,135292.8730867347,2620.255810657595,137913.1288973923,1698,37,354.75,34,2,19,30.471402143647246,0.6773897058823529,39.910714285714285,1040.357142857143,30.59873949579832,0
4880,4,0,0,36,0.0,0.0,1.0,36,1200,900,300,0.75,15,9,6,361.7733768307943,0.3902777777777778,0.0727180269514367,0.23596263533590633,135323.83786848086,2591.3123582766566,137915.1502267575,1699,38,355.75,34,2,19,30.470537757437057,0.6776960784313726,39.88095238095239,1040.4761904761915,30.602240896358573,0
4881,4,0,0,36,0.0,0.0,1.0,36,1600,1200,400,0.75,20,12,8,363.1185985106738,0.38872354497354494,0.0765889346136257,0.23848059307592928,135571.68367346944,2645.7199546485344,138217.40362811796,1700,39,356.75,34,2,20,30.188805060204228,0.6801470588235294,39.642857142857146,1041.428571428572,30.63025210084035,0
4882,4,0,0,36,0.0,0.0,1.0,36,800,500,300,0.625,11,5,6,363.91506846032013,0.3883597883597884,0.072689449022459,0.23985839815771248,135699.45031119263,2676.643294676291,138376.09360586893,1701,40,357.75,32,4,20,30.04094966876717,0.6861979166666667,39.520202020202014,1041.9191919191912,32.559974747474726,0
4883,4,0,0,36,0.0,0.0,1.0,36,1050,800,250,0.7619047619047619,13,8,5,362.81839814767466,0.3883432539682539,0.06859121935457835,0.23935573460533646,135732.34116735542,2649.238119834718,138381.57928719014,1702,41,358.75,32,4,20,30.03680479825518,0.6865234375,39.48863636363637,1042.045454545455,32.56392045454547,0
4884,4,0,0,36,0.0,0.0,1.0,36,1050,600,450,0.5714285714285714,15,6,9,365.04579355152873,0.3884589947089947,0.06886076460377111,0.2417147648239754,135863.944447633,2719.312283185404,138583.2567308184,1703,42,359.75,32,4,19,29.84790682653104,0.6878255208333333,39.362373737373744,1042.5505050505058,32.579703282828305,0
4885,4,0,0,36,0.0,0.0,1.0,36,1150,900,250,0.782608695652174,14,9,5,366.1518330641256,0.38839285714285715,0.06979582778517535,0.24334515631075965,135995.61149691365,2759.0084876543283,138754.61998456798,1704,43,360.75,32,4,19,29.688193519751447,0.6891276041666667,39.236111111111114,1043.055555555556,32.59548611111113,0
4886,4,0,0,36,0.0,0.0,1.0,36,1050,800,250,0.7619047619047619,13,8,5,362.1991423780347,0.38781415343915343,0.03790765437633148,0.22366110362901048,133322.76562767907,2457.8782739626104,135780.64390164168,1705,44,361.75,35,1,20,32.45977156412268,0.6556547619047619,41.81134259259259,1032.7546296296289,29.50727513227511,8
4887,4,0,0,36,0.0,0.0,1.0,36,1300,800,500,0.6153846153846154,18,8,10,361.71069616270745,0.38713624338624336,0.005016017534986261,0.2048100154676745,130019.64462868478,2231.3849707192558,132251.02959940402,1706,45,362.75,34,2,19,35.80721567254194,0.6246936274509804,45.029761904761905,1019.8809523809522,29.99649859943977,8
4888,4,0,0,36,0.0,0.0,1.0,36,1100,900,200,0.8181818181818182,13,9,4,375.43416142746753,0.3871858465608466,0.04845523040963173,0.20334623040014765,128265.0953089569,2431.2464569160966,130696.34176587299,1707,46,363.75,34,2,16,37.24830571551689,0.6069240196078431,46.75595238095238,1012.9761904761903,29.793417366946773,8
4889,4,0,1,35,0.0,0.027777777777777776,0.9722222222222222,36,1050,900,150,0.8571428571428571,12,9,3,375.25833204098035,0.38761574074074073,0.05061213568790213,0.2038656145925249,128385.7160572562,2435.561933106571,130821.27799036277,1708,47,364.75,34,2,15,37.12924350992599,0.6081495098039216,46.63690476190476,1013.4523809523806,29.807422969187666,0
4890,4,1,0,36,0.027777777777777776,0.0,1.0,36,550,300,250,0.5454545454545454,8,3,5,356.82164189636,0.38971560846560843,0.011188871608778461,0.19420244379389562,128458.27880245111,1967.338791494201,130425.61759394531,1709,0,363.19444444444446,36,0,15,37.52221728504777,0.6047453703703703,46.56531531531532,1013.7387387387389,28.159409409409413,8
4891,4,0,0,36,0.0,0.0,1.0,36,800,400,400,0.5,12,4,8,359.7292159513403,0.3897982804232804,0.004906677522421132,0.196487631781305,128601.01814229763,2052.308685374557,130653.3268276722,1710,1,364.19444444444446,36,0,15,37.302699752044724,0.6061921296296297,46.424549549549546,1014.3018018018012,28.175050050050032,0
4892,4,1,0,37,0.02702702702702703,0.0,1.0,37,1000,700,300,0.7,13,7,6,353.5839935865876,0.39611486486486486,0.0067544972237874035,0.18824937723829535,127575.0639786746,1650.3129819008168,129225.37696057542,1711,0,355.3243243243243,36,1,16,38.50787723405045,0.595775462962963,47.43806306306306,1010.2477477477476,28.06243743743743,8
4893,4,0,1,36,0.0,0.02702702702702703,0.972972972972973,37,1000,800,200,0.8,12,8,4,363.8485064017132,0.3968030530530531,-0.01646655648454165,0.18390888141759326,125450.85626166711,1783.4285721532424,127234.28483382035,1712,1,356.3243243243243,36,1,19,40.43694731714629,0.5740740740740741,49.54954954954955,1001.8018018018022,27.82782782782784,8
4894,4,1,0,37,0.02702702702702703,0.0,1.0,37,500,200,300,0.4,8,2,6,364.88192729591884,0.39548923923923923,0.004338644886467513,0.18594783800640977,125789.53108513913,1779.6653071990834,127569.19639233821,1713,0,357.2162162162162,36,1,22,40.0609003143242,0.5775462962962963,49.21171171171171,1003.1531531531525,27.86536536536535,0
4895,4,2,0,39,0.05128205128205128,0.0,1.0,39,1350,800,550,0.5925925925925926,19,8,11,387.35995602976914,0.40300269905533065,0.06461431661015182,0.19408417970813274,125086.82062596432,2170.7982149872105,127257.61884095153,1714,0,339.84615384615387,35,4,19,40.225833044081924,0.5723214285714286,49.913194444444436,1000.3472222222207,28.581349206349163,8
4896,4,4,0,43,0.09302325581395349,0.0,1.0,43,650,400,250,0.6153846153846154,9,4,5,365.753358784459,0.4175664451827243,0.1113202918484748,0.18781869069169055,126103.61571711997,642.7993955104942,126746.41511263046,1715,0,309.13953488372096,34,9,21,39.714699142665246,0.5848651960784313,48.89880952380951,1004.4047619047602,29.541316526610593,0
4897,4,2,2,43,0.044444444444444446,0.044444444444444446,0.9555555555555556,45,1400,1100,300,0.7857142857142857,17,11,6,348.37452532078817,0.42451599326599326,0.13899071176675193,0.18250908972894644,126921.7443795143,-156.73950978008315,126765.00486973423,1716,0,296.35555555555555,36,9,16,39.30952913127704,0.5891203703703703,48.08558558558557,1007.6576576576548,27.990490490490412,0
4898,4,1,0,44,0.022727272727272728,0.0,1.0,44,1150,800,350,0.6956521739130435,15,8,7,357.90788293994285,0.41926532769556024,0.14136419508528153,0.18763430840243367,126950.11470507648,287.2893586153489,127237.40406369184,1717,0,304.02272727272725,36,8,18,39.040209334376264,0.5894097222222222,48.05743243243242,1007.7702702702685,27.99361861861857,0
4899,4,1,1,44,0.022222222222222223,0.022222222222222223,0.9777777777777777,45,1450,1200,250,0.8275862068965517,17,12,5,354.5939482694215,0.4238215488215488,0.16593418851087605,0.18799141018541435,127404.47108848687,35.4501460920074,127439.92123457888,1718,0,298.24444444444447,36,9,14,38.657278304517575,0.5940393518518519,47.60698198198197,1009.5720720720699,28.04366866866861,0
4900,4,1,0,45,0.022222222222222223,0.0,1.0,45,1300,800,500,0.6153846153846154,18,8,10,352.6275462748216,0.4224537037037037,0.16910216046031978,0.1874236773651112,127506.9627794126,-7.506516428164389,127499.45626298443,1719,0,299.1111111111111,37,8,15,38.601830239206755,0.5931869369369369,47.505482456140335,1009.9780701754362,27.296704599336113,0
4901,4,4,1,48,0.08163265306122448,0.02040816326530612,0.9795918367346939,49,1350,900,450,0.6666666666666666,18,9,9,337.36844853803507,0.4290143140589569,0.21485664907570268,0.1852524968306725,128811.5153220226,-1102.2516543551378,127709.26366766747,1720,0,275.61224489795916,37,12,13,37.65527111687191,0.6064189189189189,46.21710526315792,1015.1315789473721,27.435988620199247,0
4902,4,1,2,47,0.02040816326530612,0.04081632653061224,0.9591836734693877,49,1400,1000,400,0.7142857142857143,18,10,8,336.6448361748733,0.42765022675736963,0.21946126226281826,0.1857896545088148,129011.37689248702,-1113.7972322667456,127897.57966022028,1721,0,276.59183673469386,38,11,16,37.470203666701714,0.6066337719298245,46.02029914529916,1015.9188034188063,26.734705353126483,0
4903,4,2,0,49,0.04081632653061224,0.0,1.0,49,1050,600,450,0.5714285714285714,15,6,9,339.2796201012864,0.42759708049886624,0.23055042864402342,0.1888120597288326,129340.77222077978,-1023.3225626059669,128317.4496581738,1722,0,277.3673469387755,37,12,18,37.06826470482555,0.6117680180180181,45.696271929824576,1017.2149122807042,27.49229492650552,0
4904,4,1,1,49,0.02,0.02,0.98,50,1350,1100,250,0.8148148148148148,16,11,5,333.88416102460957,0.42931972789115647,0.23544176285414453,0.1869515895748846,129581.83235627176,-1346.9357239388974,128234.89663233286,1723,0,272.8,38,12,14,36.96069429870584,0.612390350877193,45.459401709401725,1018.1623931623956,26.793747188484094,0
4905,4,0,0,49,0.0,0.0,1.0,49,1400,900,500,0.6428571428571429,19,9,10,326.92438693277796,0.4256483843537415,0.17379791897537444,0.17188722819785554,127067.5883829851,-1434.1619573556209,125633.42642562947,1724,1,279.2244897959184,42,7,17,39.700464520262685,0.5806051587301587,47.94089147286823,1008.2364341085296,24.00562938353642,8
4906,4,2,3,48,0.0392156862745098,0.058823529411764705,0.9411764705882353,51,1350,800,550,0.5925925925925926,19,8,11,316.7605484110955,0.4300980392156863,0.18403072569233836,0.16882292964767204,127617.73003472242,-2115.145222079482,125502.58481264293,1725,0,269.2352941176471,43,8,15,39.39432989690722,0.5847868217054264,47.39583333333334,1010.4166666666683,23.498062015503915,0
4907,4,0,0,48,0.0,0.0,1.0,48,1600,1000,600,0.625,22,10,12,327.91670232158924,0.425282579787234,0.19241898148148118,0.17404809584761274,127450.92207019633,-1241.3427853790697,126209.57928481727,1726,1,286.7916666666667,40,8,15,39.283078368223286,0.5875,47.5609756097561,1009.7560975609758,25.243902439024396,0
4908,4,1,0,49,0.02040816326530612,0.0,1.0,49,1400,1100,300,0.7857142857142857,17,11,6,316.5755947349356,0.42745535714285715,0.18614039022202267,0.16946105365223,127793.20987654304,-1708.7577160493995,126084.45216049365,1727,0,281.9183673469388,41,8,16,39.21989468864469,0.589430894308943,47.222222222222214,1011.1111111111098,24.661246612466094,0
4909,4,0,1,48,0.0,0.02040816326530612,0.9795918367346939,49,1600,800,800,0.5,24,8,16,315.14971979977844,0.42733134920634924,0.18204449852111848,0.1693307082464773,127943.7171280549,-1735.7146793902798,126208.00244866461,1728,1,282.9183673469388,41,8,16,39.10243838661175,0.5909552845528455,47.073412698412696,1011.706349206349,24.675764614789003,0
4910,4,0,0,48,0.0,0.0,1.0,48,1400,1200,200,0.8571428571428571,16,12,4,319.6489708397508,0.42616910460992913,0.18098448327809535,0.17194731510812525,127990.23321311716,-1417.6107351774822,126572.62247793967,1729,2,289.6458333333333,40,8,17,38.941197147735245,0.59296875,47.02743902439024,1011.8902439024388,25.297256097560968,0
4911,4,0,2,46,0.0,0.041666666666666664,0.9583333333333334,48,1650,1300,350,0.7878787878787878,20,13,7,327.45181887016037,0.4260675236406619,0.0730676328502422,0.1823389601919102,129364.36760355018,-894.7216102514494,128469.64599329873,1730,3,290.6458333333333,38,10,22,37.34509556815797,0.6101973684210527,45.67307692307692,1017.3076923076914,26.77125506072872,8
4912,4,1,0,47,0.02127659574468085,0.0,1.0,47,1250,700,550,0.56,18,7,11,307.0362987339859,0.4238744989207524,0.1251166736475955,0.17060034655363673,129278.89034511536,-1443.4371652310829,127835.45317988428,1731,0,297.63829787234044,40,7,17,37.95093434595782,0.6059895833333333,45.75711382113821,1016.9715447154473,25.424288617886184,8
4913,4,1,0,48,0.020833333333333332,0.0,1.0,48,1300,900,400,0.6923076923076923,17,9,8,308.1344249964387,0.42600288120567376,0.14860948762906645,0.172858361038986,129655.65653344696,-1609.7257653061015,128045.93076814087,1732,0,292.4166666666667,41,7,14,37.54139879212936,0.6082317073170731,45.38690476190477,1018.4523809523829,24.840301974448362,0
4914,4,0,0,48,0.0,0.0,1.0,48,1550,1200,350,0.7741935483870968,19,12,7,309.5085751565107,0.4258366578014185,0.14498125426039543,0.1739651646569353,129731.4453125,-1569.401041666666,128162.04427083333,1733,1,293.4166666666667,41,7,14,37.429703476482615,0.6089939024390244,45.3125,1018.75,24.847560975609756,0
4915,4,0,0,48,0.0,0.0,1.0,48,1450,1200,250,0.8275862068965517,17,12,5,307.3005219431432,0.42595670803782504,0.1474795640326978,0.17350660238943627,129908.3719135803,-1615.81790123456,128292.55401234573,1734,2,294.4166666666667,41,7,14,37.30699364214351,0.6107723577235773,45.13888888888889,1019.4444444444448,24.86449864498646,0
4916,4,1,1,48,0.02040816326530612,0.02040816326530612,0.9795918367346939,49,950,600,350,0.631578947368421,13,6,7,302.8916612329087,0.4284119897959184,0.15236932379789558,0.17203070079733151,130138.96869929685,-1916.3983159064985,128222.57038339035,1735,0,289.38775510204084,42,7,15,37.186411839189624,0.6116071428571428,44.91279069767442,1020.3488372093018,24.294019933554804,0
4917,4,0,0,48,0.0,0.0,1.0,48,1200,800,400,0.6666666666666666,16,8,8,308.3715118700542,0.42829307033096925,0.15501700680272146,0.17570004746084494,130262.58680555562,-1566.087149209775,128696.49965634584,1736,1,292.9583333333333,40,8,16,36.921768707483,0.6158854166666667,44.79166666666667,1020.8333333333339,25.52083333333335,0
4918,4,0,0,48,0.0,0.0,1.0,48,1300,600,700,0.46153846153846156,20,6,14,310.08957689568103,0.42786827718676124,0.16044921551066427,0.17715123128054014,130366.35068618225,-1514.9506948575474,128851.39999132471,1737,2,293.9583333333333,40,8,17,36.77314492320961,0.6169270833333333,44.69004065040651,1021.2398373983747,25.530995934959368,0
4919,4,0,1,47,0.0,0.020833333333333332,0.9791666666666666,48,1350,800,550,0.5925925925925926,19,8,11,310.7747766050294,0.42726802600472813,0.15953990983823974,0.17837620739384574,130548.0368828079,-1485.792600304045,129062.24428250385,1738,3,294.9583333333333,40,8,15,36.57227857332273,0.61875,44.51219512195122,1021.9512195121954,25.548780487804883,0
4920,4,0,0,47,0.0,0.0,1.0,47,1250,800,450,0.64,17,8,9,309.44811839114294,0.4254162812210916,0.16091205349495796,0.1782116496355632,130677.89019639441,-1312.3945526802731,129365.49564371414,1739,4,300.59574468085106,40,7,17,36.475209555047556,0.6200520833333334,44.38516260162602,1022.4593495934964,25.56148373983741,0
4921,4,0,0,47,0.0,0.0,1.0,47,1400,900,500,0.6428571428571429,19,9,10,313.82258980061545,0.4250308356460068,0.15979321524509205,0.18146191909952883,130833.79937743742,-1188.2796491836837,129645.51972825374,1740,5,301.59574468085106,40,7,17,36.20616866991159,0.6216145833333333,44.232723577235774,1023.0691056910573,25.57672764227643,0
4922,4,0,1,46,0.0,0.02127659574468085,0.9787234042553191,47,1000,600,400,0.6,14,6,8,314.56783646549627,0.4243177613320999,0.15542267954108513,0.18226111123173472,130911.78882444323,-1163.8723643333851,129747.91646010985,1741,6,302.59574468085106,40,7,18,36.108490566037744,0.6223958333333333,44.15650406504066,1023.3739837398382,25.584349593495954,0
4923,4,0,1,45,0.0,0.021739130434782608,0.9782608695652174,46,1500,1000,500,0.6666666666666666,20,10,10,321.8508113431458,0.4210748792270531,0.15713805354369725,0.1868179517465504,130981.34901258702,-768.7093098958089,130212.6397026912,1742,7,309.67391304347825,39,7,18,35.85201061700757,0.624732905982906,44.08854166666668,1023.6458333333351,26.247329059829106,0
4924,4,0,1,44,0.0,0.022222222222222223,0.9777777777777777,45,1550,1400,150,0.9032258064516129,17,14,3,323.5640586695272,0.4185185185185185,0.16815162580420795,0.18830367348800361,131081.84633875746,-517.3251561472607,130564.5211826102,1743,8,316.9555555555556,38,7,18,35.70683359415754,0.627467105263158,43.99038461538462,1024.0384615384621,26.948380566801635,0
4925,4,0,0,44,0.0,0.0,1.0,44,1650,1400,250,0.8484848484848485,19,14,5,337.4933046406216,0.4193754404510219,0.09545920029791022,0.18778473617183286,129333.8012695311,59.42467884511245,129393.22594837622,1744,9,287.52272727272725,39,5,20,37.12077572964671,0.6081730769230769,45.70312499999999,1017.1874999999989,26.08173076923074,8
4926,4,0,0,44,0.0,0.0,1.0,44,1050,800,250,0.7619047619047619,13,8,5,336.17851064438474,0.41925431642001404,0.09225173822798483,0.18730493516621233,129386.7852105033,-100.58865017363092,129286.19656032967,1745,10,288.52272727272725,39,5,21,37.10037626702161,0.6087072649572649,45.65104166666666,1017.3958333333319,26.08707264957261,0
4927,4,0,0,44,0.0,0.0,1.0,44,1800,1200,600,0.6666666666666666,24,12,12,336.53750909509273,0.4184394820295983,0.0993357515302653,0.18921977165890658,129744.38707325331,-67.22943105955972,129677.15764219375,1746,11,289.52272727272725,40,4,17,36.728179551122196,0.6106770833333333,45.29979674796748,1018.8008130081298,25.470020325203244,0
4928,4,0,0,44,0.0,0.0,1.0,44,1150,700,450,0.6086956521739131,16,7,9,334.17925236583017,0.41799903100775193,0.10368087572896312,0.18831724956413437,129832.53146455329,-122.53234048250204,129709.99912407079,1747,12,290.52272727272725,41,3,18,36.69885054674065,0.610010162601626,45.213293650793645,1019.1468253968244,24.857239643824986,0
4929,4,0,0,44,0.0,0.0,1.0,44,750,600,150,0.8,9,6,3,334.6969685720437,0.41838442565186756,0.1004458756502351,0.18897505763990766,129908.3719135801,-104.01234567903373,129804.35956790106,1748,13,291.52272727272725,41,3,18,36.60876475930969,0.6107723577235773,45.13888888888888,1019.4444444444432,24.86449864498642,0
4930,4,0,0,44,0.0,0.0,1.0,44,1650,900,750,0.5454545454545454,24,9,15,336.00072346597983,0.4177567829457364,0.11114400862602292,0.19094494152326322,130161.33334120666,-53.139566011611635,130108.19377519505,1749,14,292.52272727272725,41,3,20,36.31918789292888,0.6133130081300813,44.890873015873005,1020.4365079365064,24.888695315524544,0
4931,4,0,2,42,0.0,0.045454545454545456,0.9545454545454546,44,1050,700,350,0.6666666666666666,14,7,7,335.1992231582775,0.41743745595489784,0.110694121701022,0.19086136176400192,130237.26974875585,-68.9136707924078,130168.35607796344,1750,15,293.52272727272725,41,3,20,36.26273609356269,0.6140752032520325,44.816468253968246,1020.734126984126,24.895954316685998,0
4932,4,1,1,42,0.023255813953488372,0.023255813953488372,0.9767441860465116,43,850,500,350,0.5882352941176471,12,5,7,334.2141231508648,0.4169435215946844,0.12051472994701884,0.1912079166637909,130422.14084201369,117.78674866935512,130539.92759068304,1751,0,296.69767441860466,39,4,21,36.100771636413086,0.6191239316239316,44.63541666666666,1021.4583333333317,26.191239316239272,0
4933,4,0,1,41,0.0,0.023809523809523808,0.9761904761904762,42,1000,600,400,0.6,14,6,8,339.4878484568249,0.4136904761904762,0.13851953665800254,0.19438220400863193,130453.51765103341,457.47680619473243,130910.99445722814,1752,1,304.14285714285717,38,4,21,35.934340793418414,0.6211622807017544,44.604700854700845,1021.5811965811945,26.883715699505117,0
4934,4,1,1,41,0.023809523809523808,0.023809523809523808,0.9761904761904762,42,1000,600,400,0.6,14,6,8,334.22429234705214,0.41458575300038714,0.14234874603332215,0.1935195169432124,130885.78976014593,349.04209217395146,131234.83185231988,1753,0,297.64285714285717,40,2,17,35.63184857814413,0.6221354166666666,44.18191056910568,1023.2723577235761,25.581808943089403,0
4935,4,0,0,41,0.0,0.0,1.0,41,750,500,250,0.6666666666666666,10,5,5,333.11449086753555,0.41234756097560976,0.1470862036864644,0.19308848806923523,130928.03955078124,522.8054470486106,131450.84499782984,1754,1,304.9756097560976,39,2,17,35.61757845631892,0.624198717948718,44.140625,1023.4374999999999,26.241987179487175,0
4936,4,0,0,41,0.0,0.0,1.0,41,1000,600,400,0.6,14,6,8,334.9430093809367,0.41224593495934964,0.14600388218415072,0.1942827632926258,130954.69292534713,572.4717881944343,131527.16471354157,1755,2,305.9756097560976,39,2,17,35.54388018183052,0.624465811965812,44.11458333333333,1023.5416666666658,26.244658119658098,0
4937,4,0,0,41,0.0,0.0,1.0,41,1350,1000,350,0.7407407407407407,17,10,7,336.20376512616843,0.4114583333333333,0.14207379103292594,0.1955552077627357,131061.33355034715,612.6627604166611,131673.99631076382,1756,3,306.9756097560976,39,2,17,35.40395049169211,0.625534188034188,44.010416666666664,1023.9583333333327,26.255341880341863,0
4938,4,0,0,41,0.0,0.0,1.0,41,1000,500,500,0.5,15,5,10,332.4581057711517,0.41158536585365857,0.14103438441603466,0.19404898933289488,131194.69536675356,523.3479817708376,131718.0433485244,1757,4,307.9756097560976,39,2,19,35.365298254533116,0.6268696581196581,43.880208333333336,1024.4791666666672,26.268696581196593,0
4939,4,0,1,40,0.0,0.024390243902439025,0.975609756097561,41,1300,1000,300,0.7692307692307693,16,10,6,336.71138829821484,0.4120426829268293,0.14612798206756672,0.19764031764513565,131410.26925131492,649.5346560907724,132059.8039074057,1758,5,308.9756097560976,38,3,19,35.03894446181098,0.6307565789473684,43.669871794871796,1025.320512820513,26.982118758434552,0
4940,4,0,1,39,0.0,0.025,0.975,40,1100,600,500,0.5454545454545454,16,6,10,340.7290264840068,0.4121527777777778,0.1428514163548904,0.20059912163359866,131524.88175448214,962.8689837257607,132487.7507382079,1759,6,314.225,37,3,19,34.82039461963299,0.6337274774774775,43.55811403508772,1025.767543859649,27.723447131341867,0
4941,4,0,1,38,0.0,0.02564102564102564,0.9743589743589743,39,1150,1000,150,0.8695652173913043,13,10,3,348.4869068269229,0.411774628879892,0.1522138637713215,0.20550577398706157,131587.9662390434,1371.3366660579784,132959.3029051014,1760,7,317.84615384615387,36,3,15,34.55781472944792,0.6362847222222222,43.496621621621635,1026.0135135135158,28.50037537537544,0
4942,4,0,0,38,0.0,0.0,1.0,38,1200,900,300,0.75,15,9,6,357.9673377094515,0.40832444286391656,0.15588963943892864,0.2101545821582527,131417.1157648535,1808.607011959888,133225.72277681337,1761,8,326.9736842105263,35,3,19,34.48717406027768,0.6366071428571429,43.66319444444445,1025.347222222223,29.295634920634946,0
4943,4,0,0,38,0.0,0.0,1.0,38,1200,700,500,0.5833333333333334,17,7,10,357.3459008173218,0.4080280938833571,0.1517218240229936,0.21044230690657312,131535.8170037081,1800.7570033865002,133336.5740070946,1762,9,327.9736842105263,35,3,20,34.38322708638911,0.6377976190476191,43.54745370370371,1025.810185185186,29.308862433862455,0
4944,4,0,0,38,0.0,0.0,1.0,38,1350,1000,350,0.7407407407407407,17,10,7,358.18303641011624,0.4077317449027975,0.15805501798710608,0.21142814918855482,131624.87809713665,1829.1597007887742,133454.0377979254,1763,10,328.9736842105263,35,3,15,34.27184374765021,0.6386904761904761,43.46064814814816,1026.1574074074088,29.31878306878311,0
4945,4,0,0,38,0.0,0.0,1.0,38,900,500,400,0.5555555555555556,13,5,8,397.4122774403343,0.4083837126600285,0.24164754762638574,0.21283019875463188,127811.68845221595,2558.7868382579163,130370.47529047387,1764,11,329.9736842105263,37,1,15,37.15752186799683,0.5962837837837838,47.20394736842105,1011.1842105263148,27.329302987197696,8
4946,4,1,0,39,0.02564102564102564,0.0,1.0,39,1050,700,350,0.6666666666666666,14,7,7,392.6902207586968,0.4123369320737742,0.24597523848183456,0.21176663868461323,128090.45041867565,2259.973450398139,130350.4238690738,1765,0,322.4871794871795,38,1,16,36.990545294635,0.5973135964912281,46.92841880341881,1012.2863247863254,26.639113810166457,0
4947,4,0,0,39,0.0,0.0,1.0,39,1250,1000,250,0.8,15,10,5,389.11190403353487,0.41256185335132706,0.24039450436433674,0.21058245344449364,128232.4369454089,2179.3877825603545,130411.82472796926,1766,1,323.4871794871795,35,4,17,36.93542166609531,0.6044642857142857,46.78819444444444,1012.847222222222,28.938492063492056,0
4948,4,0,1,38,0.0,0.02564102564102564,0.9743589743589743,39,800,500,300,0.625,11,5,6,390.3792532348328,0.41306792622582095,0.24371424302876354,0.21157830362628435,128291.05748724712,2216.433443715712,130507.49093096283,1767,2,324.4871794871795,35,4,17,36.843201378574975,0.6050595238095238,46.730324074074076,1013.078703703704,28.94510582010583,0
4949,4,0,0,38,0.0,0.0,1.0,38,1000,600,400,0.6,14,6,8,393.8632987914335,0.4137328117591275,0.24316605467156238,0.21413487394063002,128415.88010204089,2515.660430839011,130931.5405328799,1768,3,329.44736842105266,34,4,14,36.62692819669564,0.6084558823529411,46.60714285714286,1013.5714285714291,29.810924369747916,0
4950,4,2,0,40,0.05,0.0,1.0,40,1000,700,300,0.7,13,7,6,381.1166329966393,0.42143429487179485,0.25104144183034727,0.21045451259516446,129034.22807979373,1835.4181094182743,130869.646189212,1769,0,313.925,37,3,16,36.31736096122023,0.6086711711711712,45.997807017543856,1016.0087719298241,27.459696538643893,0
4951,4,1,0,41,0.024390243902439025,0.0,1.0,41,950,600,350,0.631578947368421,13,6,7,373.54644344931853,0.42390752032520324,0.2600008562987908,0.20794490939898566,129352.72285997748,1464.2827404507673,130817.00560042825,1770,0,307.2439024390244,34,7,17,36.18465964501658,0.617953431372549,45.68452380952382,1017.2619047619061,29.919467787114883,0
4952,4,0,0,41,0.0,0.0,1.0,41,1550,1100,450,0.7096774193548387,20,11,9,376.3116795377507,0.4229928861788618,0.26835259579639903,0.21012988558904183,129473.85381235825,1544.5046768707482,131018.35848922901,1771,1,308.2439024390244,34,7,15,35.99080789176123,0.6191789215686274,45.56547619047619,1017.7380952380951,29.933473389355736,0
4953,4,0,0,41,0.0,0.0,1.0,41,750,400,350,0.5333333333333333,11,4,7,374.6176076644618,0.42258638211382116,0.2674341326502958,0.20950655089200884,129534.44054705228,1505.1764455782459,131039.61699263052,1772,2,309.2439024390244,34,7,15,35.97215725256305,0.6197916666666667,45.50595238095239,1017.9761904761914,29.940476190476218,0
4954,4,0,0,41,0.0,0.0,1.0,41,1150,600,550,0.5217391304347826,17,6,11,374.8429752066116,0.421875,0.26496674057649683,0.2103710575139146,129672.49657064467,1521.3648834019132,131193.8614540466,1773,3,310.2439024390244,35,6,15,35.825757575757564,0.6190476190476191,45.37037037037037,1018.5185185185181,29.10052910052909,0
4955,4,0,1,40,0.0,0.024390243902439025,0.975609756097561,41,1300,1000,300,0.7692307692307693,16,10,6,376.48911815878614,0.4226880081300813,0.26471365045142137,0.21215607218785915,129831.8483179126,1576.0556164272505,131407.90393433985,1774,4,311.2439024390244,36,5,16,35.621546961325976,0.6186342592592593,45.21396396396397,1019.144144144145,28.309559559559585,0
4956,4,0,0,40,0.0,0.0,1.0,40,750,500,250,0.6666666666666666,10,5,5,382.87307658805497,0.41955128205128206,0.2644102942847406,0.21503930740596497,129701.96926708246,1931.8784025634388,131633.8476696459,1775,5,319.9,35,5,17,35.59124436617051,0.6193452380952381,45.34143518518518,1018.6342592592591,29.103835978835974,0
4957,4,1,1,40,0.024390243902439025,0.024390243902439025,0.975609756097561,41,1250,900,350,0.72,16,9,7,391.3113640031854,0.424390243902439,0.2448045723917509,0.2044620534483269,126814.1328605585,1843.892169174017,128658.02502973251,1776,0,313.0731707317073,33,8,15,38.33888449527518,0.5943813131313131,48.192401960784316,1007.2303921568632,30.52213309566252,8
4958,4,3,0,43,0.06976744186046512,0.0,1.0,43,1000,800,200,0.8,12,8,4,370.146694284679,0.4298172757475083,0.24664159626713844,0.19756240430891298,127676.20991941012,851.7854080932755,128527.99532750339,1777,0,288.09302325581393,35,8,18,37.98576118491373,0.5988095238095238,47.33796296296296,1010.6481481481479,28.87566137566137,0
4959,4,0,1,42,0.0,0.023255813953488372,0.9767441860465116,43,550,200,350,0.36363636363636365,9,2,7,369.44762642937076,0.42974806201550386,0.2471619278917978,0.19733248450199972,127705.45488522378,836.0954378858046,128541.55032310958,1778,1,289.09302325581393,35,8,18,37.97341978701477,0.5991071428571428,47.30902777777778,1010.7638888888889,28.878968253968253,0
4960,4,4,1,45,0.08695652173913043,0.021739130434782608,0.9782608695652174,46,1250,900,350,0.72,16,9,7,356.9767214474573,0.4372383252818035,0.28053696004509887,0.19560802587307402,128728.04763244471,-8.663199120014383,128719.3844333247,1779,0,270.1304347826087,37,9,16,37.242819196830546,0.6055743243243243,46.299342105263165,1014.8026315789483,27.42709815078239,0
4961,4,1,1,45,0.021739130434782608,0.021739130434782608,0.9782608695652174,46,1350,700,650,0.5185185185185185,20,7,13,356.7642985742586,0.4375402576489533,0.2881532184992699,0.19631575573952528,128895.01006319262,-2.972429016608629,128892.03763417601,1780,0,271.10869565217394,37,9,18,37.07786686103013,0.6072635135135135,46.13486842105264,1015.4605263157903,27.444879089615952,0
4962,4,2,3,44,0.0425531914893617,0.06382978723404255,0.9361702127659575,47,950,600,350,0.631578947368421,13,6,7,344.6640903686084,0.4412002775208141,0.28370322817314664,0.19221651193633957,129424.43828870446,-477.68135387809275,128946.75693482636,1781,0,262.2340425531915,37,10,20,36.84626436781608,0.6126126126126126,45.61403508771931,1017.5438596491248,27.501185395922292,0
4963,4,2,1,45,0.043478260869565216,0.021739130434782608,0.9782608695652174,46,1300,900,400,0.6923076923076923,17,9,8,358.4881891488875,0.43800322061191627,0.3138328557967809,0.20112699644308568,129659.75265806368,96.29798717639363,129756.05064524007,1782,0,268.3695652173913,36,10,19,36.25515995872034,0.6168981481481481,45.382882882882896,1018.4684684684701,28.290790790790837,0
4964,4,0,0,45,0.0,0.0,1.0,45,1200,700,500,0.5833333333333334,17,7,10,367.8040157912439,0.4353324915824916,0.3067469788233519,0.20626561726877962,129643.02722318663,536.6452064043099,130179.67242959094,1783,1,275.31111111111113,35,10,19,36.03498977156496,0.61875,45.39930555555555,1018.4027777777769,29.097222222222197,0
4965,4,0,1,44,0.0,0.022222222222222223,0.9777777777777777,45,1100,700,400,0.6363636363636364,15,7,8,369.66145813602384,0.43545875420875424,0.30952907362370086,0.2076992267266134,129717.1051964128,590.2828504180035,130307.3880468308,1784,2,276.31111111111113,36,9,19,35.912281671456995,0.6174768518518519,45.326576576576585,1018.6936936936951,28.297047047047087,0
4966,4,0,0,44,0.0,0.0,1.0,44,1200,600,600,0.5,18,6,12,379.8130256900723,0.4325779598308668,0.31305868736242726,0.21268078847839395,129584.09857521014,1043.5457122342368,130627.64428744437,1785,3,283.5,35,9,19,35.78930790799894,0.6181547619047619,45.45717592592593,1018.171296296297,29.090608465608486,0
4967,4,2,1,45,0.043478260869565216,0.021739130434782608,0.9782608695652174,46,750,500,250,0.6666666666666666,10,5,5,367.85402067923957,0.4357085346215781,0.3242461618964849,0.20898959196831537,130150.67737188369,375.2899930747955,130525.96736495849,1786,0,272.1304347826087,37,9,21,35.5174081237911,0.6199324324324325,44.901315789473685,1020.3947368421057,27.57823613086772,0
4968,4,0,0,45,0.0,0.0,1.0,45,1100,700,400,0.6363636363636364,15,7,8,375.03391016050847,0.4334175084175084,0.32722633199612283,0.21242539864438564,130032.77084094236,753.3396994968007,130786.11054043917,1787,1,279.02222222222224,36,9,21,35.454160686025524,0.6206597222222222,45.016891891891895,1019.9324324324331,28.331456456456475,0
4969,4,0,0,45,0.0,0.0,1.0,45,1050,600,450,0.5714285714285714,15,6,9,374.5831941203147,0.4334806397306397,0.3228318063068034,0.21248272733474827,130090.2058096948,745.920963192918,130836.12677288771,1788,2,280.02222222222224,36,9,21,35.40723773779298,0.6212384259259259,44.960585585585584,1020.1576576576574,28.337712712712705,0
4970,4,0,0,45,0.0,0.0,1.0,45,1350,900,450,0.6666666666666666,18,9,9,377.009579341941,0.4335227272727273,0.33142857142857185,0.21480778357854777,130262.5868055555,822.1627455157817,131084.7495510713,1789,3,281.02222222222224,35,10,22,35.17006802721088,0.625,44.791666666666664,1020.8333333333329,29.166666666666654,0
4971,4,1,0,46,0.021739130434782608,0.0,1.0,46,1400,1100,300,0.7857142857142857,17,11,6,366.652216978689,0.43350442834138486,0.33066563215418054,0.21092958337975543,130636.47050766987,379.6303059816602,131016.10081365153,1790,0,275.89130434782606,36,10,20,35.05498641404127,0.6267361111111112,44.42567567567568,1022.2972972972976,28.397147147147155,0
4972,4,2,0,48,0.041666666666666664,0.0,1.0,48,1550,1200,350,0.7741935483870968,19,12,7,355.22167791397993,0.4371860224586288,0.3382239197691801,0.20731714361029552,131191.27498584625,-279.6030343706696,130911.67195147558,1791,0,265.3541666666667,38,10,22,34.78573539124691,0.6285635964912281,43.883547008547005,1024.4658119658116,26.959626630679253,0
4973,4,0,1,47,0.0,0.020833333333333332,0.9791666666666666,48,1500,900,600,0.6,21,9,12,352.0546185447247,0.43682587174940896,0.335886594919101,0.20682641009472658,131443.5782911289,-344.79355848465997,131098.78473264424,1792,1,266.3541666666667,36,12,24,34.61202320814115,0.634837962962963,43.637387387387385,1025.45045045045,28.484734734734722,0
4974,4,0,1,46,0.0,0.02127659574468085,0.9787234042553191,47,1400,900,500,0.6428571428571429,19,9,10,353.1743923126847,0.4364785692260253,0.32918577137878646,0.20795510921630533,131530.20154867697,-109.38019945621801,131420.82134922076,1793,2,262.2340425531915,36,11,24,34.49587404398581,0.6357060185185186,43.552927927927925,1025.7882882882877,28.494119119119105,0
4975,4,0,0,46,0.0,0.0,1.0,46,1250,800,450,0.64,17,8,9,360.23816323321864,0.43591988727858294,0.32199523122663454,0.211980783703372,131506.1366705246,274.70582561727764,131780.84249614188,1794,3,266.04347826086956,35,11,24,34.339031821259304,0.6375,43.576388888888886,1025.694444444444,29.30555555555554,0
4976,4,0,0,46,0.0,0.0,1.0,46,1450,1300,150,0.896551724137931,16,13,3,362.5089379868705,0.43601046698872786,0.3185896901554859,0.21414835130776672,131654.57182623877,345.1918027691873,131999.76362900797,1795,4,267.04347826086956,35,11,20,34.13088323747227,0.6389880952380953,43.431712962962955,1026.2731481481474,29.322089947089925,0
4977,4,0,1,45,0.0,0.021739130434782608,0.9782608695652174,46,1300,1000,300,0.7692307692307693,16,10,6,342.938705151635,0.4359500805152979,0.24146086166546565,0.19333663492735567,129849.38298396765,-279.3694808813561,129570.01350308629,1796,5,268.04347826086956,35,11,16,36.45856991445227,0.6208333333333333,45.19675925925925,1019.2129629629619,29.120370370370342,8
4978,4,1,0,46,0.021739130434782608,0.0,1.0,46,1450,1200,250,0.8275862068965517,17,12,5,338.90428919663196,0.43662439613526566,0.2564728062979431,0.19281164927740596,130205.11379200152,-374.5856921110247,129830.5280998905,1797,0,268.7173913043478,36,10,18,36.20076133730552,0.6223958333333333,44.847972972972975,1020.6081081081086,28.350225225225238,0
4979,4,2,2,46,0.041666666666666664,0.041666666666666664,0.9583333333333334,48,1300,800,500,0.6153846153846154,18,8,10,324.23583868208624,0.441193853427896,0.2514722966934759,0.18675103123597617,130682.67549871116,-1125.585940090774,129557.08955862038,1798,0,258.4791666666667,37,11,14,36.09238159070598,0.6252815315315315,44.38048245614035,1022.4780701754388,27.634542437174023,0
4980,4,0,0,46,0.0,0.0,1.0,46,1650,1300,350,0.7878787878787878,20,13,7,339.44730689546986,0.4360305958132045,0.25361333609198167,0.1942906569818038,130439.8750964505,-344.50713734569086,130095.36795910481,1799,2,270.7173913043478,35,11,20,35.949184228416044,0.6267857142857143,44.61805555555555,1021.5277777777768,29.18650793650791,0
4981,4,0,0,46,0.0,0.0,1.0,46,1750,1300,450,0.7428571428571429,22,13,9,339.4271305610317,0.43550724637681154,0.25681717465163256,0.19487266338451906,130558.13426997565,-337.00542266807764,130221.12884730757,1800,3,271.7173913043478,35,11,14,35.830030200075505,0.6279761904761905,44.502314814814795,1021.9907407407379,29.199735449735368,0
4982,4,1,1,46,0.02127659574468085,0.02127659574468085,0.9787234042553191,47,1350,1000,350,0.7407407407407407,17,10,7,331.2665352607602,0.43788544557508485,0.25943584003447007,0.1917125948649212,130866.8190995047,-729.6404512620948,130137.17864824261,1801,0,266.9148936170213,36,11,16,35.72666740039622,0.6290509259259259,44.20045045045044,1023.1981981981966,28.422172172172125,0
4983,4,0,0,46,0.0,0.0,1.0,46,1850,1600,250,0.8648648648648649,21,16,5,337.2842043395962,0.4371678743961353,0.26370103960128133,0.19468194080659745,130765.21675936617,-378.9915820044862,130386.22517736169,1802,1,273.39130434782606,35,11,16,35.675403606050324,0.6300595238095238,44.299768518518505,1022.8009259259239,29.22288359788354,0
4984,4,0,1,45,0.0,0.021739130434782608,0.9782608695652174,46,1100,800,300,0.7272727272727273,14,8,6,337.25139057520823,0.4373289049919485,0.2632626157788853,0.19496174239988637,130824.41332572426,-375.8569369427503,130448.55638878151,1803,2,274.39130434782606,35,11,16,35.616420598106885,0.6306547619047619,44.24189814814814,1023.0324074074059,29.229497354497312,0
4985,4,0,0,45,0.0,0.0,1.0,45,1400,1100,300,0.7857142857142857,17,11,6,400.68112566555374,0.4361531986531986,0.3461420115257243,0.2191658891477438,128657.32001133791,1484.6976256745013,130142.01763701241,1804,3,280.73333333333335,34,11,17,36.20653406868497,0.610906862745098,46.36904761904762,1014.5238095238099,29.8389355742297,8
4986,4,1,1,45,0.021739130434782608,0.021739130434782608,0.9782608695652174,46,1100,700,400,0.6363636363636364,15,7,8,398.5936729516484,0.4378220611916264,0.35502626120618386,0.22087370533339606,129171.97312510718,1097.4262420696198,130269.3993671768,1805,0,275.60869565217394,35,11,20,35.73249933583816,0.6139880952380952,45.86226851851852,1016.5509259259261,29.044312169312175,0
4987,4,1,0,46,0.021739130434782608,0.0,1.0,46,1000,600,400,0.6,14,6,8,390.55508751110614,0.4385970209339775,0.34999555234885404,0.2188601057275611,129613.56122470838,924.2471493484074,130537.80837405678,1806,0,270.0217391304348,35,11,16,35.48581116920513,0.618452380952381,45.42824074074073,1018.287037037036,29.093915343915317,0
4988,4,1,0,47,0.02127659574468085,0.0,1.0,47,1300,1100,200,0.8461538461538461,15,11,4,381.9231864369382,0.44066065371569535,0.3620051060071918,0.21664634601955038,130090.2058096947,536.8931854151238,130627.09899510983,1807,0,265.25531914893617,36,11,17,35.220039003569184,0.6212384259259259,44.96058558558558,1020.1576576576566,28.337712712712683,0
4989,4,0,0,47,0.0,0.0,1.0,47,1300,700,600,0.5384615384615384,19,7,12,379.67513536026684,0.43987049028677155,0.35935735996526286,0.21632653061224486,130262.58680555539,491.7213243648851,130754.30812992027,1808,1,266.25531914893617,34,13,20,35.10204081632652,0.6271446078431373,44.79166666666666,1020.833333333332,30.02450980392153,0
4990,4,1,1,47,0.020833333333333332,0.020833333333333332,0.9791666666666666,48,1300,700,600,0.5384615384615384,19,7,12,370.4690562595821,0.44074135638297873,0.3528083700440534,0.21344283190590135,130694.03863322786,83.61943024106012,130777.65806346892,1809,0,261.6875,36,12,15,34.89904552129223,0.6273148148148149,44.36936936936937,1022.5225225225228,28.40340340340341,0
4991,4,2,1,48,0.04081632653061224,0.02040816326530612,0.9795918367346939,49,1300,1000,300,0.7692307692307693,16,10,6,363.2975036797029,0.44185799319727886,0.36122768356168744,0.2114272357480238,131081.84633875734,-275.65848948060864,130806.18784927673,1810,0,257.3061224489796,38,11,17,34.68961919666144,0.627467105263158,43.99038461538461,1024.0384615384612,26.94838056680161,0
4992,4,0,0,48,0.0,0.0,1.0,48,1250,900,350,0.72,16,9,7,370.7400346273032,0.4417109929078014,0.35701345755693636,0.21556478476648533,131047.29940943357,116.8960641735853,131164.19547360716,1811,1,262.9791666666667,37,11,17,34.53407224958951,0.6289414414414414,44.02412280701754,1023.9035087719291,27.67306780464673,0
4993,4,0,0,48,0.0,0.0,1.0,48,1300,800,500,0.6153846153846154,18,8,10,368.1081275542227,0.4418218085106383,0.3518025372015847,0.21450393134647514,131131.51552641208,54.115328755015895,131185.6308551671,1812,2,263.9791666666667,37,11,17,34.516178674660104,0.6297860360360361,43.94188596491229,1024.2324561403518,27.68195827406356,0
4994,4,2,1,49,0.04,0.02,0.98,50,1400,1000,400,0.7142857142857143,18,10,8,353.2209356820712,0.442984693877551,0.34494732221246727,0.20845525686107738,131616.85333982646,-701.5925396729413,130915.26080015351,1813,0,254.38,36,14,15,34.40723770851626,0.6365740740740741,43.46846846846848,1026.1261261261272,28.503503503503534,0
4995,4,0,1,48,0.0,0.02040816326530612,0.9795918367346939,49,2100,1800,300,0.8571428571428571,24,18,6,370.19877828148674,0.4423894557823129,0.3612976767984253,0.19671102029763282,127496.3146162062,-360.2040187377023,127136.1105974685,1814,1,260.57142857142856,38,11,15,38.16909975669098,0.591282894736842,47.51602564102563,1009.9358974358955,26.577260458839355,8
4996,4,4,1,51,0.07692307692307693,0.019230769230769232,0.9807692307692307,52,1200,600,600,0.5,18,6,12,356.27697504222215,0.4486472473604826,0.381664910432034,0.19409118789613572,128496.33487654304,-1239.0119347651548,127257.3229417779,1815,0,244.69230769230768,38,14,13,37.49714611872148,0.6014254385964912,46.52777777777777,1013.8888888888875,26.68128654970757,0
4997,4,2,1,52,0.03773584905660377,0.018867924528301886,0.9811320754716981,53,1600,1100,500,0.6875,21,11,10,348.9809335963183,0.45066823899371067,0.38095791001451396,0.19223526003187022,128936.76757812499,-1600.7052951388896,127336.0622829861,1816,0,241.03773584905662,39,14,16,37.23290598290598,0.6041666666666667,46.09375,1015.6249999999999,26.041666666666664,0
4998,4,0,0,52,0.0,0.0,1.0,52,1600,1300,300,0.8125,19,13,6,355.0401051939515,0.45076043237807945,0.38041420118343217,0.1955729393017529,128936.76757812499,-1244.4552951388898,127692.3122829861,1817,1,246.17307692307693,39,13,16,37.07905982905983,0.6041666666666667,46.09375,1015.6249999999999,26.041666666666664,0
4999,4,1,1,52,0.018867924528301886,0.018867924528301886,0.9811320754716981,53,1450,1000,450,0.6896551724137931,19,10,9,357.2383228834433,0.45146952104499277,0.39015002797131726,0.1985251914166528,129285.0098708256,-1362.0741778720412,127922.93569295356,1818,0,242.50943396226415,37,16,18,36.66835130278527,0.611204954954955,45.75109649122807,1016.9956140350873,27.48636794689425,0
5000,4,1,2,51,0.018867924528301886,0.03773584905660377,0.9622641509433962,53,1000,400,600,0.4,16,4,12,352.64261055185864,0.4520137880986938,0.3918238316494347,0.1976458614481057,129619.76431450056,-1458.1095866035803,128161.65472789698,1819,0,242.75471698113208,37,16,15,36.44464933060551,0.6145833333333333,45.422149122807014,1018.3114035087715,27.52192982456139,0
